Xid, State, StartTime, EndTime, TransactionTime, ExecuteTime, CommunicationTime, ReadTime, WriteTime, DBTime
14, 1, 1636428093852, 1636428094350, 498, 80, 418, 35, 5, 40
16, 1, 1636428094698, 1636428095107, 409, 4, 405, 1, 1, 2
18, 1, 1636428095418, 1636428095827, 409, 4, 405, 2, 0, 2
20, 1, 1636428096138, 1636428096546, 408, 4, 404, 2, 1, 3
22, 1, 1636428096814, 1636428097227, 413, 4, 409, 2, 0, 2
24, 1, 1636428097494, 1636428097902, 408, 3, 405, 1, 0, 1
26, 1, 1636428098170, 1636428098578, 408, 4, 404, 0, 1, 1
29, 1, 1636428098842, 1636428099250, 408, 2, 406, 2, 0, 2
31, 1, 1636428099518, 1636428099938, 420, 3, 417, 2, 0, 2
33, 1, 1636428100206, 1636428100614, 408, 3, 405, 0, 0, 0
35, 1, 1636428100882, 1636428101294, 412, 4, 408, 1, 0, 1
37, 1, 1636428101562, 1636428101970, 408, 2, 406, 1, 0, 1
40, 1, 1636428102234, 1636428102642, 408, 3, 405, 1, 0, 1
43, 1, 1636428102910, 1636428103318, 408, 4, 404, 0, 0, 0
46, 1, 1636428103582, 1636428103994, 412, 2, 410, 0, 1, 1
49, 1, 1636428104266, 1636428104676, 410, 7, 403, 0, 1, 1
52, 1, 1636428104942, 1636428105306, 364, 2, 362, 0, 1, 1
54, 1, 1636428105570, 1636428105938, 368, 2, 366, 0, 0, 0
57, 1, 1636428106206, 1636428106566, 360, 3, 357, 0, 0, 0
60, 1, 1636428106834, 1636428107198, 364, 2, 362, 0, 1, 1
63, 1, 1636428107470, 1636428107838, 368, 3, 365, 1, 1, 2
66, 1, 1636428108106, 1636428108469, 363, 2, 361, 0, 0, 0
69, 1, 1636428108734, 1636428109102, 368, 2, 366, 0, 0, 0
72, 1, 1636428109366, 1636428109726, 360, 3, 357, 1, 1, 2
75, 1, 1636428109990, 1636428110354, 364, 2, 362, 0, 0, 0
78, 1, 1636428110618, 1636428110986, 368, 1, 367, 0, 0, 0
81, 1, 1636428111254, 1636428111618, 364, 2, 362, 0, 0, 0
84, 1, 1636428111886, 1636428112246, 360, 1, 359, 0, 1, 1
87, 1, 1636428112518, 1636428112882, 364, 2, 362, 0, 0, 0
90, 1, 1636428113150, 1636428113518, 368, 2, 366, 0, 1, 1
93, 1, 1636428113782, 1636428114146, 364, 2, 362, 0, 1, 1
96, 1, 1636428114410, 1636428114778, 368, 0, 368, 0, 0, 0
99, 1, 1636428115046, 1636428115410, 364, 1, 363, 0, 1, 1
102, 1, 1636428115674, 1636428116034, 360, 1, 359, 0, 0, 0
105, 1, 1636428116298, 1636428116662, 364, 1, 363, 0, 0, 0
108, 1, 1636428116926, 1636428117290, 364, 2, 362, 0, 0, 0
111, 1, 1636428117554, 1636428117922, 368, 0, 368, 0, 0, 0
114, 1, 1636428118186, 1636428118550, 364, 3, 361, 1, 0, 1
117, 1, 1636428118818, 1636428119182, 364, 1, 363, 1, 0, 1
120, 1, 1636428119446, 1636428119810, 364, 1, 363, 0, 0, 0
123, 1, 1636428120078, 1636428120442, 364, 0, 364, 0, 0, 0
126, 1, 1636428120706, 1636428121070, 364, 1, 363, 0, 0, 0
129, 1, 1636428121334, 1636428121698, 364, 1, 363, 0, 0, 0
132, 1, 1636428121962, 1636428122326, 364, 1, 363, 0, 1, 1
135, 1, 1636428122593, 1636428122958, 365, 1, 364, 0, 1, 1
138, 1, 1636428123226, 1636428123590, 364, 2, 362, 0, 0, 0
141, 1, 1636428123862, 1636428124222, 360, 3, 357, 0, 1, 1
144, 1, 1636428124485, 1636428124850, 365, 0, 365, 0, 0, 0
147, 1, 1636428125114, 1636428125482, 368, 0, 368, 0, 0, 0
150, 1, 1636428125746, 1636428126110, 364, 0, 364, 0, 0, 0
153, 1, 1636428126374, 1636428126734, 360, 1, 359, 1, 0, 1
156, 1, 1636428127002, 1636428127366, 364, 0, 364, 0, 0, 0
159, 1, 1636428127630, 1636428127994, 364, 1, 363, 0, 0, 0
162, 1, 1636428128258, 1636428128622, 364, 0, 364, 0, 0, 0
165, 1, 1636428128889, 1636428129253, 364, 2, 362, 1, 0, 1
168, 1, 1636428129522, 1636428129886, 364, 1, 363, 0, 0, 0
171, 1, 1636428130150, 1636428130514, 364, 0, 364, 0, 0, 0
174, 1, 1636428130777, 1636428131146, 369, 1, 368, 0, 0, 0
177, 1, 1636428131410, 1636428131774, 364, 1, 363, 0, 0, 0
180, 1, 1636428132038, 1636428132406, 368, 1, 367, 0, 0, 0
183, 1, 1636428132669, 1636428133034, 365, 1, 364, 0, 0, 0
186, 1, 1636428133298, 1636428133662, 364, 0, 364, 0, 0, 0
189, 1, 1636428133929, 1636428134294, 365, 1, 364, 0, 0, 0
192, 1, 1636428134562, 1636428134927, 365, 1, 364, 0, 0, 0
195, 1, 1636428135194, 1636428135562, 368, 5, 363, 3, 1, 4
198, 1, 1636428135826, 1636428136190, 364, 1, 363, 1, 0, 1
201, 1, 1636428136454, 1636428136814, 360, 0, 360, 0, 0, 0
204, 1, 1636428137078, 1636428137442, 364, 1, 363, 0, 0, 0
207, 1, 1636428137710, 1636428138074, 364, 1, 363, 0, 0, 0
210, 1, 1636428138342, 1636428138702, 360, 1, 359, 0, 0, 0
213, 1, 1636428138966, 1636428139330, 364, 0, 364, 0, 0, 0
216, 1, 1636428139594, 1636428139958, 364, 1, 363, 0, 0, 0
219, 1, 1636428140226, 1636428140594, 368, 0, 368, 0, 0, 0
222, 1, 1636428140858, 1636428141218, 360, 0, 360, 0, 0, 0
225, 1, 1636428141482, 1636428141846, 364, 1, 363, 0, 0, 0
228, 1, 1636428142110, 1636428142474, 364, 0, 364, 0, 0, 0
231, 1, 1636428142738, 1636428143102, 364, 0, 364, 0, 0, 0
234, 1, 1636428143370, 1636428143738, 368, 0, 368, 0, 0, 0
237, 1, 1636428144006, 1636428144370, 364, 2, 362, 1, 0, 1
240, 1, 1636428144633, 1636428144998, 365, 2, 363, 1, 0, 1
243, 1, 1636428145261, 1636428145626, 365, 1, 364, 0, 0, 0
246, 1, 1636428145890, 1636428146254, 364, 0, 364, 0, 0, 0
249, 1, 1636428146522, 1636428146890, 368, 0, 368, 0, 0, 0
252, 1, 1636428147154, 1636428147518, 364, 1, 363, 0, 0, 0
255, 1, 1636428147782, 1636428148138, 356, 1, 355, 1, 0, 1
258, 1, 1636428148406, 1636428148770, 364, 0, 364, 0, 0, 0
261, 1, 1636428149034, 1636428149398, 364, 0, 364, 0, 0, 0
264, 1, 1636428149666, 1636428150030, 364, 0, 364, 0, 0, 0
267, 1, 1636428150294, 1636428150658, 364, 1, 363, 0, 0, 0
270, 1, 1636428150925, 1636428151286, 361, 1, 360, 0, 0, 0
273, 1, 1636428151554, 1636428151918, 364, 0, 364, 0, 0, 0
276, 1, 1636428152182, 1636428152546, 364, 1, 363, 0, 0, 0
279, 1, 1636428152810, 1636428153174, 364, 2, 362, 0, 0, 0
282, 1, 1636428153442, 1636428153806, 364, 1, 363, 0, 0, 0
285, 1, 1636428154074, 1636428154438, 364, 1, 363, 0, 0, 0
288, 1, 1636428154702, 1636428155066, 364, 2, 362, 1, 0, 1
291, 1, 1636428155334, 1636428155698, 364, 2, 362, 0, 0, 0
294, 1, 1636428155966, 1636428156330, 364, 2, 362, 0, 0, 0
297, 1, 1636428156594, 1636428156958, 364, 0, 364, 0, 0, 0
300, 1, 1636428157226, 1636428157590, 364, 2, 362, 0, 0, 0
303, 1, 1636428157858, 1636428158222, 364, 2, 362, 0, 0, 0
306, 1, 1636428158486, 1636428158850, 364, 0, 364, 0, 0, 0
309, 1, 1636428159118, 1636428159482, 364, 1, 363, 0, 0, 0
312, 1, 1636428159746, 1636428160110, 364, 1, 363, 0, 0, 0
315, 1, 1636428160378, 1636428160742, 364, 0, 364, 0, 0, 0
318, 1, 1636428161010, 1636428161374, 364, 0, 364, 0, 0, 0
321, 1, 1636428161638, 1636428162002, 364, 0, 364, 0, 0, 0
324, 1, 1636428162270, 1636428162634, 364, 0, 364, 0, 0, 0
327, 1, 1636428162901, 1636428163266, 365, 1, 364, 0, 0, 0
330, 1, 1636428163530, 1636428163894, 364, 1, 363, 0, 0, 0
333, 1, 1636428164166, 1636428164526, 360, 1, 359, 0, 0, 0
336, 1, 1636428164793, 1636428165158, 365, 1, 364, 0, 0, 0
339, 1, 1636428165421, 1636428165786, 365, 2, 363, 0, 0, 0
342, 1, 1636428166050, 1636428166414, 364, 1, 363, 0, 0, 0
345, 1, 1636428166678, 1636428167042, 364, 2, 362, 0, 0, 0
348, 1, 1636428167310, 1636428167674, 364, 0, 364, 0, 0, 0
351, 1, 1636428167938, 1636428168306, 368, 0, 368, 0, 0, 0
354, 1, 1636428168574, 1636428168938, 364, 1, 363, 0, 0, 0
357, 1, 1636428169202, 1636428169566, 364, 0, 364, 0, 0, 0
360, 1, 1636428169830, 1636428170194, 364, 0, 364, 0, 0, 0
363, 1, 1636428170458, 1636428170822, 364, 0, 364, 0, 0, 0
366, 1, 1636428171090, 1636428171450, 360, 0, 360, 0, 0, 0
369, 1, 1636428171714, 1636428172078, 364, 0, 364, 0, 0, 0
372, 1, 1636428172342, 1636428172706, 364, 0, 364, 0, 0, 0
375, 1, 1636428172970, 1636428173330, 360, 0, 360, 0, 0, 0
378, 1, 1636428173594, 1636428173958, 364, 2, 362, 1, 0, 1
381, 1, 1636428174226, 1636428174590, 364, 3, 361, 1, 1, 2
384, 1, 1636428174853, 1636428175217, 364, 1, 363, 0, 0, 0
387, 1, 1636428175482, 1636428175846, 364, 0, 364, 0, 0, 0
390, 1, 1636428176117, 1636428176486, 369, 2, 367, 1, 0, 1
393, 1, 1636428176750, 1636428177110, 360, 1, 359, 0, 0, 0
396, 1, 1636428177378, 1636428177742, 364, 0, 364, 0, 0, 0
399, 1, 1636428178010, 1636428178370, 360, 0, 360, 0, 0, 0
402, 1, 1636428178637, 1636428178994, 357, 1, 356, 0, 0, 0
405, 1, 1636428179258, 1636428179622, 364, 0, 364, 0, 0, 0
408, 1, 1636428179890, 1636428180241, 351, 1, 350, 0, 0, 0
411, 1, 1636428180506, 1636428180865, 359, 2, 357, 1, 0, 1
414, 1, 1636428181130, 1636428181486, 356, 0, 356, 0, 0, 0
417, 1, 1636428181749, 1636428182114, 365, 2, 363, 0, 0, 0
420, 1, 1636428182377, 1636428182742, 365, 2, 363, 1, 0, 1
423, 1, 1636428183005, 1636428183370, 365, 3, 362, 1, 0, 1
426, 1, 1636428183634, 1636428183998, 364, 0, 364, 0, 0, 0
429, 1, 1636428184265, 1636428184630, 365, 1, 364, 0, 0, 0
432, 1, 1636428184893, 1636428185258, 365, 2, 363, 1, 0, 1
435, 1, 1636428185526, 1636428185890, 364, 1, 363, 0, 0, 0
438, 1, 1636428186158, 1636428186517, 359, 2, 357, 0, 0, 0
441, 1, 1636428186782, 1636428187145, 363, 0, 363, 0, 0, 0
444, 1, 1636428187413, 1636428187778, 365, 1, 364, 0, 0, 0
447, 1, 1636428188046, 1636428188414, 368, 0, 368, 0, 0, 0
450, 1, 1636428188678, 1636428189042, 364, 0, 364, 0, 0, 0
453, 1, 1636428189309, 1636428189674, 365, 2, 363, 1, 0, 1
456, 1, 1636428189938, 1636428190302, 364, 0, 364, 0, 0, 0
459, 1, 1636428190565, 1636428190929, 364, 1, 363, 0, 0, 0
462, 1, 1636428191194, 1636428191554, 360, 2, 358, 0, 0, 0
465, 1, 1636428191817, 1636428192181, 364, 1, 363, 0, 0, 0
468, 1, 1636428192449, 1636428192818, 369, 1, 368, 0, 0, 0
471, 1, 1636428193082, 1636428193446, 364, 0, 364, 0, 0, 0
474, 1, 1636428193710, 1636428194074, 364, 0, 364, 0, 0, 0
477, 1, 1636428194338, 1636428194702, 364, 0, 364, 0, 0, 0
480, 1, 1636428194965, 1636428195329, 364, 2, 362, 0, 0, 0
483, 1, 1636428195594, 1636428195958, 364, 0, 364, 0, 0, 0
486, 1, 1636428196222, 1636428196586, 364, 0, 364, 0, 0, 0
489, 1, 1636428196854, 1636428197218, 364, 0, 364, 0, 0, 0
492, 1, 1636428197482, 1636428197846, 364, 0, 364, 0, 0, 0
495, 1, 1636428198110, 1636428198478, 368, 1, 367, 0, 0, 0
498, 1, 1636428198746, 1636428199106, 360, 0, 360, 0, 0, 0
501, 1, 1636428199370, 1636428199730, 360, 1, 359, 0, 0, 0
504, 1, 1636428199994, 1636428200354, 360, 0, 360, 0, 0, 0
506, 1, 1636428200617, 1636428200978, 361, 1, 360, 0, 0, 0
509, 1, 1636428201242, 1636428201606, 364, 1, 363, 1, 0, 1
512, 1, 1636428201874, 1636428202238, 364, 1, 363, 0, 0, 0
515, 1, 1636428202502, 1636428202866, 364, 0, 364, 0, 0, 0
518, 1, 1636428203130, 1636428203494, 364, 0, 364, 0, 0, 0
521, 1, 1636428203758, 1636428204122, 364, 1, 363, 0, 0, 0
524, 1, 1636428204386, 1636428204750, 364, 0, 364, 0, 0, 0
527, 1, 1636428205013, 1636428205374, 361, 1, 360, 0, 1, 1
530, 1, 1636428205642, 1636428206006, 364, 1, 363, 0, 0, 0
533, 1, 1636428206270, 1636428206630, 360, 0, 360, 0, 0, 0
536, 1, 1636428206894, 1636428207258, 364, 1, 363, 0, 0, 0
539, 1, 1636428207526, 1636428207890, 364, 0, 364, 0, 0, 0
542, 1, 1636428208154, 1636428208518, 364, 0, 364, 0, 0, 0
545, 1, 1636428208782, 1636428209146, 364, 0, 364, 0, 0, 0
548, 1, 1636428209410, 1636428209774, 364, 0, 364, 0, 0, 0
551, 1, 1636428210038, 1636428210402, 364, 0, 364, 0, 0, 0
554, 1, 1636428210666, 1636428211030, 364, 0, 364, 0, 0, 0
557, 1, 1636428211294, 1636428211658, 364, 1, 363, 0, 0, 0
560, 1, 1636428211926, 1636428212290, 364, 1, 363, 0, 0, 0
562, 1, 1636428212558, 1636428212922, 364, 0, 364, 0, 0, 0
564, 1, 1636428213185, 1636428213546, 361, 2, 359, 0, 0, 0
566, 1, 1636428213809, 1636428214174, 365, 2, 363, 1, 1, 2
568, 1, 1636428214442, 1636428214806, 364, 2, 362, 0, 0, 0
570, 1, 1636428215070, 1636428215434, 364, 0, 364, 0, 0, 0
572, 1, 1636428215698, 1636428216062, 364, 0, 364, 0, 0, 0
574, 1, 1636428216326, 1636428216690, 364, 1, 363, 0, 0, 0
576, 1, 1636428216958, 1636428217322, 364, 0, 364, 0, 0, 0
578, 1, 1636428217585, 1636428217950, 365, 2, 363, 0, 0, 0
580, 1, 1636428218214, 1636428218582, 368, 0, 368, 0, 0, 0
582, 1, 1636428218845, 1636428219210, 365, 2, 363, 1, 0, 1
584, 1, 1636428219474, 1636428219837, 363, 0, 363, 0, 0, 0
586, 1, 1636428220102, 1636428220466, 364, 0, 364, 0, 0, 0
601, 1, 1636428331426, 1636428331818, 392, 12, 380, 0, 0, 0
602, 1, 1636428332490, 1636428332850, 360, 0, 360, 0, 0, 0
603, 1, 1636428333045, 1636428333406, 361, 1, 360, 0, 0, 0
604, 1, 1636428333286, 1636428333642, 356, 0, 356, 0, 0, 0
605, 1, 1636428334062, 1636428334418, 356, 0, 356, 0, 0, 0
606, 1, 1636428334486, 1636428334846, 360, 2, 358, 2, 0, 2
607, 1, 1636428334770, 1636428335130, 360, 1, 359, 1, 0, 1
608, 1, 1636428335042, 1636428335402, 360, 0, 360, 0, 0, 0
609, 1, 1636428335186, 1636428335542, 356, 1, 355, 1, 0, 1
610, 1, 1636428335545, 1636428335902, 357, 1, 356, 0, 0, 0
611, 1, 1636428335966, 1636428336326, 360, 0, 360, 0, 0, 0
612, 1, 1636428336370, 1636428336726, 356, 0, 356, 0, 0, 0
613, 1, 1636428336650, 1636428337010, 360, 0, 360, 0, 0, 0
614, 1, 1636428336670, 1636428337026, 356, 0, 356, 0, 0, 0
615, 1, 1636428336922, 1636428337282, 360, 0, 360, 0, 0, 0
616, 1, 1636428337090, 1636428337442, 352, 1, 351, 0, 0, 0
617, 1, 1636428337249, 1636428337522, 273, 1, 272, 0, 0, 0
618, 1, 1636428337366, 1636428337637, 271, 0, 271, 0, 0, 0
619, 1, 1636428337774, 1636428338046, 272, 0, 272, 0, 0, 0
620, 1, 1636428337806, 1636428338078, 272, 0, 272, 0, 0, 0
621, 1, 1636428338338, 1636428338605, 267, 0, 267, 0, 0, 0
622, 1, 1636428338426, 1636428338698, 272, 0, 272, 0, 0, 0
623, 1, 1636428338470, 1636428338742, 272, 0, 272, 0, 0, 0
624, 1, 1636428338506, 1636428338774, 268, 0, 268, 0, 0, 0
625, 1, 1636428338898, 1636428339174, 276, 1, 275, 0, 0, 0
626, 1, 1636428338949, 1636428339217, 268, 1, 267, 0, 0, 0
627, 1, 1636428339281, 1636428339558, 277, 1, 276, 0, 0, 0
628, 1, 1636428339362, 1636428339634, 272, 0, 272, 0, 0, 0
629, 1, 1636428339569, 1636428339838, 269, 1, 268, 0, 0, 0
630, 1, 1636428339837, 1636428340110, 273, 1, 272, 0, 0, 0
631, 1, 1636428339917, 1636428340190, 273, 1, 272, 0, 1, 1
632, 1, 1636428340270, 1636428340542, 272, 0, 272, 0, 0, 0
633, 1, 1636428340350, 1636428340622, 272, 0, 272, 0, 0, 0
634, 1, 1636428340457, 1636428340726, 269, 1, 268, 0, 0, 0
635, 1, 1636428340601, 1636428340874, 273, 1, 272, 0, 1, 1
636, 1, 1636428340813, 1636428341086, 273, 1, 272, 0, 1, 1
637, 1, 1636428340930, 1636428341198, 268, 0, 268, 0, 0, 0
638, 1, 1636428341005, 1636428341278, 273, 1, 272, 0, 0, 0
639, 1, 1636428341249, 1636428341517, 268, 1, 267, 0, 0, 0
641, 1, 1636428341301, 1636428341577, 276, 1, 275, 1, 0, 1
640, 1, 1636428341322, 1636428341589, 267, 0, 267, 0, 0, 0
642, 1, 1636428341553, 1636428341826, 273, 1, 272, 0, 1, 1
643, 1, 1636428341790, 1636428342062, 272, 0, 272, 0, 0, 0
644, 1, 1636428341882, 1636428342150, 268, 0, 268, 0, 0, 0
645, 1, 1636428341958, 1636428342226, 268, 0, 268, 0, 0, 0
646, 1, 1636428342186, 1636428342458, 272, 0, 272, 0, 0, 0
647, 1, 1636428342326, 1636428342598, 272, 0, 272, 0, 0, 0
648, 1, 1636428342446, 1636428342718, 272, 0, 272, 0, 0, 0
649, 1, 1636428342653, 1636428342922, 269, 1, 268, 0, 0, 0
650, 1, 1636428342722, 1636428342994, 272, 0, 272, 0, 0, 0
652, 1, 1636428342922, 1636428343190, 268, 1, 267, 0, 1, 1
651, 1, 1636428342922, 1636428343190, 268, 1, 267, 0, 0, 0
653, 1, 1636428343022, 1636428343294, 272, 0, 272, 0, 0, 0
654, 1, 1636428343117, 1636428343389, 272, 1, 271, 0, 0, 0
655, 1, 1636428343253, 1636428343522, 269, 1, 268, 0, 0, 0
656, 1, 1636428343342, 1636428343614, 272, 0, 272, 0, 0, 0
657, 1, 1636428343565, 1636428343842, 277, 1, 276, 0, 0, 0
658, 1, 1636428343585, 1636428343858, 273, 1, 272, 0, 0, 0
659, 1, 1636428343701, 1636428343974, 273, 1, 272, 0, 1, 1
660, 1, 1636428343713, 1636428343982, 269, 1, 268, 0, 0, 0
661, 1, 1636428343841, 1636428344110, 269, 2, 267, 0, 0, 0
662, 1, 1636428344217, 1636428344490, 273, 1, 272, 0, 1, 1
663, 1, 1636428344382, 1636428344654, 272, 0, 272, 0, 0, 0
665, 1, 1636428344569, 1636428344838, 269, 1, 268, 0, 0, 0
666, 1, 1636428344593, 1636428344866, 273, 1, 272, 0, 1, 1
667, 1, 1636428344638, 1636428344910, 272, 0, 272, 0, 0, 0
664, 1, 1636428344657, 1636428344925, 268, 1, 267, 1, 0, 1
668, 1, 1636428344753, 1636428345025, 272, 1, 271, 0, 0, 0
669, 1, 1636428344957, 1636428345233, 276, 0, 276, 0, 0, 0
671, 1, 1636428345029, 1636428345297, 268, 1, 267, 0, 1, 1
672, 1, 1636428345129, 1636428345398, 269, 1, 268, 0, 1, 1
673, 1, 1636428345218, 1636428345498, 280, 0, 280, 0, 0, 0
670, 1, 1636428345281, 1636428345554, 273, 0, 273, 0, 0, 0
674, 1, 1636428345325, 1636428345594, 269, 1, 268, 0, 0, 0
675, 1, 1636428345425, 1636428345698, 273, 1, 272, 0, 0, 0
676, 1, 1636428345654, 1636428345917, 263, 0, 263, 0, 0, 0
678, 1, 1636428345698, 1636428345966, 268, 1, 267, 0, 1, 1
677, 1, 1636428345698, 1636428345973, 275, 1, 274, 0, 1, 1
679, 1, 1636428345738, 1636428346010, 272, 0, 272, 0, 0, 0
680, 1, 1636428345958, 1636428346230, 272, 0, 272, 0, 0, 0
682, 1, 1636428346241, 1636428346514, 273, 1, 272, 0, 0, 0
681, 1, 1636428346277, 1636428346546, 269, 0, 269, 0, 0, 0
683, 1, 1636428346329, 1636428346610, 281, 1, 280, 0, 0, 0
684, 1, 1636428346414, 1636428346681, 267, 0, 267, 0, 0, 0
685, 1, 1636428346433, 1636428346710, 277, 1, 276, 0, 0, 0
686, 1, 1636428346605, 1636428346874, 269, 1, 268, 0, 0, 0
687, 1, 1636428346669, 1636428346942, 273, 1, 272, 0, 0, 0
688, 1, 1636428346678, 1636428346945, 267, 0, 267, 0, 0, 0
689, 1, 1636428346881, 1636428347158, 277, 1, 276, 0, 0, 0
690, 1, 1636428347025, 1636428347289, 264, 1, 263, 0, 0, 0
691, 1, 1636428347049, 1636428347322, 273, 1, 272, 0, 0, 0
692, 1, 1636428347117, 1636428347377, 260, 0, 260, 0, 0, 0
693, 1, 1636428347333, 1636428347606, 273, 1, 272, 0, 0, 0
694, 1, 1636428347350, 1636428347617, 267, 0, 267, 0, 0, 0
695, 1, 1636428347373, 1636428347641, 268, 1, 267, 0, 0, 0
696, 1, 1636428347465, 1636428347746, 281, 1, 280, 0, 0, 0
697, 1, 1636428347633, 1636428347905, 272, 1, 271, 0, 0, 0
698, 1, 1636428347726, 1636428347998, 272, 0, 272, 0, 0, 0
699, 1, 1636428347854, 1636428348130, 276, 0, 276, 0, 0, 0
700, 1, 1636428348021, 1636428348294, 273, 1, 272, 0, 1, 1
701, 1, 1636428348021, 1636428348294, 273, 1, 272, 1, 0, 1
702, 1, 1636428348161, 1636428348434, 273, 1, 272, 0, 0, 0
703, 1, 1636428348209, 1636428348478, 269, 1, 268, 0, 0, 0
704, 1, 1636428348434, 1636428348702, 268, 0, 268, 0, 0, 0
705, 1, 1636428348449, 1636428348721, 272, 1, 271, 0, 0, 0
706, 1, 1636428348701, 1636428348974, 273, 2, 271, 0, 0, 0
707, 1, 1636428348701, 1636428348974, 273, 1, 272, 0, 0, 0
708, 1, 1636428348782, 1636428349049, 267, 0, 267, 0, 0, 0
709, 1, 1636428348801, 1636428349074, 273, 1, 272, 0, 0, 0
710, 1, 1636428349041, 1636428349306, 265, 1, 264, 0, 1, 1
711, 1, 1636428349085, 1636428349358, 273, 1, 272, 0, 0, 0
712, 1, 1636428349161, 1636428349430, 269, 1, 268, 0, 0, 0
713, 1, 1636428349361, 1636428349634, 273, 1, 272, 0, 0, 0
714, 1, 1636428349373, 1636428349642, 269, 1, 268, 0, 0, 0
715, 1, 1636428349433, 1636428349705, 272, 1, 271, 0, 1, 1
716, 1, 1636428349478, 1636428349745, 267, 0, 267, 0, 0, 0
717, 1, 1636428349661, 1636428349933, 272, 1, 271, 0, 1, 1
718, 1, 1636428349733, 1636428350002, 269, 1, 268, 0, 0, 0
719, 1, 1636428349846, 1636428350117, 271, 0, 271, 0, 0, 0
720, 1, 1636428349913, 1636428350186, 273, 1, 272, 0, 0, 0
721, 1, 1636428350077, 1636428350346, 269, 1, 268, 0, 0, 0
722, 1, 1636428350194, 1636428350466, 272, 0, 272, 0, 0, 0
723, 1, 1636428350241, 1636428350510, 269, 1, 268, 0, 1, 1
724, 1, 1636428350490, 1636428350757, 267, 0, 267, 0, 0, 0
725, 1, 1636428350525, 1636428350794, 269, 1, 268, 0, 0, 0
727, 1, 1636428350722, 1636428350994, 272, 0, 272, 0, 0, 0
726, 1, 1636428350726, 1636428351006, 280, 0, 280, 0, 0, 0
728, 1, 1636428350821, 1636428351089, 268, 1, 267, 0, 0, 0
729, 1, 1636428350833, 1636428351098, 265, 1, 264, 0, 0, 0
730, 1, 1636428351074, 1636428351345, 271, 0, 271, 0, 0, 0
731, 1, 1636428351141, 1636428351409, 268, 1, 267, 1, 0, 1
732, 1, 1636428351185, 1636428351454, 269, 1, 268, 0, 1, 1
733, 1, 1636428351385, 1636428351658, 273, 1, 272, 0, 0, 0
734, 1, 1636428351401, 1636428351670, 269, 1, 268, 0, 1, 1
735, 1, 1636428351445, 1636428351713, 268, 1, 267, 0, 1, 1
736, 1, 1636428351490, 1636428351758, 268, 0, 268, 0, 0, 0
737, 1, 1636428351717, 1636428351986, 269, 0, 269, 0, 0, 0
738, 1, 1636428351741, 1636428352010, 269, 1, 268, 1, 0, 1
739, 1, 1636428351758, 1636428352026, 268, 1, 267, 0, 0, 0
740, 1, 1636428351942, 1636428352218, 276, 0, 276, 0, 0, 0
741, 1, 1636428352177, 1636428352449, 272, 1, 271, 1, 0, 1
742, 1, 1636428352313, 1636428352589, 276, 1, 275, 0, 0, 0
743, 1, 1636428352333, 1636428352601, 268, 1, 267, 0, 1, 1
744, 1, 1636428352445, 1636428352722, 277, 1, 276, 0, 0, 0
745, 1, 1636428352582, 1636428352854, 272, 0, 272, 0, 0, 0
746, 1, 1636428352701, 1636428352977, 276, 1, 275, 0, 0, 0
747, 1, 1636428352774, 1636428353046, 272, 0, 272, 0, 0, 0
748, 1, 1636428352793, 1636428353062, 269, 1, 268, 0, 0, 0
749, 1, 1636428352857, 1636428353125, 268, 1, 267, 0, 0, 0
750, 1, 1636428353077, 1636428353345, 268, 1, 267, 1, 0, 1
751, 1, 1636428353102, 1636428353370, 268, 0, 268, 0, 0, 0
752, 1, 1636428353198, 1636428353470, 272, 0, 272, 0, 0, 0
753, 1, 1636428353338, 1636428353605, 267, 0, 267, 0, 0, 0
754, 1, 1636428353338, 1636428353609, 271, 0, 271, 0, 0, 0
755, 1, 1636428353417, 1636428353689, 272, 1, 271, 0, 1, 1
756, 1, 1636428353549, 1636428353818, 269, 1, 268, 1, 0, 1
757, 1, 1636428353757, 1636428354029, 272, 1, 271, 1, 0, 1
758, 1, 1636428353777, 1636428354046, 269, 1, 268, 0, 1, 1
759, 1, 1636428353834, 1636428354102, 268, 0, 268, 0, 0, 0
760, 1, 1636428354049, 1636428354322, 273, 1, 272, 0, 0, 0
761, 1, 1636428354141, 1636428354409, 268, 1, 267, 0, 0, 0
762, 1, 1636428354233, 1636428354502, 269, 1, 268, 1, 0, 1
763, 1, 1636428354334, 1636428354606, 272, 0, 272, 0, 0, 0
764, 1, 1636428354434, 1636428354705, 271, 0, 271, 0, 0, 0
765, 1, 1636428354637, 1636428354914, 277, 1, 276, 0, 0, 0
766, 1, 1636428354749, 1636428355026, 277, 1, 276, 0, 0, 0
767, 1, 1636428354789, 1636428355061, 272, 1, 271, 0, 0, 0
768, 1, 1636428354817, 1636428355090, 273, 1, 272, 0, 1, 1
769, 1, 1636428354849, 1636428355122, 273, 1, 272, 0, 0, 0
770, 1, 1636428354989, 1636428355257, 268, 1, 267, 0, 0, 0
771, 1, 1636428355145, 1636428355417, 272, 1, 271, 0, 0, 0
772, 1, 1636428355257, 1636428355530, 273, 1, 272, 0, 0, 0
773, 1, 1636428355301, 1636428355570, 269, 1, 268, 0, 0, 0
774, 1, 1636428355349, 1636428355617, 268, 1, 267, 1, 0, 1
775, 1, 1636428355369, 1636428355642, 273, 1, 272, 0, 0, 0
776, 1, 1636428355533, 1636428355802, 269, 1, 268, 0, 0, 0
777, 1, 1636428355829, 1636428356102, 273, 1, 272, 0, 0, 0
778, 1, 1636428355853, 1636428356126, 273, 1, 272, 0, 0, 0
779, 1, 1636428355881, 1636428356154, 273, 1, 272, 0, 1, 1
780, 1, 1636428355990, 1636428356261, 271, 0, 271, 0, 0, 0
781, 1, 1636428356025, 1636428356297, 272, 1, 271, 0, 0, 0
782, 1, 1636428356245, 1636428356514, 269, 1, 268, 0, 0, 0
783, 1, 1636428356257, 1636428356530, 273, 0, 273, 0, 0, 0
784, 1, 1636428356538, 1636428356810, 272, 0, 272, 0, 0, 0
785, 1, 1636428356594, 1636428356862, 268, 0, 268, 0, 0, 0
786, 1, 1636428356629, 1636428356902, 273, 1, 272, 0, 0, 0
787, 1, 1636428356829, 1636428357102, 273, 1, 272, 0, 0, 0
788, 1, 1636428356890, 1636428357158, 268, 0, 268, 0, 0, 0
790, 1, 1636428356909, 1636428357178, 269, 1, 268, 0, 0, 0
789, 1, 1636428356909, 1636428357178, 269, 1, 268, 0, 0, 0
791, 1, 1636428357198, 1636428357469, 271, 0, 271, 0, 0, 0
792, 1, 1636428357265, 1636428357530, 265, 1, 264, 0, 0, 0
793, 1, 1636428357289, 1636428357558, 269, 1, 268, 0, 0, 0
795, 1, 1636428357381, 1636428357654, 273, 1, 272, 0, 0, 0
794, 1, 1636428357381, 1636428357654, 273, 1, 272, 0, 0, 0
796, 1, 1636428357462, 1636428357733, 271, 0, 271, 0, 0, 0
797, 1, 1636428357849, 1636428358121, 272, 1, 271, 0, 0, 0
798, 1, 1636428357882, 1636428358153, 271, 0, 271, 0, 0, 0
799, 1, 1636428357917, 1636428358189, 272, 1, 271, 0, 1, 1
801, 1, 1636428358006, 1636428358277, 271, 0, 271, 0, 0, 0
800, 1, 1636428358125, 1636428358410, 285, 1, 284, 1, 0, 1
802, 1, 1636428358277, 1636428358546, 269, 1, 268, 1, 0, 1
803, 1, 1636428358314, 1636428358590, 276, 0, 276, 0, 0, 0
804, 1, 1636428358486, 1636428358758, 272, 0, 272, 0, 0, 0
805, 1, 1636428358494, 1636428358765, 271, 0, 271, 0, 0, 0
806, 1, 1636428358769, 1636428359041, 272, 1, 271, 0, 0, 0
807, 1, 1636428358901, 1636428359169, 268, 0, 268, 0, 0, 0
808, 1, 1636428358909, 1636428359181, 272, 0, 272, 0, 0, 0
809, 1, 1636428358937, 1636428359210, 273, 1, 272, 0, 0, 0
810, 1, 1636428359009, 1636428359278, 269, 1, 268, 0, 0, 0
811, 1, 1636428359153, 1636428359426, 273, 1, 272, 0, 0, 0
812, 1, 1636428359173, 1636428359449, 276, 1, 275, 0, 1, 1
813, 1, 1636428359297, 1636428359565, 268, 1, 267, 1, 0, 1
814, 1, 1636428359309, 1636428359586, 277, 1, 276, 0, 0, 0
815, 1, 1636428359481, 1636428359753, 272, 1, 271, 0, 0, 0
816, 1, 1636428359490, 1636428359761, 271, 0, 271, 0, 0, 0
817, 1, 1636428359725, 1636428359993, 268, 0, 268, 0, 0, 0
818, 1, 1636428359789, 1636428360057, 268, 1, 267, 0, 0, 0
819, 1, 1636428359982, 1636428360246, 264, 0, 264, 0, 0, 0
820, 1, 1636428360009, 1636428360282, 273, 1, 272, 0, 1, 1
821, 1, 1636428360082, 1636428360354, 272, 0, 272, 0, 0, 0
822, 1, 1636428360266, 1636428360533, 267, 0, 267, 0, 0, 0
823, 1, 1636428360373, 1636428360641, 268, 1, 267, 0, 0, 0
824, 1, 1636428360381, 1636428360653, 272, 1, 271, 1, 0, 1
825, 1, 1636428360409, 1636428360677, 268, 1, 267, 0, 0, 0
826, 1, 1636428360553, 1636428360822, 269, 1, 268, 0, 0, 0
827, 1, 1636428360825, 1636428361101, 276, 1, 275, 0, 1, 1
828, 1, 1636428360957, 1636428361230, 273, 1, 272, 0, 0, 0
830, 1, 1636428360965, 1636428361230, 265, 1, 264, 1, 0, 1
829, 1, 1636428360965, 1636428361233, 268, 1, 267, 0, 1, 1
831, 1, 1636428361237, 1636428361509, 272, 1, 271, 0, 0, 0
833, 1, 1636428361277, 1636428361546, 269, 1, 268, 0, 0, 0
834, 1, 1636428361337, 1636428361606, 269, 1, 268, 0, 0, 0
835, 1, 1636428361501, 1636428361769, 268, 1, 267, 1, 0, 1
832, 1, 1636428361517, 1636428361790, 273, 1, 272, 0, 0, 0
836, 1, 1636428361537, 1636428361805, 268, 1, 267, 0, 0, 0
838, 1, 1636428361673, 1636428361941, 268, 1, 267, 0, 0, 0
839, 1, 1636428361894, 1636428362166, 272, 0, 272, 0, 0, 0
841, 1, 1636428362194, 1636428362465, 271, 0, 271, 0, 0, 0
842, 1, 1636428362293, 1636428362569, 276, 1, 275, 1, 0, 1
844, 1, 1636428362425, 1636428362702, 277, 1, 276, 0, 0, 0
845, 1, 1636428362441, 1636428362713, 272, 1, 271, 0, 0, 0
846, 1, 1636428362538, 1636428362810, 272, 0, 272, 0, 0, 0
847, 1, 1636428362862, 1636428363130, 268, 0, 268, 0, 0, 0
849, 1, 1636428362933, 1636428363206, 273, 1, 272, 0, 0, 0
850, 1, 1636428363014, 1636428363289, 275, 0, 275, 0, 0, 0
851, 1, 1636428363101, 1636428363370, 269, 1, 268, 0, 1, 1
852, 1, 1636428363209, 1636428363477, 268, 1, 267, 0, 0, 0
853, 1, 1636428363226, 1636428363501, 275, 1, 274, 0, 0, 0
854, 1, 1636428363226, 1636428363505, 279, 0, 279, 0, 0, 0
857, 1, 1636428363594, 1636428363870, 276, 0, 276, 0, 0, 0
858, 1, 1636428363921, 1636428364190, 269, 1, 268, 0, 0, 0
859, 1, 1636428364186, 1636428364453, 267, 0, 267, 0, 0, 0
860, 1, 1636428364246, 1636428364513, 267, 0, 267, 0, 0, 0
861, 1, 1636428364381, 1636428364650, 269, 1, 268, 0, 1, 1
863, 1, 1636428364558, 1636428364825, 267, 1, 266, 0, 0, 0
865, 1, 1636428364869, 1636428365141, 272, 1, 271, 0, 1, 1
867, 1, 1636428365082, 1636428365350, 268, 0, 268, 0, 0, 0
869, 1, 1636428365186, 1636428365458, 272, 0, 272, 0, 0, 0
870, 1, 1636428365329, 1636428365598, 269, 1, 268, 0, 0, 0
872, 1, 1636428365854, 1636428366126, 272, 0, 272, 0, 0, 0
873, 1, 1636428366162, 1636428366430, 268, 0, 268, 0, 0, 0
875, 1, 1636428366478, 1636428366750, 272, 0, 272, 0, 0, 0
876, 1, 1636428366485, 1636428366765, 280, 1, 279, 1, 0, 1
877, 1, 1636428366742, 1636428367014, 272, 0, 272, 0, 0, 0
878, 1, 1636428367174, 1636428367446, 272, 0, 272, 0, 0, 0
879, 1, 1636428367254, 1636428367522, 268, 0, 268, 0, 0, 0
880, 1, 1636428367258, 1636428367530, 272, 0, 272, 0, 0, 0
881, 1, 1636428367721, 1636428367994, 273, 1, 272, 0, 0, 0
882, 1, 1636428368230, 1636428368498, 268, 0, 268, 0, 0, 0
883, 1, 1636428368382, 1636428368653, 271, 0, 271, 0, 0, 0
884, 1, 1636428368410, 1636428368682, 272, 0, 272, 0, 0, 0
885, 1, 1636428368817, 1636428369090, 273, 1, 272, 0, 0, 0
886, 1, 1636428369109, 1636428369378, 269, 1, 268, 0, 0, 0
887, 1, 1636428369130, 1636428369401, 271, 0, 271, 0, 0, 0
888, 1, 1636428369317, 1636428369590, 273, 1, 272, 0, 0, 0
889, 1, 1636428369797, 1636428370070, 273, 0, 273, 0, 0, 0
890, 1, 1636428370282, 1636428370549, 267, 0, 267, 0, 0, 0
891, 1, 1636428370294, 1636428370566, 272, 0, 272, 0, 0, 0
892, 1, 1636428370454, 1636428370726, 272, 0, 272, 0, 0, 0
893, 1, 1636428370846, 1636428371113, 267, 0, 267, 0, 0, 0
894, 1, 1636428371082, 1636428371349, 267, 0, 267, 0, 0, 0
895, 1, 1636428371206, 1636428371478, 272, 0, 272, 0, 0, 0
896, 1, 1636428371257, 1636428371525, 268, 1, 267, 0, 0, 0
837, 2, 1636428361790, 1636428371847, 10057, 0, 10057, 0, 0, 0
897, 1, 1636428371938, 1636428372210, 272, 1, 271, 0, 0, 0
898, 1, 1636428372270, 1636428372538, 268, 0, 268, 0, 0, 0
899, 1, 1636428372361, 1636428372626, 265, 1, 264, 0, 0, 0
900, 1, 1636428372361, 1636428372629, 268, 1, 267, 0, 0, 0
901, 1, 1636428372510, 1636428372774, 264, 0, 264, 0, 0, 0
902, 1, 1636428372758, 1636428373062, 304, 0, 304, 0, 0, 0
903, 1, 1636428373174, 1636428373442, 268, 0, 268, 0, 0, 0
904, 1, 1636428373206, 1636428373478, 272, 0, 272, 0, 0, 0
905, 1, 1636428373229, 1636428373501, 272, 1, 271, 0, 0, 0
906, 1, 1636428373830, 1636428374106, 276, 0, 276, 0, 0, 0
907, 1, 1636428374209, 1636428374522, 313, 0, 313, 0, 0, 0
910, 1, 1636428374437, 1636428374710, 273, 1, 272, 0, 0, 0
909, 1, 1636428374437, 1636428374710, 273, 2, 271, 1, 1, 2
908, 1, 1636428374437, 1636428374710, 273, 1, 272, 0, 0, 0
911, 1, 1636428374741, 1636428375017, 276, 0, 276, 0, 0, 0
912, 1, 1636428375150, 1636428375417, 267, 0, 267, 0, 0, 0
913, 1, 1636428375157, 1636428375429, 272, 1, 271, 1, 0, 1
914, 1, 1636428375238, 1636428375509, 271, 0, 271, 0, 0, 0
915, 1, 1636428375793, 1636428376066, 273, 0, 273, 0, 0, 0
916, 1, 1636428376121, 1636428376394, 273, 1, 272, 0, 0, 0
917, 1, 1636428376277, 1636428376550, 273, 1, 272, 0, 0, 0
918, 1, 1636428376398, 1636428376669, 271, 0, 271, 0, 0, 0
919, 1, 1636428376554, 1636428376826, 272, 0, 272, 0, 0, 0
920, 1, 1636428376629, 1636428376898, 269, 1, 268, 1, 0, 1
921, 1, 1636428376717, 1636428376985, 268, 1, 267, 0, 1, 1
922, 1, 1636428377049, 1636428377321, 272, 1, 271, 1, 0, 1
923, 1, 1636428377069, 1636428377342, 273, 1, 272, 0, 0, 0
924, 1, 1636428377162, 1636428377429, 267, 0, 267, 0, 0, 0
925, 1, 1636428377770, 1636428378046, 276, 0, 276, 0, 0, 0
926, 1, 1636428378017, 1636428378286, 269, 1, 268, 0, 1, 1
927, 1, 1636428378198, 1636428378470, 272, 0, 272, 0, 0, 0
928, 1, 1636428378278, 1636428378545, 267, 0, 267, 0, 0, 0
929, 1, 1636428378341, 1636428378609, 268, 1, 267, 0, 0, 0
931, 1, 1636428378653, 1636428378922, 269, 1, 268, 0, 1, 1
930, 1, 1636428378653, 1636428378922, 269, 1, 268, 0, 1, 1
932, 1, 1636428379041, 1636428379310, 269, 1, 268, 1, 0, 1
933, 1, 1636428379101, 1636428379370, 269, 1, 268, 0, 0, 0
934, 1, 1636428379149, 1636428379421, 272, 1, 271, 0, 1, 1
935, 1, 1636428379642, 1636428379914, 272, 0, 272, 0, 0, 0
936, 1, 1636428380078, 1636428380346, 268, 0, 268, 0, 0, 0
937, 1, 1636428380209, 1636428380481, 272, 1, 271, 0, 0, 0
938, 1, 1636428380233, 1636428380501, 268, 1, 267, 0, 1, 1
939, 1, 1636428380322, 1636428380589, 267, 0, 267, 0, 0, 0
940, 1, 1636428380706, 1636428380974, 268, 0, 268, 0, 0, 0
941, 1, 1636428380757, 1636428381025, 268, 1, 267, 1, 0, 1
942, 1, 1636428380933, 1636428381202, 269, 1, 268, 0, 1, 1
943, 1, 1636428381125, 1636428381397, 272, 1, 271, 0, 0, 0
944, 1, 1636428381165, 1636428381434, 269, 1, 268, 0, 1, 1
945, 1, 1636428381698, 1636428381966, 268, 0, 268, 0, 0, 0
946, 1, 1636428382110, 1636428382381, 271, 0, 271, 0, 0, 0
947, 1, 1636428382245, 1636428382514, 269, 1, 268, 0, 0, 0
949, 1, 1636428382265, 1636428382541, 276, 1, 275, 0, 1, 1
959, 1, 1636428382302, 1636428382574, 272, 1, 271, 0, 0, 0
953, 1, 1636428382302, 1636428382574, 272, 1, 271, 0, 0, 0
948, 1, 1636428382302, 1636428382574, 272, 0, 272, 0, 0, 0
960, 1, 1636428382762, 1636428383030, 268, 0, 268, 0, 0, 0
961, 1, 1636428382769, 1636428383037, 268, 0, 268, 0, 0, 0
962, 1, 1636428382986, 1636428383254, 268, 0, 268, 0, 0, 0
963, 1, 1636428383014, 1636428383285, 271, 0, 271, 0, 0, 0
964, 1, 1636428383041, 1636428383318, 277, 1, 276, 0, 1, 1
965, 1, 1636428383738, 1636428384009, 271, 0, 271, 0, 0, 0
966, 1, 1636428384038, 1636428384305, 267, 0, 267, 0, 0, 0
967, 1, 1636428384301, 1636428384570, 269, 1, 268, 1, 0, 1
968, 1, 1636428384325, 1636428384593, 268, 1, 267, 0, 0, 0
969, 1, 1636428384349, 1636428384617, 268, 1, 267, 0, 0, 0
970, 1, 1636428384373, 1636428384633, 260, 1, 259, 1, 0, 1
971, 1, 1636428384401, 1636428384666, 265, 1, 264, 0, 1, 1
972, 1, 1636428384698, 1636428384969, 271, 0, 271, 0, 0, 0
973, 1, 1636428384766, 1636428385029, 263, 0, 263, 0, 0, 0
975, 1, 1636428385049, 1636428385318, 269, 1, 268, 0, 0, 0
976, 1, 1636428385069, 1636428385338, 269, 0, 269, 0, 0, 0
977, 1, 1636428385666, 1636428385938, 272, 0, 272, 0, 0, 0
979, 1, 1636428386186, 1636428386454, 268, 0, 268, 0, 0, 0
980, 1, 1636428386337, 1636428386610, 273, 1, 272, 0, 1, 1
981, 1, 1636428386366, 1636428386633, 267, 0, 267, 0, 0, 0
982, 1, 1636428386613, 1636428386885, 272, 1, 271, 0, 1, 1
985, 1, 1636428386690, 1636428386958, 268, 0, 268, 0, 0, 0
986, 1, 1636428386974, 1636428387246, 272, 0, 272, 0, 0, 0
987, 1, 1636428387133, 1636428387406, 273, 1, 272, 0, 0, 0
990, 1, 1636428388266, 1636428388538, 272, 0, 272, 0, 0, 0
991, 1, 1636428388341, 1636428388613, 272, 1, 271, 0, 1, 1
992, 1, 1636428388385, 1636428388654, 269, 1, 268, 0, 0, 0
993, 1, 1636428388774, 1636428389050, 276, 0, 276, 0, 0, 0
995, 1, 1636428389058, 1636428389330, 272, 0, 272, 0, 0, 0
996, 1, 1636428390317, 1636428390585, 268, 1, 267, 1, 0, 1
997, 1, 1636428390354, 1636428390621, 267, 0, 267, 0, 0, 0
999, 1, 1636428390830, 1636428391098, 268, 0, 268, 0, 0, 0
1001, 1, 1636428392593, 1636428392861, 268, 1, 267, 0, 0, 0
983, 1, 1636428392633, 1636428392901, 268, 1, 267, 0, 1, 1
1002, 1, 1636428392725, 1636428392993, 268, 1, 267, 0, 0, 0
1011, 1, 1636428392930, 1636428393202, 272, 0, 272, 0, 0, 0
1003, 1, 1636428392937, 1636428393205, 268, 1, 267, 0, 0, 0
1006, 1, 1636428392945, 1636428393214, 269, 0, 269, 0, 0, 0
1004, 1, 1636428393214, 1636428393482, 268, 0, 268, 0, 0, 0
1013, 1, 1636428394282, 1636428394550, 268, 0, 268, 0, 0, 0
1014, 1, 1636428394462, 1636428394733, 271, 0, 271, 0, 0, 0
1015, 1, 1636428394785, 1636428395066, 281, 1, 280, 0, 0, 0
1017, 1, 1636428394917, 1636428395185, 268, 1, 267, 0, 0, 0
1018, 1, 1636428394929, 1636428395202, 273, 1, 272, 0, 0, 0
1016, 1, 1636428395069, 1636428395341, 272, 1, 271, 0, 0, 0
1019, 1, 1636428395429, 1636428395702, 273, 1, 272, 0, 0, 0
1020, 1, 1636428396202, 1636428396470, 268, 0, 268, 0, 0, 0
1021, 1, 1636428396426, 1636428396717, 291, 0, 291, 0, 0, 0
1022, 1, 1636428396453, 1636428396725, 272, 1, 271, 0, 0, 0
1023, 1, 1636428396717, 1636428396985, 268, 1, 267, 1, 0, 1
1025, 1, 1636428396893, 1636428397166, 273, 1, 272, 1, 0, 1
1024, 1, 1636428396989, 1636428397262, 273, 1, 272, 0, 1, 1
1027, 1, 1636428397082, 1636428397350, 268, 0, 268, 0, 0, 0
1028, 1, 1636428397373, 1636428397678, 305, 1, 304, 0, 1, 1
1029, 1, 1636428398042, 1636428398310, 268, 0, 268, 0, 0, 0
1030, 1, 1636428398206, 1636428398482, 276, 0, 276, 0, 0, 0
1031, 1, 1636428398446, 1636428398714, 268, 0, 268, 0, 0, 0
1032, 1, 1636428398453, 1636428398721, 268, 1, 267, 0, 0, 0
1033, 1, 1636428398558, 1636428398826, 268, 0, 268, 0, 0, 0
1034, 1, 1636428398729, 1636428398997, 268, 1, 267, 0, 0, 0
1036, 1, 1636428398849, 1636428399126, 277, 1, 276, 0, 0, 0
1035, 1, 1636428399001, 1636428399273, 272, 1, 271, 1, 0, 1
1037, 1, 1636428399085, 1636428399354, 269, 0, 269, 0, 0, 0
1038, 1, 1636428399277, 1636428399549, 272, 1, 271, 0, 0, 0
1039, 1, 1636428399357, 1636428399626, 269, 1, 268, 0, 0, 0
1040, 1, 1636428400054, 1636428400325, 271, 0, 271, 0, 0, 0
1041, 1, 1636428400169, 1636428400438, 269, 1, 268, 0, 0, 0
1042, 1, 1636428400321, 1636428400590, 269, 1, 268, 0, 0, 0
1000, 1, 1636428400361, 1636428400633, 272, 1, 271, 0, 1, 1
1043, 1, 1636428400406, 1636428400674, 268, 0, 268, 0, 0, 0
1044, 1, 1636428400554, 1636428400822, 268, 0, 268, 0, 0, 0
1045, 1, 1636428400609, 1636428400882, 273, 1, 272, 1, 0, 1
1047, 1, 1636428400765, 1636428401033, 268, 1, 267, 0, 0, 0
1048, 1, 1636428400825, 1636428401090, 265, 1, 264, 0, 0, 0
1046, 1, 1636428400885, 1636428401166, 281, 0, 281, 0, 0, 0
1050, 1, 1636428401061, 1636428401326, 265, 1, 264, 0, 0, 0
1049, 1, 1636428401085, 1636428401362, 277, 1, 276, 0, 1, 1
1051, 1, 1636428401262, 1636428401534, 272, 0, 272, 0, 0, 0
1052, 1, 1636428401373, 1636428401646, 273, 1, 272, 0, 0, 0
1053, 1, 1636428401977, 1636428402246, 269, 1, 268, 1, 0, 1
1054, 1, 1636428402145, 1636428402422, 277, 1, 276, 0, 1, 1
1055, 1, 1636428402257, 1636428402526, 269, 1, 268, 0, 0, 0
1056, 1, 1636428402293, 1636428402562, 269, 1, 268, 0, 0, 0
1057, 1, 1636428402521, 1636428402790, 269, 1, 268, 0, 0, 0
1058, 1, 1636428402533, 1636428402801, 268, 1, 267, 0, 0, 0
1060, 1, 1636428402761, 1636428403185, 424, 1, 423, 1, 0, 1
1059, 1, 1636428402809, 1636428403273, 464, 1, 463, 1, 0, 1
1061, 1, 1636428403101, 1636428403401, 300, 1, 299, 1, 0, 1
1062, 1, 1636428403189, 1636428403490, 301, 0, 301, 0, 0, 0
1065, 1, 1636428403313, 1636428403585, 272, 0, 272, 0, 0, 0
1064, 1, 1636428403321, 1636428403589, 268, 1, 267, 0, 0, 0
1063, 1, 1636428403321, 1636428403593, 272, 1, 271, 0, 0, 0
1026, 1, 1636428403354, 1636428403622, 268, 0, 268, 0, 0, 0
1066, 1, 1636428403493, 1636428403762, 269, 0, 269, 0, 0, 0
1070, 1, 1636428403825, 1636428404098, 273, 1, 272, 0, 0, 0
1072, 1, 1636428403942, 1636428404217, 275, 0, 275, 0, 0, 0
1074, 1, 1636428404257, 1636428404530, 273, 1, 272, 0, 0, 0
1075, 1, 1636428404289, 1636428404557, 268, 0, 268, 0, 0, 0
1076, 1, 1636428404333, 1636428404601, 268, 1, 267, 0, 0, 0
1077, 1, 1636428404489, 1636428404762, 273, 1, 272, 1, 0, 1
1078, 1, 1636428404585, 1636428404857, 272, 1, 271, 0, 0, 0
1079, 1, 1636428404670, 1636428404942, 272, 0, 272, 0, 0, 0
1081, 1, 1636428404813, 1636428405081, 268, 1, 267, 0, 0, 0
1082, 1, 1636428405089, 1636428405354, 265, 1, 264, 1, 0, 1
1083, 1, 1636428405113, 1636428405378, 265, 1, 264, 0, 0, 0
1084, 1, 1636428405169, 1636428405433, 264, 1, 263, 0, 1, 1
1085, 1, 1636428405262, 1636428405529, 267, 0, 267, 0, 0, 0
1086, 1, 1636428405305, 1636428405573, 268, 1, 267, 0, 0, 0
1087, 1, 1636428405713, 1636428405986, 273, 1, 272, 0, 1, 1
1088, 1, 1636428405969, 1636428406238, 269, 0, 269, 0, 0, 0
1089, 1, 1636428406182, 1636428406450, 268, 0, 268, 0, 0, 0
1090, 1, 1636428406253, 1636428406526, 273, 1, 272, 1, 0, 1
1091, 1, 1636428406285, 1636428406557, 272, 1, 271, 0, 0, 0
1092, 1, 1636428406505, 1636428406778, 273, 1, 272, 0, 1, 1
1093, 1, 1636428406633, 1636428406910, 277, 1, 276, 1, 0, 1
1094, 1, 1636428406669, 1636428406942, 273, 1, 272, 0, 1, 1
1095, 1, 1636428406806, 1636428407074, 268, 0, 268, 0, 0, 0
1096, 1, 1636428406969, 1636428407237, 268, 1, 267, 0, 0, 0
1097, 1, 1636428407069, 1636428407338, 269, 1, 268, 0, 0, 0
1098, 1, 1636428407150, 1636428407425, 275, 0, 275, 0, 0, 0
1099, 1, 1636428407266, 1636428407533, 267, 0, 267, 0, 0, 0
1101, 1, 1636428407733, 1636428408002, 269, 1, 268, 0, 0, 0
1102, 1, 1636428407973, 1636428408249, 276, 0, 276, 0, 0, 0
1103, 1, 1636428408141, 1636428408410, 269, 1, 268, 0, 0, 0
1104, 1, 1636428408249, 1636428408521, 272, 1, 271, 0, 0, 0
1105, 1, 1636428408281, 1636428408550, 269, 1, 268, 0, 0, 0
1106, 1, 1636428408509, 1636428408778, 269, 1, 268, 0, 1, 1
1107, 1, 1636428408578, 1636428408842, 264, 0, 264, 0, 0, 0
1108, 1, 1636428408662, 1636428408930, 268, 0, 268, 0, 0, 0
1109, 1, 1636428408753, 1636428409021, 268, 1, 267, 0, 1, 1
1110, 1, 1636428409066, 1636428409334, 268, 0, 268, 0, 0, 0
1111, 1, 1636428409073, 1636428409342, 269, 1, 268, 0, 0, 0
1112, 1, 1636428409233, 1636428409506, 273, 1, 272, 0, 0, 0
1113, 1, 1636428409262, 1636428409530, 268, 0, 268, 0, 0, 0
1114, 1, 1636428409657, 1636428409938, 281, 1, 280, 0, 0, 0
1115, 1, 1636428409901, 1636428410174, 273, 1, 272, 0, 1, 1
1116, 1, 1636428410206, 1636428410473, 267, 0, 267, 0, 0, 0
1117, 1, 1636428410241, 1636428410510, 269, 1, 268, 0, 1, 1
1118, 1, 1636428410345, 1636428410614, 269, 1, 268, 0, 0, 0
1119, 1, 1636428410385, 1636428410661, 276, 1, 275, 0, 0, 0
1120, 1, 1636428410469, 1636428410742, 273, 1, 272, 0, 0, 0
1121, 1, 1636428410665, 1636428410933, 268, 0, 268, 0, 0, 0
1122, 1, 1636428410734, 1636428411001, 267, 0, 267, 0, 0, 0
1123, 1, 1636428411066, 1636428411338, 272, 0, 272, 0, 0, 0
1125, 1, 1636428411142, 1636428411413, 271, 0, 271, 0, 0, 0
1124, 1, 1636428411142, 1636428411413, 271, 0, 271, 0, 0, 0
1126, 1, 1636428411309, 1636428411582, 273, 1, 272, 0, 1, 1
1127, 1, 1636428411538, 1636428411806, 268, 0, 268, 0, 0, 0
1128, 1, 1636428411986, 1636428412254, 268, 0, 268, 0, 0, 0
1129, 1, 1636428412186, 1636428412458, 272, 0, 272, 0, 0, 0
1130, 1, 1636428412246, 1636428412517, 271, 0, 271, 0, 0, 0
1131, 1, 1636428412422, 1636428412698, 276, 0, 276, 0, 0, 0
1132, 1, 1636428412477, 1636428412750, 273, 1, 272, 0, 1, 1
1133, 1, 1636428412550, 1636428412813, 263, 0, 263, 0, 0, 0
1134, 1, 1636428412657, 1636428412926, 269, 1, 268, 0, 0, 0
1135, 1, 1636428412782, 1636428413049, 267, 0, 267, 0, 0, 0
1136, 1, 1636428412945, 1636428413214, 269, 1, 268, 0, 0, 0
1137, 1, 1636428413222, 1636428413489, 267, 0, 267, 0, 0, 0
1138, 1, 1636428413226, 1636428413497, 271, 0, 271, 0, 0, 0
1139, 1, 1636428413433, 1636428413809, 376, 1, 375, 0, 0, 0
1140, 1, 1636428413717, 1636428414001, 284, 1, 283, 0, 0, 0
1141, 1, 1636428414037, 1636428414302, 265, 0, 265, 0, 0, 0
1142, 1, 1636428414061, 1636428414333, 272, 1, 271, 0, 0, 0
1100, 1, 1636428414077, 1636428414345, 268, 1, 267, 0, 1, 1
1145, 1, 1636428414257, 1636428414525, 268, 1, 267, 0, 0, 0
1146, 1, 1636428414261, 1636428414533, 272, 1, 271, 0, 0, 0
1147, 1, 1636428414445, 1636428414713, 268, 1, 267, 0, 0, 0
1150, 1, 1636428414545, 1636428414817, 272, 1, 271, 1, 0, 1
1149, 1, 1636428414545, 1636428414817, 272, 1, 271, 1, 0, 1
1151, 1, 1636428414673, 1636428414942, 269, 1, 268, 0, 0, 0
1152, 1, 1636428414706, 1636428414973, 267, 0, 267, 0, 0, 0
1148, 1, 1636428414713, 1636428414985, 272, 2, 270, 1, 0, 1
1153, 1, 1636428414717, 1636428414994, 277, 0, 277, 0, 0, 0
1080, 2, 1636428404861, 1636428415002, 10141, 1, 10140, 0, 0, 0
1154, 1, 1636428415097, 1636428415365, 268, 1, 267, 1, 0, 1
1155, 1, 1636428415097, 1636428415366, 269, 1, 268, 1, 0, 1
1156, 1, 1636428415317, 1636428415585, 268, 1, 267, 0, 0, 0
1157, 1, 1636428415346, 1636428415617, 271, 0, 271, 0, 0, 0
1158, 1, 1636428415446, 1636428415710, 264, 0, 264, 0, 0, 0
1160, 1, 1636428415721, 1636428415989, 268, 1, 267, 0, 0, 0
1161, 1, 1636428416006, 1636428416281, 275, 0, 275, 0, 0, 0
1162, 1, 1636428416174, 1636428416442, 268, 0, 268, 0, 0, 0
1163, 1, 1636428416221, 1636428416493, 272, 1, 271, 0, 0, 0
1164, 1, 1636428416273, 1636428416545, 272, 1, 271, 0, 1, 1
1166, 1, 1636428416362, 1636428416629, 267, 0, 267, 0, 0, 0
1167, 1, 1636428416569, 1636428416833, 264, 1, 263, 0, 1, 1
1168, 1, 1636428416589, 1636428416854, 265, 0, 265, 0, 0, 0
1170, 1, 1636428416661, 1636428416926, 265, 1, 264, 0, 0, 0
1172, 1, 1636428416793, 1636428417061, 268, 1, 267, 0, 1, 1
1173, 1, 1636428417105, 1636428417373, 268, 1, 267, 0, 0, 0
1174, 1, 1636428417322, 1636428417589, 267, 0, 267, 0, 0, 0
1175, 1, 1636428417353, 1636428417622, 269, 0, 269, 0, 0, 0
1177, 1, 1636428417630, 1636428417902, 272, 0, 272, 0, 0, 0
1178, 1, 1636428418122, 1636428418394, 272, 0, 272, 0, 0, 0
1179, 1, 1636428418186, 1636428418454, 268, 0, 268, 0, 0, 0
1180, 1, 1636428418206, 1636428418474, 268, 0, 268, 0, 0, 0
1182, 1, 1636428418441, 1636428418709, 268, 1, 267, 0, 0, 0
1184, 1, 1636428418697, 1636428418966, 269, 1, 268, 1, 0, 1
1185, 1, 1636428418757, 1636428419030, 273, 1, 272, 0, 1, 1
1186, 1, 1636428418829, 1636428419098, 269, 1, 268, 0, 0, 0
1187, 1, 1636428419213, 1636428419482, 269, 1, 268, 0, 0, 0
1192, 1, 1636428420241, 1636428420505, 264, 1, 263, 1, 0, 1
1193, 1, 1636428420286, 1636428420557, 271, 0, 271, 0, 0, 0
1194, 1, 1636428420550, 1636428420817, 267, 0, 267, 0, 0, 0
1195, 1, 1636428420673, 1636428420938, 265, 0, 265, 0, 0, 0
1196, 1, 1636428420717, 1636428420985, 268, 0, 268, 0, 0, 0
1199, 1, 1636428422250, 1636428422522, 272, 0, 272, 0, 0, 0
1200, 1, 1636428422285, 1636428422557, 272, 1, 271, 0, 0, 0
1201, 1, 1636428422546, 1636428422818, 272, 0, 272, 0, 0, 0
1203, 1, 1636428422710, 1636428422978, 268, 0, 268, 0, 0, 0
1204, 1, 1636428424286, 1636428424553, 267, 0, 267, 0, 0, 0
1205, 1, 1636428424330, 1636428424594, 264, 0, 264, 0, 0, 0
1206, 1, 1636428424509, 1636428424778, 269, 1, 268, 0, 1, 1
1208, 1, 1636428424630, 1636428424902, 272, 0, 272, 0, 0, 0
1209, 1, 1636428424677, 1636428424946, 269, 1, 268, 0, 1, 1
1207, 1, 1636428424781, 1636428425049, 268, 1, 267, 0, 1, 1
1210, 1, 1636428425898, 1636428426166, 268, 0, 268, 0, 0, 0
1211, 1, 1636428426297, 1636428426565, 268, 1, 267, 0, 0, 0
1165, 2, 1636428416545, 1636428426593, 10048, 0, 10048, 0, 0, 0
1212, 1, 1636428426362, 1636428426630, 268, 0, 268, 0, 0, 0
1213, 1, 1636428426433, 1636428426813, 380, 1, 379, 0, 1, 1
1214, 1, 1636428426817, 1636428427081, 264, 1, 263, 0, 0, 0
1215, 1, 1636428426817, 1636428427082, 265, 1, 264, 0, 0, 0
1216, 1, 1636428426905, 1636428427174, 269, 1, 268, 1, 0, 1
1217, 1, 1636428427038, 1636428427306, 268, 0, 268, 0, 0, 0
1218, 1, 1636428427177, 1636428427477, 300, 1, 299, 0, 0, 0
1219, 1, 1636428427778, 1636428428046, 268, 0, 268, 0, 0, 0
1220, 1, 1636428427793, 1636428428066, 273, 1, 272, 0, 1, 1
1221, 1, 1636428428290, 1636428428565, 275, 0, 275, 0, 0, 0
1222, 1, 1636428428378, 1636428428693, 315, 0, 315, 0, 0, 0
1223, 1, 1636428428441, 1636428428710, 269, 1, 268, 1, 0, 1
1225, 1, 1636428428609, 1636428428877, 268, 1, 267, 0, 0, 0
1224, 1, 1636428428697, 1636428428965, 268, 1, 267, 0, 1, 1
1227, 1, 1636428428781, 1636428429053, 272, 0, 272, 0, 0, 0
1226, 1, 1636428428825, 1636428429094, 269, 1, 268, 0, 0, 0
1228, 1, 1636428428949, 1636428429217, 268, 1, 267, 1, 0, 1
1229, 1, 1636428428990, 1636428429282, 292, 0, 292, 0, 0, 0
1230, 1, 1636428429022, 1636428429294, 272, 0, 272, 0, 0, 0
1231, 1, 1636428429622, 1636428429894, 272, 0, 272, 0, 0, 0
1233, 1, 1636428429746, 1636428430009, 263, 0, 263, 0, 0, 0
1232, 1, 1636428429777, 1636428430049, 272, 0, 272, 0, 0, 0
1234, 1, 1636428430169, 1636428430437, 268, 1, 267, 0, 1, 1
1235, 1, 1636428430261, 1636428430529, 268, 1, 267, 0, 1, 1
1237, 1, 1636428430473, 1636428430742, 269, 1, 268, 1, 0, 1
1238, 1, 1636428430505, 1636428430774, 269, 1, 268, 0, 0, 0
1236, 1, 1636428430533, 1636428430801, 268, 0, 268, 0, 0, 0
1239, 1, 1636428430541, 1636428430810, 269, 0, 269, 0, 0, 0
1240, 1, 1636428430714, 1636428430982, 268, 0, 268, 0, 0, 0
1243, 1, 1636428430894, 1636428431165, 271, 0, 271, 0, 0, 0
1242, 1, 1636428430889, 1636428431165, 276, 1, 275, 1, 0, 1
1244, 1, 1636428430953, 1636428431222, 269, 1, 268, 1, 0, 1
1245, 1, 1636428431253, 1636428431522, 269, 1, 268, 0, 0, 0
1246, 1, 1636428431577, 1636428431846, 269, 1, 268, 0, 0, 0
1247, 1, 1636428431629, 1636428431901, 272, 0, 272, 0, 0, 0
1249, 1, 1636428431673, 1636428431942, 269, 0, 269, 0, 0, 0
1248, 1, 1636428431685, 1636428431954, 269, 0, 269, 0, 0, 0
1250, 1, 1636428432105, 1636428432374, 269, 0, 269, 0, 0, 0
1251, 1, 1636428432330, 1636428432602, 272, 0, 272, 0, 0, 0
1252, 1, 1636428432377, 1636428432669, 292, 1, 291, 0, 0, 0
1253, 1, 1636428432441, 1636428432709, 268, 1, 267, 1, 0, 1
1255, 1, 1636428432589, 1636428432857, 268, 1, 267, 0, 0, 0
1254, 1, 1636428432605, 1636428432874, 269, 1, 268, 0, 1, 1
1257, 1, 1636428432833, 1636428433102, 269, 1, 268, 0, 0, 0
1259, 1, 1636428432889, 1636428433157, 268, 1, 267, 0, 0, 0
1258, 1, 1636428432889, 1636428433158, 269, 1, 268, 0, 0, 0
1260, 1, 1636428432977, 1636428433246, 269, 0, 269, 0, 0, 0
1261, 1, 1636428433125, 1636428433394, 269, 0, 269, 0, 0, 0
1262, 1, 1636428433533, 1636428433805, 272, 1, 271, 0, 1, 1
1263, 1, 1636428433569, 1636428433838, 269, 1, 268, 0, 0, 0
1264, 1, 1636428433573, 1636428433846, 273, 1, 272, 0, 0, 0
1265, 1, 1636428433682, 1636428433958, 276, 0, 276, 0, 0, 0
1266, 1, 1636428434129, 1636428434397, 268, 1, 267, 0, 0, 0
1267, 1, 1636428434214, 1636428434482, 268, 0, 268, 0, 0, 0
1268, 1, 1636428434374, 1636428434646, 272, 0, 272, 0, 0, 0
1270, 1, 1636428434493, 1636428434758, 265, 1, 264, 0, 1, 1
1269, 1, 1636428434489, 1636428434758, 269, 1, 268, 0, 0, 0
1271, 1, 1636428434513, 1636428434782, 269, 1, 268, 0, 0, 0
1272, 1, 1636428434717, 1636428434990, 273, 0, 273, 0, 0, 0
1273, 1, 1636428434846, 1636428435113, 267, 0, 267, 0, 0, 0
1274, 1, 1636428434901, 1636428435170, 269, 1, 268, 0, 0, 0
1275, 1, 1636428434917, 1636428435198, 281, 0, 281, 0, 0, 0
1276, 1, 1636428435073, 1636428435345, 272, 1, 271, 0, 1, 1
1277, 1, 1636428435478, 1636428435745, 267, 0, 267, 0, 0, 0
1278, 1, 1636428435569, 1636428435838, 269, 1, 268, 0, 1, 1
1279, 1, 1636428435606, 1636428435874, 268, 0, 268, 0, 0, 0
1280, 1, 1636428435717, 1636428435990, 273, 1, 272, 0, 0, 0
1281, 1, 1636428436049, 1636428436314, 265, 1, 264, 0, 0, 0
1282, 1, 1636428436133, 1636428436406, 273, 0, 273, 0, 0, 0
1284, 1, 1636428436378, 1636428436649, 271, 0, 271, 0, 0, 0
1286, 1, 1636428436406, 1636428436673, 267, 1, 266, 0, 0, 0
1283, 1, 1636428436406, 1636428436677, 271, 1, 270, 1, 0, 1
1285, 1, 1636428436409, 1636428436678, 269, 0, 269, 0, 0, 0
1287, 1, 1636428436725, 1636428436993, 268, 1, 267, 0, 1, 1
1288, 1, 1636428436785, 1636428437057, 272, 1, 271, 0, 0, 0
1289, 1, 1636428436898, 1636428437169, 271, 0, 271, 0, 0, 0
1292, 1, 1636428436989, 1636428437262, 273, 0, 273, 0, 0, 0
1291, 1, 1636428436985, 1636428437262, 277, 1, 276, 0, 0, 0
1293, 1, 1636428437026, 1636428437294, 268, 0, 268, 0, 0, 0
1294, 1, 1636428437057, 1636428437326, 269, 1, 268, 0, 0, 0
1290, 1, 1636428437265, 1636428437534, 269, 0, 269, 0, 0, 0
1295, 1, 1636428437405, 1636428437674, 269, 1, 268, 1, 0, 1
1296, 1, 1636428437605, 1636428437874, 269, 0, 269, 0, 0, 0
1297, 1, 1636428437633, 1636428437905, 272, 0, 272, 0, 0, 0
1298, 1, 1636428437809, 1636428438078, 269, 1, 268, 1, 0, 1
1299, 1, 1636428437930, 1636428438198, 268, 0, 268, 0, 0, 0
1300, 1, 1636428438265, 1636428438533, 268, 1, 267, 1, 0, 1
1301, 1, 1636428438346, 1636428438614, 268, 0, 268, 0, 0, 0
1303, 1, 1636428438389, 1636428438657, 268, 1, 267, 1, 0, 1
1304, 1, 1636428438417, 1636428438694, 277, 0, 277, 0, 0, 0
1302, 1, 1636428438537, 1636428438806, 269, 0, 269, 0, 0, 0
1305, 1, 1636428438725, 1636428438993, 268, 1, 267, 0, 0, 0
1306, 1, 1636428438765, 1636428439033, 268, 0, 268, 0, 0, 0
1307, 1, 1636428438809, 1636428439077, 268, 1, 267, 0, 0, 0
1308, 1, 1636428438885, 1636428439153, 268, 1, 267, 0, 1, 1
1309, 1, 1636428438926, 1636428439193, 267, 0, 267, 0, 0, 0
1311, 1, 1636428439077, 1636428439345, 268, 1, 267, 1, 0, 1
1312, 1, 1636428439073, 1636428439345, 272, 1, 271, 1, 0, 1
1310, 1, 1636428439197, 1636428439465, 268, 1, 267, 1, 0, 1
1313, 1, 1636428439406, 1636428439673, 267, 0, 267, 0, 0, 0
1314, 1, 1636428439641, 1636428439918, 277, 1, 276, 0, 0, 0
1315, 1, 1636428439673, 1636428439938, 265, 0, 265, 0, 0, 0
1316, 1, 1636428439705, 1636428439974, 269, 1, 268, 1, 0, 1
1317, 1, 1636428439946, 1636428440217, 271, 0, 271, 0, 0, 0
1318, 1, 1636428440269, 1636428440537, 268, 0, 268, 0, 0, 0
1319, 1, 1636428440278, 1636428440545, 267, 0, 267, 0, 0, 0
1320, 1, 1636428440305, 1636428440574, 269, 1, 268, 0, 0, 0
1321, 1, 1636428440541, 1636428440813, 272, 0, 272, 0, 0, 0
1322, 1, 1636428440577, 1636428440846, 269, 1, 268, 0, 0, 0
1323, 1, 1636428440746, 1636428441013, 267, 0, 267, 0, 0, 0
1324, 1, 1636428440749, 1636428441021, 272, 0, 272, 0, 0, 0
1325, 1, 1636428440817, 1636428441085, 268, 0, 268, 0, 0, 0
1326, 1, 1636428440853, 1636428441121, 268, 1, 267, 0, 0, 0
1328, 1, 1636428440949, 1636428441209, 260, 0, 260, 0, 0, 0
1329, 1, 1636428440989, 1636428441253, 264, 0, 264, 0, 0, 0
1327, 1, 1636428441089, 1636428441357, 268, 0, 268, 0, 0, 0
1330, 1, 1636428441165, 1636428441429, 264, 0, 264, 0, 0, 0
1331, 1, 1636428441209, 1636428441477, 268, 0, 268, 0, 0, 0
1332, 1, 1636428441449, 1636428441709, 260, 0, 260, 0, 0, 0
1333, 1, 1636428441638, 1636428441910, 272, 0, 272, 0, 0, 0
1334, 1, 1636428441686, 1636428441957, 271, 0, 271, 0, 0, 0
1335, 1, 1636428441754, 1636428442022, 268, 0, 268, 0, 0, 0
1336, 1, 1636428441813, 1636428442082, 269, 1, 268, 0, 0, 0
1337, 1, 1636428442253, 1636428442522, 269, 1, 268, 0, 0, 0
1338, 1, 1636428442274, 1636428442546, 272, 0, 272, 0, 0, 0
1339, 1, 1636428442350, 1636428442661, 311, 0, 311, 0, 0, 0
1341, 1, 1636428442441, 1636428442761, 320, 1, 319, 0, 0, 0
1340, 1, 1636428442577, 1636428442849, 272, 1, 271, 0, 1, 1
1344, 1, 1636428442761, 1636428443025, 264, 1, 263, 1, 0, 1
1345, 1, 1636428442797, 1636428443065, 268, 1, 267, 0, 1, 1
1342, 1, 1636428442797, 1636428443065, 268, 1, 267, 0, 1, 1
1343, 1, 1636428442801, 1636428443073, 272, 0, 272, 0, 0, 0
1347, 1, 1636428442921, 1636428443193, 272, 1, 271, 0, 0, 0
1348, 1, 1636428442966, 1636428443233, 267, 0, 267, 0, 0, 0
1346, 1, 1636428443025, 1636428443293, 268, 1, 267, 1, 0, 1
1349, 1, 1636428443057, 1636428443329, 272, 1, 271, 0, 0, 0
1350, 1, 1636428443069, 1636428443338, 269, 0, 269, 0, 0, 0
1351, 1, 1636428443193, 1636428443461, 268, 1, 267, 1, 0, 1
1352, 1, 1636428443489, 1636428443762, 273, 1, 272, 1, 0, 1
1353, 1, 1636428443661, 1636428443930, 269, 0, 269, 0, 0, 0
1354, 1, 1636428443689, 1636428443962, 273, 1, 272, 0, 1, 1
1355, 1, 1636428443833, 1636428444106, 273, 1, 272, 0, 1, 1
1356, 1, 1636428443865, 1636428444142, 277, 1, 276, 0, 0, 0
1357, 1, 1636428444205, 1636428444474, 269, 1, 268, 0, 0, 0
1358, 1, 1636428444297, 1636428444565, 268, 1, 267, 0, 0, 0
1359, 1, 1636428444305, 1636428444573, 268, 1, 267, 0, 1, 1
1360, 1, 1636428444481, 1636428444757, 276, 1, 275, 0, 0, 0
1361, 1, 1636428444498, 1636428444762, 264, 0, 264, 0, 0, 0
1362, 1, 1636428444773, 1636428445046, 273, 1, 272, 0, 0, 0
1364, 1, 1636428444829, 1636428445097, 268, 1, 267, 0, 0, 0
1363, 1, 1636428444829, 1636428445105, 276, 1, 275, 1, 0, 1
1365, 1, 1636428444841, 1636428445114, 273, 1, 272, 0, 1, 1
1366, 1, 1636428444849, 1636428445125, 276, 1, 275, 1, 0, 1
1367, 1, 1636428444913, 1636428445185, 272, 1, 271, 0, 1, 1
1369, 1, 1636428445002, 1636428445270, 268, 0, 268, 0, 0, 0
1368, 1, 1636428445049, 1636428445314, 265, 1, 264, 0, 0, 0
1370, 1, 1636428445149, 1636428445422, 273, 0, 273, 0, 0, 0
1371, 1, 1636428445161, 1636428445434, 273, 0, 273, 0, 0, 0
1372, 1, 1636428445437, 1636428445705, 268, 1, 267, 0, 0, 0
1373, 1, 1636428445677, 1636428445946, 269, 1, 268, 0, 0, 0
1374, 1, 1636428445769, 1636428446037, 268, 1, 267, 0, 0, 0
1375, 1, 1636428445793, 1636428446061, 268, 1, 267, 1, 0, 1
1376, 1, 1636428445902, 1636428446166, 264, 0, 264, 0, 0, 0
1377, 1, 1636428446225, 1636428446490, 265, 1, 264, 0, 0, 0
1378, 1, 1636428446221, 1636428446493, 272, 1, 271, 0, 0, 0
1379, 1, 1636428446233, 1636428446506, 273, 0, 273, 0, 0, 0
1380, 1, 1636428446497, 1636428446769, 272, 1, 271, 1, 0, 1
1381, 1, 1636428446521, 1636428446785, 264, 1, 263, 0, 0, 0
1382, 1, 1636428446745, 1636428447017, 272, 1, 271, 0, 0, 0
1383, 1, 1636428446793, 1636428447061, 268, 1, 267, 0, 1, 1
1384, 1, 1636428446801, 1636428447073, 272, 1, 271, 0, 1, 1
1385, 1, 1636428446809, 1636428447082, 273, 1, 272, 1, 0, 1
1386, 1, 1636428446861, 1636428447129, 268, 1, 267, 0, 0, 0
1388, 1, 1636428446921, 1636428447193, 272, 1, 271, 0, 0, 0
1387, 1, 1636428446921, 1636428447194, 273, 1, 272, 0, 0, 0
1389, 1, 1636428447138, 1636428447405, 267, 0, 267, 0, 0, 0
1390, 1, 1636428447209, 1636428447486, 277, 1, 276, 0, 0, 0
1391, 1, 1636428447233, 1636428447505, 272, 1, 271, 1, 0, 1
1392, 1, 1636428447497, 1636428447766, 269, 0, 269, 0, 0, 0
1393, 1, 1636428447709, 1636428447977, 268, 0, 268, 0, 0, 0
1394, 1, 1636428447765, 1636428448033, 268, 1, 267, 0, 0, 0
1395, 1, 1636428447830, 1636428448097, 267, 0, 267, 0, 0, 0
1396, 1, 1636428447846, 1636428448113, 267, 0, 267, 0, 0, 0
1397, 1, 1636428448169, 1636428448438, 269, 0, 269, 0, 0, 0
1398, 1, 1636428448193, 1636428448465, 272, 1, 271, 0, 1, 1
1399, 1, 1636428448357, 1636428448629, 272, 1, 271, 0, 1, 1
1401, 1, 1636428448637, 1636428448905, 268, 1, 267, 0, 0, 0
1400, 1, 1636428448637, 1636428448905, 268, 1, 267, 0, 0, 0
1402, 1, 1636428448766, 1636428449033, 267, 0, 267, 0, 0, 0
1403, 1, 1636428448793, 1636428449053, 260, 1, 259, 0, 0, 0
1404, 1, 1636428448789, 1636428449053, 264, 1, 263, 0, 0, 0
1405, 1, 1636428448801, 1636428449065, 264, 0, 264, 0, 0, 0
1406, 1, 1636428448821, 1636428449081, 260, 1, 259, 0, 1, 1
1409, 1, 1636428448993, 1636428449261, 268, 1, 267, 0, 0, 0
1410, 1, 1636428449121, 1636428449389, 268, 1, 267, 0, 0, 0
1411, 1, 1636428449289, 1636428449558, 269, 1, 268, 0, 0, 0
1412, 1, 1636428449565, 1636428449833, 268, 1, 267, 0, 0, 0
1413, 1, 1636428449718, 1636428449986, 268, 0, 268, 0, 0, 0
1414, 1, 1636428449782, 1636428450049, 267, 0, 267, 0, 0, 0
1415, 1, 1636428449857, 1636428450121, 264, 1, 263, 0, 0, 0
1416, 1, 1636428449905, 1636428450174, 269, 1, 268, 0, 0, 0
1418, 1, 1636428450221, 1636428450494, 273, 1, 272, 0, 0, 0
1419, 1, 1636428450277, 1636428450546, 269, 1, 268, 0, 1, 1
1421, 1, 1636428450509, 1636428450781, 272, 1, 271, 0, 1, 1
1420, 1, 1636428450549, 1636428450821, 272, 0, 272, 0, 0, 0
1422, 1, 1636428450689, 1636428450958, 269, 1, 268, 0, 0, 0
1423, 1, 1636428450797, 1636428451066, 269, 1, 268, 0, 0, 0
1425, 1, 1636428450833, 1636428451101, 268, 1, 267, 1, 0, 1
1426, 1, 1636428450849, 1636428451118, 269, 1, 268, 0, 0, 0
1427, 1, 1636428450913, 1636428451186, 273, 1, 272, 0, 0, 0
1428, 1, 1636428451186, 1636428451454, 268, 0, 268, 0, 0, 0
1429, 1, 1636428451365, 1636428451634, 269, 1, 268, 0, 1, 1
1430, 1, 1636428451637, 1636428451906, 269, 1, 268, 0, 0, 0
1431, 1, 1636428451710, 1636428451978, 268, 0, 268, 0, 0, 0
1433, 1, 1636428451802, 1636428452074, 272, 0, 272, 0, 0, 0
1432, 1, 1636428451802, 1636428452074, 272, 0, 272, 0, 0, 0
1434, 1, 1636428451969, 1636428452238, 269, 1, 268, 0, 0, 0
1435, 1, 1636428452226, 1636428452501, 275, 0, 275, 0, 0, 0
1436, 1, 1636428452293, 1636428452566, 273, 1, 272, 0, 0, 0
1437, 1, 1636428452569, 1636428452837, 268, 1, 267, 1, 0, 1
1438, 1, 1636428452593, 1636428452862, 269, 1, 268, 0, 0, 0
1439, 1, 1636428452713, 1636428452982, 269, 1, 268, 1, 0, 1
1440, 1, 1636428452782, 1636428453049, 267, 0, 267, 0, 0, 0
1441, 1, 1636428452805, 1636428453070, 265, 0, 265, 0, 0, 0
1442, 1, 1636428452921, 1636428453197, 276, 1, 275, 0, 1, 1
1443, 1, 1636428452969, 1636428453241, 272, 1, 271, 0, 0, 0
1444, 1, 1636428453241, 1636428453513, 272, 1, 271, 0, 1, 1
1445, 1, 1636428453286, 1636428453553, 267, 0, 267, 0, 0, 0
1446, 1, 1636428453598, 1636428453865, 267, 0, 267, 0, 0, 0
1447, 1, 1636428453681, 1636428453950, 269, 1, 268, 0, 1, 1
1448, 1, 1636428453797, 1636428454070, 273, 1, 272, 0, 0, 0
1449, 1, 1636428453917, 1636428454185, 268, 1, 267, 0, 1, 1
1450, 1, 1636428453946, 1636428454209, 263, 0, 263, 0, 0, 0
1451, 1, 1636428454221, 1636428454485, 264, 1, 263, 0, 1, 1
1452, 1, 1636428454330, 1636428454601, 271, 0, 271, 0, 0, 0
1453, 1, 1636428454606, 1636428454877, 271, 0, 271, 0, 0, 0
1454, 1, 1636428454653, 1636428454922, 269, 1, 268, 0, 0, 0
1455, 1, 1636428454749, 1636428455021, 272, 7, 265, 7, 0, 7
1456, 1, 1636428454761, 1636428455030, 269, 0, 269, 0, 0, 0
1457, 1, 1636428454797, 1636428455074, 277, 1, 276, 1, 0, 1
1458, 1, 1636428454837, 1636428455110, 273, 1, 272, 0, 1, 1
1459, 1, 1636428455029, 1636428455301, 272, 1, 271, 0, 0, 0
1460, 1, 1636428455217, 1636428455489, 272, 0, 272, 0, 0, 0
1461, 1, 1636428455349, 1636428455621, 272, 1, 271, 0, 1, 1
1462, 1, 1636428455661, 1636428455933, 272, 1, 271, 1, 0, 1
1463, 1, 1636428455750, 1636428456017, 267, 0, 267, 0, 0, 0
1464, 1, 1636428455889, 1636428456157, 268, 1, 267, 0, 0, 0
1465, 1, 1636428455910, 1636428456177, 267, 0, 267, 0, 0, 0
1466, 1, 1636428456025, 1636428456293, 268, 1, 267, 1, 0, 1
1467, 1, 1636428456281, 1636428456553, 272, 1, 271, 1, 0, 1
1468, 1, 1636428456317, 1636428456589, 272, 1, 271, 0, 1, 1
1469, 1, 1636428456594, 1636428456869, 275, 0, 275, 0, 0, 0
1470, 1, 1636428456629, 1636428456897, 268, 1, 267, 1, 0, 1
1471, 1, 1636428456758, 1636428457026, 268, 0, 268, 0, 0, 0
1472, 1, 1636428456865, 1636428457134, 269, 1, 268, 0, 0, 0
1474, 1, 1636428456878, 1636428457145, 267, 0, 267, 0, 0, 0
1473, 1, 1636428456878, 1636428457146, 268, 0, 268, 0, 0, 0
1475, 1, 1636428457002, 1636428457270, 268, 0, 268, 0, 0, 0
1476, 1, 1636428457297, 1636428457566, 269, 1, 268, 1, 0, 1
1477, 1, 1636428457465, 1636428457733, 268, 1, 267, 0, 0, 0
1478, 1, 1636428457742, 1636428458014, 272, 0, 272, 0, 0, 0
1479, 1, 1636428457825, 1636428458093, 268, 1, 267, 0, 1, 1
1480, 1, 1636428457877, 1636428458145, 268, 1, 267, 1, 0, 1
1481, 1, 1636428458013, 1636428458281, 268, 1, 267, 0, 0, 0
1482, 1, 1636428458073, 1636428458341, 268, 1, 267, 1, 0, 1
1483, 1, 1636428458294, 1636428458562, 268, 0, 268, 0, 0, 0
1485, 1, 1636428458362, 1636428458630, 268, 0, 268, 0, 0, 0
1484, 1, 1636428458565, 1636428458833, 268, 1, 267, 1, 0, 1
1486, 1, 1636428458709, 1636428459009, 300, 1, 299, 0, 0, 0
1487, 1, 1636428458773, 1636428459101, 328, 1, 327, 0, 1, 1
1488, 1, 1636428458925, 1636428459193, 268, 1, 267, 0, 1, 1
1490, 1, 1636428458965, 1636428459234, 269, 1, 268, 0, 0, 0
1489, 1, 1636428459009, 1636428459281, 272, 1, 271, 1, 0, 1
1491, 1, 1636428459101, 1636428459369, 268, 1, 267, 0, 0, 0
1492, 1, 1636428459353, 1636428459621, 268, 1, 267, 0, 1, 1
1493, 1, 1636428459414, 1636428459686, 272, 0, 272, 0, 0, 0
1494, 1, 1636428459414, 1636428459686, 272, 0, 272, 0, 0, 0
1495, 1, 1636428459433, 1636428459701, 268, 0, 268, 0, 0, 0
1496, 1, 1636428459709, 1636428459977, 268, 1, 267, 0, 0, 0
1497, 1, 1636428459925, 1636428460245, 320, 1, 319, 0, 0, 0
1498, 1, 1636428460009, 1636428460281, 272, 1, 271, 0, 1, 1
1499, 1, 1636428460065, 1636428460333, 268, 0, 268, 0, 0, 0
1500, 1, 1636428460073, 1636428460341, 268, 1, 267, 1, 0, 1
1424, 1, 1636428460197, 1636428460462, 265, 0, 265, 0, 0, 0
1501, 1, 1636428460377, 1636428460641, 264, 1, 263, 0, 1, 1
1503, 1, 1636428460465, 1636428460733, 268, 1, 267, 0, 0, 0
1504, 1, 1636428460545, 1636428460821, 276, 1, 275, 0, 0, 0
1502, 1, 1636428460649, 1636428460917, 268, 1, 267, 0, 0, 0
1506, 1, 1636428460793, 1636428461061, 268, 1, 267, 0, 0, 0
1505, 1, 1636428460821, 1636428461089, 268, 1, 267, 1, 0, 1
1507, 1, 1636428460858, 1636428461125, 267, 0, 267, 0, 0, 0
1508, 1, 1636428460861, 1636428461129, 268, 1, 267, 0, 0, 0
1510, 1, 1636428460977, 1636428461246, 269, 1, 268, 1, 0, 1
1511, 1, 1636428461069, 1636428461345, 276, 0, 276, 0, 0, 0
1509, 1, 1636428461093, 1636428461362, 269, 1, 268, 1, 0, 1
1512, 1, 1636428461246, 1636428461514, 268, 0, 268, 0, 0, 0
1514, 1, 1636428461354, 1636428461617, 263, 0, 263, 0, 0, 0
1513, 1, 1636428461342, 1636428461626, 284, 0, 284, 0, 0, 0
1515, 1, 1636428461566, 1636428461841, 275, 0, 275, 0, 0, 0
1516, 1, 1636428461846, 1636428462117, 271, 0, 271, 0, 0, 0
1518, 1, 1636428462001, 1636428462269, 268, 1, 267, 0, 0, 0
1519, 1, 1636428462042, 1636428462309, 267, 0, 267, 0, 0, 0
1520, 1, 1636428462170, 1636428462441, 271, 0, 271, 0, 0, 0
1521, 1, 1636428462465, 1636428462742, 277, 1, 276, 0, 0, 0
1523, 1, 1636428462481, 1636428462754, 273, 1, 272, 1, 0, 1
1525, 1, 1636428462681, 1636428462958, 277, 1, 276, 0, 1, 1
1526, 1, 1636428462733, 1636428463001, 268, 1, 267, 0, 1, 1
1522, 1, 1636428462745, 1636428463013, 268, 1, 267, 0, 1, 1
1527, 1, 1636428462781, 1636428463054, 273, 1, 272, 1, 0, 1
1528, 1, 1636428462894, 1636428463162, 268, 0, 268, 0, 0, 0
1529, 1, 1636428462941, 1636428463209, 268, 1, 267, 0, 1, 1
1530, 1, 1636428462973, 1636428463245, 272, 1, 271, 0, 0, 0
1531, 1, 1636428463057, 1636428463325, 268, 1, 267, 1, 0, 1
1532, 1, 1636428463178, 1636428463445, 267, 0, 267, 0, 0, 0
1533, 1, 1636428463457, 1636428463729, 272, 0, 272, 0, 0, 0
1534, 1, 1636428463481, 1636428463749, 268, 0, 268, 0, 0, 0
1535, 1, 1636428463585, 1636428463853, 268, 1, 267, 1, 0, 1
1536, 1, 1636428463861, 1636428464129, 268, 1, 267, 0, 0, 0
1537, 1, 1636428463970, 1636428464238, 268, 0, 268, 0, 0, 0
1539, 1, 1636428464109, 1636428464378, 269, 1, 268, 1, 0, 1
1538, 1, 1636428464109, 1636428464381, 272, 1, 271, 1, 0, 1
1540, 1, 1636428464366, 1636428464637, 271, 0, 271, 0, 0, 0
1542, 1, 1636428464605, 1636428464873, 268, 1, 267, 1, 0, 1
1543, 1, 1636428464626, 1636428464898, 272, 0, 272, 0, 0, 0
1541, 1, 1636428464641, 1636428464917, 276, 0, 276, 0, 0, 0
1544, 1, 1636428464761, 1636428465029, 268, 1, 267, 0, 0, 0
1545, 1, 1636428464885, 1636428465153, 268, 1, 267, 0, 1, 1
1546, 1, 1636428464909, 1636428465178, 269, 1, 268, 1, 0, 1
1547, 1, 1636428464961, 1636428465230, 269, 1, 268, 0, 0, 0
1548, 1, 1636428465017, 1636428465285, 268, 1, 267, 0, 1, 1
1549, 1, 1636428465189, 1636428465458, 269, 1, 268, 0, 1, 1
1550, 1, 1636428465225, 1636428465498, 273, 1, 272, 1, 0, 1
1551, 1, 1636428465398, 1636428465665, 267, 0, 267, 0, 0, 0
1552, 1, 1636428465429, 1636428465698, 269, 1, 268, 0, 0, 0
1553, 1, 1636428465582, 1636428465854, 272, 0, 272, 0, 0, 0
1555, 1, 1636428466014, 1636428466281, 267, 0, 267, 0, 0, 0
1556, 1, 1636428466045, 1636428466313, 268, 1, 267, 0, 0, 0
1557, 1, 1636428466082, 1636428466353, 271, 0, 271, 0, 0, 0
1558, 1, 1636428466289, 1636428466562, 273, 1, 272, 0, 0, 0
1560, 1, 1636428466505, 1636428466774, 269, 1, 268, 0, 0, 0
1561, 1, 1636428466509, 1636428466781, 272, 1, 271, 0, 0, 0
1559, 1, 1636428466565, 1636428466833, 268, 1, 267, 0, 0, 0
1562, 1, 1636428466849, 1636428467126, 277, 1, 276, 0, 0, 0
1563, 1, 1636428466861, 1636428467133, 272, 1, 271, 0, 0, 0
1564, 1, 1636428466913, 1636428467177, 264, 1, 263, 1, 0, 1
1567, 1, 1636428467005, 1636428467278, 273, 1, 272, 1, 0, 1
1565, 1, 1636428467129, 1636428467402, 273, 0, 273, 0, 0, 0
1568, 1, 1636428467294, 1636428467562, 268, 0, 268, 0, 0, 0
1569, 1, 1636428467306, 1636428467573, 267, 0, 267, 0, 0, 0
1570, 1, 1636428467481, 1636428467753, 272, 1, 271, 0, 0, 0
1571, 1, 1636428467710, 1636428467982, 272, 0, 272, 0, 0, 0
1572, 1, 1636428468001, 1636428468269, 268, 1, 267, 1, 0, 1
1573, 1, 1636428468014, 1636428468281, 267, 0, 267, 0, 0, 0
1574, 1, 1636428468042, 1636428468310, 268, 0, 268, 0, 0, 0
1575, 1, 1636428468182, 1636428468450, 268, 0, 268, 0, 0, 0
1577, 1, 1636428468413, 1636428468681, 268, 1, 267, 0, 0, 0
1576, 1, 1636428468453, 1636428468722, 269, 1, 268, 1, 0, 1
1578, 1, 1636428468553, 1636428468817, 264, 1, 263, 1, 0, 1
1579, 1, 1636428468842, 1636428469117, 275, 0, 275, 0, 0, 0
1580, 1, 1636428468922, 1636428469194, 272, 0, 272, 0, 0, 0
1583, 1, 1636428469089, 1636428469358, 269, 1, 268, 0, 0, 0
1581, 1, 1636428469117, 1636428469386, 269, 1, 268, 1, 0, 1
1584, 1, 1636428469169, 1636428469438, 269, 0, 269, 0, 0, 0
1585, 1, 1636428469181, 1636428469450, 269, 1, 268, 1, 0, 1
1586, 1, 1636428469586, 1636428469854, 268, 0, 268, 0, 0, 0
1587, 1, 1636428469653, 1636428469921, 268, 1, 267, 0, 1, 1
1588, 1, 1636428469917, 1636428470190, 273, 1, 272, 0, 0, 0
1589, 1, 1636428470029, 1636428470305, 276, 1, 275, 0, 0, 0
1590, 1, 1636428470081, 1636428470354, 273, 1, 272, 0, 1, 1
1591, 1, 1636428470098, 1636428470365, 267, 0, 267, 0, 0, 0
1593, 1, 1636428470333, 1636428470605, 272, 1, 271, 0, 0, 0
1592, 1, 1636428470357, 1636428470625, 268, 1, 267, 0, 1, 1
1594, 1, 1636428470593, 1636428470862, 269, 0, 269, 0, 0, 0
1595, 1, 1636428470725, 1636428470994, 269, 1, 268, 0, 0, 0
1597, 1, 1636428470961, 1636428471233, 272, 1, 271, 1, 0, 1
1598, 1, 1636428470986, 1636428471257, 271, 0, 271, 0, 0, 0
1596, 1, 1636428470997, 1636428471266, 269, 1, 268, 0, 1, 1
1600, 1, 1636428471225, 1636428471502, 277, 0, 277, 0, 0, 0
1599, 1, 1636428471261, 1636428471533, 272, 1, 271, 0, 0, 0
1601, 1, 1636428471581, 1636428471850, 269, 1, 268, 1, 0, 1
1602, 1, 1636428471646, 1636428471913, 267, 0, 267, 0, 0, 0
1603, 1, 1636428471802, 1636428472069, 267, 0, 267, 0, 0, 0
1604, 1, 1636428471993, 1636428472269, 276, 1, 275, 1, 0, 1
1605, 1, 1636428472066, 1636428472333, 267, 0, 267, 0, 0, 0
1606, 1, 1636428472130, 1636428472398, 268, 0, 268, 0, 0, 0
1607, 1, 1636428472281, 1636428472589, 308, 1, 307, 0, 0, 0
1608, 1, 1636428472342, 1636428472614, 272, 0, 272, 0, 0, 0
1610, 1, 1636428472593, 1636428472865, 272, 1, 271, 0, 0, 0
1609, 1, 1636428472617, 1636428472890, 273, 0, 273, 0, 0, 0
1611, 1, 1636428472765, 1636428473033, 268, 1, 267, 0, 0, 0
1612, 1, 1636428472893, 1636428473162, 269, 1, 268, 1, 0, 1
1614, 1, 1636428472893, 1636428473165, 272, 1, 271, 1, 0, 1
1615, 1, 1636428472905, 1636428473173, 268, 1, 267, 1, 0, 1
1613, 1, 1636428473041, 1636428473305, 264, 1, 263, 1, 0, 1
1616, 1, 1636428473161, 1636428473429, 268, 1, 267, 0, 0, 0
1617, 1, 1636428473202, 1636428473473, 271, 0, 271, 0, 0, 0
1618, 1, 1636428473473, 1636428473742, 269, 1, 268, 1, 0, 1
1619, 1, 1636428473521, 1636428473786, 265, 1, 264, 0, 1, 1
1620, 1, 1636428473837, 1636428474106, 269, 1, 268, 0, 0, 0
1621, 1, 1636428473897, 1636428474166, 269, 1, 268, 0, 1, 1
1622, 1, 1636428473970, 1636428474237, 267, 0, 267, 0, 0, 0
1623, 1, 1636428474065, 1636428474329, 264, 1, 263, 0, 0, 0
1624, 1, 1636428474166, 1636428474438, 272, 1, 271, 0, 0, 0
1625, 1, 1636428474189, 1636428474462, 273, 1, 272, 0, 1, 1
1626, 1, 1636428474469, 1636428474737, 268, 1, 267, 0, 0, 0
1627, 1, 1636428474501, 1636428474774, 273, 1, 272, 0, 1, 1
1628, 1, 1636428474705, 1636428474973, 268, 1, 267, 0, 1, 1
1629, 1, 1636428474737, 1636428475009, 272, 1, 271, 1, 0, 1
1630, 1, 1636428474781, 1636428475050, 269, 1, 268, 0, 0, 0
1631, 1, 1636428474833, 1636428475101, 268, 1, 267, 0, 1, 1
1632, 1, 1636428474977, 1636428475246, 269, 1, 268, 0, 1, 1
1633, 1, 1636428475114, 1636428475382, 268, 0, 268, 0, 0, 0
1634, 1, 1636428475233, 1636428475502, 269, 1, 268, 1, 0, 1
1635, 1, 1636428475473, 1636428475741, 268, 1, 267, 0, 0, 0
1636, 1, 1636428475557, 1636428475825, 268, 1, 267, 0, 0, 0
1554, 2, 1636428465854, 1636428475901, 10047, 0, 10047, 0, 0, 0
1637, 1, 1636428475809, 1636428476133, 324, 1, 323, 1, 0, 1
1566, 1, 1636428475949, 1636428476221, 272, 0, 272, 0, 0, 0
1639, 1, 1636428476041, 1636428476309, 268, 1, 267, 1, 0, 1
1640, 1, 1636428476045, 1636428476317, 272, 1, 271, 1, 0, 1
1638, 1, 1636428476045, 1636428476321, 276, 1, 275, 1, 0, 1
1641, 1, 1636428476161, 1636428476426, 265, 1, 264, 0, 0, 0
1643, 1, 1636428476297, 1636428476565, 268, 1, 267, 0, 0, 0
1642, 1, 1636428476325, 1636428476589, 264, 0, 264, 0, 0, 0
1644, 1, 1636428476429, 1636428476697, 268, 1, 267, 0, 1, 1
1645, 1, 1636428476553, 1636428476821, 268, 1, 267, 1, 0, 1
1647, 1, 1636428476657, 1636428476926, 269, 0, 269, 0, 0, 0
1646, 1, 1636428476677, 1636428476946, 269, 1, 268, 0, 0, 0
1648, 1, 1636428476697, 1636428476970, 273, 1, 272, 1, 0, 1
1650, 1, 1636428476729, 1636428476997, 268, 0, 268, 0, 0, 0
1651, 1, 1636428476909, 1636428477178, 269, 1, 268, 0, 0, 0
1649, 1, 1636428476925, 1636428477201, 276, 1, 275, 0, 0, 0
1652, 1, 1636428477213, 1636428477485, 272, 1, 271, 0, 1, 1
1653, 1, 1636428477241, 1636428477509, 268, 1, 267, 0, 0, 0
1654, 1, 1636428477525, 1636428477798, 273, 0, 273, 0, 0, 0
1655, 1, 1636428477537, 1636428477806, 269, 0, 269, 0, 0, 0
1656, 1, 1636428477785, 1636428478061, 276, 1, 275, 0, 0, 0
1657, 1, 1636428477906, 1636428478177, 271, 0, 271, 0, 0, 0
1658, 1, 1636428478021, 1636428478285, 264, 1, 263, 1, 0, 1
1659, 1, 1636428478089, 1636428478354, 265, 1, 264, 0, 0, 0
1660, 1, 1636428478109, 1636428478378, 269, 1, 268, 0, 0, 0
1661, 1, 1636428478181, 1636428478458, 277, 1, 276, 0, 1, 1
1663, 1, 1636428478329, 1636428478598, 269, 0, 269, 0, 0, 0
1662, 1, 1636428478357, 1636428478621, 264, 1, 263, 1, 0, 1
1665, 1, 1636428478641, 1636428478905, 264, 0, 264, 0, 0, 0
1664, 1, 1636428478637, 1636428478909, 272, 0, 272, 0, 0, 0
1666, 1, 1636428478665, 1636428478933, 268, 1, 267, 0, 0, 0
1667, 1, 1636428478710, 1636428478993, 283, 0, 283, 0, 0, 0
1668, 1, 1636428478710, 1636428478994, 284, 0, 284, 0, 0, 0
1670, 1, 1636428478997, 1636428479270, 273, 1, 272, 0, 1, 1
1669, 1, 1636428478997, 1636428479270, 273, 1, 272, 0, 1, 1
1671, 1, 1636428479161, 1636428479430, 269, 1, 268, 0, 0, 0
1672, 1, 1636428479209, 1636428479473, 264, 1, 263, 0, 1, 1
1673, 1, 1636428479286, 1636428479558, 272, 0, 272, 0, 0, 0
1674, 1, 1636428479433, 1636428479710, 277, 1, 276, 0, 0, 0
1675, 1, 1636428479617, 1636428479885, 268, 1, 267, 0, 1, 1
1676, 1, 1636428479841, 1636428480110, 269, 1, 268, 0, 0, 0
1677, 1, 1636428479853, 1636428480122, 269, 0, 269, 0, 0, 0
1678, 1, 1636428480029, 1636428480297, 268, 0, 268, 0, 0, 0
1680, 1, 1636428480057, 1636428480333, 276, 0, 276, 0, 0, 0
1679, 1, 1636428480121, 1636428480389, 268, 1, 267, 0, 0, 0
1681, 1, 1636428480141, 1636428480414, 273, 1, 272, 0, 0, 0
1683, 1, 1636428480305, 1636428480578, 273, 0, 273, 0, 0, 0
1682, 1, 1636428480421, 1636428480689, 268, 1, 267, 0, 0, 0
1684, 1, 1636428480597, 1636428480869, 272, 1, 271, 0, 0, 0
1685, 1, 1636428480653, 1636428480921, 268, 0, 268, 0, 0, 0
1687, 1, 1636428480689, 1636428480957, 268, 1, 267, 0, 0, 0
1686, 1, 1636428480689, 1636428480961, 272, 1, 271, 1, 0, 1
1688, 1, 1636428480729, 1636428480998, 269, 0, 269, 0, 0, 0
1689, 1, 1636428480921, 1636428481185, 264, 1, 263, 1, 0, 1
1690, 1, 1636428481086, 1636428481353, 267, 0, 267, 0, 0, 0
1691, 1, 1636428481137, 1636428481405, 268, 1, 267, 0, 0, 0
1692, 1, 1636428481177, 1636428481446, 269, 1, 268, 1, 0, 1
1693, 1, 1636428481197, 1636428481469, 272, 1, 271, 0, 0, 0
1694, 1, 1636428481493, 1636428481761, 268, 1, 267, 1, 0, 1
1695, 1, 1636428481562, 1636428481833, 271, 0, 271, 0, 0, 0
1696, 1, 1636428481761, 1636428482029, 268, 0, 268, 0, 0, 0
1697, 1, 1636428481853, 1636428482121, 268, 1, 267, 0, 1, 1
1699, 1, 1636428482069, 1636428482337, 268, 0, 268, 0, 0, 0
1700, 1, 1636428482089, 1636428482357, 268, 0, 268, 0, 0, 0
1698, 1, 1636428482129, 1636428482394, 265, 0, 265, 0, 0, 0
1701, 1, 1636428482173, 1636428482445, 272, 0, 272, 0, 0, 0
1703, 1, 1636428482381, 1636428482650, 269, 1, 268, 0, 0, 0
1702, 1, 1636428482449, 1636428482721, 272, 1, 271, 0, 1, 1
1704, 1, 1636428482673, 1636428482941, 268, 1, 267, 0, 0, 0
1705, 1, 1636428482701, 1636428482969, 268, 1, 267, 1, 0, 1
1706, 1, 1636428482709, 1636428482981, 272, 1, 271, 0, 1, 1
1707, 1, 1636428482725, 1636428482993, 268, 0, 268, 0, 0, 0
1708, 1, 1636428482769, 1636428483041, 272, 1, 271, 0, 0, 0
1709, 1, 1636428482977, 1636428483249, 272, 1, 271, 0, 0, 0
1710, 1, 1636428483025, 1636428483289, 264, 1, 263, 0, 1, 1
1711, 1, 1636428483077, 1636428483353, 276, 1, 275, 0, 0, 0
1712, 1, 1636428483234, 1636428483501, 267, 0, 267, 0, 0, 0
1713, 1, 1636428483313, 1636428483581, 268, 1, 267, 0, 1, 1
1714, 1, 1636428483413, 1636428483681, 268, 1, 267, 0, 0, 0
1715, 1, 1636428483621, 1636428483894, 273, 1, 272, 1, 0, 1
1716, 1, 1636428483805, 1636428484078, 273, 1, 272, 0, 0, 0
1717, 1, 1636428483877, 1636428484150, 273, 1, 272, 0, 0, 0
1718, 1, 1636428484069, 1636428484346, 277, 1, 276, 1, 0, 1
1719, 1, 1636428484154, 1636428484422, 268, 0, 268, 0, 0, 0
1720, 1, 1636428484182, 1636428484449, 267, 0, 267, 0, 0, 0
1721, 1, 1636428484213, 1636428484481, 268, 1, 267, 1, 0, 1
1722, 1, 1636428484449, 1636428484722, 273, 1, 272, 0, 0, 0
1723, 1, 1636428484489, 1636428484766, 277, 1, 276, 0, 0, 0
1724, 1, 1636428484566, 1636428484833, 267, 0, 267, 0, 0, 0
1725, 1, 1636428484737, 1636428485005, 268, 1, 267, 0, 1, 1
1726, 1, 1636428484745, 1636428485013, 268, 1, 267, 1, 0, 1
1727, 1, 1636428484765, 1636428485029, 264, 1, 263, 1, 0, 1
1728, 1, 1636428484829, 1636428485097, 268, 1, 267, 0, 0, 0
1729, 1, 1636428485021, 1636428485293, 272, 1, 271, 1, 0, 1
1730, 1, 1636428485049, 1636428485317, 268, 1, 267, 1, 0, 1
1731, 1, 1636428485073, 1636428485338, 265, 1, 264, 0, 0, 0
1732, 1, 1636428485209, 1636428485482, 273, 0, 273, 0, 0, 0
1733, 1, 1636428485293, 1636428485557, 264, 1, 263, 1, 0, 1
1734, 1, 1636428485450, 1636428485718, 268, 0, 268, 0, 0, 0
1735, 1, 1636428485621, 1636428485889, 268, 1, 267, 1, 0, 1
1736, 1, 1636428485838, 1636428486109, 271, 0, 271, 0, 0, 0
1737, 1, 1636428485913, 1636428486185, 272, 1, 271, 0, 0, 0
1738, 1, 1636428486085, 1636428486353, 268, 1, 267, 0, 1, 1
1740, 1, 1636428486157, 1636428486426, 269, 1, 268, 0, 1, 1
1741, 1, 1636428486177, 1636428486449, 272, 1, 271, 0, 0, 0
1739, 1, 1636428486189, 1636428486461, 272, 1, 271, 0, 1, 1
1743, 1, 1636428486442, 1636428486709, 267, 0, 267, 0, 0, 0
1742, 1, 1636428486449, 1636428486721, 272, 1, 271, 1, 0, 1
1744, 1, 1636428486473, 1636428486741, 268, 0, 268, 0, 0, 0
1746, 1, 1636428486729, 1636428486998, 269, 1, 268, 0, 0, 0
1745, 1, 1636428486729, 1636428487002, 273, 1, 272, 1, 0, 1
1747, 1, 1636428486757, 1636428487022, 265, 1, 264, 0, 0, 0
1749, 1, 1636428486866, 1636428487137, 271, 0, 271, 0, 0, 0
1748, 1, 1636428487005, 1636428487273, 268, 0, 268, 0, 0, 0
1750, 1, 1636428487073, 1636428487349, 276, 1, 275, 0, 0, 0
1751, 1, 1636428487073, 1636428487349, 276, 1, 275, 1, 0, 1
1752, 1, 1636428487222, 1636428487490, 268, 0, 268, 0, 0, 0
1753, 1, 1636428487425, 1636428487690, 265, 1, 264, 0, 0, 0
1754, 1, 1636428487561, 1636428487833, 272, 1, 271, 0, 0, 0
1755, 1, 1636428487649, 1636428487917, 268, 1, 267, 0, 1, 1
1756, 1, 1636428487717, 1636428487994, 277, 1, 276, 0, 0, 0
1757, 1, 1636428488010, 1636428488277, 267, 0, 267, 0, 0, 0
1759, 1, 1636428488173, 1636428488442, 269, 1, 268, 0, 0, 0
1760, 1, 1636428488197, 1636428488461, 264, 1, 263, 0, 1, 1
1761, 1, 1636428488229, 1636428488498, 269, 0, 269, 0, 0, 0
1758, 1, 1636428488281, 1636428488545, 264, 1, 263, 0, 1, 1
1763, 1, 1636428488434, 1636428488706, 272, 0, 272, 0, 0, 0
1762, 1, 1636428488501, 1636428488770, 269, 1, 268, 0, 0, 0
1764, 1, 1636428488597, 1636428488865, 268, 1, 267, 0, 1, 1
1765, 1, 1636428488741, 1636428489010, 269, 1, 268, 0, 1, 1
1766, 1, 1636428488769, 1636428489034, 265, 1, 264, 0, 0, 0
1767, 1, 1636428488857, 1636428489126, 269, 1, 268, 0, 1, 1
1769, 1, 1636428488993, 1636428489261, 268, 1, 267, 0, 1, 1
1768, 1, 1636428489021, 1636428489289, 268, 1, 267, 0, 0, 0
1771, 1, 1636428489106, 1636428489373, 267, 0, 267, 0, 0, 0
1770, 1, 1636428489129, 1636428489401, 272, 1, 271, 0, 1, 1
1772, 1, 1636428489305, 1636428489573, 268, 1, 267, 0, 0, 0
1773, 1, 1636428489333, 1636428489601, 268, 1, 267, 0, 0, 0
1774, 1, 1636428489541, 1636428489813, 272, 1, 271, 1, 0, 1
1775, 1, 1636428489601, 1636428489874, 273, 1, 272, 0, 0, 0
1776, 1, 1636428489741, 1636428490010, 269, 1, 268, 0, 1, 1
1777, 1, 1636428489905, 1636428490178, 273, 1, 272, 0, 0, 0
1779, 1, 1636428490158, 1636428490425, 267, 0, 267, 0, 0, 0
1778, 1, 1636428490181, 1636428490449, 268, 1, 267, 0, 1, 1
1780, 1, 1636428490242, 1636428490509, 267, 0, 267, 0, 0, 0
1781, 1, 1636428490253, 1636428490517, 264, 1, 263, 1, 0, 1
1782, 1, 1636428490457, 1636428490730, 273, 1, 272, 0, 0, 0
1784, 1, 1636428490489, 1636428490758, 269, 1, 268, 0, 1, 1
1783, 1, 1636428490517, 1636428490789, 272, 1, 271, 0, 0, 0
1785, 1, 1636428490805, 1636428491073, 268, 1, 267, 0, 0, 0
1786, 1, 1636428490825, 1636428491094, 269, 1, 268, 0, 0, 0
1787, 1, 1636428490837, 1636428491110, 273, 1, 272, 0, 1, 1
1788, 1, 1636428490929, 1636428491205, 276, 1, 275, 0, 1, 1
1789, 1, 1636428491101, 1636428491370, 269, 0, 269, 0, 0, 0
1790, 1, 1636428491110, 1636428491386, 276, 1, 275, 0, 1, 1
1792, 1, 1636428491189, 1636428491457, 268, 1, 267, 0, 0, 0
1791, 1, 1636428491190, 1636428491461, 271, 0, 271, 0, 0, 0
1793, 1, 1636428491297, 1636428491570, 273, 1, 272, 1, 0, 1
1794, 1, 1636428491549, 1636428491817, 268, 1, 267, 1, 0, 1
1795, 1, 1636428491689, 1636428491957, 268, 1, 267, 0, 1, 1
1796, 1, 1636428491801, 1636428492069, 268, 1, 267, 0, 0, 0
1797, 1, 1636428491929, 1636428492201, 272, 1, 271, 0, 0, 0
1799, 1, 1636428492205, 1636428492469, 264, 1, 263, 1, 0, 1
1798, 1, 1636428492205, 1636428492477, 272, 1, 271, 1, 0, 1
1800, 1, 1636428492205, 1636428492477, 272, 1, 271, 0, 0, 0
1801, 1, 1636428492369, 1636428492633, 264, 0, 264, 0, 0, 0
1803, 1, 1636428492501, 1636428492769, 268, 1, 267, 0, 0, 0
1802, 1, 1636428492505, 1636428492777, 272, 1, 271, 0, 0, 0
1804, 1, 1636428492637, 1636428492913, 276, 1, 275, 1, 0, 1
1805, 1, 1636428492813, 1636428493089, 276, 1, 275, 0, 0, 0
1806, 1, 1636428492913, 1636428493177, 264, 1, 263, 1, 0, 1
1807, 1, 1636428492925, 1636428493198, 273, 0, 273, 0, 0, 0
1809, 1, 1636428493065, 1636428493333, 268, 1, 267, 0, 1, 1
1811, 1, 1636428493081, 1636428493350, 269, 1, 268, 0, 0, 0
1808, 1, 1636428493093, 1636428493366, 273, 1, 272, 0, 1, 1
1812, 1, 1636428493194, 1636428493462, 268, 0, 268, 0, 0, 0
1810, 1, 1636428493201, 1636428493474, 273, 1, 272, 0, 1, 1
1813, 1, 1636428493305, 1636428493573, 268, 1, 267, 0, 0, 0
1814, 1, 1636428493661, 1636428493930, 269, 1, 268, 0, 1, 1
1815, 1, 1636428493769, 1636428494037, 268, 1, 267, 0, 1, 1
1816, 1, 1636428493773, 1636428494041, 268, 1, 267, 0, 1, 1
1817, 1, 1636428494010, 1636428494281, 271, 0, 271, 0, 0, 0
1818, 1, 1636428494121, 1636428494389, 268, 1, 267, 0, 0, 0
1819, 1, 1636428494214, 1636428494486, 272, 0, 272, 0, 0, 0
1820, 1, 1636428494286, 1636428494553, 267, 0, 267, 0, 0, 0
1821, 1, 1636428494286, 1636428494566, 280, 0, 280, 0, 0, 0
1823, 1, 1636428494546, 1636428494814, 268, 0, 268, 0, 0, 0
1824, 1, 1636428494557, 1636428494829, 272, 0, 272, 0, 0, 0
1822, 1, 1636428494565, 1636428494833, 268, 1, 267, 0, 0, 0
1826, 1, 1636428494822, 1636428495089, 267, 0, 267, 0, 0, 0
1825, 1, 1636428494841, 1636428495114, 273, 1, 272, 1, 0, 1
1827, 1, 1636428495005, 1636428495273, 268, 1, 267, 0, 0, 0
1828, 1, 1636428495097, 1636428495361, 264, 0, 264, 0, 0, 0
1829, 1, 1636428495101, 1636428495365, 264, 0, 264, 0, 0, 0
1830, 1, 1636428495126, 1636428495390, 264, 0, 264, 0, 0, 0
1832, 1, 1636428495222, 1636428495489, 267, 0, 267, 0, 0, 0
1831, 1, 1636428495277, 1636428495549, 272, 1, 271, 0, 0, 0
1833, 1, 1636428495313, 1636428495585, 272, 1, 271, 0, 0, 0
1834, 1, 1636428495621, 1636428495890, 269, 0, 269, 0, 0, 0
1835, 1, 1636428495797, 1636428496070, 273, 1, 272, 0, 0, 0
1836, 1, 1636428495818, 1636428496093, 275, 0, 275, 0, 0, 0
1837, 1, 1636428496085, 1636428496354, 269, 1, 268, 0, 0, 0
1838, 1, 1636428496130, 1636428496406, 276, 0, 276, 0, 0, 0
1839, 1, 1636428496189, 1636428496462, 273, 1, 272, 0, 0, 0
1840, 1, 1636428496361, 1636428496633, 272, 0, 272, 0, 0, 0
1841, 1, 1636428496373, 1636428496641, 268, 0, 268, 0, 0, 0
1842, 1, 1636428496509, 1636428496778, 269, 1, 268, 0, 0, 0
1844, 1, 1636428496617, 1636428496881, 264, 1, 263, 0, 1, 1
1843, 1, 1636428496649, 1636428496926, 277, 1, 276, 0, 1, 1
1845, 1, 1636428496741, 1636428497014, 273, 1, 272, 0, 0, 0
1846, 1, 1636428496929, 1636428497193, 264, 1, 263, 0, 0, 0
1847, 1, 1636428497013, 1636428497281, 268, 1, 267, 0, 0, 0
1848, 1, 1636428497041, 1636428497310, 269, 0, 269, 0, 0, 0
1849, 1, 1636428497153, 1636428497422, 269, 1, 268, 0, 1, 1
1851, 1, 1636428497213, 1636428497481, 268, 1, 267, 0, 1, 1
1850, 1, 1636428497310, 1636428497581, 271, 0, 271, 0, 0, 0
1852, 1, 1636428497325, 1636428497594, 269, 1, 268, 0, 0, 0
1853, 1, 1636428497386, 1636428497654, 268, 0, 268, 0, 0, 0
1854, 1, 1636428497669, 1636428497933, 264, 1, 263, 1, 0, 1
1855, 1, 1636428497789, 1636428498062, 273, 1, 272, 0, 0, 0
1856, 1, 1636428497805, 1636428498078, 273, 0, 273, 0, 0, 0
1857, 1, 1636428497954, 1636428498226, 272, 0, 272, 0, 0, 0
1858, 1, 1636428498201, 1636428498470, 269, 1, 268, 0, 0, 0
1859, 1, 1636428498205, 1636428498473, 268, 1, 267, 1, 0, 1
1860, 1, 1636428498226, 1636428498493, 267, 1, 266, 0, 0, 0
1861, 1, 1636428498433, 1636428498697, 264, 0, 264, 0, 0, 0
1862, 1, 1636428498566, 1636428498838, 272, 0, 272, 0, 0, 0
1863, 1, 1636428498566, 1636428498846, 280, 0, 280, 0, 0, 0
1864, 1, 1636428498701, 1636428498973, 272, 1, 271, 1, 0, 1
1865, 1, 1636428498810, 1636428499078, 268, 0, 268, 0, 0, 0
1866, 1, 1636428498981, 1636428499249, 268, 1, 267, 0, 0, 0
1867, 1, 1636428499085, 1636428499353, 268, 1, 267, 0, 0, 0
1868, 1, 1636428499093, 1636428499366, 273, 1, 272, 0, 0, 0
1869, 1, 1636428499141, 1636428499410, 269, 1, 268, 0, 1, 1
1871, 1, 1636428499269, 1636428499538, 269, 1, 268, 1, 0, 1
1872, 1, 1636428499337, 1636428499605, 268, 1, 267, 0, 0, 0
1870, 1, 1636428499373, 1636428499645, 272, 1, 271, 0, 1, 1
1873, 1, 1636428499413, 1636428499682, 269, 1, 268, 1, 0, 1
1874, 1, 1636428499585, 1636428499861, 276, 1, 275, 0, 0, 0
1875, 1, 1636428499741, 1636428500014, 273, 1, 272, 0, 0, 0
1876, 1, 1636428499858, 1636428500133, 275, 0, 275, 0, 0, 0
1877, 1, 1636428500045, 1636428500314, 269, 1, 268, 0, 1, 1
1878, 1, 1636428500081, 1636428500350, 269, 1, 268, 1, 0, 1
1879, 1, 1636428500225, 1636428500498, 273, 1, 272, 0, 1, 1
1880, 1, 1636428500317, 1636428500585, 268, 0, 268, 0, 0, 0
1881, 1, 1636428500317, 1636428500585, 268, 1, 267, 0, 0, 0
1882, 1, 1636428500533, 1636428500801, 268, 0, 268, 0, 0, 0
1883, 1, 1636428500622, 1636428500890, 268, 0, 268, 0, 0, 0
1884, 1, 1636428500630, 1636428500897, 267, 0, 267, 0, 0, 0
1885, 1, 1636428500825, 1636428501097, 272, 1, 271, 0, 0, 0
1886, 1, 1636428500893, 1636428501162, 269, 1, 268, 1, 0, 1
1887, 1, 1636428501021, 1636428501290, 269, 1, 268, 0, 1, 1
1888, 1, 1636428501033, 1636428501306, 273, 1, 272, 0, 1, 1
1889, 1, 1636428501137, 1636428501410, 273, 1, 272, 0, 1, 1
1891, 1, 1636428501185, 1636428501454, 269, 1, 268, 1, 0, 1
1892, 1, 1636428501265, 1636428501537, 272, 0, 272, 0, 0, 0
1893, 1, 1636428501293, 1636428501561, 268, 1, 267, 0, 1, 1
1890, 1, 1636428501313, 1636428501585, 272, 1, 271, 0, 0, 0
1894, 1, 1636428501654, 1636428501922, 268, 0, 268, 0, 0, 0
1895, 1, 1636428501877, 1636428502149, 272, 1, 271, 0, 1, 1
1896, 1, 1636428501877, 1636428502149, 272, 1, 271, 0, 1, 1
1897, 1, 1636428502105, 1636428502374, 269, 1, 268, 0, 1, 1
1898, 1, 1636428502161, 1636428502429, 268, 0, 268, 0, 0, 0
1899, 1, 1636428502194, 1636428502462, 268, 0, 268, 0, 0, 0
1901, 1, 1636428502429, 1636428502697, 268, 0, 268, 0, 0, 0
1900, 1, 1636428502433, 1636428502706, 273, 0, 273, 0, 0, 0
1902, 1, 1636428502442, 1636428502706, 264, 0, 264, 0, 0, 0
1903, 1, 1636428502721, 1636428502989, 268, 1, 267, 0, 0, 0
1904, 1, 1636428502753, 1636428503026, 273, 1, 272, 0, 0, 0
1905, 1, 1636428502761, 1636428503026, 265, 1, 264, 0, 1, 1
1906, 1, 1636428502921, 1636428503194, 273, 1, 272, 0, 0, 0
1908, 1, 1636428503022, 1636428503290, 268, 0, 268, 0, 0, 0
1909, 1, 1636428503153, 1636428503426, 273, 1, 272, 0, 1, 1
1911, 1, 1636428503213, 1636428503482, 269, 1, 268, 1, 0, 1
1912, 1, 1636428503309, 1636428503582, 273, 1, 272, 0, 0, 0
1913, 1, 1636428503401, 1636428503670, 269, 1, 268, 0, 0, 0
1910, 1, 1636428503429, 1636428503697, 268, 1, 267, 0, 1, 1
1914, 1, 1636428503677, 1636428503942, 265, 1, 264, 0, 0, 0
1915, 1, 1636428503765, 1636428504033, 268, 1, 267, 0, 0, 0
1916, 1, 1636428503922, 1636428504190, 268, 0, 268, 0, 0, 0
1917, 1, 1636428504133, 1636428504401, 268, 1, 267, 0, 1, 1
1918, 1, 1636428504217, 1636428504489, 272, 1, 271, 0, 1, 1
1921, 1, 1636428504349, 1636428504617, 268, 0, 268, 0, 0, 0
1920, 1, 1636428504405, 1636428504673, 268, 0, 268, 0, 0, 0
1922, 1, 1636428504478, 1636428504753, 275, 0, 275, 0, 0, 0
1923, 1, 1636428504629, 1636428504898, 269, 1, 268, 0, 0, 0
1924, 1, 1636428504769, 1636428505038, 269, 0, 269, 0, 0, 0
1925, 1, 1636428504781, 1636428505049, 268, 0, 268, 0, 0, 0
1926, 1, 1636428504814, 1636428505093, 279, 0, 279, 0, 0, 0
1927, 1, 1636428505129, 1636428505397, 268, 1, 267, 0, 0, 0
1928, 1, 1636428505206, 1636428505474, 268, 0, 268, 0, 0, 0
1930, 1, 1636428505321, 1636428505590, 269, 1, 268, 0, 0, 0
1931, 1, 1636428505429, 1636428505697, 268, 1, 267, 0, 0, 0
1929, 1, 1636428505477, 1636428505745, 268, 0, 268, 0, 0, 0
1933, 1, 1636428505557, 1636428505830, 273, 1, 272, 1, 0, 1
1934, 1, 1636428505822, 1636428506089, 267, 0, 267, 0, 0, 0
1935, 1, 1636428505990, 1636428506262, 272, 0, 272, 0, 0, 0
1939, 1, 1636428506378, 1636428506650, 272, 0, 272, 0, 0, 0
1940, 1, 1636428506406, 1636428506673, 267, 0, 267, 0, 0, 0
1941, 1, 1636428506705, 1636428506974, 269, 1, 268, 1, 0, 1
1942, 1, 1636428506761, 1636428507030, 269, 1, 268, 0, 1, 1
1944, 1, 1636428506938, 1636428507206, 268, 0, 268, 0, 0, 0
1945, 1, 1636428507210, 1636428507477, 267, 0, 267, 0, 0, 0
1947, 1, 1636428507274, 1636428507546, 272, 0, 272, 0, 0, 0
1949, 1, 1636428507434, 1636428507702, 268, 0, 268, 0, 0, 0
1948, 1, 1636428507549, 1636428507817, 268, 0, 268, 0, 0, 0
1950, 1, 1636428507613, 1636428507885, 272, 0, 272, 0, 0, 0
1951, 1, 1636428507929, 1636428508202, 273, 1, 272, 1, 0, 1
1953, 1, 1636428508249, 1636428508517, 268, 1, 267, 0, 0, 0
1954, 1, 1636428508510, 1636428508778, 268, 0, 268, 0, 0, 0
1955, 1, 1636428508773, 1636428509045, 272, 1, 271, 0, 1, 1
1956, 1, 1636428508862, 1636428509129, 267, 0, 267, 0, 0, 0
1957, 1, 1636428508874, 1636428509141, 267, 0, 267, 0, 0, 0
1958, 1, 1636428509209, 1636428509482, 273, 1, 272, 0, 0, 0
1961, 1, 1636428509441, 1636428509710, 269, 0, 269, 0, 0, 0
1959, 1, 1636428509485, 1636428509754, 269, 1, 268, 1, 0, 1
1963, 1, 1636428509809, 1636428510078, 269, 1, 268, 0, 0, 0
1964, 1, 1636428510214, 1636428510490, 276, 0, 276, 0, 0, 0
1965, 1, 1636428510449, 1636428510721, 272, 0, 272, 0, 0, 0
1966, 1, 1636428510649, 1636428510922, 273, 1, 272, 1, 0, 1
1967, 1, 1636428510818, 1636428511089, 271, 0, 271, 0, 0, 0
1968, 1, 1636428510821, 1636428511093, 272, 1, 271, 1, 0, 1
1969, 1, 1636428511125, 1636428511398, 273, 1, 272, 0, 0, 0
1970, 1, 1636428511401, 1636428511674, 273, 0, 273, 0, 0, 0
1971, 1, 1636428511481, 1636428511750, 269, 1, 268, 0, 0, 0
1972, 1, 1636428511709, 1636428511978, 269, 1, 268, 1, 0, 1
1973, 1, 1636428512301, 1636428512570, 269, 1, 268, 0, 0, 0
1974, 1, 1636428512354, 1636428512622, 268, 0, 268, 0, 0, 0
1976, 1, 1636428512806, 1636428513073, 267, 0, 267, 0, 0, 0
1907, 2, 1636428503026, 1636428513074, 10048, 0, 10048, 0, 0, 0
1977, 1, 1636428512926, 1636428513206, 280, 0, 280, 0, 0, 0
1978, 1, 1636428513121, 1636428513390, 269, 1, 268, 1, 0, 1
1937, 1, 1636428513121, 1636428513393, 272, 1, 271, 1, 0, 1
1980, 1, 1636428513469, 1636428513742, 273, 1, 272, 0, 0, 0
1981, 1, 1636428513477, 1636428513745, 268, 1, 267, 0, 0, 0
1982, 1, 1636428513629, 1636428513897, 268, 0, 268, 0, 0, 0
1983, 1, 1636428513853, 1636428514122, 269, 1, 268, 1, 0, 1
1984, 1, 1636428514197, 1636428514474, 277, 1, 276, 1, 0, 1
1985, 1, 1636428514373, 1636428514642, 269, 1, 268, 0, 0, 0
1986, 1, 1636428514689, 1636428514957, 268, 1, 267, 1, 0, 1
1987, 1, 1636428514909, 1636428515178, 269, 1, 268, 1, 0, 1
1988, 1, 1636428514941, 1636428515209, 268, 1, 267, 1, 0, 1
1989, 1, 1636428515410, 1636428515681, 271, 0, 271, 0, 0, 0
1990, 1, 1636428515502, 1636428515769, 267, 0, 267, 0, 0, 0
1991, 1, 1636428515678, 1636428515946, 268, 0, 268, 0, 0, 0
1992, 1, 1636428515862, 1636428516134, 272, 0, 272, 0, 0, 0
1993, 1, 1636428516098, 1636428516402, 304, 0, 304, 0, 0, 0
1994, 1, 1636428516433, 1636428516709, 276, 1, 275, 1, 0, 1
1995, 1, 1636428516733, 1636428517037, 304, 1, 303, 0, 1, 1
1996, 1, 1636428516793, 1636428517062, 269, 1, 268, 1, 0, 1
1997, 1, 1636428516986, 1636428517254, 268, 0, 268, 0, 0, 0
1998, 1, 1636428517462, 1636428517730, 268, 0, 268, 0, 0, 0
1999, 1, 1636428517557, 1636428517822, 265, 1, 264, 0, 0, 0
2000, 1, 1636428517625, 1636428517894, 269, 1, 268, 0, 0, 0
2001, 1, 1636428517909, 1636428518178, 269, 1, 268, 0, 0, 0
2002, 1, 1636428518014, 1636428518282, 268, 0, 268, 0, 0, 0
2003, 1, 1636428518378, 1636428518646, 268, 0, 268, 0, 0, 0
2004, 1, 1636428518666, 1636428518938, 272, 0, 272, 0, 0, 0
2005, 1, 1636428518713, 1636428518982, 269, 1, 268, 1, 0, 1
2006, 1, 1636428518862, 1636428519142, 280, 0, 280, 0, 0, 0
2007, 1, 1636428519542, 1636428519810, 268, 0, 268, 0, 0, 0
2008, 1, 1636428519605, 1636428519874, 269, 0, 269, 0, 0, 0
2009, 1, 1636428519694, 1636428519965, 271, 0, 271, 0, 0, 0
2010, 1, 1636428519974, 1636428520246, 272, 0, 272, 0, 0, 0
2011, 1, 1636428520130, 1636428520398, 268, 0, 268, 0, 0, 0
2012, 1, 1636428520322, 1636428520593, 271, 0, 271, 0, 0, 0
2013, 1, 1636428520661, 1636428520933, 272, 1, 271, 0, 1, 1
2014, 1, 1636428520769, 1636428521042, 273, 1, 272, 1, 0, 1
2015, 1, 1636428520782, 1636428521054, 272, 0, 272, 0, 0, 0
2016, 1, 1636428521550, 1636428521817, 267, 0, 267, 0, 0, 0
2017, 1, 1636428521565, 1636428521833, 268, 1, 267, 0, 1, 1
2018, 1, 1636428521681, 1636428521953, 272, 1, 271, 1, 0, 1
2019, 1, 1636428521842, 1636428522110, 268, 0, 268, 0, 0, 0
2020, 1, 1636428522134, 1636428522402, 268, 0, 268, 0, 0, 0
2021, 1, 1636428522449, 1636428522726, 277, 1, 276, 0, 1, 1
2022, 1, 1636428522729, 1636428522998, 269, 1, 268, 0, 1, 1
2023, 1, 1636428522786, 1636428523054, 268, 0, 268, 0, 0, 0
2024, 1, 1636428522866, 1636428523133, 267, 0, 267, 0, 0, 0
2025, 1, 1636428523085, 1636428523353, 268, 1, 267, 0, 0, 0
1979, 2, 1636428513389, 1636428523526, 10137, 2, 10135, 0, 1, 1
2026, 1, 1636428523621, 1636428523885, 264, 1, 263, 1, 0, 1
2027, 1, 1636428523705, 1636428523973, 268, 1, 267, 0, 1, 1
2028, 1, 1636428523705, 1636428523982, 277, 1, 276, 0, 1, 1
2030, 1, 1636428523833, 1636428524102, 269, 1, 268, 0, 0, 0
2037, 1, 1636428523889, 1636428524166, 277, 1, 276, 0, 1, 1
2039, 1, 1636428523969, 1636428524237, 268, 1, 267, 0, 1, 1
2038, 1, 1636428523981, 1636428524261, 280, 1, 279, 0, 0, 0
2029, 1, 1636428524169, 1636428524446, 277, 1, 276, 0, 0, 0
2040, 1, 1636428524233, 1636428524501, 268, 1, 267, 1, 0, 1
2041, 1, 1636428524437, 1636428524705, 268, 1, 267, 0, 0, 0
2034, 1, 1636428524449, 1636428524722, 273, 1, 272, 1, 0, 1
2042, 1, 1636428524714, 1636428524986, 272, 0, 272, 0, 0, 0
2043, 1, 1636428524793, 1636428525062, 269, 1, 268, 1, 0, 1
2044, 1, 1636428524881, 1636428525154, 273, 1, 272, 0, 0, 0
2045, 1, 1636428525021, 1636428525294, 273, 1, 272, 0, 1, 1
2046, 1, 1636428525565, 1636428525834, 269, 1, 268, 1, 0, 1
2047, 1, 1636428525586, 1636428525858, 272, 0, 272, 0, 0, 0
2049, 1, 1636428525689, 1636428525953, 264, 1, 263, 1, 0, 1
2052, 1, 1636428525769, 1636428526038, 269, 1, 268, 1, 0, 1
2053, 1, 1636428525905, 1636428526178, 273, 1, 272, 0, 1, 1
2054, 1, 1636428525965, 1636428526233, 268, 1, 267, 0, 0, 0
2055, 1, 1636428526118, 1636428526390, 272, 0, 272, 0, 0, 0
2056, 1, 1636428526469, 1636428526737, 268, 1, 267, 0, 0, 0
2057, 1, 1636428526682, 1636428526954, 272, 0, 272, 0, 0, 0
2058, 1, 1636428526745, 1636428527021, 276, 1, 275, 0, 0, 0
2059, 1, 1636428526777, 1636428527041, 264, 1, 263, 0, 0, 0
2060, 1, 1636428527058, 1636428527330, 272, 0, 272, 0, 0, 0
2061, 1, 1636428527541, 1636428527813, 272, 1, 271, 0, 0, 0
2062, 1, 1636428527578, 1636428527846, 268, 0, 268, 0, 0, 0
2063, 1, 1636428527713, 1636428527989, 276, 0, 276, 0, 0, 0
2064, 1, 1636428527869, 1636428528138, 269, 1, 268, 0, 0, 0
2065, 1, 1636428527993, 1636428528270, 277, 1, 276, 0, 0, 0
2066, 1, 1636428528021, 1636428528293, 272, 1, 271, 1, 0, 1
2068, 1, 1636428528554, 1636428528826, 272, 0, 272, 0, 0, 0
2069, 1, 1636428528582, 1636428528850, 268, 0, 268, 0, 0, 0
2071, 1, 1636428528853, 1636428529122, 269, 1, 268, 0, 1, 1
2072, 1, 1636428528974, 1636428529242, 268, 0, 268, 0, 0, 0
2074, 1, 1636428529654, 1636428529922, 268, 0, 268, 0, 0, 0
2075, 1, 1636428529722, 1636428529989, 267, 0, 267, 0, 0, 0
2076, 1, 1636428529785, 1636428530053, 268, 1, 267, 0, 0, 0
2077, 1, 1636428529914, 1636428530182, 268, 0, 268, 0, 0, 0
2078, 1, 1636428530001, 1636428530270, 269, 0, 269, 0, 0, 0
2079, 1, 1636428530562, 1636428530833, 271, 0, 271, 0, 0, 0
2081, 1, 1636428530833, 1636428531106, 273, 1, 272, 1, 0, 1
2083, 1, 1636428531609, 1636428531877, 268, 1, 267, 0, 0, 0
2084, 1, 1636428531625, 1636428531898, 273, 0, 273, 0, 0, 0
2087, 1, 1636428531893, 1636428532162, 269, 1, 268, 0, 0, 0
2086, 1, 1636428531906, 1636428532177, 271, 0, 271, 0, 0, 0
2088, 1, 1636428532574, 1636428532846, 272, 0, 272, 0, 0, 0
2089, 1, 1636428532849, 1636428533126, 277, 1, 276, 0, 1, 1
2090, 1, 1636428533633, 1636428534062, 429, 1, 428, 0, 0, 0
2091, 1, 1636428533710, 1636428534150, 440, 0, 440, 0, 0, 0
2092, 1, 1636428533973, 1636428534246, 273, 1, 272, 0, 0, 0
2093, 1, 1636428534065, 1636428534333, 268, 1, 267, 0, 0, 0
2096, 1, 1636428534454, 1636428534726, 272, 0, 272, 0, 0, 0
2101, 1, 1636428535737, 1636428536005, 268, 0, 268, 0, 0, 0
2102, 1, 1636428535781, 1636428536058, 277, 1, 276, 0, 0, 0
2103, 1, 1636428535821, 1636428536090, 269, 1, 268, 1, 0, 1
2104, 1, 1636428536066, 1636428536338, 272, 0, 272, 0, 0, 0
2106, 1, 1636428536205, 1636428536478, 273, 1, 272, 0, 1, 1
2108, 1, 1636428536417, 1636428536690, 273, 1, 272, 0, 0, 0
2107, 1, 1636428536481, 1636428536754, 273, 1, 272, 0, 0, 0
2105, 1, 1636428536758, 1636428537034, 276, 0, 276, 0, 0, 0
2109, 1, 1636428537546, 1636428537817, 271, 0, 271, 0, 0, 0
2110, 1, 1636428537821, 1636428538089, 268, 1, 267, 0, 0, 0
2111, 1, 1636428537877, 1636428538178, 301, 1, 300, 1, 0, 1
2112, 1, 1636428538089, 1636428538361, 272, 1, 271, 0, 1, 1
2114, 1, 1636428538093, 1636428538365, 272, 1, 271, 0, 1, 1
2116, 1, 1636428538478, 1636428538746, 268, 0, 268, 0, 0, 0
2117, 1, 1636428538481, 1636428538750, 269, 1, 268, 0, 1, 1
2118, 1, 1636428539133, 1636428539406, 273, 1, 272, 0, 0, 0
2119, 1, 1636428539569, 1636428539845, 276, 0, 276, 0, 0, 0
2080, 1, 1636428539614, 1636428539890, 276, 0, 276, 0, 0, 0
2120, 1, 1636428539741, 1636428540013, 272, 1, 271, 1, 0, 1
2123, 1, 1636428539973, 1636428540242, 269, 1, 268, 0, 0, 0
2124, 1, 1636428540013, 1636428540286, 273, 1, 272, 0, 0, 0
2122, 1, 1636428540013, 1636428540286, 273, 1, 272, 1, 0, 1
2126, 1, 1636428540478, 1636428540749, 271, 0, 271, 0, 0, 0
2127, 1, 1636428540485, 1636428540753, 268, 1, 267, 0, 0, 0
2128, 1, 1636428541126, 1636428541393, 267, 0, 267, 0, 0, 0
2129, 1, 1636428541341, 1636428541609, 268, 1, 267, 1, 0, 1
2131, 1, 1636428541661, 1636428541941, 280, 0, 280, 0, 0, 0
2133, 1, 1636428541933, 1636428542201, 268, 0, 268, 0, 0, 0
2132, 1, 1636428541946, 1636428542214, 268, 0, 268, 0, 0, 0
2134, 1, 1636428541997, 1636428542269, 272, 0, 272, 0, 0, 0
2135, 1, 1636428542149, 1636428542417, 268, 1, 267, 1, 0, 1
2137, 1, 1636428542446, 1636428542718, 272, 0, 272, 0, 0, 0
2136, 1, 1636428542437, 1636428542718, 281, 1, 280, 0, 1, 1
2138, 1, 1636428543109, 1636428543378, 269, 1, 268, 1, 0, 1
2139, 1, 1636428543321, 1636428543593, 272, 1, 271, 1, 0, 1
2140, 1, 1636428543565, 1636428543838, 273, 1, 272, 1, 0, 1
2141, 1, 1636428543841, 1636428544113, 272, 1, 271, 0, 0, 0
2142, 1, 1636428543978, 1636428544246, 268, 0, 268, 0, 0, 0
2143, 1, 1636428543997, 1636428544266, 269, 1, 268, 1, 0, 1
2144, 1, 1636428544137, 1636428544406, 269, 1, 268, 1, 0, 1
2145, 1, 1636428544342, 1636428544789, 447, 0, 447, 0, 0, 0
2100, 1, 1636428544653, 1636428544926, 273, 0, 273, 0, 0, 0
2146, 1, 1636428544697, 1636428544969, 272, 1, 271, 0, 0, 0
2147, 1, 1636428544993, 1636428545262, 269, 1, 268, 1, 0, 1
2148, 1, 1636428545014, 1636428545285, 271, 0, 271, 0, 0, 0
2149, 1, 1636428545090, 1636428545358, 268, 0, 268, 0, 0, 0
2153, 1, 1636428545313, 1636428545585, 272, 1, 271, 0, 0, 0
2154, 1, 1636428545393, 1636428545669, 276, 1, 275, 0, 0, 0
2155, 1, 1636428545669, 1636428545938, 269, 1, 268, 1, 0, 1
2157, 1, 1636428545910, 1636428546177, 267, 0, 267, 0, 0, 0
2156, 1, 1636428545945, 1636428546214, 269, 1, 268, 1, 0, 1
2158, 1, 1636428546017, 1636428546286, 269, 0, 269, 0, 0, 0
2159, 1, 1636428546113, 1636428546382, 269, 1, 268, 0, 1, 1
2160, 1, 1636428546369, 1636428546637, 268, 1, 267, 1, 0, 1
2161, 1, 1636428546433, 1636428546701, 268, 0, 268, 0, 0, 0
2162, 1, 1636428547001, 1636428547269, 268, 1, 267, 0, 1, 1
2163, 1, 1636428547013, 1636428547282, 269, 1, 268, 0, 0, 0
2164, 1, 1636428547037, 1636428547314, 277, 1, 276, 1, 0, 1
2165, 1, 1636428547222, 1636428547493, 271, 0, 271, 0, 0, 0
2166, 1, 1636428547401, 1636428547673, 272, 0, 272, 0, 0, 0
2167, 1, 1636428547677, 1636428547945, 268, 0, 268, 0, 0, 0
2169, 1, 1636428547874, 1636428548161, 287, 0, 287, 0, 0, 0
2170, 1, 1636428547917, 1636428548202, 285, 1, 284, 0, 1, 1
2168, 1, 1636428547957, 1636428548253, 296, 0, 296, 0, 0, 0
2171, 1, 1636428548202, 1636428548466, 264, 0, 264, 0, 0, 0
2172, 1, 1636428548333, 1636428548606, 273, 1, 272, 0, 0, 0
2173, 1, 1636428548473, 1636428548745, 272, 1, 271, 0, 0, 0
2174, 1, 1636428548473, 1636428548745, 272, 1, 271, 0, 0, 0
2175, 1, 1636428548749, 1636428549022, 273, 1, 272, 0, 1, 1
2176, 1, 1636428548889, 1636428549157, 268, 1, 267, 0, 1, 1
2177, 1, 1636428549042, 1636428549310, 268, 0, 268, 0, 0, 0
2178, 1, 1636428549161, 1636428549430, 269, 1, 268, 1, 0, 1
2179, 1, 1636428549249, 1636428549517, 268, 1, 267, 1, 0, 1
2180, 1, 1636428549342, 1636428549614, 272, 0, 272, 0, 0, 0
2181, 1, 1636428549617, 1636428549894, 277, 0, 277, 0, 0, 0
2183, 1, 1636428549798, 1636428550097, 299, 0, 299, 0, 0, 0
2182, 1, 1636428549921, 1636428550189, 268, 1, 267, 0, 0, 0
2184, 1, 1636428549953, 1636428550222, 269, 1, 268, 0, 1, 1
2185, 1, 1636428550133, 1636428550402, 269, 0, 269, 0, 0, 0
2187, 1, 1636428550277, 1636428550541, 264, 0, 264, 0, 0, 0
2130, 1, 1636428550317, 1636428550581, 264, 0, 264, 0, 0, 0
2188, 1, 1636428550362, 1636428550625, 263, 0, 263, 0, 0, 0
2189, 1, 1636428550585, 1636428550849, 264, 0, 264, 0, 0, 0
2190, 1, 1636428550629, 1636428550901, 272, 0, 272, 0, 0, 0
2192, 1, 1636428550849, 1636428551114, 265, 1, 264, 0, 1, 1
2193, 1, 1636428550989, 1636428551253, 264, 1, 263, 0, 1, 1
2195, 1, 1636428551213, 1636428551482, 269, 1, 268, 0, 1, 1
2196, 1, 1636428551261, 1636428551533, 272, 0, 272, 0, 0, 0
2197, 1, 1636428551373, 1636428551646, 273, 1, 272, 0, 0, 0
2198, 1, 1636428551490, 1636428551758, 268, 0, 268, 0, 0, 0
2200, 1, 1636428551766, 1636428552034, 268, 0, 268, 0, 0, 0
2199, 1, 1636428551773, 1636428552045, 272, 1, 271, 1, 0, 1
2201, 1, 1636428552057, 1636428552325, 268, 1, 267, 0, 0, 0
2202, 1, 1636428552065, 1636428552337, 272, 1, 271, 0, 0, 0
2203, 1, 1636428552181, 1636428552450, 269, 1, 268, 0, 0, 0
2204, 1, 1636428552458, 1636428552729, 271, 0, 271, 0, 0, 0
2205, 1, 1636428552469, 1636428552738, 269, 1, 268, 1, 0, 1
2206, 1, 1636428552621, 1636428552889, 268, 1, 267, 0, 0, 0
2207, 1, 1636428552933, 1636428553206, 273, 1, 272, 0, 0, 0
2208, 1, 1636428553078, 1636428553346, 268, 0, 268, 0, 0, 0
2209, 1, 1636428553141, 1636428553409, 268, 1, 267, 1, 0, 1
2210, 1, 1636428553302, 1636428553574, 272, 0, 272, 0, 0, 0
2211, 1, 1636428553457, 1636428553729, 272, 1, 271, 0, 1, 1
2212, 1, 1636428553574, 1636428553846, 272, 1, 271, 1, 0, 1
2213, 1, 1636428553757, 1636428554025, 268, 1, 267, 0, 0, 0
2214, 1, 1636428553849, 1636428554117, 268, 0, 268, 0, 0, 0
2215, 1, 1636428553950, 1636428554218, 268, 0, 268, 0, 0, 0
2216, 1, 1636428554065, 1636428554338, 273, 1, 272, 1, 0, 1
2217, 1, 1636428554161, 1636428554438, 277, 1, 276, 0, 0, 0
2218, 1, 1636428554333, 1636428554602, 269, 1, 268, 1, 0, 1
2219, 1, 1636428554506, 1636428554773, 267, 0, 267, 0, 0, 0
2220, 1, 1636428554569, 1636428554842, 273, 1, 272, 0, 0, 0
2221, 1, 1636428554826, 1636428555230, 404, 0, 404, 0, 0, 0
2222, 1, 1636428554978, 1636428555325, 347, 0, 347, 0, 0, 0
2223, 1, 1636428555233, 1636428555497, 264, 0, 264, 0, 0, 0
2224, 1, 1636428555277, 1636428555546, 269, 1, 268, 1, 0, 1
2225, 1, 1636428555365, 1636428555629, 264, 1, 263, 1, 0, 1
2226, 1, 1636428555545, 1636428555813, 268, 1, 267, 0, 0, 0
2230, 1, 1636428555817, 1636428556089, 272, 1, 271, 0, 0, 0
2231, 1, 1636428555829, 1636428556097, 268, 1, 267, 0, 0, 0
2232, 1, 1636428555865, 1636428556133, 268, 1, 267, 0, 1, 1
2233, 1, 1636428556137, 1636428556406, 269, 1, 268, 0, 0, 0
2234, 1, 1636428556157, 1636428556429, 272, 1, 271, 1, 0, 1
2235, 1, 1636428556225, 1636428556504, 279, 1, 278, 0, 0, 0
2236, 1, 1636428556462, 1636428556738, 276, 0, 276, 0, 0, 0
2237, 1, 1636428556546, 1636428556817, 271, 0, 271, 0, 0, 0
2238, 1, 1636428556777, 1636428557054, 277, 0, 277, 0, 0, 0
2239, 1, 1636428557034, 1636428557301, 267, 0, 267, 0, 0, 0
2240, 1, 1636428557049, 1636428557322, 273, 1, 272, 0, 0, 0
2241, 1, 1636428557201, 1636428557469, 268, 1, 267, 0, 0, 0
2242, 1, 1636428557261, 1636428557530, 269, 1, 268, 0, 0, 0
2243, 1, 1636428557477, 1636428557745, 268, 1, 267, 0, 0, 0
2245, 1, 1636428557737, 1636428558006, 269, 1, 268, 0, 0, 0
2244, 1, 1636428557749, 1636428558022, 273, 1, 272, 0, 1, 1
2246, 1, 1636428557898, 1636428558165, 267, 0, 267, 0, 0, 0
2248, 1, 1636428558109, 1636428558374, 265, 1, 264, 0, 1, 1
2247, 1, 1636428558101, 1636428558374, 273, 1, 272, 0, 0, 0
2249, 1, 1636428558125, 1636428558397, 272, 1, 271, 0, 0, 0
2250, 1, 1636428558445, 1636428558717, 272, 1, 271, 1, 0, 1
2251, 1, 1636428558485, 1636428558753, 268, 0, 268, 0, 0, 0
2252, 1, 1636428558750, 1636428559021, 271, 0, 271, 0, 0, 0
2253, 1, 1636428559037, 1636428559305, 268, 0, 268, 0, 0, 0
2254, 1, 1636428559073, 1636428559349, 276, 1, 275, 0, 0, 0
2255, 1, 1636428559101, 1636428559373, 272, 1, 271, 1, 0, 1
2256, 1, 1636428559157, 1636428559426, 269, 1, 268, 0, 0, 0
2257, 1, 1636428559345, 1636428559621, 276, 5, 271, 5, 0, 5
2258, 1, 1636428559629, 1636428559898, 269, 0, 269, 0, 0, 0
2259, 1, 1636428559693, 1636428559962, 269, 0, 269, 0, 0, 0
2260, 1, 1636428559833, 1636428560101, 268, 0, 268, 0, 0, 0
2262, 1, 1636428559993, 1636428560262, 269, 1, 268, 0, 0, 0
2263, 1, 1636428560001, 1636428560270, 269, 1, 268, 0, 0, 0
2261, 1, 1636428559997, 1636428560273, 276, 1, 275, 0, 0, 0
2264, 1, 1636428560373, 1636428560650, 277, 1, 276, 0, 1, 1
2265, 1, 1636428560462, 1636428560729, 267, 0, 267, 0, 0, 0
2194, 1, 1636428560673, 1636428560946, 273, 0, 273, 0, 0, 0
2267, 1, 1636428560869, 1636428561146, 277, 1, 276, 0, 0, 0
2269, 1, 1636428560973, 1636428561242, 269, 1, 268, 0, 0, 0
2271, 1, 1636428561142, 1636428561406, 264, 0, 264, 0, 0, 0
2274, 1, 1636428561422, 1636428561689, 267, 0, 267, 0, 0, 0
2275, 1, 1636428561641, 1636428561910, 269, 1, 268, 0, 0, 0
2276, 1, 1636428561733, 1636428562005, 272, 0, 272, 0, 0, 0
2277, 1, 1636428561746, 1636428562014, 268, 0, 268, 0, 0, 0
2278, 1, 1636428561910, 1636428562177, 267, 0, 267, 0, 0, 0
2279, 1, 1636428561946, 1636428562214, 268, 0, 268, 0, 0, 0
2280, 1, 1636428562129, 1636428562402, 273, 0, 273, 0, 0, 0
2281, 1, 1636428562253, 1636428562526, 273, 1, 272, 0, 1, 1
2282, 1, 1636428562530, 1636428562802, 272, 0, 272, 0, 0, 0
2284, 1, 1636428562946, 1636428563217, 271, 0, 271, 0, 0, 0
2285, 1, 1636428563049, 1636428563322, 273, 1, 272, 0, 0, 0
2287, 1, 1636428563621, 1636428563894, 273, 1, 272, 0, 0, 0
2289, 1, 1636428563794, 1636428564062, 268, 0, 268, 0, 0, 0
2290, 1, 1636428563821, 1636428564090, 269, 1, 268, 0, 0, 0
2291, 1, 1636428563825, 1636428564098, 273, 1, 272, 1, 0, 1
2292, 1, 1636428564122, 1636428564390, 268, 0, 268, 0, 0, 0
2293, 1, 1636428564153, 1636428564422, 269, 1, 268, 0, 1, 1
2294, 1, 1636428564517, 1636428564785, 268, 1, 267, 0, 0, 0
2295, 1, 1636428565042, 1636428565314, 272, 0, 272, 0, 0, 0
2296, 1, 1636428565050, 1636428565322, 272, 0, 272, 0, 0, 0
2300, 1, 1636428565862, 1636428566130, 268, 1, 267, 0, 1, 1
2298, 1, 1636428565862, 1636428566130, 268, 1, 267, 0, 1, 1
2299, 1, 1636428565862, 1636428566130, 268, 1, 267, 0, 1, 1
2297, 1, 1636428565862, 1636428566133, 271, 1, 270, 0, 1, 1
2304, 1, 1636428566142, 1636428566406, 264, 0, 264, 0, 0, 0
2305, 1, 1636428566149, 1636428566417, 268, 1, 267, 1, 0, 1
2306, 1, 1636428566554, 1636428566826, 272, 0, 272, 0, 0, 0
2308, 1, 1636428567002, 1636428567270, 268, 0, 268, 0, 0, 0
2309, 1, 1636428567677, 1636428567938, 261, 0, 261, 0, 0, 0
2310, 1, 1636428567709, 1636428567974, 265, 0, 265, 0, 0, 0
2311, 1, 1636428567745, 1636428568013, 268, 1, 267, 0, 1, 1
2312, 1, 1636428567789, 1636428568057, 268, 1, 267, 0, 1, 1
2313, 1, 1636428568101, 1636428568366, 265, 0, 265, 0, 0, 0
2314, 1, 1636428568186, 1636428568453, 267, 0, 267, 0, 0, 0
2315, 1, 1636428568585, 1636428568857, 272, 1, 271, 1, 0, 1
2316, 1, 1636428568941, 1636428569218, 277, 1, 276, 0, 0, 0
2317, 1, 1636428569574, 1636428569841, 267, 0, 267, 0, 0, 0
2318, 1, 1636428569586, 1636428569853, 267, 0, 267, 0, 0, 0
2319, 1, 1636428569794, 1636428570062, 268, 0, 268, 0, 0, 0
2320, 1, 1636428570054, 1636428570322, 268, 0, 268, 0, 0, 0
2321, 1, 1636428570162, 1636428570438, 276, 0, 276, 0, 0, 0
2322, 1, 1636428570565, 1636428570858, 293, 1, 292, 1, 0, 1
2323, 1, 1636428571010, 1636428571282, 272, 0, 272, 0, 0, 0
2326, 1, 1636428571594, 1636428571862, 268, 0, 268, 0, 0, 0
2327, 1, 1636428571657, 1636428571930, 273, 1, 272, 0, 0, 0
2328, 1, 1636428571681, 1636428571954, 273, 1, 272, 0, 0, 0
2330, 1, 1636428572073, 1636428572341, 268, 0, 268, 0, 0, 0
2331, 1, 1636428572186, 1636428572458, 272, 0, 272, 0, 0, 0
2332, 1, 1636428572685, 1636428572966, 281, 1, 280, 1, 0, 1
2288, 1, 1636428573537, 1636428573814, 277, 1, 276, 1, 0, 1
2334, 1, 1636428573677, 1636428573950, 273, 1, 272, 0, 0, 0
2335, 1, 1636428573814, 1636428574082, 268, 0, 268, 0, 0, 0
2338, 1, 1636428574246, 1636428574522, 276, 0, 276, 0, 0, 0
2339, 1, 1636428574749, 1636428575017, 268, 0, 268, 0, 0, 0
2340, 1, 1636428575546, 1636428575814, 268, 0, 268, 0, 0, 0
2341, 1, 1636428575822, 1636428576094, 272, 0, 272, 0, 0, 0
2342, 1, 1636428576305, 1636428576573, 268, 1, 267, 0, 0, 0
2344, 1, 1636428576521, 1636428576790, 269, 1, 268, 1, 0, 1
2346, 1, 1636428576654, 1636428576926, 272, 0, 272, 0, 0, 0
2345, 1, 1636428576793, 1636428577062, 269, 0, 269, 0, 0, 0
2343, 1, 1636428577065, 1636428577334, 269, 0, 269, 0, 0, 0
2347, 1, 1636428577498, 1636428577766, 268, 0, 268, 0, 0, 0
2348, 1, 1636428577709, 1636428577982, 273, 1, 272, 0, 0, 0
2349, 1, 1636428578265, 1636428578533, 268, 1, 267, 1, 0, 1
2353, 1, 1636428578670, 1636428578942, 272, 0, 272, 0, 0, 0
2354, 1, 1636428579546, 1636428579817, 271, 0, 271, 0, 0, 0
2355, 1, 1636428579733, 1636428580006, 273, 0, 273, 0, 0, 0
2356, 1, 1636428580230, 1636428580497, 267, 0, 267, 0, 0, 0
2357, 1, 1636428580634, 1636428580902, 268, 0, 268, 0, 0, 0
2358, 1, 1636428581417, 1636428581686, 269, 0, 269, 0, 0, 0
2359, 1, 1636428581506, 1636428581777, 271, 0, 271, 0, 0, 0
2360, 1, 1636428581641, 1636428581906, 265, 1, 264, 0, 0, 0
2361, 1, 1636428581713, 1636428581985, 272, 1, 271, 0, 0, 0
2362, 1, 1636428582085, 1636428582354, 269, 1, 268, 1, 0, 1
2363, 1, 1636428582298, 1636428582570, 272, 0, 272, 0, 0, 0
2364, 1, 1636428582698, 1636428582970, 272, 0, 272, 0, 0, 0
2367, 1, 1636428583618, 1636428583926, 308, 0, 308, 0, 0, 0
2369, 1, 1636428583749, 1636428584022, 273, 1, 272, 0, 0, 0
2371, 1, 1636428584226, 1636428584493, 267, 0, 267, 0, 0, 0
2372, 1, 1636428584310, 1636428584578, 268, 0, 268, 0, 0, 0
2374, 1, 1636428584717, 1636428584986, 269, 1, 268, 0, 0, 0
2376, 1, 1636428585626, 1636428585894, 268, 0, 268, 0, 0, 0
2378, 1, 1636428586194, 1636428586462, 268, 0, 268, 0, 0, 0
2379, 1, 1636428586598, 1636428586866, 268, 0, 268, 0, 0, 0
2380, 1, 1636428587638, 1636428587906, 268, 0, 268, 0, 0, 0
2381, 1, 1636428588246, 1636428588582, 336, 0, 336, 0, 0, 0
2382, 1, 1636428588673, 1636428588942, 269, 1, 268, 0, 1, 1
2383, 1, 1636428588849, 1636428589117, 268, 1, 267, 1, 0, 1
2386, 1, 1636428589734, 1636428590002, 268, 0, 268, 0, 0, 0
2387, 1, 1636428590366, 1636428590638, 272, 0, 272, 0, 0, 0
2388, 1, 1636428590666, 1636428590938, 272, 0, 272, 0, 0, 0
2389, 1, 1636428590821, 1636428591094, 273, 0, 273, 0, 0, 0
2390, 1, 1636428591638, 1636428591906, 268, 0, 268, 0, 0, 0
2391, 1, 1636428592298, 1636428592566, 268, 0, 268, 0, 0, 0
2392, 1, 1636428592605, 1636428592877, 272, 1, 271, 1, 0, 1
2393, 1, 1636428592738, 1636428593010, 272, 0, 272, 0, 0, 0
2394, 1, 1636428593610, 1636428593878, 268, 0, 268, 0, 0, 0
2396, 1, 1636428593865, 1636428594133, 268, 1, 267, 0, 0, 0
2398, 1, 1636428594254, 1636428594526, 272, 0, 272, 0, 0, 0
2400, 1, 1636428594597, 1636428594870, 273, 1, 272, 1, 0, 1
2401, 1, 1636428594806, 1636428595074, 268, 0, 268, 0, 0, 0
2402, 1, 1636428595470, 1636428595754, 284, 0, 284, 0, 0, 0
2377, 1, 1636428595622, 1636428595890, 268, 0, 268, 0, 0, 0
2403, 1, 1636428595890, 1636428596158, 268, 1, 267, 1, 0, 1
2406, 1, 1636428596298, 1636428596566, 268, 0, 268, 0, 0, 0
2407, 1, 1636428596634, 1636428596906, 272, 0, 272, 0, 0, 0
2408, 1, 1636428596733, 1636428597006, 273, 1, 272, 0, 0, 0
2409, 1, 1636428597462, 1636428597733, 271, 0, 271, 0, 0, 0
2410, 1, 1636428597758, 1636428598030, 272, 0, 272, 0, 0, 0
2411, 1, 1636428598254, 1636428598526, 272, 0, 272, 0, 0, 0
2412, 1, 1636428598594, 1636428598946, 352, 0, 352, 0, 0, 0
2413, 1, 1636428598742, 1636428599037, 295, 0, 295, 0, 0, 0
2416, 1, 1636428599442, 1636428599710, 268, 0, 268, 0, 0, 0
2417, 1, 1636428599790, 1636428600061, 271, 0, 271, 0, 0, 0
2418, 1, 1636428600286, 1636428600554, 268, 0, 268, 0, 0, 0
2419, 1, 1636428600678, 1636428600949, 271, 0, 271, 0, 0, 0
2420, 1, 1636428600806, 1636428601078, 272, 0, 272, 0, 0, 0
2421, 1, 1636428601514, 1636428601790, 276, 0, 276, 0, 0, 0
2422, 1, 1636428601694, 1636428601970, 276, 0, 276, 0, 0, 0
2423, 1, 1636428602174, 1636428602441, 267, 0, 267, 0, 0, 0
2424, 1, 1636428602582, 1636428602849, 267, 0, 267, 0, 0, 0
2425, 1, 1636428602706, 1636428602978, 272, 0, 272, 0, 0, 0
2426, 1, 1636428603430, 1636428603706, 276, 0, 276, 0, 0, 0
2427, 1, 1636428603833, 1636428604134, 301, 1, 300, 0, 1, 1
2429, 1, 1636428604282, 1636428604566, 284, 0, 284, 0, 0, 0
2431, 1, 1636428604626, 1636428604898, 272, 0, 272, 0, 0, 0
2432, 1, 1636428604690, 1636428604962, 272, 0, 272, 0, 0, 0
2434, 1, 1636428605510, 1636428605778, 268, 0, 268, 0, 0, 0
2435, 1, 1636428605862, 1636428606130, 268, 0, 268, 0, 0, 0
2405, 1, 1636428605962, 1636428606229, 267, 0, 267, 0, 0, 0
2437, 1, 1636428606286, 1636428606557, 271, 0, 271, 0, 0, 0
2438, 1, 1636428606494, 1636428606769, 275, 0, 275, 0, 0, 0
2440, 1, 1636428606702, 1636428606974, 272, 0, 272, 0, 0, 0
2441, 1, 1636428607517, 1636428607789, 272, 0, 272, 0, 0, 0
2442, 1, 1636428607729, 1636428607998, 269, 1, 268, 0, 0, 0
2443, 1, 1636428608158, 1636428608434, 276, 0, 276, 0, 0, 0
2444, 1, 1636428608421, 1636428608690, 269, 1, 268, 0, 0, 0
2445, 1, 1636428608573, 1636428608846, 273, 1, 272, 0, 0, 0
2446, 1, 1636428609706, 1636428609978, 272, 0, 272, 0, 0, 0
2449, 1, 1636428610098, 1636428610370, 272, 0, 272, 0, 0, 0
2450, 1, 1636428610358, 1636428610626, 268, 0, 268, 0, 0, 0
2451, 1, 1636428610546, 1636428610814, 268, 0, 268, 0, 0, 0
2452, 1, 1636428611810, 1636428612082, 272, 0, 272, 0, 0, 0
2453, 1, 1636428612202, 1636428612469, 267, 0, 267, 0, 0, 0
2454, 1, 1636428612481, 1636428612750, 269, 1, 268, 1, 0, 1
2455, 1, 1636428612653, 1636428612926, 273, 1, 272, 0, 0, 0
2456, 1, 1636428613701, 1636428613970, 269, 1, 268, 0, 0, 0
2457, 1, 1636428614101, 1636428614390, 289, 1, 288, 0, 0, 0
2458, 1, 1636428614386, 1636428614654, 268, 0, 268, 0, 0, 0
2460, 1, 1636428614546, 1636428614814, 268, 0, 268, 0, 0, 0
2463, 1, 1636428615790, 1636428616062, 272, 0, 272, 0, 0, 0
2464, 1, 1636428616162, 1636428616446, 284, 0, 284, 0, 0, 0
2439, 1, 1636428616310, 1636428616582, 272, 0, 272, 0, 0, 0
2465, 1, 1636428616577, 1636428616846, 269, 1, 268, 0, 0, 0
2468, 1, 1636428617753, 1636428618030, 277, 1, 276, 0, 1, 1
2470, 1, 1636428618565, 1636428618838, 273, 1, 272, 0, 0, 0
2471, 1, 1636428619837, 1636428620106, 269, 1, 268, 0, 0, 0
2474, 1, 1636428620618, 1636428620894, 276, 0, 276, 0, 0, 0
2475, 1, 1636428621937, 1636428622210, 273, 1, 272, 0, 0, 0
2476, 1, 1636428622649, 1636428622917, 268, 1, 267, 0, 0, 0
2477, 1, 1636428623801, 1636428624070, 269, 0, 269, 0, 0, 0
2478, 1, 1636428624546, 1636428624822, 276, 0, 276, 0, 0, 0
2467, 1, 1636428626657, 1636428626926, 269, 1, 268, 0, 0, 0
2483, 1, 1636428637006, 1636428637274, 268, 0, 268, 0, 0, 0
2491, 1, 1636428640902, 1636428641174, 272, 0, 272, 0, 0, 0
2492, 1, 1636428641173, 1636428641445, 272, 1, 271, 1, 0, 1
2493, 1, 1636428642754, 1636428643026, 272, 0, 272, 0, 0, 0
2494, 1, 1636428643029, 1636428643302, 273, 1, 272, 0, 1, 1
2495, 1, 1636428644861, 1636428645137, 276, 1, 275, 1, 0, 1
2496, 1, 1636428645161, 1636428645430, 269, 1, 268, 0, 0, 0
2498, 1, 1636428645733, 1636428646002, 269, 1, 268, 1, 0, 1
2499, 1, 1636428646194, 1636428646466, 272, 0, 272, 0, 0, 0
2500, 1, 1636428646890, 1636428647157, 267, 0, 267, 0, 0, 0
2501, 1, 1636428647165, 1636428647437, 272, 1, 271, 1, 0, 1
2490, 1, 1636428647357, 1636428647626, 269, 1, 268, 0, 1, 1
2502, 1, 1636428647613, 1636428647881, 268, 1, 267, 0, 1, 1
2503, 1, 1636428647697, 1636428647965, 268, 1, 267, 0, 1, 1
2504, 1, 1636428648061, 1636428648329, 268, 1, 267, 0, 0, 0
2505, 1, 1636428648078, 1636428648346, 268, 0, 268, 0, 0, 0
2506, 1, 1636428648757, 1636428649030, 273, 1, 272, 0, 0, 0
2507, 1, 1636428649033, 1636428649310, 277, 1, 276, 0, 0, 0
2508, 1, 1636428649510, 1636428649782, 272, 0, 272, 0, 0, 0
2509, 1, 1636428649726, 1636428649998, 272, 0, 272, 0, 0, 0
2510, 1, 1636428649957, 1636428650230, 273, 0, 273, 0, 0, 0
2511, 1, 1636428650186, 1636428650454, 268, 0, 268, 0, 0, 0
2512, 1, 1636428650733, 1636428651002, 269, 1, 268, 1, 0, 1
2513, 1, 1636428651010, 1636428651278, 268, 0, 268, 0, 0, 0
2514, 1, 1636428651621, 1636428651894, 273, 1, 272, 0, 0, 0
2515, 1, 1636428651798, 1636428652070, 272, 0, 272, 0, 0, 0
2516, 1, 1636428652066, 1636428652334, 268, 0, 268, 0, 0, 0
2517, 1, 1636428652258, 1636428652533, 275, 0, 275, 0, 0, 0
2518, 1, 1636428652794, 1636428653062, 268, 0, 268, 0, 0, 0
2519, 1, 1636428653070, 1636428653341, 271, 0, 271, 0, 0, 0
2520, 1, 1636428653633, 1636428653902, 269, 1, 268, 0, 1, 1
2521, 1, 1636428653666, 1636428653934, 268, 0, 268, 0, 0, 0
2522, 1, 1636428654133, 1636428654405, 272, 1, 271, 1, 0, 1
2523, 1, 1636428654225, 1636428654494, 269, 1, 268, 1, 0, 1
2524, 1, 1636428654670, 1636428654938, 268, 0, 268, 0, 0, 0
2525, 1, 1636428654942, 1636428655214, 272, 0, 272, 0, 0, 0
2526, 1, 1636428655546, 1636428655814, 268, 0, 268, 0, 0, 0
2527, 1, 1636428655558, 1636428655829, 271, 0, 271, 0, 0, 0
2528, 1, 1636428656062, 1636428656330, 268, 0, 268, 0, 0, 0
2529, 1, 1636428656201, 1636428656470, 269, 1, 268, 0, 0, 0
2530, 1, 1636428656710, 1636428656978, 268, 0, 268, 0, 0, 0
2531, 1, 1636428656985, 1636428657258, 273, 1, 272, 0, 0, 0
2532, 1, 1636428657441, 1636428657714, 273, 1, 272, 0, 0, 0
2533, 1, 1636428657653, 1636428657922, 269, 1, 268, 0, 0, 0
2534, 1, 1636428657949, 1636428658221, 272, 1, 271, 0, 1, 1
2535, 1, 1636428658305, 1636428658578, 273, 0, 273, 0, 0, 0
2536, 1, 1636428659530, 1636428659797, 267, 0, 267, 0, 0, 0
2537, 1, 1636428659545, 1636428659814, 269, 1, 268, 0, 0, 0
2538, 1, 1636428660049, 1636428660318, 269, 0, 269, 0, 0, 0
2539, 1, 1636428660189, 1636428660453, 264, 1, 263, 0, 0, 0
2540, 1, 1636428661425, 1636428661701, 276, 1, 275, 1, 0, 1
2541, 1, 1636428661617, 1636428661886, 269, 1, 268, 0, 1, 1
2542, 1, 1636428661926, 1636428662194, 268, 0, 268, 0, 0, 0
2543, 1, 1636428662330, 1636428662602, 272, 0, 272, 0, 0, 0
2544, 1, 1636428663462, 1636428663734, 272, 0, 272, 0, 0, 0
2545, 1, 1636428664014, 1636428664282, 268, 0, 268, 0, 0, 0
