Xid, State, StartTime, EndTime, TransactionTime, ExecuteTime, CommunicationTime, ReadTime, WriteTime, DBTime
22, 1, 1636407292189, 1636407292675, 486, 78, 408, 34, 6, 40
24, 1, 1636407293014, 1636407293418, 404, 4, 400, 0, 1, 1
26, 1, 1636407293687, 1636407294094, 407, 3, 404, 1, 1, 2
28, 1, 1636407294358, 1636407294767, 409, 4, 405, 1, 1, 2
31, 1, 1636407295030, 1636407295438, 408, 4, 404, 2, 1, 3
33, 1, 1636407295706, 1636407296111, 405, 3, 402, 0, 0, 0
35, 1, 1636407296374, 1636407296779, 405, 4, 401, 1, 0, 1
37, 1, 1636407297042, 1636407297450, 408, 4, 404, 2, 0, 2
39, 1, 1636407297714, 1636407298126, 412, 4, 408, 2, 0, 2
41, 1, 1636407298386, 1636407298786, 400, 3, 397, 1, 0, 1
43, 1, 1636407299054, 1636407299458, 404, 3, 401, 2, 0, 2
45, 1, 1636407299722, 1636407300122, 400, 3, 397, 2, 1, 3
47, 1, 1636407300382, 1636407300778, 396, 2, 394, 1, 0, 1
49, 1, 1636407301042, 1636407301442, 400, 3, 397, 1, 0, 1
51, 1, 1636407301710, 1636407302106, 396, 3, 393, 2, 0, 2
53, 1, 1636407302370, 1636407302779, 409, 5, 404, 1, 0, 1
55, 1, 1636407303042, 1636407303398, 356, 3, 353, 2, 1, 3
57, 1, 1636407303666, 1636407304018, 352, 2, 350, 0, 1, 1
59, 1, 1636407304282, 1636407304638, 356, 3, 353, 1, 0, 1
61, 1, 1636407304902, 1636407305254, 352, 3, 349, 0, 0, 0
63, 1, 1636407305514, 1636407305870, 356, 2, 354, 2, 0, 2
65, 1, 1636407306134, 1636407306490, 356, 1, 355, 0, 0, 0
67, 1, 1636407306750, 1636407307102, 352, 3, 349, 0, 0, 0
69, 1, 1636407307362, 1636407307714, 352, 3, 349, 1, 0, 1
71, 1, 1636407307974, 1636407308326, 352, 3, 349, 0, 1, 1
73, 1, 1636407308590, 1636407308942, 352, 2, 350, 0, 1, 1
76, 1, 1636407309206, 1636407309558, 352, 1, 351, 0, 1, 1
79, 1, 1636407309818, 1636407310170, 352, 0, 352, 0, 0, 0
82, 1, 1636407310430, 1636407310782, 352, 1, 351, 0, 1, 1
85, 1, 1636407311042, 1636407311394, 352, 1, 351, 0, 1, 1
88, 1, 1636407311654, 1636407312010, 356, 0, 356, 0, 0, 0
91, 1, 1636407312270, 1636407312626, 356, 0, 356, 0, 0, 0
94, 1, 1636407312890, 1636407313242, 352, 1, 351, 1, 0, 1
96, 1, 1636407313506, 1636407313858, 352, 2, 350, 0, 0, 0
99, 1, 1636407314118, 1636407314470, 352, 2, 350, 0, 0, 0
102, 1, 1636407314730, 1636407315082, 352, 1, 351, 0, 1, 1
105, 1, 1636407315346, 1636407315698, 352, 0, 352, 0, 0, 0
108, 1, 1636407315958, 1636407316310, 352, 1, 351, 0, 1, 1
111, 1, 1636407316570, 1636407316922, 352, 2, 350, 0, 0, 0
114, 1, 1636407317190, 1636407317542, 352, 2, 350, 0, 0, 0
117, 1, 1636407317802, 1636407318154, 352, 0, 352, 0, 0, 0
120, 1, 1636407318414, 1636407318766, 352, 2, 350, 0, 0, 0
123, 1, 1636407319026, 1636407319378, 352, 3, 349, 0, 0, 0
126, 1, 1636407319642, 1636407319994, 352, 0, 352, 0, 0, 0
129, 1, 1636407320254, 1636407320606, 352, 0, 352, 0, 0, 0
132, 1, 1636407320866, 1636407321218, 352, 0, 352, 0, 0, 0
135, 1, 1636407321478, 1636407321830, 352, 1, 351, 0, 0, 0
138, 1, 1636407322090, 1636407322442, 352, 2, 350, 0, 0, 0
141, 1, 1636407322701, 1636407323054, 353, 1, 352, 0, 0, 0
144, 1, 1636407323314, 1636407323666, 352, 0, 352, 0, 0, 0
147, 1, 1636407323926, 1636407324278, 352, 1, 351, 0, 0, 0
150, 1, 1636407324538, 1636407324890, 352, 1, 351, 0, 0, 0
153, 1, 1636407325150, 1636407325502, 352, 1, 351, 0, 1, 1
156, 1, 1636407325762, 1636407326114, 352, 1, 351, 0, 0, 0
159, 1, 1636407326373, 1636407326726, 353, 2, 351, 1, 0, 1
162, 1, 1636407326986, 1636407327338, 352, 1, 351, 0, 0, 0
165, 1, 1636407327598, 1636407327950, 352, 1, 351, 1, 0, 1
168, 1, 1636407328210, 1636407328562, 352, 1, 351, 0, 0, 0
171, 1, 1636407328826, 1636407329182, 356, 0, 356, 0, 0, 0
174, 1, 1636407329442, 1636407329794, 352, 0, 352, 0, 0, 0
177, 1, 1636407330054, 1636407330406, 352, 1, 351, 0, 0, 0
180, 1, 1636407330666, 1636407331018, 352, 0, 352, 0, 0, 0
183, 1, 1636407331278, 1636407331626, 348, 1, 347, 0, 0, 0
186, 1, 1636407331885, 1636407332238, 353, 1, 352, 0, 0, 0
189, 1, 1636407332506, 1636407332866, 360, 5, 355, 3, 1, 4
192, 1, 1636407333126, 1636407333478, 352, 0, 352, 0, 0, 0
195, 1, 1636407333738, 1636407334090, 352, 0, 352, 0, 0, 0
198, 1, 1636407334349, 1636407334701, 352, 1, 351, 0, 0, 0
201, 1, 1636407334961, 1636407335314, 353, 1, 352, 0, 0, 0
204, 1, 1636407335574, 1636407335926, 352, 0, 352, 0, 0, 0
207, 1, 1636407336185, 1636407336533, 348, 1, 347, 0, 0, 0
210, 1, 1636407336793, 1636407337146, 353, 1, 352, 0, 0, 0
213, 1, 1636407337410, 1636407337762, 352, 0, 352, 0, 0, 0
216, 1, 1636407338022, 1636407338373, 351, 0, 351, 0, 0, 0
219, 1, 1636407338634, 1636407338986, 352, 0, 352, 0, 0, 0
222, 1, 1636407339246, 1636407339598, 352, 0, 352, 0, 0, 0
225, 1, 1636407339858, 1636407340210, 352, 0, 352, 0, 0, 0
228, 1, 1636407340470, 1636407340826, 356, 0, 356, 0, 0, 0
231, 1, 1636407341086, 1636407341438, 352, 0, 352, 0, 0, 0
233, 1, 1636407341698, 1636407342050, 352, 2, 350, 0, 0, 0
235, 1, 1636407342310, 1636407342662, 352, 0, 352, 0, 0, 0
237, 1, 1636407342922, 1636407343274, 352, 0, 352, 0, 0, 0
239, 1, 1636407343534, 1636407343894, 360, 3, 357, 0, 0, 0
241, 1, 1636407344149, 1636407344502, 353, 1, 352, 0, 0, 0
243, 1, 1636407344762, 1636407345114, 352, 1, 351, 0, 0, 0
245, 1, 1636407345374, 1636407345726, 352, 1, 351, 0, 0, 0
247, 1, 1636407345986, 1636407346338, 352, 1, 351, 0, 0, 0
249, 1, 1636407346598, 1636407346950, 352, 1, 351, 0, 0, 0
251, 1, 1636407347214, 1636407347566, 352, 1, 351, 0, 0, 0
253, 1, 1636407347826, 1636407348178, 352, 0, 352, 0, 0, 0
255, 1, 1636407348441, 1636407348794, 353, 1, 352, 0, 1, 1
257, 1, 1636407349054, 1636407349406, 352, 2, 350, 0, 0, 0
259, 1, 1636407349666, 1636407350018, 352, 0, 352, 0, 0, 0
261, 1, 1636407350278, 1636407350626, 348, 0, 348, 0, 0, 0
263, 1, 1636407350886, 1636407351234, 348, 0, 348, 0, 0, 0
265, 1, 1636407351494, 1636407351846, 352, 0, 352, 0, 0, 0
267, 1, 1636407352106, 1636407352457, 351, 1, 350, 0, 0, 0
269, 1, 1636407352722, 1636407353074, 352, 0, 352, 0, 0, 0
271, 1, 1636407353334, 1636407353686, 352, 1, 351, 0, 0, 0
273, 1, 1636407353946, 1636407354298, 352, 1, 351, 0, 0, 0
301, 1, 1636407605321, 1636407605710, 389, 13, 376, 0, 0, 0
302, 1, 1636407606010, 1636407606378, 368, 1, 367, 0, 0, 0
303, 1, 1636407606202, 1636407606554, 352, 0, 352, 0, 0, 0
304, 1, 1636407606858, 1636407607214, 356, 1, 355, 0, 0, 0
305, 1, 1636407606930, 1636407607290, 360, 2, 358, 1, 0, 1
306, 1, 1636407607042, 1636407607394, 352, 1, 351, 1, 0, 1
307, 1, 1636407607693, 1636407608042, 349, 1, 348, 1, 0, 1
308, 1, 1636407607774, 1636407608130, 356, 1, 355, 1, 0, 1
309, 1, 1636407608006, 1636407608357, 351, 0, 351, 0, 0, 0
310, 1, 1636407608401, 1636407608753, 352, 1, 351, 0, 1, 1
311, 1, 1636407608610, 1636407608970, 360, 0, 360, 0, 0, 0
312, 1, 1636407608798, 1636407609154, 356, 0, 356, 0, 0, 0
318, 1, 1636407864418, 1636407864778, 360, 0, 360, 0, 0, 0
319, 1, 1636407865178, 1636407865538, 360, 1, 359, 0, 0, 0
320, 1, 1636407865462, 1636407865822, 360, 0, 360, 0, 0, 0
321, 1, 1636407865938, 1636407866293, 355, 2, 353, 0, 0, 0
322, 1, 1636407866226, 1636407866498, 272, 1, 271, 0, 0, 0
323, 1, 1636407866513, 1636407866782, 269, 2, 267, 1, 0, 1
324, 1, 1636407866694, 1636407866965, 271, 0, 271, 0, 0, 0
325, 1, 1636407866898, 1636407867170, 272, 0, 272, 0, 0, 0
326, 1, 1636407867182, 1636407867450, 268, 0, 268, 0, 0, 0
327, 1, 1636407867366, 1636407867638, 272, 0, 272, 0, 0, 0
328, 1, 1636407867470, 1636407867746, 276, 0, 276, 0, 0, 0
329, 1, 1636407867574, 1636407867845, 271, 0, 271, 0, 0, 0
330, 1, 1636407867849, 1636407868118, 269, 1, 268, 0, 1, 1
331, 1, 1636407868038, 1636407868306, 268, 0, 268, 0, 0, 0
332, 1, 1636407868146, 1636407868418, 272, 0, 272, 0, 0, 0
333, 1, 1636407868246, 1636407868514, 268, 0, 268, 0, 0, 0
334, 1, 1636407868501, 1636407868774, 273, 1, 272, 1, 0, 1
335, 1, 1636407868517, 1636407868798, 281, 1, 280, 0, 1, 1
336, 1, 1636407868714, 1636407868986, 272, 0, 272, 0, 0, 0
337, 1, 1636407868826, 1636407869094, 268, 0, 268, 0, 0, 0
338, 1, 1636407868913, 1636407869185, 272, 1, 271, 0, 0, 0
339, 1, 1636407869189, 1636407869461, 272, 1, 271, 0, 0, 0
340, 1, 1636407869197, 1636407869469, 272, 1, 271, 0, 0, 0
341, 1, 1636407869385, 1636407869654, 269, 1, 268, 0, 0, 0
342, 1, 1636407869493, 1636407869766, 273, 1, 272, 0, 0, 0
343, 1, 1636407869590, 1636407869862, 272, 1, 271, 0, 1, 1
344, 1, 1636407869865, 1636407870138, 273, 1, 272, 0, 0, 0
345, 1, 1636407869877, 1636407870149, 272, 1, 271, 0, 0, 0
346, 1, 1636407870058, 1636407870329, 271, 0, 271, 0, 0, 0
347, 1, 1636407870169, 1636407870438, 269, 1, 268, 0, 0, 0
348, 1, 1636407870265, 1636407870530, 265, 1, 264, 1, 0, 1
349, 1, 1636407870533, 1636407870801, 268, 1, 267, 1, 0, 1
350, 1, 1636407870550, 1636407870822, 272, 0, 272, 0, 0, 0
351, 1, 1636407870730, 1636407870998, 268, 0, 268, 0, 0, 0
352, 1, 1636407870842, 1636407871114, 272, 0, 272, 0, 0, 0
353, 1, 1636407870937, 1636407871202, 265, 1, 264, 0, 0, 0
354, 1, 1636407871201, 1636407871469, 268, 1, 267, 1, 0, 1
355, 1, 1636407871221, 1636407871490, 269, 0, 269, 0, 0, 0
356, 1, 1636407871398, 1636407871669, 271, 0, 271, 0, 0, 0
357, 1, 1636407871513, 1636407871782, 269, 1, 268, 0, 0, 0
358, 1, 1636407871602, 1636407871866, 264, 0, 264, 0, 0, 0
359, 1, 1636407871870, 1636407872141, 271, 0, 271, 0, 0, 0
360, 1, 1636407871890, 1636407872158, 268, 0, 268, 0, 0, 0
361, 1, 1636407872069, 1636407872346, 277, 1, 276, 0, 0, 0
362, 1, 1636407872182, 1636407872450, 268, 0, 268, 0, 0, 0
363, 1, 1636407872266, 1636407872534, 268, 0, 268, 0, 0, 0
364, 1, 1636407872537, 1636407872802, 265, 1, 264, 0, 1, 1
365, 1, 1636407872562, 1636407872834, 272, 0, 272, 0, 0, 0
366, 1, 1636407872746, 1636407873010, 264, 0, 264, 0, 0, 0
367, 1, 1636407872858, 1636407873122, 264, 0, 264, 0, 0, 0
368, 1, 1636407872933, 1636407873206, 273, 0, 273, 0, 0, 0
369, 1, 1636407873202, 1636407873474, 272, 0, 272, 0, 0, 0
370, 1, 1636407873233, 1636407873498, 265, 1, 264, 0, 0, 0
371, 1, 1636407873410, 1636407873682, 272, 0, 272, 0, 0, 0
372, 1, 1636407873525, 1636407873798, 273, 1, 272, 0, 0, 0
373, 1, 1636407873606, 1636407873877, 271, 0, 271, 0, 0, 0
374, 1, 1636407873874, 1636407874142, 268, 0, 268, 0, 0, 0
375, 1, 1636407873898, 1636407874165, 267, 0, 267, 0, 0, 0
377, 1, 1636407874201, 1636407874481, 280, 1, 279, 1, 0, 1
378, 1, 1636407874277, 1636407874542, 265, 1, 264, 0, 1, 1
379, 1, 1636407874542, 1636407874809, 267, 0, 267, 0, 0, 0
380, 1, 1636407874569, 1636407874842, 273, 1, 272, 0, 1, 1
381, 1, 1636407874885, 1636407875158, 273, 1, 272, 0, 0, 0
383, 1, 1636407875209, 1636407875478, 269, 1, 268, 1, 0, 1
384, 1, 1636407875242, 1636407875509, 267, 0, 267, 0, 0, 0
385, 1, 1636407875553, 1636407875826, 273, 1, 272, 0, 0, 0
386, 1, 1636407875878, 1636407876145, 267, 0, 267, 0, 0, 0
388, 1, 1636407876226, 1636407876493, 267, 0, 267, 0, 0, 0
389, 1, 1636407876542, 1636407876814, 272, 0, 272, 0, 0, 0
391, 1, 1636407877210, 1636407877482, 272, 0, 272, 0, 0, 0
376, 2, 1636407874141, 1636407884194, 10053, 0, 10053, 0, 0, 0
