Xid, State, StartTime, EndTime, TransactionTime, ExecuteTime, CommunicationTime, ReadTime, WriteTime, DBTime
21, 1, 1636420162788, 1636420163324, 536, 111, 425, 50, 6, 56
24, 1, 1636420163666, 1636420164074, 408, 4, 404, 2, 1, 3
26, 1, 1636420164342, 1636420164751, 409, 3, 406, 1, 0, 1
28, 1, 1636420165014, 1636420165427, 413, 4, 409, 1, 1, 2
30, 1, 1636420165690, 1636420166098, 408, 4, 404, 1, 0, 1
32, 1, 1636420166362, 1636420166770, 408, 4, 404, 2, 0, 2
34, 1, 1636420167034, 1636420167442, 408, 4, 404, 3, 0, 3
36, 1, 1636420167710, 1636420168118, 408, 3, 405, 2, 0, 2
38, 1, 1636420168386, 1636420168798, 412, 4, 408, 2, 0, 2
40, 1, 1636420169062, 1636420169474, 412, 3, 409, 1, 0, 1
42, 1, 1636420169738, 1636420170146, 408, 3, 405, 2, 0, 2
44, 1, 1636420170410, 1636420170819, 409, 3, 406, 1, 0, 1
47, 1, 1636420171082, 1636420171490, 408, 3, 405, 1, 0, 1
49, 1, 1636420171754, 1636420172162, 408, 3, 405, 3, 0, 3
51, 1, 1636420172430, 1636420172838, 408, 3, 405, 1, 0, 1
53, 1, 1636420173106, 1636420173523, 417, 7, 410, 0, 0, 0
55, 1, 1636420173786, 1636420174150, 364, 3, 361, 2, 0, 2
57, 1, 1636420174422, 1636420174782, 360, 3, 357, 0, 1, 1
59, 1, 1636420175046, 1636420175410, 364, 3, 361, 2, 0, 2
61, 1, 1636420175674, 1636420176038, 364, 1, 363, 0, 1, 1
63, 1, 1636420176302, 1636420176662, 360, 2, 358, 0, 1, 1
65, 1, 1636420176926, 1636420177286, 360, 1, 359, 0, 1, 1
67, 1, 1636420177550, 1636420177910, 360, 1, 359, 0, 0, 0
69, 1, 1636420178174, 1636420178538, 364, 2, 362, 0, 1, 1
71, 1, 1636420178806, 1636420179170, 364, 2, 362, 0, 0, 0
73, 1, 1636420179438, 1636420179802, 364, 2, 362, 0, 0, 0
75, 1, 1636420180070, 1636420180434, 364, 2, 362, 0, 1, 1
77, 1, 1636420180698, 1636420181058, 360, 2, 358, 0, 0, 0
80, 1, 1636420181322, 1636420181682, 360, 3, 357, 1, 0, 1
83, 1, 1636420181946, 1636420182310, 364, 1, 363, 0, 0, 0
86, 1, 1636420182573, 1636420182942, 369, 1, 368, 0, 0, 0
88, 1, 1636420183206, 1636420183569, 363, 1, 362, 0, 0, 0
91, 1, 1636420183834, 1636420184198, 364, 2, 362, 0, 0, 0
94, 1, 1636420184462, 1636420184826, 364, 2, 362, 0, 1, 1
97, 1, 1636420185098, 1636420185462, 364, 1, 363, 0, 1, 1
100, 1, 1636420185726, 1636420186090, 364, 1, 363, 0, 1, 1
103, 1, 1636420186354, 1636420186717, 363, 1, 362, 0, 0, 0
106, 1, 1636420186982, 1636420187342, 360, 0, 360, 0, 0, 0
109, 1, 1636420187609, 1636420187974, 365, 2, 363, 1, 0, 1
112, 1, 1636420188238, 1636420188598, 360, 2, 358, 1, 0, 1
115, 1, 1636420188862, 1636420189222, 360, 1, 359, 0, 0, 0
118, 1, 1636420189486, 1636420189846, 360, 0, 360, 0, 0, 0
121, 1, 1636420190110, 1636420190474, 364, 1, 363, 0, 0, 0
124, 1, 1636420190738, 1636420191110, 372, 1, 371, 0, 0, 0
127, 1, 1636420191373, 1636420191737, 364, 3, 361, 3, 0, 3
129, 1, 1636420192006, 1636420192366, 360, 1, 359, 0, 0, 0
132, 1, 1636420192630, 1636420192994, 364, 0, 364, 0, 0, 0
135, 1, 1636420193258, 1636420193626, 368, 0, 368, 0, 0, 0
139, 1, 1636420193890, 1636420194258, 368, 1, 367, 0, 0, 0
142, 1, 1636420194522, 1636420194882, 360, 0, 360, 0, 0, 0
144, 1, 1636420195146, 1636420195510, 364, 0, 364, 0, 0, 0
148, 1, 1636420195774, 1636420196138, 364, 0, 364, 0, 0, 0
151, 1, 1636420196401, 1636420196762, 361, 1, 360, 0, 0, 0
154, 1, 1636420197026, 1636420197386, 360, 0, 360, 0, 0, 0
157, 1, 1636420197650, 1636420198014, 364, 0, 364, 0, 0, 0
159, 1, 1636420198278, 1636420198642, 364, 0, 364, 0, 0, 0
162, 1, 1636420198906, 1636420199266, 360, 2, 358, 0, 0, 0
165, 1, 1636420199530, 1636420199898, 368, 0, 368, 0, 0, 0
169, 1, 1636420200162, 1636420200526, 364, 0, 364, 0, 0, 0
172, 1, 1636420200790, 1636420201150, 360, 0, 360, 0, 0, 0
175, 1, 1636420201417, 1636420201782, 365, 2, 363, 1, 0, 1
178, 1, 1636420202046, 1636420202406, 360, 1, 359, 0, 0, 0
181, 1, 1636420202670, 1636420203034, 364, 0, 364, 0, 0, 0
184, 1, 1636420203298, 1636420203658, 360, 0, 360, 0, 0, 0
187, 1, 1636420203922, 1636420204282, 360, 2, 358, 0, 1, 1
189, 1, 1636420204546, 1636420204910, 364, 0, 364, 0, 0, 0
193, 1, 1636420205174, 1636420205534, 360, 0, 360, 0, 0, 0
195, 1, 1636420205798, 1636420206158, 360, 1, 359, 0, 0, 0
198, 1, 1636420206422, 1636420206782, 360, 0, 360, 0, 0, 0
201, 1, 1636420207046, 1636420207409, 363, 0, 363, 0, 0, 0
205, 1, 1636420207673, 1636420208034, 361, 1, 360, 1, 0, 1
208, 1, 1636420208298, 1636420208658, 360, 1, 359, 0, 0, 0
211, 1, 1636420208922, 1636420209282, 360, 1, 359, 0, 0, 0
214, 1, 1636420209546, 1636420209906, 360, 1, 359, 1, 0, 1
217, 1, 1636420210170, 1636420210530, 360, 0, 360, 0, 0, 0
220, 1, 1636420210798, 1636420211162, 364, 1, 363, 0, 0, 0
223, 1, 1636420211426, 1636420211790, 364, 1, 363, 0, 0, 0
226, 1, 1636420212054, 1636420212410, 356, 1, 355, 0, 0, 0
229, 1, 1636420212674, 1636420213034, 360, 1, 359, 0, 0, 0
232, 1, 1636420213298, 1636420213658, 360, 2, 358, 1, 0, 1
235, 1, 1636420213921, 1636420214282, 361, 1, 360, 0, 0, 0
238, 1, 1636420214562, 1636420214925, 363, 0, 363, 0, 0, 0
241, 1, 1636420215190, 1636420215558, 368, 0, 368, 0, 0, 0
244, 1, 1636420215822, 1636420216182, 360, 0, 360, 0, 0, 0
247, 1, 1636420216446, 1636420216810, 364, 0, 364, 0, 0, 0
250, 1, 1636420217074, 1636420217430, 356, 2, 354, 1, 0, 1
253, 1, 1636420217693, 1636420218054, 361, 3, 358, 0, 1, 1
256, 1, 1636420218318, 1636420218681, 363, 1, 362, 0, 0, 0
259, 1, 1636420218946, 1636420219314, 368, 1, 367, 0, 0, 0
262, 1, 1636420219578, 1636420219934, 356, 0, 356, 0, 0, 0
265, 1, 1636420220198, 1636420220558, 360, 0, 360, 0, 0, 0
268, 1, 1636420220821, 1636420221186, 365, 1, 364, 0, 0, 0
271, 1, 1636420221449, 1636420221814, 365, 1, 364, 0, 0, 0
274, 1, 1636420222078, 1636420222442, 364, 1, 363, 0, 0, 0
277, 1, 1636420222706, 1636420223066, 360, 1, 359, 0, 0, 0
280, 1, 1636420223330, 1636420223694, 364, 0, 364, 0, 0, 0
283, 1, 1636420223958, 1636420224317, 359, 0, 359, 0, 0, 0
286, 1, 1636420224581, 1636420224942, 361, 1, 360, 0, 1, 1
289, 1, 1636420225206, 1636420225566, 360, 0, 360, 0, 0, 0
292, 1, 1636420225830, 1636420226190, 360, 2, 358, 1, 0, 1
295, 1, 1636420226454, 1636420226817, 363, 1, 362, 1, 0, 1
298, 1, 1636420227081, 1636420227442, 361, 2, 359, 0, 0, 0
301, 1, 1636420227706, 1636420228070, 364, 0, 364, 0, 0, 0
304, 1, 1636420228333, 1636420228694, 361, 1, 360, 0, 0, 0
307, 1, 1636420228958, 1636420229317, 359, 0, 359, 0, 0, 0
310, 1, 1636420229582, 1636420229946, 364, 2, 362, 1, 0, 1
313, 1, 1636420230210, 1636420230570, 360, 1, 359, 0, 0, 0
316, 1, 1636420230834, 1636420231194, 360, 1, 359, 1, 0, 1
319, 1, 1636420231461, 1636420231822, 361, 2, 359, 0, 0, 0
322, 1, 1636420232085, 1636420232446, 361, 1, 360, 0, 0, 0
325, 1, 1636420232710, 1636420233066, 356, 2, 354, 1, 0, 1
328, 1, 1636420233329, 1636420233690, 361, 1, 360, 0, 0, 0
331, 1, 1636420233954, 1636420234317, 363, 1, 362, 1, 0, 1
334, 1, 1636420234581, 1636420234946, 365, 1, 364, 0, 0, 0
337, 1, 1636420235210, 1636420235574, 364, 0, 364, 0, 0, 0
340, 1, 1636420235837, 1636420236198, 361, 2, 359, 1, 0, 1
343, 1, 1636420236462, 1636420236817, 355, 0, 355, 0, 0, 0
346, 1, 1636420237082, 1636420237438, 356, 3, 353, 3, 0, 3
349, 1, 1636420237706, 1636420238062, 356, 2, 354, 1, 1, 2
352, 1, 1636420238326, 1636420238690, 364, 2, 362, 1, 0, 1
355, 1, 1636420238954, 1636420239314, 360, 0, 360, 0, 0, 0
358, 1, 1636420239578, 1636420239942, 364, 0, 364, 0, 0, 0
361, 1, 1636420240206, 1636420240570, 364, 2, 362, 0, 0, 0
364, 1, 1636420240833, 1636420241194, 361, 2, 359, 0, 1, 1
367, 1, 1636420241458, 1636420241814, 356, 0, 356, 0, 0, 0
370, 1, 1636420242078, 1636420242437, 359, 1, 358, 0, 0, 0
373, 1, 1636420242705, 1636420243070, 365, 2, 363, 0, 0, 0
376, 1, 1636420243334, 1636420243697, 363, 0, 363, 0, 0, 0
379, 1, 1636420243962, 1636420244322, 360, 0, 360, 0, 0, 0
382, 1, 1636420244586, 1636420244950, 364, 1, 363, 0, 0, 0
385, 1, 1636420245213, 1636420245574, 361, 1, 360, 0, 0, 0
388, 1, 1636420245841, 1636420246201, 360, 1, 359, 1, 0, 1
391, 1, 1636420246469, 1636420246834, 365, 2, 363, 0, 0, 0
394, 1, 1636420247098, 1636420247450, 352, 1, 351, 0, 0, 0
397, 1, 1636420247713, 1636420248078, 365, 2, 363, 0, 1, 1
400, 1, 1636420248341, 1636420248702, 361, 2, 359, 2, 0, 2
403, 1, 1636420248966, 1636420249326, 360, 1, 359, 0, 0, 0
406, 1, 1636420249589, 1636420249950, 361, 2, 359, 1, 0, 1
409, 1, 1636420250213, 1636420250574, 361, 3, 358, 1, 0, 1
412, 1, 1636420250838, 1636420251198, 360, 1, 359, 0, 0, 0
415, 1, 1636420251461, 1636420251817, 356, 1, 355, 0, 1, 1
418, 1, 1636420252082, 1636420252441, 359, 0, 359, 0, 0, 0
421, 1, 1636420252705, 1636420253066, 361, 2, 359, 0, 0, 0
424, 1, 1636420253330, 1636420253694, 364, 1, 363, 0, 0, 0
427, 1, 1636420253961, 1636420254322, 361, 2, 359, 1, 0, 1
430, 1, 1636420254586, 1636420254946, 360, 0, 360, 0, 0, 0
433, 1, 1636420255210, 1636420255574, 364, 0, 364, 0, 0, 0
436, 1, 1636420255837, 1636420256198, 361, 2, 359, 0, 0, 0
439, 1, 1636420256461, 1636420256822, 361, 2, 359, 1, 0, 1
442, 1, 1636420257090, 1636420257446, 356, 2, 354, 0, 0, 0
445, 1, 1636420257710, 1636420258070, 360, 1, 359, 0, 1, 1
448, 1, 1636420258333, 1636420258698, 365, 1, 364, 1, 0, 1
451, 1, 1636420258961, 1636420259322, 361, 2, 359, 1, 0, 1
454, 1, 1636420259585, 1636420259945, 360, 1, 359, 0, 0, 0
457, 1, 1636420260209, 1636420260570, 361, 2, 359, 0, 0, 0
461, 1, 1636420260833, 1636420261198, 365, 2, 363, 0, 0, 0
464, 1, 1636420261462, 1636420261826, 364, 0, 364, 0, 0, 0
467, 1, 1636420262094, 1636420262454, 360, 1, 359, 0, 0, 0
470, 1, 1636420262718, 1636420263082, 364, 0, 364, 0, 0, 0
473, 1, 1636420263346, 1636420263706, 360, 1, 359, 0, 0, 0
476, 1, 1636420263969, 1636420264330, 361, 1, 360, 1, 0, 1
479, 1, 1636420264594, 1636420264954, 360, 1, 359, 0, 0, 0
482, 1, 1636420265217, 1636420265582, 365, 1, 364, 0, 0, 0
485, 1, 1636420265846, 1636420266210, 364, 1, 363, 0, 0, 0
488, 1, 1636420266474, 1636420266830, 356, 0, 356, 0, 0, 0
491, 1, 1636420267094, 1636420267458, 364, 1, 363, 0, 0, 0
494, 1, 1636420267726, 1636420268086, 360, 1, 359, 1, 0, 1
497, 1, 1636420268350, 1636420268710, 360, 0, 360, 0, 0, 0
500, 1, 1636420268974, 1636420269330, 356, 1, 355, 1, 0, 1
503, 1, 1636420269594, 1636420269950, 356, 1, 355, 0, 0, 0
507, 1, 1636420270217, 1636420270582, 365, 1, 364, 0, 0, 0
510, 1, 1636420270846, 1636420271206, 360, 0, 360, 0, 0, 0
513, 1, 1636420271470, 1636420271826, 356, 0, 356, 0, 0, 0
516, 1, 1636420272089, 1636420272450, 361, 2, 359, 0, 0, 0
518, 1, 1636420272714, 1636420273078, 364, 0, 364, 0, 0, 0
522, 1, 1636420273342, 1636420273701, 359, 1, 358, 0, 0, 0
525, 1, 1636420273966, 1636420274326, 360, 1, 359, 0, 0, 0
526, 1, 1636420274589, 1636420274934, 345, 3, 342, 2, 0, 2
528, 1, 1636420275198, 1636420275558, 360, 0, 360, 0, 0, 0
530, 1, 1636420275822, 1636420276182, 360, 0, 360, 0, 0, 0
532, 1, 1636420276446, 1636420276810, 364, 0, 364, 0, 0, 0
534, 1, 1636420277074, 1636420277434, 360, 1, 359, 0, 0, 0
536, 1, 1636420277698, 1636420278058, 360, 2, 358, 0, 0, 0
539, 1, 1636420278326, 1636420278686, 360, 0, 360, 0, 0, 0
541, 1, 1636420278950, 1636420279310, 360, 0, 360, 0, 0, 0
542, 1, 1636420279573, 1636420279930, 357, 2, 355, 0, 1, 1
544, 1, 1636420280194, 1636420280558, 364, 1, 363, 0, 0, 0
546, 1, 1636420280822, 1636420281186, 364, 0, 364, 0, 0, 0
549, 1, 1636420281450, 1636420281810, 360, 0, 360, 0, 0, 0
550, 1, 1636420282073, 1636420282434, 361, 1, 360, 0, 0, 0
552, 1, 1636420282698, 1636420283058, 360, 1, 359, 0, 0, 0
554, 1, 1636420283322, 1636420283682, 360, 0, 360, 0, 0, 0
556, 1, 1636420283945, 1636420284310, 365, 2, 363, 1, 0, 1
558, 1, 1636420284574, 1636420284934, 360, 0, 360, 0, 0, 0
560, 1, 1636420285198, 1636420285558, 360, 1, 359, 0, 0, 0
562, 1, 1636420285822, 1636420286182, 360, 0, 360, 0, 0, 0
565, 1, 1636420286446, 1636420286806, 360, 1, 359, 0, 0, 0
567, 1, 1636420287070, 1636420287430, 360, 1, 359, 0, 0, 0
569, 1, 1636420287694, 1636420288054, 360, 0, 360, 0, 0, 0
570, 1, 1636420288322, 1636420288682, 360, 0, 360, 0, 0, 0
601, 1, 1636420525825, 1636420526210, 385, 12, 373, 0, 0, 0
602, 1, 1636420526357, 1636420526714, 357, 1, 356, 0, 0, 0
603, 1, 1636420526782, 1636420527134, 352, 2, 350, 1, 1, 2
604, 1, 1636420526858, 1636420527210, 352, 0, 352, 0, 0, 0
605, 1, 1636420527358, 1636420527710, 352, 0, 352, 0, 0, 0
606, 1, 1636420527642, 1636420528002, 360, 0, 360, 0, 0, 0
607, 1, 1636420527774, 1636420528126, 352, 0, 352, 0, 0, 0
608, 1, 1636420527858, 1636420528218, 360, 0, 360, 0, 0, 0
609, 1, 1636420528354, 1636420528710, 356, 0, 356, 0, 0, 0
610, 1, 1636420528558, 1636420528914, 356, 0, 356, 0, 0, 0
611, 1, 1636420528590, 1636420528946, 356, 0, 356, 0, 0, 0
612, 1, 1636420528778, 1636420529138, 360, 1, 359, 0, 0, 0
613, 1, 1636420528858, 1636420529214, 356, 0, 356, 0, 0, 0
614, 1, 1636420529158, 1636420529509, 351, 0, 351, 0, 0, 0
615, 1, 1636420529366, 1636420529726, 360, 0, 360, 0, 0, 0
616, 1, 1636420529497, 1636420529810, 313, 2, 311, 1, 0, 1
617, 1, 1636420529505, 1636420529817, 312, 1, 311, 0, 0, 0
618, 1, 1636420529701, 1636420529966, 265, 1, 264, 0, 0, 0
619, 1, 1636420529786, 1636420530050, 264, 0, 264, 0, 0, 0
620, 1, 1636420530006, 1636420530278, 272, 0, 272, 0, 0, 0
621, 1, 1636420530010, 1636420530278, 268, 0, 268, 0, 0, 0
622, 1, 1636420530285, 1636420530554, 269, 1, 268, 1, 0, 1
623, 1, 1636420530405, 1636420530674, 269, 1, 268, 0, 0, 0
624, 1, 1636420530502, 1636420530770, 268, 0, 268, 0, 0, 0
626, 1, 1636420530673, 1636420530938, 265, 1, 264, 0, 0, 0
625, 1, 1636420530702, 1636420530970, 268, 0, 268, 0, 0, 0
628, 1, 1636420530885, 1636420531154, 269, 1, 268, 0, 0, 0
629, 1, 1636420530994, 1636420531265, 271, 0, 271, 0, 0, 0
632, 1, 1636420531410, 1636420531678, 268, 0, 268, 0, 0, 0
631, 1, 1636420531433, 1636420531706, 273, 1, 272, 0, 0, 0
634, 1, 1636420531590, 1636420531858, 268, 0, 268, 0, 0, 0
635, 1, 1636420531710, 1636420531978, 268, 0, 268, 0, 0, 0
636, 1, 1636420531874, 1636420532138, 264, 0, 264, 0, 0, 0
637, 1, 1636420532005, 1636420532270, 265, 1, 264, 0, 0, 0
638, 1, 1636420532122, 1636420532390, 268, 0, 268, 0, 0, 0
639, 1, 1636420532326, 1636420532598, 272, 0, 272, 0, 0, 0
641, 1, 1636420532578, 1636420532850, 272, 0, 272, 0, 0, 0
642, 1, 1636420532698, 1636420532966, 268, 0, 268, 0, 0, 0
643, 1, 1636420532877, 1636420533142, 265, 1, 264, 0, 0, 0
644, 1, 1636420533014, 1636420533286, 272, 0, 272, 0, 0, 0
646, 1, 1636420533314, 1636420533578, 264, 0, 264, 0, 0, 0
647, 1, 1636420533606, 1636420533886, 280, 0, 280, 0, 0, 0
648, 1, 1636420533717, 1636420533986, 269, 1, 268, 1, 0, 1
649, 1, 1636420533774, 1636420534042, 268, 0, 268, 0, 0, 0
651, 1, 1636420533997, 1636420534270, 273, 1, 272, 1, 0, 1
653, 1, 1636420534317, 1636420534586, 269, 1, 268, 0, 0, 0
652, 1, 1636420534325, 1636420534594, 269, 0, 269, 0, 0, 0
655, 1, 1636420534662, 1636420534938, 276, 0, 276, 0, 0, 0
656, 1, 1636420534722, 1636420534986, 264, 0, 264, 0, 0, 0
658, 1, 1636420535001, 1636420535274, 273, 1, 272, 0, 0, 0
657, 1, 1636420535013, 1636420535286, 273, 0, 273, 0, 0, 0
659, 1, 1636420535210, 1636420535482, 272, 0, 272, 0, 0, 0
662, 1, 1636420535637, 1636420535905, 268, 1, 267, 0, 0, 0
661, 1, 1636420535633, 1636420535905, 272, 1, 271, 0, 0, 0
663, 1, 1636420535682, 1636420535950, 268, 0, 268, 0, 0, 0
664, 1, 1636420535901, 1636420536166, 265, 1, 264, 0, 0, 0
666, 1, 1636420536198, 1636420536475, 277, 0, 277, 0, 0, 0
667, 1, 1636420536289, 1636420536562, 273, 1, 272, 0, 0, 0
668, 1, 1636420536529, 1636420536798, 269, 1, 268, 0, 0, 0
669, 1, 1636420536638, 1636420536906, 268, 0, 268, 0, 0, 0
670, 1, 1636420536674, 1636420536942, 268, 0, 268, 0, 0, 0
672, 1, 1636420536886, 1636420537154, 268, 0, 268, 0, 0, 0
671, 1, 1636420536886, 1636420537162, 276, 0, 276, 0, 0, 0
673, 1, 1636420537174, 1636420537438, 264, 0, 264, 0, 0, 0
674, 1, 1636420537222, 1636420537494, 272, 0, 272, 0, 0, 0
675, 1, 1636420537510, 1636420537777, 267, 0, 267, 0, 0, 0
676, 1, 1636420537570, 1636420537838, 268, 0, 268, 0, 0, 0
677, 1, 1636420537641, 1636420537910, 269, 1, 268, 0, 0, 0
679, 1, 1636420537773, 1636420538046, 273, 1, 272, 0, 0, 0
680, 1, 1636420537910, 1636420538174, 264, 0, 264, 0, 0, 0
681, 1, 1636420538153, 1636420538422, 269, 1, 268, 0, 0, 0
682, 1, 1636420538262, 1636420538530, 268, 0, 268, 0, 0, 0
684, 1, 1636420538458, 1636420538730, 272, 0, 272, 0, 0, 0
685, 1, 1636420538509, 1636420538773, 264, 1, 263, 0, 0, 0
686, 1, 1636420538642, 1636420538910, 268, 0, 268, 0, 0, 0
687, 1, 1636420538762, 1636420539030, 268, 0, 268, 0, 0, 0
689, 1, 1636420539154, 1636420539418, 264, 0, 264, 0, 0, 0
690, 1, 1636420539189, 1636420539453, 264, 1, 263, 0, 0, 0
691, 1, 1636420539398, 1636420539666, 268, 0, 268, 0, 0, 0
692, 1, 1636420539449, 1636420539717, 268, 0, 268, 0, 0, 0
694, 1, 1636420539606, 1636420539877, 271, 0, 271, 0, 0, 0
696, 1, 1636420539765, 1636420540029, 264, 1, 263, 0, 0, 0
695, 1, 1636420539790, 1636420540058, 268, 0, 268, 0, 0, 0
697, 1, 1636420540142, 1636420540409, 267, 0, 267, 0, 0, 0
699, 1, 1636420540277, 1636420540550, 273, 1, 272, 0, 0, 0
700, 1, 1636420540454, 1636420540722, 268, 0, 268, 0, 0, 0
701, 1, 1636420540617, 1636420540886, 269, 1, 268, 0, 1, 1
702, 1, 1636420540681, 1636420540946, 265, 1, 264, 0, 0, 0
627, 2, 1636420530938, 1636420540994, 10056, 0, 10056, 0, 0, 0
704, 1, 1636420541226, 1636420541498, 272, 0, 272, 0, 0, 0
705, 1, 1636420541257, 1636420541573, 316, 0, 316, 0, 0, 0
706, 1, 1636420541486, 1636420541750, 264, 0, 264, 0, 0, 0
708, 1, 1636420541614, 1636420541878, 264, 0, 264, 0, 0, 0
709, 1, 1636420541661, 1636420541926, 265, 1, 264, 0, 0, 0
711, 1, 1636420542289, 1636420542566, 277, 1, 276, 0, 0, 0
712, 1, 1636420542313, 1636420542578, 265, 1, 264, 0, 0, 0
713, 1, 1636420542606, 1636420542878, 272, 0, 272, 0, 0, 0
714, 1, 1636420542706, 1636420542974, 268, 0, 268, 0, 0, 0
715, 1, 1636420543305, 1636420543574, 269, 1, 268, 0, 1, 1
717, 1, 1636420543637, 1636420543946, 309, 1, 308, 0, 0, 0
719, 1, 1636420544294, 1636420544566, 272, 0, 272, 0, 0, 0
720, 1, 1636420544686, 1636420544954, 268, 0, 268, 0, 0, 0
721, 1, 1636420545298, 1636420545562, 264, 0, 264, 0, 0, 0
722, 1, 1636420545626, 1636420545898, 272, 0, 272, 0, 0, 0
723, 1, 1636420546258, 1636420546526, 268, 0, 268, 0, 0, 0
724, 1, 1636420546590, 1636420546862, 272, 0, 272, 0, 0, 0
725, 1, 1636420547290, 1636420547558, 268, 0, 268, 0, 0, 0
726, 1, 1636420547558, 1636420547825, 267, 0, 267, 0, 0, 0
727, 1, 1636420548345, 1636420548614, 269, 1, 268, 0, 0, 0
728, 1, 1636420548558, 1636420548830, 272, 0, 272, 0, 0, 0
729, 1, 1636420549357, 1636420549658, 301, 1, 300, 0, 0, 0
730, 1, 1636420549574, 1636420549838, 264, 0, 264, 0, 0, 0
731, 1, 1636420550374, 1636420550638, 264, 0, 264, 0, 0, 0
732, 1, 1636420550594, 1636420550862, 268, 0, 268, 0, 0, 0
733, 1, 1636420551349, 1636420551617, 268, 1, 267, 0, 0, 0
740, 1, 1636420551433, 1636420551702, 269, 1, 268, 1, 0, 1
737, 1, 1636420551433, 1636420551705, 272, 1, 271, 0, 0, 0
748, 1, 1636420551569, 1636420551833, 264, 1, 263, 0, 0, 0
750, 1, 1636420552317, 1636420552594, 277, 1, 276, 0, 0, 0
751, 1, 1636420552321, 1636420552594, 273, 0, 273, 0, 0, 0
752, 1, 1636420552349, 1636420552617, 268, 1, 267, 0, 0, 0
754, 1, 1636420552534, 1636420552802, 268, 0, 268, 0, 0, 0
755, 1, 1636420553310, 1636420553578, 268, 0, 268, 0, 0, 0
718, 1, 1636420553317, 1636420553586, 269, 2, 267, 0, 0, 0
756, 1, 1636420553317, 1636420553586, 269, 1, 268, 0, 0, 0
758, 1, 1636420553549, 1636420553814, 265, 1, 264, 0, 0, 0
757, 1, 1636420553581, 1636420553846, 265, 1, 264, 1, 0, 1
761, 1, 1636420554290, 1636420554558, 268, 0, 268, 0, 0, 0
762, 1, 1636420554294, 1636420554562, 268, 0, 268, 0, 0, 0
763, 1, 1636420554386, 1636420554654, 268, 0, 268, 0, 0, 0
764, 1, 1636420554558, 1636420554821, 263, 0, 263, 0, 0, 0
765, 1, 1636420555270, 1636420555538, 268, 0, 268, 0, 0, 0
766, 1, 1636420555278, 1636420555545, 267, 0, 267, 0, 0, 0
767, 1, 1636420555397, 1636420555669, 272, 1, 271, 0, 1, 1
768, 1, 1636420555541, 1636420555810, 269, 1, 268, 0, 0, 0
769, 1, 1636420556242, 1636420556510, 268, 0, 268, 0, 0, 0
770, 1, 1636420556301, 1636420556570, 269, 1, 268, 0, 0, 0
771, 1, 1636420556398, 1636420556666, 268, 0, 268, 0, 0, 0
772, 1, 1636420556518, 1636420556786, 268, 0, 268, 0, 0, 0
773, 1, 1636420557278, 1636420557546, 268, 0, 268, 0, 0, 0
774, 1, 1636420557329, 1636420557597, 268, 1, 267, 0, 0, 0
775, 1, 1636420557373, 1636420557641, 268, 0, 268, 0, 0, 0
776, 1, 1636420557486, 1636420557754, 268, 0, 268, 0, 0, 0
777, 1, 1636420558301, 1636420558569, 268, 1, 267, 1, 0, 1
778, 1, 1636420558337, 1636420558614, 277, 1, 276, 0, 0, 0
779, 1, 1636420558357, 1636420558630, 273, 1, 272, 0, 0, 0
780, 1, 1636420558490, 1636420558762, 272, 0, 272, 0, 0, 0
781, 1, 1636420559317, 1636420559590, 273, 1, 272, 0, 0, 0
782, 1, 1636420559338, 1636420559606, 268, 0, 268, 0, 0, 0
783, 1, 1636420559393, 1636420559662, 269, 0, 269, 0, 0, 0
784, 1, 1636420559462, 1636420559726, 264, 0, 264, 0, 0, 0
785, 1, 1636420560325, 1636420560590, 265, 0, 265, 0, 0, 0
786, 1, 1636420560357, 1636420560626, 269, 0, 269, 0, 0, 0
787, 1, 1636420560361, 1636420560630, 269, 1, 268, 1, 0, 1
788, 1, 1636420560494, 1636420560762, 268, 0, 268, 0, 0, 0
743, 2, 1636420551705, 1636420561887, 10182, 1, 10181, 1, 1, 2
789, 1, 1636420561317, 1636420562217, 900, 1, 899, 1, 0, 1
791, 1, 1636420562030, 1636420562306, 276, 0, 276, 0, 0, 0
790, 1, 1636420562033, 1636420562306, 273, 1, 272, 0, 0, 0
792, 1, 1636420562130, 1636420562398, 268, 0, 268, 0, 0, 0
794, 1, 1636420562334, 1636420562602, 268, 0, 268, 0, 0, 0
806, 1, 1636420562617, 1636420562882, 265, 1, 264, 0, 0, 0
807, 1, 1636420562706, 1636420562970, 264, 0, 264, 0, 0, 0
808, 1, 1636420562721, 1636420562990, 269, 1, 268, 0, 0, 0
809, 1, 1636420562793, 1636420563057, 264, 1, 263, 0, 0, 0
810, 1, 1636420563278, 1636420563546, 268, 0, 268, 0, 0, 0
812, 1, 1636420563637, 1636420563901, 264, 1, 263, 0, 0, 0
811, 1, 1636420563634, 1636420563901, 267, 0, 267, 0, 0, 0
760, 1, 1636420563669, 1636420563937, 268, 1, 267, 0, 1, 1
813, 1, 1636420563721, 1636420563989, 268, 1, 267, 0, 1, 1
814, 1, 1636420563766, 1636420564030, 264, 0, 264, 0, 0, 0
816, 1, 1636420564270, 1636420564538, 268, 0, 268, 0, 0, 0
818, 1, 1636420564598, 1636420564870, 272, 0, 272, 0, 0, 0
819, 1, 1636420564630, 1636420564898, 268, 0, 268, 0, 0, 0
820, 1, 1636420564685, 1636420564958, 273, 1, 272, 0, 0, 0
821, 1, 1636420564790, 1636420565061, 271, 0, 271, 0, 0, 0
822, 1, 1636420565242, 1636420565509, 267, 0, 267, 0, 0, 0
823, 1, 1636420565585, 1636420565858, 273, 1, 272, 0, 1, 1
824, 1, 1636420565650, 1636420565914, 264, 0, 264, 0, 0, 0
825, 1, 1636420565678, 1636420565946, 268, 0, 268, 0, 0, 0
826, 1, 1636420565801, 1636420566066, 265, 1, 264, 0, 0, 0
827, 1, 1636420566217, 1636420566485, 268, 1, 267, 0, 0, 0
828, 1, 1636420566565, 1636420566834, 269, 1, 268, 0, 0, 0
829, 1, 1636420566674, 1636420566942, 268, 0, 268, 0, 0, 0
830, 1, 1636420566701, 1636420566974, 273, 1, 272, 1, 0, 1
831, 1, 1636420566806, 1636420567073, 267, 0, 267, 0, 0, 0
832, 1, 1636420567250, 1636420567517, 267, 0, 267, 0, 0, 0
833, 1, 1636420567557, 1636420567829, 272, 1, 271, 0, 0, 0
834, 1, 1636420567678, 1636420567950, 272, 0, 272, 0, 0, 0
835, 1, 1636420567726, 1636420567994, 268, 0, 268, 0, 0, 0
836, 1, 1636420567826, 1636420568090, 264, 0, 264, 0, 0, 0
837, 1, 1636420568254, 1636420568530, 276, 0, 276, 0, 0, 0
838, 1, 1636420568562, 1636420568830, 268, 0, 268, 0, 0, 0
839, 1, 1636420568665, 1636420568933, 268, 0, 268, 0, 0, 0
840, 1, 1636420568726, 1636420569001, 275, 0, 275, 0, 0, 0
841, 1, 1636420568862, 1636420569130, 268, 0, 268, 0, 0, 0
842, 1, 1636420569278, 1636420569546, 268, 0, 268, 0, 0, 0
843, 1, 1636420569546, 1636420569810, 264, 0, 264, 0, 0, 0
844, 1, 1636420569686, 1636420569954, 268, 0, 268, 0, 0, 0
845, 1, 1636420569717, 1636420569985, 268, 1, 267, 0, 0, 0
846, 1, 1636420569838, 1636420570106, 268, 0, 268, 0, 0, 0
847, 1, 1636420570278, 1636420570541, 263, 0, 263, 0, 0, 0
848, 1, 1636420570534, 1636420570806, 272, 0, 272, 0, 0, 0
849, 1, 1636420570709, 1636420570978, 269, 1, 268, 0, 0, 0
850, 1, 1636420570742, 1636420571022, 280, 0, 280, 0, 0, 0
851, 1, 1636420570822, 1636420571089, 267, 0, 267, 0, 0, 0
852, 1, 1636420571270, 1636420571542, 272, 0, 272, 0, 0, 0
853, 1, 1636420571506, 1636420571774, 268, 0, 268, 0, 0, 0
854, 1, 1636420571686, 1636420571949, 263, 0, 263, 0, 0, 0
855, 1, 1636420571738, 1636420572005, 267, 0, 267, 0, 0, 0
856, 1, 1636420571798, 1636420572074, 276, 0, 276, 0, 0, 0
858, 1, 1636420572825, 1636420573098, 273, 1, 272, 0, 1, 1
859, 1, 1636420572957, 1636420573221, 264, 1, 263, 1, 0, 1
861, 1, 1636420572961, 1636420573225, 264, 1, 263, 1, 0, 1
860, 1, 1636420572965, 1636420573234, 269, 0, 269, 0, 0, 0
862, 1, 1636420573042, 1636420573306, 264, 0, 264, 0, 0, 0
863, 1, 1636420573125, 1636420573394, 269, 1, 268, 0, 0, 0
875, 1, 1636420573513, 1636420573782, 269, 1, 268, 0, 0, 0
876, 1, 1636420573633, 1636420573901, 268, 1, 267, 0, 0, 0
878, 1, 1636420573725, 1636420573993, 268, 1, 267, 0, 0, 0
877, 1, 1636420573725, 1636420573993, 268, 1, 267, 0, 0, 0
881, 1, 1636420574474, 1636420574745, 271, 0, 271, 0, 0, 0
883, 1, 1636420574578, 1636420574842, 264, 0, 264, 0, 0, 0
885, 1, 1636420574721, 1636420574990, 269, 1, 268, 0, 0, 0
886, 1, 1636420574758, 1636420575026, 268, 0, 268, 0, 0, 0
887, 1, 1636420575426, 1636420575694, 268, 0, 268, 0, 0, 0
888, 1, 1636420575570, 1636420575838, 268, 0, 268, 0, 0, 0
889, 1, 1636420575717, 1636420575985, 268, 1, 267, 0, 0, 0
890, 1, 1636420575745, 1636420576014, 269, 1, 268, 0, 0, 0
891, 1, 1636420576454, 1636420576721, 267, 0, 267, 0, 0, 0
892, 1, 1636420576570, 1636420576842, 272, 0, 272, 0, 0, 0
893, 1, 1636420576745, 1636420577017, 272, 1, 271, 0, 1, 1
894, 1, 1636420576750, 1636420577017, 267, 0, 267, 0, 0, 0
895, 1, 1636420577489, 1636420577753, 264, 0, 264, 0, 0, 0
896, 1, 1636420577577, 1636420577846, 269, 1, 268, 0, 0, 0
897, 1, 1636420577745, 1636420578017, 272, 1, 271, 1, 0, 1
898, 1, 1636420577773, 1636420578042, 269, 1, 268, 0, 0, 0
899, 1, 1636420578478, 1636420578745, 267, 0, 267, 0, 0, 0
900, 1, 1636420578598, 1636420578862, 264, 0, 264, 0, 0, 0
901, 1, 1636420578733, 1636420579001, 268, 1, 267, 0, 0, 0
902, 1, 1636420578777, 1636420579042, 265, 1, 264, 0, 0, 0
903, 1, 1636420579446, 1636420579714, 268, 0, 268, 0, 0, 0
904, 1, 1636420579561, 1636420579834, 273, 1, 272, 1, 0, 1
905, 1, 1636420579722, 1636420579990, 268, 0, 268, 0, 0, 0
906, 1, 1636420579773, 1636420580046, 273, 1, 272, 0, 0, 0
907, 1, 1636420580413, 1636420580681, 268, 1, 267, 0, 0, 0
908, 1, 1636420580546, 1636420580809, 263, 0, 263, 0, 0, 0
910, 1, 1636420580766, 1636420581042, 276, 0, 276, 0, 0, 0
909, 1, 1636420580813, 1636420581081, 268, 0, 268, 0, 0, 0
911, 1, 1636420581410, 1636420581678, 268, 0, 268, 0, 0, 0
912, 1, 1636420581558, 1636420581826, 268, 0, 268, 0, 0, 0
913, 1, 1636420581673, 1636420581946, 273, 1, 272, 0, 0, 0
914, 1, 1636420581733, 1636420581998, 265, 1, 264, 0, 0, 0
880, 1, 1636420582238, 1636420582506, 268, 0, 268, 0, 0, 0
915, 1, 1636420582426, 1636420582694, 268, 0, 268, 0, 0, 0
917, 1, 1636420582594, 1636420582858, 264, 0, 264, 0, 0, 0
918, 1, 1636420582669, 1636420582938, 269, 2, 267, 0, 0, 0
919, 1, 1636420582714, 1636420582985, 271, 0, 271, 0, 0, 0
920, 1, 1636420582930, 1636420583649, 719, 0, 719, 0, 0, 0
921, 1, 1636420583697, 1636420583966, 269, 1, 268, 0, 1, 1
922, 1, 1636420583697, 1636420583966, 269, 1, 268, 0, 0, 0
924, 1, 1636420583781, 1636420584061, 280, 2, 278, 0, 0, 0
923, 1, 1636420583781, 1636420584062, 281, 1, 280, 0, 0, 0
925, 1, 1636420583857, 1636420584149, 292, 0, 292, 0, 0, 0
936, 1, 1636420584061, 1636420584325, 264, 1, 263, 0, 0, 0
930, 1, 1636420584149, 1636420584413, 264, 1, 263, 1, 0, 1
937, 1, 1636420584369, 1636420584682, 313, 1, 312, 0, 0, 0
938, 1, 1636420584437, 1636420584749, 312, 0, 312, 0, 0, 0
939, 1, 1636420584590, 1636420584858, 268, 0, 268, 0, 0, 0
916, 1, 1636420584709, 1636420584974, 265, 0, 265, 0, 0, 0
940, 1, 1636420584749, 1636420585014, 265, 1, 264, 0, 0, 0
941, 1, 1636420584753, 1636420585021, 268, 0, 268, 0, 0, 0
946, 1, 1636420585006, 1636420585270, 264, 1, 263, 0, 0, 0
947, 1, 1636420585294, 1636420585566, 272, 0, 272, 0, 0, 0
949, 1, 1636420585414, 1636420585682, 268, 0, 268, 0, 0, 0
950, 1, 1636420585613, 1636420585886, 273, 1, 272, 0, 0, 0
952, 1, 1636420585733, 1636420586001, 268, 1, 267, 1, 0, 1
953, 1, 1636420585977, 1636420586250, 273, 1, 272, 0, 0, 0
954, 1, 1636420586253, 1636420586522, 269, 0, 269, 0, 0, 0
955, 1, 1636420586434, 1636420586698, 264, 1, 263, 0, 0, 0
956, 1, 1636420586605, 1636420586873, 268, 1, 267, 1, 0, 1
957, 1, 1636420586741, 1636420587010, 269, 1, 268, 1, 0, 1
958, 1, 1636420587010, 1636420587274, 264, 0, 264, 0, 0, 0
960, 1, 1636420587437, 1636420587706, 269, 1, 268, 1, 0, 1
961, 1, 1636420587594, 1636420587866, 272, 0, 272, 0, 0, 0
962, 1, 1636420587758, 1636420588021, 263, 0, 263, 0, 0, 0
963, 1, 1636420588017, 1636420588282, 265, 1, 264, 0, 0, 0
964, 1, 1636420588426, 1636420588694, 268, 0, 268, 0, 0, 0
966, 1, 1636420588730, 1636420589001, 271, 0, 271, 0, 0, 0
967, 1, 1636420589034, 1636420589306, 272, 0, 272, 0, 0, 0
968, 1, 1636420589394, 1636420589662, 268, 0, 268, 0, 0, 0
969, 1, 1636420589710, 1636420589982, 272, 0, 272, 0, 0, 0
970, 1, 1636420590038, 1636420590306, 268, 0, 268, 0, 0, 0
971, 1, 1636420590358, 1636420590622, 264, 0, 264, 0, 0, 0
972, 1, 1636420590722, 1636420590994, 272, 0, 272, 0, 0, 0
973, 1, 1636420591030, 1636420591294, 264, 0, 264, 0, 0, 0
974, 1, 1636420591398, 1636420591662, 264, 0, 264, 0, 0, 0
975, 1, 1636420591729, 1636420591998, 269, 1, 268, 0, 0, 0
976, 1, 1636420592014, 1636420592282, 268, 0, 268, 0, 0, 0
977, 1, 1636420592394, 1636420592658, 264, 0, 264, 0, 0, 0
978, 1, 1636420592710, 1636420592982, 272, 0, 272, 0, 0, 0
979, 1, 1636420593046, 1636420593317, 271, 0, 271, 0, 0, 0
980, 1, 1636420593422, 1636420593690, 268, 0, 268, 0, 0, 0
981, 1, 1636420593726, 1636420594382, 656, 0, 656, 0, 0, 0
982, 1, 1636420594342, 1636420594614, 272, 0, 272, 0, 0, 0
983, 1, 1636420594457, 1636420594730, 273, 1, 272, 0, 0, 0
993, 1, 1636420594850, 1636420595162, 312, 1, 311, 0, 0, 0
951, 1, 1636420594850, 1636420595162, 312, 1, 311, 0, 1, 1
987, 1, 1636420594849, 1636420595162, 313, 2, 311, 0, 0, 0
994, 1, 1636420595074, 1636420595342, 268, 0, 268, 0, 0, 0
996, 1, 1636420595345, 1636420595613, 268, 0, 268, 0, 0, 0
999, 1, 1636420595433, 1636420595698, 265, 1, 264, 0, 0, 0
1000, 1, 1636420595561, 1636420595829, 268, 0, 268, 0, 0, 0
997, 1, 1636420595617, 1636420595882, 265, 0, 265, 0, 0, 0
1003, 1, 1636420595721, 1636420595989, 268, 0, 268, 0, 0, 0
1001, 1, 1636420595882, 1636420596146, 264, 2, 262, 1, 1, 2
1004, 1, 1636420596033, 1636420596298, 265, 0, 265, 0, 0, 0
1005, 1, 1636420596226, 1636420596490, 264, 0, 264, 0, 0, 0
1007, 1, 1636420596449, 1636420596713, 264, 0, 264, 0, 0, 0
1008, 1, 1636420596538, 1636420596805, 267, 0, 267, 0, 0, 0
1009, 1, 1636420596622, 1636420596890, 268, 0, 268, 0, 0, 0
1010, 1, 1636420596725, 1636420596997, 272, 1, 271, 0, 0, 0
1011, 1, 1636420597030, 1636420597301, 271, 0, 271, 0, 0, 0
1012, 1, 1636420597213, 1636420597481, 268, 1, 267, 0, 0, 0
1013, 1, 1636420597465, 1636420597738, 273, 1, 272, 0, 0, 0
1015, 1, 1636420597545, 1636420597814, 269, 1, 268, 0, 0, 0
1014, 1, 1636420597569, 1636420597833, 264, 0, 264, 0, 0, 0
1016, 1, 1636420597601, 1636420597874, 273, 0, 273, 0, 0, 0
1017, 1, 1636420597734, 1636420598001, 267, 0, 267, 0, 0, 0
1018, 1, 1636420598034, 1636420598301, 267, 0, 267, 0, 0, 0
1019, 1, 1636420598217, 1636420598485, 268, 1, 267, 0, 0, 0
1020, 1, 1636420598481, 1636420598754, 273, 1, 272, 1, 0, 1
1021, 1, 1636420598493, 1636420598757, 264, 1, 263, 1, 0, 1
1022, 1, 1636420598577, 1636420598849, 272, 0, 272, 0, 0, 0
1023, 1, 1636420598609, 1636420598877, 268, 0, 268, 0, 0, 0
1006, 1, 1636420598617, 1636420598889, 272, 1, 271, 1, 0, 1
1024, 1, 1636420598753, 1636420599017, 264, 1, 263, 1, 0, 1
1025, 1, 1636420599017, 1636420599282, 265, 1, 264, 1, 0, 1
1026, 1, 1636420599021, 1636420599286, 265, 0, 265, 0, 0, 0
1027, 1, 1636420599218, 1636420599486, 268, 0, 268, 0, 0, 0
1028, 1, 1636420599301, 1636420599573, 272, 1, 271, 1, 0, 1
1029, 1, 1636420599445, 1636420599714, 269, 1, 268, 0, 1, 1
1030, 1, 1636420599509, 1636420599778, 269, 1, 268, 0, 0, 0
1031, 1, 1636420599554, 1636420599817, 263, 0, 263, 0, 0, 0
1032, 1, 1636420599617, 1636420599882, 265, 0, 265, 0, 0, 0
1033, 1, 1636420599750, 1636420600017, 267, 0, 267, 0, 0, 0
1034, 1, 1636420600021, 1636420600289, 268, 1, 267, 1, 0, 1
1035, 1, 1636420600041, 1636420600310, 269, 1, 268, 0, 0, 0
1036, 1, 1636420600225, 1636420600489, 264, 1, 263, 0, 0, 0
1037, 1, 1636420600241, 1636420600509, 268, 1, 267, 0, 0, 0
1038, 1, 1636420600425, 1636420600694, 269, 1, 268, 1, 0, 1
1039, 1, 1636420600505, 1636420600773, 268, 0, 268, 0, 0, 0
1040, 1, 1636420600585, 1636420600849, 264, 0, 264, 0, 0, 0
1041, 1, 1636420600629, 1636420600893, 264, 1, 263, 0, 1, 1
1042, 1, 1636420600769, 1636420601033, 264, 0, 264, 0, 0, 0
1043, 1, 1636420601033, 1636420601301, 268, 1, 267, 1, 0, 1
1044, 1, 1636420601061, 1636420601330, 269, 1, 268, 0, 0, 0
1045, 1, 1636420601209, 1636420601473, 264, 1, 263, 0, 0, 0
1046, 1, 1636420601245, 1636420601510, 265, 1, 264, 0, 0, 0
1047, 1, 1636420601433, 1636420601698, 265, 1, 264, 0, 1, 1
1048, 1, 1636420601509, 1636420601774, 265, 1, 264, 0, 0, 0
1050, 1, 1636420601629, 1636420601897, 268, 1, 267, 0, 0, 0
1051, 1, 1636420601761, 1636420602030, 269, 1, 268, 0, 0, 0
1052, 1, 1636420602033, 1636420602301, 268, 1, 267, 0, 0, 0
1053, 1, 1636420602045, 1636420602313, 268, 1, 267, 0, 0, 0
1054, 1, 1636420602209, 1636420602478, 269, 1, 268, 0, 0, 0
1055, 1, 1636420602237, 1636420602506, 269, 1, 268, 0, 0, 0
1056, 1, 1636420602469, 1636420602734, 265, 1, 264, 0, 0, 0
1057, 1, 1636420602486, 1636420602754, 268, 0, 268, 0, 0, 0
1058, 1, 1636420602629, 1636420602898, 269, 1, 268, 0, 0, 0
1059, 1, 1636420602769, 1636420603038, 269, 1, 268, 0, 1, 1
1060, 1, 1636420603041, 1636420603310, 269, 1, 268, 0, 0, 0
1061, 1, 1636420603053, 1636420603317, 264, 1, 263, 0, 0, 0
1062, 1, 1636420603222, 1636420603489, 267, 0, 267, 0, 0, 0
1063, 1, 1636420603237, 1636420603510, 273, 1, 272, 0, 0, 0
1064, 1, 1636420603458, 1636420603725, 267, 0, 267, 0, 0, 0
1065, 1, 1636420603478, 1636420603750, 272, 0, 272, 0, 0, 0
1066, 1, 1636420603613, 1636420603878, 265, 0, 265, 0, 0, 0
1067, 1, 1636420603745, 1636420604014, 269, 1, 268, 0, 0, 0
1068, 1, 1636420604014, 1636420604286, 272, 1, 271, 0, 0, 0
1069, 1, 1636420604081, 1636420604354, 273, 1, 272, 0, 0, 0
1070, 1, 1636420604250, 1636420604513, 263, 0, 263, 0, 0, 0
1071, 1, 1636420604278, 1636420604542, 264, 0, 264, 0, 0, 0
1072, 1, 1636420604474, 1636420605093, 619, 0, 619, 0, 0, 0
1074, 1, 1636420605005, 1636420605278, 273, 1, 272, 0, 1, 1
1075, 1, 1636420605097, 1636420605377, 280, 1, 279, 0, 1, 1
1073, 1, 1636420605097, 1636420605381, 284, 1, 283, 1, 0, 1
1077, 1, 1636420605157, 1636420605474, 317, 1, 316, 0, 1, 1
1079, 1, 1636420605293, 1636420605566, 273, 1, 272, 1, 0, 1
1078, 1, 1636420605293, 1636420605566, 273, 1, 272, 0, 0, 0
1076, 1, 1636420605377, 1636420605642, 265, 1, 264, 1, 0, 1
1089, 1, 1636420605525, 1636420605837, 312, 1, 311, 0, 0, 0
1091, 1, 1636420605681, 1636420605953, 272, 1, 271, 0, 0, 0
1049, 1, 1636420605698, 1636420605974, 276, 0, 276, 0, 0, 0
1092, 1, 1636420605793, 1636420606062, 269, 1, 268, 1, 0, 1
1093, 1, 1636420605793, 1636420606065, 272, 1, 271, 0, 0, 0
1096, 1, 1636420606045, 1636420606309, 264, 1, 263, 0, 0, 0
1095, 1, 1636420606061, 1636420606329, 268, 1, 267, 0, 0, 0
1097, 1, 1636420606241, 1636420606506, 265, 1, 264, 0, 0, 0
1098, 1, 1636420606245, 1636420606509, 264, 0, 264, 0, 0, 0
1099, 1, 1636420606373, 1636420606641, 268, 1, 267, 0, 1, 1
1100, 1, 1636420606450, 1636420606718, 268, 0, 268, 0, 0, 0
1101, 1, 1636420606633, 1636420606897, 264, 1, 263, 0, 0, 0
1102, 1, 1636420606721, 1636420606990, 269, 1, 268, 1, 0, 1
1103, 1, 1636420606737, 1636420607001, 264, 1, 263, 0, 1, 1
1104, 1, 1636420607001, 1636420607266, 265, 1, 264, 0, 0, 0
1105, 1, 1636420607065, 1636420607330, 265, 1, 264, 0, 1, 1
1106, 1, 1636420607242, 1636420607510, 268, 0, 268, 0, 0, 0
1107, 1, 1636420607254, 1636420607517, 263, 0, 263, 0, 0, 0
1108, 1, 1636420607309, 1636420607574, 265, 1, 264, 1, 0, 1
1109, 1, 1636420607449, 1636420607713, 264, 1, 263, 1, 0, 1
1110, 1, 1636420607661, 1636420607929, 268, 1, 267, 0, 1, 1
1111, 1, 1636420607693, 1636420607962, 269, 1, 268, 1, 0, 1
1112, 1, 1636420607725, 1636420607994, 269, 1, 268, 0, 0, 0
1113, 1, 1636420607961, 1636420608230, 269, 1, 268, 0, 0, 0
1114, 1, 1636420608089, 1636420608353, 264, 1, 263, 0, 0, 0
1116, 1, 1636420608266, 1636420608530, 264, 0, 264, 0, 0, 0
1117, 1, 1636420608329, 1636420608598, 269, 1, 268, 0, 0, 0
1115, 1, 1636420608353, 1636420608617, 264, 1, 263, 1, 0, 1
1118, 1, 1636420608421, 1636420608690, 269, 0, 269, 0, 0, 0
1119, 1, 1636420608697, 1636420608965, 268, 1, 267, 0, 1, 1
1120, 1, 1636420608713, 1636420608982, 269, 1, 268, 0, 0, 0
1121, 1, 1636420608733, 1636420609010, 277, 0, 277, 0, 0, 0
1122, 1, 1636420608981, 1636420609246, 265, 1, 264, 0, 0, 0
1123, 1, 1636420609065, 1636420609333, 268, 1, 267, 0, 0, 0
1124, 1, 1636420609253, 1636420609522, 269, 1, 268, 0, 0, 0
1125, 1, 1636420609273, 1636420609541, 268, 1, 267, 0, 1, 1
1126, 1, 1636420609345, 1636420609609, 264, 1, 263, 0, 0, 0
1128, 1, 1636420609689, 1636420609958, 269, 1, 268, 0, 0, 0
1129, 1, 1636420609689, 1636420609958, 269, 1, 268, 0, 0, 0
1130, 1, 1636420609725, 1636420609993, 268, 1, 267, 1, 0, 1
1131, 1, 1636420609961, 1636420610233, 272, 1, 271, 0, 0, 0
1132, 1, 1636420610053, 1636420610317, 264, 1, 263, 1, 0, 1
1133, 1, 1636420610249, 1636420610514, 265, 1, 264, 0, 0, 0
1134, 1, 1636420610286, 1636420610554, 268, 0, 268, 0, 0, 0
1135, 1, 1636420610354, 1636420610621, 267, 0, 267, 0, 0, 0
1136, 1, 1636420610658, 1636420610926, 268, 0, 268, 0, 0, 0
1138, 1, 1636420610753, 1636420611022, 269, 1, 268, 0, 0, 0
1140, 1, 1636420611054, 1636420611317, 263, 0, 263, 0, 0, 0
1141, 1, 1636420611261, 1636420611530, 269, 1, 268, 0, 0, 0
1142, 1, 1636420611322, 1636420611589, 267, 0, 267, 0, 0, 0
1143, 1, 1636420611346, 1636420611614, 268, 0, 268, 0, 0, 0
1144, 1, 1636420611617, 1636420611886, 269, 0, 269, 0, 0, 0
1145, 1, 1636420611766, 1636420612033, 267, 0, 267, 0, 0, 0
1146, 1, 1636420612049, 1636420612313, 264, 1, 263, 0, 0, 0
1147, 1, 1636420612270, 1636420612534, 264, 0, 264, 0, 0, 0
1148, 1, 1636420612298, 1636420612561, 263, 0, 263, 0, 0, 0
1149, 1, 1636420612370, 1636420612634, 264, 0, 264, 0, 0, 0
1150, 1, 1636420612590, 1636420612854, 264, 0, 264, 0, 0, 0
1151, 1, 1636420612754, 1636420613022, 268, 0, 268, 0, 0, 0
1152, 1, 1636420613046, 1636420613313, 267, 0, 267, 0, 0, 0
1154, 1, 1636420613269, 1636420613534, 265, 1, 264, 0, 0, 0
1153, 1, 1636420613266, 1636420613534, 268, 0, 268, 0, 0, 0
1155, 1, 1636420613377, 1636420613641, 264, 1, 263, 0, 0, 0
1156, 1, 1636420613610, 1636420613874, 264, 0, 264, 0, 0, 0
1157, 1, 1636420613761, 1636420614026, 265, 1, 264, 0, 0, 0
1158, 1, 1636420614033, 1636420614301, 268, 1, 267, 1, 0, 1
1159, 1, 1636420614237, 1636420614501, 264, 1, 263, 0, 0, 0
1160, 1, 1636420614301, 1636420614566, 265, 1, 264, 0, 1, 1
1161, 1, 1636420614369, 1636420614634, 265, 1, 264, 0, 0, 0
1162, 1, 1636420614634, 1636420614902, 268, 0, 268, 0, 0, 0
1163, 1, 1636420614725, 1636420614994, 269, 1, 268, 0, 1, 1
1164, 1, 1636420615045, 1636420615310, 265, 1, 264, 0, 0, 0
1165, 1, 1636420615258, 1636420615925, 667, 0, 667, 0, 0, 0
1166, 1, 1636420615302, 1636420616009, 707, 0, 707, 0, 0, 0
1167, 1, 1636420615781, 1636420616049, 268, 1, 267, 1, 0, 1
1094, 1, 1636420615869, 1636420616137, 268, 0, 268, 0, 0, 0
1168, 1, 1636420615925, 1636420616197, 272, 1, 271, 1, 0, 1
1169, 1, 1636420615961, 1636420616225, 264, 1, 263, 0, 1, 1
1170, 1, 1636420616081, 1636420616354, 273, 1, 272, 1, 0, 1
1181, 1, 1636420616333, 1636420616601, 268, 1, 267, 0, 1, 1
1182, 1, 1636420616430, 1636420616698, 268, 0, 268, 0, 0, 0
1183, 1, 1636420616449, 1636420616717, 268, 1, 267, 0, 0, 0
1185, 1, 1636420616701, 1636420616969, 268, 1, 267, 0, 0, 0
1186, 1, 1636420616974, 1636420617238, 264, 0, 264, 0, 0, 0
1187, 1, 1636420617025, 1636420617298, 273, 1, 272, 0, 0, 0
1188, 1, 1636420617274, 1636420617542, 268, 0, 268, 0, 0, 0
1189, 1, 1636420617409, 1636420617677, 268, 1, 267, 0, 0, 0
1190, 1, 1636420617434, 1636420617701, 267, 0, 267, 0, 0, 0
1191, 1, 1636420617685, 1636420617950, 265, 0, 265, 0, 0, 0
1192, 1, 1636420617713, 1636420617978, 265, 1, 264, 0, 0, 0
1193, 1, 1636420618009, 1636420618274, 265, 1, 264, 0, 1, 1
1194, 1, 1636420618273, 1636420618538, 265, 1, 264, 0, 0, 0
1195, 1, 1636420618449, 1636420618714, 265, 1, 264, 0, 0, 0
1196, 1, 1636420618469, 1636420618738, 269, 0, 269, 0, 0, 0
1198, 1, 1636420618689, 1636420618958, 269, 1, 268, 0, 0, 0
1197, 1, 1636420618717, 1636420618981, 264, 1, 263, 0, 1, 1
1199, 1, 1636420619025, 1636420619294, 269, 1, 268, 0, 0, 0
1200, 1, 1636420619277, 1636420619545, 268, 1, 267, 0, 0, 0
1201, 1, 1636420619449, 1636420619717, 268, 1, 267, 1, 0, 1
1202, 1, 1636420619489, 1636420619757, 268, 1, 267, 0, 0, 0
1205, 1, 1636420619677, 1636420619941, 264, 0, 264, 0, 0, 0
1204, 1, 1636420619705, 1636420619977, 272, 0, 272, 0, 0, 0
1203, 1, 1636420619717, 1636420619981, 264, 0, 264, 0, 0, 0
1206, 1, 1636420620053, 1636420620317, 264, 0, 264, 0, 0, 0
1207, 1, 1636420620265, 1636420620534, 269, 1, 268, 0, 1, 1
1208, 1, 1636420620405, 1636420620726, 321, 0, 321, 0, 0, 0
1209, 1, 1636420620482, 1636420620749, 267, 0, 267, 0, 0, 0
1210, 1, 1636420620634, 1636420620906, 272, 0, 272, 0, 0, 0
1212, 1, 1636420620642, 1636420620910, 268, 0, 268, 0, 0, 0
1211, 1, 1636420620726, 1636420620998, 272, 0, 272, 0, 0, 0
1213, 1, 1636420621026, 1636420621293, 267, 0, 267, 0, 0, 0
1214, 1, 1636420621073, 1636420621337, 264, 1, 263, 0, 0, 0
1216, 1, 1636420621257, 1636420621521, 264, 1, 263, 0, 0, 0
1217, 1, 1636420621369, 1636420621638, 269, 1, 268, 1, 0, 1
1218, 1, 1636420621513, 1636420621781, 268, 0, 268, 0, 0, 0
1219, 1, 1636420621605, 1636420621874, 269, 1, 268, 0, 0, 0
1220, 1, 1636420621641, 1636420621910, 269, 1, 268, 0, 1, 1
1221, 1, 1636420621653, 1636420621921, 268, 1, 267, 0, 0, 0
1222, 1, 1636420621921, 1636420622185, 264, 1, 263, 0, 1, 1
1223, 1, 1636420622042, 1636420622309, 267, 0, 267, 0, 0, 0
1224, 1, 1636420622277, 1636420622545, 268, 1, 267, 0, 0, 0
1225, 1, 1636420622377, 1636420622642, 265, 0, 265, 0, 0, 0
1226, 1, 1636420622525, 1636420622794, 269, 0, 269, 0, 0, 0
1227, 1, 1636420622573, 1636420622838, 265, 0, 265, 0, 0, 0
1228, 1, 1636420622653, 1636420622921, 268, 1, 267, 0, 0, 0
1229, 1, 1636420622693, 1636420622962, 269, 1, 268, 0, 1, 1
1230, 1, 1636420622937, 1636420623205, 268, 1, 267, 0, 1, 1
1231, 1, 1636420623065, 1636420623333, 268, 1, 267, 0, 1, 1
1232, 1, 1636420623282, 1636420623550, 268, 0, 268, 0, 0, 0
1233, 1, 1636420623341, 1636420623605, 264, 1, 263, 1, 0, 1
1234, 1, 1636420623557, 1636420623822, 265, 1, 264, 0, 1, 1
1235, 1, 1636420623601, 1636420623866, 265, 0, 265, 0, 0, 0
1236, 1, 1636420623613, 1636420623881, 268, 0, 268, 0, 0, 0
1237, 1, 1636420623685, 1636420623957, 272, 1, 271, 0, 1, 1
1238, 1, 1636420623945, 1636420624214, 269, 1, 268, 1, 0, 1
1239, 1, 1636420624082, 1636420624350, 268, 0, 268, 0, 0, 0
1240, 1, 1636420624258, 1636420624525, 267, 0, 267, 0, 0, 0
1241, 1, 1636420624353, 1636420624617, 264, 1, 263, 0, 0, 0
1242, 1, 1636420624577, 1636420624842, 265, 1, 264, 0, 0, 0
1243, 1, 1636420624589, 1636420624861, 272, 1, 271, 0, 0, 0
1244, 1, 1636420624630, 1636420624901, 271, 0, 271, 0, 0, 0
1245, 1, 1636420624654, 1636420624917, 263, 0, 263, 0, 0, 0
1246, 1, 1636420624941, 1636420625209, 268, 1, 267, 1, 0, 1
1247, 1, 1636420625085, 1636420625354, 269, 1, 268, 0, 0, 0
1248, 1, 1636420625254, 1636420625522, 268, 0, 268, 0, 0, 0
1249, 1, 1636420625334, 1636420625598, 264, 0, 264, 0, 0, 0
1250, 1, 1636420625573, 1636420625841, 268, 0, 268, 0, 0, 0
1252, 1, 1636420625613, 1636420625881, 268, 1, 267, 0, 0, 0
1253, 1, 1636420625654, 1636420625918, 264, 0, 264, 0, 0, 0
1254, 1, 1636420625905, 1636420626654, 749, 1, 748, 0, 1, 1
1255, 1, 1636420626569, 1636420626842, 273, 1, 272, 0, 0, 0
1256, 1, 1636420626657, 1636420626929, 272, 0, 272, 0, 0, 0
1259, 1, 1636420626701, 1636420626969, 268, 1, 267, 1, 0, 1
1258, 1, 1636420626701, 1636420626970, 269, 1, 268, 1, 0, 1
1257, 1, 1636420626733, 1636420627001, 268, 0, 268, 0, 0, 0
1272, 1, 1636420627054, 1636420627317, 263, 0, 263, 0, 0, 0
1273, 1, 1636420627233, 1636420627498, 265, 1, 264, 0, 1, 1
1274, 1, 1636420627325, 1636420627594, 269, 1, 268, 0, 1, 1
1275, 1, 1636420627365, 1636420627633, 268, 1, 267, 1, 0, 1
1277, 1, 1636420627673, 1636420627942, 269, 1, 268, 0, 0, 0
1279, 1, 1636420628198, 1636420628462, 264, 0, 264, 0, 0, 0
1280, 1, 1636420628281, 1636420628546, 265, 1, 264, 0, 0, 0
1281, 1, 1636420628337, 1636420628602, 265, 1, 264, 0, 0, 0
1282, 1, 1636420628702, 1636420628970, 268, 0, 268, 0, 0, 0
1283, 1, 1636420629217, 1636420629485, 268, 1, 267, 0, 0, 0
1284, 1, 1636420629261, 1636420629525, 264, 1, 263, 0, 0, 0
1285, 1, 1636420629341, 1636420629606, 265, 0, 265, 0, 0, 0
1286, 1, 1636420629702, 1636420629970, 268, 0, 268, 0, 0, 0
1287, 1, 1636420630242, 1636420630509, 267, 0, 267, 0, 0, 0
1288, 1, 1636420630249, 1636420630517, 268, 1, 267, 0, 1, 1
1289, 1, 1636420630366, 1636420630630, 264, 0, 264, 0, 0, 0
1290, 1, 1636420630725, 1636420630998, 273, 1, 272, 0, 0, 0
1215, 2, 1636420621293, 1636420631337, 10044, 0, 10044, 0, 0, 0
1292, 1, 1636420631289, 1636420631562, 273, 1, 272, 0, 1, 1
1291, 1, 1636420631222, 1636420631562, 340, 0, 340, 0, 0, 0
1278, 1, 1636420631386, 1636420631649, 263, 0, 263, 0, 0, 0
1293, 1, 1636420631470, 1636420631733, 263, 0, 263, 0, 0, 0
1294, 1, 1636420631690, 1636420631954, 264, 0, 264, 0, 0, 0
1295, 1, 1636420631750, 1636420632013, 263, 0, 263, 0, 0, 0
1296, 1, 1636420632050, 1636420632313, 263, 0, 263, 0, 0, 0
1298, 1, 1636420632297, 1636420632570, 273, 1, 272, 0, 0, 0
1297, 1, 1636420632313, 1636420632577, 264, 1, 263, 0, 0, 0
1299, 1, 1636420632393, 1636420632658, 265, 1, 264, 0, 0, 0
1300, 1, 1636420632581, 1636420632846, 265, 0, 265, 0, 0, 0
1301, 1, 1636420632786, 1636420633054, 268, 0, 268, 0, 0, 0
1302, 1, 1636420632974, 1636420633242, 268, 0, 268, 0, 0, 0
1303, 1, 1636420633262, 1636420633526, 264, 0, 264, 0, 0, 0
1304, 1, 1636420633317, 1636420633585, 268, 0, 268, 0, 0, 0
1305, 1, 1636420633385, 1636420633650, 265, 1, 264, 1, 0, 1
1306, 1, 1636420633617, 1636420633886, 269, 1, 268, 0, 1, 1
1307, 1, 1636420633765, 1636420634029, 264, 0, 264, 0, 0, 0
1308, 1, 1636420633982, 1636420634246, 264, 0, 264, 0, 0, 0
1310, 1, 1636420634285, 1636420634549, 264, 1, 263, 0, 1, 1
1309, 1, 1636420634282, 1636420634557, 275, 0, 275, 0, 0, 0
1311, 1, 1636420634365, 1636420634630, 265, 1, 264, 0, 0, 0
1312, 1, 1636420634617, 1636420634882, 265, 1, 264, 0, 0, 0
1313, 1, 1636420634745, 1636420635014, 269, 1, 268, 0, 1, 1
1314, 1, 1636420634962, 1636420635225, 263, 0, 263, 0, 0, 0
1315, 1, 1636420635250, 1636420635514, 264, 0, 264, 0, 0, 0
1316, 1, 1636420635270, 1636420635533, 263, 0, 263, 0, 0, 0
1317, 1, 1636420635341, 1636420635634, 293, 1, 292, 0, 1, 1
1318, 1, 1636420635634, 1636420635902, 268, 0, 268, 0, 0, 0
1319, 1, 1636420635721, 1636420635986, 265, 0, 265, 0, 0, 0
1320, 1, 1636420635977, 1636420636241, 264, 1, 263, 1, 0, 1
1321, 1, 1636420636270, 1636420636538, 268, 0, 268, 0, 0, 0
1322, 1, 1636420636286, 1636420636550, 264, 0, 264, 0, 0, 0
1323, 1, 1636420636362, 1636420636625, 263, 0, 263, 0, 0, 0
1324, 1, 1636420636601, 1636420636866, 265, 1, 264, 0, 1, 1
1325, 1, 1636420636754, 1636420637477, 723, 0, 723, 0, 0, 0
1276, 1, 1636420637297, 1636420637570, 273, 1, 272, 0, 1, 1
1326, 1, 1636420637389, 1636420637657, 268, 0, 268, 0, 0, 0
1328, 1, 1636420637425, 1636420637694, 269, 1, 268, 0, 0, 0
1329, 1, 1636420637430, 1636420637694, 264, 0, 264, 0, 0, 0
1327, 1, 1636420637430, 1636420637694, 264, 0, 264, 0, 0, 0
1342, 1, 1636420637877, 1636420638146, 269, 1, 268, 0, 1, 1
1343, 1, 1636420637885, 1636420638154, 269, 1, 268, 0, 1, 1
1345, 1, 1636420638054, 1636420638317, 263, 0, 263, 0, 0, 0
1344, 1, 1636420638154, 1636420638417, 263, 1, 262, 0, 1, 1
1346, 1, 1636420638269, 1636420638546, 277, 1, 276, 1, 0, 1
1347, 1, 1636420638293, 1636420638562, 269, 1, 268, 0, 1, 1
1348, 1, 1636420638354, 1636420638617, 263, 0, 263, 0, 0, 0
1349, 1, 1636420638790, 1636420639054, 264, 0, 264, 0, 0, 0
1350, 1, 1636420638845, 1636420639122, 277, 1, 276, 0, 0, 0
1352, 1, 1636420639010, 1636420639278, 268, 0, 268, 0, 0, 0
1351, 1, 1636420639054, 1636420639321, 267, 1, 266, 0, 0, 0
1353, 1, 1636420639285, 1636420639558, 273, 1, 272, 0, 0, 0
1354, 1, 1636420639329, 1636420639594, 265, 0, 265, 0, 0, 0
1355, 1, 1636420639365, 1636420639630, 265, 0, 265, 0, 0, 0
1356, 1, 1636420639801, 1636420640070, 269, 0, 269, 0, 0, 0
1357, 1, 1636420639837, 1636420640106, 269, 1, 268, 0, 0, 0
1359, 1, 1636420639982, 1636420640249, 267, 0, 267, 0, 0, 0
1358, 1, 1636420640070, 1636420640334, 264, 0, 264, 0, 0, 0
1360, 1, 1636420640309, 1636420640582, 273, 1, 272, 1, 0, 1
1362, 1, 1636420640358, 1636420640629, 271, 0, 271, 0, 0, 0
1363, 1, 1636420640777, 1636420641050, 273, 1, 272, 0, 0, 0
1364, 1, 1636420640866, 1636420641138, 272, 0, 272, 0, 0, 0
1366, 1, 1636420640986, 1636420641254, 268, 0, 268, 0, 0, 0
1365, 1, 1636420641050, 1636420641313, 263, 1, 262, 0, 0, 0
1367, 1, 1636420641305, 1636420641574, 269, 1, 268, 1, 0, 1
1368, 1, 1636420641357, 1636420641621, 264, 1, 263, 0, 0, 0
1369, 1, 1636420641777, 1636420642049, 272, 1, 271, 0, 1, 1
1370, 1, 1636420641870, 1636420642133, 263, 0, 263, 0, 0, 0
1371, 1, 1636420641953, 1636420642226, 273, 0, 273, 0, 0, 0
1373, 1, 1636420641998, 1636420642261, 263, 0, 263, 0, 0, 0
1374, 1, 1636420642290, 1636420642554, 264, 0, 264, 0, 0, 0
1375, 1, 1636420642374, 1636420642638, 264, 0, 264, 0, 0, 0
1376, 1, 1636420642782, 1636420643045, 263, 0, 263, 0, 0, 0
1377, 1, 1636420642854, 1636420643122, 268, 0, 268, 0, 0, 0
1378, 1, 1636420642862, 1636420643129, 267, 0, 267, 0, 0, 0
1379, 1, 1636420642993, 1636420643262, 269, 1, 268, 0, 1, 1
1381, 1, 1636420643373, 1636420643638, 265, 1, 264, 1, 0, 1
1383, 1, 1636420643866, 1636420644142, 276, 0, 276, 0, 0, 0
1384, 1, 1636420643886, 1636420644158, 272, 0, 272, 0, 0, 0
1385, 1, 1636420643966, 1636420644230, 264, 0, 264, 0, 0, 0
1386, 1, 1636420644382, 1636420644646, 264, 0, 264, 0, 0, 0
1387, 1, 1636420644854, 1636420645129, 275, 0, 275, 0, 0, 0
1388, 1, 1636420644897, 1636420645162, 265, 1, 264, 1, 0, 1
1389, 1, 1636420644982, 1636420645249, 267, 0, 267, 0, 0, 0
1390, 1, 1636420645350, 1636420645613, 263, 0, 263, 0, 0, 0
1391, 1, 1636420645826, 1636420646097, 271, 0, 271, 0, 0, 0
1392, 1, 1636420645886, 1636420646154, 268, 0, 268, 0, 0, 0
1393, 1, 1636420645962, 1636420646230, 268, 0, 268, 0, 0, 0
1394, 1, 1636420646346, 1636420646614, 268, 0, 268, 0, 0, 0
1395, 1, 1636420646794, 1636420647061, 267, 0, 267, 0, 0, 0
1396, 1, 1636420646902, 1636420647169, 267, 0, 267, 0, 0, 0
1397, 1, 1636420646993, 1636420647262, 269, 1, 268, 0, 1, 1
1398, 1, 1636420647333, 1636420648158, 825, 1, 824, 0, 0, 0
1380, 1, 1636420648110, 1636420648374, 264, 0, 264, 0, 0, 0
1399, 1, 1636420648205, 1636420648470, 265, 0, 265, 0, 0, 0
1400, 1, 1636420648201, 1636420648470, 269, 1, 268, 0, 0, 0
1405, 1, 1636420648389, 1636420648661, 272, 1, 271, 0, 0, 0
1414, 1, 1636420648557, 1636420648821, 264, 1, 263, 0, 0, 0
1415, 1, 1636420648770, 1636420649042, 272, 0, 272, 0, 0, 0
1416, 1, 1636420648890, 1636420649158, 268, 0, 268, 0, 0, 0
1417, 1, 1636420648978, 1636420649245, 267, 0, 267, 0, 0, 0
1418, 1, 1636420649278, 1636420649545, 267, 0, 267, 0, 0, 0
1419, 1, 1636420649493, 1636420649761, 268, 1, 267, 0, 0, 0
1420, 1, 1636420649742, 1636420650005, 263, 0, 263, 0, 0, 0
1421, 1, 1636420649853, 1636420650122, 269, 0, 269, 0, 0, 0
1422, 1, 1636420650005, 1636420650273, 268, 1, 267, 1, 0, 1
1423, 1, 1636420650285, 1636420650549, 264, 0, 264, 0, 0, 0
1424, 1, 1636420650501, 1636420650765, 264, 1, 263, 0, 0, 0
1425, 1, 1636420650625, 1636420650889, 264, 1, 263, 0, 0, 0
1426, 1, 1636420650754, 1636420651022, 268, 0, 268, 0, 0, 0
1427, 1, 1636420650882, 1636420651150, 268, 0, 268, 0, 0, 0
1428, 1, 1636420650989, 1636420651253, 264, 1, 263, 0, 1, 1
1429, 1, 1636420651266, 1636420651533, 267, 0, 267, 0, 0, 0
1430, 1, 1636420651493, 1636420651757, 264, 1, 263, 0, 0, 0
1431, 1, 1636420651541, 1636420651810, 269, 0, 269, 0, 0, 0
1432, 1, 1636420651757, 1636420652021, 264, 1, 263, 1, 0, 1
1372, 2, 1636420642049, 1636420652098, 10049, 0, 10049, 0, 0, 0
1433, 1, 1636420651865, 1636420652130, 265, 0, 265, 0, 0, 0
1434, 1, 1636420651978, 1636420652322, 344, 0, 344, 0, 0, 0
1382, 1, 1636420652141, 1636420652409, 268, 1, 267, 0, 1, 1
1435, 1, 1636420652413, 1636420652682, 269, 1, 268, 0, 1, 1
1436, 1, 1636420652449, 1636420652713, 264, 1, 263, 0, 0, 0
1438, 1, 1636420652578, 1636420652846, 268, 0, 268, 0, 0, 0
1439, 1, 1636420652761, 1636420653026, 265, 1, 264, 0, 0, 0
1440, 1, 1636420652805, 1636420653073, 268, 0, 268, 0, 0, 0
1442, 1, 1636420652966, 1636420653230, 264, 0, 264, 0, 0, 0
1443, 1, 1636420653302, 1636420653570, 268, 0, 268, 0, 0, 0
1444, 1, 1636420653361, 1636420653626, 265, 1, 264, 0, 0, 0
1445, 1, 1636420653549, 1636420653821, 272, 1, 271, 0, 0, 0
1446, 1, 1636420653726, 1636420653990, 264, 0, 264, 0, 0, 0
1447, 1, 1636420653734, 1636420654001, 267, 0, 267, 0, 0, 0
1448, 1, 1636420653958, 1636420654225, 267, 0, 267, 0, 0, 0
1449, 1, 1636420654277, 1636420654542, 265, 1, 264, 0, 0, 0
1450, 1, 1636420654358, 1636420654621, 263, 0, 263, 0, 0, 0
1451, 1, 1636420654525, 1636420654789, 264, 1, 263, 0, 0, 0
1452, 1, 1636420654717, 1636420654982, 265, 1, 264, 0, 0, 0
1453, 1, 1636420654746, 1636420655013, 267, 0, 267, 0, 0, 0
1454, 1, 1636420654938, 1636420655201, 263, 0, 263, 0, 0, 0
1455, 1, 1636420655278, 1636420655546, 268, 0, 268, 0, 0, 0
1456, 1, 1636420655325, 1636420655589, 264, 1, 263, 0, 1, 1
1457, 1, 1636420655485, 1636420655750, 265, 1, 264, 1, 0, 1
1458, 1, 1636420655689, 1636420655958, 269, 1, 268, 0, 0, 0
1459, 1, 1636420655758, 1636420656026, 268, 0, 268, 0, 0, 0
1460, 1, 1636420655962, 1636420656230, 268, 0, 268, 0, 0, 0
1461, 1, 1636420656317, 1636420656581, 264, 1, 263, 0, 1, 1
1462, 1, 1636420656345, 1636420656613, 268, 1, 267, 0, 1, 1
1464, 1, 1636420656693, 1636420656966, 273, 1, 272, 0, 0, 0
1465, 1, 1636420656757, 1636420657022, 265, 1, 264, 0, 1, 1
1466, 1, 1636420656938, 1636420657206, 268, 0, 268, 0, 0, 0
1467, 1, 1636420657290, 1636420657553, 263, 0, 263, 0, 0, 0
1468, 1, 1636420657362, 1636420657629, 267, 0, 267, 0, 0, 0
1469, 1, 1636420657670, 1636420657942, 272, 0, 272, 0, 0, 0
1470, 1, 1636420657737, 1636420658001, 264, 1, 263, 1, 0, 1
1472, 1, 1636420658801, 1636420659070, 269, 1, 268, 0, 1, 1
1471, 1, 1636420658801, 1636420659070, 269, 1, 268, 0, 1, 1
1473, 1, 1636420658894, 1636420659166, 272, 0, 272, 0, 0, 0
1475, 1, 1636420658929, 1636420659193, 264, 1, 263, 1, 0, 1
1477, 1, 1636420659105, 1636420659378, 273, 1, 272, 0, 0, 0
1474, 1, 1636420659166, 1636420659433, 267, 1, 266, 0, 0, 0
1487, 1, 1636420659470, 1636420659734, 264, 0, 264, 0, 0, 0
1488, 1, 1636420659470, 1636420659734, 264, 0, 264, 0, 0, 0
1490, 1, 1636420659650, 1636420659917, 267, 0, 267, 0, 0, 0
1489, 1, 1636420659737, 1636420660001, 264, 1, 263, 0, 0, 0
1491, 1, 1636420659834, 1636420660101, 267, 0, 267, 0, 0, 0
1492, 1, 1636420660013, 1636420660278, 265, 1, 264, 0, 1, 1
1494, 1, 1636420660406, 1636420660673, 267, 0, 267, 0, 0, 0
1495, 1, 1636420660533, 1636420660801, 268, 1, 267, 0, 0, 0
1496, 1, 1636420660614, 1636420660882, 268, 0, 268, 0, 0, 0
1497, 1, 1636420660794, 1636420661058, 264, 0, 264, 0, 0, 0
1498, 1, 1636420661021, 1636420661290, 269, 1, 268, 0, 1, 1
1499, 1, 1636420661426, 1636420661690, 264, 0, 264, 0, 0, 0
1500, 1, 1636420661498, 1636420661766, 268, 0, 268, 0, 0, 0
1501, 1, 1636420661577, 1636420661845, 268, 1, 267, 1, 0, 1
1502, 1, 1636420661769, 1636420662033, 264, 1, 263, 0, 0, 0
1503, 1, 1636420662022, 1636420662290, 268, 0, 268, 0, 0, 0
1504, 1, 1636420662437, 1636420662702, 265, 1, 264, 0, 0, 0
1505, 1, 1636420662466, 1636420662737, 271, 0, 271, 0, 0, 0
1506, 1, 1636420662609, 1636420662901, 292, 1, 291, 0, 1, 1
1508, 1, 1636420662753, 1636420663026, 273, 1, 272, 0, 1, 1
1509, 1, 1636420663033, 1636420663301, 268, 0, 268, 0, 0, 0
1511, 1, 1636420663413, 1636420663678, 265, 1, 264, 0, 0, 0
1512, 1, 1636420663469, 1636420663738, 269, 1, 268, 1, 0, 1
1513, 1, 1636420663594, 1636420663862, 268, 0, 268, 0, 0, 0
1514, 1, 1636420663749, 1636420664018, 269, 1, 268, 0, 0, 0
1515, 1, 1636420664038, 1636420664306, 268, 0, 268, 0, 0, 0
1516, 1, 1636420664398, 1636420664666, 268, 0, 268, 0, 0, 0
1517, 1, 1636420664470, 1636420664741, 271, 0, 271, 0, 0, 0
1518, 1, 1636420664561, 1636420664830, 269, 1, 268, 1, 0, 1
1519, 1, 1636420664766, 1636420665034, 268, 0, 268, 0, 0, 0
1520, 1, 1636420665033, 1636420665298, 265, 1, 264, 0, 0, 0
1521, 1, 1636420665430, 1636420665694, 264, 0, 264, 0, 0, 0
1522, 1, 1636420665449, 1636420665714, 265, 1, 264, 0, 0, 0
1523, 1, 1636420665545, 1636420665809, 264, 1, 263, 0, 0, 0
1524, 1, 1636420665793, 1636420666062, 269, 0, 269, 0, 0, 0
1525, 1, 1636420666010, 1636420666277, 267, 0, 267, 0, 0, 0
1526, 1, 1636420666437, 1636420666705, 268, 1, 267, 0, 0, 0
1527, 1, 1636420666458, 1636420666726, 268, 0, 268, 0, 0, 0
1530, 1, 1636420666761, 1636420667029, 268, 1, 267, 0, 1, 1
1529, 1, 1636420666790, 1636420667053, 263, 0, 263, 0, 0, 0
1531, 1, 1636420667045, 1636420667313, 268, 1, 267, 0, 0, 0
1533, 1, 1636420667446, 1636420667709, 263, 0, 263, 0, 0, 0
1532, 1, 1636420667446, 1636420667709, 263, 0, 263, 0, 0, 0
1534, 1, 1636420667701, 1636420667966, 265, 0, 265, 0, 0, 0
1535, 1, 1636420667749, 1636420668014, 265, 1, 264, 0, 1, 1
1536, 1, 1636420668014, 1636420668282, 268, 0, 268, 0, 0, 0
1537, 1, 1636420668434, 1636420668697, 263, 0, 263, 0, 0, 0
1538, 1, 1636420668457, 1636420668726, 269, 1, 268, 0, 1, 1
1539, 1, 1636420668709, 1636420668978, 269, 1, 268, 0, 0, 0
1540, 1, 1636420668738, 1636420669006, 268, 0, 268, 0, 0, 0
1541, 1, 1636420669001, 1636420669666, 665, 1, 664, 0, 1, 1
1493, 1, 1636420669517, 1636420669782, 265, 0, 265, 0, 0, 0
1542, 1, 1636420669609, 1636420669878, 269, 1, 268, 0, 0, 0
1543, 1, 1636420669613, 1636420669881, 268, 1, 267, 0, 0, 0
1544, 1, 1636420669713, 1636420669977, 264, 1, 263, 1, 0, 1
1545, 1, 1636420669741, 1636420670009, 268, 0, 268, 0, 0, 0
1547, 1, 1636420669782, 1636420670046, 264, 0, 264, 0, 0, 0
1556, 1, 1636420670078, 1636420670346, 268, 0, 268, 0, 0, 0
1557, 1, 1636420670178, 1636420670442, 264, 0, 264, 0, 0, 0
1558, 1, 1636420670386, 1636420670650, 264, 0, 264, 0, 0, 0
1559, 1, 1636420670442, 1636420670709, 267, 0, 267, 0, 0, 0
1560, 1, 1636420670697, 1636420670961, 264, 0, 264, 0, 0, 0
1562, 1, 1636420670725, 1636420670994, 269, 1, 268, 0, 0, 0
1561, 1, 1636420670725, 1636420670994, 269, 1, 268, 0, 0, 0
1563, 1, 1636420671037, 1636420671301, 264, 1, 263, 0, 0, 0
1564, 1, 1636420671137, 1636420671402, 265, 1, 264, 0, 0, 0
1565, 1, 1636420671370, 1636420671633, 263, 0, 263, 0, 0, 0
1566, 1, 1636420671457, 1636420671726, 269, 1, 268, 0, 0, 0
1567, 1, 1636420671669, 1636420671934, 265, 1, 264, 0, 0, 0
1568, 1, 1636420671721, 1636420671985, 264, 1, 263, 0, 1, 1
1569, 1, 1636420672025, 1636420672289, 264, 1, 263, 1, 0, 1
1570, 1, 1636420672121, 1636420672393, 272, 1, 271, 0, 0, 0
1571, 1, 1636420672397, 1636420672665, 268, 0, 268, 0, 0, 0
1572, 1, 1636420672437, 1636420672705, 268, 1, 267, 0, 0, 0
1573, 1, 1636420672661, 1636420672933, 272, 0, 272, 0, 0, 0
1574, 1, 1636420672745, 1636420673009, 264, 1, 263, 0, 0, 0
1575, 1, 1636420673005, 1636420673297, 292, 0, 292, 0, 0, 0
1576, 1, 1636420673121, 1636420673389, 268, 0, 268, 0, 0, 0
1577, 1, 1636420673137, 1636420673406, 269, 0, 269, 0, 0, 0
1578, 1, 1636420673377, 1636420673642, 265, 1, 264, 0, 0, 0
1580, 1, 1636420673441, 1636420673706, 265, 1, 264, 0, 1, 1
1579, 1, 1636420673470, 1636420673734, 264, 0, 264, 0, 0, 0
1581, 1, 1636420673641, 1636420673906, 265, 1, 264, 0, 0, 0
1582, 1, 1636420673737, 1636420674001, 264, 1, 263, 0, 0, 0
1583, 1, 1636420674001, 1636420674265, 264, 1, 263, 1, 0, 1
1584, 1, 1636420674001, 1636420674265, 264, 1, 263, 1, 0, 1
1585, 1, 1636420674169, 1636420674433, 264, 1, 263, 0, 0, 0
1586, 1, 1636420674365, 1636420674629, 264, 1, 263, 0, 0, 0
1587, 1, 1636420674406, 1636420674674, 268, 0, 268, 0, 0, 0
1588, 1, 1636420674674, 1636420674942, 268, 0, 268, 0, 0, 0
1589, 1, 1636420674754, 1636420675017, 263, 0, 263, 0, 0, 0
1590, 1, 1636420674973, 1636420675242, 269, 0, 269, 0, 0, 0
1591, 1, 1636420675037, 1636420675310, 273, 1, 272, 0, 1, 1
1592, 1, 1636420675137, 1636420675405, 268, 1, 267, 0, 1, 1
1593, 1, 1636420675397, 1636420675666, 269, 1, 268, 0, 1, 1
1594, 1, 1636420675445, 1636420675709, 264, 1, 263, 0, 0, 0
1595, 1, 1636420675641, 1636420675906, 265, 1, 264, 1, 0, 1
1596, 1, 1636420675753, 1636420676017, 264, 1, 263, 0, 0, 0
1598, 1, 1636420676009, 1636420676274, 265, 1, 264, 0, 0, 0
1599, 1, 1636420676117, 1636420676382, 265, 0, 265, 0, 0, 0
1600, 1, 1636420676370, 1636420676638, 268, 0, 268, 0, 0, 0
1601, 1, 1636420676462, 1636420676730, 268, 0, 268, 0, 0, 0
1602, 1, 1636420676662, 1636420676929, 267, 0, 267, 0, 0, 0
1603, 1, 1636420676733, 1636420676998, 265, 1, 264, 0, 0, 0
1604, 1, 1636420676874, 1636420677141, 267, 0, 267, 0, 0, 0
1605, 1, 1636420677005, 1636420677274, 269, 1, 268, 0, 0, 0
1606, 1, 1636420677145, 1636420677409, 264, 1, 263, 1, 0, 1
1607, 1, 1636420677349, 1636420677617, 268, 0, 268, 0, 0, 0
1608, 1, 1636420677433, 1636420677701, 268, 1, 267, 0, 0, 0
1609, 1, 1636420677654, 1636420677917, 263, 0, 263, 0, 0, 0
1610, 1, 1636420677733, 1636420678002, 269, 1, 268, 0, 0, 0
1611, 1, 1636420677789, 1636420678057, 268, 1, 267, 1, 0, 1
1612, 1, 1636420677969, 1636420678238, 269, 1, 268, 1, 0, 1
1613, 1, 1636420678122, 1636420678389, 267, 0, 267, 0, 0, 0
1614, 1, 1636420678341, 1636420678610, 269, 1, 268, 1, 0, 1
1615, 1, 1636420678610, 1636420678874, 264, 0, 264, 0, 0, 0
1616, 1, 1636420678649, 1636420678914, 265, 1, 264, 0, 0, 0
1617, 1, 1636420678730, 1636420678998, 268, 0, 268, 0, 0, 0
1618, 1, 1636420678810, 1636420679078, 268, 0, 268, 0, 0, 0
1620, 1, 1636420679125, 1636420679389, 264, 1, 263, 0, 0, 0
1622, 1, 1636420679405, 1636420679674, 269, 0, 269, 0, 0, 0
1623, 1, 1636420679674, 1636420680297, 623, 0, 623, 0, 0, 0
1624, 1, 1636420680117, 1636420680385, 268, 1, 267, 1, 0, 1
1625, 1, 1636420680117, 1636420680389, 272, 1, 271, 1, 0, 1
1626, 1, 1636420680249, 1636420680517, 268, 1, 267, 0, 1, 1
1636, 1, 1636420680405, 1636420680673, 268, 1, 267, 0, 0, 0
1637, 1, 1636420680714, 1636420680982, 268, 0, 268, 0, 0, 0
1638, 1, 1636420680785, 1636420681054, 269, 0, 269, 0, 0, 0
1639, 1, 1636420680825, 1636420681093, 268, 1, 267, 0, 0, 0
1640, 1, 1636420681138, 1636420681406, 268, 0, 268, 0, 0, 0
1641, 1, 1636420681381, 1636420681650, 269, 1, 268, 0, 0, 0
1642, 1, 1636420681650, 1636420681914, 264, 0, 264, 0, 0, 0
1644, 1, 1636420681801, 1636420682074, 273, 1, 272, 1, 0, 1
1643, 1, 1636420681917, 1636420682193, 276, 1, 275, 0, 0, 0
1645, 1, 1636420682166, 1636420682429, 263, 0, 263, 0, 0, 0
1646, 1, 1636420682417, 1636420682685, 268, 0, 268, 0, 0, 0
1647, 1, 1636420682621, 1636420682886, 265, 1, 264, 1, 0, 1
1648, 1, 1636420682777, 1636420683041, 264, 1, 263, 0, 0, 0
1649, 1, 1636420682777, 1636420683041, 264, 1, 263, 0, 0, 0
1650, 1, 1636420683134, 1636420683398, 264, 0, 264, 0, 0, 0
1651, 1, 1636420683394, 1636420683662, 268, 0, 268, 0, 0, 0
1652, 1, 1636420683605, 1636420683874, 269, 1, 268, 1, 0, 1
1653, 1, 1636420683781, 1636420684049, 268, 1, 267, 0, 0, 0
1654, 1, 1636420683809, 1636420684078, 269, 1, 268, 0, 0, 0
1655, 1, 1636420684605, 1636420684869, 264, 1, 263, 1, 0, 1
1656, 1, 1636420684810, 1636420685078, 268, 0, 268, 0, 0, 0
1657, 1, 1636420684829, 1636420685098, 269, 1, 268, 0, 1, 1
1659, 1, 1636420685798, 1636420686070, 272, 0, 272, 0, 0, 0
1660, 1, 1636420685830, 1636420686117, 287, 0, 287, 0, 0, 0
1661, 1, 1636420686294, 1636420686562, 268, 0, 268, 0, 0, 0
1662, 1, 1636420686786, 1636420687054, 268, 0, 268, 0, 0, 0
1663, 1, 1636420686806, 1636420687078, 272, 0, 272, 0, 0, 0
1664, 1, 1636420687201, 1636420687466, 265, 1, 264, 0, 1, 1
1665, 1, 1636420687750, 1636420688013, 263, 0, 263, 0, 0, 0
1666, 1, 1636420687817, 1636420688090, 273, 1, 272, 0, 0, 0
1667, 1, 1636420688174, 1636420688442, 268, 0, 268, 0, 0, 0
1668, 1, 1636420688746, 1636420689014, 268, 0, 268, 0, 0, 0
1669, 1, 1636420688809, 1636420689098, 289, 1, 288, 0, 0, 0
1670, 1, 1636420689149, 1636420689413, 264, 1, 263, 0, 0, 0
1671, 1, 1636420689293, 1636420689561, 268, 1, 267, 1, 0, 1
1672, 1, 1636420689641, 1636420689905, 264, 1, 263, 0, 0, 0
1673, 1, 1636420689722, 1636420689985, 263, 0, 263, 0, 0, 0
1674, 1, 1636420689809, 1636420690078, 269, 0, 269, 0, 0, 0
1676, 1, 1636420690189, 1636420690837, 648, 1, 647, 0, 0, 0
1675, 1, 1636420690169, 1636420690837, 668, 1, 667, 1, 0, 1
1677, 1, 1636420690841, 1636420691105, 264, 0, 264, 0, 0, 0
1678, 1, 1636420690881, 1636420691149, 268, 1, 267, 0, 0, 0
1679, 1, 1636420690881, 1636420691153, 272, 1, 271, 0, 0, 0
1683, 1, 1636420691053, 1636420691317, 264, 1, 263, 0, 0, 0
1690, 1, 1636420691233, 1636420691501, 268, 1, 267, 0, 0, 0
1689, 1, 1636420691237, 1636420691501, 264, 1, 263, 0, 1, 1
1691, 1, 1636420691558, 1636420691830, 272, 0, 272, 0, 0, 0
1692, 1, 1636420691741, 1636420692010, 269, 1, 268, 0, 1, 1
1693, 1, 1636420691806, 1636420692073, 267, 0, 267, 0, 0, 0
1694, 1, 1636420691986, 1636420692254, 268, 0, 268, 0, 0, 0
1695, 1, 1636420692189, 1636420692458, 269, 1, 268, 0, 0, 0
1696, 1, 1636420692213, 1636420692482, 269, 1, 268, 0, 1, 1
1697, 1, 1636420692529, 1636420692801, 272, 1, 271, 0, 0, 0
1698, 1, 1636420692830, 1636420693098, 268, 0, 268, 0, 0, 0
1699, 1, 1636420692990, 1636420693258, 268, 0, 268, 0, 0, 0
1700, 1, 1636420693153, 1636420693417, 264, 1, 263, 0, 0, 0
1701, 1, 1636420693257, 1636420693526, 269, 1, 268, 0, 0, 0
1702, 1, 1636420693546, 1636420693814, 268, 0, 268, 0, 0, 0
1703, 1, 1636420693813, 1636420694077, 264, 1, 263, 0, 0, 0
1704, 1, 1636420694005, 1636420694274, 269, 0, 269, 0, 0, 0
1705, 1, 1636420694169, 1636420694433, 264, 1, 263, 1, 0, 1
1706, 1, 1636420694209, 1636420694478, 269, 1, 268, 0, 0, 0
1707, 1, 1636420694586, 1636420694854, 268, 0, 268, 0, 0, 0
1708, 1, 1636420694794, 1636420695066, 272, 0, 272, 0, 0, 0
1709, 1, 1636420695010, 1636420695278, 268, 0, 268, 0, 0, 0
1710, 1, 1636420695162, 1636420695430, 268, 0, 268, 0, 0, 0
1711, 1, 1636420695177, 1636420695446, 269, 1, 268, 0, 0, 0
1712, 1, 1636420695578, 1636420695846, 268, 0, 268, 0, 0, 0
1713, 1, 1636420695802, 1636420696069, 267, 0, 267, 0, 0, 0
1714, 1, 1636420695930, 1636420696194, 264, 0, 264, 0, 0, 0
1715, 1, 1636420696001, 1636420696270, 269, 1, 268, 0, 1, 1
1716, 1, 1636420696154, 1636420696417, 263, 0, 263, 0, 0, 0
1717, 1, 1636420696177, 1636420696450, 273, 1, 272, 0, 0, 0
1718, 1, 1636420696578, 1636420696845, 267, 0, 267, 0, 0, 0
1719, 1, 1636420696798, 1636420697061, 263, 0, 263, 0, 0, 0
1720, 1, 1636420696833, 1636420697102, 269, 0, 269, 0, 0, 0
1721, 1, 1636420696989, 1636420697257, 268, 1, 267, 1, 0, 1
1722, 1, 1636420697122, 1636420697389, 267, 0, 267, 0, 0, 0
1723, 1, 1636420697149, 1636420697414, 265, 1, 264, 0, 0, 0
1724, 1, 1636420697614, 1636420697881, 267, 0, 267, 0, 0, 0
1725, 1, 1636420697802, 1636420698066, 264, 0, 264, 0, 0, 0
1726, 1, 1636420697810, 1636420698081, 271, 0, 271, 0, 0, 0
1727, 1, 1636420698029, 1636420698298, 269, 0, 269, 0, 0, 0
1728, 1, 1636420698121, 1636420698390, 269, 1, 268, 0, 1, 1
1729, 1, 1636420698150, 1636420698422, 272, 0, 272, 0, 0, 0
1730, 1, 1636420698605, 1636420698874, 269, 0, 269, 0, 0, 0
1731, 1, 1636420698789, 1636420699062, 273, 1, 272, 0, 0, 0
1732, 1, 1636420698797, 1636420699065, 268, 1, 267, 1, 0, 1
1733, 1, 1636420699058, 1636420699330, 272, 4, 268, 4, 0, 4
1734, 1, 1636420699117, 1636420699381, 264, 0, 264, 0, 0, 0
1735, 1, 1636420699130, 1636420699394, 264, 0, 264, 0, 0, 0
1736, 1, 1636420699590, 1636420699858, 268, 0, 268, 0, 0, 0
1737, 1, 1636420699802, 1636420700069, 267, 0, 267, 0, 0, 0
1738, 1, 1636420699809, 1636420700085, 276, 1, 275, 0, 0, 0
1739, 1, 1636420699974, 1636420700241, 267, 0, 267, 0, 0, 0
1740, 1, 1636420700121, 1636420700386, 265, 1, 264, 0, 1, 1
1741, 1, 1636420700153, 1636420700417, 264, 1, 263, 0, 0, 0
1742, 1, 1636420700594, 1636420700862, 268, 0, 268, 0, 0, 0
1743, 1, 1636420700790, 1636420701437, 647, 0, 647, 0, 0, 0
1744, 1, 1636420701349, 1636420701617, 268, 1, 267, 0, 0, 0
1745, 1, 1636420701441, 1636420701709, 268, 1, 267, 0, 0, 0
1746, 1, 1636420701441, 1636420701710, 269, 1, 268, 0, 1, 1
1747, 1, 1636420701593, 1636420701857, 264, 1, 263, 0, 0, 0
1756, 1, 1636420701857, 1636420702126, 269, 1, 268, 0, 0, 0
1757, 1, 1636420702030, 1636420702302, 272, 0, 272, 0, 0, 0
1759, 1, 1636420702129, 1636420702398, 269, 0, 269, 0, 0, 0
1758, 1, 1636420702137, 1636420702405, 268, 1, 267, 0, 0, 0
1760, 1, 1636420702626, 1636420702894, 268, 0, 268, 0, 0, 0
1761, 1, 1636420702833, 1636420703106, 273, 0, 273, 0, 0, 0
1762, 1, 1636420702973, 1636420703242, 269, 1, 268, 0, 0, 0
1763, 1, 1636420703089, 1636420703362, 273, 1, 272, 0, 0, 0
1764, 1, 1636420703365, 1636420703634, 269, 1, 268, 0, 0, 0
1765, 1, 1636420703609, 1636420703878, 269, 1, 268, 1, 0, 1
1766, 1, 1636420703817, 1636420704090, 273, 0, 273, 0, 0, 0
1767, 1, 1636420703946, 1636420704218, 272, 0, 272, 0, 0, 0
1768, 1, 1636420704105, 1636420704374, 269, 1, 268, 1, 0, 1
1769, 1, 1636420704117, 1636420704381, 264, 0, 264, 0, 0, 0
1770, 1, 1636420704625, 1636420704894, 269, 0, 269, 0, 0, 0
1772, 1, 1636420704925, 1636420705194, 269, 1, 268, 0, 0, 0
1773, 1, 1636420705085, 1636420705358, 273, 1, 272, 0, 0, 0
1774, 1, 1636420705146, 1636420705414, 268, 0, 268, 0, 0, 0
1775, 1, 1636420705653, 1636420705922, 269, 1, 268, 0, 0, 0
1776, 1, 1636420705925, 1636420706193, 268, 1, 267, 1, 0, 1
1777, 1, 1636420706113, 1636420706386, 273, 1, 272, 0, 0, 0
1779, 1, 1636420706626, 1636420706894, 268, 0, 268, 0, 0, 0
1781, 1, 1636420707141, 1636420707414, 273, 1, 272, 1, 0, 1
1782, 1, 1636420707614, 1636420707881, 267, 0, 267, 0, 0, 0
1783, 1, 1636420708133, 1636420708402, 269, 0, 269, 0, 0, 0
1784, 1, 1636420708614, 1636420708882, 268, 0, 268, 0, 0, 0
1785, 1, 1636420709122, 1636420709390, 268, 0, 268, 0, 0, 0
1786, 1, 1636420709586, 1636420709854, 268, 0, 268, 0, 0, 0
1787, 1, 1636420710086, 1636420710354, 268, 0, 268, 0, 0, 0
1788, 1, 1636420710589, 1636420710858, 269, 1, 268, 0, 0, 0
1789, 1, 1636420711082, 1636420711354, 272, 0, 272, 0, 0, 0
1790, 1, 1636420711941, 1636420712213, 272, 1, 271, 0, 1, 1
1791, 1, 1636420712073, 1636420712342, 269, 1, 268, 0, 1, 1
1800, 1, 1636420712630, 1636420712901, 271, 0, 271, 0, 0, 0
1778, 1, 1636420714806, 1636420715074, 268, 0, 268, 0, 0, 0
1801, 1, 1636420715114, 1636420715381, 267, 0, 267, 0, 0, 0
1802, 1, 1636420715470, 1636420715737, 267, 0, 267, 0, 0, 0
1803, 1, 1636420716017, 1636420716282, 265, 1, 264, 0, 0, 0
1804, 1, 1636420716410, 1636420716678, 268, 0, 268, 0, 0, 0
1805, 1, 1636420717073, 1636420717338, 265, 1, 264, 0, 0, 0
1806, 1, 1636420717246, 1636420717514, 268, 0, 268, 0, 0, 0
1807, 1, 1636420717425, 1636420717690, 265, 1, 264, 0, 0, 0
1808, 1, 1636420718034, 1636420718301, 267, 0, 267, 0, 0, 0
1809, 1, 1636420718153, 1636420718426, 273, 0, 273, 0, 0, 0
1810, 1, 1636420718446, 1636420718710, 264, 0, 264, 0, 0, 0
1811, 1, 1636420719022, 1636420719290, 268, 0, 268, 0, 0, 0
1812, 1, 1636420719133, 1636420719401, 268, 1, 267, 1, 0, 1
1813, 1, 1636420719442, 1636420719710, 268, 0, 268, 0, 0, 0
1814, 1, 1636420720058, 1636420720322, 264, 0, 264, 0, 0, 0
1815, 1, 1636420720122, 1636420720394, 272, 0, 272, 0, 0, 0
1816, 1, 1636420720417, 1636420720682, 265, 0, 265, 0, 0, 0
1817, 1, 1636420721074, 1636420721338, 264, 0, 264, 0, 0, 0
1818, 1, 1636420721138, 1636420721406, 268, 0, 268, 0, 0, 0
1820, 1, 1636420722089, 1636420722709, 620, 1, 619, 0, 0, 0
1821, 1, 1636420722105, 1636420722709, 604, 1, 603, 0, 1, 1
1819, 1, 1636420722570, 1636420722842, 272, 0, 272, 0, 0, 0
1824, 1, 1636420722838, 1636420723109, 271, 0, 271, 0, 0, 0
1830, 1, 1636420723126, 1636420723390, 264, 0, 264, 0, 0, 0
1831, 1, 1636420723153, 1636420723421, 268, 1, 267, 1, 0, 1
1832, 1, 1636420723237, 1636420723506, 269, 1, 268, 0, 0, 0
1833, 1, 1636420723758, 1636420724025, 267, 0, 267, 0, 0, 0
1834, 1, 1636420724065, 1636420724334, 269, 1, 268, 0, 0, 0
1835, 1, 1636420724125, 1636420724394, 269, 1, 268, 0, 0, 0
1836, 1, 1636420724209, 1636420724478, 269, 1, 268, 0, 0, 0
1837, 1, 1636420724774, 1636420725042, 268, 0, 268, 0, 0, 0
1838, 1, 1636420725082, 1636420725346, 264, 0, 264, 0, 0, 0
1839, 1, 1636420725125, 1636420725394, 269, 1, 268, 0, 0, 0
1840, 1, 1636420725217, 1636420725486, 269, 1, 268, 0, 0, 0
1841, 1, 1636420725774, 1636420726041, 267, 0, 267, 0, 0, 0
1843, 1, 1636420726105, 1636420726374, 269, 0, 269, 0, 0, 0
1842, 1, 1636420726105, 1636420726374, 269, 0, 269, 0, 0, 0
1844, 1, 1636420726214, 1636420726478, 264, 0, 264, 0, 0, 0
1845, 1, 1636420726770, 1636420727038, 268, 0, 268, 0, 0, 0
1846, 1, 1636420727101, 1636420727369, 268, 1, 267, 1, 0, 1
1847, 1, 1636420727113, 1636420727381, 268, 1, 267, 0, 1, 1
1848, 1, 1636420727245, 1636420727513, 268, 1, 267, 0, 0, 0
1849, 1, 1636420727762, 1636420728030, 268, 0, 268, 0, 0, 0
1850, 1, 1636420728134, 1636420728406, 272, 0, 272, 0, 0, 0
1851, 1, 1636420728134, 1636420728406, 272, 0, 272, 0, 0, 0
1852, 1, 1636420728217, 1636420728482, 265, 0, 265, 0, 0, 0
1854, 1, 1636420729141, 1636420729414, 273, 1, 272, 1, 0, 1
1855, 1, 1636420729141, 1636420729414, 273, 1, 272, 0, 0, 0
1856, 1, 1636420729210, 1636420729474, 264, 0, 264, 0, 0, 0
1857, 1, 1636420730145, 1636420730414, 269, 1, 268, 0, 1, 1
1858, 1, 1636420730158, 1636420730421, 263, 0, 263, 0, 0, 0
1859, 1, 1636420730182, 1636420730450, 268, 0, 268, 0, 0, 0
1860, 1, 1636420731122, 1636420731394, 272, 0, 272, 0, 0, 0
1861, 1, 1636420731153, 1636420731417, 264, 1, 263, 0, 0, 0
1862, 1, 1636420731178, 1636420731446, 268, 0, 268, 0, 0, 0
1863, 1, 1636420732117, 1636420732386, 269, 0, 269, 0, 0, 0
1864, 1, 1636420732125, 1636420732394, 269, 1, 268, 0, 0, 0
1865, 1, 1636420732185, 1636420732453, 268, 0, 268, 0, 0, 0
1853, 1, 1636420733126, 1636420733394, 268, 0, 268, 0, 0, 0
1866, 1, 1636420733213, 1636420733478, 265, 0, 265, 0, 0, 0
1868, 1, 1636420733217, 1636420733485, 268, 0, 268, 0, 0, 0
1867, 1, 1636420733485, 1636420733750, 265, 1, 264, 1, 0, 1
1876, 1, 1636420733809, 1636420734078, 269, 1, 268, 0, 0, 0
1877, 1, 1636420734089, 1636420734358, 269, 1, 268, 0, 0, 0
1878, 1, 1636420734181, 1636420734449, 268, 1, 267, 0, 1, 1
1879, 1, 1636420734221, 1636420734489, 268, 0, 268, 0, 0, 0
1880, 1, 1636420734738, 1636420735006, 268, 0, 268, 0, 0, 0
1881, 1, 1636420735049, 1636420735314, 265, 1, 264, 0, 0, 0
1882, 1, 1636420735126, 1636420735390, 264, 0, 264, 0, 0, 0
1883, 1, 1636420735245, 1636420735514, 269, 1, 268, 0, 0, 0
1884, 1, 1636420735773, 1636420736041, 268, 1, 267, 0, 0, 0
1885, 1, 1636420736053, 1636420736317, 264, 1, 263, 0, 0, 0
1886, 1, 1636420736146, 1636420736410, 264, 0, 264, 0, 0, 0
1887, 1, 1636420736225, 1636420736494, 269, 1, 268, 0, 0, 0
1888, 1, 1636420736810, 1636420737082, 272, 0, 272, 0, 0, 0
1889, 1, 1636420737081, 1636420737350, 269, 1, 268, 0, 0, 0
1890, 1, 1636420737157, 1636420737426, 269, 1, 268, 0, 0, 0
1891, 1, 1636420737205, 1636420737474, 269, 0, 269, 0, 0, 0
1892, 1, 1636420737774, 1636420738041, 267, 0, 267, 0, 0, 0
1893, 1, 1636420738057, 1636420738326, 269, 1, 268, 0, 0, 0
1894, 1, 1636420738174, 1636420738438, 264, 0, 264, 0, 0, 0
1895, 1, 1636420738185, 1636420738461, 276, 1, 275, 0, 1, 1
1896, 1, 1636420738746, 1636420739014, 268, 0, 268, 0, 0, 0
1897, 1, 1636420739029, 1636420739298, 269, 1, 268, 0, 1, 1
1898, 1, 1636420739165, 1636420739433, 268, 1, 267, 0, 0, 0
1899, 1, 1636420739198, 1636420739466, 268, 0, 268, 0, 0, 0
1900, 1, 1636420739710, 1636420739982, 272, 0, 272, 0, 0, 0
1901, 1, 1636420739997, 1636420740265, 268, 0, 268, 0, 0, 0
1902, 1, 1636420740165, 1636420740433, 268, 1, 267, 1, 0, 1
1903, 1, 1636420740198, 1636420740462, 264, 0, 264, 0, 0, 0
1904, 1, 1636420740710, 1636420740982, 272, 0, 272, 0, 0, 0
1906, 1, 1636420741189, 1636420741462, 273, 1, 272, 0, 0, 0
1907, 1, 1636420741209, 1636420741474, 265, 1, 264, 1, 0, 1
1910, 1, 1636420742210, 1636420742473, 263, 0, 263, 0, 0, 0
1909, 1, 1636420742206, 1636420742473, 267, 0, 267, 0, 0, 0
1912, 1, 1636420743218, 1636420743738, 520, 0, 520, 0, 0, 0
1911, 1, 1636420743198, 1636420743738, 540, 0, 540, 0, 0, 0
1913, 1, 1636420743958, 1636420744226, 268, 0, 268, 0, 0, 0
1920, 1, 1636420744201, 1636420744470, 269, 0, 269, 0, 0, 0
1922, 1, 1636420744901, 1636420745170, 269, 0, 269, 0, 0, 0
1923, 1, 1636420745221, 1636420745490, 269, 1, 268, 0, 0, 0
1924, 1, 1636420745934, 1636420746197, 263, 0, 263, 0, 0, 0
1925, 1, 1636420746217, 1636420746486, 269, 0, 269, 0, 0, 0
1926, 1, 1636420746958, 1636420747222, 264, 0, 264, 0, 0, 0
1927, 1, 1636420747225, 1636420747494, 269, 1, 268, 0, 1, 1
1928, 1, 1636420747941, 1636420748210, 269, 0, 269, 0, 0, 0
1929, 1, 1636420748198, 1636420748465, 267, 0, 267, 0, 0, 0
1930, 1, 1636420748938, 1636420749205, 267, 0, 267, 0, 0, 0
1931, 1, 1636420749185, 1636420749462, 277, 1, 276, 0, 1, 1
1932, 1, 1636420749961, 1636420750229, 268, 1, 267, 0, 1, 1
1934, 1, 1636420750966, 1636420751234, 268, 0, 268, 0, 0, 0
1935, 1, 1636420751290, 1636420751558, 268, 0, 268, 0, 0, 0
1936, 1, 1636420751974, 1636420752237, 263, 0, 263, 0, 0, 0
1937, 1, 1636420752030, 1636420752297, 267, 0, 267, 0, 0, 0
1938, 1, 1636420752206, 1636420752474, 268, 0, 268, 0, 0, 0
1939, 1, 1636420752946, 1636420753213, 267, 0, 267, 0, 0, 0
1940, 1, 1636420752962, 1636420753225, 263, 0, 263, 0, 0, 0
1941, 1, 1636420753213, 1636420753478, 265, 1, 264, 1, 0, 1
1933, 1, 1636420754189, 1636420754457, 268, 1, 267, 0, 0, 0
1943, 1, 1636420754189, 1636420754458, 269, 2, 267, 1, 0, 1
1942, 1, 1636420754189, 1636420754469, 280, 2, 278, 1, 1, 2
1944, 1, 1636420754322, 1636420754586, 264, 0, 264, 0, 0, 0
1945, 1, 1636420754521, 1636420754786, 265, 1, 264, 0, 0, 0
1952, 1, 1636420754873, 1636420755145, 272, 1, 271, 0, 0, 0
1953, 1, 1636420754926, 1636420755193, 267, 0, 267, 0, 0, 0
1954, 1, 1636420754933, 1636420755197, 264, 1, 263, 1, 0, 1
1955, 1, 1636420755205, 1636420755470, 265, 0, 265, 0, 0, 0
1956, 1, 1636420755413, 1636420755685, 272, 0, 272, 0, 0, 0
1957, 1, 1636420755821, 1636420756089, 268, 1, 267, 1, 0, 1
1958, 1, 1636420755897, 1636420756166, 269, 0, 269, 0, 0, 0
1959, 1, 1636420755925, 1636420756197, 272, 1, 271, 1, 0, 1
1960, 1, 1636420756237, 1636420756501, 264, 1, 263, 1, 0, 1
1961, 1, 1636420756457, 1636420756726, 269, 1, 268, 0, 1, 1
1962, 1, 1636420756826, 1636420757093, 267, 0, 267, 0, 0, 0
1963, 1, 1636420756910, 1636420757178, 268, 0, 268, 0, 0, 0
1964, 1, 1636420756917, 1636420757185, 268, 1, 267, 1, 0, 1
1965, 1, 1636420757233, 1636420757498, 265, 1, 264, 0, 0, 0
1966, 1, 1636420757426, 1636420757694, 268, 0, 268, 0, 0, 0
1967, 1, 1636420757822, 1636420758094, 272, 0, 272, 0, 0, 0
1968, 1, 1636420757894, 1636420758162, 268, 0, 268, 0, 0, 0
1969, 1, 1636420757913, 1636420758185, 272, 1, 271, 0, 0, 0
1970, 1, 1636420758237, 1636420758506, 269, 1, 268, 1, 0, 1
1971, 1, 1636420758506, 1636420758770, 264, 1, 263, 1, 0, 1
1974, 1, 1636420758901, 1636420759169, 268, 1, 267, 0, 0, 0
1973, 1, 1636420758898, 1636420759177, 279, 0, 279, 0, 0, 0
1975, 1, 1636420759278, 1636420759546, 268, 0, 268, 0, 0, 0
1976, 1, 1636420759386, 1636420759654, 268, 0, 268, 0, 0, 0
1977, 1, 1636420759882, 1636420760150, 268, 1, 267, 0, 1, 1
1978, 1, 1636420759882, 1636420760150, 268, 0, 268, 0, 0, 0
1979, 1, 1636420760274, 1636420760538, 264, 0, 264, 0, 0, 0
1981, 1, 1636420760862, 1636420761130, 268, 0, 268, 0, 0, 0
1982, 1, 1636420760873, 1636420761142, 269, 1, 268, 0, 0, 0
1983, 1, 1636420761262, 1636420761530, 268, 0, 268, 0, 0, 0
1984, 1, 1636420761866, 1636420762133, 267, 0, 267, 0, 0, 0
1985, 1, 1636420761882, 1636420762153, 271, 0, 271, 0, 0, 0
1986, 1, 1636420762282, 1636420762550, 268, 0, 268, 0, 0, 0
1987, 1, 1636420762850, 1636420763117, 267, 0, 267, 0, 0, 0
1988, 1, 1636420762886, 1636420763153, 267, 0, 267, 0, 0, 0
1989, 1, 1636420763278, 1636420763550, 272, 0, 272, 0, 0, 0
1990, 1, 1636420763838, 1636420764110, 272, 0, 272, 0, 0, 0
1991, 1, 1636420763897, 1636420764166, 269, 1, 268, 0, 0, 0
1992, 1, 1636420764294, 1636420764814, 520, 0, 520, 0, 0, 0
1993, 1, 1636420764861, 1636420765130, 269, 1, 268, 0, 0, 0
1994, 1, 1636420764913, 1636420765182, 269, 1, 268, 0, 0, 0
2001, 1, 1636420765298, 1636420765570, 272, 0, 272, 0, 0, 0
2002, 1, 1636420765833, 1636420766101, 268, 1, 267, 1, 0, 1
2003, 1, 1636420765945, 1636420766214, 269, 1, 268, 0, 0, 0
2004, 1, 1636420766306, 1636420766578, 272, 0, 272, 0, 0, 0
2005, 1, 1636420766813, 1636420767085, 272, 1, 271, 0, 0, 0
2006, 1, 1636420766950, 1636420767217, 267, 0, 267, 0, 0, 0
2007, 1, 1636420767333, 1636420767606, 273, 1, 272, 0, 0, 0
2008, 1, 1636420767809, 1636420768082, 273, 0, 273, 0, 0, 0
2009, 1, 1636420767958, 1636420768225, 267, 0, 267, 0, 0, 0
2010, 1, 1636420768309, 1636420768578, 269, 1, 268, 0, 0, 0
2011, 1, 1636420768833, 1636420769098, 265, 1, 264, 1, 0, 1
2012, 1, 1636420768977, 1636420769246, 269, 1, 268, 1, 0, 1
2014, 1, 1636420769293, 1636420769558, 265, 1, 264, 0, 0, 0
2015, 1, 1636420769850, 1636420770117, 267, 0, 267, 0, 0, 0
2016, 1, 1636420770014, 1636420770282, 268, 0, 268, 0, 0, 0
2017, 1, 1636420770333, 1636420770602, 269, 1, 268, 0, 1, 1
2018, 1, 1636420770677, 1636420770946, 269, 1, 268, 0, 0, 0
2020, 1, 1636420770993, 1636420771258, 265, 1, 264, 0, 1, 1
2021, 1, 1636420771593, 1636420771862, 269, 1, 268, 0, 0, 0
2022, 1, 1636420771974, 1636420772242, 268, 0, 268, 0, 0, 0
2023, 1, 1636420772606, 1636420772878, 272, 0, 272, 0, 0, 0
2024, 1, 1636420772946, 1636420773214, 268, 0, 268, 0, 0, 0
2025, 1, 1636420773578, 1636420773850, 272, 0, 272, 0, 0, 0
2026, 1, 1636420773981, 1636420774249, 268, 1, 267, 1, 0, 1
2027, 1, 1636420774598, 1636420774866, 268, 0, 268, 0, 0, 0
2028, 1, 1636420775225, 1636420775493, 268, 0, 268, 0, 0, 0
2019, 1, 1636420775270, 1636420775537, 267, 0, 267, 0, 0, 0
2033, 1, 1636420775537, 1636420775802, 265, 0, 265, 0, 0, 0
2035, 1, 1636420775610, 1636420775878, 268, 0, 268, 0, 0, 0
2036, 1, 1636420775933, 1636420776197, 264, 1, 263, 0, 1, 1
2037, 1, 1636420775965, 1636420776230, 265, 1, 264, 0, 1, 1
2038, 1, 1636420776465, 1636420776733, 268, 1, 267, 1, 0, 1
2039, 1, 1636420776582, 1636420776850, 268, 0, 268, 0, 0, 0
2040, 1, 1636420776870, 1636420777133, 263, 0, 263, 0, 0, 0
2041, 1, 1636420776978, 1636420777250, 272, 0, 272, 0, 0, 0
2042, 1, 1636420777490, 1636420777757, 267, 0, 267, 0, 0, 0
2043, 1, 1636420777617, 1636420777885, 268, 0, 268, 0, 0, 0
2044, 1, 1636420777833, 1636420778106, 273, 1, 272, 1, 0, 1
2045, 1, 1636420777953, 1636420778217, 264, 1, 263, 1, 0, 1
2046, 1, 1636420778462, 1636420778730, 268, 0, 268, 0, 0, 0
2047, 1, 1636420778654, 1636420778918, 264, 0, 264, 0, 0, 0
2048, 1, 1636420778813, 1636420779082, 269, 1, 268, 0, 0, 0
2049, 1, 1636420778974, 1636420779242, 268, 0, 268, 0, 0, 0
2050, 1, 1636420779405, 1636420779674, 269, 1, 268, 0, 1, 1
2051, 1, 1636420779461, 1636420779725, 264, 1, 263, 0, 0, 0
2052, 1, 1636420779629, 1636420779898, 269, 1, 268, 0, 0, 0
2053, 1, 1636420779826, 1636420780094, 268, 0, 268, 0, 0, 0
2054, 1, 1636420779985, 1636420780250, 265, 1, 264, 0, 0, 0
2055, 1, 1636420780309, 1636420780577, 268, 1, 267, 0, 1, 1
2056, 1, 1636420780485, 1636420780754, 269, 0, 269, 0, 0, 0
2057, 1, 1636420780610, 1636420780874, 264, 0, 264, 0, 0, 0
2058, 1, 1636420780838, 1636420781101, 263, 0, 263, 0, 0, 0
2059, 1, 1636420780966, 1636420781238, 272, 0, 272, 0, 0, 0
2060, 1, 1636420781353, 1636420781617, 264, 1, 263, 1, 0, 1
2061, 1, 1636420781489, 1636420781753, 264, 1, 263, 1, 0, 1
2062, 1, 1636420781606, 1636420781869, 263, 0, 263, 0, 0, 0
2063, 1, 1636420781841, 1636420782110, 269, 1, 268, 0, 1, 1
2064, 1, 1636420781981, 1636420782254, 273, 1, 272, 1, 0, 1
2065, 1, 1636420782325, 1636420782598, 273, 1, 272, 0, 0, 0
2066, 1, 1636420782497, 1636420782765, 268, 0, 268, 0, 0, 0
2067, 1, 1636420782586, 1636420782853, 267, 0, 267, 0, 0, 0
2068, 1, 1636420782841, 1636420783110, 269, 1, 268, 1, 0, 1
2069, 1, 1636420782978, 1636420783246, 268, 0, 268, 0, 0, 0
2070, 1, 1636420783289, 1636420783554, 265, 1, 264, 0, 0, 0
2071, 1, 1636420783482, 1636420783750, 268, 0, 268, 0, 0, 0
2072, 1, 1636420783609, 1636420783877, 268, 1, 267, 0, 0, 0
2073, 1, 1636420783869, 1636420784133, 264, 0, 264, 0, 0, 0
2074, 1, 1636420783966, 1636420784230, 264, 0, 264, 0, 0, 0
2075, 1, 1636420784273, 1636420784541, 268, 1, 267, 0, 0, 0
2076, 1, 1636420784457, 1636420784722, 265, 1, 264, 0, 1, 1
2077, 1, 1636420784593, 1636420784862, 269, 1, 268, 1, 0, 1
2078, 1, 1636420784885, 1636420785154, 269, 1, 268, 0, 1, 1
2079, 1, 1636420784957, 1636420785226, 269, 1, 268, 0, 1, 1
2081, 1, 1636420785442, 1636420785869, 427, 0, 427, 0, 0, 0
2082, 1, 1636420785778, 1636420786041, 263, 0, 263, 0, 0, 0
2083, 1, 1636420785905, 1636420786169, 264, 1, 263, 0, 0, 0
2085, 1, 1636420785957, 1636420786221, 264, 1, 263, 0, 1, 1
2084, 1, 1636420786001, 1636420786269, 268, 1, 267, 0, 0, 0
2090, 1, 1636420786433, 1636420786701, 268, 1, 267, 0, 1, 1
2091, 1, 1636420786622, 1636420786885, 263, 0, 263, 0, 0, 0
2092, 1, 1636420786905, 1636420787174, 269, 1, 268, 0, 1, 1
2093, 1, 1636420786929, 1636420787198, 269, 1, 268, 0, 0, 0
2094, 1, 1636420786933, 1636420787201, 268, 0, 268, 0, 0, 0
2095, 1, 1636420787453, 1636420787722, 269, 1, 268, 1, 0, 1
2096, 1, 1636420787606, 1636420787870, 264, 0, 264, 0, 0, 0
2097, 1, 1636420787917, 1636420788181, 264, 1, 263, 0, 1, 1
2098, 1, 1636420787929, 1636420788201, 272, 1, 271, 0, 0, 0
2099, 1, 1636420787929, 1636420788205, 276, 1, 275, 0, 0, 0
2100, 1, 1636420788450, 1636420788721, 271, 0, 271, 0, 0, 0
2101, 1, 1636420788590, 1636420788862, 272, 0, 272, 0, 0, 0
2102, 1, 1636420788885, 1636420789154, 269, 0, 269, 0, 0, 0
2103, 1, 1636420788921, 1636420789185, 264, 1, 263, 0, 1, 1
2104, 1, 1636420788933, 1636420789198, 265, 1, 264, 0, 0, 0
2105, 1, 1636420789438, 1636420789706, 268, 0, 268, 0, 0, 0
2106, 1, 1636420789590, 1636420789857, 267, 0, 267, 0, 0, 0
2107, 1, 1636420789853, 1636420790121, 268, 1, 267, 1, 0, 1
2108, 1, 1636420789929, 1636420790198, 269, 1, 268, 1, 0, 1
2109, 1, 1636420789953, 1636420790226, 273, 1, 272, 1, 0, 1
2110, 1, 1636420790414, 1636420790682, 268, 0, 268, 0, 0, 0
2111, 1, 1636420790822, 1636420791094, 272, 0, 272, 0, 0, 0
2112, 1, 1636420790921, 1636420791185, 264, 1, 263, 0, 1, 1
2113, 1, 1636420790938, 1636420791201, 263, 0, 263, 0, 0, 0
2114, 1, 1636420791402, 1636420791674, 272, 0, 272, 0, 0, 0
2115, 1, 1636420791822, 1636420792089, 267, 0, 267, 0, 0, 0
2116, 1, 1636420791910, 1636420792177, 267, 0, 267, 0, 0, 0
2117, 1, 1636420791969, 1636420792238, 269, 1, 268, 0, 1, 1
2118, 1, 1636420792410, 1636420792682, 272, 0, 272, 0, 0, 0
2119, 1, 1636420792793, 1636420793062, 269, 1, 268, 0, 0, 0
2120, 1, 1636420792926, 1636420793193, 267, 0, 267, 0, 0, 0
2121, 1, 1636420792962, 1636420793229, 267, 0, 267, 0, 0, 0
2122, 1, 1636420793393, 1636420793662, 269, 1, 268, 0, 0, 0
2123, 1, 1636420793766, 1636420794038, 272, 0, 272, 0, 0, 0
2124, 1, 1636420793953, 1636420794221, 268, 1, 267, 0, 0, 0
2125, 1, 1636420793973, 1636420794238, 265, 1, 264, 0, 0, 0
2126, 1, 1636420794373, 1636420794642, 269, 1, 268, 0, 0, 0
2127, 1, 1636420794733, 1636420794998, 265, 1, 264, 0, 1, 1
2129, 1, 1636420794954, 1636420795222, 268, 0, 268, 0, 0, 0
2128, 1, 1636420794954, 1636420795222, 268, 0, 268, 0, 0, 0
2130, 1, 1636420795401, 1636420795665, 264, 1, 263, 0, 0, 0
2131, 1, 1636420795570, 1636420795838, 268, 0, 268, 0, 0, 0
2134, 1, 1636420795998, 1636420796334, 336, 0, 336, 0, 0, 0
2133, 1, 1636420795941, 1636420796334, 393, 1, 392, 0, 0, 0
2135, 1, 1636420796369, 1636420796633, 264, 0, 264, 0, 0, 0
2137, 1, 1636420796481, 1636420796754, 273, 1, 272, 1, 0, 1
2136, 1, 1636420796510, 1636420796778, 268, 0, 268, 0, 0, 0
2140, 1, 1636420796778, 1636420797042, 264, 1, 263, 0, 1, 1
2141, 1, 1636420796945, 1636420797210, 265, 0, 265, 0, 0, 0
2142, 1, 1636420796958, 1636420797222, 264, 0, 264, 0, 0, 0
2139, 1, 1636420797041, 1636420797305, 264, 1, 263, 0, 0, 0
2138, 1, 1636420797305, 1636420797569, 264, 1, 263, 1, 0, 1
2143, 1, 1636420797346, 1636420797613, 267, 0, 267, 0, 0, 0
2144, 1, 1636420797421, 1636420797690, 269, 1, 268, 0, 0, 0
2145, 1, 1636420797493, 1636420797758, 265, 1, 264, 0, 0, 0
2146, 1, 1636420797689, 1636420797953, 264, 0, 264, 0, 0, 0
2147, 1, 1636420797717, 1636420797990, 273, 0, 273, 0, 0, 0
2149, 1, 1636420797965, 1636420798234, 269, 1, 268, 0, 1, 1
2150, 1, 1636420797993, 1636420798258, 265, 1, 264, 0, 1, 1
2148, 1, 1636420797990, 1636420798258, 268, 0, 268, 0, 0, 0
2151, 1, 1636420798353, 1636420798626, 273, 1, 272, 1, 0, 1
2152, 1, 1636420798386, 1636420798649, 263, 0, 263, 0, 0, 0
2153, 1, 1636420798474, 1636420798737, 263, 0, 263, 0, 0, 0
2154, 1, 1636420798649, 1636420798914, 265, 1, 264, 1, 0, 1
2155, 1, 1636420798701, 1636420798966, 265, 0, 265, 0, 0, 0
2157, 1, 1636420798957, 1636420799221, 264, 1, 263, 0, 1, 1
2156, 1, 1636420798965, 1636420799229, 264, 1, 263, 0, 0, 0
2158, 1, 1636420798973, 1636420799238, 265, 0, 265, 0, 0, 0
2159, 1, 1636420799381, 1636420799646, 265, 1, 264, 0, 1, 1
2160, 1, 1636420799406, 1636420799670, 264, 0, 264, 0, 0, 0
2161, 1, 1636420799485, 1636420799749, 264, 1, 263, 1, 0, 1
2162, 1, 1636420799670, 1636420799933, 263, 0, 263, 0, 0, 0
2163, 1, 1636420799685, 1636420799954, 269, 1, 268, 0, 0, 0
2164, 1, 1636420799957, 1636420800225, 268, 1, 267, 0, 0, 0
2166, 1, 1636420799974, 1636420800238, 264, 0, 264, 0, 0, 0
2167, 1, 1636420800389, 1636420800658, 269, 1, 268, 0, 1, 1
2168, 1, 1636420800389, 1636420800658, 269, 1, 268, 1, 0, 1
2170, 1, 1636420800521, 1636420800789, 268, 1, 267, 1, 0, 1
2169, 1, 1636420800657, 1636420800926, 269, 2, 267, 0, 0, 0
2171, 1, 1636420800681, 1636420800954, 273, 0, 273, 0, 0, 0
2172, 1, 1636420800953, 1636420801222, 269, 1, 268, 0, 0, 0
2174, 1, 1636420801378, 1636420801646, 268, 0, 268, 0, 0, 0
2175, 1, 1636420801409, 1636420801674, 265, 1, 264, 0, 0, 0
2177, 1, 1636420801498, 1636420801766, 268, 0, 268, 0, 0, 0
2176, 1, 1636420801645, 1636420801910, 265, 1, 264, 0, 0, 0
2178, 1, 1636420801709, 1636420801973, 264, 1, 263, 0, 0, 0
2179, 1, 1636420801977, 1636420802245, 268, 1, 267, 0, 1, 1
2180, 1, 1636420802410, 1636420802678, 268, 0, 268, 0, 0, 0
2181, 1, 1636420802438, 1636420802709, 271, 0, 271, 0, 0, 0
2183, 1, 1636420802501, 1636420802778, 277, 1, 276, 0, 0, 0
2182, 1, 1636420802677, 1636420802941, 264, 1, 263, 0, 0, 0
2184, 1, 1636420802709, 1636420802981, 272, 0, 272, 0, 0, 0
2185, 1, 1636420802981, 1636420803250, 269, 1, 268, 0, 0, 0
2187, 1, 1636420803442, 1636420803705, 263, 0, 263, 0, 0, 0
2186, 1, 1636420803437, 1636420803709, 272, 1, 271, 0, 0, 0
2189, 1, 1636420803522, 1636420803790, 268, 0, 268, 0, 0, 0
2188, 1, 1636420803709, 1636420803978, 269, 1, 268, 1, 0, 1
2190, 1, 1636420803721, 1636420803986, 265, 0, 265, 0, 0, 0
2191, 1, 1636420803985, 1636420804249, 264, 1, 263, 0, 0, 0
2192, 1, 1636420804430, 1636420804702, 272, 0, 272, 0, 0, 0
2193, 1, 1636420804466, 1636420804730, 264, 0, 264, 0, 0, 0
2195, 1, 1636420804521, 1636420804789, 268, 1, 267, 0, 0, 0
2194, 1, 1636420804706, 1636420804970, 264, 0, 264, 0, 0, 0
2198, 1, 1636420805398, 1636420805666, 268, 0, 268, 0, 0, 0
2200, 1, 1636420805490, 1636420805762, 272, 0, 272, 0, 0, 0
2201, 1, 1636420805502, 1636420805770, 268, 0, 268, 0, 0, 0
2199, 1, 1636420805677, 1636420805942, 265, 1, 264, 0, 1, 1
2202, 1, 1636420806029, 1636420806301, 272, 1, 271, 0, 1, 1
2203, 1, 1636420806362, 1636420806625, 263, 0, 263, 0, 0, 0
2205, 1, 1636420806521, 1636420806789, 268, 1, 267, 1, 0, 1
2206, 1, 1636420806529, 1636420806806, 277, 1, 276, 0, 0, 0
2204, 1, 1636420806625, 1636420806898, 273, 1, 272, 0, 0, 0
2207, 1, 1636420806941, 1636420807214, 273, 1, 272, 1, 0, 1
2208, 1, 1636420807330, 1636420807597, 267, 0, 267, 0, 0, 0
2210, 1, 1636420807497, 1636420807765, 268, 1, 267, 0, 1, 1
2211, 1, 1636420807501, 1636420807765, 264, 1, 263, 0, 0, 0
2209, 1, 1636420807597, 1636420807862, 265, 1, 264, 1, 0, 1
2212, 1, 1636420807949, 1636420808222, 273, 1, 272, 1, 0, 1
2214, 1, 1636420808477, 1636420808745, 268, 1, 267, 0, 0, 0
2216, 1, 1636420808518, 1636420808782, 264, 0, 264, 0, 0, 0
2217, 1, 1636420808930, 1636420809197, 267, 0, 267, 0, 0, 0
2218, 1, 1636420809457, 1636420809721, 264, 0, 264, 0, 0, 0
2219, 1, 1636420809498, 1636420809766, 268, 0, 268, 0, 0, 0
2220, 1, 1636420809990, 1636420810258, 268, 0, 268, 0, 0, 0
2222, 1, 1636420810466, 1636420810734, 268, 0, 268, 0, 0, 0
2223, 1, 1636420810534, 1636420810801, 267, 0, 267, 0, 0, 0
2224, 1, 1636420810969, 1636420811238, 269, 1, 268, 0, 0, 0
2225, 1, 1636420811317, 1636420811585, 268, 1, 267, 0, 0, 0
2226, 1, 1636420811445, 1636420811714, 269, 1, 268, 1, 0, 1
2227, 1, 1636420811565, 1636420811834, 269, 1, 268, 0, 0, 0
2228, 1, 1636420811942, 1636420812213, 271, 0, 271, 0, 0, 0
2229, 1, 1636420812245, 1636420812509, 264, 1, 263, 0, 0, 0
2230, 1, 1636420812449, 1636420812714, 265, 1, 264, 0, 0, 0
2231, 1, 1636420812537, 1636420812806, 269, 1, 268, 0, 0, 0
2232, 1, 1636420812950, 1636420813218, 268, 0, 268, 0, 0, 0
2233, 1, 1636420813281, 1636420813550, 269, 1, 268, 1, 0, 1
2234, 1, 1636420813466, 1636420813734, 268, 0, 268, 0, 0, 0
2235, 1, 1636420813985, 1636420814257, 272, 1, 271, 1, 0, 1
2236, 1, 1636420814261, 1636420814526, 265, 1, 264, 0, 0, 0
2237, 1, 1636420814450, 1636420814758, 308, 0, 308, 0, 0, 0
2238, 1, 1636420814982, 1636420815249, 267, 0, 267, 0, 0, 0
2239, 1, 1636420815246, 1636420815514, 268, 0, 268, 0, 0, 0
2241, 1, 1636420815261, 1636420815525, 264, 1, 263, 0, 0, 0
2242, 1, 1636420815473, 1636420815738, 265, 0, 265, 0, 0, 0
2240, 1, 1636420815517, 1636420815786, 269, 0, 269, 0, 0, 0
2243, 1, 1636420815969, 1636420816238, 269, 1, 268, 0, 0, 0
2244, 1, 1636420816162, 1636420816433, 271, 0, 271, 0, 0, 0
2246, 1, 1636420816226, 1636420816494, 268, 0, 268, 0, 0, 0
2245, 1, 1636420816433, 1636420816698, 265, 1, 264, 1, 0, 1
2247, 1, 1636420816485, 1636420816750, 265, 1, 264, 0, 1, 1
2248, 1, 1636420816990, 1636420817258, 268, 0, 268, 0, 0, 0
2249, 1, 1636420817142, 1636420817410, 268, 0, 268, 0, 0, 0
2251, 1, 1636420817229, 1636420817498, 269, 1, 268, 0, 0, 0
2250, 1, 1636420817413, 1636420817677, 264, 1, 263, 0, 0, 0
2252, 1, 1636420817465, 1636420817730, 265, 1, 264, 0, 1, 1
2253, 1, 1636420817986, 1636420818253, 267, 0, 267, 0, 0, 0
2254, 1, 1636420818169, 1636420818437, 268, 1, 267, 1, 0, 1
2256, 1, 1636420818221, 1636420818533, 312, 1, 311, 0, 0, 0
2255, 1, 1636420818445, 1636420818714, 269, 0, 269, 0, 0, 0
2257, 1, 1636420818533, 1636420818798, 265, 0, 265, 0, 0, 0
2258, 1, 1636420818677, 1636420818946, 269, 0, 269, 0, 0, 0
2259, 1, 1636420818946, 1636420819217, 271, 0, 271, 0, 0, 0
2260, 1, 1636420819001, 1636420819269, 268, 1, 267, 1, 0, 1
2261, 1, 1636420819189, 1636420819458, 269, 1, 268, 1, 0, 1
2263, 1, 1636420819233, 1636420819506, 273, 1, 272, 0, 0, 0
2262, 1, 1636420819461, 1636420819733, 272, 1, 271, 0, 1, 1
2264, 1, 1636420819485, 1636420819750, 265, 1, 264, 0, 1, 1
2265, 1, 1636420819569, 1636420819834, 265, 0, 265, 0, 0, 0
2266, 1, 1636420819834, 1636420820097, 263, 0, 263, 0, 0, 0
2267, 1, 1636420819993, 1636420820298, 305, 1, 304, 0, 0, 0
2268, 1, 1636420820209, 1636420820482, 273, 1, 272, 0, 0, 0
2270, 1, 1636420820226, 1636420820493, 267, 0, 267, 0, 0, 0
2271, 1, 1636420820481, 1636420820750, 269, 1, 268, 0, 0, 0
2273, 1, 1636420820549, 1636420820817, 268, 1, 267, 1, 0, 1
2272, 1, 1636420820561, 1636420820830, 269, 1, 268, 0, 1, 1
2274, 1, 1636420820817, 1636420821082, 265, 1, 264, 1, 0, 1
2275, 1, 1636420821001, 1636420821266, 265, 0, 265, 0, 0, 0
2276, 1, 1636420821193, 1636420821462, 269, 1, 268, 0, 0, 0
2277, 1, 1636420821221, 1636420821489, 268, 1, 267, 1, 0, 1
2278, 1, 1636420821465, 1636420821733, 268, 0, 268, 0, 0, 0
2279, 1, 1636420821477, 1636420821741, 264, 1, 263, 0, 0, 0
2280, 1, 1636420821534, 1636420821801, 267, 0, 267, 0, 0, 0
2281, 1, 1636420821801, 1636420822066, 265, 1, 264, 1, 0, 1
2282, 1, 1636420822033, 1636420822302, 269, 1, 268, 1, 0, 1
2283, 1, 1636420822217, 1636420822485, 268, 0, 268, 0, 0, 0
2285, 1, 1636420822477, 1636420822745, 268, 1, 267, 0, 1, 1
2286, 1, 1636420822509, 1636420822777, 268, 1, 267, 0, 0, 0
2287, 1, 1636420822545, 1636420822814, 269, 1, 268, 1, 0, 1
2288, 1, 1636420822813, 1636420823078, 265, 1, 264, 0, 0, 0
2289, 1, 1636420823005, 1636420823273, 268, 1, 267, 0, 0, 0
2290, 1, 1636420823273, 1636420823541, 268, 1, 267, 1, 0, 1
2291, 1, 1636420823449, 1636420823717, 268, 1, 267, 0, 0, 0
2292, 1, 1636420823482, 1636420823749, 267, 0, 267, 0, 0, 0
2293, 1, 1636420823521, 1636420823790, 269, 1, 268, 0, 0, 0
2294, 1, 1636420823793, 1636420824057, 264, 1, 263, 0, 0, 0
2295, 1, 1636420824233, 1636420824509, 276, 1, 275, 1, 0, 1
2296, 1, 1636420824449, 1636420824721, 272, 1, 271, 0, 0, 0
2297, 1, 1636420824449, 1636420824721, 272, 1, 271, 1, 0, 1
2298, 1, 1636420824501, 1636420824766, 265, 1, 264, 0, 1, 1
2299, 1, 1636420824765, 1636420825038, 273, 1, 272, 0, 0, 0
2301, 1, 1636420825414, 1636420825682, 268, 0, 268, 0, 0, 0
2302, 1, 1636420825426, 1636420825690, 264, 0, 264, 0, 0, 0
2303, 1, 1636420825510, 1636420825774, 264, 0, 264, 0, 0, 0
2305, 1, 1636420826398, 1636420826670, 272, 0, 272, 0, 0, 0
2307, 1, 1636420826510, 1636420826778, 268, 0, 268, 0, 0, 0
2308, 1, 1636420827386, 1636420827650, 264, 0, 264, 0, 0, 0
2310, 1, 1636420828421, 1636420828689, 268, 0, 268, 0, 0, 0
2311, 1, 1636420829394, 1636420829662, 268, 0, 268, 0, 0, 0
2269, 2, 1636420820481, 1636420830534, 10053, 0, 10053, 0, 0, 0
2312, 1, 1636420830366, 1636420830669, 303, 0, 303, 0, 0, 0
2300, 1, 1636420830581, 1636420830850, 269, 1, 268, 0, 0, 0
2313, 1, 1636420830890, 1636420831162, 272, 0, 272, 0, 0, 0
2314, 1, 1636420831249, 1636420831513, 264, 1, 263, 0, 1, 1
2315, 1, 1636420831334, 1636420831601, 267, 0, 267, 0, 0, 0
2316, 1, 1636420831782, 1636420832050, 268, 0, 268, 0, 0, 0
2317, 1, 1636420832209, 1636420832482, 273, 0, 273, 0, 0, 0
2319, 1, 1636420832533, 1636420832798, 265, 1, 264, 0, 0, 0
2321, 1, 1636420833190, 1636420833462, 272, 0, 272, 0, 0, 0
2322, 1, 1636420833465, 1636420833730, 265, 0, 265, 0, 0, 0
2323, 1, 1636420834190, 1636420834462, 272, 0, 272, 0, 0, 0
2324, 1, 1636420834478, 1636420834749, 271, 0, 271, 0, 0, 0
2325, 1, 1636420835173, 1636420835442, 269, 1, 268, 0, 0, 0
2326, 1, 1636420835466, 1636420835742, 276, 0, 276, 0, 0, 0
2304, 2, 1636420825774, 1636420835914, 10140, 1, 10139, 0, 1, 1
2327, 1, 1636420836181, 1636420836454, 273, 1, 272, 0, 0, 0
2329, 1, 1636420836454, 1636420836722, 268, 0, 268, 0, 0, 0
2330, 1, 1636420836717, 1636420836985, 268, 1, 267, 0, 0, 0
2331, 1, 1636420837154, 1636420837421, 267, 0, 267, 0, 0, 0
2332, 1, 1636420837449, 1636420837722, 273, 1, 272, 0, 0, 0
2333, 1, 1636420837625, 1636420837894, 269, 0, 269, 0, 0, 0
2335, 1, 1636420838162, 1636420838429, 267, 0, 267, 0, 0, 0
2336, 1, 1636420838457, 1636420838729, 272, 1, 271, 1, 0, 1
2337, 1, 1636420838638, 1636420838906, 268, 0, 268, 0, 0, 0
2338, 1, 1636420839169, 1636420839442, 273, 1, 272, 1, 0, 1
2339, 1, 1636420839425, 1636420839694, 269, 0, 269, 0, 0, 0
2340, 1, 1636420839610, 1636420839882, 272, 0, 272, 0, 0, 0
2341, 1, 1636420840165, 1636420840433, 268, 1, 267, 0, 0, 0
2342, 1, 1636420840458, 1636420840726, 268, 0, 268, 0, 0, 0
2343, 1, 1636420840626, 1636420840890, 264, 0, 264, 0, 0, 0
2344, 1, 1636420841166, 1636420841434, 268, 0, 268, 0, 0, 0
2345, 1, 1636420841449, 1636420841717, 268, 0, 268, 0, 0, 0
2346, 1, 1636420841658, 1636420841926, 268, 0, 268, 0, 0, 0
2347, 1, 1636420842182, 1636420842493, 311, 0, 311, 0, 0, 0
2348, 1, 1636420842457, 1636420842726, 269, 1, 268, 0, 0, 0
2320, 2, 1636420832798, 1636420842841, 10043, 0, 10043, 0, 0, 0
2349, 1, 1636420842670, 1636420842978, 308, 0, 308, 0, 0, 0
2350, 1, 1636420842653, 1636420842978, 325, 1, 324, 0, 1, 1
2328, 1, 1636420842889, 1636420843157, 268, 1, 267, 0, 1, 1
2352, 1, 1636420843173, 1636420843438, 265, 1, 264, 0, 0, 0
2351, 1, 1636420843198, 1636420843469, 271, 0, 271, 0, 0, 0
2353, 1, 1636420843477, 1636420843746, 269, 1, 268, 0, 1, 1
2355, 1, 1636420843569, 1636420843834, 265, 1, 264, 0, 0, 0
2354, 1, 1636420843593, 1636420843857, 264, 1, 263, 0, 1, 1
2356, 1, 1636420843674, 1636420843942, 268, 0, 268, 0, 0, 0
2357, 1, 1636420844106, 1636420844373, 267, 0, 267, 0, 0, 0
2358, 1, 1636420844181, 1636420844449, 268, 1, 267, 0, 0, 0
2359, 1, 1636420844489, 1636420844758, 269, 1, 268, 0, 1, 1
2360, 1, 1636420844561, 1636420844825, 264, 1, 263, 0, 0, 0
2361, 1, 1636420844601, 1636420844869, 268, 0, 268, 0, 0, 0
2362, 1, 1636420844690, 1636420844958, 268, 0, 268, 0, 0, 0
2363, 1, 1636420845077, 1636420845346, 269, 1, 268, 1, 0, 1
2364, 1, 1636420845157, 1636420845430, 273, 1, 272, 0, 0, 0
2365, 1, 1636420845505, 1636420845774, 269, 0, 269, 0, 0, 0
2366, 1, 1636420845549, 1636420845817, 268, 0, 268, 0, 0, 0
2367, 1, 1636420845574, 1636420845846, 272, 0, 272, 0, 0, 0
2368, 1, 1636420845690, 1636420845961, 271, 0, 271, 0, 0, 0
2369, 1, 1636420846065, 1636420846337, 272, 1, 271, 0, 0, 0
2370, 1, 1636420846117, 1636420846385, 268, 0, 268, 0, 0, 0
2371, 1, 1636420846477, 1636420846742, 265, 1, 264, 1, 0, 1
2372, 1, 1636420846577, 1636420846846, 269, 1, 268, 0, 0, 0
2373, 1, 1636420846577, 1636420846846, 269, 1, 268, 0, 0, 0
2374, 1, 1636420846669, 1636420846938, 269, 1, 268, 0, 0, 0
2375, 1, 1636420847081, 1636420847349, 268, 1, 267, 0, 0, 0
2376, 1, 1636420847110, 1636420847378, 268, 0, 268, 0, 0, 0
2379, 1, 1636420847577, 1636420847845, 268, 1, 267, 0, 0, 0
2378, 1, 1636420847573, 1636420847845, 272, 1, 271, 0, 0, 0
2380, 1, 1636420847670, 1636420847933, 263, 0, 263, 0, 0, 0
2382, 1, 1636420848070, 1636420848333, 263, 0, 263, 0, 0, 0
2381, 1, 1636420848105, 1636420848374, 269, 1, 268, 0, 0, 0
2383, 1, 1636420848113, 1636420848378, 265, 1, 264, 0, 1, 1
2385, 1, 1636420848573, 1636420848838, 265, 1, 264, 0, 0, 0
2384, 1, 1636420848569, 1636420848838, 269, 1, 268, 0, 0, 0
2386, 1, 1636420848653, 1636420848917, 264, 1, 263, 0, 0, 0
2387, 1, 1636420849026, 1636420849298, 272, 0, 272, 0, 0, 0
2389, 1, 1636420849090, 1636420849357, 267, 0, 267, 0, 0, 0
2390, 1, 1636420849569, 1636420849834, 265, 1, 264, 0, 0, 0
2391, 1, 1636420849586, 1636420849849, 263, 0, 263, 0, 0, 0
2392, 1, 1636420849677, 1636420849942, 265, 1, 264, 0, 1, 1
2393, 1, 1636420850017, 1636420850286, 269, 1, 268, 0, 1, 1
2394, 1, 1636420850069, 1636420850338, 269, 1, 268, 0, 0, 0
2395, 1, 1636420850582, 1636420850849, 267, 0, 267, 0, 0, 0
2396, 1, 1636420850613, 1636420850877, 264, 1, 263, 0, 0, 0
2397, 1, 1636420850657, 1636420850921, 264, 1, 263, 0, 1, 1
2398, 1, 1636420851010, 1636420851278, 268, 0, 268, 0, 0, 0
2399, 1, 1636420851042, 1636420851309, 267, 0, 267, 0, 0, 0
2400, 1, 1636420851581, 1636420851849, 268, 1, 267, 0, 0, 0
2401, 1, 1636420851606, 1636420851874, 268, 0, 268, 0, 0, 0
2402, 1, 1636420851693, 1636420851958, 265, 1, 264, 0, 0, 0
2403, 1, 1636420852001, 1636420852270, 269, 1, 268, 0, 1, 1
2404, 1, 1636420852050, 1636420852317, 267, 0, 267, 0, 0, 0
2405, 1, 1636420852565, 1636420852833, 268, 1, 267, 0, 1, 1
2406, 1, 1636420852581, 1636420852853, 272, 1, 271, 0, 0, 0
2407, 1, 1636420853005, 1636420853277, 272, 1, 271, 1, 0, 1
2408, 1, 1636420853061, 1636420853330, 269, 1, 268, 1, 0, 1
2410, 1, 1636420853594, 1636420853862, 268, 0, 268, 0, 0, 0
2411, 1, 1636420854009, 1636420854282, 273, 1, 272, 0, 1, 1
2412, 1, 1636420854077, 1636420854353, 276, 1, 275, 0, 0, 0
2413, 1, 1636420854585, 1636420854853, 268, 1, 267, 0, 1, 1
2414, 1, 1636420854970, 1636420855246, 276, 0, 276, 0, 0, 0
2415, 1, 1636420855058, 1636420855326, 268, 0, 268, 0, 0, 0
2416, 1, 1636420855606, 1636420855873, 267, 0, 267, 0, 0, 0
2417, 1, 1636420855937, 1636420856210, 273, 0, 273, 0, 0, 0
2419, 1, 1636420856594, 1636420856861, 267, 0, 267, 0, 0, 0
2420, 1, 1636420856909, 1636420857177, 268, 0, 268, 0, 0, 0
2421, 1, 1636420857606, 1636420857874, 268, 0, 268, 0, 0, 0
2422, 1, 1636420857761, 1636420858030, 269, 1, 268, 0, 0, 0
2424, 1, 1636420858674, 1636420858946, 272, 0, 272, 0, 0, 0
2426, 1, 1636420859669, 1636420859942, 273, 1, 272, 0, 0, 0
2427, 1, 1636420860649, 1636420860921, 272, 1, 271, 0, 0, 0
2428, 1, 1636420861658, 1636420861926, 268, 0, 268, 0, 0, 0
2429, 1, 1636420862641, 1636420862909, 268, 1, 267, 0, 0, 0
2430, 1, 1636420863658, 1636420863925, 267, 0, 267, 0, 0, 0
2431, 1, 1636420863878, 1636420864146, 268, 0, 268, 0, 0, 0
2432, 1, 1636420864657, 1636420864925, 268, 1, 267, 0, 0, 0
2433, 1, 1636420864786, 1636420865054, 268, 0, 268, 0, 0, 0
2434, 1, 1636420865649, 1636420865921, 272, 1, 271, 0, 0, 0
2435, 1, 1636420865765, 1636420866081, 316, 1, 315, 0, 1, 1
2436, 1, 1636420866345, 1636420866617, 272, 1, 271, 1, 0, 1
2437, 1, 1636420866666, 1636420866933, 267, 0, 267, 0, 0, 0
2438, 1, 1636420866757, 1636420867026, 269, 1, 268, 0, 0, 0
2439, 1, 1636420867249, 1636420867517, 268, 0, 268, 0, 0, 0
2440, 1, 1636420867673, 1636420867942, 269, 0, 269, 0, 0, 0
2441, 1, 1636420867765, 1636420868033, 268, 1, 267, 0, 1, 1
2442, 1, 1636420868205, 1636420868473, 268, 1, 267, 1, 0, 1
2443, 1, 1636420868226, 1636420868489, 263, 0, 263, 0, 0, 0
2444, 1, 1636420868677, 1636420868945, 268, 1, 267, 0, 0, 0
2445, 1, 1636420868745, 1636420869017, 272, 1, 271, 0, 0, 0
2446, 1, 1636420869113, 1636420869413, 300, 1, 299, 0, 0, 0
2447, 1, 1636420869193, 1636420869502, 309, 1, 308, 0, 0, 0
2448, 1, 1636420869677, 1636420869946, 269, 1, 268, 0, 0, 0
2449, 1, 1636420869686, 1636420869953, 267, 0, 267, 0, 0, 0
2450, 1, 1636420869753, 1636420870026, 273, 1, 272, 0, 1, 1
2451, 1, 1636420870113, 1636420870381, 268, 1, 267, 0, 0, 0
2452, 1, 1636420870201, 1636420870469, 268, 1, 267, 0, 0, 0
2453, 1, 1636420870617, 1636420870882, 265, 0, 265, 0, 0, 0
2454, 1, 1636420870661, 1636420870925, 264, 0, 264, 0, 0, 0
2455, 1, 1636420870761, 1636420871033, 272, 1, 271, 1, 0, 1
2456, 1, 1636420871089, 1636420871354, 265, 1, 264, 1, 0, 1
2457, 1, 1636420871177, 1636420871446, 269, 1, 268, 0, 1, 1
2458, 1, 1636420871601, 1636420871866, 265, 0, 265, 0, 0, 0
2459, 1, 1636420871649, 1636420871917, 268, 1, 267, 0, 0, 0
2460, 1, 1636420871741, 1636420872010, 269, 1, 268, 1, 0, 1
2461, 1, 1636420872117, 1636420872386, 269, 1, 268, 1, 0, 1
2462, 1, 1636420872181, 1636420872445, 264, 1, 263, 0, 1, 1
2463, 1, 1636420872598, 1636420872862, 264, 0, 264, 0, 0, 0
2464, 1, 1636420872641, 1636420872909, 268, 1, 267, 1, 0, 1
2465, 1, 1636420872765, 1636420873029, 264, 1, 263, 1, 0, 1
2466, 1, 1636420873122, 1636420873394, 272, 0, 272, 0, 0, 0
2467, 1, 1636420873201, 1636420873466, 265, 0, 265, 0, 0, 0
2468, 1, 1636420873597, 1636420873866, 269, 1, 268, 0, 1, 1
2469, 1, 1636420873645, 1636420873910, 265, 1, 264, 0, 0, 0
2470, 1, 1636420873778, 1636420874045, 267, 0, 267, 0, 0, 0
2471, 1, 1636420874089, 1636420874362, 273, 1, 272, 0, 0, 0
2472, 1, 1636420874189, 1636420874454, 265, 1, 264, 1, 0, 1
2473, 1, 1636420874609, 1636420874873, 264, 1, 263, 1, 0, 1
2474, 1, 1636420874621, 1636420874889, 268, 1, 267, 0, 1, 1
2475, 1, 1636420874778, 1636420875046, 268, 0, 268, 0, 0, 0
2476, 1, 1636420875097, 1636420875366, 269, 1, 268, 0, 0, 0
2477, 1, 1636420875197, 1636420875461, 264, 1, 263, 0, 0, 0
2478, 1, 1636420875601, 1636420875866, 265, 0, 265, 0, 0, 0
2479, 1, 1636420875625, 1636420875893, 268, 1, 267, 0, 0, 0
2480, 1, 1636420875777, 1636420876045, 268, 1, 267, 0, 0, 0
2481, 1, 1636420876133, 1636420876402, 269, 1, 268, 0, 0, 0
2482, 1, 1636420876205, 1636420876478, 273, 0, 273, 0, 0, 0
2483, 1, 1636420876569, 1636420876833, 264, 1, 263, 0, 0, 0
2484, 1, 1636420876589, 1636420876857, 268, 1, 267, 0, 0, 0
2485, 1, 1636420876753, 1636420877025, 272, 1, 271, 0, 0, 0
2486, 1, 1636420877133, 1636420877397, 264, 1, 263, 0, 0, 0
2487, 1, 1636420877205, 1636420877469, 264, 0, 264, 0, 0, 0
2488, 1, 1636420877549, 1636420877817, 268, 1, 267, 1, 0, 1
2490, 1, 1636420877746, 1636420878017, 271, 0, 271, 0, 0, 0
2491, 1, 1636420878113, 1636420878385, 272, 1, 271, 0, 0, 0
2492, 1, 1636420878237, 1636420878505, 268, 1, 267, 0, 0, 0
2493, 1, 1636420878517, 1636420878785, 268, 1, 267, 0, 1, 1
2494, 1, 1636420878737, 1636420879009, 272, 1, 271, 0, 0, 0
2495, 1, 1636420879141, 1636420879414, 273, 1, 272, 0, 0, 0
2496, 1, 1636420879209, 1636420879481, 272, 1, 271, 1, 0, 1
2497, 1, 1636420879513, 1636420879781, 268, 1, 267, 0, 0, 0
2498, 1, 1636420879717, 1636420879982, 265, 1, 264, 0, 0, 0
2499, 1, 1636420880133, 1636420880402, 269, 1, 268, 1, 0, 1
2500, 1, 1636420880198, 1636420880466, 268, 0, 268, 0, 0, 0
2501, 1, 1636420880485, 1636420880753, 268, 1, 267, 0, 0, 0
2502, 1, 1636420880685, 1636420880950, 265, 1, 264, 1, 0, 1
2503, 1, 1636420881157, 1636420881426, 269, 0, 269, 0, 0, 0
2504, 1, 1636420881189, 1636420881461, 272, 0, 272, 0, 0, 0
2505, 1, 1636420881457, 1636420881726, 269, 1, 268, 0, 0, 0
2506, 1, 1636420881686, 1636420881953, 267, 0, 267, 0, 0, 0
2507, 1, 1636420882161, 1636420882430, 269, 1, 268, 1, 0, 1
2508, 1, 1636420882426, 1636420882694, 268, 0, 268, 0, 0, 0
2509, 1, 1636420882657, 1636420882922, 265, 1, 264, 0, 1, 1
2510, 1, 1636420883145, 1636420883413, 268, 1, 267, 1, 0, 1
2512, 1, 1636420883634, 1636420883902, 268, 0, 268, 0, 0, 0
2513, 1, 1636420884126, 1636420884398, 272, 0, 272, 0, 0, 0
2514, 1, 1636420884602, 1636420884870, 268, 0, 268, 0, 0, 0
2515, 1, 1636420885098, 1636420885366, 268, 0, 268, 0, 0, 0
2516, 1, 1636420885633, 1636420885901, 268, 1, 267, 0, 0, 0
2517, 1, 1636420886062, 1636420886330, 268, 0, 268, 0, 0, 0
2518, 1, 1636420886606, 1636420886870, 264, 0, 264, 0, 0, 0
2519, 1, 1636420887025, 1636420887289, 264, 0, 264, 0, 0, 0
2520, 1, 1636420887613, 1636420887877, 264, 1, 263, 0, 0, 0
2521, 1, 1636420887877, 1636420888141, 264, 1, 263, 1, 0, 1
2522, 1, 1636420888057, 1636420888321, 264, 1, 263, 0, 1, 1
2523, 1, 1636420888545, 1636420888813, 268, 1, 267, 0, 0, 0
2524, 1, 1636420888785, 1636420889049, 264, 1, 263, 0, 1, 1
2525, 1, 1636420889057, 1636420889321, 264, 1, 263, 0, 1, 1
2527, 1, 1636420889757, 1636420890021, 264, 0, 264, 0, 0, 0
2528, 1, 1636420890050, 1636420890314, 264, 0, 264, 0, 0, 0
2529, 1, 1636420890721, 1636420890985, 264, 1, 263, 1, 0, 1
2530, 1, 1636420891029, 1636420891298, 269, 0, 269, 0, 0, 0
2531, 1, 1636420891753, 1636420892018, 265, 1, 264, 0, 0, 0
2533, 1, 1636420892745, 1636420893013, 268, 1, 267, 0, 1, 1
2534, 1, 1636420893721, 1636420893985, 264, 1, 263, 0, 1, 1
2535, 1, 1636420893749, 1636420894013, 264, 1, 263, 1, 0, 1
2536, 1, 1636420894633, 1636420894897, 264, 1, 263, 0, 0, 0
2537, 1, 1636420894758, 1636420895025, 267, 0, 267, 0, 0, 0
2538, 1, 1636420895661, 1636420895933, 272, 1, 271, 0, 0, 0
2539, 1, 1636420895754, 1636420896022, 268, 0, 268, 0, 0, 0
2540, 1, 1636420896633, 1636420896905, 272, 1, 271, 0, 0, 0
2541, 1, 1636420896757, 1636420897025, 268, 1, 267, 0, 0, 0
2542, 1, 1636420897637, 1636420897906, 269, 1, 268, 0, 1, 1
2543, 1, 1636420897769, 1636420898042, 273, 1, 272, 0, 0, 0
2544, 1, 1636420898637, 1636420898910, 273, 1, 272, 0, 0, 0
2545, 1, 1636420898910, 1636420899178, 268, 1, 267, 1, 0, 1
2546, 1, 1636420899637, 1636420899909, 272, 1, 271, 1, 0, 1
2547, 1, 1636420899789, 1636420900058, 269, 1, 268, 0, 1, 1
2548, 1, 1636420899845, 1636420900114, 269, 1, 268, 0, 0, 0
2549, 1, 1636420900629, 1636420900898, 269, 1, 268, 1, 0, 1
2550, 1, 1636420900749, 1636420901018, 269, 1, 268, 0, 0, 0
2551, 1, 1636420900758, 1636420901022, 264, 0, 264, 0, 0, 0
2552, 1, 1636420901669, 1636420901942, 273, 1, 272, 0, 1, 1
2553, 1, 1636420901749, 1636420902065, 316, 1, 315, 1, 0, 1
2554, 1, 1636420901778, 1636420902065, 287, 0, 287, 0, 0, 0
2555, 1, 1636420902329, 1636420902594, 265, 1, 264, 0, 0, 0
2556, 1, 1636420902641, 1636420902913, 272, 1, 271, 0, 0, 0
2557, 1, 1636420902721, 1636420902990, 269, 1, 268, 0, 0, 0
2558, 1, 1636420902773, 1636420903041, 268, 1, 267, 0, 0, 0
2559, 1, 1636420903237, 1636420903510, 273, 1, 272, 0, 0, 0
2560, 1, 1636420903626, 1636420903889, 263, 0, 263, 0, 0, 0
2561, 1, 1636420903689, 1636420903953, 264, 1, 263, 0, 0, 0
2562, 1, 1636420903794, 1636420904058, 264, 0, 264, 0, 0, 0
2563, 1, 1636420904254, 1636420904526, 272, 0, 272, 0, 0, 0
2564, 1, 1636420904630, 1636420904901, 271, 0, 271, 0, 0, 0
2565, 1, 1636420904661, 1636420904937, 276, 1, 275, 0, 0, 0
2566, 1, 1636420904794, 1636420905061, 267, 0, 267, 0, 0, 0
2567, 1, 1636420905233, 1636420905502, 269, 1, 268, 0, 0, 0
2568, 1, 1636420905661, 1636420905930, 269, 1, 268, 1, 0, 1
2569, 1, 1636420905766, 1636420906034, 268, 0, 268, 0, 0, 0
2570, 1, 1636420906229, 1636420906501, 272, 1, 271, 1, 0, 1
2571, 1, 1636420906633, 1636420906902, 269, 1, 268, 0, 0, 0
2572, 1, 1636420906774, 1636420907041, 267, 0, 267, 0, 0, 0
2573, 1, 1636420907237, 1636420907510, 273, 0, 273, 0, 0, 0
2574, 1, 1636420907622, 1636420907890, 268, 0, 268, 0, 0, 0
2575, 1, 1636420907805, 1636420908078, 273, 1, 272, 0, 0, 0
2576, 1, 1636420908206, 1636420908474, 268, 0, 268, 0, 0, 0
2577, 1, 1636420908585, 1636420908853, 268, 0, 268, 0, 0, 0
2578, 1, 1636420908806, 1636420909078, 272, 0, 272, 0, 0, 0
2579, 1, 1636420909213, 1636420909482, 269, 1, 268, 0, 1, 1
2580, 1, 1636420909617, 1636420909885, 268, 1, 267, 0, 0, 0
2581, 1, 1636420909794, 1636420910062, 268, 0, 268, 0, 0, 0
2582, 1, 1636420910250, 1636420910517, 267, 0, 267, 0, 0, 0
2583, 1, 1636420910593, 1636420910861, 268, 1, 267, 0, 1, 1
2584, 1, 1636420910817, 1636420911086, 269, 1, 268, 0, 1, 1
2585, 1, 1636420911246, 1636420911517, 271, 0, 271, 0, 0, 0
2586, 1, 1636420911561, 1636420911830, 269, 1, 268, 0, 0, 0
2587, 1, 1636420912229, 1636420912498, 269, 1, 268, 1, 0, 1
2588, 1, 1636420912530, 1636420912801, 271, 0, 271, 0, 0, 0
2589, 1, 1636420913257, 1636420913525, 268, 1, 267, 0, 0, 0
2591, 1, 1636420923830, 1636420924102, 272, 0, 272, 0, 0, 0
2592, 1, 1636420924742, 1636420925009, 267, 0, 267, 0, 0, 0
2593, 1, 1636420925750, 1636420926017, 267, 0, 267, 0, 0, 0
2594, 1, 1636420926726, 1636420926994, 268, 0, 268, 0, 0, 0
2595, 1, 1636420927742, 1636420928013, 271, 0, 271, 0, 0, 0
2596, 1, 1636420928746, 1636420929013, 267, 0, 267, 0, 0, 0
2597, 1, 1636420929717, 1636420929990, 273, 1, 272, 0, 1, 1
2598, 1, 1636420930725, 1636420930994, 269, 1, 268, 0, 0, 0
2599, 1, 1636420931762, 1636420932033, 271, 0, 271, 0, 0, 0
2600, 1, 1636420932762, 1636420933029, 267, 0, 267, 0, 0, 0
2601, 1, 1636421195537, 1636421195805, 268, 1, 267, 0, 0, 0
2602, 1, 1636421196201, 1636421196470, 269, 1, 268, 0, 1, 1
2603, 1, 1636421196381, 1636421196649, 268, 1, 267, 1, 0, 1
2604, 1, 1636421196870, 1636421197138, 268, 0, 268, 0, 0, 0
2605, 1, 1636421197050, 1636421197318, 268, 0, 268, 0, 0, 0
2606, 1, 1636421197101, 1636421197365, 264, 1, 263, 1, 0, 1
2607, 1, 1636421197538, 1636421197805, 267, 0, 267, 0, 0, 0
2609, 1, 1636421197717, 1636421197985, 268, 1, 267, 0, 1, 1
2608, 1, 1636421197717, 1636421197989, 272, 1, 271, 1, 0, 1
2610, 1, 1636421197762, 1636421198026, 264, 0, 264, 0, 0, 0
2611, 1, 1636421198205, 1636421198473, 268, 1, 267, 0, 0, 0
2613, 1, 1636421198349, 1636421198613, 264, 1, 263, 0, 1, 1
2612, 1, 1636421198389, 1636421198654, 265, 0, 265, 0, 0, 0
2614, 1, 1636421198397, 1636421198661, 264, 1, 263, 0, 0, 0
2615, 1, 1636421198422, 1636421198685, 263, 0, 263, 0, 0, 0
2616, 1, 1636421198877, 1636421199146, 269, 1, 268, 0, 0, 0
2617, 1, 1636421198897, 1636421199170, 273, 1, 272, 0, 0, 0
2618, 1, 1636421199017, 1636421199281, 264, 1, 263, 0, 0, 0
2619, 1, 1636421199053, 1636421199321, 268, 1, 267, 0, 0, 0
2620, 1, 1636421199061, 1636421199325, 264, 1, 263, 0, 1, 1
2621, 1, 1636421199090, 1636421199362, 272, 0, 272, 0, 0, 0
2623, 1, 1636421199541, 1636421199810, 269, 0, 269, 0, 0, 0
2622, 1, 1636421199549, 1636421199817, 268, 0, 268, 0, 0, 0
2624, 1, 1636421199585, 1636421199854, 269, 1, 268, 0, 0, 0
2625, 1, 1636421199677, 1636421199949, 272, 0, 272, 0, 0, 0
2626, 1, 1636421199721, 1636421199989, 268, 1, 267, 1, 0, 1
2627, 1, 1636421199721, 1636421199989, 268, 1, 267, 1, 0, 1
2628, 1, 1636421199761, 1636421200030, 269, 0, 269, 0, 0, 0
2631, 1, 1636421200198, 1636421200470, 272, 0, 272, 0, 0, 0
2629, 1, 1636421200209, 1636421200478, 269, 1, 268, 0, 0, 0
2630, 1, 1636421200221, 1636421200493, 272, 1, 271, 0, 0, 0
2632, 1, 1636421200254, 1636421200521, 267, 0, 267, 0, 0, 0
2633, 1, 1636421200345, 1636421200613, 268, 0, 268, 0, 0, 0
2635, 1, 1636421200390, 1636421200653, 263, 0, 263, 0, 0, 0
2634, 1, 1636421200389, 1636421200653, 264, 1, 263, 0, 0, 0
2636, 1, 1636421200426, 1636421200689, 263, 0, 263, 0, 0, 0
2637, 1, 1636421200770, 1636421201037, 267, 0, 267, 0, 0, 0
2639, 1, 1636421200874, 1636421201145, 271, 0, 271, 0, 0, 0
2638, 1, 1636421200874, 1636421201153, 279, 0, 279, 0, 0, 0
2641, 1, 1636421200921, 1636421201185, 264, 1, 263, 0, 0, 0
2642, 1, 1636421201009, 1636421201277, 268, 1, 267, 0, 1, 1
2640, 1, 1636421201041, 1636421201309, 268, 0, 268, 0, 0, 0
2643, 1, 1636421201061, 1636421201329, 268, 1, 267, 0, 0, 0
2644, 1, 1636421201061, 1636421201330, 269, 1, 268, 0, 1, 1
2645, 1, 1636421201094, 1636421201365, 271, 0, 271, 0, 0, 0
2646, 1, 1636421201314, 1636421201582, 268, 0, 268, 0, 0, 0
2647, 1, 1636421201438, 1636421201706, 268, 0, 268, 0, 0, 0
2648, 1, 1636421201545, 1636421201814, 269, 1, 268, 0, 0, 0
2649, 1, 1636421201545, 1636421201817, 272, 1, 271, 0, 1, 1
2650, 1, 1636421201585, 1636421201858, 273, 1, 272, 0, 0, 0
2651, 1, 1636421201677, 1636421201945, 268, 1, 267, 0, 0, 0
2652, 1, 1636421201705, 1636421201969, 264, 1, 263, 0, 0, 0
2653, 1, 1636421201729, 1636421201997, 268, 1, 267, 0, 1, 1
2654, 1, 1636421201729, 1636421201998, 269, 1, 268, 0, 0, 0
2655, 1, 1636421201769, 1636421202037, 268, 1, 267, 0, 1, 1
2656, 1, 1636421201978, 1636421202246, 268, 0, 268, 0, 0, 0
2657, 1, 1636421202114, 1636421202381, 267, 0, 267, 0, 0, 0
2658, 1, 1636421202213, 1636421202481, 268, 1, 267, 0, 0, 0
2659, 1, 1636421202213, 1636421202481, 268, 0, 268, 0, 0, 0
2660, 1, 1636421202257, 1636421202525, 268, 1, 267, 0, 0, 0
2661, 1, 1636421202341, 1636421202610, 269, 1, 268, 0, 0, 0
2662, 1, 1636421202369, 1636421202638, 269, 1, 268, 0, 0, 0
2663, 1, 1636421202397, 1636421202661, 264, 0, 264, 0, 0, 0
2664, 1, 1636421202397, 1636421202661, 264, 1, 263, 0, 1, 1
2665, 1, 1636421202437, 1636421202701, 264, 0, 264, 0, 0, 0
2666, 1, 1636421202645, 1636421202913, 268, 1, 267, 0, 1, 1
2667, 1, 1636421202781, 1636421203050, 269, 1, 268, 1, 0, 1
2668, 1, 1636421202877, 1636421203141, 264, 1, 263, 0, 1, 1
2669, 1, 1636421202877, 1636421203141, 264, 1, 263, 1, 0, 1
2670, 1, 1636421202925, 1636421203189, 264, 1, 263, 0, 0, 0
2671, 1, 1636421203009, 1636421203277, 268, 1, 267, 0, 0, 0
2672, 1, 1636421203041, 1636421203305, 264, 1, 263, 0, 1, 1
2674, 1, 1636421203057, 1636421203325, 268, 0, 268, 0, 0, 0
2673, 1, 1636421203065, 1636421203333, 268, 1, 267, 0, 1, 1
2675, 1, 1636421203101, 1636421203369, 268, 0, 268, 0, 0, 0
2677, 1, 1636421203317, 1636421203585, 268, 0, 268, 0, 0, 0
2676, 1, 1636421203325, 1636421203589, 264, 1, 263, 1, 0, 1
2678, 1, 1636421203450, 1636421203721, 271, 0, 271, 0, 0, 0
2680, 1, 1636421203541, 1636421203809, 268, 1, 267, 0, 0, 0
2679, 1, 1636421203541, 1636421203810, 269, 1, 268, 0, 0, 0
2681, 1, 1636421203593, 1636421203861, 268, 0, 268, 0, 0, 0
2682, 1, 1636421203669, 1636421203937, 268, 1, 267, 0, 0, 0
2683, 1, 1636421203709, 1636421203977, 268, 1, 267, 0, 0, 0
2684, 1, 1636421203725, 1636421203989, 264, 1, 263, 0, 0, 0
2685, 1, 1636421203741, 1636421204014, 273, 1, 272, 0, 0, 0
2686, 1, 1636421203769, 1636421204037, 268, 0, 268, 0, 0, 0
2687, 1, 1636421203981, 1636421204250, 269, 1, 268, 1, 0, 1
2688, 1, 1636421203989, 1636421204257, 268, 1, 267, 0, 0, 0
2689, 1, 1636421204117, 1636421204381, 264, 1, 263, 0, 0, 0
2692, 1, 1636421204181, 1636421204454, 273, 1, 272, 0, 0, 0
2691, 1, 1636421204205, 1636421204477, 272, 1, 271, 1, 0, 1
2690, 1, 1636421204205, 1636421204477, 272, 1, 271, 1, 0, 1
2694, 1, 1636421204337, 1636421204601, 264, 1, 263, 0, 1, 1
2696, 1, 1636421204393, 1636421204670, 277, 0, 277, 0, 0, 0
2697, 1, 1636421204413, 1636421204681, 268, 0, 268, 0, 0, 0
2698, 1, 1636421204437, 1636421204705, 268, 0, 268, 0, 0, 0
2693, 1, 1636421204453, 1636421204725, 272, 1, 271, 0, 0, 0
2700, 1, 1636421204649, 1636421204917, 268, 1, 267, 0, 0, 0
2701, 1, 1636421204657, 1636421204925, 268, 0, 268, 0, 0, 0
2702, 1, 1636421204789, 1636421205058, 269, 1, 268, 0, 1, 1
2703, 1, 1636421204869, 1636421205134, 265, 1, 264, 1, 0, 1
2705, 1, 1636421204873, 1636421205145, 272, 1, 271, 1, 0, 1
2706, 1, 1636421205002, 1636421205265, 263, 0, 263, 0, 0, 0
2708, 1, 1636421205077, 1636421205354, 277, 1, 276, 0, 0, 0
2711, 1, 1636421205133, 1636421205401, 268, 1, 267, 0, 0, 0
2710, 1, 1636421205133, 1636421205409, 276, 1, 275, 0, 0, 0
2712, 1, 1636421205317, 1636421205589, 272, 0, 272, 0, 0, 0
2713, 1, 1636421205325, 1636421205597, 272, 1, 271, 1, 0, 1
2714, 1, 1636421205457, 1636421205729, 272, 1, 271, 0, 0, 0
2715, 1, 1636421205537, 1636421205810, 273, 1, 272, 0, 1, 1
2718, 1, 1636421205665, 1636421205938, 273, 1, 272, 1, 0, 1
2719, 1, 1636421205750, 1636421206017, 267, 0, 267, 0, 0, 0
2720, 1, 1636421205801, 1636421206070, 269, 1, 268, 0, 0, 0
2722, 1, 1636421205982, 1636421206258, 276, 0, 276, 0, 0, 0
2723, 1, 1636421205998, 1636421206266, 268, 0, 268, 0, 0, 0
2725, 1, 1636421206214, 1636421206481, 267, 0, 267, 0, 0, 0
2727, 1, 1636421206334, 1636421206602, 268, 0, 268, 0, 0, 0
2729, 1, 1636421206470, 1636421206734, 264, 0, 264, 0, 0, 0
2731, 1, 1636421206669, 1636421206942, 273, 1, 272, 0, 0, 0
2733, 1, 1636421206881, 1636421207150, 269, 1, 268, 1, 0, 1
2735, 1, 1636421207137, 1636421207414, 277, 1, 276, 1, 0, 1
2736, 1, 1636421207341, 1636421207618, 277, 1, 276, 0, 0, 0
2738, 1, 1636421207549, 1636421207817, 268, 1, 267, 1, 0, 1
2741, 1, 1636421208017, 1636421208286, 269, 1, 268, 0, 1, 1
2742, 1, 1636421208217, 1636421208486, 269, 1, 268, 0, 0, 0
2745, 1, 1636421208885, 1636421209158, 273, 1, 272, 0, 0, 0
2699, 2, 1636421204721, 1636421214878, 10157, 5, 10152, 5, 0, 5
2749, 1, 1636421215326, 1636421215642, 316, 1, 315, 0, 0, 0
2748, 1, 1636421215326, 1636421215642, 316, 0, 316, 0, 0, 0
2752, 1, 1636421216041, 1636421216310, 269, 1, 268, 0, 1, 1
2751, 1, 1636421216041, 1636421216310, 269, 1, 268, 0, 0, 0
2754, 1, 1636421216745, 1636421217045, 300, 1, 299, 0, 1, 1
2755, 1, 1636421216745, 1636421217045, 300, 1, 299, 1, 0, 1
2758, 1, 1636421217478, 1636421217754, 276, 1, 275, 0, 1, 1
2759, 1, 1636421217478, 1636421217754, 276, 0, 276, 0, 0, 0
2762, 1, 1636421218158, 1636421218426, 268, 0, 268, 0, 0, 0
2763, 1, 1636421218850, 1636421219122, 272, 0, 272, 0, 0, 0
2764, 1, 1636421219522, 1636421219790, 268, 0, 268, 0, 0, 0
2765, 1, 1636421228126, 1636421228397, 271, 0, 271, 0, 0, 0
2784, 1, 1636421228466, 1636421228734, 268, 0, 268, 0, 0, 0
2785, 1, 1636421235777, 1636421236050, 273, 1, 272, 0, 0, 0
2793, 1, 1636421236085, 1636421236350, 265, 1, 264, 0, 0, 0
2788, 1, 1636421236081, 1636421236350, 269, 0, 269, 0, 0, 0
2787, 1, 1636421236081, 1636421236350, 269, 0, 269, 0, 0, 0
2791, 1, 1636421236381, 1636421236654, 273, 0, 273, 0, 0, 0
2802, 1, 1636421236733, 1636421237001, 268, 1, 267, 0, 0, 0
2805, 1, 1636421236750, 1636421237017, 267, 1, 266, 0, 1, 1
2804, 1, 1636421236750, 1636421237017, 267, 0, 267, 0, 0, 0
2803, 1, 1636421236750, 1636421237026, 276, 1, 275, 0, 0, 0
2806, 1, 1636421237093, 1636421237361, 268, 1, 267, 0, 0, 0
2807, 1, 1636421237361, 1636421237633, 272, 0, 272, 0, 0, 0
2808, 1, 1636421237406, 1636421237701, 295, 0, 295, 0, 0, 0
2809, 1, 1636421237413, 1636421237701, 288, 1, 287, 0, 0, 0
2811, 1, 1636421237425, 1636421237701, 276, 1, 275, 0, 0, 0
2812, 1, 1636421237765, 1636421238034, 269, 1, 268, 1, 0, 1
2813, 1, 1636421237969, 1636421238238, 269, 1, 268, 1, 0, 1
2814, 1, 1636421238034, 1636421238298, 264, 0, 264, 0, 0, 0
2816, 1, 1636421238101, 1636421238370, 269, 1, 268, 0, 1, 1
2817, 1, 1636421238101, 1636421238370, 269, 1, 268, 1, 0, 1
2815, 1, 1636421238101, 1636421238373, 272, 1, 271, 1, 0, 1
2818, 1, 1636421238473, 1636421238746, 273, 0, 273, 0, 0, 0
2819, 1, 1636421238637, 1636421238905, 268, 1, 267, 0, 0, 0
2820, 1, 1636421238713, 1636421238982, 269, 0, 269, 0, 0, 0
2821, 1, 1636421238737, 1636421239006, 269, 1, 268, 0, 0, 0
2824, 1, 1636421238770, 1636421239038, 268, 1, 267, 0, 0, 0
2823, 1, 1636421238770, 1636421239038, 268, 1, 267, 0, 1, 1
2822, 1, 1636421238770, 1636421239038, 268, 1, 267, 0, 0, 0
2810, 1, 1636421239133, 1636421239397, 264, 0, 264, 0, 0, 0
2825, 1, 1636421239177, 1636421239450, 273, 1, 272, 1, 0, 1
2826, 1, 1636421239313, 1636421239585, 272, 1, 271, 1, 0, 1
2827, 1, 1636421239382, 1636421239649, 267, 0, 267, 0, 0, 0
2828, 1, 1636421239405, 1636421239677, 272, 1, 271, 0, 1, 1
2831, 1, 1636421239437, 1636421239706, 269, 1, 268, 0, 0, 0
2829, 1, 1636421239437, 1636421239713, 276, 1, 275, 0, 0, 0
2830, 1, 1636421239449, 1636421239713, 264, 1, 263, 1, 0, 1
2832, 1, 1636421239705, 1636421239973, 268, 1, 267, 0, 0, 0
2834, 1, 1636421239977, 1636421240245, 268, 1, 267, 1, 0, 1
2835, 1, 1636421239981, 1636421240253, 272, 0, 272, 0, 0, 0
2836, 1, 1636421240053, 1636421240321, 268, 1, 267, 0, 0, 0
2837, 1, 1636421240077, 1636421240346, 269, 1, 268, 0, 0, 0
2838, 1, 1636421240106, 1636421240373, 267, 0, 267, 0, 0, 0
2839, 1, 1636421240249, 1636421240521, 272, 1, 271, 0, 1, 1
2840, 1, 1636421240345, 1636421240617, 272, 1, 271, 0, 0, 0
2841, 1, 1636421240369, 1636421240637, 268, 1, 267, 0, 0, 0
2843, 1, 1636421240649, 1636421240921, 272, 1, 271, 0, 0, 0
2842, 1, 1636421240649, 1636421240922, 273, 1, 272, 0, 0, 0
2844, 1, 1636421240721, 1636421240990, 269, 0, 269, 0, 0, 0
2845, 1, 1636421240749, 1636421241017, 268, 1, 267, 1, 0, 1
2847, 1, 1636421240925, 1636421241190, 265, 0, 265, 0, 0, 0
2848, 1, 1636421241013, 1636421241282, 269, 1, 268, 0, 0, 0
2849, 1, 1636421241037, 1636421241310, 273, 1, 272, 1, 0, 1
2850, 1, 1636421241321, 1636421241590, 269, 1, 268, 1, 0, 1
2852, 1, 1636421241390, 1636421241662, 272, 0, 272, 0, 0, 0
2853, 1, 1636421241413, 1636421241686, 273, 1, 272, 0, 1, 1
2856, 1, 1636421241710, 1636421241978, 268, 0, 268, 0, 0, 0
2857, 1, 1636421241989, 1636421242258, 269, 1, 268, 1, 0, 1
2859, 1, 1636421242085, 1636421242354, 269, 1, 268, 0, 0, 0
2860, 1, 1636421242378, 1636421242646, 268, 0, 268, 0, 0, 0
2862, 1, 1636421242754, 1636421243022, 268, 0, 268, 0, 0, 0
2863, 1, 1636421243042, 1636421243310, 268, 0, 268, 0, 0, 0
2865, 1, 1636421243710, 1636421243978, 268, 0, 268, 0, 0, 0
2855, 1, 1636421246530, 1636421246801, 271, 0, 271, 0, 0, 0
2868, 1, 1636421246794, 1636421247062, 268, 0, 268, 0, 0, 0
2867, 1, 1636421246794, 1636421247062, 268, 0, 268, 0, 0, 0
2873, 1, 1636421247065, 1636421247334, 269, 0, 269, 0, 0, 0
2875, 1, 1636421247065, 1636421247334, 269, 0, 269, 0, 0, 0
2880, 1, 1636421247465, 1636421247734, 269, 1, 268, 0, 1, 1
2879, 1, 1636421247465, 1636421247734, 269, 1, 268, 0, 1, 1
2881, 1, 1636421247737, 1636421248006, 269, 1, 268, 1, 0, 1
2882, 1, 1636421247737, 1636421248006, 269, 1, 268, 0, 1, 1
2884, 1, 1636421248130, 1636421248398, 268, 0, 268, 0, 0, 0
2885, 1, 1636421248410, 1636421248682, 272, 0, 272, 0, 0, 0
2887, 1, 1636421248798, 1636421249065, 267, 0, 267, 0, 0, 0
2888, 1, 1636421249082, 1636421249353, 271, 0, 271, 0, 0, 0
2889, 1, 1636421249466, 1636421249737, 271, 0, 271, 0, 0, 0
2890, 1, 1636421249757, 1636421250025, 268, 0, 268, 0, 0, 0
2891, 1, 1636421250101, 1636421250369, 268, 1, 267, 0, 0, 0
2892, 1, 1636421250369, 1636421250637, 268, 1, 267, 0, 0, 0
2893, 1, 1636421250637, 1636421250909, 272, 1, 271, 0, 0, 0
2894, 1, 1636421250769, 1636421251041, 272, 1, 271, 0, 0, 0
2895, 1, 1636421251037, 1636421251310, 273, 1, 272, 0, 0, 0
2896, 1, 1636421251085, 1636421251365, 280, 1, 279, 0, 1, 1
2897, 1, 1636421251310, 1636421251573, 263, 0, 263, 0, 0, 0
2898, 1, 1636421251437, 1636421251725, 288, 1, 287, 0, 0, 0
2899, 1, 1636421251633, 1636421251901, 268, 1, 267, 0, 0, 0
2900, 1, 1636421251705, 1636421251973, 268, 0, 268, 0, 0, 0
2902, 1, 1636421251905, 1636421252194, 289, 1, 288, 1, 0, 1
2903, 1, 1636421252017, 1636421252289, 272, 1, 271, 0, 0, 0
2904, 1, 1636421252153, 1636421252417, 264, 1, 263, 0, 0, 0
2906, 1, 1636421252370, 1636421252638, 268, 0, 268, 0, 0, 0
2910, 1, 1636421252833, 1636421253101, 268, 1, 267, 0, 0, 0
2911, 1, 1636421252961, 1636421253229, 268, 1, 267, 1, 0, 1
2913, 1, 1636421253510, 1636421253777, 267, 0, 267, 0, 0, 0
2915, 1, 1636421253730, 1636421254002, 272, 0, 272, 0, 0, 0
2916, 1, 1636421254178, 1636421254446, 268, 0, 268, 0, 0, 0
2918, 1, 1636421254690, 1636421254958, 268, 0, 268, 0, 0, 0
2919, 1, 1636421254846, 1636421255114, 268, 0, 268, 0, 0, 0
2921, 1, 1636421255513, 1636421255786, 273, 1, 272, 0, 1, 1
2878, 2, 1636421247333, 1636421257381, 10048, 0, 10048, 0, 0, 0
2923, 1, 1636421257322, 1636421257606, 284, 0, 284, 0, 0, 0
2909, 1, 1636421257429, 1636421257697, 268, 1, 267, 0, 0, 0
2926, 1, 1636421257429, 1636421257701, 272, 1, 271, 1, 0, 1
2907, 1, 1636421257701, 1636421257977, 276, 0, 276, 0, 0, 0
2929, 1, 1636421257701, 1636421257985, 284, 0, 284, 0, 0, 0
2928, 1, 1636421257985, 1636421258270, 285, 1, 284, 0, 0, 0
2933, 1, 1636421258105, 1636421258374, 269, 1, 268, 0, 0, 0
2927, 1, 1636421258270, 1636421258542, 272, 1, 271, 0, 1, 1
2935, 1, 1636421258381, 1636421258645, 264, 1, 263, 0, 0, 0
2936, 1, 1636421258450, 1636421258718, 268, 0, 268, 0, 0, 0
2937, 1, 1636421258677, 1636421258945, 268, 1, 267, 0, 1, 1
2938, 1, 1636421258717, 1636421258985, 268, 0, 268, 0, 0, 0
2939, 1, 1636421258765, 1636421259030, 265, 0, 265, 0, 0, 0
2940, 1, 1636421258945, 1636421259209, 264, 1, 263, 1, 0, 1
2941, 1, 1636421259041, 1636421259305, 264, 1, 263, 0, 1, 1
2943, 1, 1636421259341, 1636421259609, 268, 0, 268, 0, 0, 0
2945, 1, 1636421259425, 1636421259690, 265, 1, 264, 1, 0, 1
2946, 1, 1636421259609, 1636421259874, 265, 1, 264, 1, 0, 1
2947, 1, 1636421259706, 1636421259969, 263, 0, 263, 0, 0, 0
2948, 1, 1636421260013, 1636421260281, 268, 0, 268, 0, 0, 0
2949, 1, 1636421260086, 1636421260353, 267, 0, 267, 0, 0, 0
2950, 1, 1636421260281, 1636421260553, 272, 1, 271, 1, 0, 1
2951, 1, 1636421260373, 1636421260642, 269, 1, 268, 0, 0, 0
2952, 1, 1636421260681, 1636421260950, 269, 1, 268, 1, 0, 1
2953, 1, 1636421260749, 1636421261022, 273, 1, 272, 0, 0, 0
2954, 1, 1636421260953, 1636421261217, 264, 1, 263, 0, 1, 1
2955, 1, 1636421261041, 1636421261310, 269, 1, 268, 0, 0, 0
2956, 1, 1636421261350, 1636421261618, 268, 0, 268, 0, 0, 0
2957, 1, 1636421261417, 1636421261690, 273, 1, 272, 0, 1, 1
2958, 1, 1636421261621, 1636421261901, 280, 1, 279, 0, 0, 0
2959, 1, 1636421261725, 1636421261993, 268, 1, 267, 0, 1, 1
2960, 1, 1636421262017, 1636421262289, 272, 1, 271, 0, 1, 1
2961, 1, 1636421262078, 1636421262346, 268, 0, 268, 0, 0, 0
2962, 1, 1636421262081, 1636421262346, 265, 1, 264, 0, 0, 0
2963, 1, 1636421262301, 1636421262574, 273, 1, 272, 1, 0, 1
2964, 1, 1636421262390, 1636421262658, 268, 0, 268, 0, 0, 0
2965, 1, 1636421262637, 1636421262906, 269, 1, 268, 0, 1, 1
2966, 1, 1636421262689, 1636421262961, 272, 1, 271, 1, 0, 1
2968, 1, 1636421262774, 1636421263082, 308, 0, 308, 0, 0, 0
2969, 1, 1636421262905, 1636421263169, 264, 1, 263, 0, 0, 0
2970, 1, 1636421262993, 1636421263261, 268, 1, 267, 1, 0, 1
2972, 1, 1636421263305, 1636421263569, 264, 1, 263, 1, 0, 1
2973, 1, 1636421263349, 1636421263614, 265, 1, 264, 1, 0, 1
2975, 1, 1636421263482, 1636421263766, 284, 0, 284, 0, 0, 0
2976, 1, 1636421263585, 1636421263850, 265, 0, 265, 0, 0, 0
2978, 1, 1636421263934, 1636421264205, 271, 0, 271, 0, 0, 0
2979, 1, 1636421263966, 1636421264233, 267, 0, 267, 0, 0, 0
2980, 1, 1636421264010, 1636421264278, 268, 0, 268, 0, 0, 0
2981, 1, 1636421264161, 1636421264470, 309, 1, 308, 1, 0, 1
2982, 1, 1636421264249, 1636421264557, 308, 1, 307, 0, 0, 0
2983, 1, 1636421264601, 1636421264870, 269, 1, 268, 0, 0, 0
2984, 1, 1636421264633, 1636421264901, 268, 0, 268, 0, 0, 0
2985, 1, 1636421264678, 1636421264949, 271, 0, 271, 0, 0, 0
2986, 1, 1636421264733, 1636421265002, 269, 1, 268, 0, 1, 1
2987, 1, 1636421264873, 1636421265145, 272, 0, 272, 0, 0, 0
2988, 1, 1636421264969, 1636421265238, 269, 0, 269, 0, 0, 0
2989, 1, 1636421265269, 1636421265538, 269, 1, 268, 0, 0, 0
2990, 1, 1636421265317, 1636421265581, 264, 0, 264, 0, 0, 0
2991, 1, 1636421265349, 1636421265617, 268, 1, 267, 0, 1, 1
2922, 1, 1636421265361, 1636421265629, 268, 0, 268, 0, 0, 0
2992, 1, 1636421265405, 1636421265677, 272, 0, 272, 0, 0, 0
2993, 1, 1636421265541, 1636421265810, 269, 0, 269, 0, 0, 0
2994, 1, 1636421265641, 1636421265910, 269, 1, 268, 0, 1, 1
2995, 1, 1636421265669, 1636421265934, 265, 1, 264, 0, 0, 0
2996, 1, 1636421265941, 1636421266209, 268, 1, 267, 0, 0, 0
2997, 1, 1636421265981, 1636421266249, 268, 1, 267, 0, 1, 1
2998, 1, 1636421266017, 1636421266285, 268, 1, 267, 0, 0, 0
2999, 1, 1636421266033, 1636421266309, 276, 1, 275, 0, 0, 0
3000, 1, 1636421266074, 1636421266341, 267, 0, 267, 0, 0, 0
3001, 1, 1636421266209, 1636421266473, 264, 1, 263, 1, 0, 1
3002, 1, 1636421266313, 1636421266585, 272, 0, 272, 0, 0, 0
3003, 1, 1636421266330, 1636421266602, 272, 0, 272, 0, 0, 0
3004, 1, 1636421266609, 1636421266877, 268, 1, 267, 0, 1, 1
3005, 1, 1636421266645, 1636421266917, 272, 1, 271, 1, 0, 1
3006, 1, 1636421266681, 1636421266950, 269, 1, 268, 0, 1, 1
3007, 1, 1636421266710, 1636421266978, 268, 0, 268, 0, 0, 0
3008, 1, 1636421266746, 1636421267010, 264, 0, 264, 0, 0, 0
3009, 1, 1636421266869, 1636421267138, 269, 1, 268, 1, 0, 1
3010, 1, 1636421266990, 1636421267257, 267, 0, 267, 0, 0, 0
3011, 1, 1636421267002, 1636421267269, 267, 0, 267, 0, 0, 0
3012, 1, 1636421267321, 1636421267593, 272, 0, 272, 0, 0, 0
3013, 1, 1636421267325, 1636421267593, 268, 0, 268, 0, 0, 0
3016, 1, 1636421267413, 1636421267681, 268, 1, 267, 1, 0, 1
3014, 1, 1636421267413, 1636421267682, 269, 1, 268, 0, 0, 0
3015, 1, 1636421267413, 1636421267681, 268, 1, 267, 1, 0, 1
3018, 1, 1636421267685, 1636421267949, 264, 1, 263, 1, 0, 1
3019, 1, 1636421267685, 1636421267953, 268, 1, 267, 0, 0, 0
3023, 1, 1636421267997, 1636421268262, 265, 1, 264, 1, 0, 1
3025, 1, 1636421268146, 1636421268422, 276, 1, 275, 0, 1, 1
3027, 1, 1636421268146, 1636421268422, 276, 1, 275, 0, 0, 0
3026, 1, 1636421268146, 1636421268422, 276, 0, 276, 0, 0, 0
3028, 1, 1636421268333, 1636421268605, 272, 1, 271, 0, 1, 1
3030, 1, 1636421268353, 1636421268622, 269, 1, 268, 0, 0, 0
3032, 1, 1636421268657, 1636421268925, 268, 1, 267, 0, 0, 0
3036, 1, 1636421268825, 1636421269094, 269, 1, 268, 0, 1, 1
3034, 1, 1636421268833, 1636421269101, 268, 0, 268, 0, 0, 0
3038, 1, 1636421269022, 1636421269290, 268, 0, 268, 0, 0, 0
3040, 1, 1636421269433, 1636421269705, 272, 1, 271, 0, 1, 1
3041, 1, 1636421269494, 1636421269762, 268, 0, 268, 0, 0, 0
3042, 1, 1636421269505, 1636421269774, 269, 1, 268, 0, 0, 0
3043, 1, 1636421269693, 1636421269962, 269, 1, 268, 0, 0, 0
3044, 1, 1636421269705, 1636421269974, 269, 1, 268, 1, 0, 1
3045, 1, 1636421270105, 1636421270374, 269, 1, 268, 0, 0, 0
3047, 1, 1636421270182, 1636421270450, 268, 0, 268, 0, 0, 0
3048, 1, 1636421270369, 1636421270634, 265, 1, 264, 1, 0, 1
3049, 1, 1636421270373, 1636421270638, 265, 1, 264, 0, 0, 0
3050, 1, 1636421270774, 1636421271038, 264, 0, 264, 0, 0, 0
3051, 1, 1636421270857, 1636421271126, 269, 0, 269, 0, 0, 0
3053, 1, 1636421271041, 1636421271309, 268, 0, 268, 0, 0, 0
3054, 1, 1636421271445, 1636421271717, 272, 1, 271, 0, 0, 0
3055, 1, 1636421271526, 1636421271794, 268, 0, 268, 0, 0, 0
3056, 1, 1636421271717, 1636421271986, 269, 1, 268, 1, 0, 1
3057, 1, 1636421272121, 1636421272390, 269, 1, 268, 1, 0, 1
3058, 1, 1636421272194, 1636421272462, 268, 0, 268, 0, 0, 0
3059, 1, 1636421272390, 1636421272661, 271, 1, 270, 0, 0, 0
3060, 1, 1636421272814, 1636421273126, 312, 0, 312, 0, 0, 0
3062, 1, 1636421273129, 1636421273410, 281, 1, 280, 1, 0, 1
3065, 1, 1636421273537, 1636421273809, 272, 1, 271, 1, 0, 1
3037, 1, 1636421273678, 1636421273945, 267, 0, 267, 0, 0, 0
3067, 1, 1636421273853, 1636421274126, 273, 1, 272, 1, 0, 1
3069, 1, 1636421274210, 1636421274478, 268, 0, 268, 0, 0, 0
3070, 1, 1636421274346, 1636421274614, 268, 0, 268, 0, 0, 0
3071, 1, 1636421274525, 1636421274798, 273, 1, 272, 0, 0, 0
3072, 1, 1636421274878, 1636421275146, 268, 0, 268, 0, 0, 0
3073, 1, 1636421275010, 1636421275278, 268, 0, 268, 0, 0, 0
3074, 1, 1636421275202, 1636421275469, 267, 0, 267, 0, 0, 0
3075, 1, 1636421275546, 1636421275817, 271, 0, 271, 0, 0, 0
3076, 1, 1636421275678, 1636421275946, 268, 0, 268, 0, 0, 0
3077, 1, 1636421275873, 1636421276145, 272, 1, 271, 1, 0, 1
3078, 1, 1636421276221, 1636421276490, 269, 1, 268, 0, 0, 0
3079, 1, 1636421276346, 1636421276614, 268, 0, 268, 0, 0, 0
3080, 1, 1636421276545, 1636421276822, 277, 1, 276, 1, 0, 1
3081, 1, 1636421276885, 1636421277154, 269, 0, 269, 0, 0, 0
3082, 1, 1636421277010, 1636421277282, 272, 0, 272, 0, 0, 0
3083, 1, 1636421277222, 1636421277486, 264, 0, 264, 0, 0, 0
3084, 1, 1636421277594, 1636421277862, 268, 0, 268, 0, 0, 0
3085, 1, 1636421278013, 1636421278282, 269, 1, 268, 1, 0, 1
3087, 1, 1636421278306, 1636421278578, 272, 1, 271, 0, 1, 1
3089, 1, 1636421278306, 1636421278578, 272, 1, 271, 0, 1, 1
3088, 1, 1636421278306, 1636421278578, 272, 1, 271, 0, 0, 0
3093, 1, 1636421278682, 1636421278961, 279, 0, 279, 0, 0, 0
3099, 1, 1636421279006, 1636421279281, 275, 0, 275, 0, 0, 0
3097, 1, 1636421279009, 1636421279281, 272, 0, 272, 0, 0, 0
3098, 1, 1636421279005, 1636421279281, 276, 0, 276, 0, 0, 0
3101, 1, 1636421279369, 1636421279637, 268, 1, 267, 0, 0, 0
3104, 1, 1636421279677, 1636421279950, 273, 2, 271, 1, 0, 1
3105, 1, 1636421279677, 1636421279950, 273, 1, 272, 1, 0, 1
3103, 1, 1636421279677, 1636421279950, 273, 1, 272, 1, 0, 1
3106, 1, 1636421280037, 1636421280301, 264, 0, 264, 0, 0, 0
3108, 1, 1636421280346, 1636421280614, 268, 0, 268, 0, 0, 0
3109, 1, 1636421280349, 1636421280617, 268, 1, 267, 1, 0, 1
3107, 1, 1636421280349, 1636421280617, 268, 1, 267, 0, 0, 0
3111, 1, 1636421280701, 1636421280973, 272, 0, 272, 0, 0, 0
3113, 1, 1636421281017, 1636421281286, 269, 1, 268, 0, 0, 0
3114, 1, 1636421281017, 1636421281286, 269, 1, 268, 1, 0, 1
3116, 1, 1636421281369, 1636421281641, 272, 0, 272, 0, 0, 0
3118, 1, 1636421281686, 1636421281954, 268, 0, 268, 0, 0, 0
3119, 1, 1636421282041, 1636421282309, 268, 1, 267, 0, 1, 1
3121, 1, 1636421282709, 1636421282993, 284, 1, 283, 0, 1, 1
3124, 1, 1636421283394, 1636421283662, 268, 0, 268, 0, 0, 0
3127, 1, 1636421284074, 1636421284346, 272, 0, 272, 0, 0, 0
3129, 1, 1636421284746, 1636421285014, 268, 0, 268, 0, 0, 0
3130, 1, 1636421285410, 1636421285678, 268, 0, 268, 0, 0, 0
3131, 1, 1636421286082, 1636421286350, 268, 0, 268, 0, 0, 0
3133, 1, 1636421288170, 1636421288462, 292, 0, 292, 0, 0, 0
3134, 1, 1636421288737, 1636421289049, 312, 1, 311, 1, 0, 1
3135, 1, 1636421288874, 1636421289181, 307, 0, 307, 0, 0, 0
3136, 1, 1636421288909, 1636421289181, 272, 1, 271, 0, 0, 0
3139, 1, 1636421289094, 1636421289357, 263, 0, 263, 0, 0, 0
3141, 1, 1636421289445, 1636421289713, 268, 1, 267, 0, 1, 1
3142, 1, 1636421289450, 1636421289717, 267, 0, 267, 0, 0, 0
3144, 1, 1636421289589, 1636421289853, 264, 0, 264, 0, 0, 0
3143, 1, 1636421289589, 1636421289853, 264, 0, 264, 0, 0, 0
3145, 1, 1636421289758, 1636421290026, 268, 0, 268, 0, 0, 0
3146, 1, 1636421289941, 1636421290209, 268, 1, 267, 0, 0, 0
3148, 1, 1636421290118, 1636421290385, 267, 0, 267, 0, 0, 0
3147, 1, 1636421290118, 1636421290389, 271, 0, 271, 0, 0, 0
3150, 1, 1636421290253, 1636421290521, 268, 1, 267, 1, 0, 1
3149, 1, 1636421290253, 1636421290521, 268, 1, 267, 0, 1, 1
3151, 1, 1636421290425, 1636421290693, 268, 0, 268, 0, 0, 0
3152, 1, 1636421290641, 1636421290917, 276, 0, 276, 0, 0, 0
3153, 1, 1636421290774, 1636421291057, 283, 0, 283, 0, 0, 0
3154, 1, 1636421290789, 1636421291061, 272, 1, 271, 0, 0, 0
3155, 1, 1636421290789, 1636421291061, 272, 1, 271, 0, 0, 0
3157, 1, 1636421290925, 1636421291193, 268, 0, 268, 0, 0, 0
3158, 1, 1636421291105, 1636421291390, 285, 1, 284, 0, 0, 0
3159, 1, 1636421291321, 1636421291590, 269, 1, 268, 1, 0, 1
3160, 1, 1636421291321, 1636421291594, 273, 1, 272, 0, 1, 1
3161, 1, 1636421291461, 1636421291729, 268, 1, 267, 0, 0, 0
3163, 1, 1636421291465, 1636421291733, 268, 1, 267, 1, 0, 1
3162, 1, 1636421291465, 1636421291737, 272, 1, 271, 1, 0, 1
3164, 1, 1636421291594, 1636421291869, 275, 0, 275, 0, 0, 0
3165, 1, 1636421291649, 1636421291917, 268, 1, 267, 1, 0, 1
3166, 1, 1636421291789, 1636421292061, 272, 1, 271, 1, 0, 1
3167, 1, 1636421291990, 1636421292258, 268, 0, 268, 0, 0, 0
3169, 1, 1636421291993, 1636421292262, 269, 1, 268, 0, 0, 0
3171, 1, 1636421292129, 1636421292397, 268, 1, 267, 0, 0, 0
3170, 1, 1636421292129, 1636421292397, 268, 1, 267, 0, 0, 0
3172, 1, 1636421292137, 1636421292405, 268, 0, 268, 0, 0, 0
3173, 1, 1636421292309, 1636421292574, 265, 1, 264, 0, 0, 0
3174, 1, 1636421292321, 1636421292589, 268, 1, 267, 0, 0, 0
3175, 1, 1636421292457, 1636421292725, 268, 1, 267, 0, 0, 0
3177, 1, 1636421292657, 1636421292934, 277, 1, 276, 0, 0, 0
3178, 1, 1636421292665, 1636421292934, 269, 1, 268, 1, 0, 1
3179, 1, 1636421292797, 1636421293066, 269, 1, 268, 1, 0, 1
3180, 1, 1636421292797, 1636421293066, 269, 1, 268, 1, 0, 1
3181, 1, 1636421292801, 1636421293069, 268, 0, 268, 0, 0, 0
3182, 1, 1636421292969, 1636421293238, 269, 0, 269, 0, 0, 0
3183, 1, 1636421292985, 1636421293301, 316, 0, 316, 0, 0, 0
3184, 1, 1636421293121, 1636421293426, 305, 1, 304, 0, 0, 0
3185, 1, 1636421293338, 1636421293606, 268, 0, 268, 0, 0, 0
3186, 1, 1636421293338, 1636421293613, 275, 0, 275, 0, 0, 0
3187, 1, 1636421293473, 1636421293761, 288, 2, 286, 1, 0, 1
3189, 1, 1636421293473, 1636421293761, 288, 2, 286, 0, 1, 1
3190, 1, 1636421293473, 1636421293761, 288, 1, 287, 0, 0, 0
3188, 1, 1636421293473, 1636421293761, 288, 2, 286, 0, 1, 1
3191, 1, 1636421293673, 1636421293941, 268, 1, 267, 1, 0, 1
3193, 1, 1636421293705, 1636421294021, 316, 1, 315, 1, 0, 1
3194, 1, 1636421293829, 1636421294109, 280, 1, 279, 0, 0, 0
3196, 1, 1636421294025, 1636421294337, 312, 1, 311, 1, 0, 1
3195, 1, 1636421294025, 1636421294337, 312, 1, 311, 1, 0, 1
3198, 1, 1636421294169, 1636421294437, 268, 2, 266, 0, 1, 1
3200, 1, 1636421294169, 1636421294438, 269, 2, 267, 0, 1, 1
3201, 1, 1636421294169, 1636421294438, 269, 2, 267, 2, 0, 2
3199, 1, 1636421294169, 1636421294441, 272, 1, 271, 0, 0, 0
3156, 1, 1636421294294, 1636421294561, 267, 0, 267, 0, 0, 0
3203, 1, 1636421294381, 1636421294649, 268, 1, 267, 0, 0, 0
3204, 1, 1636421294421, 1636421294693, 272, 1, 271, 0, 1, 1
3205, 1, 1636421294506, 1636421294773, 267, 0, 267, 0, 0, 0
3207, 1, 1636421294733, 1636421295001, 268, 0, 268, 0, 0, 0
3208, 1, 1636421294737, 1636421295005, 268, 0, 268, 0, 0, 0
3209, 1, 1636421294833, 1636421295097, 264, 1, 263, 0, 1, 1
3212, 1, 1636421294842, 1636421295109, 267, 1, 266, 0, 1, 1
3210, 1, 1636421294842, 1636421295117, 275, 1, 274, 0, 1, 1
3211, 1, 1636421294842, 1636421295117, 275, 0, 275, 0, 0, 0
3213, 1, 1636421294969, 1636421295238, 269, 0, 269, 0, 0, 0
3214, 1, 1636421295053, 1636421295322, 269, 0, 269, 0, 0, 0
3215, 1, 1636421295093, 1636421295357, 264, 1, 263, 0, 1, 1
3216, 1, 1636421295170, 1636421295438, 268, 0, 268, 0, 0, 0
3217, 1, 1636421295397, 1636421295661, 264, 1, 263, 0, 0, 0
3218, 1, 1636421295401, 1636421295665, 264, 1, 263, 1, 0, 1
3219, 1, 1636421295497, 1636421295761, 264, 0, 264, 0, 0, 0
3220, 1, 1636421295514, 1636421295782, 268, 0, 268, 0, 0, 0
3222, 1, 1636421295525, 1636421295793, 268, 1, 267, 1, 0, 1
3221, 1, 1636421295525, 1636421295793, 268, 1, 267, 0, 0, 0
3223, 1, 1636421295633, 1636421295897, 264, 1, 263, 1, 0, 1
3224, 1, 1636421295721, 1636421295989, 268, 1, 267, 0, 0, 0
3225, 1, 1636421295757, 1636421296021, 264, 0, 264, 0, 0, 0
3226, 1, 1636421295837, 1636421296101, 264, 1, 263, 0, 0, 0
3228, 1, 1636421296061, 1636421296329, 268, 1, 267, 0, 1, 1
3227, 1, 1636421296061, 1636421296333, 272, 1, 271, 1, 0, 1
3229, 1, 1636421296157, 1636421296421, 264, 1, 263, 1, 0, 1
3230, 1, 1636421296182, 1636421296450, 268, 0, 268, 0, 0, 0
3231, 1, 1636421296190, 1636421296466, 276, 0, 276, 0, 0, 0
3232, 1, 1636421296194, 1636421296466, 272, 0, 272, 0, 0, 0
3233, 1, 1636421296301, 1636421296566, 265, 1, 264, 0, 0, 0
3234, 1, 1636421296389, 1636421296658, 269, 1, 268, 0, 0, 0
3235, 1, 1636421296421, 1636421296690, 269, 1, 268, 0, 0, 0
3236, 1, 1636421296501, 1636421296793, 292, 1, 291, 0, 1, 1
3237, 1, 1636421296726, 1636421296993, 267, 0, 267, 0, 0, 0
3238, 1, 1636421296737, 1636421297006, 269, 1, 268, 0, 0, 0
3239, 1, 1636421296837, 1636421297105, 268, 1, 267, 0, 0, 0
3240, 1, 1636421296853, 1636421297117, 264, 1, 263, 1, 0, 1
3242, 1, 1636421296869, 1636421297138, 269, 0, 269, 0, 0, 0
3241, 1, 1636421296865, 1636421297138, 273, 0, 273, 0, 0, 0
3243, 1, 1636421296961, 1636421297226, 265, 0, 265, 0, 0, 0
3245, 1, 1636421297053, 1636421297317, 264, 1, 263, 0, 1, 1
3246, 1, 1636421297097, 1636421297373, 276, 0, 276, 0, 0, 0
3247, 1, 1636421297193, 1636421297461, 268, 0, 268, 0, 0, 0
3248, 1, 1636421297389, 1636421297658, 269, 1, 268, 1, 0, 1
3249, 1, 1636421297409, 1636421297677, 268, 1, 267, 0, 1, 1
3250, 1, 1636421297501, 1636421297769, 268, 0, 268, 0, 0, 0
3251, 1, 1636421297521, 1636421297790, 269, 1, 268, 1, 0, 1
3252, 1, 1636421297537, 1636421297810, 273, 1, 272, 0, 0, 0
3253, 1, 1636421297537, 1636421297810, 273, 1, 272, 0, 0, 0
3254, 1, 1636421297621, 1636421297881, 260, 1, 259, 0, 1, 1
3255, 1, 1636421297713, 1636421297977, 264, 1, 263, 0, 0, 0
3256, 1, 1636421297786, 1636421298057, 271, 0, 271, 0, 0, 0
3257, 1, 1636421297857, 1636421298129, 272, 0, 272, 0, 0, 0
3258, 1, 1636421298057, 1636421298329, 272, 1, 271, 1, 0, 1
3259, 1, 1636421298081, 1636421298346, 265, 1, 264, 0, 0, 0
3260, 1, 1636421298165, 1636421298429, 264, 0, 264, 0, 0, 0
3261, 1, 1636421298189, 1636421298458, 269, 1, 268, 1, 0, 1
3262, 1, 1636421298209, 1636421298481, 272, 1, 271, 0, 0, 0
3264, 1, 1636421298277, 1636421298549, 272, 1, 271, 0, 0, 0
3263, 1, 1636421298345, 1636421298613, 268, 1, 267, 0, 0, 0
3265, 1, 1636421298381, 1636421298649, 268, 1, 267, 1, 0, 1
3266, 1, 1636421298461, 1636421298725, 264, 1, 263, 0, 0, 0
3267, 1, 1636421298533, 1636421298801, 268, 1, 267, 0, 0, 0
3269, 1, 1636421298737, 1636421299046, 309, 0, 309, 0, 0, 0
3268, 1, 1636421298729, 1636421299046, 317, 1, 316, 0, 1, 1
3270, 1, 1636421298865, 1636421299133, 268, 1, 267, 1, 0, 1
3271, 1, 1636421298865, 1636421299134, 269, 1, 268, 0, 1, 1
3272, 1, 1636421298885, 1636421299189, 304, 0, 304, 0, 0, 0
3273, 1, 1636421298957, 1636421299225, 268, 0, 268, 0, 0, 0
3274, 1, 1636421299017, 1636421299281, 264, 0, 264, 0, 0, 0
3275, 1, 1636421299093, 1636421299357, 264, 0, 264, 0, 0, 0
3276, 1, 1636421299141, 1636421299445, 304, 0, 304, 0, 0, 0
3277, 1, 1636421299269, 1636421299537, 268, 0, 268, 0, 0, 0
3279, 1, 1636421299449, 1636421299717, 268, 1, 267, 0, 1, 1
3278, 1, 1636421299449, 1636421299717, 268, 1, 267, 0, 1, 1
3282, 1, 1636421299533, 1636421299801, 268, 1, 267, 0, 0, 0
3283, 1, 1636421299541, 1636421299813, 272, 1, 271, 0, 0, 0
3284, 1, 1636421299593, 1636421299861, 268, 0, 268, 0, 0, 0
3286, 1, 1636421299625, 1636421299893, 268, 1, 267, 0, 1, 1
3287, 1, 1636421299685, 1636421299953, 268, 1, 267, 0, 1, 1
3288, 1, 1636421299757, 1636421300025, 268, 0, 268, 0, 0, 0
3289, 1, 1636421299845, 1636421300113, 268, 1, 267, 0, 0, 0
3290, 1, 1636421299941, 1636421300205, 264, 1, 263, 0, 0, 0
3292, 1, 1636421300113, 1636421300385, 272, 1, 271, 1, 0, 1
3291, 1, 1636421300113, 1636421300385, 272, 1, 271, 1, 0, 1
3293, 1, 1636421300197, 1636421300473, 276, 1, 275, 0, 1, 1
3294, 1, 1636421300217, 1636421300481, 264, 0, 264, 0, 0, 0
3295, 1, 1636421300265, 1636421300533, 268, 0, 268, 0, 0, 0
3296, 1, 1636421300293, 1636421300561, 268, 1, 267, 1, 0, 1
3297, 1, 1636421300357, 1636421300625, 268, 0, 268, 0, 0, 0
3298, 1, 1636421300429, 1636421300693, 264, 1, 263, 1, 0, 1
3299, 1, 1636421300517, 1636421300785, 268, 1, 267, 0, 0, 0
3300, 1, 1636421300605, 1636421300874, 269, 1, 268, 1, 0, 1
3302, 1, 1636421300778, 1636421301045, 267, 0, 267, 0, 0, 0
3301, 1, 1636421300781, 1636421301049, 268, 1, 267, 0, 0, 0
3303, 1, 1636421300878, 1636421301145, 267, 0, 267, 0, 0, 0
3304, 1, 1636421300881, 1636421301158, 277, 1, 276, 0, 0, 0
3305, 1, 1636421300942, 1636421301210, 268, 0, 268, 0, 0, 0
3307, 1, 1636421301033, 1636421301301, 268, 1, 267, 0, 0, 0
3308, 1, 1636421301093, 1636421301361, 268, 1, 267, 0, 0, 0
3309, 1, 1636421301185, 1636421301449, 264, 1, 263, 0, 0, 0
3310, 1, 1636421301273, 1636421301537, 264, 0, 264, 0, 0, 0
3311, 1, 1636421301446, 1636421301717, 271, 0, 271, 0, 0, 0
3313, 1, 1636421301549, 1636421301813, 264, 0, 264, 0, 0, 0
3314, 1, 1636421301553, 1636421301829, 276, 1, 275, 0, 0, 0
3315, 1, 1636421301613, 1636421301877, 264, 1, 263, 0, 1, 1
3316, 1, 1636421301701, 1636421301969, 268, 0, 268, 0, 0, 0
3318, 1, 1636421301857, 1636421302125, 268, 1, 267, 1, 0, 1
3319, 1, 1636421301949, 1636421302222, 273, 0, 273, 0, 0, 0
3320, 1, 1636421302118, 1636421302385, 267, 0, 267, 0, 0, 0
3322, 1, 1636421302225, 1636421302497, 272, 1, 271, 1, 0, 1
3323, 1, 1636421302277, 1636421302545, 268, 1, 267, 0, 0, 0
3325, 1, 1636421302373, 1636421302642, 269, 1, 268, 1, 0, 1
3324, 1, 1636421302501, 1636421302789, 288, 0, 288, 0, 0, 0
3326, 1, 1636421302525, 1636421302797, 272, 0, 272, 0, 0, 0
3328, 1, 1636421302833, 1636421303105, 272, 1, 271, 1, 0, 1
3330, 1, 1636421302949, 1636421303213, 264, 1, 263, 0, 0, 0
3332, 1, 1636421303041, 1636421303306, 265, 1, 264, 1, 0, 1
3331, 1, 1636421303105, 1636421303373, 268, 1, 267, 1, 0, 1
3333, 1, 1636421303193, 1636421303461, 268, 1, 267, 0, 0, 0
3334, 1, 1636421303193, 1636421303461, 268, 1, 267, 0, 0, 0
3336, 1, 1636421303645, 1636421303917, 272, 1, 271, 1, 0, 1
3337, 1, 1636421303737, 1636421304010, 273, 0, 273, 0, 0, 0
3338, 1, 1636421303781, 1636421304066, 285, 1, 284, 1, 0, 1
3340, 1, 1636421303869, 1636421304158, 289, 1, 288, 0, 0, 0
3339, 1, 1636421303865, 1636421304158, 293, 0, 293, 0, 0, 0
3206, 1, 1636421304281, 1636421304546, 265, 1, 264, 0, 0, 0
3342, 1, 1636421304326, 1636421304590, 264, 0, 264, 0, 0, 0
3345, 1, 1636421304461, 1636421304726, 265, 1, 264, 0, 1, 1
3347, 1, 1636421304553, 1636421304826, 273, 1, 272, 0, 0, 0
3346, 1, 1636421304553, 1636421304826, 273, 1, 272, 0, 0, 0
3350, 1, 1636421304989, 1636421305258, 269, 0, 269, 0, 0, 0
3351, 1, 1636421305126, 1636421305394, 268, 0, 268, 0, 0, 0
3352, 1, 1636421305226, 1636421305490, 264, 0, 264, 0, 0, 0
3354, 1, 1636421305662, 1636421305926, 264, 0, 264, 0, 0, 0
3355, 1, 1636421305793, 1636421306066, 273, 1, 272, 0, 0, 0
3356, 1, 1636421305889, 1636421306154, 265, 1, 264, 1, 0, 1
3357, 1, 1636421306325, 1636421306594, 269, 1, 268, 0, 0, 0
3358, 1, 1636421306465, 1636421306733, 268, 1, 267, 0, 1, 1
3359, 1, 1636421306557, 1636421306822, 265, 1, 264, 0, 1, 1
3361, 1, 1636421307142, 1636421307409, 267, 0, 267, 0, 0, 0
3362, 1, 1636421307226, 1636421307494, 268, 0, 268, 0, 0, 0
3363, 1, 1636421307362, 1636421307629, 267, 0, 267, 0, 0, 0
3364, 1, 1636421307810, 1636421308077, 267, 0, 267, 0, 0, 0
3365, 1, 1636421307894, 1636421308162, 268, 0, 268, 0, 0, 0
3366, 1, 1636421308030, 1636421308297, 267, 0, 267, 0, 0, 0
3367, 1, 1636421308478, 1636421308745, 267, 0, 267, 0, 0, 0
3368, 1, 1636421308562, 1636421308830, 268, 0, 268, 0, 0, 0
3369, 1, 1636421308698, 1636421308965, 267, 0, 267, 0, 0, 0
3370, 1, 1636421309146, 1636421309413, 267, 0, 267, 0, 0, 0
3371, 1, 1636421309230, 1636421309578, 348, 0, 348, 0, 0, 0
3372, 1, 1636421309365, 1636421309673, 308, 1, 307, 0, 0, 0
3374, 1, 1636421309801, 1636421310069, 268, 1, 267, 0, 0, 0
3375, 1, 1636421309821, 1636421310089, 268, 0, 268, 0, 0, 0
3377, 1, 1636421309973, 1636421310241, 268, 0, 268, 0, 0, 0
3378, 1, 1636421310069, 1636421310334, 265, 0, 265, 0, 0, 0
3379, 1, 1636421310469, 1636421310742, 273, 1, 272, 1, 0, 1
3380, 1, 1636421310490, 1636421310757, 267, 0, 267, 0, 0, 0
3381, 1, 1636421310642, 1636421310913, 271, 0, 271, 0, 0, 0
3382, 1, 1636421310733, 1636421311001, 268, 0, 268, 0, 0, 0
3383, 1, 1636421311146, 1636421311413, 267, 0, 267, 0, 0, 0
3384, 1, 1636421311165, 1636421311433, 268, 1, 267, 0, 1, 1
3385, 1, 1636421311257, 1636421311521, 264, 1, 263, 0, 1, 1
3387, 1, 1636421311405, 1636421311670, 265, 1, 264, 0, 1, 1
3389, 1, 1636421311814, 1636421312081, 267, 0, 267, 0, 0, 0
3391, 1, 1636421311942, 1636421312253, 311, 0, 311, 0, 0, 0
3393, 1, 1636421312070, 1636421312346, 276, 0, 276, 0, 0, 0
3392, 1, 1636421312070, 1636421312346, 276, 0, 276, 0, 0, 0
3395, 1, 1636421312522, 1636421312790, 268, 0, 268, 0, 0, 0
3396, 1, 1636421312670, 1636421312941, 271, 0, 271, 0, 0, 0
3397, 1, 1636421312745, 1636421313029, 284, 1, 283, 0, 0, 0
3399, 1, 1636421312937, 1636421313206, 269, 1, 268, 1, 0, 1
3401, 1, 1636421313209, 1636421313478, 269, 1, 268, 0, 0, 0
3402, 1, 1636421313338, 1636421313637, 299, 0, 299, 0, 0, 0
3403, 1, 1636421313461, 1636421313730, 269, 1, 268, 0, 0, 0
3405, 1, 1636421313813, 1636421314077, 264, 0, 264, 0, 0, 0
3407, 1, 1636421314041, 1636421314309, 268, 1, 267, 0, 0, 0
3408, 1, 1636421314174, 1636421314465, 291, 0, 291, 0, 0, 0
3413, 1, 1636421314726, 1636421314993, 267, 0, 267, 0, 0, 0
3414, 1, 1636421314901, 1636421315170, 269, 0, 269, 0, 0, 0
3394, 1, 1636421314946, 1636421315214, 268, 0, 268, 0, 0, 0
3418, 1, 1636421315533, 1636421315810, 277, 1, 276, 0, 0, 0
3419, 1, 1636421315569, 1636421315845, 276, 0, 276, 0, 0, 0
3420, 1, 1636421315613, 1636421315890, 277, 1, 276, 0, 0, 0
3423, 1, 1636421316294, 1636421316566, 272, 0, 272, 0, 0, 0
3424, 1, 1636421316966, 1636421317233, 267, 0, 267, 0, 0, 0
3425, 1, 1636421317298, 1636421317566, 268, 0, 268, 0, 0, 0
3426, 1, 1636421317634, 1636421317902, 268, 0, 268, 0, 0, 0
3428, 1, 1636421318302, 1636421318578, 276, 0, 276, 0, 0, 0
3429, 1, 1636421318982, 1636421319250, 268, 0, 268, 0, 0, 0
3430, 1, 1636421319650, 1636421319974, 324, 0, 324, 0, 0, 0
3431, 1, 1636421320374, 1636421320641, 267, 0, 267, 0, 0, 0
3432, 1, 1636421320378, 1636421320649, 271, 0, 271, 0, 0, 0
3433, 1, 1636421320653, 1636421320926, 273, 1, 272, 0, 0, 0
3434, 1, 1636421321041, 1636421321314, 273, 1, 272, 0, 1, 1
3386, 2, 1636421311413, 1636421321461, 10048, 0, 10048, 0, 0, 0
3437, 1, 1636421321730, 1636421321994, 264, 0, 264, 0, 0, 0
3438, 1, 1636421321846, 1636421322113, 267, 0, 267, 0, 0, 0
3439, 1, 1636421322062, 1636421322330, 268, 0, 268, 0, 0, 0
3440, 1, 1636421322394, 1636421322665, 271, 0, 271, 0, 0, 0
3441, 1, 1636421322510, 1636421322793, 283, 0, 283, 0, 0, 0
3442, 1, 1636421322729, 1636421323002, 273, 0, 273, 0, 0, 0
3443, 1, 1636421323061, 1636421323330, 269, 1, 268, 0, 0, 0
3444, 1, 1636421323061, 1636421323330, 269, 0, 269, 0, 0, 0
3445, 1, 1636421323233, 1636421323505, 272, 1, 271, 0, 0, 0
3446, 1, 1636421323401, 1636421323670, 269, 1, 268, 0, 0, 0
3447, 1, 1636421323493, 1636421323761, 268, 1, 267, 0, 0, 0
3451, 1, 1636421323929, 1636421324198, 269, 0, 269, 0, 0, 0
3450, 1, 1636421323929, 1636421324198, 269, 1, 268, 0, 0, 0
3452, 1, 1636421324070, 1636421324346, 276, 0, 276, 0, 0, 0
3455, 1, 1636421324681, 1636421324949, 268, 1, 267, 0, 0, 0
3457, 1, 1636421324681, 1636421324949, 268, 1, 267, 0, 0, 0
3458, 1, 1636421324773, 1636421325041, 268, 1, 267, 0, 0, 0
3416, 1, 1636421324906, 1636421325173, 267, 0, 267, 0, 0, 0
3460, 1, 1636421324993, 1636421325265, 272, 1, 271, 0, 0, 0
3462, 1, 1636421325261, 1636421325541, 280, 5, 275, 5, 0, 5
3463, 1, 1636421325361, 1636421325633, 272, 1, 271, 0, 0, 0
3465, 1, 1636421325445, 1636421325714, 269, 0, 269, 0, 0, 0
3466, 1, 1636421325585, 1636421325854, 269, 1, 268, 0, 0, 0
3471, 1, 1636421326110, 1636421326389, 279, 0, 279, 0, 0, 0
3474, 1, 1636421326790, 1636421327058, 268, 0, 268, 0, 0, 0
3475, 1, 1636421327457, 1636421327726, 269, 1, 268, 0, 0, 0
3476, 1, 1636421328142, 1636421328414, 272, 0, 272, 0, 0, 0
3478, 1, 1636421328818, 1636421329089, 271, 0, 271, 0, 0, 0
3479, 1, 1636421329489, 1636421329761, 272, 1, 271, 1, 0, 1
3480, 1, 1636421330161, 1636421330430, 269, 1, 268, 0, 1, 1
3483, 1, 1636421331810, 1636421332078, 268, 0, 268, 0, 0, 0
3482, 1, 1636421331810, 1636421332082, 272, 0, 272, 0, 0, 0
3485, 1, 1636421332082, 1636421332345, 263, 0, 263, 0, 0, 0
3486, 1, 1636421332478, 1636421332746, 268, 1, 267, 0, 0, 0
3487, 1, 1636421332478, 1636421332750, 272, 1, 271, 0, 0, 0
3488, 1, 1636421332750, 1636421333022, 272, 0, 272, 0, 0, 0
3490, 1, 1636421333145, 1636421333410, 265, 0, 265, 0, 0, 0
3489, 1, 1636421333141, 1636421333414, 273, 1, 272, 1, 0, 1
3491, 1, 1636421333421, 1636421333689, 268, 1, 267, 0, 0, 0
3493, 1, 1636421333825, 1636421334093, 268, 1, 267, 0, 0, 0
3492, 1, 1636421333825, 1636421334093, 268, 1, 267, 1, 0, 1
3454, 2, 1636421324197, 1636421334242, 10045, 0, 10045, 0, 0, 0
3495, 1, 1636421334046, 1636421334377, 331, 0, 331, 0, 0, 0
3496, 1, 1636421334117, 1636421334465, 348, 1, 347, 0, 1, 1
3477, 1, 1636421334289, 1636421334561, 272, 1, 271, 0, 0, 0
3497, 1, 1636421334465, 1636421334741, 276, 1, 275, 0, 0, 0
3498, 1, 1636421334505, 1636421334770, 265, 1, 264, 0, 1, 1
3499, 1, 1636421334509, 1636421334773, 264, 1, 263, 1, 0, 1
3468, 1, 1636421334561, 1636421334829, 268, 1, 267, 1, 0, 1
3501, 1, 1636421334821, 1636421335085, 264, 0, 264, 0, 0, 0
3473, 1, 1636421334857, 1636421335149, 292, 1, 291, 0, 1, 1
3503, 1, 1636421334909, 1636421335178, 269, 1, 268, 1, 0, 1
3502, 1, 1636421334909, 1636421335178, 269, 1, 268, 1, 0, 1
3505, 1, 1636421335141, 1636421335405, 264, 0, 264, 0, 0, 0
3507, 1, 1636421335189, 1636421335482, 293, 1, 292, 1, 0, 1
3506, 1, 1636421335185, 1636421335485, 300, 1, 299, 1, 0, 1
3509, 1, 1636421335482, 1636421335746, 264, 1, 263, 0, 1, 1
3511, 1, 1636421335525, 1636421335801, 276, 1, 275, 0, 0, 0
3513, 1, 1636421335622, 1636421335894, 272, 0, 272, 0, 0, 0
3514, 1, 1636421335745, 1636421336009, 264, 1, 263, 0, 0, 0
3516, 1, 1636421335837, 1636421336101, 264, 0, 264, 0, 0, 0
3518, 1, 1636421335897, 1636421336165, 268, 1, 267, 1, 0, 1
3520, 1, 1636421336141, 1636421336433, 292, 1, 291, 0, 0, 0
3521, 1, 1636421336257, 1636421336529, 272, 1, 271, 0, 0, 0
3523, 1, 1636421336294, 1636421336561, 267, 0, 267, 0, 0, 0
3481, 1, 1636421336301, 1636421336582, 281, 1, 280, 0, 1, 1
3527, 1, 1636421336569, 1636421336841, 272, 1, 271, 1, 0, 1
3529, 1, 1636421336826, 1636421337093, 267, 0, 267, 0, 0, 0
3530, 1, 1636421336925, 1636421337197, 272, 1, 271, 0, 0, 0
3532, 1, 1636421336977, 1636421337250, 273, 1, 272, 1, 0, 1
3533, 1, 1636421337242, 1636421337510, 268, 0, 268, 0, 0, 0
3534, 1, 1636421337489, 1636421337757, 268, 1, 267, 0, 0, 0
3535, 1, 1636421337597, 1636421337865, 268, 1, 267, 0, 0, 0
3536, 1, 1636421337654, 1636421337922, 268, 0, 268, 0, 0, 0
3537, 1, 1636421337910, 1636421338177, 267, 0, 267, 0, 0, 0
3538, 1, 1636421338157, 1636421338430, 273, 1, 272, 1, 0, 1
3539, 1, 1636421338265, 1636421338533, 268, 1, 267, 1, 0, 1
3540, 1, 1636421338321, 1636421338589, 268, 1, 267, 1, 0, 1
3541, 1, 1636421338577, 1636421338842, 265, 1, 264, 1, 0, 1
3542, 1, 1636421338829, 1636421339098, 269, 1, 268, 0, 0, 0
3543, 1, 1636421338930, 1636421339197, 267, 0, 267, 0, 0, 0
3544, 1, 1636421338985, 1636421339254, 269, 1, 268, 0, 1, 1
3545, 1, 1636421339238, 1636421339505, 267, 0, 267, 0, 0, 0
3546, 1, 1636421339490, 1636421339762, 272, 0, 272, 0, 0, 0
3548, 1, 1636421339658, 1636421339930, 272, 0, 272, 0, 0, 0
3550, 1, 1636421340158, 1636421340426, 268, 0, 268, 0, 0, 0
3551, 1, 1636421340330, 1636421340601, 271, 0, 271, 0, 0, 0
3552, 1, 1636421340821, 1636421341090, 269, 1, 268, 0, 1, 1
3554, 1, 1636421341490, 1636421341758, 268, 0, 268, 0, 0, 0
3484, 2, 1636421332082, 1636421342134, 10052, 0, 10052, 0, 0, 0
3555, 1, 1636421342177, 1636421342445, 268, 1, 267, 0, 1, 1
3556, 1, 1636421342490, 1636421342762, 272, 0, 272, 0, 0, 0
3557, 1, 1636421342842, 1636421343114, 272, 0, 272, 0, 0, 0
3558, 1, 1636421343161, 1636421343430, 269, 1, 268, 1, 0, 1
3559, 1, 1636421343510, 1636421343778, 268, 0, 268, 0, 0, 0
3560, 1, 1636421343830, 1636421344094, 264, 0, 264, 0, 0, 0
3561, 1, 1636421344222, 1636421344490, 268, 0, 268, 0, 0, 0
3562, 1, 1636421344354, 1636421344646, 292, 0, 292, 0, 0, 0
3563, 1, 1636421344494, 1636421344761, 267, 0, 267, 0, 0, 0
3564, 1, 1636421344917, 1636421345185, 268, 1, 267, 0, 1, 1
3565, 1, 1636421344917, 1636421345189, 272, 1, 271, 0, 1, 1
3566, 1, 1636421345050, 1636421345366, 316, 0, 316, 0, 0, 0
3567, 1, 1636421345189, 1636421345502, 313, 0, 313, 0, 0, 0
3568, 1, 1636421345278, 1636421345594, 316, 0, 316, 0, 0, 0
3571, 1, 1636421345641, 1636421345925, 284, 1, 283, 0, 0, 0
3569, 1, 1636421345609, 1636421345925, 316, 1, 315, 0, 0, 0
3570, 1, 1636421345609, 1636421345925, 316, 1, 315, 0, 0, 0
3573, 1, 1636421345765, 1636421346042, 277, 1, 276, 0, 0, 0
3575, 1, 1636421345941, 1636421346214, 273, 1, 272, 0, 0, 0
3574, 1, 1636421345941, 1636421346214, 273, 1, 272, 0, 1, 1
3576, 1, 1636421346029, 1636421346301, 272, 1, 271, 0, 0, 0
3572, 1, 1636421346217, 1636421346481, 264, 0, 264, 0, 0, 0
3578, 1, 1636421346373, 1636421346654, 281, 0, 281, 0, 0, 0
3580, 1, 1636421346369, 1636421346654, 285, 1, 284, 0, 1, 1
3579, 1, 1636421346369, 1636421346657, 288, 1, 287, 1, 0, 1
3581, 1, 1636421346461, 1636421346741, 280, 1, 279, 0, 0, 0
3583, 1, 1636421346653, 1636421346917, 264, 1, 263, 0, 0, 0
3584, 1, 1636421346701, 1636421347005, 304, 1, 303, 0, 0, 0
3589, 1, 1636421346917, 1636421347185, 268, 1, 267, 0, 1, 1
3587, 1, 1636421346917, 1636421347185, 268, 1, 267, 0, 0, 0
3591, 1, 1636421347057, 1636421347325, 268, 1, 267, 1, 0, 1
3590, 1, 1636421347057, 1636421347333, 276, 1, 275, 0, 1, 1
3593, 1, 1636421347137, 1636421347409, 272, 1, 271, 0, 0, 0
3594, 1, 1636421347270, 1636421347541, 271, 0, 271, 0, 0, 0
3595, 1, 1636421347317, 1636421347590, 273, 0, 273, 0, 0, 0
3597, 1, 1636421347590, 1636421347853, 263, 0, 263, 0, 0, 0
3598, 1, 1636421347581, 1636421347853, 272, 1, 271, 0, 0, 0
3600, 1, 1636421347725, 1636421347989, 264, 1, 263, 0, 0, 0
3601, 1, 1636421347810, 1636421348081, 271, 0, 271, 0, 0, 0
3602, 1, 1636421347941, 1636421348209, 268, 0, 268, 0, 0, 0
3603, 1, 1636421347989, 1636421348257, 268, 1, 267, 0, 0, 0
3605, 1, 1636421348254, 1636421348522, 268, 0, 268, 0, 0, 0
3604, 1, 1636421348254, 1636421348522, 268, 0, 268, 0, 0, 0
3606, 1, 1636421348390, 1636421348657, 267, 0, 267, 0, 0, 0
3607, 1, 1636421348481, 1636421348749, 268, 0, 268, 0, 0, 0
3608, 1, 1636421348610, 1636421348881, 271, 0, 271, 0, 0, 0
3609, 1, 1636421348657, 1636421348921, 264, 1, 263, 1, 0, 1
3610, 1, 1636421348925, 1636421349193, 268, 1, 267, 0, 0, 0
3611, 1, 1636421348926, 1636421349193, 267, 0, 267, 0, 0, 0
3613, 1, 1636421349145, 1636421349413, 268, 1, 267, 0, 1, 1
3614, 1, 1636421349281, 1636421349549, 268, 0, 268, 0, 0, 0
3615, 1, 1636421349322, 1636421349590, 268, 0, 268, 0, 0, 0
3616, 1, 1636421349593, 1636421349865, 272, 1, 271, 0, 0, 0
3618, 1, 1636421349813, 1636421350085, 272, 0, 272, 0, 0, 0
3619, 1, 1636421349946, 1636421350213, 267, 0, 267, 0, 0, 0
3622, 1, 1636421350210, 1636421350478, 268, 0, 268, 0, 0, 0
3623, 1, 1636421350265, 1636421350533, 268, 0, 268, 0, 0, 0
3624, 1, 1636421350490, 1636421350762, 272, 0, 272, 0, 0, 0
3625, 1, 1636421350617, 1636421350885, 268, 0, 268, 0, 0, 0
3627, 1, 1636421350957, 1636421351225, 268, 1, 267, 0, 0, 0
3628, 1, 1636421351177, 1636421351446, 269, 1, 268, 0, 1, 1
3631, 1, 1636421351626, 1636421351893, 267, 0, 267, 0, 0, 0
3632, 1, 1636421351846, 1636421352114, 268, 0, 268, 0, 0, 0
3633, 1, 1636421352294, 1636421352561, 267, 0, 267, 0, 0, 0
3634, 1, 1636421352478, 1636421352745, 267, 0, 267, 0, 0, 0
3637, 1, 1636421352514, 1636421352785, 271, 0, 271, 0, 0, 0
3638, 1, 1636421352961, 1636421353230, 269, 1, 268, 0, 0, 0
3639, 1, 1636421353145, 1636421353413, 268, 1, 267, 0, 1, 1
3640, 1, 1636421353185, 1636421353454, 269, 0, 269, 0, 0, 0
3641, 1, 1636421353626, 1636421353894, 268, 0, 268, 0, 0, 0
3642, 1, 1636421353809, 1636421354085, 276, 0, 276, 0, 0, 0
3643, 1, 1636421353853, 1636421354121, 268, 0, 268, 0, 0, 0
3645, 1, 1636421354481, 1636421354749, 268, 1, 267, 0, 0, 0
3646, 1, 1636421354521, 1636421354790, 269, 1, 268, 1, 0, 1
3647, 1, 1636421355150, 1636421355417, 267, 0, 267, 0, 0, 0
3648, 1, 1636421355189, 1636421355462, 273, 1, 272, 0, 0, 0
3649, 1, 1636421355817, 1636421356093, 276, 0, 276, 0, 0, 0
3650, 1, 1636421355862, 1636421356134, 272, 0, 272, 0, 0, 0
3582, 2, 1636421346653, 1636421356702, 10049, 0, 10049, 0, 0, 0
3652, 1, 1636421356493, 1636421356966, 473, 1, 472, 0, 1, 1
3653, 1, 1636421356533, 1636421356966, 433, 1, 432, 0, 0, 0
3659, 1, 1636421357366, 1636421357634, 268, 0, 268, 0, 0, 0
3660, 1, 1636421357373, 1636421357642, 269, 1, 268, 0, 1, 1
3661, 1, 1636421357717, 1636421357986, 269, 1, 268, 0, 0, 0
3662, 1, 1636421358033, 1636421358301, 268, 1, 267, 0, 0, 0
3664, 1, 1636421358045, 1636421358314, 269, 1, 268, 0, 0, 0
3665, 1, 1636421358389, 1636421358657, 268, 1, 267, 0, 0, 0
3666, 1, 1636421358701, 1636421358974, 273, 1, 272, 0, 1, 1
3667, 1, 1636421358713, 1636421358985, 272, 1, 271, 1, 0, 1
3668, 1, 1636421359098, 1636421359365, 267, 0, 267, 0, 0, 0
3671, 1, 1636421359390, 1636421359694, 304, 0, 304, 0, 0, 0
3670, 1, 1636421359377, 1636421359694, 317, 1, 316, 0, 0, 0
3672, 1, 1636421359762, 1636421360037, 275, 0, 275, 0, 0, 0
3673, 1, 1636421359949, 1636421360217, 268, 1, 267, 0, 1, 1
3674, 1, 1636421360173, 1636421360441, 268, 1, 267, 1, 0, 1
3676, 1, 1636421360261, 1636421360529, 268, 0, 268, 0, 0, 0
3677, 1, 1636421360302, 1636421360570, 268, 0, 268, 0, 0, 0
3679, 1, 1636421360617, 1636421360926, 309, 0, 309, 0, 0, 0
3681, 1, 1636421360926, 1636421361194, 268, 0, 268, 0, 0, 0
3658, 1, 1636421362526, 1636421362794, 268, 0, 268, 0, 0, 0
3688, 1, 1636421363054, 1636421363326, 272, 0, 272, 0, 0, 0
3690, 1, 1636421363194, 1636421363461, 267, 0, 267, 0, 0, 0
3689, 1, 1636421363326, 1636421363590, 264, 1, 263, 0, 1, 1
3691, 1, 1636421363725, 1636421363994, 269, 1, 268, 0, 0, 0
3692, 1, 1636421363862, 1636421364126, 264, 0, 264, 0, 0, 0
3693, 1, 1636421363997, 1636421364266, 269, 1, 268, 1, 0, 1
3694, 1, 1636421364394, 1636421364661, 267, 0, 267, 0, 0, 0
3695, 1, 1636421364530, 1636421364797, 267, 0, 267, 0, 0, 0
3696, 1, 1636421364597, 1636421364861, 264, 1, 263, 0, 0, 0
3697, 1, 1636421364661, 1636421364929, 268, 1, 267, 1, 0, 1
3698, 1, 1636421365062, 1636421365326, 264, 0, 264, 0, 0, 0
3701, 1, 1636421365326, 1636421365589, 263, 1, 262, 0, 0, 0
3702, 1, 1636421365721, 1636421365989, 268, 0, 268, 0, 0, 0
3703, 1, 1636421365994, 1636421366262, 268, 0, 268, 0, 0, 0
3704, 1, 1636421366390, 1636421366662, 272, 0, 272, 0, 0, 0
3705, 1, 1636421366662, 1636421366925, 263, 1, 262, 0, 1, 1
3707, 1, 1636421367238, 1636421367506, 268, 0, 268, 0, 0, 0
3708, 1, 1636421367506, 1636421367774, 268, 1, 267, 0, 0, 0
3713, 1, 1636421367906, 1636421368178, 272, 0, 272, 0, 0, 0
3714, 1, 1636421368210, 1636421368482, 272, 0, 272, 0, 0, 0
3716, 1, 1636421368577, 1636421368850, 273, 1, 272, 0, 0, 0
3717, 1, 1636421368881, 1636421369150, 269, 1, 268, 0, 0, 0
3718, 1, 1636421369250, 1636421369521, 271, 0, 271, 0, 0, 0
3719, 1, 1636421369546, 1636421369814, 268, 0, 268, 0, 0, 0
3723, 1, 1636421370485, 1636421370757, 272, 1, 271, 0, 0, 0
3724, 1, 1636421370798, 1636421371110, 312, 0, 312, 0, 0, 0
3725, 1, 1636421371149, 1636421371417, 268, 1, 267, 1, 0, 1
3726, 1, 1636421371162, 1636421371461, 299, 0, 299, 0, 0, 0
3728, 1, 1636421371641, 1636421371909, 268, 1, 267, 0, 0, 0
3729, 1, 1636421371641, 1636421371909, 268, 1, 267, 0, 0, 0
3732, 1, 1636421371909, 1636421372181, 272, 0, 272, 0, 0, 0
3733, 1, 1636421371954, 1636421372222, 268, 0, 268, 0, 0, 0
3736, 1, 1636421372313, 1636421372586, 273, 1, 272, 0, 1, 1
3739, 1, 1636421372621, 1636421372894, 273, 1, 272, 0, 0, 0
3740, 1, 1636421372982, 1636421373250, 268, 0, 268, 0, 0, 0
3742, 1, 1636421373645, 1636421373918, 273, 1, 272, 1, 0, 1
3743, 1, 1636421374317, 1636421374590, 273, 1, 272, 0, 0, 0
3744, 1, 1636421374990, 1636421375258, 268, 0, 268, 0, 0, 0
3745, 1, 1636421375526, 1636421375793, 267, 0, 267, 0, 0, 0
3747, 1, 1636421375658, 1636421375929, 271, 0, 271, 0, 0, 0
3749, 1, 1636421376326, 1636421376597, 271, 0, 271, 0, 0, 0
3750, 1, 1636421376998, 1636421377266, 268, 0, 268, 0, 0, 0
3715, 1, 1636421377673, 1636421377945, 272, 1, 271, 0, 0, 0
3752, 1, 1636421377721, 1636421377993, 272, 0, 272, 0, 0, 0
3753, 1, 1636421377937, 1636421378205, 268, 1, 267, 0, 0, 0
3756, 1, 1636421377937, 1636421378209, 272, 1, 271, 0, 0, 0
3755, 1, 1636421378209, 1636421378477, 268, 1, 267, 0, 0, 0
3758, 1, 1636421378394, 1636421378661, 267, 0, 267, 0, 0, 0
3759, 1, 1636421378606, 1636421378874, 268, 0, 268, 0, 0, 0
3760, 1, 1636421378613, 1636421378890, 277, 1, 276, 0, 1, 1
3761, 1, 1636421378890, 1636421379157, 267, 1, 266, 1, 0, 1
3762, 1, 1636421379069, 1636421379337, 268, 1, 267, 0, 1, 1
3763, 1, 1636421379274, 1636421379541, 267, 0, 267, 0, 0, 0
3764, 1, 1636421379289, 1636421379562, 273, 1, 272, 1, 0, 1
3765, 1, 1636421379565, 1636421379834, 269, 0, 269, 0, 0, 0
3766, 1, 1636421379742, 1636421380054, 312, 0, 312, 0, 0, 0
3767, 1, 1636421379965, 1636421380265, 300, 1, 299, 0, 0, 0
3768, 1, 1636421379965, 1636421380265, 300, 1, 299, 0, 0, 0
3770, 1, 1636421380269, 1636421380541, 272, 1, 271, 1, 0, 1
3771, 1, 1636421380269, 1636421380541, 272, 1, 271, 1, 0, 1
3772, 1, 1636421380450, 1636421380721, 271, 0, 271, 0, 0, 0
3773, 1, 1636421380545, 1636421380814, 269, 0, 269, 0, 0, 0
3774, 1, 1636421380662, 1636421380930, 268, 0, 268, 0, 0, 0
3775, 1, 1636421380665, 1636421380938, 273, 1, 272, 0, 0, 0
3776, 1, 1636421380941, 1636421381206, 265, 0, 265, 0, 0, 0
3778, 1, 1636421381117, 1636421381417, 300, 0, 300, 0, 0, 0
3780, 1, 1636421381333, 1636421381601, 268, 0, 268, 0, 0, 0
3781, 1, 1636421381369, 1636421381638, 269, 0, 269, 0, 0, 0
3783, 1, 1636421381605, 1636421381909, 304, 0, 304, 0, 0, 0
3782, 1, 1636421381590, 1636421381909, 319, 0, 319, 0, 0, 0
3784, 1, 1636421381821, 1636421382129, 308, 0, 308, 0, 0, 0
3786, 1, 1636421382041, 1636421382354, 313, 1, 312, 0, 0, 0
3785, 1, 1636421382041, 1636421382354, 313, 1, 312, 0, 0, 0
3787, 1, 1636421382045, 1636421382354, 309, 0, 309, 0, 0, 0
3791, 1, 1636421382357, 1636421382625, 268, 1, 267, 0, 1, 1
3792, 1, 1636421382357, 1636421382633, 276, 1, 275, 1, 0, 1
3790, 1, 1636421382357, 1636421382633, 276, 1, 275, 0, 0, 0
3793, 1, 1636421382537, 1636421382806, 269, 1, 268, 0, 0, 0
3795, 1, 1636421382761, 1636421383033, 272, 1, 271, 0, 0, 0
3796, 1, 1636421382761, 1636421383037, 276, 0, 276, 0, 0, 0
3800, 1, 1636421383033, 1636421383337, 304, 1, 303, 0, 0, 0
3801, 1, 1636421383033, 1636421383337, 304, 1, 303, 1, 0, 1
3802, 1, 1636421383250, 1636421383517, 267, 0, 267, 0, 0, 0
3803, 1, 1636421383469, 1636421383737, 268, 0, 268, 0, 0, 0
3805, 1, 1636421383601, 1636421383881, 280, 1, 279, 0, 1, 1
3807, 1, 1636421383741, 1636421384009, 268, 0, 268, 0, 0, 0
3808, 1, 1636421383917, 1636421384190, 273, 0, 273, 0, 0, 0
3809, 1, 1636421384145, 1636421384414, 269, 1, 268, 0, 0, 0
3810, 1, 1636421384293, 1636421384566, 273, 1, 272, 0, 1, 1
3811, 1, 1636421384417, 1636421384685, 268, 1, 267, 0, 0, 0
3812, 1, 1636421384590, 1636421384857, 267, 0, 267, 0, 0, 0
3813, 1, 1636421384813, 1636421385081, 268, 0, 268, 0, 0, 0
3814, 1, 1636421384966, 1636421385237, 271, 0, 271, 0, 0, 0
3815, 1, 1636421385085, 1636421385357, 272, 0, 272, 0, 0, 0
3819, 1, 1636421385757, 1636421386030, 273, 1, 272, 1, 0, 1
3820, 1, 1636421385881, 1636421386154, 273, 1, 272, 0, 0, 0
3821, 1, 1636421386430, 1636421386702, 272, 0, 272, 0, 0, 0
3823, 1, 1636421386553, 1636421386822, 269, 1, 268, 0, 0, 0
3824, 1, 1636421387158, 1636421387430, 272, 0, 272, 0, 0, 0
3825, 1, 1636421387222, 1636421387490, 268, 0, 268, 0, 0, 0
3826, 1, 1636421387401, 1636421387670, 269, 0, 269, 0, 0, 0
3827, 1, 1636421387830, 1636421388098, 268, 0, 268, 0, 0, 0
3828, 1, 1636421387889, 1636421388157, 268, 1, 267, 0, 0, 0
3829, 1, 1636421388110, 1636421388389, 279, 0, 279, 0, 0, 0
3830, 1, 1636421388238, 1636421388501, 263, 0, 263, 0, 0, 0
3831, 1, 1636421388525, 1636421388798, 273, 1, 272, 1, 0, 1
3832, 1, 1636421388557, 1636421388826, 269, 1, 268, 0, 0, 0
3834, 1, 1636421388790, 1636421389058, 268, 0, 268, 0, 0, 0
3835, 1, 1636421388901, 1636421389174, 273, 1, 272, 0, 0, 0
3836, 1, 1636421389197, 1636421389469, 272, 1, 271, 0, 0, 0
3837, 1, 1636421389221, 1636421389489, 268, 1, 267, 0, 0, 0
3838, 1, 1636421389462, 1636421389730, 268, 0, 268, 0, 0, 0
3839, 1, 1636421389574, 1636421389842, 268, 0, 268, 0, 0, 0
3840, 1, 1636421389869, 1636421390137, 268, 1, 267, 1, 0, 1
3841, 1, 1636421389925, 1636421390189, 264, 0, 264, 0, 0, 0
3842, 1, 1636421390149, 1636421390425, 276, 1, 275, 0, 0, 0
3843, 1, 1636421390245, 1636421390514, 269, 1, 268, 0, 0, 0
3845, 1, 1636421390542, 1636421390810, 268, 0, 268, 0, 0, 0
3846, 1, 1636421390589, 1636421390857, 268, 1, 267, 0, 0, 0
3847, 1, 1636421390821, 1636421391098, 277, 1, 276, 0, 1, 1
3848, 1, 1636421390917, 1636421391186, 269, 0, 269, 0, 0, 0
3849, 1, 1636421391253, 1636421391522, 269, 1, 268, 0, 0, 0
3851, 1, 1636421391261, 1636421391533, 272, 0, 272, 0, 0, 0
3852, 1, 1636421391502, 1636421391769, 267, 0, 267, 0, 0, 0
3854, 1, 1636421391586, 1636421391858, 272, 0, 272, 0, 0, 0
3855, 1, 1636421391926, 1636421392194, 268, 0, 268, 0, 0, 0
3856, 1, 1636421391929, 1636421392197, 268, 1, 267, 1, 0, 1
3857, 1, 1636421392221, 1636421392493, 272, 1, 271, 0, 0, 0
3858, 1, 1636421392309, 1636421392581, 272, 1, 271, 0, 0, 0
3859, 1, 1636421392529, 1636421392801, 272, 0, 272, 0, 0, 0
3860, 1, 1636421392581, 1636421392934, 353, 1, 352, 0, 0, 0
3862, 1, 1636421392597, 1636421392934, 337, 0, 337, 0, 0, 0
3861, 1, 1636421392589, 1636421392937, 348, 0, 348, 0, 0, 0
3864, 1, 1636421392981, 1636421393245, 264, 1, 263, 0, 1, 1
3863, 1, 1636421392981, 1636421393245, 264, 1, 263, 0, 1, 1
3865, 1, 1636421392981, 1636421393245, 264, 1, 263, 0, 1, 1
3868, 1, 1636421393201, 1636421393470, 269, 0, 269, 0, 0, 0
3867, 1, 1636421393245, 1636421393521, 276, 1, 275, 1, 0, 1
3871, 1, 1636421393333, 1636421393606, 273, 1, 272, 0, 1, 1
3872, 1, 1636421393333, 1636421393606, 273, 1, 272, 1, 0, 1
3870, 1, 1636421393333, 1636421393609, 276, 1, 275, 1, 0, 1
3874, 1, 1636421393693, 1636421393961, 268, 1, 267, 1, 0, 1
3873, 1, 1636421393693, 1636421393961, 268, 1, 267, 0, 0, 0
3875, 1, 1636421393693, 1636421393965, 272, 1, 271, 1, 0, 1
3876, 1, 1636421393785, 1636421394053, 268, 0, 268, 0, 0, 0
3878, 1, 1636421393969, 1636421394237, 268, 0, 268, 0, 0, 0
3881, 1, 1636421394006, 1636421394277, 271, 0, 271, 0, 0, 0
3880, 1, 1636421394006, 1636421394281, 275, 0, 275, 0, 0, 0
3882, 1, 1636421394053, 1636421394321, 268, 1, 267, 1, 0, 1
3879, 1, 1636421394237, 1636421394501, 264, 1, 263, 1, 0, 1
3884, 1, 1636421394362, 1636421394629, 267, 0, 267, 0, 0, 0
3883, 1, 1636421394362, 1636421394629, 267, 0, 267, 0, 0, 0
3886, 1, 1636421394453, 1636421394721, 268, 1, 267, 0, 0, 0
3888, 1, 1636421394673, 1636421394938, 265, 1, 264, 0, 0, 0
3889, 1, 1636421394685, 1636421394957, 272, 0, 272, 0, 0, 0
3890, 1, 1636421394721, 1636421394989, 268, 1, 267, 1, 0, 1
3891, 1, 1636421394897, 1636421395165, 268, 0, 268, 0, 0, 0
3892, 1, 1636421395026, 1636421395301, 275, 0, 275, 0, 0, 0
3894, 1, 1636421395125, 1636421395389, 264, 1, 263, 0, 1, 1
3895, 1, 1636421395345, 1636421395617, 272, 1, 271, 0, 0, 0
3897, 1, 1636421395441, 1636421395713, 272, 0, 272, 0, 0, 0
3899, 1, 1636421395617, 1636421395886, 269, 1, 268, 0, 0, 0
3898, 1, 1636421395617, 1636421395889, 272, 1, 271, 1, 0, 1
3903, 1, 1636421395969, 1636421396237, 268, 0, 268, 0, 0, 0
3904, 1, 1636421396017, 1636421396290, 273, 0, 273, 0, 0, 0
3906, 1, 1636421396282, 1636421396549, 267, 0, 267, 0, 0, 0
3908, 1, 1636421396682, 1636421396950, 268, 0, 268, 0, 0, 0
3909, 1, 1636421396690, 1636421396957, 267, 0, 267, 0, 0, 0
3910, 1, 1636421396806, 1636421397070, 264, 0, 264, 0, 0, 0
3911, 1, 1636421396950, 1636421397217, 267, 0, 267, 0, 0, 0
3913, 1, 1636421397353, 1636421397618, 265, 0, 265, 0, 0, 0
3912, 1, 1636421397349, 1636421397618, 269, 0, 269, 0, 0, 0
3914, 1, 1636421397470, 1636421397742, 272, 0, 272, 0, 0, 0
3915, 1, 1636421397618, 1636421397881, 263, 0, 263, 0, 0, 0
3917, 1, 1636421398021, 1636421398301, 280, 1, 279, 0, 1, 1
3916, 1, 1636421398021, 1636421398301, 280, 1, 279, 0, 0, 0
3918, 1, 1636421398142, 1636421398413, 271, 0, 271, 0, 0, 0
3919, 1, 1636421398277, 1636421398546, 269, 0, 269, 0, 0, 0
3921, 1, 1636421398697, 1636421398966, 269, 1, 268, 1, 0, 1
3920, 1, 1636421398697, 1636421398966, 269, 1, 268, 1, 0, 1
3922, 1, 1636421398829, 1636421399093, 264, 1, 263, 1, 0, 1
3923, 1, 1636421398946, 1636421399214, 268, 0, 268, 0, 0, 0
3925, 1, 1636421399365, 1636421399633, 268, 1, 267, 0, 1, 1
3927, 1, 1636421399493, 1636421399766, 273, 0, 273, 0, 0, 0
3928, 1, 1636421399613, 1636421399885, 272, 1, 271, 0, 0, 0
3929, 1, 1636421400033, 1636421400310, 277, 0, 277, 0, 0, 0
3930, 1, 1636421400161, 1636421400430, 269, 0, 269, 0, 0, 0
3932, 1, 1636421400577, 1636421400845, 268, 1, 267, 0, 0, 0
3933, 1, 1636421400709, 1636421400977, 268, 0, 268, 0, 0, 0
3934, 1, 1636421400829, 1636421401098, 269, 1, 268, 0, 1, 1
3935, 1, 1636421401245, 1636421401513, 268, 1, 267, 0, 0, 0
3936, 1, 1636421401381, 1636421401653, 272, 1, 271, 1, 0, 1
3937, 1, 1636421401502, 1636421401774, 272, 0, 272, 0, 0, 0
3938, 1, 1636421401561, 1636421401829, 268, 1, 267, 0, 0, 0
3939, 1, 1636421401829, 1636421402098, 269, 1, 268, 0, 0, 0
3940, 1, 1636421401910, 1636421402178, 268, 0, 268, 0, 0, 0
3941, 1, 1636421402053, 1636421402326, 273, 1, 272, 0, 0, 0
3942, 1, 1636421402173, 1636421402442, 269, 1, 268, 0, 0, 0
3943, 1, 1636421402225, 1636421402493, 268, 0, 268, 0, 0, 0
3944, 1, 1636421402493, 1636421402762, 269, 1, 268, 1, 0, 1
3945, 1, 1636421402574, 1636421402838, 264, 0, 264, 0, 0, 0
3946, 1, 1636421402729, 1636421402997, 268, 1, 267, 1, 0, 1
3947, 1, 1636421402849, 1636421403117, 268, 1, 267, 0, 1, 1
3948, 1, 1636421402901, 1636421403205, 304, 1, 303, 0, 1, 1
3949, 1, 1636421403209, 1636421403477, 268, 0, 268, 0, 0, 0
3950, 1, 1636421403289, 1636421403558, 269, 1, 268, 0, 0, 0
3951, 1, 1636421403382, 1636421403650, 268, 0, 268, 0, 0, 0
3953, 1, 1636421403522, 1636421403785, 263, 0, 263, 0, 0, 0
3954, 1, 1636421403609, 1636421403873, 264, 0, 264, 0, 0, 0
3955, 1, 1636421403649, 1636421403962, 313, 1, 312, 0, 0, 0
3956, 1, 1636421403873, 1636421404141, 268, 1, 267, 0, 0, 0
3957, 1, 1636421403966, 1636421404229, 263, 0, 263, 0, 0, 0
3958, 1, 1636421404053, 1636421404321, 268, 0, 268, 0, 0, 0
3959, 1, 1636421404185, 1636421404497, 312, 1, 311, 0, 1, 1
3960, 1, 1636421404226, 1636421404497, 271, 0, 271, 0, 0, 0
3961, 1, 1636421404273, 1636421404538, 265, 1, 264, 0, 0, 0
3962, 1, 1636421404361, 1636421404629, 268, 1, 267, 0, 1, 1
3963, 1, 1636421404538, 1636421404801, 263, 1, 262, 0, 0, 0
3964, 1, 1636421404622, 1636421404885, 263, 0, 263, 0, 0, 0
3965, 1, 1636421404677, 1636421404945, 268, 0, 268, 0, 0, 0
3968, 1, 1636421404893, 1636421405162, 269, 1, 268, 0, 0, 0
3967, 1, 1636421404893, 1636421405169, 276, 1, 275, 0, 1, 1
3969, 1, 1636421404933, 1636421405206, 273, 0, 273, 0, 0, 0
3970, 1, 1636421404985, 1636421405257, 272, 0, 272, 0, 0, 0
3972, 1, 1636421405206, 1636421405494, 288, 1, 287, 0, 0, 0
3973, 1, 1636421405313, 1636421405581, 268, 1, 267, 0, 1, 1
3975, 1, 1636421405345, 1636421405614, 269, 1, 268, 1, 0, 1
3976, 1, 1636421405561, 1636421405877, 316, 0, 316, 0, 0, 0
3977, 1, 1636421405565, 1636421405877, 312, 1, 311, 1, 0, 1
3978, 1, 1636421405606, 1636421405877, 271, 0, 271, 0, 0, 0
3979, 1, 1636421405665, 1636421405965, 300, 1, 299, 1, 0, 1
3980, 1, 1636421405665, 1636421405969, 304, 1, 303, 1, 0, 1
3981, 1, 1636421405921, 1636421406186, 265, 1, 264, 0, 0, 0
3982, 1, 1636421406009, 1636421406278, 269, 1, 268, 1, 0, 1
3983, 1, 1636421406009, 1636421406278, 269, 1, 268, 1, 0, 1
3986, 1, 1636421406098, 1636421406365, 267, 0, 267, 0, 0, 0
3985, 1, 1636421406098, 1636421406369, 271, 0, 271, 0, 0, 0
3987, 1, 1636421406289, 1636421406565, 276, 0, 276, 0, 0, 0
3988, 1, 1636421406341, 1636421406605, 264, 0, 264, 0, 0, 0
3990, 1, 1636421406386, 1636421406649, 263, 0, 263, 0, 0, 0
3992, 1, 1636421406421, 1636421406690, 269, 1, 268, 1, 0, 1
3993, 1, 1636421406609, 1636421406873, 264, 1, 263, 0, 1, 1
3995, 1, 1636421406678, 1636421406942, 264, 0, 264, 0, 0, 0
3997, 1, 1636421406769, 1636421407037, 268, 1, 267, 1, 0, 1
3998, 1, 1636421406877, 1636421407145, 268, 1, 267, 0, 0, 0
3999, 1, 1636421406961, 1636421407230, 269, 1, 268, 0, 0, 0
4000, 1, 1636421407001, 1636421407270, 269, 1, 268, 0, 0, 0
4002, 1, 1636421407093, 1636421407357, 264, 0, 264, 0, 0, 0
4003, 1, 1636421407273, 1636421407546, 273, 1, 272, 0, 0, 0
4004, 1, 1636421407337, 1636421407606, 269, 1, 268, 0, 0, 0
4005, 1, 1636421407437, 1636421407709, 272, 0, 272, 0, 0, 0
4007, 1, 1636421407633, 1636421407905, 272, 1, 271, 0, 0, 0
4008, 1, 1636421407669, 1636421407938, 269, 0, 269, 0, 0, 0
4009, 1, 1636421407757, 1636421408030, 273, 1, 272, 0, 0, 0
4010, 1, 1636421407937, 1636421408205, 268, 1, 267, 0, 0, 0
4012, 1, 1636421408110, 1636421408378, 268, 0, 268, 0, 0, 0
4013, 1, 1636421408305, 1636421408574, 269, 1, 268, 0, 0, 0
4014, 1, 1636421408341, 1636421408609, 268, 1, 267, 0, 1, 1
4015, 1, 1636421408438, 1636421408714, 276, 0, 276, 0, 0, 0
4016, 1, 1636421408614, 1636421408881, 267, 0, 267, 0, 0, 0
4017, 1, 1636421408778, 1636421409045, 267, 0, 267, 0, 0, 0
4018, 1, 1636421409013, 1636421409277, 264, 1, 263, 0, 1, 1
4019, 1, 1636421409009, 1636421409277, 268, 1, 267, 0, 0, 0
4020, 1, 1636421409149, 1636421409417, 268, 1, 267, 0, 0, 0
4021, 1, 1636421409322, 1636421409589, 267, 0, 267, 0, 0, 0
4022, 1, 1636421409322, 1636421409589, 267, 0, 267, 0, 0, 0
4023, 1, 1636421409457, 1636421409725, 268, 1, 267, 0, 0, 0
4024, 1, 1636421409674, 1636421409941, 267, 0, 267, 0, 0, 0
4025, 1, 1636421409681, 1636421409945, 264, 1, 263, 0, 1, 1
4026, 1, 1636421409681, 1636421409945, 264, 1, 263, 1, 0, 1
4027, 1, 1636421409825, 1636421410089, 264, 0, 264, 0, 0, 0
4028, 1, 1636421409985, 1636421410254, 269, 1, 268, 0, 0, 0
4029, 1, 1636421409985, 1636421410254, 269, 1, 268, 0, 0, 0
4030, 1, 1636421410125, 1636421410393, 268, 1, 267, 1, 0, 1
4033, 1, 1636421410361, 1636421410629, 268, 1, 267, 1, 0, 1
4034, 1, 1636421410494, 1636421410769, 275, 0, 275, 0, 0, 0
4036, 1, 1636421410654, 1636421410921, 267, 0, 267, 0, 0, 0
4037, 1, 1636421410654, 1636421410922, 268, 0, 268, 0, 0, 0
4038, 1, 1636421410793, 1636421411061, 268, 0, 268, 0, 0, 0
4039, 1, 1636421411030, 1636421411301, 271, 0, 271, 0, 0, 0
4040, 1, 1636421411169, 1636421411438, 269, 0, 269, 0, 0, 0
4042, 1, 1636421411325, 1636421411598, 273, 1, 272, 0, 0, 0
4041, 1, 1636421411325, 1636421411598, 273, 1, 272, 0, 0, 0
4043, 1, 1636421411461, 1636421411730, 269, 0, 269, 0, 0, 0
4044, 1, 1636421411705, 1636421411973, 268, 1, 267, 0, 0, 0
4045, 1, 1636421411837, 1636421412102, 265, 1, 264, 0, 0, 0
4046, 1, 1636421411997, 1636421412266, 269, 1, 268, 0, 0, 0
4047, 1, 1636421411994, 1636421412266, 272, 0, 272, 0, 0, 0
4048, 1, 1636421412137, 1636421412406, 269, 1, 268, 0, 1, 1
4049, 1, 1636421412374, 1636421412641, 267, 0, 267, 0, 0, 0
4050, 1, 1636421412501, 1636421412769, 268, 1, 267, 0, 1, 1
4052, 1, 1636421412666, 1636421412933, 267, 0, 267, 0, 0, 0
4051, 1, 1636421412666, 1636421412933, 267, 0, 267, 0, 0, 0
4053, 1, 1636421412801, 1636421413077, 276, 0, 276, 0, 0, 0
4054, 1, 1636421413041, 1636421413310, 269, 1, 268, 0, 0, 0
4055, 1, 1636421413170, 1636421413465, 295, 0, 295, 0, 0, 0
4056, 1, 1636421413330, 1636421413597, 267, 0, 267, 0, 0, 0
4057, 1, 1636421413377, 1636421413645, 268, 1, 267, 1, 0, 1
4059, 1, 1636421413710, 1636421413981, 271, 0, 271, 0, 0, 0
4060, 1, 1636421413730, 1636421414005, 275, 0, 275, 0, 0, 0
4062, 1, 1636421413994, 1636421414266, 272, 0, 272, 0, 0, 0
4063, 1, 1636421414045, 1636421414317, 272, 1, 271, 0, 1, 1
4064, 1, 1636421414382, 1636421414649, 267, 0, 267, 0, 0, 0
4065, 1, 1636421414410, 1636421414685, 275, 0, 275, 0, 0, 0
4066, 1, 1636421414685, 1636421414957, 272, 1, 271, 0, 0, 0
4067, 1, 1636421414717, 1636421414985, 268, 1, 267, 0, 0, 0
4068, 1, 1636421415033, 1636421415301, 268, 1, 267, 0, 0, 0
4070, 1, 1636421415121, 1636421415394, 273, 1, 272, 0, 0, 0
4072, 1, 1636421415385, 1636421415653, 268, 1, 267, 0, 1, 1
4073, 1, 1636421415385, 1636421415653, 268, 1, 267, 0, 0, 0
4074, 1, 1636421415641, 1636421415914, 273, 1, 272, 0, 1, 1
4075, 1, 1636421415698, 1636421415965, 267, 0, 267, 0, 0, 0
4076, 1, 1636421415789, 1636421416098, 309, 1, 308, 0, 0, 0
4078, 1, 1636421416053, 1636421416338, 285, 1, 284, 0, 0, 0
4077, 1, 1636421416049, 1636421416338, 289, 1, 288, 0, 1, 1
4079, 1, 1636421416341, 1636421416650, 309, 0, 309, 0, 0, 0
4081, 1, 1636421416429, 1636421416737, 308, 0, 308, 0, 0, 0
4080, 1, 1636421416425, 1636421416737, 312, 1, 311, 0, 0, 0
4082, 1, 1636421416502, 1636421416813, 311, 0, 311, 0, 0, 0
4083, 1, 1636421416653, 1636421416921, 268, 0, 268, 0, 0, 0
4086, 1, 1636421416785, 1636421417094, 309, 0, 309, 0, 0, 0
4088, 1, 1636421417009, 1636421417278, 269, 1, 268, 0, 1, 1
4091, 1, 1636421417145, 1636421417414, 269, 1, 268, 0, 0, 0
4092, 1, 1636421417225, 1636421417493, 268, 1, 267, 1, 0, 1
4093, 1, 1636421417322, 1636421417589, 267, 0, 267, 0, 0, 0
4094, 1, 1636421417358, 1636421417626, 268, 0, 268, 0, 0, 0
4096, 1, 1636421417722, 1636421417989, 267, 0, 267, 0, 0, 0
4098, 1, 1636421417853, 1636421418133, 280, 1, 279, 0, 0, 0
4099, 1, 1636421417893, 1636421418162, 269, 0, 269, 0, 0, 0
4100, 1, 1636421417985, 1636421418253, 268, 1, 267, 0, 0, 0
4101, 1, 1636421418045, 1636421418313, 268, 1, 267, 1, 0, 1
4103, 1, 1636421418386, 1636421418654, 268, 0, 268, 0, 0, 0
4104, 1, 1636421418533, 1636421418801, 268, 1, 267, 0, 0, 0
4105, 1, 1636421418654, 1636421418930, 276, 0, 276, 0, 0, 0
4106, 1, 1636421418717, 1636421418986, 269, 1, 268, 0, 0, 0
4107, 1, 1636421419054, 1636421419326, 272, 0, 272, 0, 0, 0
4108, 1, 1636421419202, 1636421419469, 267, 0, 267, 0, 0, 0
4109, 1, 1636421419329, 1636421419598, 269, 1, 268, 0, 0, 0
4110, 1, 1636421419385, 1636421419649, 264, 1, 263, 0, 0, 0
4111, 1, 1636421419726, 1636421419993, 267, 0, 267, 0, 0, 0
4113, 1, 1636421419997, 1636421420266, 269, 0, 269, 0, 0, 0
4114, 1, 1636421420050, 1636421420317, 267, 0, 267, 0, 0, 0
4115, 1, 1636421420453, 1636421420750, 297, 1, 296, 0, 0, 0
4116, 1, 1636421420661, 1636421420933, 272, 0, 272, 0, 0, 0
4117, 1, 1636421420705, 1636421420973, 268, 0, 268, 0, 0, 0
4119, 1, 1636421420750, 1636421421013, 263, 1, 262, 0, 0, 0
4120, 1, 1636421420917, 1636421421185, 268, 1, 267, 0, 1, 1
4121, 1, 1636421421149, 1636421421417, 268, 1, 267, 1, 0, 1
4122, 1, 1636421421333, 1636421421605, 272, 1, 271, 0, 1, 1
4124, 1, 1636421421421, 1636421421693, 272, 1, 271, 0, 1, 1
4125, 1, 1636421421586, 1636421421854, 268, 0, 268, 0, 0, 0
4126, 1, 1636421421817, 1636421422086, 269, 1, 268, 0, 0, 0
4127, 1, 1636421422005, 1636421422274, 269, 1, 268, 0, 0, 0
4128, 1, 1636421422097, 1636421422366, 269, 1, 268, 0, 0, 0
4130, 1, 1636421422489, 1636421422758, 269, 1, 268, 0, 1, 1
4131, 1, 1636421422673, 1636421422946, 273, 1, 272, 1, 0, 1
4132, 1, 1636421422766, 1636421423033, 267, 0, 267, 0, 0, 0
4133, 1, 1636421423158, 1636421423425, 267, 0, 267, 0, 0, 0
4134, 1, 1636421423346, 1636421423645, 299, 0, 299, 0, 0, 0
4135, 1, 1636421423469, 1636421423737, 268, 1, 267, 0, 1, 1
4136, 1, 1636421423821, 1636421424089, 268, 1, 267, 0, 1, 1
4137, 1, 1636421423825, 1636421424093, 268, 1, 267, 0, 1, 1
4139, 1, 1636421424137, 1636421424406, 269, 0, 269, 0, 0, 0
4140, 1, 1636421424174, 1636421424445, 271, 0, 271, 0, 0, 0
4141, 1, 1636421424489, 1636421424762, 273, 1, 272, 1, 0, 1
4144, 1, 1636421424846, 1636421425114, 268, 0, 268, 0, 0, 0
4145, 1, 1636421425161, 1636421425434, 273, 0, 273, 0, 0, 0
4146, 1, 1636421425362, 1636421425633, 271, 0, 271, 0, 0, 0
4147, 1, 1636421425517, 1636421425786, 269, 0, 269, 0, 0, 0
4148, 1, 1636421425689, 1636421425958, 269, 1, 268, 0, 0, 0
4149, 1, 1636421425837, 1636421426106, 269, 0, 269, 0, 0, 0
4151, 1, 1636421426185, 1636421426450, 265, 0, 265, 0, 0, 0
4153, 1, 1636421426505, 1636421426773, 268, 1, 267, 0, 0, 0
4154, 1, 1636421426901, 1636421427186, 285, 1, 284, 0, 1, 1
4157, 1, 1636421427189, 1636421427457, 268, 1, 267, 1, 0, 1
4158, 1, 1636421427253, 1636421427541, 288, 1, 287, 1, 0, 1
4159, 1, 1636421427353, 1636421427633, 280, 1, 279, 0, 0, 0
4160, 1, 1636421427453, 1636421427725, 272, 1, 271, 0, 0, 0
4161, 1, 1636421427582, 1636421427857, 275, 0, 275, 0, 0, 0
4162, 1, 1636421427806, 1636421428073, 267, 0, 267, 0, 0, 0
4163, 1, 1636421427857, 1636421428121, 264, 1, 263, 0, 1, 1
4164, 1, 1636421427941, 1636421428205, 264, 0, 264, 0, 0, 0
4165, 1, 1636421428046, 1636421428345, 299, 0, 299, 0, 0, 0
4167, 1, 1636421428117, 1636421428381, 264, 1, 263, 0, 0, 0
4166, 1, 1636421428114, 1636421428386, 272, 0, 272, 0, 0, 0
4168, 1, 1636421428257, 1636421428525, 268, 1, 267, 0, 0, 0
4169, 1, 1636421428473, 1636421428737, 264, 1, 263, 0, 0, 0
4171, 1, 1636421428605, 1636421428877, 272, 1, 271, 1, 0, 1
4170, 1, 1636421428605, 1636421428877, 272, 1, 271, 1, 0, 1
4172, 1, 1636421428753, 1636421429021, 268, 1, 267, 0, 1, 1
4173, 1, 1636421428777, 1636421429045, 268, 1, 267, 0, 0, 0
4174, 1, 1636421428789, 1636421429053, 264, 1, 263, 0, 0, 0
4175, 1, 1636421429138, 1636421429405, 267, 0, 267, 0, 0, 0
4176, 1, 1636421429274, 1636421429541, 267, 0, 267, 0, 0, 0
4177, 1, 1636421429274, 1636421429541, 267, 0, 267, 0, 0, 0
4179, 1, 1636421429450, 1636421429717, 267, 0, 267, 0, 0, 0
4180, 1, 1636421429450, 1636421429717, 267, 0, 267, 0, 0, 0
4181, 1, 1636421429825, 1636421430094, 269, 1, 268, 1, 0, 1
4182, 1, 1636421429962, 1636421430229, 267, 0, 267, 0, 0, 0
4184, 1, 1636421430117, 1636421430394, 277, 0, 277, 0, 0, 0
4186, 1, 1636421430173, 1636421430441, 268, 1, 267, 1, 0, 1
4187, 1, 1636421430493, 1636421430766, 273, 0, 273, 0, 0, 0
4188, 1, 1636421430662, 1636421430926, 264, 0, 264, 0, 0, 0
4189, 1, 1636421430794, 1636421431058, 264, 0, 264, 0, 0, 0
4190, 1, 1636421430881, 1636421431146, 265, 1, 264, 0, 1, 1
4192, 1, 1636421431173, 1636421431438, 265, 1, 264, 1, 0, 1
4193, 1, 1636421431333, 1636421431601, 268, 1, 267, 1, 0, 1
4194, 1, 1636421431466, 1636421431733, 267, 0, 267, 0, 0, 0
4195, 1, 1636421431553, 1636421431822, 269, 0, 269, 0, 0, 0
4197, 1, 1636421431838, 1636421432106, 268, 0, 268, 0, 0, 0
4198, 1, 1636421432001, 1636421432290, 289, 0, 289, 0, 0, 0
4199, 1, 1636421432129, 1636421432394, 265, 1, 264, 0, 0, 0
4200, 1, 1636421432217, 1636421432481, 264, 1, 263, 0, 1, 1
4201, 1, 1636421432505, 1636421432770, 265, 1, 264, 0, 0, 0
4202, 1, 1636421432553, 1636421432821, 268, 1, 267, 0, 0, 0
4203, 1, 1636421432698, 1636421432970, 272, 0, 272, 0, 0, 0
4204, 1, 1636421432789, 1636421433058, 269, 1, 268, 0, 0, 0
4205, 1, 1636421432881, 1636421433149, 268, 1, 267, 0, 0, 0
4206, 1, 1636421433169, 1636421433442, 273, 1, 272, 0, 0, 0
4207, 1, 1636421433221, 1636421433489, 268, 1, 267, 0, 0, 0
4208, 1, 1636421433369, 1636421433633, 264, 0, 264, 0, 0, 0
4209, 1, 1636421433449, 1636421433717, 268, 1, 267, 0, 0, 0
4210, 1, 1636421433549, 1636421433822, 273, 0, 273, 0, 0, 0
4211, 1, 1636421433841, 1636421434110, 269, 1, 268, 0, 1, 1
4212, 1, 1636421433893, 1636421434177, 284, 1, 283, 0, 0, 0
4213, 1, 1636421434033, 1636421434301, 268, 1, 267, 0, 0, 0
4214, 1, 1636421434133, 1636421434401, 268, 0, 268, 0, 0, 0
4215, 1, 1636421434221, 1636421434537, 316, 0, 316, 0, 0, 0
4216, 1, 1636421434353, 1636421434630, 277, 1, 276, 0, 0, 0
4217, 1, 1636421434541, 1636421434849, 308, 1, 307, 0, 1, 1
4220, 1, 1636421434798, 1636421435069, 271, 0, 271, 0, 0, 0
4222, 1, 1636421434938, 1636421435205, 267, 0, 267, 0, 0, 0
4223, 1, 1636421435029, 1636421435298, 269, 1, 268, 0, 0, 0
4224, 1, 1636421435114, 1636421435381, 267, 0, 267, 0, 0, 0
4226, 1, 1636421435470, 1636421435737, 267, 0, 267, 0, 0, 0
4227, 1, 1636421435605, 1636421435870, 265, 1, 264, 0, 0, 0
4228, 1, 1636421435693, 1636421435957, 264, 1, 263, 0, 0, 0
4229, 1, 1636421435778, 1636421436078, 300, 0, 300, 0, 0, 0
4230, 1, 1636421436134, 1636421436405, 271, 0, 271, 0, 0, 0
4231, 1, 1636421436266, 1636421436534, 268, 0, 268, 0, 0, 0
4233, 1, 1636421436357, 1636421436625, 268, 1, 267, 0, 0, 0
4234, 1, 1636421436478, 1636421436742, 264, 0, 264, 0, 0, 0
4236, 1, 1636421436810, 1636421437082, 272, 0, 272, 0, 0, 0
4237, 1, 1636421436934, 1636421437233, 299, 0, 299, 0, 0, 0
4238, 1, 1636421437053, 1636421437321, 268, 1, 267, 0, 0, 0
4239, 1, 1636421437145, 1636421437418, 273, 1, 272, 0, 0, 0
4240, 1, 1636421437406, 1636421437681, 275, 0, 275, 0, 0, 0
4241, 1, 1636421437482, 1636421437746, 264, 0, 264, 0, 0, 0
4242, 1, 1636421437501, 1636421437769, 268, 0, 268, 0, 0, 0
4244, 1, 1636421437717, 1636421437985, 268, 1, 267, 0, 0, 0
4245, 1, 1636421437814, 1636421438082, 268, 0, 268, 0, 0, 0
4246, 1, 1636421438081, 1636421438346, 265, 1, 264, 0, 0, 0
4247, 1, 1636421438145, 1636421438414, 269, 1, 268, 0, 0, 0
4248, 1, 1636421438174, 1636421438437, 263, 0, 263, 0, 0, 0
4249, 1, 1636421438382, 1636421438650, 268, 0, 268, 0, 0, 0
4250, 1, 1636421438478, 1636421438742, 264, 0, 264, 0, 0, 0
4251, 1, 1636421438741, 1636421439009, 268, 1, 267, 0, 0, 0
4252, 1, 1636421438817, 1636421439086, 269, 0, 269, 0, 0, 0
4254, 1, 1636421439142, 1636421439406, 264, 0, 264, 0, 0, 0
4255, 1, 1636421439406, 1636421439678, 272, 0, 272, 0, 0, 0
4256, 1, 1636421439730, 1636421440005, 275, 0, 275, 0, 0, 0
4257, 1, 1636421440073, 1636421440342, 269, 1, 268, 0, 0, 0
4258, 1, 1636421440290, 1636421440558, 268, 0, 268, 0, 0, 0
4259, 1, 1636421440406, 1636421440678, 272, 0, 272, 0, 0, 0
4260, 1, 1636421440426, 1636421440701, 275, 0, 275, 0, 0, 0
4261, 1, 1636421440741, 1636421441054, 313, 1, 312, 1, 0, 1
4262, 1, 1636421440969, 1636421441238, 269, 1, 268, 1, 0, 1
4264, 1, 1636421441105, 1636421441378, 273, 1, 272, 0, 0, 0
4263, 1, 1636421441105, 1636421441378, 273, 1, 272, 0, 1, 1
4265, 1, 1636421441326, 1636421441594, 268, 0, 268, 0, 0, 0
4266, 1, 1636421441457, 1636421441730, 273, 1, 272, 1, 0, 1
4267, 1, 1636421441645, 1636421441913, 268, 1, 267, 0, 0, 0
4269, 1, 1636421441777, 1636421442045, 268, 1, 267, 1, 0, 1
4268, 1, 1636421441777, 1636421442046, 269, 1, 268, 1, 0, 1
4271, 1, 1636421441997, 1636421442266, 269, 0, 269, 0, 0, 0
4272, 1, 1636421442130, 1636421442401, 271, 0, 271, 0, 0, 0
4275, 1, 1636421442446, 1636421442713, 267, 0, 267, 0, 0, 0
4274, 1, 1636421442446, 1636421442714, 268, 0, 268, 0, 0, 0
4276, 1, 1636421442666, 1636421442934, 268, 0, 268, 0, 0, 0
4277, 1, 1636421442801, 1636421443069, 268, 1, 267, 0, 0, 0
4279, 1, 1636421443113, 1636421443378, 265, 1, 264, 1, 0, 1
4278, 1, 1636421443113, 1636421443381, 268, 1, 267, 0, 0, 0
4280, 1, 1636421443333, 1636421443597, 264, 1, 263, 0, 0, 0
4281, 1, 1636421443466, 1636421443733, 267, 0, 267, 0, 0, 0
4282, 1, 1636421443778, 1636421444045, 267, 0, 267, 0, 0, 0
4283, 1, 1636421443778, 1636421444049, 271, 0, 271, 0, 0, 0
4284, 1, 1636421443997, 1636421444266, 269, 0, 269, 0, 0, 0
4285, 1, 1636421444133, 1636421444398, 265, 1, 264, 0, 0, 0
4287, 1, 1636421444446, 1636421444750, 304, 0, 304, 0, 0, 0
4286, 1, 1636421444446, 1636421444750, 304, 0, 304, 0, 0, 0
4288, 1, 1636421444678, 1636421444945, 267, 0, 267, 0, 0, 0
4290, 1, 1636421444893, 1636421445161, 268, 1, 267, 0, 0, 0
4292, 1, 1636421445109, 1636421445382, 273, 0, 273, 0, 0, 0
4293, 1, 1636421445145, 1636421445413, 268, 1, 267, 0, 0, 0
4294, 1, 1636421445153, 1636421445429, 276, 1, 275, 1, 0, 1
4295, 1, 1636421445341, 1636421445605, 264, 1, 263, 0, 0, 0
4297, 1, 1636421445562, 1636421445830, 268, 0, 268, 0, 0, 0
4296, 1, 1636421445562, 1636421445830, 268, 1, 267, 0, 0, 0
4298, 1, 1636421445778, 1636421446045, 267, 0, 267, 0, 0, 0
4299, 1, 1636421445814, 1636421446082, 268, 0, 268, 0, 0, 0
4300, 1, 1636421445830, 1636421446093, 263, 0, 263, 0, 0, 0
4301, 1, 1636421446005, 1636421446273, 268, 0, 268, 0, 0, 0
4302, 1, 1636421446225, 1636421446493, 268, 1, 267, 1, 0, 1
4303, 1, 1636421446230, 1636421446497, 267, 0, 267, 0, 0, 0
4304, 1, 1636421446442, 1636421446714, 272, 0, 272, 0, 0, 0
4306, 1, 1636421446521, 1636421446801, 280, 1, 279, 0, 0, 0
4305, 1, 1636421446521, 1636421446801, 280, 1, 279, 0, 0, 0
4308, 1, 1636421446714, 1636421446981, 267, 0, 267, 0, 0, 0
4309, 1, 1636421446889, 1636421447157, 268, 0, 268, 0, 0, 0
4310, 1, 1636421446898, 1636421447161, 263, 0, 263, 0, 0, 0
4312, 1, 1636421447110, 1636421447381, 271, 0, 271, 0, 0, 0
4313, 1, 1636421447201, 1636421447469, 268, 0, 268, 0, 0, 0
4315, 1, 1636421447385, 1636421447682, 297, 0, 297, 0, 0, 0
4316, 1, 1636421447589, 1636421447857, 268, 1, 267, 0, 0, 0
4317, 1, 1636421447589, 1636421447857, 268, 1, 267, 0, 0, 0
4318, 1, 1636421447809, 1636421448078, 269, 1, 268, 0, 0, 0
4320, 1, 1636421447942, 1636421448210, 268, 0, 268, 0, 0, 0
4321, 1, 1636421448078, 1636421448345, 267, 0, 267, 0, 0, 0
4323, 1, 1636421448257, 1636421448521, 264, 1, 263, 1, 0, 1
4322, 1, 1636421448257, 1636421448525, 268, 1, 267, 0, 0, 0
4324, 1, 1636421448473, 1636421448741, 268, 0, 268, 0, 0, 0
4325, 1, 1636421448613, 1636421448885, 272, 1, 271, 1, 0, 1
4327, 1, 1636421448933, 1636421449206, 273, 1, 272, 1, 0, 1
4328, 1, 1636421448933, 1636421449206, 273, 1, 272, 0, 0, 0
4329, 1, 1636421449141, 1636421449410, 269, 1, 268, 1, 0, 1
4330, 1, 1636421449150, 1636421449418, 268, 0, 268, 0, 0, 0
4331, 1, 1636421449281, 1636421449550, 269, 1, 268, 0, 1, 1
4334, 1, 1636421449825, 1636421450098, 273, 1, 272, 1, 0, 1
4335, 1, 1636421449950, 1636421450217, 267, 0, 267, 0, 0, 0
4336, 1, 1636421450498, 1636421450766, 268, 0, 268, 0, 0, 0
4337, 1, 1636421450614, 1636421450882, 268, 0, 268, 0, 0, 0
4339, 1, 1636421451282, 1636421451554, 272, 0, 272, 0, 0, 0
4341, 1, 1636421452302, 1636421452570, 268, 0, 268, 0, 0, 0
4342, 1, 1636421452610, 1636421452881, 271, 0, 271, 0, 0, 0
4343, 1, 1636421452970, 1636421453242, 272, 0, 272, 0, 0, 0
4344, 1, 1636421453278, 1636421453550, 272, 0, 272, 0, 0, 0
4345, 1, 1636421453641, 1636421453906, 265, 1, 264, 0, 1, 1
4346, 1, 1636421453946, 1636421454222, 276, 0, 276, 0, 0, 0
4347, 1, 1636421454305, 1636421454573, 268, 1, 267, 0, 0, 0
4348, 1, 1636421454617, 1636421454934, 317, 1, 316, 0, 0, 0
4349, 1, 1636421454969, 1636421455238, 269, 1, 268, 0, 1, 1
4351, 1, 1636421455322, 1636421455590, 268, 0, 268, 0, 0, 0
4352, 1, 1636421455329, 1636421455597, 268, 1, 267, 0, 0, 0
4353, 1, 1636421455641, 1636421455910, 269, 1, 268, 0, 0, 0
4354, 1, 1636421455986, 1636421456253, 267, 0, 267, 0, 0, 0
4355, 1, 1636421455997, 1636421456265, 268, 1, 267, 1, 0, 1
4356, 1, 1636421456305, 1636421456578, 273, 1, 272, 0, 1, 1
4358, 1, 1636421456698, 1636421456966, 268, 0, 268, 0, 0, 0
4359, 1, 1636421456957, 1636421457245, 288, 1, 287, 1, 0, 1
4360, 1, 1636421457017, 1636421457290, 273, 0, 273, 0, 0, 0
4361, 1, 1636421457290, 1636421457553, 263, 0, 263, 0, 0, 0
4363, 1, 1636421457505, 1636421457774, 269, 0, 269, 0, 0, 0
4364, 1, 1636421457650, 1636421457917, 267, 0, 267, 0, 0, 0
4365, 1, 1636421457689, 1636421457958, 269, 0, 269, 0, 0, 0
4366, 1, 1636421457958, 1636421458225, 267, 0, 267, 0, 0, 0
4368, 1, 1636421458174, 1636421458441, 267, 0, 267, 0, 0, 0
4367, 1, 1636421458174, 1636421458441, 267, 0, 267, 0, 0, 0
4369, 1, 1636421458326, 1636421458594, 268, 0, 268, 0, 0, 0
4370, 1, 1636421458357, 1636421458622, 265, 1, 264, 0, 0, 0
4371, 1, 1636421458622, 1636421458886, 264, 0, 264, 0, 0, 0
4372, 1, 1636421458841, 1636421459109, 268, 1, 267, 0, 0, 0
4373, 1, 1636421458841, 1636421459110, 269, 1, 268, 0, 0, 0
4374, 1, 1636421459001, 1636421459269, 268, 0, 268, 0, 0, 0
4375, 1, 1636421459017, 1636421459289, 272, 0, 272, 0, 0, 0
4377, 1, 1636421459282, 1636421459550, 268, 0, 268, 0, 0, 0
4378, 1, 1636421459509, 1636421459782, 273, 1, 272, 0, 0, 0
4379, 1, 1636421459509, 1636421459782, 273, 1, 272, 1, 0, 1
4380, 1, 1636421459693, 1636421459961, 268, 0, 268, 0, 0, 0
4382, 1, 1636421459910, 1636421460177, 267, 0, 267, 0, 0, 0
4383, 1, 1636421459961, 1636421460225, 264, 1, 263, 0, 0, 0
4384, 1, 1636421460181, 1636421460446, 265, 1, 264, 1, 0, 1
4385, 1, 1636421460181, 1636421460449, 268, 1, 267, 0, 1, 1
4386, 1, 1636421460361, 1636421460629, 268, 1, 267, 0, 0, 0
4387, 1, 1636421460578, 1636421460853, 275, 0, 275, 0, 0, 0
4388, 1, 1636421460637, 1636421460909, 272, 1, 271, 0, 0, 0
4389, 1, 1636421460846, 1636421461113, 267, 0, 267, 0, 0, 0
4390, 1, 1636421460857, 1636421461129, 272, 0, 272, 0, 0, 0
4391, 1, 1636421461029, 1636421461301, 272, 1, 271, 1, 0, 1
4392, 1, 1636421461253, 1636421461521, 268, 1, 267, 1, 0, 1
4393, 1, 1636421461341, 1636421461606, 265, 1, 264, 1, 0, 1
4394, 1, 1636421461474, 1636421461741, 267, 0, 267, 0, 0, 0
4395, 1, 1636421461513, 1636421461781, 268, 1, 267, 0, 1, 1
4397, 1, 1636421461705, 1636421461994, 289, 0, 289, 0, 0, 0
4399, 1, 1636421462005, 1636421462274, 269, 1, 268, 0, 1, 1
4400, 1, 1636421462142, 1636421462417, 275, 0, 275, 0, 0, 0
4402, 1, 1636421462394, 1636421462662, 268, 0, 268, 0, 0, 0
4403, 1, 1636421462670, 1636421462937, 267, 0, 267, 0, 0, 0
4404, 1, 1636421462814, 1636421463081, 267, 0, 267, 0, 0, 0
4405, 1, 1636421463062, 1636421463330, 268, 0, 268, 0, 0, 0
4406, 1, 1636421463334, 1636421463601, 267, 0, 267, 0, 0, 0
4407, 1, 1636421463482, 1636421463749, 267, 0, 267, 0, 0, 0
4408, 1, 1636421463729, 1636421463998, 269, 0, 269, 0, 0, 0
4409, 1, 1636421464002, 1636421464270, 268, 0, 268, 0, 0, 0
4410, 1, 1636421464150, 1636421464421, 271, 0, 271, 0, 0, 0
4413, 1, 1636421464822, 1636421465094, 272, 0, 272, 0, 0, 0
4414, 1, 1636421465414, 1636421465682, 268, 0, 268, 0, 0, 0
4415, 1, 1636421465494, 1636421465766, 272, 0, 272, 0, 0, 0
4416, 1, 1636421466081, 1636421466353, 272, 1, 271, 0, 0, 0
4419, 1, 1636421467006, 1636421467278, 272, 0, 272, 0, 0, 0
4420, 1, 1636421467677, 1636421467950, 273, 1, 272, 0, 0, 0
4421, 1, 1636421467677, 1636421467950, 273, 1, 272, 0, 0, 0
4422, 1, 1636421468345, 1636421468614, 269, 1, 268, 0, 0, 0
4423, 1, 1636421468345, 1636421468614, 269, 1, 268, 0, 0, 0
4424, 1, 1636421469014, 1636421469281, 267, 0, 267, 0, 0, 0
4426, 1, 1636421469362, 1636421469630, 268, 0, 268, 0, 0, 0
4429, 1, 1636421470030, 1636421470298, 268, 0, 268, 0, 0, 0
4417, 1, 1636421472174, 1636421472446, 272, 0, 272, 0, 0, 0
4431, 1, 1636421472226, 1636421472494, 268, 0, 268, 0, 0, 0
4432, 1, 1636421472846, 1636421473118, 272, 0, 272, 0, 0, 0
4433, 1, 1636421472893, 1636421473165, 272, 1, 271, 0, 0, 0
4434, 1, 1636421473521, 1636421473786, 265, 0, 265, 0, 0, 0
4435, 1, 1636421473566, 1636421473833, 267, 0, 267, 0, 0, 0
4436, 1, 1636421474185, 1636421474454, 269, 1, 268, 0, 0, 0
4437, 1, 1636421474237, 1636421474529, 292, 1, 291, 0, 0, 0
4440, 1, 1636421474930, 1636421475202, 272, 0, 272, 0, 0, 0
4442, 1, 1636421475602, 1636421475874, 272, 0, 272, 0, 0, 0
4443, 1, 1636421476274, 1636421476542, 268, 0, 268, 0, 0, 0
4444, 1, 1636421477098, 1636421477370, 272, 0, 272, 0, 0, 0
4445, 1, 1636421477773, 1636421478046, 273, 1, 272, 0, 0, 0
4446, 1, 1636421478446, 1636421478717, 271, 0, 271, 0, 0, 0
4448, 1, 1636421479322, 1636421479593, 271, 0, 271, 0, 0, 0
4449, 1, 1636421479978, 1636421480246, 268, 0, 268, 0, 0, 0
4450, 1, 1636421479998, 1636421480274, 276, 0, 276, 0, 0, 0
4451, 1, 1636421480310, 1636421480582, 272, 0, 272, 0, 0, 0
4452, 1, 1636421480653, 1636421480922, 269, 1, 268, 0, 0, 0
4453, 1, 1636421480669, 1636421480934, 265, 1, 264, 0, 0, 0
4454, 1, 1636421480985, 1636421481254, 269, 1, 268, 0, 0, 0
4455, 1, 1636421481006, 1636421481278, 272, 0, 272, 0, 0, 0
4456, 1, 1636421481317, 1636421481594, 277, 0, 277, 0, 0, 0
4457, 1, 1636421481329, 1636421481601, 272, 1, 271, 0, 0, 0
4459, 1, 1636421481674, 1636421481942, 268, 0, 268, 0, 0, 0
4460, 1, 1636421481989, 1636421482262, 273, 1, 272, 0, 0, 0
4461, 1, 1636421482001, 1636421482273, 272, 1, 271, 0, 1, 1
4462, 1, 1636421482341, 1636421482610, 269, 1, 268, 0, 1, 1
4463, 1, 1636421482662, 1636421482930, 268, 0, 268, 0, 0, 0
4464, 1, 1636421482674, 1636421482942, 268, 0, 268, 0, 0, 0
4466, 1, 1636421483326, 1636421483593, 267, 0, 267, 0, 0, 0
4467, 1, 1636421483341, 1636421483609, 268, 1, 267, 1, 0, 1
4468, 1, 1636421483990, 1636421484262, 272, 0, 272, 0, 0, 0
4469, 1, 1636421484262, 1636421484530, 268, 1, 267, 0, 1, 1
4470, 1, 1636421484942, 1636421485210, 268, 0, 268, 0, 0, 0
4471, 1, 1636421485062, 1636421485330, 268, 0, 268, 0, 0, 0
4472, 1, 1636421485162, 1636421485433, 271, 0, 271, 0, 0, 0
4473, 1, 1636421485333, 1636421485602, 269, 1, 268, 0, 0, 0
4474, 1, 1636421485609, 1636421485882, 273, 1, 272, 0, 0, 0
4475, 1, 1636421485730, 1636421485998, 268, 0, 268, 0, 0, 0
4476, 1, 1636421485838, 1636421486114, 276, 0, 276, 0, 0, 0
4477, 1, 1636421486002, 1636421486277, 275, 0, 275, 0, 0, 0
4478, 1, 1636421486286, 1636421486554, 268, 0, 268, 0, 0, 0
4480, 1, 1636421486513, 1636421486781, 268, 1, 267, 0, 0, 0
4483, 1, 1636421487186, 1636421487458, 272, 0, 272, 0, 0, 0
4484, 1, 1636421487857, 1636421488130, 273, 1, 272, 0, 0, 0
4485, 1, 1636421488530, 1636421488802, 272, 0, 272, 0, 0, 0
4486, 1, 1636421489206, 1636421489482, 276, 0, 276, 0, 0, 0
4487, 1, 1636421489426, 1636421489698, 272, 0, 272, 0, 0, 0
4488, 1, 1636421490097, 1636421490369, 272, 1, 271, 0, 0, 0
4489, 1, 1636421490770, 1636421491042, 272, 0, 272, 0, 0, 0
4490, 1, 1636421491442, 1636421491710, 268, 0, 268, 0, 0, 0
4491, 1, 1636421491958, 1636421492233, 275, 0, 275, 0, 0, 0
4492, 1, 1636421492110, 1636421492378, 268, 0, 268, 0, 0, 0
4493, 1, 1636421492634, 1636421492905, 271, 0, 271, 0, 0, 0
4494, 1, 1636421492909, 1636421493178, 269, 1, 268, 1, 0, 1
4495, 1, 1636421493302, 1636421493573, 271, 0, 271, 0, 0, 0
4496, 1, 1636421493326, 1636421493598, 272, 0, 272, 0, 0, 0
4497, 1, 1636421493577, 1636421493853, 276, 1, 275, 1, 0, 1
4499, 1, 1636421493998, 1636421494270, 272, 0, 272, 0, 0, 0
4500, 1, 1636421494253, 1636421494525, 272, 1, 271, 0, 0, 0
4501, 1, 1636421494674, 1636421494942, 268, 0, 268, 0, 0, 0
4502, 1, 1636421494925, 1636421495197, 272, 1, 271, 0, 0, 0
4503, 1, 1636421495341, 1636421495610, 269, 1, 268, 0, 0, 0
4504, 1, 1636421495597, 1636421495866, 269, 1, 268, 0, 1, 1
4505, 1, 1636421496010, 1636421496277, 267, 0, 267, 0, 0, 0
4506, 1, 1636421496265, 1636421496537, 272, 1, 271, 1, 0, 1
4507, 1, 1636421496721, 1636421496998, 277, 0, 277, 0, 0, 0
4508, 1, 1636421496721, 1636421496998, 277, 1, 276, 0, 0, 0
4510, 1, 1636421497001, 1636421497269, 268, 0, 268, 0, 0, 0
4511, 1, 1636421497262, 1636421497530, 268, 0, 268, 0, 0, 0
4512, 1, 1636421497401, 1636421497669, 268, 1, 267, 0, 1, 1
4513, 1, 1636421497401, 1636421497673, 272, 1, 271, 0, 1, 1
4514, 1, 1636421497673, 1636421497937, 264, 1, 263, 1, 0, 1
4515, 1, 1636421497925, 1636421498198, 273, 1, 272, 1, 0, 1
4516, 1, 1636421498069, 1636421498337, 268, 1, 267, 0, 0, 0
4517, 1, 1636421498073, 1636421498345, 272, 0, 272, 0, 0, 0
4518, 1, 1636421498349, 1636421498617, 268, 1, 267, 0, 0, 0
4519, 1, 1636421498598, 1636421498870, 272, 0, 272, 0, 0, 0
4520, 1, 1636421498738, 1636421499009, 271, 0, 271, 0, 0, 0
4523, 1, 1636421499270, 1636421499538, 268, 0, 268, 0, 0, 0
4524, 1, 1636421499410, 1636421499678, 268, 0, 268, 0, 0, 0
4525, 1, 1636421499938, 1636421500210, 272, 0, 272, 0, 0, 0
4526, 1, 1636421500077, 1636421500346, 269, 1, 268, 1, 0, 1
4527, 1, 1636421500610, 1636421500886, 276, 0, 276, 0, 0, 0
4529, 1, 1636421501285, 1636421501558, 273, 1, 272, 0, 1, 1
4530, 1, 1636421504282, 1636421504554, 272, 0, 272, 0, 0, 0
4531, 1, 1636421504954, 1636421505225, 271, 0, 271, 0, 0, 0
4532, 1, 1636421505626, 1636421505894, 268, 0, 268, 0, 0, 0
4533, 1, 1636421506294, 1636421506566, 272, 0, 272, 0, 0, 0
4534, 1, 1636421506982, 1636421507249, 267, 0, 267, 0, 0, 0
4535, 1, 1636421507246, 1636421507518, 272, 0, 272, 0, 0, 0
4536, 1, 1636421507650, 1636421507922, 272, 0, 272, 0, 0, 0
4537, 1, 1636421507922, 1636421508194, 272, 0, 272, 0, 0, 0
4538, 1, 1636421508322, 1636421508594, 272, 0, 272, 0, 0, 0
4539, 1, 1636421508594, 1636421508882, 288, 0, 288, 0, 0, 0
4540, 1, 1636421508994, 1636421509266, 272, 0, 272, 0, 0, 0
4541, 1, 1636421509053, 1636421509321, 268, 1, 267, 1, 0, 1
4542, 1, 1636421509289, 1636421509562, 273, 0, 273, 0, 0, 0
4543, 1, 1636421509325, 1636421509589, 264, 0, 264, 0, 0, 0
4544, 1, 1636421509666, 1636421509933, 267, 0, 267, 0, 0, 0
4545, 1, 1636421509721, 1636421509989, 268, 1, 267, 1, 0, 1
4546, 1, 1636421509961, 1636421510229, 268, 1, 267, 0, 0, 0
4547, 1, 1636421509989, 1636421510257, 268, 1, 267, 0, 0, 0
4548, 1, 1636421510333, 1636421510601, 268, 1, 267, 0, 0, 0
4549, 1, 1636421510389, 1636421510657, 268, 1, 267, 0, 0, 0
4550, 1, 1636421510629, 1636421510901, 272, 0, 272, 0, 0, 0
4551, 1, 1636421510701, 1636421510978, 277, 1, 276, 0, 0, 0
4552, 1, 1636421511001, 1636421511270, 269, 1, 268, 0, 1, 1
4553, 1, 1636421511054, 1636421511322, 268, 0, 268, 0, 0, 0
4554, 1, 1636421511057, 1636421511325, 268, 1, 267, 1, 0, 1
4555, 1, 1636421511301, 1636421511574, 273, 1, 272, 0, 0, 0
4556, 1, 1636421511373, 1636421511642, 269, 1, 268, 0, 1, 1
4558, 1, 1636421511721, 1636421511990, 269, 1, 268, 0, 0, 0
4559, 1, 1636421511725, 1636421511993, 268, 1, 267, 1, 0, 1
4560, 1, 1636421512041, 1636421512310, 269, 1, 268, 0, 0, 0
4562, 1, 1636421512394, 1636421512662, 268, 0, 268, 0, 0, 0
4561, 1, 1636421512394, 1636421512662, 268, 0, 268, 0, 0, 0
4563, 1, 1636421512709, 1636421512982, 273, 0, 273, 0, 0, 0
4565, 1, 1636421513062, 1636421513334, 272, 0, 272, 0, 0, 0
4564, 1, 1636421513062, 1636421513334, 272, 0, 272, 0, 0, 0
4566, 1, 1636421513378, 1636421513646, 268, 0, 268, 0, 0, 0
4568, 1, 1636421513733, 1636421514001, 268, 1, 267, 0, 1, 1
4567, 1, 1636421513733, 1636421514001, 268, 1, 267, 1, 0, 1
4569, 1, 1636421514045, 1636421514310, 265, 1, 264, 0, 1, 1
4570, 1, 1636421514401, 1636421514670, 269, 0, 269, 0, 0, 0
4571, 1, 1636421514401, 1636421514670, 269, 1, 268, 0, 0, 0
4572, 1, 1636421514709, 1636421514981, 272, 1, 271, 0, 1, 1
4574, 1, 1636421515069, 1636421515337, 268, 1, 267, 0, 1, 1
4573, 1, 1636421515069, 1636421515337, 268, 1, 267, 0, 1, 1
4575, 1, 1636421515381, 1636421515646, 265, 1, 264, 0, 1, 1
4576, 1, 1636421515737, 1636421516005, 268, 1, 267, 0, 1, 1
4577, 1, 1636421516046, 1636421516313, 267, 0, 267, 0, 0, 0
4580, 1, 1636421521978, 1636421522246, 268, 0, 268, 0, 0, 0
4581, 1, 1636421522646, 1636421522917, 271, 0, 271, 0, 0, 0
4582, 1, 1636421523317, 1636421523590, 273, 1, 272, 0, 0, 0
4583, 1, 1636421523989, 1636421524257, 268, 0, 268, 0, 0, 0
4584, 1, 1636421524658, 1636421524926, 268, 0, 268, 0, 0, 0
4585, 1, 1636421525326, 1636421525594, 268, 0, 268, 0, 0, 0
4586, 1, 1636421525994, 1636421526266, 272, 0, 272, 0, 0, 0
4587, 1, 1636421526757, 1636421527026, 269, 1, 268, 0, 0, 0
4588, 1, 1636421527030, 1636421527298, 268, 0, 268, 0, 0, 0
4589, 1, 1636421527426, 1636421527702, 276, 0, 276, 0, 0, 0
4590, 1, 1636421527702, 1636421527970, 268, 0, 268, 0, 0, 0
4591, 1, 1636421528101, 1636421528370, 269, 0, 269, 0, 0, 0
4592, 1, 1636421528374, 1636421528642, 268, 0, 268, 0, 0, 0
4593, 1, 1636421528770, 1636421529038, 268, 0, 268, 0, 0, 0
4594, 1, 1636421529042, 1636421529322, 280, 0, 280, 0, 0, 0
4595, 1, 1636421529438, 1636421529706, 268, 0, 268, 0, 0, 0
4596, 1, 1636421529722, 1636421529990, 268, 0, 268, 0, 0, 0
4597, 1, 1636421530105, 1636421530374, 269, 1, 268, 0, 1, 1
4598, 1, 1636421530389, 1636421530658, 269, 1, 268, 0, 0, 0
4599, 1, 1636421530774, 1636421531042, 268, 0, 268, 0, 0, 0
4600, 1, 1636421531049, 1636421531322, 273, 1, 272, 1, 0, 1
4601, 1, 1636421835982, 1636421836250, 268, 0, 268, 0, 0, 0
4603, 1, 1636421836750, 1636421837018, 268, 0, 268, 0, 0, 0
4604, 1, 1636421837394, 1636421837666, 272, 0, 272, 0, 0, 0
4606, 1, 1636421838010, 1636421838282, 272, 0, 272, 0, 0, 0
4608, 1, 1636421838630, 1636421838898, 268, 0, 268, 0, 0, 0
4611, 1, 1636421839325, 1636421839594, 269, 1, 268, 0, 0, 0
4613, 1, 1636421840046, 1636421840314, 268, 0, 268, 0, 0, 0
4615, 1, 1636421840678, 1636421840950, 272, 0, 272, 0, 0, 0
4614, 1, 1636421840714, 1636421840982, 268, 0, 268, 0, 0, 0
4616, 1, 1636421841310, 1636421841578, 268, 0, 268, 0, 0, 0
4617, 1, 1636421841381, 1636421841654, 273, 1, 272, 0, 0, 0
4620, 1, 1636421841989, 1636421842262, 273, 1, 272, 1, 0, 1
4622, 1, 1636421842661, 1636421842934, 273, 1, 272, 0, 0, 0
4623, 1, 1636421843337, 1636421843605, 268, 1, 267, 1, 0, 1
4624, 1, 1636421843693, 1636421843966, 273, 0, 273, 0, 0, 0
4627, 1, 1636421844390, 1636421844662, 272, 0, 272, 0, 0, 0
4628, 1, 1636421845061, 1636421845334, 273, 1, 272, 0, 0, 0
4629, 1, 1636421845598, 1636421845866, 268, 0, 268, 0, 0, 0
4630, 1, 1636421845737, 1636421846010, 273, 1, 272, 1, 0, 1
4632, 1, 1636421846226, 1636421846493, 267, 0, 267, 0, 0, 0
4631, 1, 1636421846266, 1636421846534, 268, 0, 268, 0, 0, 0
4635, 1, 1636421846930, 1636421847198, 268, 0, 268, 0, 0, 0
4636, 1, 1636421846993, 1636421847262, 269, 1, 268, 1, 0, 1
4637, 1, 1636421847130, 1636421847397, 267, 0, 267, 0, 0, 0
4639, 1, 1636421847661, 1636421847930, 269, 1, 268, 0, 0, 0
4640, 1, 1636421847762, 1636421848033, 271, 0, 271, 0, 0, 0
4642, 1, 1636421847926, 1636421848237, 311, 0, 311, 0, 0, 0
4643, 1, 1636421848329, 1636421848598, 269, 1, 268, 0, 0, 0
4644, 1, 1636421848410, 1636421848677, 267, 0, 267, 0, 0, 0
4645, 1, 1636421848438, 1636421848706, 268, 0, 268, 0, 0, 0
4647, 1, 1636421848598, 1636421848869, 271, 0, 271, 0, 0, 0
4646, 1, 1636421848673, 1636421848942, 269, 1, 268, 1, 0, 1
4648, 1, 1636421849001, 1636421849269, 268, 1, 267, 0, 1, 1
4649, 1, 1636421849026, 1636421849293, 267, 0, 267, 0, 0, 0
4651, 1, 1636421849105, 1636421849377, 272, 1, 271, 0, 1, 1
4650, 1, 1636421849081, 1636421849385, 304, 1, 303, 1, 0, 1
4652, 1, 1636421849121, 1636421849389, 268, 0, 268, 0, 0, 0
4654, 1, 1636421849377, 1636421849649, 272, 1, 271, 0, 0, 0
4655, 1, 1636421849637, 1636421849906, 269, 1, 268, 1, 0, 1
4656, 1, 1636421849669, 1636421849941, 272, 1, 271, 1, 0, 1
4657, 1, 1636421849697, 1636421849965, 268, 0, 268, 0, 0, 0
4659, 1, 1636421849798, 1636421850074, 276, 0, 276, 0, 0, 0
4658, 1, 1636421849781, 1636421850074, 293, 1, 292, 0, 0, 0
4660, 1, 1636421849985, 1636421850253, 268, 1, 267, 0, 0, 0
4663, 1, 1636421850305, 1636421850569, 264, 1, 263, 0, 0, 0
4664, 1, 1636421850334, 1636421850601, 267, 0, 267, 0, 0, 0
4665, 1, 1636421850337, 1636421850601, 264, 0, 264, 0, 0, 0
4666, 1, 1636421850366, 1636421850630, 264, 0, 264, 0, 0, 0
4668, 1, 1636421850469, 1636421850737, 268, 1, 267, 0, 0, 0
4667, 1, 1636421850473, 1636421850745, 272, 0, 272, 0, 0, 0
4669, 1, 1636421850649, 1636421850922, 273, 0, 273, 0, 0, 0
4670, 1, 1636421850969, 1636421851237, 268, 1, 267, 0, 0, 0
4671, 1, 1636421851002, 1636421851270, 268, 0, 268, 0, 0, 0
4672, 1, 1636421851005, 1636421851273, 268, 1, 267, 1, 0, 1
4673, 1, 1636421851034, 1636421851305, 271, 0, 271, 0, 0, 0
4674, 1, 1636421851141, 1636421851434, 293, 1, 292, 1, 0, 1
4675, 1, 1636421851149, 1636421851434, 285, 1, 284, 0, 1, 1
4676, 1, 1636421851342, 1636421851605, 263, 0, 263, 0, 0, 0
4677, 1, 1636421851641, 1636421851909, 268, 0, 268, 0, 0, 0
4678, 1, 1636421851669, 1636421851937, 268, 1, 267, 1, 0, 1
4679, 1, 1636421851681, 1636421851949, 268, 1, 267, 1, 0, 1
4680, 1, 1636421851685, 1636421851961, 276, 1, 275, 0, 0, 0
4682, 1, 1636421851705, 1636421851977, 272, 0, 272, 0, 0, 0
4684, 1, 1636421851833, 1636421852189, 356, 1, 355, 1, 0, 1
4683, 1, 1636421851842, 1636421852189, 347, 0, 347, 0, 0, 0
4681, 1, 1636421852013, 1636421852277, 264, 1, 263, 1, 0, 1
4686, 1, 1636421852305, 1636421852574, 269, 1, 268, 0, 0, 0
4687, 1, 1636421852317, 1636421852585, 268, 0, 268, 0, 0, 0
4688, 1, 1636421852337, 1636421852605, 268, 1, 267, 0, 0, 0
4689, 1, 1636421852357, 1636421852625, 268, 1, 267, 0, 1, 1
4691, 1, 1636421852365, 1636421852641, 276, 0, 276, 0, 0, 0
4690, 1, 1636421852589, 1636421852866, 277, 1, 276, 0, 0, 0
4693, 1, 1636421852593, 1636421852869, 276, 1, 275, 0, 1, 1
4694, 1, 1636421852593, 1636421852869, 276, 1, 275, 0, 1, 1
4695, 1, 1636421852677, 1636421852945, 268, 1, 267, 0, 0, 0
4696, 1, 1636421852974, 1636421853246, 272, 0, 272, 0, 0, 0
4697, 1, 1636421852993, 1636421853262, 269, 0, 269, 0, 0, 0
4698, 1, 1636421853001, 1636421853277, 276, 0, 276, 0, 0, 0
4700, 1, 1636421853045, 1636421853313, 268, 1, 267, 0, 0, 0
4701, 1, 1636421853262, 1636421853525, 263, 1, 262, 0, 1, 1
4703, 1, 1636421853266, 1636421853533, 267, 0, 267, 0, 0, 0
4702, 1, 1636421853269, 1636421853537, 268, 0, 268, 0, 0, 0
4704, 1, 1636421853346, 1636421853610, 264, 0, 264, 0, 0, 0
4705, 1, 1636421853641, 1636421853909, 268, 0, 268, 0, 0, 0
4706, 1, 1636421853657, 1636421853925, 268, 0, 268, 0, 0, 0
4707, 1, 1636421853681, 1636421853949, 268, 0, 268, 0, 0, 0
4708, 1, 1636421853709, 1636421853977, 268, 0, 268, 0, 0, 0
4709, 1, 1636421853961, 1636421854230, 269, 1, 268, 1, 0, 1
4711, 1, 1636421853961, 1636421854233, 272, 1, 271, 0, 1, 1
4712, 1, 1636421854053, 1636421854321, 268, 1, 267, 1, 0, 1
4714, 1, 1636421854309, 1636421854578, 269, 1, 268, 0, 0, 0
4713, 1, 1636421854361, 1636421854630, 269, 1, 268, 1, 0, 1
4716, 1, 1636421854361, 1636421854630, 269, 1, 268, 0, 1, 1
4715, 1, 1636421854361, 1636421854630, 269, 1, 268, 0, 1, 1
4717, 1, 1636421854381, 1636421854650, 269, 1, 268, 0, 1, 1
4718, 1, 1636421854637, 1636421854901, 264, 1, 263, 1, 0, 1
4720, 1, 1636421854713, 1636421854985, 272, 0, 272, 0, 0, 0
4721, 1, 1636421854717, 1636421854985, 268, 0, 268, 0, 0, 0
4722, 1, 1636421854978, 1636421855246, 268, 0, 268, 0, 0, 0
4723, 1, 1636421855022, 1636421855289, 267, 0, 267, 0, 0, 0
4725, 1, 1636421855029, 1636421855297, 268, 1, 267, 0, 0, 0
4724, 1, 1636421855033, 1636421855310, 277, 0, 277, 0, 0, 0
4726, 1, 1636421855049, 1636421855317, 268, 1, 267, 0, 0, 0
4727, 1, 1636421855309, 1636421855577, 268, 1, 267, 0, 0, 0
4728, 1, 1636421855389, 1636421855657, 268, 0, 268, 0, 0, 0
4730, 1, 1636421855645, 1636421855914, 269, 1, 268, 1, 0, 1
4732, 1, 1636421855701, 1636421855969, 268, 0, 268, 0, 0, 0
4733, 1, 1636421855717, 1636421855985, 268, 1, 267, 0, 1, 1
4734, 1, 1636421855725, 1636421855994, 269, 1, 268, 1, 0, 1
4735, 1, 1636421855981, 1636421856250, 269, 1, 268, 0, 0, 0
4736, 1, 1636421856062, 1636421856329, 267, 0, 267, 0, 0, 0
4737, 1, 1636421856314, 1636421856585, 271, 0, 271, 0, 0, 0
4738, 1, 1636421856373, 1636421856641, 268, 1, 267, 0, 1, 1
4740, 1, 1636421856397, 1636421856665, 268, 1, 267, 0, 0, 0
4741, 1, 1636421856657, 1636421856973, 316, 1, 315, 0, 0, 0
4743, 1, 1636421856729, 1636421856997, 268, 1, 267, 0, 0, 0
4742, 1, 1636421856729, 1636421856997, 268, 1, 267, 0, 0, 0
4744, 1, 1636421857025, 1636421857293, 268, 1, 267, 0, 0, 0
4745, 1, 1636421857042, 1636421857305, 263, 0, 263, 0, 0, 0
4746, 1, 1636421857105, 1636421857373, 268, 1, 267, 1, 0, 1
4747, 1, 1636421857234, 1636421857505, 271, 0, 271, 0, 0, 0
4750, 1, 1636421857401, 1636421857674, 273, 1, 272, 0, 0, 0
4749, 1, 1636421857401, 1636421857674, 273, 1, 272, 1, 0, 1
4748, 1, 1636421857369, 1636421857674, 305, 0, 305, 0, 0, 0
4752, 1, 1636421857717, 1636421857981, 264, 0, 264, 0, 0, 0
4751, 1, 1636421857721, 1636421857990, 269, 0, 269, 0, 0, 0
4754, 1, 1636421857925, 1636421858193, 268, 1, 267, 0, 1, 1
4755, 1, 1636421857933, 1636421858202, 269, 1, 268, 0, 1, 1
4757, 1, 1636421858069, 1636421858337, 268, 1, 267, 1, 0, 1
4756, 1, 1636421858077, 1636421858345, 268, 1, 267, 1, 0, 1
4758, 1, 1636421858077, 1636421858353, 276, 1, 275, 1, 0, 1
4759, 1, 1636421858201, 1636421858473, 272, 1, 271, 1, 0, 1
4761, 1, 1636421858389, 1636421858657, 268, 1, 267, 0, 0, 0
4762, 1, 1636421858585, 1636421858853, 268, 1, 267, 0, 0, 0
4763, 1, 1636421858601, 1636421858869, 268, 0, 268, 0, 0, 0
4764, 1, 1636421858741, 1636421859009, 268, 1, 267, 1, 0, 1
4766, 1, 1636421858757, 1636421859029, 272, 0, 272, 0, 0, 0
4767, 1, 1636421858877, 1636421859146, 269, 0, 269, 0, 0, 0
4768, 1, 1636421859057, 1636421859358, 301, 1, 300, 0, 0, 0
4769, 1, 1636421859269, 1636421859537, 268, 1, 267, 0, 0, 0
4770, 1, 1636421859269, 1636421859537, 268, 1, 267, 1, 0, 1
4771, 1, 1636421859409, 1636421859673, 264, 1, 263, 0, 0, 0
4772, 1, 1636421859425, 1636421859689, 264, 0, 264, 0, 0, 0
4773, 1, 1636421859549, 1636421859817, 268, 0, 268, 0, 0, 0
4774, 1, 1636421859622, 1636421859889, 267, 0, 267, 0, 0, 0
4775, 1, 1636421859789, 1636421860057, 268, 1, 267, 0, 0, 0
4776, 1, 1636421859933, 1636421860210, 277, 1, 276, 0, 0, 0
4777, 1, 1636421859929, 1636421860210, 281, 1, 280, 0, 0, 0
4778, 1, 1636421860122, 1636421860386, 264, 0, 264, 0, 0, 0
4779, 1, 1636421860122, 1636421860390, 268, 0, 268, 0, 0, 0
4780, 1, 1636421860165, 1636421860433, 268, 0, 268, 0, 0, 0
4781, 1, 1636421860257, 1636421860529, 272, 1, 271, 0, 0, 0
4782, 1, 1636421860294, 1636421860561, 267, 0, 267, 0, 0, 0
4783, 1, 1636421860433, 1636421860697, 264, 1, 263, 1, 0, 1
4785, 1, 1636421860601, 1636421860869, 268, 1, 267, 1, 0, 1
4786, 1, 1636421860606, 1636421860873, 267, 0, 267, 0, 0, 0
4787, 1, 1636421860789, 1636421861057, 268, 1, 267, 0, 0, 0
4789, 1, 1636421860837, 1636421861105, 268, 0, 268, 0, 0, 0
4790, 1, 1636421860925, 1636421861197, 272, 0, 272, 0, 0, 0
4791, 1, 1636421860961, 1636421861229, 268, 0, 268, 0, 0, 0
4792, 1, 1636421861109, 1636421861377, 268, 0, 268, 0, 0, 0
4793, 1, 1636421861273, 1636421861541, 268, 1, 267, 0, 0, 0
4794, 1, 1636421861273, 1636421861542, 269, 1, 268, 0, 0, 0
4795, 1, 1636421861458, 1636421861730, 272, 0, 272, 0, 0, 0
4796, 1, 1636421861505, 1636421861773, 268, 1, 267, 0, 0, 0
4797, 1, 1636421861597, 1636421861866, 269, 0, 269, 0, 0, 0
4798, 1, 1636421861629, 1636421861894, 265, 1, 264, 1, 0, 1
4799, 1, 1636421861781, 1636421862053, 272, 0, 272, 0, 0, 0
4800, 1, 1636421861957, 1636421862229, 272, 1, 271, 0, 0, 0
4801, 1, 1636421861957, 1636421862233, 276, 1, 275, 0, 0, 0
4802, 1, 1636421862177, 1636421862458, 281, 1, 280, 0, 0, 0
4803, 1, 1636421862177, 1636421862458, 281, 1, 280, 0, 0, 0
4804, 1, 1636421862265, 1636421862542, 277, 0, 277, 0, 0, 0
4805, 1, 1636421862302, 1636421862570, 268, 0, 268, 0, 0, 0
4806, 1, 1636421862310, 1636421862574, 264, 0, 264, 0, 0, 0
4807, 1, 1636421862458, 1636421862725, 267, 1, 266, 0, 1, 1
4808, 1, 1636421862626, 1636421862893, 267, 0, 267, 0, 0, 0
4809, 1, 1636421862633, 1636421862901, 268, 0, 268, 0, 0, 0
4810, 1, 1636421862725, 1636421862993, 268, 1, 267, 0, 0, 0
4811, 1, 1636421862861, 1636421863161, 300, 0, 300, 0, 0, 0
4815, 1, 1636421862981, 1636421863250, 269, 1, 268, 0, 0, 0
4814, 1, 1636421862981, 1636421863250, 269, 1, 268, 0, 0, 0
4813, 1, 1636421862981, 1636421863250, 269, 1, 268, 0, 0, 0
4816, 1, 1636421863165, 1636421863429, 264, 1, 263, 0, 1, 1
4818, 1, 1636421863305, 1636421863573, 268, 1, 267, 0, 0, 0
4820, 1, 1636421863397, 1636421863661, 264, 1, 263, 0, 0, 0
4819, 1, 1636421863429, 1636421863697, 268, 1, 267, 1, 0, 1
4821, 1, 1636421863569, 1636421863833, 264, 0, 264, 0, 0, 0
4822, 1, 1636421863645, 1636421863913, 268, 1, 267, 0, 0, 0
4824, 1, 1636421863649, 1636421863917, 268, 1, 267, 1, 0, 1
4823, 1, 1636421863649, 1636421863921, 272, 1, 271, 1, 0, 1
4825, 1, 1636421863833, 1636421864101, 268, 1, 267, 1, 0, 1
4827, 1, 1636421864065, 1636421864337, 272, 1, 271, 0, 0, 0
4828, 1, 1636421864121, 1636421864389, 268, 1, 267, 1, 0, 1
4829, 1, 1636421864229, 1636421864498, 269, 1, 268, 0, 1, 1
4830, 1, 1636421864250, 1636421864513, 263, 0, 263, 0, 0, 0
4831, 1, 1636421864314, 1636421864578, 264, 0, 264, 0, 0, 0
4833, 1, 1636421864325, 1636421864589, 264, 0, 264, 0, 0, 0
4834, 1, 1636421864497, 1636421864765, 268, 1, 267, 0, 0, 0
4835, 1, 1636421864737, 1636421865009, 272, 1, 271, 1, 0, 1
4836, 1, 1636421864809, 1636421865082, 273, 1, 272, 0, 0, 0
4837, 1, 1636421864905, 1636421865173, 268, 0, 268, 0, 0, 0
4838, 1, 1636421864913, 1636421865181, 268, 0, 268, 0, 0, 0
4839, 1, 1636421864945, 1636421865213, 268, 1, 267, 0, 1, 1
4842, 1, 1636421865173, 1636421865441, 268, 1, 267, 1, 0, 1
4841, 1, 1636421865185, 1636421865453, 268, 0, 268, 0, 0, 0
4840, 1, 1636421865221, 1636421865522, 301, 1, 300, 0, 0, 0
4844, 1, 1636421865485, 1636421865753, 268, 1, 267, 0, 0, 0
4843, 1, 1636421865525, 1636421865830, 305, 1, 304, 0, 1, 1
4845, 1, 1636421865577, 1636421865845, 268, 0, 268, 0, 0, 0
4846, 1, 1636421865585, 1636421865853, 268, 0, 268, 0, 0, 0
4848, 1, 1636421865833, 1636421866102, 269, 0, 269, 0, 0, 0
4847, 1, 1636421865845, 1636421866121, 276, 1, 275, 1, 0, 1
4851, 1, 1636421865917, 1636421866190, 273, 1, 272, 0, 0, 0
4852, 1, 1636421866102, 1636421866369, 267, 0, 267, 0, 0, 0
4850, 1, 1636421866125, 1636421866433, 308, 0, 308, 0, 0, 0
4854, 1, 1636421866229, 1636421866517, 288, 1, 287, 1, 0, 1
4856, 1, 1636421866253, 1636421866517, 264, 1, 263, 0, 0, 0
4853, 1, 1636421866373, 1636421866642, 269, 1, 268, 0, 0, 0
4857, 1, 1636421866501, 1636421866778, 277, 1, 276, 0, 0, 0
4858, 1, 1636421866561, 1636421866830, 269, 1, 268, 0, 1, 1
4859, 1, 1636421866589, 1636421866853, 264, 1, 263, 0, 1, 1
4860, 1, 1636421866689, 1636421866958, 269, 0, 269, 0, 0, 0
4861, 1, 1636421866777, 1636421867046, 269, 1, 268, 0, 0, 0
4864, 1, 1636421866930, 1636421867197, 267, 0, 267, 0, 0, 0
4863, 1, 1636421866961, 1636421867242, 281, 1, 280, 1, 0, 1
4865, 1, 1636421867045, 1636421867314, 269, 1, 268, 0, 0, 0
4866, 1, 1636421867177, 1636421867446, 269, 1, 268, 1, 0, 1
4867, 1, 1636421867233, 1636421867513, 280, 1, 279, 0, 0, 0
4868, 1, 1636421867257, 1636421867530, 273, 1, 272, 1, 0, 1
4869, 1, 1636421867361, 1636421867629, 268, 1, 267, 1, 0, 1
4870, 1, 1636421867449, 1636421867721, 272, 1, 271, 0, 0, 0
4871, 1, 1636421867597, 1636421867866, 269, 0, 269, 0, 0, 0
4872, 1, 1636421867645, 1636421867937, 292, 1, 291, 0, 0, 0
4874, 1, 1636421867893, 1636421868162, 269, 1, 268, 0, 0, 0
4875, 1, 1636421867913, 1636421868178, 265, 1, 264, 0, 0, 0
4876, 1, 1636421867925, 1636421868194, 269, 1, 268, 1, 0, 1
4877, 1, 1636421868033, 1636421868301, 268, 1, 267, 0, 0, 0
4879, 1, 1636421868165, 1636421868433, 268, 1, 267, 0, 0, 0
4878, 1, 1636421868185, 1636421868457, 272, 1, 271, 0, 0, 0
4880, 1, 1636421868265, 1636421868533, 268, 1, 267, 0, 0, 0
4882, 1, 1636421868557, 1636421868825, 268, 1, 267, 0, 1, 1
4883, 1, 1636421868589, 1636421868882, 293, 1, 292, 0, 0, 0
4886, 1, 1636421868705, 1636421868973, 268, 0, 268, 0, 0, 0
4885, 1, 1636421868829, 1636421869105, 276, 1, 275, 0, 0, 0
4888, 1, 1636421868857, 1636421869130, 273, 1, 272, 1, 0, 1
4891, 1, 1636421869230, 1636421869502, 272, 0, 272, 0, 0, 0
4894, 1, 1636421869502, 1636421869769, 267, 0, 267, 0, 0, 0
4895, 1, 1636421869525, 1636421869793, 268, 1, 267, 0, 1, 1
4897, 1, 1636421870174, 1636421870442, 268, 0, 268, 0, 0, 0
4898, 1, 1636421870198, 1636421870501, 303, 0, 303, 0, 0, 0
4900, 1, 1636421870841, 1636421871118, 277, 1, 276, 0, 0, 0
4911, 1, 1636421878022, 1636421878294, 272, 0, 272, 0, 0, 0
4913, 1, 1636421878697, 1636421878978, 281, 1, 280, 1, 0, 1
4912, 1, 1636421878685, 1636421878978, 293, 1, 292, 0, 1, 1
4917, 1, 1636421879422, 1636421879690, 268, 1, 267, 1, 0, 1
4916, 1, 1636421879422, 1636421879690, 268, 1, 267, 0, 1, 1
4919, 1, 1636421879422, 1636421879690, 268, 1, 267, 1, 0, 1
4918, 1, 1636421879422, 1636421879690, 268, 1, 267, 0, 0, 0
4920, 1, 1636421879589, 1636421879857, 268, 1, 267, 1, 0, 1
4921, 1, 1636421879689, 1636421879957, 268, 2, 266, 1, 0, 1
4922, 1, 1636421880085, 1636421880353, 268, 0, 268, 0, 0, 0
4925, 1, 1636421880089, 1636421880358, 269, 1, 268, 0, 0, 0
4924, 1, 1636421880093, 1636421880358, 265, 0, 265, 0, 0, 0
4927, 1, 1636421880258, 1636421880530, 272, 0, 272, 0, 0, 0
4926, 1, 1636421880361, 1636421880629, 268, 1, 267, 0, 0, 0
4931, 1, 1636421880757, 1636421881037, 280, 1, 279, 0, 0, 0
4930, 1, 1636421880757, 1636421881037, 280, 1, 279, 0, 0, 0
4929, 1, 1636421880757, 1636421881037, 280, 1, 279, 0, 0, 0
4933, 1, 1636421881057, 1636421881326, 269, 1, 268, 0, 1, 1
4932, 1, 1636421881057, 1636421881326, 269, 0, 269, 0, 0, 0
4934, 1, 1636421881073, 1636421881345, 272, 0, 272, 0, 0, 0
4935, 1, 1636421881205, 1636421881474, 269, 1, 268, 0, 0, 0
4936, 1, 1636421881410, 1636421881677, 267, 0, 267, 0, 0, 0
4938, 1, 1636421881474, 1636421881742, 268, 0, 268, 0, 0, 0
4937, 1, 1636421881474, 1636421881742, 268, 0, 268, 0, 0, 0
4941, 1, 1636421881725, 1636421881997, 272, 1, 271, 0, 0, 0
4942, 1, 1636421881745, 1636421882014, 269, 0, 269, 0, 0, 0
4940, 1, 1636421881745, 1636421882021, 276, 0, 276, 0, 0, 0
4943, 1, 1636421881826, 1636421882089, 263, 0, 263, 0, 0, 0
4945, 1, 1636421882078, 1636421882349, 271, 0, 271, 0, 0, 0
4946, 1, 1636421882142, 1636421882410, 268, 0, 268, 0, 0, 0
4947, 1, 1636421882142, 1636421882417, 275, 0, 275, 0, 0, 0
4948, 1, 1636421882394, 1636421882661, 267, 0, 267, 0, 0, 0
4949, 1, 1636421882410, 1636421882678, 268, 0, 268, 0, 0, 0
4950, 1, 1636421882417, 1636421882689, 272, 0, 272, 0, 0, 0
4952, 1, 1636421882745, 1636421883017, 272, 1, 271, 1, 0, 1
4953, 1, 1636421882810, 1636421883078, 268, 0, 268, 0, 0, 0
4954, 1, 1636421882817, 1636421883085, 268, 1, 267, 0, 0, 0
4955, 1, 1636421883065, 1636421883337, 272, 1, 271, 0, 0, 0
4957, 1, 1636421883125, 1636421883393, 268, 0, 268, 0, 0, 0
4960, 1, 1636421883478, 1636421883745, 267, 0, 267, 0, 0, 0
4959, 1, 1636421883478, 1636421883749, 271, 0, 271, 0, 0, 0
4961, 1, 1636421883481, 1636421883753, 272, 0, 272, 0, 0, 0
4962, 1, 1636421883777, 1636421884045, 268, 1, 267, 1, 0, 1
4963, 1, 1636421883793, 1636421884061, 268, 1, 267, 0, 0, 0
4964, 1, 1636421883902, 1636421884169, 267, 0, 267, 0, 0, 0
4967, 1, 1636421884149, 1636421884425, 276, 1, 275, 0, 0, 0
4965, 1, 1636421884149, 1636421884425, 276, 1, 275, 0, 0, 0
4966, 1, 1636421884149, 1636421884425, 276, 2, 274, 0, 0, 0
4969, 1, 1636421884470, 1636421884758, 288, 0, 288, 0, 0, 0
4968, 1, 1636421884469, 1636421884761, 292, 1, 291, 0, 0, 0
4971, 1, 1636421884594, 1636421884865, 271, 0, 271, 0, 0, 0
4970, 1, 1636421884758, 1636421885022, 264, 0, 264, 0, 0, 0
4973, 1, 1636421884825, 1636421885094, 269, 1, 268, 0, 1, 1
4972, 1, 1636421884825, 1636421885094, 269, 1, 268, 1, 0, 1
4974, 1, 1636421884829, 1636421885094, 265, 0, 265, 0, 0, 0
4975, 1, 1636421884930, 1636421885193, 263, 0, 263, 0, 0, 0
4976, 1, 1636421885162, 1636421885430, 268, 0, 268, 0, 0, 0
4977, 1, 1636421885162, 1636421885430, 268, 0, 268, 0, 0, 0
4978, 1, 1636421885429, 1636421885693, 264, 2, 262, 0, 0, 0
4979, 1, 1636421885421, 1636421885693, 272, 1, 271, 0, 0, 0
4982, 1, 1636421885498, 1636421885765, 267, 0, 267, 0, 0, 0
4983, 1, 1636421885701, 1636421885966, 265, 0, 265, 0, 0, 0
4984, 1, 1636421885825, 1636421886093, 268, 1, 267, 1, 0, 1
4985, 1, 1636421885825, 1636421886093, 268, 1, 267, 1, 0, 1
4986, 1, 1636421886134, 1636421886402, 268, 0, 268, 0, 0, 0
4989, 1, 1636421886401, 1636421886689, 288, 1, 287, 0, 0, 0
4991, 1, 1636421886514, 1636421886782, 268, 1, 267, 0, 1, 1
4992, 1, 1636421886514, 1636421886782, 268, 0, 268, 0, 0, 0
4990, 1, 1636421886514, 1636421886785, 271, 1, 270, 1, 0, 1
4994, 1, 1636421886866, 1636421887138, 272, 0, 272, 0, 0, 0
4997, 1, 1636421887190, 1636421887458, 268, 0, 268, 0, 0, 0
4998, 1, 1636421887190, 1636421887458, 268, 0, 268, 0, 0, 0
4999, 1, 1636421887446, 1636421887714, 268, 0, 268, 0, 0, 0
5000, 1, 1636421887537, 1636421887802, 265, 1, 264, 1, 0, 1
5001, 1, 1636421887861, 1636421888134, 273, 1, 272, 0, 1, 1
5003, 1, 1636421888114, 1636421888382, 268, 0, 268, 0, 0, 0
5004, 1, 1636421888202, 1636421888470, 268, 0, 268, 0, 0, 0
5006, 1, 1636421888782, 1636421889065, 283, 0, 283, 0, 0, 0
5008, 1, 1636421889229, 1636421889497, 268, 1, 267, 0, 0, 0
5010, 1, 1636421889553, 1636421889822, 269, 1, 268, 0, 0, 0
5011, 1, 1636421889894, 1636421890161, 267, 0, 267, 0, 0, 0
5012, 1, 1636421890221, 1636421890497, 276, 1, 275, 1, 0, 1
5013, 1, 1636421890501, 1636421890769, 268, 0, 268, 0, 0, 0
5014, 1, 1636421890562, 1636421890830, 268, 0, 268, 0, 0, 0
5015, 1, 1636421890773, 1636421891045, 272, 0, 272, 0, 0, 0
5016, 1, 1636421890897, 1636421891166, 269, 0, 269, 0, 0, 0
5017, 1, 1636421891169, 1636421891485, 316, 0, 316, 0, 0, 0
5019, 1, 1636421891485, 1636421891753, 268, 1, 267, 1, 0, 1
5021, 1, 1636421891749, 1636421892017, 268, 0, 268, 0, 0, 0
5022, 1, 1636421891922, 1636421892194, 272, 0, 272, 0, 0, 0
5024, 1, 1636421892181, 1636421892449, 268, 1, 267, 0, 0, 0
5023, 1, 1636421892193, 1636421892462, 269, 1, 268, 0, 0, 0
5026, 1, 1636421892589, 1636421892858, 269, 0, 269, 0, 0, 0
5027, 1, 1636421892798, 1636421893066, 268, 0, 268, 0, 0, 0
5028, 1, 1636421892850, 1636421893121, 271, 0, 271, 0, 0, 0
5029, 1, 1636421892861, 1636421893130, 269, 1, 268, 0, 0, 0
5030, 1, 1636421893257, 1636421893554, 297, 1, 296, 1, 0, 1
5031, 1, 1636421893386, 1636421893653, 267, 0, 267, 0, 0, 0
5032, 1, 1636421893465, 1636421893738, 273, 1, 272, 0, 0, 0
5034, 1, 1636421893557, 1636421893834, 277, 0, 277, 0, 0, 0
5035, 1, 1636421893725, 1636421893994, 269, 1, 268, 0, 1, 1
5033, 1, 1636421893833, 1636421894101, 268, 1, 267, 0, 0, 0
5036, 1, 1636421893953, 1636421894226, 273, 1, 272, 0, 0, 0
5038, 1, 1636421894137, 1636421894405, 268, 1, 267, 1, 0, 1
5039, 1, 1636421894229, 1636421894497, 268, 1, 267, 0, 0, 0
5041, 1, 1636421894505, 1636421894778, 273, 1, 272, 0, 1, 1
5042, 1, 1636421894625, 1636421894893, 268, 1, 267, 0, 0, 0
5043, 1, 1636421894806, 1636421895074, 268, 0, 268, 0, 0, 0
5044, 1, 1636421894897, 1636421895170, 273, 0, 273, 0, 0, 0
5045, 1, 1636421895182, 1636421895454, 272, 0, 272, 0, 0, 0
5046, 1, 1636421895289, 1636421895590, 301, 1, 300, 1, 0, 1
5047, 1, 1636421895501, 1636421895773, 272, 0, 272, 0, 0, 0
5048, 1, 1636421895593, 1636421895861, 268, 0, 268, 0, 0, 0
5049, 1, 1636421895810, 1636421896077, 267, 0, 267, 0, 0, 0
5050, 1, 1636421895810, 1636421896081, 271, 0, 271, 0, 0, 0
5051, 1, 1636421895857, 1636421896137, 280, 0, 280, 0, 0, 0
5052, 1, 1636421895989, 1636421896298, 309, 1, 308, 0, 0, 0
5053, 1, 1636421896210, 1636421896477, 267, 0, 267, 0, 0, 0
5054, 1, 1636421896301, 1636421896570, 269, 1, 268, 0, 0, 0
5055, 1, 1636421896426, 1636421896694, 268, 0, 268, 0, 0, 0
5056, 1, 1636421896473, 1636421896741, 268, 1, 267, 1, 0, 1
5059, 1, 1636421896537, 1636421896849, 312, 1, 311, 0, 1, 1
5060, 1, 1636421896698, 1636421896970, 272, 0, 272, 0, 0, 0
5061, 1, 1636421896897, 1636421897166, 269, 1, 268, 0, 0, 0
5062, 1, 1636421896989, 1636421897257, 268, 1, 267, 0, 1, 1
5064, 1, 1636421897141, 1636421897410, 269, 1, 268, 0, 1, 1
5066, 1, 1636421897273, 1636421897545, 272, 1, 271, 1, 0, 1
5067, 1, 1636421897373, 1636421897646, 273, 0, 273, 0, 0, 0
5068, 1, 1636421897410, 1636421897677, 267, 0, 267, 0, 0, 0
5069, 1, 1636421897505, 1636421897773, 268, 0, 268, 0, 0, 0
5070, 1, 1636421897561, 1636421897833, 272, 1, 271, 0, 0, 0
5071, 1, 1636421897657, 1636421897930, 273, 0, 273, 0, 0, 0
5073, 1, 1636421897945, 1636421898213, 268, 1, 267, 0, 1, 1
5076, 1, 1636421898166, 1636421898434, 268, 0, 268, 0, 0, 0
5078, 1, 1636421898238, 1636421898510, 272, 0, 272, 0, 0, 0
5080, 1, 1636421898622, 1636421898914, 292, 0, 292, 0, 0, 0
5082, 1, 1636421898841, 1636421899114, 273, 1, 272, 0, 1, 1
5083, 1, 1636421898917, 1636421899186, 269, 1, 268, 0, 1, 1
5084, 1, 1636421899177, 1636421899449, 272, 1, 271, 0, 0, 0
5085, 1, 1636421899314, 1636421899602, 288, 0, 288, 0, 0, 0
5087, 1, 1636421899605, 1636421899874, 269, 1, 268, 0, 0, 0
5088, 1, 1636421899774, 1636421900042, 268, 0, 268, 0, 0, 0
5020, 1, 1636421901226, 1636421901498, 272, 0, 272, 0, 0, 0
5093, 1, 1636421901530, 1636421901797, 267, 0, 267, 0, 0, 0
5094, 1, 1636421901898, 1636421902170, 272, 0, 272, 0, 0, 0
5097, 1, 1636421902726, 1636421902998, 272, 0, 272, 0, 0, 0
5098, 1, 1636421903402, 1636421903670, 268, 0, 268, 0, 0, 0
5099, 1, 1636421904101, 1636421904369, 268, 1, 267, 0, 0, 0
5100, 1, 1636421904362, 1636421904634, 272, 0, 272, 0, 0, 0
5101, 1, 1636421904705, 1636421904974, 269, 1, 268, 1, 0, 1
5102, 1, 1636421904770, 1636421905038, 268, 0, 268, 0, 0, 0
5103, 1, 1636421905038, 1636421905310, 272, 0, 272, 0, 0, 0
5104, 1, 1636421905373, 1636421905641, 268, 1, 267, 0, 0, 0
5105, 1, 1636421905438, 1636421905710, 272, 0, 272, 0, 0, 0
5106, 1, 1636421905706, 1636421905977, 271, 4, 267, 4, 0, 4
5107, 1, 1636421906041, 1636421906314, 273, 1, 272, 0, 0, 0
5108, 1, 1636421906109, 1636421906378, 269, 1, 268, 0, 0, 0
5109, 1, 1636421906378, 1636421906653, 275, 0, 275, 0, 0, 0
5110, 1, 1636421906713, 1636421906985, 272, 1, 271, 0, 1, 1
5111, 1, 1636421906777, 1636421907045, 268, 1, 267, 0, 0, 0
5112, 1, 1636421906786, 1636421907053, 267, 0, 267, 0, 0, 0
5114, 1, 1636421907053, 1636421907330, 277, 1, 276, 1, 0, 1
5115, 1, 1636421907389, 1636421907661, 272, 1, 271, 0, 0, 0
5116, 1, 1636421907433, 1636421907702, 269, 1, 268, 0, 1, 1
5118, 1, 1636421907458, 1636421907726, 268, 0, 268, 0, 0, 0
5117, 1, 1636421907701, 1636421907969, 268, 1, 267, 0, 0, 0
5120, 1, 1636421907765, 1636421908033, 268, 1, 267, 1, 0, 1
5121, 1, 1636421908134, 1636421908401, 267, 0, 267, 0, 0, 0
5123, 1, 1636421908134, 1636421908402, 268, 0, 268, 0, 0, 0
5122, 1, 1636421908134, 1636421908401, 267, 1, 266, 0, 1, 1
5124, 1, 1636421908134, 1636421908405, 271, 1, 270, 0, 1, 1
5125, 1, 1636421908373, 1636421908641, 268, 1, 267, 0, 1, 1
5126, 1, 1636421908373, 1636421908641, 268, 1, 267, 1, 0, 1
5127, 1, 1636421908421, 1636421908694, 273, 0, 273, 0, 0, 0
5128, 1, 1636421908429, 1636421908697, 268, 1, 267, 1, 0, 1
5132, 1, 1636421908793, 1636421909065, 272, 1, 271, 1, 0, 1
5133, 1, 1636421908805, 1636421909074, 269, 1, 268, 0, 0, 0
5131, 1, 1636421908805, 1636421909077, 272, 1, 271, 0, 0, 0
5134, 1, 1636421908809, 1636421909077, 268, 0, 268, 0, 0, 0
5135, 1, 1636421909041, 1636421909306, 265, 1, 264, 0, 0, 0
5137, 1, 1636421909093, 1636421909362, 269, 1, 268, 0, 1, 1
5138, 1, 1636421909106, 1636421909389, 283, 0, 283, 0, 0, 0
5140, 1, 1636421909469, 1636421909737, 268, 1, 267, 0, 0, 0
5141, 1, 1636421909477, 1636421909745, 268, 1, 267, 0, 0, 0
5143, 1, 1636421909477, 1636421909746, 269, 1, 268, 1, 0, 1
5144, 1, 1636421909709, 1636421909981, 272, 0, 272, 0, 0, 0
5142, 1, 1636421909745, 1636421910037, 292, 1, 291, 0, 0, 0
5146, 1, 1636421909805, 1636421910070, 265, 0, 265, 0, 0, 0
5147, 1, 1636421909817, 1636421910129, 312, 0, 312, 0, 0, 0
5145, 1, 1636421910041, 1636421910317, 276, 0, 276, 0, 0, 0
5149, 1, 1636421910177, 1636421910486, 309, 1, 308, 0, 0, 0
5151, 1, 1636421910177, 1636421910486, 309, 1, 308, 1, 0, 1
5148, 1, 1636421910169, 1636421910486, 317, 1, 316, 0, 0, 0
5150, 1, 1636421910317, 1636421910581, 264, 1, 263, 1, 0, 1
5155, 1, 1636421910489, 1636421910757, 268, 1, 267, 0, 0, 0
5154, 1, 1636421910489, 1636421910757, 268, 0, 268, 0, 0, 0
5156, 1, 1636421910529, 1636421910801, 272, 1, 271, 0, 0, 0
5158, 1, 1636421910717, 1636421910989, 272, 0, 272, 0, 0, 0
5159, 1, 1636421910741, 1636421911010, 269, 1, 268, 0, 1, 1
5162, 1, 1636421910881, 1636421911146, 265, 1, 264, 0, 0, 0
5160, 1, 1636421910881, 1636421911146, 265, 1, 264, 0, 0, 0
5161, 1, 1636421910881, 1636421911149, 268, 1, 267, 0, 0, 0
5163, 1, 1636421910977, 1636421911245, 268, 1, 267, 1, 0, 1
5165, 1, 1636421911153, 1636421911422, 269, 1, 268, 0, 1, 1
5164, 1, 1636421911153, 1636421911422, 269, 1, 268, 0, 0, 0
5166, 1, 1636421911209, 1636421911478, 269, 0, 269, 0, 0, 0
5168, 1, 1636421911409, 1636421911677, 268, 1, 267, 0, 1, 1
5167, 1, 1636421911478, 1636421911746, 268, 0, 268, 0, 0, 0
5169, 1, 1636421911549, 1636421911817, 268, 0, 268, 0, 0, 0
5170, 1, 1636421911557, 1636421911829, 272, 1, 271, 1, 0, 1
5172, 1, 1636421911649, 1636421911913, 264, 1, 263, 0, 0, 0
5171, 1, 1636421911745, 1636421912009, 264, 1, 263, 0, 0, 0
5173, 1, 1636421911829, 1636421912105, 276, 1, 275, 0, 0, 0
5175, 1, 1636421911881, 1636421912153, 272, 1, 271, 0, 0, 0
5176, 1, 1636421912073, 1636421912341, 268, 1, 267, 1, 0, 1
5177, 1, 1636421912149, 1636421912417, 268, 1, 267, 0, 1, 1
5178, 1, 1636421912241, 1636421912509, 268, 1, 267, 1, 0, 1
5180, 1, 1636421912314, 1636421912582, 268, 0, 268, 0, 0, 0
5181, 1, 1636421912409, 1636421912677, 268, 1, 267, 0, 1, 1
5183, 1, 1636421912501, 1636421912769, 268, 0, 268, 0, 0, 0
5184, 1, 1636421912553, 1636421912817, 264, 0, 264, 0, 0, 0
5182, 1, 1636421912581, 1636421912845, 264, 1, 263, 0, 0, 0
5185, 1, 1636421912773, 1636421913050, 277, 0, 277, 0, 0, 0
5186, 1, 1636421912817, 1636421913085, 268, 1, 267, 0, 0, 0
5187, 1, 1636421912905, 1636421913173, 268, 0, 268, 0, 0, 0
5189, 1, 1636421912981, 1636421913253, 272, 0, 272, 0, 0, 0
5190, 1, 1636421913081, 1636421913353, 272, 1, 271, 1, 0, 1
5188, 1, 1636421913173, 1636421913445, 272, 1, 271, 0, 0, 0
5191, 1, 1636421913173, 1636421913446, 273, 1, 272, 0, 0, 0
5192, 1, 1636421913217, 1636421913489, 272, 0, 272, 0, 0, 0
5193, 1, 1636421913241, 1636421913509, 268, 0, 268, 0, 0, 0
5194, 1, 1636421913445, 1636421913710, 265, 1, 264, 0, 0, 0
5195, 1, 1636421913489, 1636421913753, 264, 1, 263, 0, 0, 0
5196, 1, 1636421913577, 1636421913849, 272, 1, 271, 1, 0, 1
5197, 1, 1636421913649, 1636421913917, 268, 1, 267, 1, 0, 1
5198, 1, 1636421913757, 1636421914022, 265, 0, 265, 0, 0, 0
5199, 1, 1636421913841, 1636421914113, 272, 0, 272, 0, 0, 0
5200, 1, 1636421913845, 1636421914113, 268, 0, 268, 0, 0, 0
5201, 1, 1636421913893, 1636421914157, 264, 1, 263, 0, 0, 0
5202, 1, 1636421913910, 1636421914181, 271, 0, 271, 0, 0, 0
5203, 1, 1636421914109, 1636421914381, 272, 1, 271, 0, 0, 0
5204, 1, 1636421914153, 1636421914422, 269, 1, 268, 0, 0, 0
5205, 1, 1636421914249, 1636421914517, 268, 1, 267, 0, 0, 0
5206, 1, 1636421914317, 1636421914586, 269, 0, 269, 0, 0, 0
5207, 1, 1636421914422, 1636421914686, 264, 0, 264, 0, 0, 0
5209, 1, 1636421914514, 1636421914778, 264, 0, 264, 0, 0, 0
5210, 1, 1636421914557, 1636421914825, 268, 1, 267, 0, 0, 0
5211, 1, 1636421914573, 1636421914837, 264, 1, 263, 1, 0, 1
5212, 1, 1636421914777, 1636421915041, 264, 1, 263, 0, 0, 0
5213, 1, 1636421914821, 1636421915093, 272, 1, 271, 0, 1, 1
5214, 1, 1636421914926, 1636421915193, 267, 0, 267, 0, 0, 0
5216, 1, 1636421915086, 1636421915353, 267, 0, 267, 0, 0, 0
5217, 1, 1636421915181, 1636421915449, 268, 0, 268, 0, 0, 0
5218, 1, 1636421915225, 1636421915493, 268, 1, 267, 0, 0, 0
5219, 1, 1636421915246, 1636421915514, 268, 0, 268, 0, 0, 0
5220, 1, 1636421915446, 1636421915717, 271, 0, 271, 0, 0, 0
5221, 1, 1636421915493, 1636421915758, 265, 1, 264, 1, 0, 1
5222, 1, 1636421915597, 1636421915865, 268, 1, 267, 0, 0, 0
5223, 1, 1636421915749, 1636421916017, 268, 1, 267, 0, 0, 0
5225, 1, 1636421915897, 1636421916165, 268, 0, 268, 0, 0, 0
5226, 1, 1636421915909, 1636421916177, 268, 1, 267, 0, 0, 0
5227, 1, 1636421916117, 1636421916389, 272, 1, 271, 0, 1, 1
5229, 1, 1636421916265, 1636421916534, 269, 1, 268, 0, 0, 0
5230, 1, 1636421916417, 1636421916686, 269, 0, 269, 0, 0, 0
5231, 1, 1636421916566, 1636421916837, 271, 0, 271, 0, 0, 0
5232, 1, 1636421916581, 1636421916845, 264, 1, 263, 0, 0, 0
5233, 1, 1636421916785, 1636421917050, 265, 0, 265, 0, 0, 0
5234, 1, 1636421916973, 1636421917241, 268, 1, 267, 1, 0, 1
5235, 1, 1636421917089, 1636421917357, 268, 1, 267, 0, 1, 1
5236, 1, 1636421917105, 1636421917369, 264, 1, 263, 1, 0, 1
5238, 1, 1636421917373, 1636421917650, 277, 1, 276, 0, 1, 1
5239, 1, 1636421917449, 1636421917722, 273, 1, 272, 0, 0, 0
5240, 1, 1636421917670, 1636421917937, 267, 0, 267, 0, 0, 0
5242, 1, 1636421917765, 1636421918034, 269, 1, 268, 0, 1, 1
5243, 1, 1636421917798, 1636421918066, 268, 0, 268, 0, 0, 0
5244, 1, 1636421918041, 1636421918310, 269, 1, 268, 0, 1, 1
5246, 1, 1636421918337, 1636421918638, 301, 1, 300, 0, 0, 0
5130, 2, 1636421908641, 1636421918689, 10048, 0, 10048, 0, 0, 0
5248, 1, 1636421918461, 1636421918822, 361, 1, 360, 0, 0, 0
5247, 1, 1636421918461, 1636421918822, 361, 1, 360, 0, 0, 0
5157, 1, 1636421918738, 1636421919010, 272, 0, 272, 0, 0, 0
5250, 1, 1636421918833, 1636421919106, 273, 0, 273, 0, 0, 0
5152, 1, 1636421919010, 1636421919277, 267, 0, 267, 0, 0, 0
5251, 1, 1636421919105, 1636421919373, 268, 1, 267, 0, 0, 0
5254, 1, 1636421919229, 1636421919497, 268, 1, 267, 0, 0, 0
5253, 1, 1636421919229, 1636421919497, 268, 0, 268, 0, 0, 0
5257, 1, 1636421919450, 1636421919717, 267, 0, 267, 0, 0, 0
5258, 1, 1636421919509, 1636421919777, 268, 1, 267, 0, 0, 0
5260, 1, 1636421919777, 1636421920046, 269, 1, 268, 0, 0, 0
5261, 1, 1636421919902, 1636421920169, 267, 0, 267, 0, 0, 0
5262, 1, 1636421919902, 1636421920169, 267, 0, 267, 0, 0, 0
5263, 1, 1636421920117, 1636421920430, 313, 1, 312, 0, 1, 1
5264, 1, 1636421920178, 1636421920445, 267, 0, 267, 0, 0, 0
5267, 1, 1636421920570, 1636421920838, 268, 0, 268, 0, 0, 0
5266, 1, 1636421920570, 1636421920838, 268, 0, 268, 0, 0, 0
5268, 1, 1636421920694, 1636421920962, 268, 0, 268, 0, 0, 0
5269, 1, 1636421920825, 1636421921093, 268, 0, 268, 0, 0, 0
5270, 1, 1636421920841, 1636421921109, 268, 0, 268, 0, 0, 0
5272, 1, 1636421921237, 1636421921506, 269, 0, 269, 0, 0, 0
5271, 1, 1636421921237, 1636421921506, 269, 1, 268, 0, 1, 1
5274, 1, 1636421921498, 1636421921761, 263, 0, 263, 0, 0, 0
5275, 1, 1636421921513, 1636421921781, 268, 0, 268, 0, 0, 0
5276, 1, 1636421921917, 1636421922185, 268, 1, 267, 1, 0, 1
5277, 1, 1636421921917, 1636421922189, 272, 1, 271, 0, 1, 1
5278, 1, 1636421922133, 1636421922402, 269, 1, 268, 0, 0, 0
5280, 1, 1636421922193, 1636421922461, 268, 1, 267, 0, 0, 0
5279, 1, 1636421922193, 1636421922462, 269, 1, 268, 0, 0, 0
5281, 1, 1636421922549, 1636421922817, 268, 0, 268, 0, 0, 0
5282, 1, 1636421922585, 1636421922854, 269, 1, 268, 0, 0, 0
5283, 1, 1636421922593, 1636421922858, 265, 1, 264, 0, 0, 0
5285, 1, 1636421922869, 1636421923141, 272, 1, 271, 0, 0, 0
5286, 1, 1636421922869, 1636421923141, 272, 1, 271, 1, 0, 1
5288, 1, 1636421923254, 1636421923522, 268, 0, 268, 0, 0, 0
5289, 1, 1636421923258, 1636421923522, 264, 0, 264, 0, 0, 0
5290, 1, 1636421923541, 1636421923809, 268, 1, 267, 0, 0, 0
5291, 1, 1636421923541, 1636421923817, 276, 1, 275, 0, 1, 1
5293, 1, 1636421923922, 1636421924189, 267, 0, 267, 0, 0, 0
5292, 1, 1636421923922, 1636421924193, 271, 0, 271, 0, 0, 0
5294, 1, 1636421924213, 1636421924482, 269, 1, 268, 1, 0, 1
5295, 1, 1636421924222, 1636421924494, 272, 0, 272, 0, 0, 0
5296, 1, 1636421924605, 1636421924874, 269, 1, 268, 0, 0, 0
5297, 1, 1636421924605, 1636421924877, 272, 1, 271, 0, 1, 1
5298, 1, 1636421924825, 1636421925114, 289, 1, 288, 0, 0, 0
5299, 1, 1636421924885, 1636421925153, 268, 1, 267, 0, 1, 1
5300, 1, 1636421924937, 1636421925205, 268, 1, 267, 0, 0, 0
5301, 1, 1636421925274, 1636421925538, 264, 0, 264, 0, 0, 0
5302, 1, 1636421925274, 1636421925538, 264, 0, 264, 0, 0, 0
5303, 1, 1636421925281, 1636421925549, 268, 1, 267, 0, 0, 0
5305, 1, 1636421925553, 1636421925821, 268, 0, 268, 0, 0, 0
5306, 1, 1636421925605, 1636421925894, 289, 1, 288, 0, 1, 1
5308, 1, 1636421925945, 1636421926213, 268, 1, 267, 0, 1, 1
5307, 1, 1636421925945, 1636421926213, 268, 1, 267, 1, 0, 1
5310, 1, 1636421926158, 1636421926429, 271, 0, 271, 0, 0, 0
5311, 1, 1636421926249, 1636421926517, 268, 1, 267, 0, 0, 0
5312, 1, 1636421926293, 1636421926565, 272, 1, 271, 0, 0, 0
5313, 1, 1636421926469, 1636421926738, 269, 1, 268, 0, 0, 0
5314, 1, 1636421926613, 1636421926878, 265, 1, 264, 0, 0, 0
5315, 1, 1636421926609, 1636421926878, 269, 1, 268, 0, 0, 0
5317, 1, 1636421926917, 1636421927182, 265, 1, 264, 0, 1, 1
5318, 1, 1636421926965, 1636421927229, 264, 1, 263, 0, 0, 0
5320, 1, 1636421927282, 1636421927549, 267, 0, 267, 0, 0, 0
5321, 1, 1636421927282, 1636421927549, 267, 0, 267, 0, 0, 0
5322, 1, 1636421927545, 1636421927814, 269, 1, 268, 0, 0, 0
5323, 1, 1636421927585, 1636421927890, 305, 1, 304, 0, 0, 0
5324, 1, 1636421927633, 1636421927897, 264, 1, 263, 0, 0, 0
5326, 1, 1636421927945, 1636421928258, 313, 1, 312, 0, 0, 0
5325, 1, 1636421927953, 1636421928258, 305, 1, 304, 0, 0, 0
5327, 1, 1636421928081, 1636421928349, 268, 1, 267, 0, 0, 0
5330, 1, 1636421928301, 1636421928565, 264, 0, 264, 0, 0, 0
5329, 1, 1636421928301, 1636421928565, 264, 0, 264, 0, 0, 0
5331, 1, 1636421928441, 1636421928705, 264, 1, 263, 0, 0, 0
5332, 1, 1636421928669, 1636421928937, 268, 1, 267, 1, 0, 1
5333, 1, 1636421928669, 1636421928937, 268, 1, 267, 1, 0, 1
5336, 1, 1636421928969, 1636421929238, 269, 1, 268, 0, 0, 0
5335, 1, 1636421928969, 1636421929238, 269, 1, 268, 0, 0, 0
5337, 1, 1636421929045, 1636421929314, 269, 1, 268, 0, 0, 0
5339, 1, 1636421929365, 1636421929637, 272, 1, 271, 1, 0, 1
5340, 1, 1636421929365, 1636421929638, 273, 1, 272, 0, 0, 0
5343, 1, 1636421929633, 1636421929905, 272, 1, 271, 0, 1, 1
5342, 1, 1636421929637, 1636421929905, 268, 1, 267, 0, 0, 0
5344, 1, 1636421929669, 1636421929942, 273, 0, 273, 0, 0, 0
5348, 1, 1636421930037, 1636421930306, 269, 1, 268, 0, 1, 1
5349, 1, 1636421930037, 1636421930306, 269, 1, 268, 0, 0, 0
5351, 1, 1636421930305, 1636421930605, 300, 1, 299, 0, 0, 0
5350, 1, 1636421930305, 1636421930610, 305, 1, 304, 0, 0, 0
5352, 1, 1636421930345, 1636421930617, 272, 0, 272, 0, 0, 0
5353, 1, 1636421930705, 1636421930973, 268, 1, 267, 0, 0, 0
5355, 1, 1636421930782, 1636421931050, 268, 0, 268, 0, 0, 0
5356, 1, 1636421931005, 1636421931273, 268, 0, 268, 0, 0, 0
5357, 1, 1636421931009, 1636421931277, 268, 0, 268, 0, 0, 0
5358, 1, 1636421931013, 1636421931281, 268, 0, 268, 0, 0, 0
5362, 1, 1636421931674, 1636421931942, 268, 0, 268, 0, 0, 0
5364, 1, 1636421931678, 1636421931950, 272, 0, 272, 0, 0, 0
5363, 1, 1636421931678, 1636421931950, 272, 0, 272, 0, 0, 0
5365, 1, 1636421932342, 1636421932613, 271, 0, 271, 0, 0, 0
5367, 1, 1636421932358, 1636421932626, 268, 0, 268, 0, 0, 0
5369, 1, 1636421933022, 1636421933290, 268, 0, 268, 0, 0, 0
5372, 1, 1636421933690, 1636421933962, 272, 0, 272, 0, 0, 0
5373, 1, 1636421934366, 1636421934633, 267, 0, 267, 0, 0, 0
5374, 1, 1636421935034, 1636421935306, 272, 0, 272, 0, 0, 0
5375, 1, 1636421935706, 1636421935990, 284, 0, 284, 0, 0, 0
5378, 1, 1636421936390, 1636421936662, 272, 0, 272, 0, 0, 0
5379, 1, 1636421937093, 1636421937366, 273, 1, 272, 1, 0, 1
5382, 1, 1636421937765, 1636421938038, 273, 1, 272, 0, 0, 0
5383, 1, 1636421938434, 1636421938706, 272, 0, 272, 0, 0, 0
5386, 1, 1636421939105, 1636421939381, 276, 1, 275, 1, 0, 1
5388, 1, 1636421939725, 1636421940029, 304, 1, 303, 1, 0, 1
5389, 1, 1636421939818, 1636421940117, 299, 0, 299, 0, 0, 0
5392, 1, 1636421940290, 1636421940562, 272, 0, 272, 0, 0, 0
5393, 1, 1636421940433, 1636421940750, 317, 1, 316, 0, 0, 0
5394, 1, 1636421940521, 1636421940790, 269, 0, 269, 0, 0, 0
5391, 1, 1636421940565, 1636421940837, 272, 0, 272, 0, 0, 0
5395, 1, 1636421940962, 1636421941230, 268, 0, 268, 0, 0, 0
5396, 1, 1636421941013, 1636421941285, 272, 0, 272, 0, 0, 0
5397, 1, 1636421941150, 1636421941490, 340, 0, 340, 0, 0, 0
5398, 1, 1636421941186, 1636421941490, 304, 0, 304, 0, 0, 0
5399, 1, 1636421941241, 1636421941581, 340, 1, 339, 1, 0, 1
5400, 1, 1636421941625, 1636421941893, 268, 1, 267, 0, 0, 0
5402, 1, 1636421941753, 1636421942021, 268, 1, 267, 0, 1, 1
5405, 1, 1636421941889, 1636421942158, 269, 1, 268, 0, 1, 1
5404, 1, 1636421941889, 1636421942158, 269, 1, 268, 0, 0, 0
5407, 1, 1636421941973, 1636421942242, 269, 1, 268, 0, 0, 0
5406, 1, 1636421941973, 1636421942242, 269, 0, 269, 0, 0, 0
5408, 1, 1636421942305, 1636421942573, 268, 1, 267, 0, 0, 0
5410, 1, 1636421942566, 1636421942834, 268, 1, 267, 0, 1, 1
5411, 1, 1636421942566, 1636421942834, 268, 0, 268, 0, 0, 0
5413, 1, 1636421942641, 1636421942910, 269, 1, 268, 1, 0, 1
5412, 1, 1636421942641, 1636421942910, 269, 1, 268, 0, 0, 0
5414, 1, 1636421942661, 1636421942925, 264, 0, 264, 0, 0, 0
5415, 1, 1636421942977, 1636421943245, 268, 1, 267, 0, 1, 1
5417, 1, 1636421943233, 1636421943506, 273, 0, 273, 0, 0, 0
5419, 1, 1636421943309, 1636421943578, 269, 1, 268, 0, 0, 0
5418, 1, 1636421943309, 1636421943578, 269, 1, 268, 0, 0, 0
5420, 1, 1636421943325, 1636421943597, 272, 0, 272, 0, 0, 0
5422, 1, 1636421943409, 1636421943677, 268, 1, 267, 0, 0, 0
5423, 1, 1636421943645, 1636421943913, 268, 1, 267, 0, 0, 0
5424, 1, 1636421943837, 1636421944105, 268, 0, 268, 0, 0, 0
5425, 1, 1636421943905, 1636421944178, 273, 1, 272, 0, 1, 1
5427, 1, 1636421943981, 1636421944250, 269, 0, 269, 0, 0, 0
5426, 1, 1636421943981, 1636421944250, 269, 0, 269, 0, 0, 0
5429, 1, 1636421944081, 1636421944354, 273, 1, 272, 0, 0, 0
5430, 1, 1636421944309, 1636421944578, 269, 1, 268, 1, 0, 1
5431, 1, 1636421944513, 1636421944786, 273, 1, 272, 0, 0, 0
5432, 1, 1636421944577, 1636421944841, 264, 1, 263, 0, 0, 0
5434, 1, 1636421944650, 1636421944918, 268, 0, 268, 0, 0, 0
5433, 1, 1636421944650, 1636421944918, 268, 0, 268, 0, 0, 0
5435, 1, 1636421944753, 1636421945025, 272, 0, 272, 0, 0, 0
5436, 1, 1636421944977, 1636421945246, 269, 1, 268, 0, 0, 0
5437, 1, 1636421945190, 1636421945458, 268, 0, 268, 0, 0, 0
5438, 1, 1636421945249, 1636421945517, 268, 1, 267, 0, 1, 1
5440, 1, 1636421945321, 1636421945590, 269, 1, 268, 1, 0, 1
5439, 1, 1636421945321, 1636421945590, 269, 1, 268, 0, 0, 0
5441, 1, 1636421945425, 1636421945693, 268, 1, 267, 1, 0, 1
5442, 1, 1636421945645, 1636421945965, 320, 1, 319, 1, 0, 1
5443, 1, 1636421945874, 1636421946145, 271, 0, 271, 0, 0, 0
5444, 1, 1636421945925, 1636421946189, 264, 1, 263, 0, 0, 0
5445, 1, 1636421946005, 1636421946294, 289, 0, 289, 0, 0, 0
5446, 1, 1636421946001, 1636421946294, 293, 0, 293, 0, 0, 0
5447, 1, 1636421946093, 1636421946385, 292, 1, 291, 0, 0, 0
5448, 1, 1636421946134, 1636421946405, 271, 0, 271, 0, 0, 0
5449, 1, 1636421946361, 1636421946633, 272, 1, 271, 0, 0, 0
5450, 1, 1636421946549, 1636421946822, 273, 1, 272, 0, 1, 1
5451, 1, 1636421946553, 1636421946822, 269, 0, 269, 0, 0, 0
5452, 1, 1636421946589, 1636421946854, 265, 1, 264, 1, 0, 1
5454, 1, 1636421946693, 1636421946961, 268, 1, 267, 0, 0, 0
5453, 1, 1636421946693, 1636421946965, 272, 1, 271, 0, 0, 0
5455, 1, 1636421946785, 1636421947049, 264, 1, 263, 0, 0, 0
5456, 1, 1636421946805, 1636421947078, 273, 1, 272, 0, 0, 0
5457, 1, 1636421947033, 1636421947301, 268, 0, 268, 0, 0, 0
5459, 1, 1636421947226, 1636421947493, 267, 0, 267, 0, 0, 0
5458, 1, 1636421947226, 1636421947493, 267, 0, 267, 0, 0, 0
5460, 1, 1636421947258, 1636421947522, 264, 0, 264, 0, 0, 0
5461, 1, 1636421947401, 1636421947678, 277, 1, 276, 0, 0, 0
5462, 1, 1636421947401, 1636421947678, 277, 1, 276, 0, 0, 0
5463, 1, 1636421947438, 1636421947710, 272, 0, 272, 0, 0, 0
5464, 1, 1636421947489, 1636421947761, 272, 1, 271, 1, 0, 1
5465, 1, 1636421947489, 1636421947762, 273, 1, 272, 0, 0, 0
5466, 1, 1636421947706, 1636421947969, 263, 0, 263, 0, 0, 0
5467, 1, 1636421947765, 1636421948037, 272, 0, 272, 0, 0, 0
5468, 1, 1636421947897, 1636421948169, 272, 1, 271, 1, 0, 1
5469, 1, 1636421947901, 1636421948173, 272, 0, 272, 0, 0, 0
5470, 1, 1636421947926, 1636421948193, 267, 0, 267, 0, 0, 0
5471, 1, 1636421948077, 1636421948345, 268, 1, 267, 0, 1, 1
5472, 1, 1636421948085, 1636421948353, 268, 0, 268, 0, 0, 0
5473, 1, 1636421948114, 1636421948382, 268, 0, 268, 0, 0, 0
5475, 1, 1636421948165, 1636421948433, 268, 1, 267, 1, 0, 1
5474, 1, 1636421948165, 1636421948441, 276, 1, 275, 0, 0, 0
5476, 1, 1636421948369, 1636421948661, 292, 0, 292, 0, 0, 0
5477, 1, 1636421948433, 1636421948698, 265, 1, 264, 0, 1, 1
5479, 1, 1636421948577, 1636421948845, 268, 1, 267, 0, 1, 1
5478, 1, 1636421948577, 1636421948845, 268, 1, 267, 0, 1, 1
5480, 1, 1636421948625, 1636421948893, 268, 1, 267, 0, 0, 0
5481, 1, 1636421948745, 1636421949013, 268, 0, 268, 0, 0, 0
5482, 1, 1636421948761, 1636421949029, 268, 1, 267, 0, 1, 1
5483, 1, 1636421948782, 1636421949049, 267, 0, 267, 0, 0, 0
5485, 1, 1636421948837, 1636421949114, 277, 0, 277, 0, 0, 0
5484, 1, 1636421948833, 1636421949114, 281, 1, 280, 0, 0, 0
5486, 1, 1636421948841, 1636421949114, 273, 0, 273, 0, 0, 0
5487, 1, 1636421949057, 1636421949329, 272, 1, 271, 0, 1, 1
5488, 1, 1636421949117, 1636421949385, 268, 0, 268, 0, 0, 0
5490, 1, 1636421949253, 1636421949521, 268, 1, 267, 0, 1, 1
5489, 1, 1636421949249, 1636421949522, 273, 1, 272, 1, 0, 1
5491, 1, 1636421949301, 1636421949581, 280, 0, 280, 0, 0, 0
5492, 1, 1636421949401, 1636421949669, 268, 1, 267, 0, 0, 0
5493, 1, 1636421949413, 1636421949677, 264, 1, 263, 1, 0, 1
5494, 1, 1636421949437, 1636421949705, 268, 1, 267, 0, 1, 1
5495, 1, 1636421949493, 1636421949757, 264, 0, 264, 0, 0, 0
5498, 1, 1636421949538, 1636421949801, 263, 0, 263, 0, 0, 0
5497, 1, 1636421949538, 1636421949809, 271, 1, 270, 0, 1, 1
5496, 1, 1636421949538, 1636421949809, 271, 1, 270, 0, 1, 1
5499, 1, 1636421949733, 1636421950001, 268, 1, 267, 0, 0, 0
5500, 1, 1636421949745, 1636421950013, 268, 1, 267, 0, 1, 1
5501, 1, 1636421949785, 1636421950077, 292, 0, 292, 0, 0, 0
5503, 1, 1636421949917, 1636421950185, 268, 1, 267, 0, 0, 0
5502, 1, 1636421949925, 1636421950198, 273, 0, 273, 0, 0, 0
5504, 1, 1636421949989, 1636421950261, 272, 0, 272, 0, 0, 0
5505, 1, 1636421950085, 1636421950349, 264, 1, 263, 1, 0, 1
5506, 1, 1636421950085, 1636421950349, 264, 1, 263, 0, 0, 0
5507, 1, 1636421950129, 1636421950393, 264, 1, 263, 0, 1, 1
5508, 1, 1636421950157, 1636421950425, 268, 1, 267, 0, 0, 0
5509, 1, 1636421950209, 1636421950474, 265, 1, 264, 0, 0, 0
5510, 1, 1636421950217, 1636421950481, 264, 1, 263, 1, 0, 1
5511, 1, 1636421950217, 1636421950485, 268, 1, 267, 1, 0, 1
5512, 1, 1636421950329, 1636421950594, 265, 1, 264, 0, 1, 1
5513, 1, 1636421950397, 1636421950665, 268, 0, 268, 0, 0, 0
5514, 1, 1636421950413, 1636421950682, 269, 0, 269, 0, 0, 0
5515, 1, 1636421950473, 1636421950741, 268, 1, 267, 0, 0, 0
5516, 1, 1636421950585, 1636421950853, 268, 1, 267, 0, 0, 0
5517, 1, 1636421950593, 1636421950861, 268, 1, 267, 0, 0, 0
5518, 1, 1636421950661, 1636421950925, 264, 1, 263, 0, 0, 0
5519, 1, 1636421950749, 1636421951017, 268, 1, 267, 1, 0, 1
5520, 1, 1636421950749, 1636421951017, 268, 1, 267, 0, 1, 1
5521, 1, 1636421950793, 1636421951062, 269, 0, 269, 0, 0, 0
5522, 1, 1636421950829, 1636421951097, 268, 0, 268, 0, 0, 0
5523, 1, 1636421950873, 1636421951142, 269, 1, 268, 0, 1, 1
5524, 1, 1636421950889, 1636421951157, 268, 1, 267, 0, 0, 0
5525, 1, 1636421950889, 1636421951161, 272, 1, 271, 0, 0, 0
5526, 1, 1636421950989, 1636421951253, 264, 1, 263, 0, 1, 1
5527, 1, 1636421951073, 1636421951345, 272, 1, 271, 0, 1, 1
5528, 1, 1636421951081, 1636421951353, 272, 1, 271, 0, 0, 0
5529, 1, 1636421951141, 1636421951405, 264, 1, 263, 0, 0, 0
5530, 1, 1636421951253, 1636421951529, 276, 1, 275, 0, 1, 1
5531, 1, 1636421951261, 1636421951530, 269, 1, 268, 1, 0, 1
5532, 1, 1636421951333, 1636421951609, 276, 0, 276, 0, 0, 0
5533, 1, 1636421951417, 1636421951685, 268, 0, 268, 0, 0, 0
5534, 1, 1636421951421, 1636421951689, 268, 0, 268, 0, 0, 0
5535, 1, 1636421951469, 1636421951809, 340, 1, 339, 1, 0, 1
5536, 1, 1636421951497, 1636421951810, 313, 0, 313, 0, 0, 0
5538, 1, 1636421951553, 1636421951897, 344, 1, 343, 0, 1, 1
5539, 1, 1636421951561, 1636421951901, 340, 0, 340, 0, 0, 0
5537, 1, 1636421951542, 1636421951901, 359, 0, 359, 0, 0, 0
5540, 1, 1636421951721, 1636421951989, 268, 0, 268, 0, 0, 0
5542, 1, 1636421951809, 1636421952077, 268, 1, 267, 0, 0, 0
5541, 1, 1636421951809, 1636421952077, 268, 1, 267, 0, 0, 0
5543, 1, 1636421951813, 1636421952081, 268, 0, 268, 0, 0, 0
5544, 1, 1636421951941, 1636421952210, 269, 1, 268, 1, 0, 1
5545, 1, 1636421951937, 1636421952213, 276, 1, 275, 0, 1, 1
5546, 1, 1636421952005, 1636421952273, 268, 0, 268, 0, 0, 0
5548, 1, 1636421952066, 1636421952334, 268, 0, 268, 0, 0, 0
5549, 1, 1636421952081, 1636421952353, 272, 0, 272, 0, 0, 0
5550, 1, 1636421952089, 1636421952361, 272, 1, 271, 0, 0, 0
5551, 1, 1636421952209, 1636421952485, 276, 1, 275, 0, 0, 0
5552, 1, 1636421952209, 1636421952489, 280, 1, 279, 0, 0, 0
5553, 1, 1636421952305, 1636421952586, 281, 1, 280, 1, 0, 1
5555, 1, 1636421952305, 1636421952586, 281, 1, 280, 0, 0, 0
5554, 1, 1636421952305, 1636421952586, 281, 1, 280, 1, 0, 1
5556, 1, 1636421952393, 1636421952673, 280, 0, 280, 0, 0, 0
5558, 1, 1636421952493, 1636421952761, 268, 0, 268, 0, 0, 0
5557, 1, 1636421952478, 1636421952762, 284, 0, 284, 0, 0, 0
5559, 1, 1636421952478, 1636421952762, 284, 0, 284, 0, 0, 0
5561, 1, 1636421952629, 1636421952893, 264, 0, 264, 0, 0, 0
5560, 1, 1636421952629, 1636421952894, 265, 1, 264, 0, 0, 0
5562, 1, 1636421952677, 1636421952937, 260, 0, 260, 0, 0, 0
5563, 1, 1636421952729, 1636421952997, 268, 0, 268, 0, 0, 0
5566, 1, 1636421952765, 1636421953033, 268, 0, 268, 0, 0, 0
5565, 1, 1636421952761, 1636421953041, 280, 1, 279, 0, 0, 0
5568, 1, 1636421952897, 1636421953161, 264, 0, 264, 0, 0, 0
5567, 1, 1636421952893, 1636421953161, 268, 1, 267, 0, 1, 1
5571, 1, 1636421952981, 1636421953274, 293, 1, 292, 0, 0, 0
5569, 1, 1636421952981, 1636421953274, 293, 1, 292, 0, 0, 0
5570, 1, 1636421952981, 1636421953274, 293, 1, 292, 0, 1, 1
5572, 1, 1636421953069, 1636421953373, 304, 1, 303, 0, 0, 0
5573, 1, 1636421953185, 1636421953457, 272, 1, 271, 0, 1, 1
5574, 1, 1636421953189, 1636421953457, 268, 1, 267, 1, 0, 1
5575, 1, 1636421953189, 1636421953461, 272, 1, 271, 0, 1, 1
5576, 1, 1636421953317, 1636421953585, 268, 0, 268, 0, 0, 0
5577, 1, 1636421953325, 1636421953597, 272, 0, 272, 0, 0, 0
5579, 1, 1636421953417, 1636421953681, 264, 0, 264, 0, 0, 0
5581, 1, 1636421953441, 1636421953709, 268, 1, 267, 1, 0, 1
5580, 1, 1636421953465, 1636421953733, 268, 1, 267, 0, 1, 1
5582, 1, 1636421953541, 1636421953805, 264, 1, 263, 0, 0, 0
5583, 1, 1636421953561, 1636421953829, 268, 1, 267, 1, 0, 1
5584, 1, 1636421953561, 1636421953829, 268, 1, 267, 1, 0, 1
5586, 1, 1636421953681, 1636421953950, 269, 1, 268, 0, 0, 0
5588, 1, 1636421953681, 1636421953957, 276, 2, 274, 0, 1, 1
5587, 1, 1636421953681, 1636421953957, 276, 2, 274, 0, 1, 1
5589, 1, 1636421953765, 1636421954045, 280, 0, 280, 0, 0, 0
5591, 1, 1636421953861, 1636421954129, 268, 1, 267, 0, 0, 0
5590, 1, 1636421953861, 1636421954130, 269, 1, 268, 1, 0, 1
5593, 1, 1636421953986, 1636421954253, 267, 0, 267, 0, 0, 0
5594, 1, 1636421953993, 1636421954265, 272, 0, 272, 0, 0, 0
5595, 1, 1636421954093, 1636421954365, 272, 0, 272, 0, 0, 0
5596, 1, 1636421954109, 1636421954377, 268, 1, 267, 1, 0, 1
5600, 1, 1636421954233, 1636421954501, 268, 1, 267, 1, 0, 1
5599, 1, 1636421954233, 1636421954501, 268, 1, 267, 1, 0, 1
5604, 1, 1636421954353, 1636421954621, 268, 1, 267, 0, 0, 0
5602, 1, 1636421954345, 1636421954621, 276, 1, 275, 1, 0, 1
5603, 1, 1636421954353, 1636421954625, 272, 1, 271, 0, 0, 0
5605, 1, 1636421954441, 1636421954709, 268, 1, 267, 0, 0, 0
5607, 1, 1636421954529, 1636421954797, 268, 1, 267, 0, 0, 0
5606, 1, 1636421954529, 1636421954797, 268, 1, 267, 1, 0, 1
5608, 1, 1636421954649, 1636421954913, 264, 0, 264, 0, 0, 0
5609, 1, 1636421954677, 1636421954950, 273, 1, 272, 0, 0, 0
5610, 1, 1636421954769, 1636421955037, 268, 1, 267, 0, 0, 0
5611, 1, 1636421954777, 1636421955045, 268, 0, 268, 0, 0, 0
5613, 1, 1636421954905, 1636421955173, 268, 1, 267, 0, 0, 0
5612, 1, 1636421954905, 1636421955173, 268, 1, 267, 1, 0, 1
5615, 1, 1636421955029, 1636421955305, 276, 0, 276, 0, 0, 0
5614, 1, 1636421955029, 1636421955305, 276, 0, 276, 0, 0, 0
5616, 1, 1636421955029, 1636421955305, 276, 1, 275, 0, 0, 0
5617, 1, 1636421955109, 1636421955374, 265, 0, 265, 0, 0, 0
5618, 1, 1636421955197, 1636421955469, 272, 1, 271, 0, 0, 0
5619, 1, 1636421955197, 1636421955473, 276, 1, 275, 0, 0, 0
5620, 1, 1636421955317, 1636421955585, 268, 0, 268, 0, 0, 0
5621, 1, 1636421955350, 1636421955614, 264, 0, 264, 0, 0, 0
5622, 1, 1636421955437, 1636421955709, 272, 1, 271, 0, 0, 0
5623, 1, 1636421955445, 1636421955713, 268, 0, 268, 0, 0, 0
5625, 1, 1636421955577, 1636421955845, 268, 0, 268, 0, 0, 0
5627, 1, 1636421955706, 1636421955977, 271, 0, 271, 0, 0, 0
5626, 1, 1636421955706, 1636421955978, 272, 1, 271, 0, 1, 1
5628, 1, 1636421955706, 1636421955977, 271, 0, 271, 0, 0, 0
5629, 1, 1636421955777, 1636421956045, 268, 1, 267, 1, 0, 1
5630, 1, 1636421955873, 1636421956141, 268, 1, 267, 0, 0, 0
5631, 1, 1636421955873, 1636421956141, 268, 1, 267, 1, 0, 1
5632, 1, 1636421955981, 1636421956249, 268, 0, 268, 0, 0, 0
5633, 1, 1636421956017, 1636421956285, 268, 0, 268, 0, 0, 0
5635, 1, 1636421956117, 1636421956385, 268, 1, 267, 0, 1, 1
5634, 1, 1636421956117, 1636421956389, 272, 1, 271, 0, 1, 1
5636, 1, 1636421956245, 1636421956513, 268, 0, 268, 0, 0, 0
5638, 1, 1636421956377, 1636421956646, 269, 1, 268, 0, 0, 0
5637, 1, 1636421956377, 1636421956646, 269, 1, 268, 0, 0, 0
5639, 1, 1636421956377, 1636421956646, 269, 1, 268, 1, 0, 1
5640, 1, 1636421956445, 1636421956722, 277, 1, 276, 1, 0, 1
5641, 1, 1636421956541, 1636421956813, 272, 1, 271, 0, 1, 1
5642, 1, 1636421956541, 1636421956817, 276, 1, 275, 1, 0, 1
5643, 1, 1636421956645, 1636421956909, 264, 2, 262, 0, 0, 0
5644, 1, 1636421956681, 1636421956949, 268, 0, 268, 0, 0, 0
5645, 1, 1636421956789, 1636421957057, 268, 1, 267, 0, 0, 0
5646, 1, 1636421956789, 1636421957057, 268, 1, 267, 1, 0, 1
5647, 1, 1636421956913, 1636421957185, 272, 0, 272, 0, 0, 0
5648, 1, 1636421957045, 1636421957314, 269, 0, 269, 0, 0, 0
5650, 1, 1636421957049, 1636421957314, 265, 1, 264, 0, 1, 1
5651, 1, 1636421957117, 1636421957385, 268, 1, 267, 0, 1, 1
5652, 1, 1636421957209, 1636421957477, 268, 1, 267, 0, 0, 0
5653, 1, 1636421957221, 1636421957489, 268, 1, 267, 0, 1, 1
5654, 1, 1636421957317, 1636421957582, 265, 0, 265, 0, 0, 0
5656, 1, 1636421957465, 1636421957733, 268, 1, 267, 1, 0, 1
5657, 1, 1636421957465, 1636421957733, 268, 1, 267, 0, 0, 0
5658, 1, 1636421957581, 1636421957845, 264, 1, 263, 0, 0, 0
5659, 1, 1636421957713, 1636421957981, 268, 1, 267, 0, 1, 1
5660, 1, 1636421957713, 1636421957985, 272, 1, 271, 1, 0, 1
5661, 1, 1636421957789, 1636421958058, 269, 1, 268, 0, 1, 1
5662, 1, 1636421957881, 1636421958149, 268, 1, 267, 0, 0, 0
5663, 1, 1636421957890, 1636421958153, 263, 0, 263, 0, 0, 0
5664, 1, 1636421957985, 1636421958254, 269, 0, 269, 0, 0, 0
5666, 1, 1636421958133, 1636421958397, 264, 1, 263, 0, 0, 0
5665, 1, 1636421958133, 1636421958401, 268, 1, 267, 0, 1, 1
5667, 1, 1636421958254, 1636421958525, 271, 0, 271, 0, 0, 0
5669, 1, 1636421958385, 1636421958653, 268, 1, 267, 1, 0, 1
5668, 1, 1636421958385, 1636421958653, 268, 1, 267, 1, 0, 1
5670, 1, 1636421958453, 1636421958721, 268, 1, 267, 0, 1, 1
5671, 1, 1636421958545, 1636421958817, 272, 1, 271, 0, 1, 1
5672, 1, 1636421958557, 1636421958825, 268, 1, 267, 0, 0, 0
5673, 1, 1636421958657, 1636421958921, 264, 0, 264, 0, 0, 0
5675, 1, 1636421958801, 1636421959069, 268, 0, 268, 0, 0, 0
5674, 1, 1636421958797, 1636421959069, 272, 1, 271, 0, 1, 1
5676, 1, 1636421958921, 1636421959185, 264, 1, 263, 1, 0, 1
5678, 1, 1636421959053, 1636421959322, 269, 1, 268, 0, 0, 0
5677, 1, 1636421959053, 1636421959322, 269, 1, 268, 0, 0, 0
5679, 1, 1636421959122, 1636421959389, 267, 0, 267, 0, 0, 0
5680, 1, 1636421959217, 1636421959489, 272, 0, 272, 0, 0, 0
5681, 1, 1636421959225, 1636421959493, 268, 1, 267, 0, 1, 1
5682, 1, 1636421959322, 1636421959590, 268, 1, 267, 1, 0, 1
5683, 1, 1636421959469, 1636421959742, 273, 1, 272, 1, 0, 1
5684, 1, 1636421959477, 1636421959745, 268, 1, 267, 0, 1, 1
5685, 1, 1636421959589, 1636421959853, 264, 1, 263, 0, 0, 0
5686, 1, 1636421959725, 1636421959997, 272, 1, 271, 1, 0, 1
5688, 1, 1636421959789, 1636421960057, 268, 1, 267, 0, 0, 0
5690, 1, 1636421959897, 1636421960169, 272, 1, 271, 0, 0, 0
5689, 1, 1636421959897, 1636421960170, 273, 1, 272, 0, 0, 0
5692, 1, 1636421960141, 1636421960410, 269, 0, 269, 0, 0, 0
5693, 1, 1636421960145, 1636421960417, 272, 1, 271, 1, 0, 1
5694, 1, 1636421960257, 1636421960529, 272, 1, 271, 1, 0, 1
5695, 1, 1636421960397, 1636421960670, 273, 1, 272, 1, 0, 1
5696, 1, 1636421960462, 1636421960729, 267, 0, 267, 0, 0, 0
5697, 1, 1636421960569, 1636421960838, 269, 1, 268, 0, 0, 0
5698, 1, 1636421960569, 1636421960838, 269, 1, 268, 0, 0, 0
5699, 1, 1636421960809, 1636421961077, 268, 0, 268, 0, 0, 0
5700, 1, 1636421960817, 1636421961089, 272, 1, 271, 0, 1, 1
5702, 1, 1636421961069, 1636421961337, 268, 0, 268, 0, 0, 0
5703, 1, 1636421961125, 1636421961393, 268, 0, 268, 0, 0, 0
5704, 1, 1636421961238, 1636421961506, 268, 0, 268, 0, 0, 0
5706, 1, 1636421961477, 1636421961746, 269, 1, 268, 0, 0, 0
5707, 1, 1636421961493, 1636421961766, 273, 1, 272, 1, 0, 1
5708, 1, 1636421961738, 1636421962006, 268, 0, 268, 0, 0, 0
5709, 1, 1636421961797, 1636421962077, 280, 1, 279, 0, 1, 1
5710, 1, 1636421961906, 1636421962177, 271, 0, 271, 0, 0, 0
5711, 1, 1636421962150, 1636421962417, 267, 0, 267, 0, 0, 0
5712, 1, 1636421962217, 1636421962489, 272, 0, 272, 0, 0, 0
5715, 1, 1636421962478, 1636421962750, 272, 0, 272, 0, 0, 0
5716, 1, 1636421962574, 1636421962842, 268, 0, 268, 0, 0, 0
5718, 1, 1636421962894, 1636421963162, 268, 0, 268, 0, 0, 0
5720, 1, 1636421963146, 1636421963417, 271, 0, 271, 0, 0, 0
5722, 1, 1636421963590, 1636421963858, 268, 0, 268, 0, 0, 0
5723, 1, 1636421963677, 1636421963942, 265, 1, 264, 0, 0, 0
5726, 1, 1636421964181, 1636421964453, 272, 0, 272, 0, 0, 0
5727, 1, 1636421964290, 1636421964558, 268, 0, 268, 0, 0, 0
5729, 1, 1636421964485, 1636421964758, 273, 1, 272, 0, 1, 1
5733, 1, 1636421964958, 1636421965230, 272, 0, 272, 0, 0, 0
5736, 1, 1636421965886, 1636421966153, 267, 0, 267, 0, 0, 0
5738, 1, 1636421967350, 1636421967622, 272, 0, 272, 0, 0, 0
5739, 1, 1636421967662, 1636421967934, 272, 0, 272, 0, 0, 0
5742, 1, 1636421970038, 1636421970306, 268, 0, 268, 0, 0, 0
5743, 1, 1636421970309, 1636421970578, 269, 1, 268, 0, 0, 0
5746, 1, 1636421971234, 1636421971502, 268, 0, 268, 0, 0, 0
5747, 1, 1636421971549, 1636421971822, 273, 1, 272, 0, 1, 1
5750, 1, 1636421972673, 1636421972942, 269, 0, 269, 0, 0, 0
5751, 1, 1636421972717, 1636421972993, 276, 1, 275, 0, 0, 0
5752, 1, 1636421973197, 1636421973462, 265, 1, 264, 0, 0, 0
5753, 1, 1636421973346, 1636421973614, 268, 0, 268, 0, 0, 0
5754, 1, 1636421973417, 1636421973685, 268, 1, 267, 0, 0, 0
5756, 1, 1636421973545, 1636421973858, 313, 1, 312, 0, 0, 0
5758, 1, 1636421974045, 1636421974313, 268, 1, 267, 0, 1, 1
5759, 1, 1636421974085, 1636421974354, 269, 0, 269, 0, 0, 0
5760, 1, 1636421974125, 1636421974438, 313, 1, 312, 1, 0, 1
5762, 1, 1636421974265, 1636421974549, 284, 1, 283, 0, 0, 0
5764, 1, 1636421974714, 1636421974986, 272, 0, 272, 0, 0, 0
5765, 1, 1636421974809, 1636421975073, 264, 1, 263, 0, 1, 1
5768, 1, 1636421974941, 1636421975210, 269, 1, 268, 1, 0, 1
5769, 1, 1636421974953, 1636421975222, 269, 0, 269, 0, 0, 0
5771, 1, 1636421975389, 1636421975658, 269, 0, 269, 0, 0, 0
5773, 1, 1636421975474, 1636421975746, 272, 0, 272, 0, 0, 0
5774, 1, 1636421975621, 1636421975893, 272, 1, 271, 0, 0, 0
5775, 1, 1636421975621, 1636421975893, 272, 1, 271, 0, 0, 0
5776, 1, 1636421975974, 1636421976238, 264, 0, 264, 0, 0, 0
5777, 1, 1636421976058, 1636421976326, 268, 0, 268, 0, 0, 0
5778, 1, 1636421976149, 1636421976417, 268, 1, 267, 0, 0, 0
5780, 1, 1636421976293, 1636421976597, 304, 1, 303, 1, 0, 1
5779, 1, 1636421976297, 1636421976597, 300, 1, 299, 0, 0, 0
5782, 1, 1636421976733, 1636421976998, 265, 1, 264, 0, 0, 0
5783, 1, 1636421976817, 1636421977086, 269, 0, 269, 0, 0, 0
5785, 1, 1636421976998, 1636421977270, 272, 1, 271, 0, 1, 1
5786, 1, 1636421976998, 1636421977270, 272, 0, 272, 0, 0, 0
5787, 1, 1636421977405, 1636421977673, 268, 1, 267, 0, 0, 0
5788, 1, 1636421977490, 1636421977758, 268, 0, 268, 0, 0, 0
5789, 1, 1636421977669, 1636421977941, 272, 1, 271, 0, 0, 0
5790, 1, 1636421977669, 1636421977941, 272, 1, 271, 1, 0, 1
5791, 1, 1636421978113, 1636421978377, 264, 0, 264, 0, 0, 0
5792, 1, 1636421978201, 1636421978466, 265, 0, 265, 0, 0, 0
5795, 1, 1636421978381, 1636421978649, 268, 1, 267, 0, 1, 1
5794, 1, 1636421978381, 1636421978654, 273, 1, 272, 0, 0, 0
5797, 1, 1636421978778, 1636421979046, 268, 0, 268, 0, 0, 0
5798, 1, 1636421978869, 1636421979138, 269, 1, 268, 0, 0, 0
5799, 1, 1636421979045, 1636421979317, 272, 1, 271, 0, 0, 0
5800, 1, 1636421979053, 1636421979330, 277, 0, 277, 0, 0, 0
5801, 1, 1636421979446, 1636421979713, 267, 0, 267, 0, 0, 0
5802, 1, 1636421979537, 1636421979805, 268, 1, 267, 0, 0, 0
5803, 1, 1636421979717, 1636421979985, 268, 0, 268, 0, 0, 0
5804, 1, 1636421979733, 1636421980005, 272, 1, 271, 0, 0, 0
5806, 1, 1636421980205, 1636421980474, 269, 1, 268, 1, 0, 1
5807, 1, 1636421980385, 1636421980653, 268, 1, 267, 1, 0, 1
5808, 1, 1636421980405, 1636421980673, 268, 1, 267, 0, 0, 0
5811, 1, 1636421981066, 1636421981329, 263, 0, 263, 0, 0, 0
5812, 1, 1636421981110, 1636421981377, 267, 0, 267, 0, 0, 0
5815, 1, 1636421981777, 1636421982050, 273, 1, 272, 0, 1, 1
5823, 1, 1636421985126, 1636421985398, 272, 0, 272, 0, 0, 0
5827, 1, 1636421985793, 1636421986062, 269, 1, 268, 0, 1, 1
5828, 1, 1636421986470, 1636421986777, 307, 0, 307, 0, 0, 0
5831, 1, 1636421987174, 1636421987446, 272, 0, 272, 0, 0, 0
5832, 1, 1636421987846, 1636421988118, 272, 0, 272, 0, 0, 0
5833, 1, 1636421988517, 1636421988790, 273, 1, 272, 0, 0, 0
5836, 1, 1636421989190, 1636421989462, 272, 0, 272, 0, 0, 0
5837, 1, 1636421989866, 1636421990161, 295, 0, 295, 0, 0, 0
5839, 1, 1636421990562, 1636421990834, 272, 0, 272, 0, 0, 0
5841, 1, 1636421991230, 1636421991502, 272, 0, 272, 0, 0, 0
5844, 1, 1636421991905, 1636421992173, 268, 1, 267, 1, 0, 1
5853, 1, 1636421995350, 1636421995645, 295, 0, 295, 0, 0, 0
5855, 1, 1636421995813, 1636421996085, 272, 1, 271, 1, 0, 1
5856, 1, 1636421996045, 1636421996313, 268, 0, 268, 0, 0, 0
5857, 1, 1636421996089, 1636421996362, 273, 1, 272, 0, 1, 1
5858, 1, 1636421996481, 1636421996750, 269, 1, 268, 0, 0, 0
5859, 1, 1636421996717, 1636421996997, 280, 0, 280, 0, 0, 0
5860, 1, 1636421996761, 1636421997034, 273, 0, 273, 0, 0, 0
5861, 1, 1636421997149, 1636421997422, 273, 0, 273, 0, 0, 0
5863, 1, 1636421997397, 1636421997666, 269, 1, 268, 0, 0, 0
5864, 1, 1636421997433, 1636421997705, 272, 0, 272, 0, 0, 0
5865, 1, 1636421997478, 1636421997746, 268, 0, 268, 0, 0, 0
5866, 1, 1636421997821, 1636421998090, 269, 1, 268, 0, 0, 0
5867, 1, 1636421998065, 1636421998334, 269, 0, 269, 0, 0, 0
5868, 1, 1636421998109, 1636421998378, 269, 1, 268, 0, 0, 0
5869, 1, 1636421998142, 1636421998414, 272, 0, 272, 0, 0, 0
5870, 1, 1636421998489, 1636421998765, 276, 1, 275, 0, 0, 0
5871, 1, 1636421998745, 1636421999017, 272, 1, 271, 0, 0, 0
5872, 1, 1636421998806, 1636421999082, 276, 0, 276, 0, 0, 0
5873, 1, 1636421998817, 1636421999082, 265, 0, 265, 0, 0, 0
5874, 1, 1636421998930, 1636421999198, 268, 0, 268, 0, 0, 0
5875, 1, 1636421999165, 1636421999437, 272, 1, 271, 0, 0, 0
5876, 1, 1636421999253, 1636421999522, 269, 1, 268, 0, 0, 0
5877, 1, 1636421999422, 1636421999690, 268, 0, 268, 0, 0, 0
5878, 1, 1636421999481, 1636421999745, 264, 1, 263, 1, 0, 1
5879, 1, 1636421999477, 1636421999745, 268, 1, 267, 1, 0, 1
5880, 1, 1636421999598, 1636421999870, 272, 0, 272, 0, 0, 0
5881, 1, 1636421999833, 1636422000106, 273, 1, 272, 0, 1, 1
5882, 1, 1636421999921, 1636422000185, 264, 1, 263, 1, 0, 1
5883, 1, 1636422000089, 1636422000357, 268, 1, 267, 0, 1, 1
5884, 1, 1636422000153, 1636422000469, 316, 1, 315, 1, 0, 1
5885, 1, 1636422000153, 1636422000469, 316, 1, 315, 1, 0, 1
5886, 1, 1636422000269, 1636422000565, 296, 1, 295, 1, 0, 1
5887, 1, 1636422000517, 1636422000781, 264, 0, 264, 0, 0, 0
5888, 1, 1636422000605, 1636422000877, 272, 1, 271, 1, 0, 1
5889, 1, 1636422000733, 1636422001002, 269, 1, 268, 0, 0, 0
5890, 1, 1636422000757, 1636422001026, 269, 1, 268, 0, 0, 0
5891, 1, 1636422000869, 1636422001137, 268, 1, 267, 1, 0, 1
5892, 1, 1636422000869, 1636422001137, 268, 1, 267, 1, 0, 1
5893, 1, 1636422001029, 1636422001334, 305, 1, 304, 1, 0, 1
5895, 1, 1636422001337, 1636422001609, 272, 0, 272, 0, 0, 0
5896, 1, 1636422001421, 1636422001689, 268, 1, 267, 0, 1, 1
5897, 1, 1636422001461, 1636422001753, 292, 1, 291, 0, 0, 0
5899, 1, 1636422001577, 1636422001849, 272, 1, 271, 1, 0, 1
5898, 1, 1636422001577, 1636422001849, 272, 1, 271, 1, 0, 1
5900, 1, 1636422001609, 1636422001881, 272, 1, 271, 1, 0, 1
5901, 1, 1636422001705, 1636422001969, 264, 0, 264, 0, 0, 0
5902, 1, 1636422001733, 1636422002001, 268, 1, 267, 0, 0, 0
5894, 1, 1636422001885, 1636422002169, 284, 0, 284, 0, 0, 0
5903, 1, 1636422001993, 1636422002265, 272, 1, 271, 0, 1, 1
5904, 1, 1636422002013, 1636422002290, 277, 0, 277, 0, 0, 0
5906, 1, 1636422002149, 1636422002421, 272, 1, 271, 0, 0, 0
5907, 1, 1636422002253, 1636422002521, 268, 1, 267, 1, 0, 1
5908, 1, 1636422002253, 1636422002522, 269, 1, 268, 0, 0, 0
5909, 1, 1636422002281, 1636422002553, 272, 1, 271, 0, 0, 0
5911, 1, 1636422002369, 1636422002665, 296, 1, 295, 0, 1, 1
5910, 1, 1636422002349, 1636422002666, 317, 1, 316, 0, 0, 0
5912, 1, 1636422002405, 1636422002750, 345, 1, 344, 0, 0, 0
5913, 1, 1636422002577, 1636422002885, 308, 0, 308, 0, 0, 0
5914, 1, 1636422002669, 1636422002973, 304, 1, 303, 0, 0, 0
5915, 1, 1636422002797, 1636422003065, 268, 1, 267, 1, 0, 1
5917, 1, 1636422002889, 1636422003153, 264, 0, 264, 0, 0, 0
5920, 1, 1636422002933, 1636422003193, 260, 0, 260, 0, 0, 0
5921, 1, 1636422003017, 1636422003289, 272, 1, 271, 1, 0, 1
5922, 1, 1636422003062, 1636422003333, 271, 0, 271, 0, 0, 0
5924, 1, 1636422003109, 1636422003389, 280, 0, 280, 0, 0, 0
5926, 1, 1636422003149, 1636422003421, 272, 0, 272, 0, 0, 0
5925, 1, 1636422003153, 1636422003425, 272, 1, 271, 0, 0, 0
5927, 1, 1636422003289, 1636422003561, 272, 1, 271, 1, 0, 1
5923, 1, 1636422003333, 1636422003597, 264, 1, 263, 1, 0, 1
5929, 1, 1636422003466, 1636422003733, 267, 0, 267, 0, 0, 0
5930, 1, 1636422003553, 1636422003821, 268, 1, 267, 1, 0, 1
5931, 1, 1636422003594, 1636422003862, 268, 0, 268, 0, 0, 0
5928, 1, 1636422003597, 1636422003866, 269, 1, 268, 1, 0, 1
5935, 1, 1636422003821, 1636422004085, 264, 1, 263, 0, 0, 0
5936, 1, 1636422003825, 1636422004093, 268, 0, 268, 0, 0, 0
5934, 1, 1636422003865, 1636422004169, 304, 1, 303, 0, 0, 0
5938, 1, 1636422003994, 1636422004269, 275, 0, 275, 0, 0, 0
5939, 1, 1636422004133, 1636422004405, 272, 0, 272, 0, 0, 0
5940, 1, 1636422004217, 1636422004525, 308, 0, 308, 0, 0, 0
5941, 1, 1636422004261, 1636422004533, 272, 0, 272, 0, 0, 0
5942, 1, 1636422004269, 1636422004537, 268, 0, 268, 0, 0, 0
5943, 1, 1636422004341, 1636422004613, 272, 0, 272, 0, 0, 0
5945, 1, 1636422004529, 1636422004797, 268, 0, 268, 0, 0, 0
5944, 1, 1636422004537, 1636422004805, 268, 1, 267, 1, 0, 1
5947, 1, 1636422004669, 1636422004945, 276, 1, 275, 0, 0, 0
5948, 1, 1636422004790, 1636422005058, 268, 0, 268, 0, 0, 0
5949, 1, 1636422004837, 1636422005105, 268, 0, 268, 0, 0, 0
5952, 1, 1636422004973, 1636422005241, 268, 1, 267, 1, 0, 1
5953, 1, 1636422005061, 1636422005325, 264, 1, 263, 1, 0, 1
5950, 1, 1636422005105, 1636422005378, 273, 1, 272, 1, 0, 1
5956, 1, 1636422005209, 1636422005485, 276, 1, 275, 0, 0, 0
5954, 1, 1636422005185, 1636422005486, 301, 1, 300, 0, 1, 1
5955, 1, 1636422005397, 1636422005665, 268, 1, 267, 1, 0, 1
5957, 1, 1636422005397, 1636422005666, 269, 1, 268, 1, 0, 1
5958, 1, 1636422005489, 1636422005757, 268, 0, 268, 0, 0, 0
5959, 1, 1636422005529, 1636422005801, 272, 0, 272, 0, 0, 0
5960, 1, 1636422005669, 1636422005937, 268, 1, 267, 0, 1, 1
5961, 1, 1636422005729, 1636422005997, 268, 1, 267, 0, 0, 0
5962, 1, 1636422005749, 1636422006021, 272, 1, 271, 0, 0, 0
5963, 1, 1636422005781, 1636422006045, 264, 0, 264, 0, 0, 0
5965, 1, 1636422005889, 1636422006157, 268, 0, 268, 0, 0, 0
5964, 1, 1636422005886, 1636422006157, 271, 0, 271, 0, 0, 0
5966, 1, 1636422006066, 1636422006337, 271, 1, 270, 0, 0, 0
5967, 1, 1636422006066, 1636422006341, 275, 0, 275, 0, 0, 0
5968, 1, 1636422006161, 1636422006429, 268, 0, 268, 0, 0, 0
5969, 1, 1636422006201, 1636422006469, 268, 1, 267, 0, 0, 0
5970, 1, 1636422006345, 1636422006609, 264, 0, 264, 0, 0, 0
5971, 1, 1636422006393, 1636422006661, 268, 0, 268, 0, 0, 0
5972, 1, 1636422006422, 1636422006693, 271, 0, 271, 0, 0, 0
5973, 1, 1636422006449, 1636422006713, 264, 0, 264, 0, 0, 0
5974, 1, 1636422006561, 1636422006826, 265, 1, 264, 1, 0, 1
5976, 1, 1636422006737, 1636422007006, 269, 1, 268, 1, 0, 1
5977, 1, 1636422006737, 1636422007009, 272, 1, 271, 0, 0, 0
5978, 1, 1636422006829, 1636422007106, 277, 1, 276, 0, 0, 0
5980, 1, 1636422007006, 1636422007305, 299, 4, 295, 4, 0, 4
5981, 1, 1636422007065, 1636422007337, 272, 1, 271, 0, 0, 0
5983, 1, 1636422007113, 1636422007393, 280, 0, 280, 0, 0, 0
5982, 1, 1636422007090, 1636422007393, 303, 0, 303, 0, 0, 0
5984, 1, 1636422007225, 1636422007493, 268, 1, 267, 0, 1, 1
5986, 1, 1636422007437, 1636422007709, 272, 1, 271, 0, 0, 0
5985, 1, 1636422007497, 1636422007769, 272, 1, 271, 0, 0, 0
5987, 1, 1636422007506, 1636422007777, 271, 0, 271, 0, 0, 0
5988, 1, 1636422007569, 1636422007837, 268, 1, 267, 0, 1, 1
5990, 1, 1636422007737, 1636422008010, 273, 1, 272, 0, 0, 0
5989, 1, 1636422007773, 1636422008041, 268, 1, 267, 0, 0, 0
5992, 1, 1636422007801, 1636422008069, 268, 0, 268, 0, 0, 0
5993, 1, 1636422007893, 1636422008166, 273, 1, 272, 0, 1, 1
5991, 1, 1636422008045, 1636422008313, 268, 0, 268, 0, 0, 0
5994, 1, 1636422008109, 1636422008377, 268, 0, 268, 0, 0, 0
5995, 1, 1636422008166, 1636422008429, 263, 0, 263, 0, 0, 0
5996, 1, 1636422008177, 1636422008446, 269, 1, 268, 0, 1, 1
5997, 1, 1636422008237, 1636422008505, 268, 0, 268, 0, 0, 0
5998, 1, 1636422008414, 1636422008682, 268, 0, 268, 0, 0, 0
5999, 1, 1636422008437, 1636422008709, 272, 1, 271, 0, 0, 0
6000, 1, 1636422008469, 1636422008737, 268, 1, 267, 1, 0, 1
6001, 1, 1636422008561, 1636422008829, 268, 1, 267, 0, 0, 0
6002, 1, 1636422008709, 1636422008981, 272, 1, 271, 0, 0, 0
6003, 1, 1636422008781, 1636422009049, 268, 1, 267, 0, 0, 0
6004, 1, 1636422008829, 1636422009093, 264, 1, 263, 0, 1, 1
6005, 1, 1636422008841, 1636422009110, 269, 1, 268, 1, 0, 1
6006, 1, 1636422008910, 1636422009177, 267, 0, 267, 0, 0, 0
6007, 1, 1636422009082, 1636422009353, 271, 0, 271, 0, 0, 0
6008, 1, 1636422009101, 1636422009369, 268, 0, 268, 0, 0, 0
6009, 1, 1636422009137, 1636422009406, 269, 0, 269, 0, 0, 0
6010, 1, 1636422009237, 1636422009505, 268, 1, 267, 1, 0, 1
6011, 1, 1636422009381, 1636422009649, 268, 1, 267, 0, 0, 0
6012, 1, 1636422009449, 1636422009721, 272, 1, 271, 0, 0, 0
6014, 1, 1636422009517, 1636422009785, 268, 0, 268, 0, 0, 0
6015, 1, 1636422009581, 1636422009849, 268, 1, 267, 0, 0, 0
6018, 1, 1636422009809, 1636422010077, 268, 0, 268, 0, 0, 0
6016, 1, 1636422009853, 1636422010125, 272, 1, 271, 0, 1, 1
6019, 1, 1636422009901, 1636422010166, 265, 0, 265, 0, 0, 0
6020, 1, 1636422010041, 1636422010309, 268, 1, 267, 0, 0, 0
6021, 1, 1636422010122, 1636422010385, 263, 0, 263, 0, 0, 0
6022, 1, 1636422010189, 1636422010457, 268, 0, 268, 0, 0, 0
6023, 1, 1636422010249, 1636422010518, 269, 1, 268, 1, 0, 1
6025, 1, 1636422010525, 1636422010789, 264, 0, 264, 0, 0, 0
6026, 1, 1636422010569, 1636422010837, 268, 0, 268, 0, 0, 0
6027, 1, 1636422010714, 1636422010982, 268, 0, 268, 0, 0, 0
6029, 1, 1636422010857, 1636422011126, 269, 1, 268, 0, 0, 0
6030, 1, 1636422010913, 1636422011185, 272, 1, 271, 0, 0, 0
6031, 1, 1636422011193, 1636422011462, 269, 1, 268, 1, 0, 1
6032, 1, 1636422011238, 1636422011506, 268, 0, 268, 0, 0, 0
6033, 1, 1636422011377, 1636422011645, 268, 1, 267, 0, 0, 0
6034, 1, 1636422011530, 1636422011797, 267, 0, 267, 0, 0, 0
6035, 1, 1636422011590, 1636422011858, 268, 0, 268, 0, 0, 0
6037, 1, 1636422011905, 1636422012173, 268, 1, 267, 0, 1, 1
6038, 1, 1636422012086, 1636422012362, 276, 0, 276, 0, 0, 0
6040, 1, 1636422012258, 1636422012525, 267, 0, 267, 0, 0, 0
6041, 1, 1636422012437, 1636422012706, 269, 1, 268, 1, 0, 1
6043, 1, 1636422012757, 1636422013110, 353, 1, 352, 0, 1, 1
6044, 1, 1636422013021, 1636422013289, 268, 1, 267, 0, 0, 0
6045, 1, 1636422013157, 1636422013425, 268, 1, 267, 0, 0, 0
6048, 1, 1636422013241, 1636422013513, 272, 1, 271, 1, 0, 1
6046, 1, 1636422013250, 1636422013518, 268, 0, 268, 0, 0, 0
6050, 1, 1636422013697, 1636422014001, 304, 0, 304, 0, 0, 0
6051, 1, 1636422013829, 1636422014093, 264, 1, 263, 0, 1, 1
6052, 1, 1636422013921, 1636422014190, 269, 1, 268, 0, 0, 0
6053, 1, 1636422013921, 1636422014190, 269, 1, 268, 0, 0, 0
6055, 1, 1636422014045, 1636422014317, 272, 0, 272, 0, 0, 0
6057, 1, 1636422014397, 1636422014701, 304, 0, 304, 0, 0, 0
6059, 1, 1636422014617, 1636422014885, 268, 0, 268, 0, 0, 0
6061, 1, 1636422014749, 1636422015017, 268, 1, 267, 0, 0, 0
6062, 1, 1636422014878, 1636422015145, 267, 0, 267, 0, 0, 0
6066, 1, 1636422015417, 1636422015685, 268, 0, 268, 0, 0, 0
6067, 1, 1636422015546, 1636422015817, 271, 0, 271, 0, 0, 0
6069, 1, 1636422016217, 1636422016490, 273, 1, 272, 0, 1, 1
6080, 1, 1636422023594, 1636422023866, 272, 0, 272, 0, 0, 0
6083, 1, 1636422024310, 1636422024578, 268, 0, 268, 0, 0, 0
6082, 1, 1636422024310, 1636422024578, 268, 0, 268, 0, 0, 0
6084, 1, 1636422024589, 1636422024850, 261, 0, 261, 0, 0, 0
6085, 1, 1636422024809, 1636422025085, 276, 1, 275, 0, 0, 0
6086, 1, 1636422024925, 1636422025233, 308, 1, 307, 0, 0, 0
6088, 1, 1636422024977, 1636422025245, 268, 1, 267, 1, 0, 1
6089, 1, 1636422025281, 1636422025553, 272, 0, 272, 0, 0, 0
6091, 1, 1636422025510, 1636422025778, 268, 0, 268, 0, 0, 0
6092, 1, 1636422025589, 1636422025858, 269, 0, 269, 0, 0, 0
6093, 1, 1636422025597, 1636422025866, 269, 0, 269, 0, 0, 0
6094, 1, 1636422025633, 1636422025902, 269, 1, 268, 0, 0, 0
6097, 1, 1636422026181, 1636422026449, 268, 1, 267, 0, 0, 0
6099, 1, 1636422026269, 1636422026537, 268, 1, 267, 0, 0, 0
6098, 1, 1636422026269, 1636422026541, 272, 1, 271, 1, 0, 1
6100, 1, 1636422026297, 1636422026566, 269, 1, 268, 1, 0, 1
6101, 1, 1636422026397, 1636422026666, 269, 1, 268, 0, 0, 0
6102, 1, 1636422026869, 1636422027142, 273, 1, 272, 0, 0, 0
6104, 1, 1636422026958, 1636422027225, 267, 0, 267, 0, 0, 0
6106, 1, 1636422027133, 1636422027406, 273, 1, 272, 0, 0, 0
6107, 1, 1636422027173, 1636422027441, 268, 0, 268, 0, 0, 0
6108, 1, 1636422027225, 1636422027498, 273, 0, 273, 0, 0, 0
6109, 1, 1636422027485, 1636422027758, 273, 1, 272, 0, 0, 0
6110, 1, 1636422027545, 1636422027813, 268, 1, 267, 1, 0, 1
6111, 1, 1636422027625, 1636422027894, 269, 1, 268, 1, 0, 1
6112, 1, 1636422027809, 1636422028082, 273, 1, 272, 1, 0, 1
6113, 1, 1636422027841, 1636422028110, 269, 1, 268, 0, 0, 0
6114, 1, 1636422027897, 1636422028161, 264, 0, 264, 0, 0, 0
6115, 1, 1636422028161, 1636422028430, 269, 1, 268, 0, 0, 0
6116, 1, 1636422028213, 1636422028482, 269, 1, 268, 0, 0, 0
6117, 1, 1636422028293, 1636422028562, 269, 1, 268, 0, 1, 1
6118, 1, 1636422028482, 1636422028750, 268, 0, 268, 0, 0, 0
6120, 1, 1636422028566, 1636422028841, 275, 0, 275, 0, 0, 0
6122, 1, 1636422028885, 1636422029149, 264, 1, 263, 0, 0, 0
6123, 1, 1636422028961, 1636422029229, 268, 1, 267, 0, 1, 1
6124, 1, 1636422029153, 1636422029421, 268, 1, 267, 0, 0, 0
6125, 1, 1636422029241, 1636422029509, 268, 1, 267, 0, 0, 0
6126, 1, 1636422029550, 1636422029814, 264, 0, 264, 0, 0, 0
6127, 1, 1636422029630, 1636422029898, 268, 0, 268, 0, 0, 0
6128, 1, 1636422029869, 1636422030137, 268, 0, 268, 0, 0, 0
6129, 1, 1636422029914, 1636422030209, 295, 0, 295, 0, 0, 0
6130, 1, 1636422030165, 1636422030433, 268, 0, 268, 0, 0, 0
6131, 1, 1636422030253, 1636422030521, 268, 0, 268, 0, 0, 0
6132, 1, 1636422030297, 1636422030562, 265, 1, 264, 0, 0, 0
6133, 1, 1636422030433, 1636422030697, 264, 1, 263, 1, 0, 1
6134, 1, 1636422030533, 1636422030821, 288, 1, 287, 0, 1, 1
6135, 1, 1636422030613, 1636422030910, 297, 1, 296, 0, 0, 0
6136, 1, 1636422030866, 1636422031141, 275, 0, 275, 0, 0, 0
6138, 1, 1636422030965, 1636422031233, 268, 1, 267, 1, 0, 1
6137, 1, 1636422030957, 1636422031233, 276, 1, 275, 0, 0, 0
6139, 1, 1636422031082, 1636422031350, 268, 0, 268, 0, 0, 0
6140, 1, 1636422031145, 1636422031413, 268, 1, 267, 1, 0, 1
6141, 1, 1636422031221, 1636422031485, 264, 0, 264, 0, 0, 0
6142, 1, 1636422031309, 1636422031578, 269, 1, 268, 1, 0, 1
6143, 1, 1636422031401, 1636422031669, 268, 0, 268, 0, 0, 0
6145, 1, 1636422031637, 1636422031910, 273, 1, 272, 0, 0, 0
6146, 1, 1636422031637, 1636422031910, 273, 1, 272, 0, 0, 0
6147, 1, 1636422031749, 1636422032017, 268, 1, 267, 1, 0, 1
6149, 1, 1636422031889, 1636422032153, 264, 1, 263, 1, 0, 1
6150, 1, 1636422031978, 1636422032242, 264, 0, 264, 0, 0, 0
6151, 1, 1636422032069, 1636422032337, 268, 1, 267, 0, 1, 1
6152, 1, 1636422032349, 1636422032657, 308, 1, 307, 1, 0, 1
6155, 1, 1636422032481, 1636422032753, 272, 1, 271, 0, 0, 0
6156, 1, 1636422032569, 1636422032845, 276, 1, 275, 0, 0, 0
6157, 1, 1636422032645, 1636422032926, 281, 1, 280, 0, 0, 0
6159, 1, 1636422032837, 1636422033106, 269, 1, 268, 0, 0, 0
6161, 1, 1636422033157, 1636422033425, 268, 1, 267, 0, 0, 0
6162, 1, 1636422033185, 1636422033461, 276, 1, 275, 0, 0, 0
6163, 1, 1636422033249, 1636422033517, 268, 1, 267, 0, 0, 0
6164, 1, 1636422033322, 1636422033590, 268, 0, 268, 0, 0, 0
6165, 1, 1636422033506, 1636422033769, 263, 0, 263, 0, 0, 0
6167, 1, 1636422033901, 1636422034169, 268, 1, 267, 0, 0, 0
6169, 1, 1636422033993, 1636422034261, 268, 1, 267, 0, 0, 0
6170, 1, 1636422034117, 1636422034389, 272, 0, 272, 0, 0, 0
6174, 1, 1636422034786, 1636422035053, 267, 0, 267, 0, 0, 0
6175, 1, 1636422035286, 1636422035549, 263, 0, 263, 0, 0, 0
6177, 1, 1636422035738, 1636422036005, 267, 0, 267, 0, 0, 0
6178, 1, 1636422035998, 1636422036266, 268, 0, 268, 0, 0, 0
6179, 1, 1636422035998, 1636422036266, 268, 0, 268, 0, 0, 0
6180, 1, 1636422036266, 1636422036533, 267, 1, 266, 1, 0, 1
6181, 1, 1636422036405, 1636422036677, 272, 1, 271, 0, 1, 1
6182, 1, 1636422036665, 1636422036933, 268, 1, 267, 0, 0, 0
6183, 1, 1636422036665, 1636422036933, 268, 1, 267, 0, 0, 0
6184, 1, 1636422036961, 1636422037230, 269, 1, 268, 0, 0, 0
6186, 1, 1636422037269, 1636422037537, 268, 1, 267, 0, 1, 1
6187, 1, 1636422037305, 1636422037569, 264, 1, 263, 0, 0, 0
6189, 1, 1636422037337, 1636422037610, 273, 1, 272, 1, 0, 1
6190, 1, 1636422037625, 1636422037893, 268, 1, 267, 0, 1, 1
6191, 1, 1636422037937, 1636422038206, 269, 1, 268, 0, 0, 0
6192, 1, 1636422037974, 1636422038242, 268, 0, 268, 0, 0, 0
6195, 1, 1636422038605, 1636422038874, 269, 1, 268, 0, 0, 0
6196, 1, 1636422038641, 1636422038910, 269, 0, 269, 0, 0, 0
6197, 1, 1636422038822, 1636422039090, 268, 0, 268, 0, 0, 0
6198, 1, 1636422039142, 1636422039410, 268, 0, 268, 0, 0, 0
6200, 1, 1636422039305, 1636422039578, 273, 1, 272, 0, 0, 0
6201, 1, 1636422039490, 1636422039758, 268, 0, 268, 0, 0, 0
6202, 1, 1636422039810, 1636422040082, 272, 0, 272, 0, 0, 0
6203, 1, 1636422039974, 1636422040242, 268, 0, 268, 0, 0, 0
6204, 1, 1636422040162, 1636422040433, 271, 0, 271, 0, 0, 0
6205, 1, 1636422040481, 1636422040753, 272, 0, 272, 0, 0, 0
6206, 1, 1636422040645, 1636422040914, 269, 1, 268, 0, 0, 0
6209, 1, 1636422041314, 1636422041590, 276, 0, 276, 0, 0, 0
6210, 1, 1636422041858, 1636422042126, 268, 0, 268, 0, 0, 0
6211, 1, 1636422041985, 1636422042254, 269, 1, 268, 0, 0, 0
6212, 1, 1636422042125, 1636422042393, 268, 1, 267, 0, 0, 0
6213, 1, 1636422042525, 1636422042801, 276, 1, 275, 0, 0, 0
6214, 1, 1636422042693, 1636422042958, 265, 1, 264, 0, 0, 0
6215, 1, 1636422042693, 1636422042958, 265, 1, 264, 0, 1, 1
6216, 1, 1636422042726, 1636422042994, 268, 0, 268, 0, 0, 0
6217, 1, 1636422042825, 1636422043105, 280, 1, 279, 0, 1, 1
6218, 1, 1636422043045, 1636422043313, 268, 1, 267, 1, 0, 1
6219, 1, 1636422043237, 1636422043509, 272, 1, 271, 0, 0, 0
6220, 1, 1636422043354, 1636422043626, 272, 0, 272, 0, 0, 0
6221, 1, 1636422043357, 1636422043626, 269, 1, 268, 0, 1, 1
6222, 1, 1636422043369, 1636422043637, 268, 0, 268, 0, 0, 0
6223, 1, 1636422043393, 1636422043661, 268, 1, 267, 0, 0, 0
6224, 1, 1636422043509, 1636422043773, 264, 1, 263, 0, 0, 0
6225, 1, 1636422043714, 1636422043993, 279, 0, 279, 0, 0, 0
6227, 1, 1636422044033, 1636422044302, 269, 1, 268, 0, 0, 0
6228, 1, 1636422044041, 1636422044309, 268, 1, 267, 1, 0, 1
6229, 1, 1636422044041, 1636422044309, 268, 1, 267, 0, 0, 0
6230, 1, 1636422044125, 1636422044393, 268, 0, 268, 0, 0, 0
6232, 1, 1636422044217, 1636422044481, 264, 0, 264, 0, 0, 0
6233, 1, 1636422044261, 1636422044529, 268, 1, 267, 0, 1, 1
6234, 1, 1636422044397, 1636422044705, 308, 0, 308, 0, 0, 0
6235, 1, 1636422044525, 1636422044793, 268, 1, 267, 0, 0, 0
6236, 1, 1636422044753, 1636422045014, 261, 0, 261, 0, 0, 0
6238, 1, 1636422044753, 1636422045021, 268, 0, 268, 0, 0, 0
6240, 1, 1636422044874, 1636422045142, 268, 0, 268, 0, 0, 0
6241, 1, 1636422044881, 1636422045146, 265, 1, 264, 0, 0, 0
6242, 1, 1636422044929, 1636422045202, 273, 1, 272, 1, 0, 1
6243, 1, 1636422044969, 1636422045237, 268, 0, 268, 0, 0, 0
6245, 1, 1636422045201, 1636422045506, 305, 1, 304, 0, 0, 0
6246, 1, 1636422045421, 1636422045689, 268, 1, 267, 0, 0, 0
6247, 1, 1636422045425, 1636422045689, 264, 0, 264, 0, 0, 0
6249, 1, 1636422045553, 1636422045826, 273, 1, 272, 1, 0, 1
6248, 1, 1636422045553, 1636422045826, 273, 1, 272, 1, 0, 1
6250, 1, 1636422045641, 1636422045906, 265, 1, 264, 0, 0, 0
6251, 1, 1636422045641, 1636422045909, 268, 1, 267, 0, 1, 1
6252, 1, 1636422045769, 1636422046038, 269, 1, 268, 0, 0, 0
6253, 1, 1636422045906, 1636422046174, 268, 0, 268, 0, 0, 0
6255, 1, 1636422046089, 1636422046357, 268, 0, 268, 0, 0, 0
6254, 1, 1636422046177, 1636422046449, 272, 1, 271, 0, 0, 0
6258, 1, 1636422046310, 1636422046577, 267, 0, 267, 0, 0, 0
6259, 1, 1636422046310, 1636422046582, 272, 0, 272, 0, 0, 0
6260, 1, 1636422046433, 1636422046702, 269, 0, 269, 0, 0, 0
6257, 1, 1636422046449, 1636422046717, 268, 1, 267, 0, 1, 1
6262, 1, 1636422046761, 1636422047033, 272, 1, 271, 0, 0, 0
6263, 1, 1636422046849, 1636422047137, 288, 1, 287, 0, 0, 0
6264, 1, 1636422046977, 1636422047245, 268, 1, 267, 0, 1, 1
6265, 1, 1636422046985, 1636422047253, 268, 1, 267, 0, 0, 0
6266, 1, 1636422047137, 1636422047410, 273, 1, 272, 0, 0, 0
6268, 1, 1636422047421, 1636422047689, 268, 0, 268, 0, 0, 0
6269, 1, 1636422047433, 1636422047705, 272, 0, 272, 0, 0, 0
6271, 1, 1636422047641, 1636422047914, 273, 1, 272, 1, 0, 1
6272, 1, 1636422047641, 1636422047917, 276, 1, 275, 0, 1, 1
6273, 1, 1636422047657, 1636422047930, 273, 1, 272, 0, 0, 0
6275, 1, 1636422048097, 1636422048365, 268, 1, 267, 0, 0, 0
6277, 1, 1636422048341, 1636422048614, 273, 2, 271, 0, 1, 1
6279, 1, 1636422048341, 1636422048614, 273, 1, 272, 0, 0, 0
6280, 1, 1636422048341, 1636422048614, 273, 2, 271, 0, 1, 1
6278, 1, 1636422048341, 1636422048614, 273, 1, 272, 0, 0, 0
6281, 1, 1636422048614, 1636422048885, 271, 1, 270, 1, 0, 1
6282, 1, 1636422048773, 1636422049041, 268, 1, 267, 1, 0, 1
6285, 1, 1636422049017, 1636422049325, 308, 1, 307, 0, 0, 0
6286, 1, 1636422049017, 1636422049325, 308, 1, 307, 0, 0, 0
6284, 1, 1636422049013, 1636422049325, 312, 1, 311, 0, 1, 1
6287, 1, 1636422049329, 1636422049593, 264, 0, 264, 0, 0, 0
6289, 1, 1636422049589, 1636422049858, 269, 1, 268, 0, 0, 0
6292, 1, 1636422049726, 1636422049993, 267, 0, 267, 0, 0, 0
6290, 1, 1636422049726, 1636422049994, 268, 1, 267, 0, 1, 1
6293, 1, 1636422049993, 1636422050261, 268, 1, 267, 0, 0, 0
6294, 1, 1636422050258, 1636422050526, 268, 0, 268, 0, 0, 0
6296, 1, 1636422050393, 1636422050662, 269, 1, 268, 1, 0, 1
6295, 1, 1636422050393, 1636422050662, 269, 1, 268, 0, 0, 0
6297, 1, 1636422050665, 1636422050962, 297, 0, 297, 0, 0, 0
6298, 1, 1636422050933, 1636422051201, 268, 1, 267, 0, 0, 0
6300, 1, 1636422051062, 1636422051329, 267, 0, 267, 0, 0, 0
6299, 1, 1636422051062, 1636422051337, 275, 0, 275, 0, 0, 0
6301, 1, 1636422051138, 1636422051406, 268, 0, 268, 0, 0, 0
6302, 1, 1636422051365, 1636422051634, 269, 0, 269, 0, 0, 0
6303, 1, 1636422051461, 1636422051729, 268, 1, 267, 1, 0, 1
6304, 1, 1636422051605, 1636422051873, 268, 1, 267, 1, 0, 1
6305, 1, 1636422051733, 1636422052005, 272, 1, 271, 0, 0, 0
6306, 1, 1636422051737, 1636422052013, 276, 0, 276, 0, 0, 0
6307, 1, 1636422051810, 1636422052081, 271, 0, 271, 0, 0, 0
6308, 1, 1636422052034, 1636422052305, 271, 0, 271, 0, 0, 0
6309, 1, 1636422052137, 1636422052409, 272, 1, 271, 1, 0, 1
6310, 1, 1636422052281, 1636422052550, 269, 1, 268, 1, 0, 1
6311, 1, 1636422052405, 1636422052669, 264, 1, 263, 0, 1, 1
6312, 1, 1636422052409, 1636422052682, 273, 0, 273, 0, 0, 0
6313, 1, 1636422052485, 1636422052753, 268, 0, 268, 0, 0, 0
6314, 1, 1636422052705, 1636422052974, 269, 1, 268, 0, 0, 0
6315, 1, 1636422052817, 1636422053085, 268, 0, 268, 0, 0, 0
6316, 1, 1636422052953, 1636422053221, 268, 1, 267, 0, 0, 0
6317, 1, 1636422053073, 1636422053350, 277, 1, 276, 0, 0, 0
6318, 1, 1636422053082, 1636422053353, 271, 0, 271, 0, 0, 0
6319, 1, 1636422053157, 1636422053421, 264, 1, 263, 1, 0, 1
6320, 1, 1636422053373, 1636422053641, 268, 1, 267, 0, 0, 0
6321, 1, 1636422053485, 1636422053757, 272, 1, 271, 0, 1, 1
6322, 1, 1636422053621, 1636422053889, 268, 0, 268, 0, 0, 0
6323, 1, 1636422053749, 1636422054017, 268, 1, 267, 0, 0, 0
6324, 1, 1636422053757, 1636422054021, 264, 1, 263, 0, 0, 0
6325, 1, 1636422053825, 1636422054093, 268, 1, 267, 0, 0, 0
6326, 1, 1636422054049, 1636422054350, 301, 1, 300, 1, 0, 1
6327, 1, 1636422054173, 1636422054449, 276, 0, 276, 0, 0, 0
6328, 1, 1636422054305, 1636422054569, 264, 1, 263, 1, 0, 1
6329, 1, 1636422054309, 1636422054577, 268, 1, 267, 0, 0, 0
6330, 1, 1636422054422, 1636422054685, 263, 0, 263, 0, 0, 0
6331, 1, 1636422054422, 1636422054685, 263, 0, 263, 0, 0, 0
6332, 1, 1636422054506, 1636422054841, 335, 0, 335, 0, 0, 0
6333, 1, 1636422054573, 1636422054929, 356, 1, 355, 0, 1, 1
6334, 1, 1636422054753, 1636422055021, 268, 1, 267, 0, 0, 0
6335, 1, 1636422054885, 1636422055157, 272, 0, 272, 0, 0, 0
6336, 1, 1636422054974, 1636422055241, 267, 0, 267, 0, 0, 0
6337, 1, 1636422054981, 1636422055249, 268, 0, 268, 0, 0, 0
6338, 1, 1636422055065, 1636422055330, 265, 1, 264, 0, 0, 0
6339, 1, 1636422055089, 1636422055358, 269, 0, 269, 0, 0, 0
6341, 1, 1636422055097, 1636422055366, 269, 1, 268, 0, 1, 1
6342, 1, 1636422055237, 1636422055509, 272, 1, 271, 0, 0, 0
6343, 1, 1636422055329, 1636422055598, 269, 1, 268, 0, 0, 0
6344, 1, 1636422055417, 1636422055685, 268, 1, 267, 0, 0, 0
6345, 1, 1636422055421, 1636422055689, 268, 0, 268, 0, 0, 0
6346, 1, 1636422055554, 1636422055821, 267, 0, 267, 0, 0, 0
6347, 1, 1636422055645, 1636422055913, 268, 1, 267, 0, 0, 0
6348, 1, 1636422055649, 1636422055917, 268, 0, 268, 0, 0, 0
6349, 1, 1636422055729, 1636422055997, 268, 0, 268, 0, 0, 0
6351, 1, 1636422055773, 1636422056041, 268, 1, 267, 0, 0, 0
6352, 1, 1636422055909, 1636422056177, 268, 1, 267, 0, 0, 0
6353, 1, 1636422055997, 1636422056269, 272, 1, 271, 0, 1, 1
6354, 1, 1636422056085, 1636422056357, 272, 1, 271, 0, 0, 0
6356, 1, 1636422056221, 1636422056493, 272, 0, 272, 0, 0, 0
6357, 1, 1636422056313, 1636422056621, 308, 1, 307, 1, 0, 1
6358, 1, 1636422056313, 1636422056621, 308, 1, 307, 0, 0, 0
6360, 1, 1636422056441, 1636422056710, 269, 0, 269, 0, 0, 0
6359, 1, 1636422056401, 1636422056710, 309, 1, 308, 0, 0, 0
6362, 1, 1636422056573, 1636422056842, 269, 1, 268, 0, 0, 0
6363, 1, 1636422056669, 1636422056933, 264, 0, 264, 0, 0, 0
6361, 1, 1636422056713, 1636422056977, 264, 0, 264, 0, 0, 0
6364, 1, 1636422056757, 1636422057021, 264, 1, 263, 0, 1, 1
6366, 1, 1636422056893, 1636422057185, 292, 0, 292, 0, 0, 0
6365, 1, 1636422056977, 1636422057273, 296, 1, 295, 1, 0, 1
6368, 1, 1636422057021, 1636422057285, 264, 0, 264, 0, 0, 0
6370, 1, 1636422057109, 1636422057381, 272, 0, 272, 0, 0, 0
6369, 1, 1636422057109, 1636422057381, 272, 1, 271, 0, 0, 0
6371, 1, 1636422057241, 1636422057509, 268, 0, 268, 0, 0, 0
6372, 1, 1636422057333, 1636422057601, 268, 1, 267, 0, 1, 1
6373, 1, 1636422057378, 1636422057669, 291, 0, 291, 0, 0, 0
6374, 1, 1636422057421, 1636422057693, 272, 1, 271, 1, 0, 1
6375, 1, 1636422057493, 1636422057765, 272, 1, 271, 0, 0, 0
6376, 1, 1636422057586, 1636422057857, 271, 0, 271, 0, 0, 0
6378, 1, 1636422057713, 1636422057978, 265, 1, 264, 1, 0, 1
6377, 1, 1636422057713, 1636422057978, 265, 1, 264, 0, 0, 0
6379, 1, 1636422057777, 1636422058046, 269, 1, 268, 1, 0, 1
6380, 1, 1636422057785, 1636422058053, 268, 1, 267, 0, 0, 0
6382, 1, 1636422057909, 1636422058177, 268, 1, 267, 0, 0, 0
6383, 1, 1636422058001, 1636422058270, 269, 1, 268, 0, 0, 0
6384, 1, 1636422058065, 1636422058333, 268, 0, 268, 0, 0, 0
6385, 1, 1636422058093, 1636422058361, 268, 1, 267, 0, 0, 0
6386, 1, 1636422058149, 1636422058429, 280, 1, 279, 0, 1, 1
6387, 1, 1636422058197, 1636422058461, 264, 1, 263, 1, 0, 1
6388, 1, 1636422058285, 1636422058553, 268, 0, 268, 0, 0, 0
6390, 1, 1636422058377, 1636422058645, 268, 1, 267, 0, 0, 0
6389, 1, 1636422058377, 1636422058645, 268, 1, 267, 0, 0, 0
6392, 1, 1636422058445, 1636422058713, 268, 1, 267, 0, 1, 1
6393, 1, 1636422058449, 1636422058713, 264, 1, 263, 1, 0, 1
6395, 1, 1636422058665, 1636422058929, 264, 1, 263, 0, 0, 0
6396, 1, 1636422058741, 1636422059010, 269, 1, 268, 0, 1, 1
6397, 1, 1636422058765, 1636422059062, 297, 1, 296, 0, 1, 1
6398, 1, 1636422058829, 1636422059093, 264, 1, 263, 1, 0, 1
6399, 1, 1636422058861, 1636422059145, 284, 1, 283, 0, 0, 0
6401, 1, 1636422059061, 1636422059330, 269, 1, 268, 1, 0, 1
6402, 1, 1636422059061, 1636422059334, 273, 1, 272, 0, 0, 0
6403, 1, 1636422059109, 1636422059385, 276, 0, 276, 0, 0, 0
6406, 1, 1636422059329, 1636422059597, 268, 5, 263, 4, 0, 4
6407, 1, 1636422059417, 1636422059681, 264, 0, 264, 0, 0, 0
6408, 1, 1636422059461, 1636422059770, 309, 0, 309, 0, 0, 0
6409, 1, 1636422059505, 1636422059774, 269, 0, 269, 0, 0, 0
6410, 1, 1636422059549, 1636422059861, 312, 1, 311, 0, 0, 0
6412, 1, 1636422059773, 1636422060041, 268, 1, 267, 0, 1, 1
6411, 1, 1636422059773, 1636422060041, 268, 1, 267, 0, 1, 1
6413, 1, 1636422059773, 1636422060045, 272, 1, 271, 0, 1, 1
6414, 1, 1636422059813, 1636422060085, 272, 0, 272, 0, 0, 0
6415, 1, 1636422060041, 1636422060306, 265, 0, 265, 0, 0, 0
6417, 1, 1636422060082, 1636422060349, 267, 0, 267, 0, 0, 0
6418, 1, 1636422060173, 1636422060441, 268, 1, 267, 1, 0, 1
6419, 1, 1636422060173, 1636422060442, 269, 1, 268, 1, 0, 1
6420, 1, 1636422060262, 1636422060533, 271, 0, 271, 0, 0, 0
6421, 1, 1636422060441, 1636422060705, 264, 1, 263, 0, 0, 0
6422, 1, 1636422060441, 1636422060705, 264, 1, 263, 1, 0, 1
6423, 1, 1636422060445, 1636422060705, 260, 0, 260, 0, 0, 0
6424, 1, 1636422060481, 1636422060750, 269, 0, 269, 0, 0, 0
6426, 1, 1636422060749, 1636422061014, 265, 1, 264, 1, 0, 1
6427, 1, 1636422060833, 1636422061101, 268, 1, 267, 0, 0, 0
6428, 1, 1636422060841, 1636422061110, 269, 1, 268, 0, 1, 1
6429, 1, 1636422060933, 1636422061201, 268, 0, 268, 0, 0, 0
6432, 1, 1636422061110, 1636422061381, 271, 1, 270, 1, 0, 1
6431, 1, 1636422061110, 1636422061385, 275, 0, 275, 0, 0, 0
6430, 1, 1636422061110, 1636422061385, 275, 1, 274, 0, 0, 0
6434, 1, 1636422061417, 1636422061682, 265, 1, 264, 0, 0, 0
6435, 1, 1636422061505, 1636422061777, 272, 0, 272, 0, 0, 0
6437, 1, 1636422061606, 1636422061870, 264, 0, 264, 0, 0, 0
6438, 1, 1636422061785, 1636422062053, 268, 1, 267, 0, 0, 0
6439, 1, 1636422061785, 1636422062057, 272, 1, 271, 1, 0, 1
6441, 1, 1636422062077, 1636422062346, 269, 1, 268, 0, 0, 0
6442, 1, 1636422062174, 1636422062442, 268, 0, 268, 0, 0, 0
6443, 1, 1636422062270, 1636422062538, 268, 0, 268, 0, 0, 0
6445, 1, 1636422062458, 1636422062722, 264, 0, 264, 0, 0, 0
6444, 1, 1636422062454, 1636422062725, 271, 0, 271, 0, 0, 0
6447, 1, 1636422062845, 1636422063114, 269, 1, 268, 0, 0, 0
6448, 1, 1636422062937, 1636422063206, 269, 1, 268, 0, 0, 0
6450, 1, 1636422063126, 1636422063398, 272, 0, 272, 0, 0, 0
6451, 1, 1636422063510, 1636422063781, 271, 0, 271, 0, 0, 0
6453, 1, 1636422063797, 1636422064066, 269, 1, 268, 0, 0, 0
6455, 1, 1636422064466, 1636422064738, 272, 0, 272, 0, 0, 0
6456, 1, 1636422065142, 1636422065410, 268, 0, 268, 0, 0, 0
6457, 1, 1636422065402, 1636422065674, 272, 0, 272, 0, 0, 0
6459, 1, 1636422066066, 1636422066334, 268, 0, 268, 0, 0, 0
6460, 1, 1636422066074, 1636422066342, 268, 0, 268, 0, 0, 0
6461, 1, 1636422066395, 1636422066662, 267, 0, 267, 0, 0, 0
6462, 1, 1636422066734, 1636422067001, 267, 0, 267, 0, 0, 0
6463, 1, 1636422066745, 1636422067014, 269, 1, 268, 0, 1, 1
6464, 1, 1636422067065, 1636422067342, 277, 1, 276, 0, 0, 0
6465, 1, 1636422067330, 1636422067597, 267, 0, 267, 0, 0, 0
6466, 1, 1636422067402, 1636422067670, 268, 0, 268, 0, 0, 0
6467, 1, 1636422067413, 1636422067682, 269, 1, 268, 0, 1, 1
6468, 1, 1636422067738, 1636422068010, 272, 0, 272, 0, 0, 0
6469, 1, 1636422068025, 1636422068297, 272, 0, 272, 0, 0, 0
6470, 1, 1636422068070, 1636422068337, 267, 0, 267, 0, 0, 0
6471, 1, 1636422068081, 1636422068349, 268, 0, 268, 0, 0, 0
6472, 1, 1636422068409, 1636422068717, 308, 1, 307, 0, 0, 0
6473, 1, 1636422068698, 1636422068997, 299, 0, 299, 0, 0, 0
6475, 1, 1636422068753, 1636422069022, 269, 1, 268, 0, 0, 0
6474, 1, 1636422068753, 1636422069022, 269, 1, 268, 0, 0, 0
6476, 1, 1636422068910, 1636422069177, 267, 0, 267, 0, 0, 0
6477, 1, 1636422069169, 1636422069453, 284, 1, 283, 1, 0, 1
6478, 1, 1636422069298, 1636422069565, 267, 0, 267, 0, 0, 0
6479, 1, 1636422069406, 1636422069674, 268, 0, 268, 0, 0, 0
6480, 1, 1636422069422, 1636422069690, 268, 0, 268, 0, 0, 0
6481, 1, 1636422069422, 1636422069690, 268, 0, 268, 0, 0, 0
6482, 1, 1636422069421, 1636422069690, 269, 1, 268, 0, 0, 0
6483, 1, 1636422069577, 1636422069846, 269, 1, 268, 1, 0, 1
6484, 1, 1636422069853, 1636422070166, 313, 0, 313, 0, 0, 0
6485, 1, 1636422069989, 1636422070258, 269, 0, 269, 0, 0, 0
6486, 1, 1636422070081, 1636422070350, 269, 0, 269, 0, 0, 0
6487, 1, 1636422070125, 1636422070397, 272, 1, 271, 1, 0, 1
6489, 1, 1636422070125, 1636422070397, 272, 1, 271, 0, 1, 1
6490, 1, 1636422070246, 1636422070517, 271, 0, 271, 0, 0, 0
6425, 2, 1636422060705, 1636422070754, 10049, 0, 10049, 0, 0, 0
6491, 1, 1636422070565, 1636422070885, 320, 1, 319, 0, 1, 1
6492, 1, 1636422070657, 1636422070981, 324, 1, 323, 0, 0, 0
6493, 1, 1636422070797, 1636422071069, 272, 1, 271, 0, 0, 0
6495, 1, 1636422070933, 1636422071205, 272, 0, 272, 0, 0, 0
6496, 1, 1636422071105, 1636422071374, 269, 1, 268, 0, 0, 0
6498, 1, 1636422071382, 1636422071649, 267, 0, 267, 0, 0, 0
6499, 1, 1636422071466, 1636422071738, 272, 0, 272, 0, 0, 0
6500, 1, 1636422071606, 1636422071873, 267, 0, 267, 0, 0, 0
6502, 1, 1636422072049, 1636422072317, 268, 1, 267, 0, 1, 1
6503, 1, 1636422072097, 1636422072362, 265, 1, 264, 1, 0, 1
6504, 1, 1636422072274, 1636422072541, 267, 0, 267, 0, 0, 0
6505, 1, 1636422072717, 1636422072985, 268, 1, 267, 0, 0, 0
6506, 1, 1636422072798, 1636422073066, 268, 0, 268, 0, 0, 0
6507, 1, 1636422072937, 1636422073206, 269, 1, 268, 0, 0, 0
6508, 1, 1636422073389, 1636422073662, 273, 1, 272, 1, 0, 1
6509, 1, 1636422073465, 1636422073737, 272, 1, 271, 1, 0, 1
6511, 1, 1636422074138, 1636422074410, 272, 0, 272, 0, 0, 0
6512, 1, 1636422074809, 1636422075085, 276, 1, 275, 1, 0, 1
6513, 1, 1636422075490, 1636422075758, 268, 0, 268, 0, 0, 0
6514, 1, 1636422076117, 1636422076386, 269, 1, 268, 0, 1, 1
6515, 1, 1636422076154, 1636422076422, 268, 0, 268, 0, 0, 0
6518, 1, 1636422081102, 1636422081370, 268, 0, 268, 0, 0, 0
6522, 1, 1636422081374, 1636422081642, 268, 0, 268, 0, 0, 0
6528, 1, 1636422082078, 1636422082350, 272, 0, 272, 0, 0, 0
6529, 1, 1636422082746, 1636422083017, 271, 0, 271, 0, 0, 0
6530, 1, 1636422083417, 1636422083690, 273, 1, 272, 0, 1, 1
6531, 1, 1636422084110, 1636422084382, 272, 0, 272, 0, 0, 0
6533, 1, 1636422084778, 1636422085054, 276, 0, 276, 0, 0, 0
6534, 1, 1636422085458, 1636422085730, 272, 0, 272, 0, 0, 0
6535, 1, 1636422086130, 1636422086397, 267, 0, 267, 0, 0, 0
6537, 1, 1636422087094, 1636422087362, 268, 0, 268, 0, 0, 0
6538, 1, 1636422087762, 1636422088033, 271, 0, 271, 0, 0, 0
6539, 1, 1636422088433, 1636422088701, 268, 1, 267, 1, 0, 1
6540, 1, 1636422089102, 1636422089370, 268, 0, 268, 0, 0, 0
6541, 1, 1636422089769, 1636422090042, 273, 1, 272, 0, 0, 0
6542, 1, 1636422090478, 1636422090746, 268, 0, 268, 0, 0, 0
6543, 1, 1636422091334, 1636422091601, 267, 0, 267, 0, 0, 0
6549, 1, 1636422092089, 1636422092362, 273, 0, 273, 0, 0, 0
6550, 1, 1636422092362, 1636422092630, 268, 1, 267, 0, 0, 0
6551, 1, 1636422092761, 1636422093030, 269, 1, 268, 0, 0, 0
6552, 1, 1636422093033, 1636422093309, 276, 1, 275, 0, 0, 0
6553, 1, 1636422093430, 1636422093701, 271, 0, 271, 0, 0, 0
6554, 1, 1636422093709, 1636422093978, 269, 1, 268, 0, 1, 1
6555, 1, 1636422094101, 1636422094418, 317, 0, 317, 0, 0, 0
6556, 1, 1636422094417, 1636422094689, 272, 1, 271, 0, 0, 0
6557, 1, 1636422094817, 1636422095086, 269, 1, 268, 1, 0, 1
6558, 1, 1636422095089, 1636422095357, 268, 1, 267, 0, 1, 1
6559, 1, 1636422095486, 1636422095754, 268, 0, 268, 0, 0, 0
6560, 1, 1636422095758, 1636422096026, 268, 0, 268, 0, 0, 0
6561, 1, 1636422096154, 1636422096422, 268, 0, 268, 0, 0, 0
6562, 1, 1636422096425, 1636422096693, 268, 1, 267, 0, 0, 0
6564, 1, 1636422101858, 1636422102221, 363, 0, 363, 0, 0, 0
6565, 1, 1636422102301, 1636422102570, 269, 0, 269, 0, 0, 0
6569, 1, 1636422102622, 1636422102886, 264, 0, 264, 0, 0, 0
6570, 1, 1636422102970, 1636422103238, 268, 0, 268, 0, 0, 0
6571, 1, 1636422103282, 1636422103550, 268, 0, 268, 0, 0, 0
6572, 1, 1636422103638, 1636422103909, 271, 0, 271, 0, 0, 0
6573, 1, 1636422103954, 1636422104218, 264, 0, 264, 0, 0, 0
6574, 1, 1636422104306, 1636422104573, 267, 0, 267, 0, 0, 0
6575, 1, 1636422104617, 1636422104886, 269, 1, 268, 0, 1, 1
6576, 1, 1636422104974, 1636422105241, 267, 0, 267, 0, 0, 0
6577, 1, 1636422105286, 1636422105558, 272, 0, 272, 0, 0, 0
6578, 1, 1636422105638, 1636422105910, 272, 0, 272, 0, 0, 0
6579, 1, 1636422105954, 1636422106222, 268, 0, 268, 0, 0, 0
6580, 1, 1636422106306, 1636422106574, 268, 0, 268, 0, 0, 0
6583, 1, 1636422112670, 1636422112942, 272, 0, 272, 0, 0, 0
6584, 1, 1636422112946, 1636422113214, 268, 0, 268, 0, 0, 0
6585, 1, 1636422113341, 1636422113610, 269, 1, 268, 0, 1, 1
6586, 1, 1636422113610, 1636422113882, 272, 1, 271, 0, 0, 0
6587, 1, 1636422114010, 1636422114282, 272, 0, 272, 0, 0, 0
6588, 1, 1636422114282, 1636422114549, 267, 1, 266, 0, 0, 0
6589, 1, 1636422114682, 1636422114954, 272, 0, 272, 0, 0, 0
6590, 1, 1636422114954, 1636422115222, 268, 0, 268, 0, 0, 0
6591, 1, 1636422115353, 1636422115626, 273, 0, 273, 0, 0, 0
6592, 1, 1636422115630, 1636422115898, 268, 0, 268, 0, 0, 0
6593, 1, 1636422116026, 1636422116294, 268, 0, 268, 0, 0, 0
6594, 1, 1636422116293, 1636422116562, 269, 1, 268, 0, 0, 0
6601, 1, 1636422474766, 1636422475038, 272, 0, 272, 0, 0, 0
6602, 1, 1636422475238, 1636422475510, 272, 0, 272, 0, 0, 0
6604, 1, 1636422475794, 1636422476066, 272, 0, 272, 0, 0, 0
6606, 1, 1636422476321, 1636422476590, 269, 0, 269, 0, 0, 0
6608, 1, 1636422476889, 1636422477162, 273, 0, 273, 0, 0, 0
6610, 1, 1636422477490, 1636422477762, 272, 0, 272, 0, 0, 0
6612, 1, 1636422478010, 1636422478278, 268, 0, 268, 0, 0, 0
6614, 1, 1636422478622, 1636422478889, 267, 0, 267, 0, 0, 0
6616, 1, 1636422479157, 1636422479433, 276, 1, 275, 1, 0, 1
6618, 1, 1636422479626, 1636422479898, 272, 0, 272, 0, 0, 0
6621, 1, 1636422481270, 1636422481542, 272, 0, 272, 0, 0, 0
6622, 1, 1636422481785, 1636422482054, 269, 1, 268, 0, 0, 0
6624, 1, 1636422482350, 1636422482614, 264, 0, 264, 0, 0, 0
6626, 1, 1636422482942, 1636422483210, 268, 0, 268, 0, 0, 0
6628, 1, 1636422483485, 1636422483753, 268, 1, 267, 0, 0, 0
6630, 1, 1636422483993, 1636422484266, 273, 1, 272, 0, 0, 0
6632, 1, 1636422484605, 1636422484878, 273, 1, 272, 0, 0, 0
6634, 1, 1636422485190, 1636422485462, 272, 0, 272, 0, 0, 0
6637, 1, 1636422485785, 1636422486057, 272, 1, 271, 0, 0, 0
6636, 1, 1636422485826, 1636422486121, 295, 0, 295, 0, 0, 0
6639, 1, 1636422486297, 1636422486597, 300, 1, 299, 1, 0, 1
6640, 1, 1636422486537, 1636422486810, 273, 1, 272, 1, 0, 1
6641, 1, 1636422486541, 1636422486810, 269, 0, 269, 0, 0, 0
6643, 1, 1636422486854, 1636422487126, 272, 0, 272, 0, 0, 0
6644, 1, 1636422487037, 1636422487309, 272, 1, 271, 0, 1, 1
6647, 1, 1636422487353, 1636422487621, 268, 1, 267, 0, 0, 0
6646, 1, 1636422487390, 1636422487657, 267, 0, 267, 0, 0, 0
6648, 1, 1636422487573, 1636422487842, 269, 1, 268, 1, 0, 1
6649, 1, 1636422487817, 1636422488089, 272, 0, 272, 0, 0, 0
6650, 1, 1636422487982, 1636422488290, 308, 0, 308, 0, 0, 0
6651, 1, 1636422488106, 1636422488377, 271, 0, 271, 0, 0, 0
6653, 1, 1636422488390, 1636422488653, 263, 0, 263, 0, 0, 0
6654, 1, 1636422488553, 1636422488837, 284, 1, 283, 0, 1, 1
6656, 1, 1636422488698, 1636422488965, 267, 0, 267, 0, 0, 0
6657, 1, 1636422488925, 1636422489198, 273, 0, 273, 0, 0, 0
6658, 1, 1636422489101, 1636422489417, 316, 1, 315, 0, 0, 0
6660, 1, 1636422489270, 1636422489537, 267, 0, 267, 0, 0, 0
6661, 1, 1636422489514, 1636422489782, 268, 0, 268, 0, 0, 0
6662, 1, 1636422489681, 1636422489953, 272, 1, 271, 0, 0, 0
6664, 1, 1636422489866, 1636422490133, 267, 0, 267, 0, 0, 0
6665, 1, 1636422490085, 1636422490353, 268, 0, 268, 0, 0, 0
6666, 1, 1636422490213, 1636422490481, 268, 1, 267, 0, 1, 1
6668, 1, 1636422490397, 1636422490657, 260, 1, 259, 1, 0, 1
6669, 1, 1636422490621, 1636422490889, 268, 1, 267, 0, 1, 1
6670, 1, 1636422490717, 1636422490985, 268, 1, 267, 0, 0, 0
6672, 1, 1636422490937, 1636422491205, 268, 0, 268, 0, 0, 0
6673, 1, 1636422491209, 1636422491477, 268, 0, 268, 0, 0, 0
6675, 1, 1636422491445, 1636422491713, 268, 0, 268, 0, 0, 0
6676, 1, 1636422491757, 1636422492069, 312, 1, 311, 0, 1, 1
6678, 1, 1636422492258, 1636422492522, 264, 0, 264, 0, 0, 0
6679, 1, 1636422492334, 1636422492614, 280, 0, 280, 0, 0, 0
6681, 1, 1636422492877, 1636422493185, 308, 1, 307, 1, 0, 1
6682, 1, 1636422493050, 1636422493322, 272, 0, 272, 0, 0, 0
6684, 1, 1636422493450, 1636422493746, 296, 0, 296, 0, 0, 0
6685, 1, 1636422493594, 1636422493861, 267, 0, 267, 0, 0, 0
6686, 1, 1636422493866, 1636422494133, 267, 0, 267, 0, 0, 0
6687, 1, 1636422494005, 1636422494294, 289, 0, 289, 0, 0, 0
6688, 1, 1636422494202, 1636422494469, 267, 0, 267, 0, 0, 0
6689, 1, 1636422494405, 1636422494678, 273, 1, 272, 0, 1, 1
6690, 1, 1636422494553, 1636422494826, 273, 1, 272, 0, 1, 1
6692, 1, 1636422494737, 1636422495002, 265, 1, 264, 1, 0, 1
6693, 1, 1636422494969, 1636422495238, 269, 1, 268, 0, 0, 0
6694, 1, 1636422495085, 1636422495398, 313, 1, 312, 0, 0, 0
6696, 1, 1636422495313, 1636422495582, 269, 1, 268, 0, 0, 0
6697, 1, 1636422495537, 1636422495802, 265, 1, 264, 1, 0, 1
6698, 1, 1636422495669, 1636422495990, 321, 0, 321, 0, 0, 0
6700, 1, 1636422495809, 1636422496081, 272, 1, 271, 0, 1, 1
6701, 1, 1636422496074, 1636422496346, 272, 0, 272, 0, 0, 0
6702, 1, 1636422496250, 1636422496517, 267, 0, 267, 0, 0, 0
6704, 1, 1636422496425, 1636422496694, 269, 1, 268, 0, 0, 0
6705, 1, 1636422496629, 1636422496897, 268, 0, 268, 0, 0, 0
6706, 1, 1636422496845, 1636422497117, 272, 1, 271, 0, 0, 0
6708, 1, 1636422496965, 1636422497233, 268, 1, 267, 1, 0, 1
6709, 1, 1636422497186, 1636422497454, 268, 0, 268, 0, 0, 0
6712, 1, 1636422497558, 1636422497829, 271, 0, 271, 0, 0, 0
6711, 1, 1636422497598, 1636422497870, 272, 0, 272, 0, 0, 0
6713, 1, 1636422497781, 1636422498050, 269, 1, 268, 0, 0, 0
6715, 1, 1636422498314, 1636422498582, 268, 0, 268, 0, 0, 0
6716, 1, 1636422498373, 1636422498650, 277, 1, 276, 0, 0, 0
6717, 1, 1636422498449, 1636422498737, 288, 1, 287, 1, 0, 1
6719, 1, 1636422498913, 1636422499222, 309, 1, 308, 0, 0, 0
6720, 1, 1636422499133, 1636422499406, 273, 1, 272, 1, 0, 1
6721, 1, 1636422499161, 1636422499434, 273, 1, 272, 0, 0, 0
6723, 1, 1636422499490, 1636422499758, 268, 0, 268, 0, 0, 0
6724, 1, 1636422499669, 1636422499938, 269, 1, 268, 0, 0, 0
6727, 1, 1636422500021, 1636422500290, 269, 0, 269, 0, 0, 0
6728, 1, 1636422500201, 1636422500470, 269, 1, 268, 1, 0, 1
6730, 1, 1636422500609, 1636422500917, 308, 1, 307, 0, 1, 1
6731, 1, 1636422500737, 1636422501005, 268, 1, 267, 0, 0, 0
6733, 1, 1636422501182, 1636422501453, 271, 0, 271, 0, 0, 0
6734, 1, 1636422501365, 1636422501634, 269, 0, 269, 0, 0, 0
6736, 1, 1636422501714, 1636422501982, 268, 0, 268, 0, 0, 0
6737, 1, 1636422501894, 1636422502166, 272, 0, 272, 0, 0, 0
6739, 1, 1636422502317, 1636422502590, 273, 0, 273, 0, 0, 0
6740, 1, 1636422502434, 1636422502701, 267, 0, 267, 0, 0, 0
6742, 1, 1636422502850, 1636422503117, 267, 0, 267, 0, 0, 0
6743, 1, 1636422503042, 1636422503310, 268, 0, 268, 0, 0, 0
6745, 1, 1636422503361, 1636422503633, 272, 1, 271, 0, 0, 0
6746, 1, 1636422503574, 1636422503842, 268, 0, 268, 0, 0, 0
6748, 1, 1636422504082, 1636422504354, 272, 0, 272, 0, 0, 0
6751, 1, 1636422504962, 1636422505237, 275, 0, 275, 0, 0, 0
6752, 1, 1636422505501, 1636422505802, 301, 1, 300, 0, 1, 1
6753, 1, 1636422505713, 1636422505982, 269, 1, 268, 1, 0, 1
6754, 1, 1636422506061, 1636422506369, 308, 1, 307, 0, 0, 0
6755, 1, 1636422506217, 1636422506490, 273, 0, 273, 0, 0, 0
6757, 1, 1636422506630, 1636422506905, 275, 0, 275, 0, 0, 0
6758, 1, 1636422506817, 1636422507082, 265, 1, 264, 0, 0, 0
6760, 1, 1636422507169, 1636422507466, 297, 0, 297, 0, 0, 0
6761, 1, 1636422507377, 1636422507646, 269, 0, 269, 0, 0, 0
6763, 1, 1636422507726, 1636422508013, 287, 0, 287, 0, 0, 0
6764, 1, 1636422507925, 1636422508198, 273, 1, 272, 1, 0, 1
6766, 1, 1636422508278, 1636422508546, 268, 0, 268, 0, 0, 0
6767, 1, 1636422508446, 1636422508713, 267, 0, 267, 0, 0, 0
6769, 1, 1636422508878, 1636422509150, 272, 0, 272, 0, 0, 0
6770, 1, 1636422508990, 1636422509301, 311, 0, 311, 0, 0, 0
6772, 1, 1636422509481, 1636422509750, 269, 1, 268, 0, 1, 1
6773, 1, 1636422509590, 1636422509858, 268, 0, 268, 0, 0, 0
6776, 1, 1636422510189, 1636422510478, 289, 0, 289, 0, 0, 0
6775, 1, 1636422510233, 1636422510502, 269, 1, 268, 0, 1, 1
6777, 1, 1636422510261, 1636422510565, 304, 1, 303, 0, 0, 0
6779, 1, 1636422510741, 1636422511050, 309, 1, 308, 1, 0, 1
6780, 1, 1636422510961, 1636422511230, 269, 1, 268, 0, 0, 0
6781, 1, 1636422510978, 1636422511245, 267, 0, 267, 0, 0, 0
6783, 1, 1636422511314, 1636422511586, 272, 0, 272, 0, 0, 0
6784, 1, 1636422511498, 1636422511766, 268, 0, 268, 0, 0, 0
6786, 1, 1636422511782, 1636422512049, 267, 0, 267, 0, 0, 0
6787, 1, 1636422511849, 1636422512117, 268, 1, 267, 0, 1, 1
6788, 1, 1636422512026, 1636422512294, 268, 0, 268, 0, 0, 0
6789, 1, 1636422512277, 1636422512545, 268, 1, 267, 1, 0, 1
6790, 1, 1636422512446, 1636422512729, 283, 0, 283, 0, 0, 0
6791, 1, 1636422512566, 1636422512834, 268, 0, 268, 0, 0, 0
6792, 1, 1636422512586, 1636422512854, 268, 0, 268, 0, 0, 0
6793, 1, 1636422512845, 1636422513114, 269, 1, 268, 1, 0, 1
6794, 1, 1636422512993, 1636422513274, 281, 1, 280, 0, 0, 0
6795, 1, 1636422513062, 1636422513361, 299, 0, 299, 0, 0, 0
6796, 1, 1636422513185, 1636422513454, 269, 1, 268, 0, 0, 0
6797, 1, 1636422513374, 1636422513641, 267, 0, 267, 0, 0, 0
6798, 1, 1636422513374, 1636422513653, 279, 0, 279, 0, 0, 0
6799, 1, 1636422513541, 1636422513810, 269, 1, 268, 0, 0, 0
6800, 1, 1636422513641, 1636422513910, 269, 1, 268, 0, 1, 1
6801, 1, 1636422513710, 1636422513977, 267, 0, 267, 0, 0, 0
6802, 1, 1636422513877, 1636422514146, 269, 1, 268, 1, 0, 1
6803, 1, 1636422513973, 1636422514242, 269, 1, 268, 1, 0, 1
6804, 1, 1636422514133, 1636422514409, 276, 0, 276, 0, 0, 0
6805, 1, 1636422514165, 1636422514437, 272, 0, 272, 0, 0, 0
6807, 1, 1636422514253, 1636422514521, 268, 1, 267, 0, 0, 0
6806, 1, 1636422514437, 1636422514705, 268, 1, 267, 1, 0, 1
6808, 1, 1636422514453, 1636422514726, 273, 0, 273, 0, 0, 0
6809, 1, 1636422514513, 1636422514778, 265, 1, 264, 0, 0, 0
6810, 1, 1636422514669, 1636422514942, 273, 0, 273, 0, 0, 0
6811, 1, 1636422514709, 1636422515005, 296, 1, 295, 0, 0, 0
6813, 1, 1636422514861, 1636422515133, 272, 1, 271, 0, 1, 1
6814, 1, 1636422515005, 1636422515273, 268, 1, 267, 0, 1, 1
6812, 1, 1636422515013, 1636422515281, 268, 1, 267, 0, 1, 1
6815, 1, 1636422515061, 1636422515329, 268, 1, 267, 0, 0, 0
6816, 1, 1636422515113, 1636422515385, 272, 1, 271, 0, 0, 0
6817, 1, 1636422515186, 1636422515453, 267, 0, 267, 0, 0, 0
6818, 1, 1636422515281, 1636422515549, 268, 1, 267, 1, 0, 1
6820, 1, 1636422515393, 1636422515662, 269, 0, 269, 0, 0, 0
6821, 1, 1636422515449, 1636422515717, 268, 1, 267, 1, 0, 1
6819, 1, 1636422515549, 1636422515813, 264, 1, 263, 1, 0, 1
6823, 1, 1636422515669, 1636422515941, 272, 1, 271, 1, 0, 1
6822, 1, 1636422515681, 1636422515953, 272, 1, 271, 0, 1, 1
6824, 1, 1636422515782, 1636422516045, 263, 0, 263, 0, 0, 0
6825, 1, 1636422515853, 1636422516122, 269, 1, 268, 0, 0, 0
6827, 1, 1636422515909, 1636422516177, 268, 1, 267, 0, 1, 1
6828, 1, 1636422516029, 1636422516293, 264, 0, 264, 0, 0, 0
6830, 1, 1636422516201, 1636422516509, 308, 0, 308, 0, 0, 0
6829, 1, 1636422516221, 1636422516509, 288, 1, 287, 0, 1, 1
6831, 1, 1636422516249, 1636422516517, 268, 1, 267, 0, 0, 0
6833, 1, 1636422516462, 1636422516729, 267, 0, 267, 0, 0, 0
6834, 1, 1636422516597, 1636422516865, 268, 1, 267, 1, 0, 1
6835, 1, 1636422516638, 1636422516906, 268, 0, 268, 0, 0, 0
6836, 1, 1636422516722, 1636422516990, 268, 0, 268, 0, 0, 0
6837, 1, 1636422516773, 1636422517053, 280, 1, 279, 0, 1, 1
6838, 1, 1636422516821, 1636422517085, 264, 1, 263, 0, 0, 0
6840, 1, 1636422516989, 1636422517257, 268, 1, 267, 0, 0, 0
6841, 1, 1636422517097, 1636422517365, 268, 1, 267, 0, 1, 1
6842, 1, 1636422517246, 1636422517513, 267, 0, 267, 0, 0, 0
6843, 1, 1636422517317, 1636422517625, 308, 1, 307, 0, 1, 1
6844, 1, 1636422517397, 1636422517666, 269, 1, 268, 0, 0, 0
6845, 1, 1636422517429, 1636422517713, 284, 1, 283, 1, 0, 1
6846, 1, 1636422517489, 1636422517761, 272, 1, 271, 0, 0, 0
6848, 1, 1636422517670, 1636422517933, 263, 0, 263, 0, 0, 0
6847, 1, 1636422517713, 1636422517981, 268, 1, 267, 1, 0, 1
6849, 1, 1636422517781, 1636422518057, 276, 1, 275, 1, 0, 1
6851, 1, 1636422517861, 1636422518133, 272, 1, 271, 1, 0, 1
6850, 1, 1636422517882, 1636422518190, 308, 0, 308, 0, 0, 0
6852, 1, 1636422518034, 1636422518297, 263, 0, 263, 0, 0, 0
6853, 1, 1636422518042, 1636422518309, 267, 0, 267, 0, 0, 0
6854, 1, 1636422518189, 1636422518454, 265, 1, 264, 0, 0, 0
6855, 1, 1636422518241, 1636422518513, 272, 1, 271, 0, 1, 1
6856, 1, 1636422518305, 1636422518581, 276, 1, 275, 1, 0, 1
6857, 1, 1636422518385, 1636422518653, 268, 0, 268, 0, 0, 0
6859, 1, 1636422518425, 1636422518697, 272, 1, 271, 1, 0, 1
6858, 1, 1636422518449, 1636422518753, 304, 1, 303, 0, 0, 0
6860, 1, 1636422518569, 1636422518841, 272, 1, 271, 0, 0, 0
6861, 1, 1636422518605, 1636422518874, 269, 1, 268, 1, 0, 1
6862, 1, 1636422518665, 1636422518929, 264, 1, 263, 0, 1, 1
6863, 1, 1636422518841, 1636422519105, 264, 1, 263, 0, 1, 1
6864, 1, 1636422518845, 1636422519117, 272, 1, 271, 0, 0, 0
6865, 1, 1636422519013, 1636422519301, 288, 0, 288, 0, 0, 0
6867, 1, 1636422519029, 1636422519301, 272, 0, 272, 0, 0, 0
6866, 1, 1636422518989, 1636422519301, 312, 1, 311, 0, 1, 1
6868, 1, 1636422519097, 1636422519389, 292, 0, 292, 0, 0, 0
6870, 1, 1636422519217, 1636422519481, 264, 0, 264, 0, 0, 0
6871, 1, 1636422519229, 1636422519498, 269, 0, 269, 0, 0, 0
6872, 1, 1636422519393, 1636422519661, 268, 0, 268, 0, 0, 0
6873, 1, 1636422519417, 1636422519689, 272, 0, 272, 0, 0, 0
6874, 1, 1636422519461, 1636422519725, 264, 1, 263, 0, 0, 0
6875, 1, 1636422519557, 1636422519821, 264, 1, 263, 0, 1, 1
6876, 1, 1636422519633, 1636422519910, 277, 0, 277, 0, 0, 0
6877, 1, 1636422519637, 1636422519910, 273, 0, 273, 0, 0, 0
6878, 1, 1636422519733, 1636422520009, 276, 0, 276, 0, 0, 0
6879, 1, 1636422519825, 1636422520089, 264, 0, 264, 0, 0, 0
6880, 1, 1636422519869, 1636422520133, 264, 0, 264, 0, 0, 0
6881, 1, 1636422519913, 1636422520177, 264, 0, 264, 0, 0, 0
6882, 1, 1636422519977, 1636422520245, 268, 1, 267, 1, 0, 1
6883, 1, 1636422520037, 1636422520305, 268, 1, 267, 0, 1, 1
6884, 1, 1636422520093, 1636422520361, 268, 0, 268, 0, 0, 0
6885, 1, 1636422520165, 1636422520433, 268, 0, 268, 0, 0, 0
6886, 1, 1636422520210, 1636422520517, 307, 0, 307, 0, 0, 0
6887, 1, 1636422520273, 1636422520533, 260, 0, 260, 0, 0, 0
6888, 1, 1636422520277, 1636422520541, 264, 0, 264, 0, 0, 0
6889, 1, 1636422520425, 1636422520689, 264, 0, 264, 0, 0, 0
6890, 1, 1636422520473, 1636422520741, 268, 0, 268, 0, 0, 0
6891, 1, 1636422520541, 1636422520806, 265, 1, 264, 1, 0, 1
6893, 1, 1636422520625, 1636422520893, 268, 1, 267, 0, 0, 0
6895, 1, 1636422520693, 1636422520965, 272, 1, 271, 1, 0, 1
6894, 1, 1636422520693, 1636422520966, 273, 1, 272, 1, 0, 1
6897, 1, 1636422520805, 1636422521069, 264, 1, 263, 0, 0, 0
6898, 1, 1636422520841, 1636422521122, 281, 0, 281, 0, 0, 0
6896, 1, 1636422520965, 1636422521229, 264, 1, 263, 1, 0, 1
6899, 1, 1636422520985, 1636422521254, 269, 1, 268, 1, 0, 1
6900, 1, 1636422521037, 1636422521297, 260, 0, 260, 0, 0, 0
6902, 1, 1636422521121, 1636422521389, 268, 1, 267, 0, 0, 0
6903, 1, 1636422521229, 1636422521493, 264, 1, 263, 1, 0, 1
6904, 1, 1636422521254, 1636422521517, 263, 0, 263, 0, 0, 0
6905, 1, 1636422521297, 1636422521553, 256, 0, 256, 0, 0, 0
6907, 1, 1636422521409, 1636422521669, 260, 0, 260, 0, 0, 0
6908, 1, 1636422521421, 1636422521681, 260, 0, 260, 0, 0, 0
6906, 1, 1636422521493, 1636422521782, 289, 0, 289, 0, 0, 0
6909, 1, 1636422521489, 1636422521785, 296, 0, 296, 0, 0, 0
6911, 1, 1636422521617, 1636422521881, 264, 0, 264, 0, 0, 0
6910, 1, 1636422521621, 1636422521885, 264, 1, 263, 0, 1, 1
6913, 1, 1636422521785, 1636422522053, 268, 0, 268, 0, 0, 0
6914, 1, 1636422521829, 1636422522089, 260, 1, 259, 0, 0, 0
6917, 1, 1636422522021, 1636422522289, 268, 1, 267, 0, 1, 1
6918, 1, 1636422522021, 1636422522289, 268, 1, 267, 0, 0, 0
6916, 1, 1636422522049, 1636422522313, 264, 0, 264, 0, 0, 0
6919, 1, 1636422522057, 1636422522317, 260, 0, 260, 0, 0, 0
6915, 1, 1636422522093, 1636422522366, 273, 0, 273, 0, 0, 0
6920, 1, 1636422522185, 1636422522453, 268, 0, 268, 0, 0, 0
6921, 1, 1636422522225, 1636422522489, 264, 0, 264, 0, 0, 0
6922, 1, 1636422522229, 1636422522510, 281, 0, 281, 0, 0, 0
6923, 1, 1636422522301, 1636422522569, 268, 0, 268, 0, 0, 0
6925, 1, 1636422522410, 1636422522685, 275, 0, 275, 0, 0, 0
6926, 1, 1636422522577, 1636422522846, 269, 1, 268, 0, 0, 0
6927, 1, 1636422522605, 1636422522877, 272, 1, 271, 0, 0, 0
6929, 1, 1636422522761, 1636422523029, 268, 0, 268, 0, 0, 0
6928, 1, 1636422522765, 1636422523033, 268, 0, 268, 0, 0, 0
6930, 1, 1636422522821, 1636422523089, 268, 1, 267, 1, 0, 1
6931, 1, 1636422522821, 1636422523089, 268, 1, 267, 1, 0, 1
6932, 1, 1636422522857, 1636422523121, 264, 0, 264, 0, 0, 0
6934, 1, 1636422523014, 1636422523282, 268, 0, 268, 0, 0, 0
6935, 1, 1636422523041, 1636422523309, 268, 1, 267, 0, 1, 1
6936, 1, 1636422523105, 1636422523377, 272, 1, 271, 0, 0, 0
6937, 1, 1636422523205, 1636422523473, 268, 1, 267, 0, 0, 0
6938, 1, 1636422523389, 1636422523658, 269, 0, 269, 0, 0, 0
6939, 1, 1636422523401, 1636422523673, 272, 0, 272, 0, 0, 0
6941, 1, 1636422523570, 1636422523837, 267, 0, 267, 0, 0, 0
6942, 1, 1636422523622, 1636422523890, 268, 0, 268, 0, 0, 0
6943, 1, 1636422523638, 1636422523906, 268, 0, 268, 0, 0, 0
6944, 1, 1636422523669, 1636422523933, 264, 1, 263, 1, 0, 1
6945, 1, 1636422523805, 1636422524077, 272, 1, 271, 0, 0, 0
6947, 1, 1636422523906, 1636422524177, 271, 0, 271, 0, 0, 0
6948, 1, 1636422524010, 1636422524282, 272, 0, 272, 0, 0, 0
6949, 1, 1636422524197, 1636422524466, 269, 1, 268, 1, 0, 1
6950, 1, 1636422524209, 1636422524481, 272, 1, 271, 1, 0, 1
6951, 1, 1636422524366, 1636422524633, 267, 0, 267, 0, 0, 0
6952, 1, 1636422524398, 1636422524665, 267, 0, 267, 0, 0, 0
6953, 1, 1636422524429, 1636422524697, 268, 1, 267, 1, 0, 1
6955, 1, 1636422524633, 1636422524897, 264, 1, 263, 1, 0, 1
6956, 1, 1636422524697, 1636422524965, 268, 1, 267, 0, 0, 0
6957, 1, 1636422524806, 1636422525069, 263, 0, 263, 0, 0, 0
6959, 1, 1636422525001, 1636422525269, 268, 0, 268, 0, 0, 0
6960, 1, 1636422525150, 1636422525421, 271, 0, 271, 0, 0, 0
6961, 1, 1636422525193, 1636422525461, 268, 1, 267, 0, 0, 0
6962, 1, 1636422525238, 1636422525497, 259, 0, 259, 0, 0, 0
6963, 1, 1636422525398, 1636422525666, 268, 0, 268, 0, 0, 0
6964, 1, 1636422525501, 1636422525769, 268, 1, 267, 0, 0, 0
6965, 1, 1636422525601, 1636422525873, 272, 0, 272, 0, 0, 0
6966, 1, 1636422525833, 1636422526105, 272, 0, 272, 0, 0, 0
6967, 1, 1636422525965, 1636422526229, 264, 0, 264, 0, 0, 0
6968, 1, 1636422526009, 1636422526281, 272, 1, 271, 0, 1, 1
6969, 1, 1636422526037, 1636422526305, 268, 1, 267, 1, 0, 1
6971, 1, 1636422526194, 1636422526490, 296, 0, 296, 0, 0, 0
6972, 1, 1636422526309, 1636422526577, 268, 1, 267, 0, 0, 0
6973, 1, 1636422526417, 1636422526681, 264, 1, 263, 0, 0, 0
6974, 1, 1636422526602, 1636422526869, 267, 0, 267, 0, 0, 0
6976, 1, 1636422526753, 1636422527025, 272, 0, 272, 0, 0, 0
6977, 1, 1636422526789, 1636422527057, 268, 0, 268, 0, 0, 0
6978, 1, 1636422526853, 1636422527117, 264, 1, 263, 0, 0, 0
6979, 1, 1636422527017, 1636422527281, 264, 0, 264, 0, 0, 0
6981, 1, 1636422527214, 1636422527477, 263, 0, 263, 0, 0, 0
6983, 1, 1636422527414, 1636422527682, 268, 0, 268, 0, 0, 0
6984, 1, 1636422527553, 1636422527822, 269, 1, 268, 1, 0, 1
6985, 1, 1636422527610, 1636422527878, 268, 0, 268, 0, 0, 0
6987, 1, 1636422527793, 1636422528061, 268, 1, 267, 1, 0, 1
6988, 1, 1636422528014, 1636422528286, 272, 0, 272, 0, 0, 0
6990, 1, 1636422528370, 1636422528637, 267, 0, 267, 0, 0, 0
6991, 1, 1636422528406, 1636422528674, 268, 0, 268, 0, 0, 0
6992, 1, 1636422528598, 1636422528870, 272, 0, 272, 0, 0, 0
6993, 1, 1636422528814, 1636422529086, 272, 0, 272, 0, 0, 0
6994, 1, 1636422529189, 1636422529454, 265, 0, 265, 0, 0, 0
6995, 1, 1636422529233, 1636422529501, 268, 0, 268, 0, 0, 0
6996, 1, 1636422529410, 1636422529678, 268, 0, 268, 0, 0, 0
6998, 1, 1636422529625, 1636422529898, 273, 1, 272, 0, 0, 0
6999, 1, 1636422529954, 1636422530222, 268, 0, 268, 0, 0, 0
7000, 1, 1636422530005, 1636422530273, 268, 1, 267, 0, 0, 0
7001, 1, 1636422530218, 1636422530486, 268, 0, 268, 0, 0, 0
7003, 1, 1636422530761, 1636422531026, 265, 0, 265, 0, 0, 0
7004, 1, 1636422530809, 1636422531073, 264, 0, 264, 0, 0, 0
7005, 1, 1636422530906, 1636422531213, 307, 0, 307, 0, 0, 0
7007, 1, 1636422531389, 1636422531677, 288, 1, 287, 0, 0, 0
7008, 1, 1636422531589, 1636422531862, 273, 0, 273, 0, 0, 0
7010, 1, 1636422531865, 1636422532134, 269, 0, 269, 0, 0, 0
7011, 1, 1636422531941, 1636422532210, 269, 1, 268, 1, 0, 1
7012, 1, 1636422532133, 1636422532442, 309, 1, 308, 1, 0, 1
7014, 1, 1636422532578, 1636422532846, 268, 0, 268, 0, 0, 0
7015, 1, 1636422532649, 1636422532917, 268, 1, 267, 1, 0, 1
7017, 1, 1636422532905, 1636422533178, 273, 1, 272, 0, 0, 0
7019, 1, 1636422533334, 1636422533602, 268, 0, 268, 0, 0, 0
7020, 1, 1636422533478, 1636422533745, 267, 0, 267, 0, 0, 0
7021, 1, 1636422533701, 1636422533970, 269, 1, 268, 0, 0, 0
7024, 1, 1636422534138, 1636422534406, 268, 0, 268, 0, 0, 0
7023, 1, 1636422534145, 1636422534414, 269, 0, 269, 0, 0, 0
7025, 1, 1636422534253, 1636422534522, 269, 1, 268, 0, 0, 0
7027, 1, 1636422534773, 1636422535045, 272, 1, 271, 0, 1, 1
7028, 1, 1636422534846, 1636422535133, 287, 0, 287, 0, 0, 0
7029, 1, 1636422534953, 1636422535222, 269, 0, 269, 0, 0, 0
7031, 1, 1636422535301, 1636422535570, 269, 1, 268, 0, 0, 0
7032, 1, 1636422535485, 1636422535754, 269, 1, 268, 1, 0, 1
7033, 1, 1636422535649, 1636422535917, 268, 1, 267, 0, 0, 0
7034, 1, 1636422535729, 1636422535994, 265, 1, 264, 1, 0, 1
7035, 1, 1636422536013, 1636422536321, 308, 1, 307, 0, 0, 0
7036, 1, 1636422536321, 1636422536594, 273, 1, 272, 0, 1, 1
7038, 1, 1636422536461, 1636422536730, 269, 1, 268, 1, 0, 1
7037, 1, 1636422536498, 1636422536798, 300, 0, 300, 0, 0, 0
7040, 1, 1636422536798, 1636422537065, 267, 0, 267, 0, 0, 0
7041, 1, 1636422537061, 1636422537334, 273, 0, 273, 0, 0, 0
7042, 1, 1636422537093, 1636422537362, 269, 1, 268, 0, 0, 0
7043, 1, 1636422537237, 1636422537505, 268, 1, 267, 1, 0, 1
7045, 1, 1636422537413, 1636422537681, 268, 1, 267, 0, 0, 0
7046, 1, 1636422537593, 1636422537862, 269, 1, 268, 1, 0, 1
7047, 1, 1636422537610, 1636422537881, 271, 0, 271, 0, 0, 0
7048, 1, 1636422537773, 1636422538041, 268, 1, 267, 1, 0, 1
7050, 1, 1636422537949, 1636422538253, 304, 1, 303, 0, 1, 1
7051, 1, 1636422538014, 1636422538282, 268, 0, 268, 0, 0, 0
7052, 1, 1636422538118, 1636422538386, 268, 0, 268, 0, 0, 0
7053, 1, 1636422538301, 1636422538569, 268, 1, 267, 0, 0, 0
7055, 1, 1636422538514, 1636422538782, 268, 0, 268, 0, 0, 0
7056, 1, 1636422538573, 1636422538841, 268, 1, 267, 0, 1, 1
7057, 1, 1636422538657, 1636422538929, 272, 1, 271, 1, 0, 1
7058, 1, 1636422538829, 1636422539098, 269, 0, 269, 0, 0, 0
7059, 1, 1636422538917, 1636422539185, 268, 1, 267, 0, 1, 1
7060, 1, 1636422539098, 1636422539365, 267, 0, 267, 0, 0, 0
7061, 1, 1636422539225, 1636422539490, 265, 1, 264, 1, 0, 1
7062, 1, 1636422539402, 1636422539670, 268, 0, 268, 0, 0, 0
7063, 1, 1636422539497, 1636422539765, 268, 1, 267, 1, 0, 1
7064, 1, 1636422539625, 1636422539894, 269, 1, 268, 0, 1, 1
7066, 1, 1636422539717, 1636422539990, 273, 0, 273, 0, 0, 0
7065, 1, 1636422539749, 1636422540017, 268, 1, 267, 0, 0, 0
7067, 1, 1636422539921, 1636422540186, 265, 1, 264, 0, 0, 0
7068, 1, 1636422540017, 1636422540281, 264, 0, 264, 0, 0, 0
7069, 1, 1636422540185, 1636422540458, 273, 1, 272, 1, 0, 1
7070, 1, 1636422540258, 1636422540545, 287, 0, 287, 0, 0, 0
7071, 1, 1636422540461, 1636422540729, 268, 1, 267, 0, 1, 1
7072, 1, 1636422540505, 1636422540773, 268, 0, 268, 0, 0, 0
7075, 1, 1636422540717, 1636422540986, 269, 1, 268, 0, 1, 1
7074, 1, 1636422540721, 1636422540993, 272, 1, 271, 0, 0, 0
7076, 1, 1636422540825, 1636422541093, 268, 0, 268, 0, 0, 0
7077, 1, 1636422540985, 1636422541249, 264, 1, 263, 0, 1, 1
7079, 1, 1636422541237, 1636422541505, 268, 1, 267, 0, 0, 0
7080, 1, 1636422541266, 1636422541534, 268, 0, 268, 0, 0, 0
7081, 1, 1636422541322, 1636422541590, 268, 0, 268, 0, 0, 0
7082, 1, 1636422541425, 1636422541729, 304, 1, 303, 1, 0, 1
7083, 1, 1636422541553, 1636422541822, 269, 0, 269, 0, 0, 0
7085, 1, 1636422541790, 1636422542062, 272, 0, 272, 0, 0, 0
7086, 1, 1636422541901, 1636422542173, 272, 1, 271, 0, 0, 0
7087, 1, 1636422542025, 1636422542294, 269, 1, 268, 0, 0, 0
7089, 1, 1636422542077, 1636422542345, 268, 1, 267, 0, 1, 1
7090, 1, 1636422542210, 1636422542497, 287, 0, 287, 0, 0, 0
7091, 1, 1636422542317, 1636422542585, 268, 1, 267, 0, 1, 1
7088, 1, 1636422542317, 1636422542589, 272, 1, 271, 1, 0, 1
7092, 1, 1636422542601, 1636422542869, 268, 0, 268, 0, 0, 0
7094, 1, 1636422542673, 1636422542942, 269, 1, 268, 1, 0, 1
7095, 1, 1636422542841, 1636422543109, 268, 0, 268, 0, 0, 0
7093, 1, 1636422542873, 1636422543137, 264, 1, 263, 0, 1, 1
7096, 1, 1636422542873, 1636422543145, 272, 0, 272, 0, 0, 0
7099, 1, 1636422543017, 1636422543301, 284, 1, 283, 0, 0, 0
7098, 1, 1636422543001, 1636422543301, 300, 1, 299, 0, 1, 1
7100, 1, 1636422543141, 1636422543409, 268, 0, 268, 0, 0, 0
7101, 1, 1636422543413, 1636422543689, 276, 1, 275, 0, 0, 0
7103, 1, 1636422543533, 1636422543806, 273, 0, 273, 0, 0, 0
7104, 1, 1636422543565, 1636422543869, 304, 1, 303, 0, 1, 1
7105, 1, 1636422543642, 1636422543909, 267, 0, 267, 0, 0, 0
7106, 1, 1636422543673, 1636422543953, 280, 1, 279, 1, 0, 1
7107, 1, 1636422543721, 1636422543989, 268, 1, 267, 0, 0, 0
7110, 1, 1636422544129, 1636422544397, 268, 1, 267, 1, 0, 1
7111, 1, 1636422544165, 1636422544433, 268, 0, 268, 0, 0, 0
7112, 1, 1636422544274, 1636422544562, 288, 0, 288, 0, 0, 0
7113, 1, 1636422544294, 1636422544562, 268, 0, 268, 0, 0, 0
7115, 1, 1636422544473, 1636422544741, 268, 0, 268, 0, 0, 0
7116, 1, 1636422544565, 1636422544833, 268, 1, 267, 0, 0, 0
7117, 1, 1636422544825, 1636422545097, 272, 0, 272, 0, 0, 0
7118, 1, 1636422544849, 1636422545117, 268, 0, 268, 0, 0, 0
7119, 1, 1636422545001, 1636422545269, 268, 0, 268, 0, 0, 0
7120, 1, 1636422545089, 1636422545354, 265, 1, 264, 0, 1, 1
7121, 1, 1636422545133, 1636422545401, 268, 0, 268, 0, 0, 0
7122, 1, 1636422545286, 1636422545549, 263, 0, 263, 0, 0, 0
7124, 1, 1636422545321, 1636422545585, 264, 1, 263, 0, 0, 0
7123, 1, 1636422545345, 1636422545614, 269, 1, 268, 1, 0, 1
7125, 1, 1636422545533, 1636422545798, 265, 0, 265, 0, 0, 0
7126, 1, 1636422545645, 1636422545914, 269, 1, 268, 0, 0, 0
7128, 1, 1636422545877, 1636422546142, 265, 1, 264, 0, 1, 1
7129, 1, 1636422545901, 1636422546166, 265, 0, 265, 0, 0, 0
7130, 1, 1636422546069, 1636422546337, 268, 1, 267, 0, 0, 0
7132, 1, 1636422546121, 1636422546385, 264, 1, 263, 0, 0, 0
7134, 1, 1636422546493, 1636422546761, 268, 1, 267, 0, 0, 0
7135, 1, 1636422546669, 1636422546937, 268, 1, 267, 0, 1, 1
7136, 1, 1636422546709, 1636422546969, 260, 1, 259, 1, 0, 1
7137, 1, 1636422546841, 1636422547109, 268, 0, 268, 0, 0, 0
7139, 1, 1636422546922, 1636422547190, 268, 0, 268, 0, 0, 0
7140, 1, 1636422547290, 1636422547557, 267, 0, 267, 0, 0, 0
7141, 1, 1636422547469, 1636422547742, 273, 1, 272, 0, 1, 1
7142, 1, 1636422547554, 1636422547817, 263, 0, 263, 0, 0, 0
7144, 1, 1636422547565, 1636422547833, 268, 1, 267, 0, 0, 0
7145, 1, 1636422547726, 1636422548009, 283, 0, 283, 0, 0, 0
7146, 1, 1636422548053, 1636422548317, 264, 1, 263, 0, 0, 0
7147, 1, 1636422548177, 1636422548450, 273, 1, 272, 0, 1, 1
7148, 1, 1636422548273, 1636422548537, 264, 1, 263, 0, 0, 0
7149, 1, 1636422548277, 1636422548545, 268, 0, 268, 0, 0, 0
7150, 1, 1636422548378, 1636422548646, 268, 0, 268, 0, 0, 0
7151, 1, 1636422548537, 1636422548802, 265, 1, 264, 0, 0, 0
7152, 1, 1636422548702, 1636422548969, 267, 0, 267, 0, 0, 0
7153, 1, 1636422548865, 1636422549133, 268, 0, 268, 0, 0, 0
7154, 1, 1636422548901, 1636422549174, 273, 0, 273, 0, 0, 0
7156, 1, 1636422549081, 1636422549353, 272, 1, 271, 0, 0, 0
7157, 1, 1636422549165, 1636422549433, 268, 1, 267, 1, 0, 1
7159, 1, 1636422549425, 1636422549694, 269, 1, 268, 0, 0, 0
7160, 1, 1636422549674, 1636422549941, 267, 0, 267, 0, 0, 0
7163, 1, 1636422549958, 1636422550234, 276, 0, 276, 0, 0, 0
7166, 1, 1636422550762, 1636422551034, 272, 0, 272, 0, 0, 0
7167, 1, 1636422550813, 1636422551106, 293, 0, 293, 0, 0, 0
7168, 1, 1636422551362, 1636422551633, 271, 0, 271, 0, 0, 0
7169, 1, 1636422551525, 1636422551797, 272, 1, 271, 0, 0, 0
7170, 1, 1636422551602, 1636422551873, 271, 0, 271, 0, 0, 0
7171, 1, 1636422551945, 1636422552214, 269, 1, 268, 0, 0, 0
7172, 1, 1636422552085, 1636422552357, 272, 1, 271, 0, 0, 0
7174, 1, 1636422552370, 1636422552642, 272, 0, 272, 0, 0, 0
7175, 1, 1636422552670, 1636422552938, 268, 0, 268, 0, 0, 0
7177, 1, 1636422553186, 1636422553458, 272, 0, 272, 0, 0, 0
7180, 1, 1636422553701, 1636422553970, 269, 1, 268, 0, 0, 0
7181, 1, 1636422554005, 1636422554273, 268, 0, 268, 0, 0, 0
7182, 1, 1636422554114, 1636422554382, 268, 0, 268, 0, 0, 0
7183, 1, 1636422554226, 1636422554498, 272, 0, 272, 0, 0, 0
7184, 1, 1636422554417, 1636422554686, 269, 0, 269, 0, 0, 0
7185, 1, 1636422554737, 1636422555001, 264, 0, 264, 0, 0, 0
7186, 1, 1636422554782, 1636422555049, 267, 0, 267, 0, 0, 0
7187, 1, 1636422554829, 1636422555097, 268, 0, 268, 0, 0, 0
7188, 1, 1636422554933, 1636422555201, 268, 1, 267, 0, 0, 0
7189, 1, 1636422555213, 1636422555481, 268, 1, 267, 0, 0, 0
7190, 1, 1636422555454, 1636422555721, 267, 0, 267, 0, 0, 0
7191, 1, 1636422555581, 1636422555850, 269, 1, 268, 1, 0, 1
7193, 1, 1636422555725, 1636422555993, 268, 1, 267, 0, 0, 0
7194, 1, 1636422556037, 1636422556306, 269, 0, 269, 0, 0, 0
7195, 1, 1636422556074, 1636422556385, 311, 0, 311, 0, 0, 0
7198, 1, 1636422556389, 1636422556658, 269, 1, 268, 0, 0, 0
7197, 1, 1636422556389, 1636422556658, 269, 1, 268, 1, 0, 1
7199, 1, 1636422556541, 1636422556809, 268, 1, 267, 0, 1, 1
7200, 1, 1636422556650, 1636422556929, 279, 0, 279, 0, 0, 0
7201, 1, 1636422556793, 1636422557061, 268, 0, 268, 0, 0, 0
7203, 1, 1636422557093, 1636422557362, 269, 0, 269, 0, 0, 0
7204, 1, 1636422557197, 1636422557465, 268, 1, 267, 0, 0, 0
7205, 1, 1636422557201, 1636422557469, 268, 0, 268, 0, 0, 0
7207, 1, 1636422557369, 1636422557646, 277, 0, 277, 0, 0, 0
7209, 1, 1636422557814, 1636422558086, 272, 0, 272, 0, 0, 0
7210, 1, 1636422557889, 1636422558158, 269, 1, 268, 1, 0, 1
7211, 1, 1636422557917, 1636422558186, 269, 0, 269, 0, 0, 0
7212, 1, 1636422557997, 1636422558266, 269, 1, 268, 0, 0, 0
7213, 1, 1636422558181, 1636422558457, 276, 0, 276, 0, 0, 0
7214, 1, 1636422558542, 1636422558810, 268, 0, 268, 0, 0, 0
7215, 1, 1636422558710, 1636422558978, 268, 0, 268, 0, 0, 0
7216, 1, 1636422558726, 1636422558993, 267, 0, 267, 0, 0, 0
7218, 1, 1636422558969, 1636422559238, 269, 0, 269, 0, 0, 0
7219, 1, 1636422559389, 1636422559657, 268, 1, 267, 0, 0, 0
7220, 1, 1636422559393, 1636422559662, 269, 0, 269, 0, 0, 0
7222, 1, 1636422559513, 1636422559782, 269, 0, 269, 0, 0, 0
7223, 1, 1636422559669, 1636422559942, 273, 0, 273, 0, 0, 0
7224, 1, 1636422559761, 1636422560034, 273, 0, 273, 0, 0, 0
7225, 1, 1636422560053, 1636422560326, 273, 1, 272, 0, 1, 1
7226, 1, 1636422560105, 1636422560381, 276, 0, 276, 0, 0, 0
7228, 1, 1636422560145, 1636422560414, 269, 0, 269, 0, 0, 0
7227, 1, 1636422560201, 1636422560510, 309, 0, 309, 0, 0, 0
7229, 1, 1636422560337, 1636422560598, 261, 0, 261, 0, 0, 0
7230, 1, 1636422560377, 1636422560645, 268, 0, 268, 0, 0, 0
7231, 1, 1636422560557, 1636422560825, 268, 0, 268, 0, 0, 0
7232, 1, 1636422560557, 1636422560825, 268, 0, 268, 0, 0, 0
7234, 1, 1636422560737, 1636422561005, 268, 1, 267, 1, 0, 1
7233, 1, 1636422560773, 1636422561041, 268, 1, 267, 0, 0, 0
7236, 1, 1636422560909, 1636422561177, 268, 0, 268, 0, 0, 0
7237, 1, 1636422560937, 1636422561205, 268, 1, 267, 1, 0, 1
7235, 1, 1636422560937, 1636422561205, 268, 1, 267, 0, 0, 0
7238, 1, 1636422561097, 1636422561365, 268, 1, 267, 0, 0, 0
7239, 1, 1636422561161, 1636422561430, 269, 1, 268, 1, 0, 1
7240, 1, 1636422561269, 1636422561537, 268, 0, 268, 0, 0, 0
7241, 1, 1636422561361, 1636422561633, 272, 1, 271, 0, 1, 1
7242, 1, 1636422561489, 1636422561757, 268, 1, 267, 0, 0, 0
7243, 1, 1636422561554, 1636422561821, 267, 0, 267, 0, 0, 0
7244, 1, 1636422561689, 1636422561953, 264, 1, 263, 0, 1, 1
7246, 1, 1636422561726, 1636422561994, 268, 0, 268, 0, 0, 0
7247, 1, 1636422561909, 1636422562174, 265, 1, 264, 0, 0, 0
7245, 1, 1636422561961, 1636422562229, 268, 0, 268, 0, 0, 0
7248, 1, 1636422561974, 1636422562245, 271, 0, 271, 0, 0, 0
7249, 1, 1636422562085, 1636422562390, 305, 1, 304, 0, 1, 1
7250, 1, 1636422562158, 1636422562425, 267, 0, 267, 0, 0, 0
7251, 1, 1636422562301, 1636422562570, 269, 0, 269, 0, 0, 0
7253, 1, 1636422562501, 1636422562766, 265, 0, 265, 0, 0, 0
7254, 1, 1636422562545, 1636422562813, 268, 0, 268, 0, 0, 0
7252, 1, 1636422562570, 1636422562841, 271, 0, 271, 0, 0, 0
7256, 1, 1636422562661, 1636422562941, 280, 0, 280, 0, 0, 0
7257, 1, 1636422562697, 1636422562965, 268, 1, 267, 0, 0, 0
7259, 1, 1636422562881, 1636422563145, 264, 1, 263, 0, 1, 1
7260, 1, 1636422562981, 1636422563249, 268, 1, 267, 0, 0, 0
7261, 1, 1636422563098, 1636422563365, 267, 0, 267, 0, 0, 0
7262, 1, 1636422563197, 1636422563469, 272, 0, 272, 0, 0, 0
7265, 1, 1636422563345, 1636422563617, 272, 0, 272, 0, 0, 0
7266, 1, 1636422563385, 1636422563653, 268, 0, 268, 0, 0, 0
7267, 1, 1636422563529, 1636422563797, 268, 1, 267, 1, 0, 1
7269, 1, 1636422563673, 1636422563937, 264, 0, 264, 0, 0, 0
7271, 1, 1636422563761, 1636422564025, 264, 1, 263, 0, 0, 0
7270, 1, 1636422563785, 1636422564049, 264, 0, 264, 0, 0, 0
7273, 1, 1636422563918, 1636422564189, 271, 0, 271, 0, 0, 0
7274, 1, 1636422564150, 1636422564421, 271, 0, 271, 0, 0, 0
7275, 1, 1636422564181, 1636422564450, 269, 1, 268, 1, 0, 1
7276, 1, 1636422564309, 1636422564578, 269, 1, 268, 0, 0, 0
7277, 1, 1636422564462, 1636422564730, 268, 0, 268, 0, 0, 0
7278, 1, 1636422564513, 1636422564781, 268, 1, 267, 1, 0, 1
7279, 1, 1636422564549, 1636422564817, 268, 1, 267, 1, 0, 1
7280, 1, 1636422564730, 1636422564997, 267, 0, 267, 0, 0, 0
7281, 1, 1636422564946, 1636422565214, 268, 0, 268, 0, 0, 0
7282, 1, 1636422564961, 1636422565233, 272, 0, 272, 0, 0, 0
7283, 1, 1636422565089, 1636422565353, 264, 0, 264, 0, 0, 0
7284, 1, 1636422565269, 1636422565538, 269, 1, 268, 0, 0, 0
7285, 1, 1636422565333, 1636422565601, 268, 0, 268, 0, 0, 0
7286, 1, 1636422565357, 1636422565630, 273, 1, 272, 0, 0, 0
7287, 1, 1636422565517, 1636422565785, 268, 0, 268, 0, 0, 0
7288, 1, 1636422565734, 1636422566001, 267, 0, 267, 0, 0, 0
7289, 1, 1636422565781, 1636422566049, 268, 0, 268, 0, 0, 0
7290, 1, 1636422565893, 1636422566158, 265, 1, 264, 0, 1, 1
7291, 1, 1636422565958, 1636422566230, 272, 0, 272, 0, 0, 0
7292, 1, 1636422566062, 1636422566330, 268, 0, 268, 0, 0, 0
7293, 1, 1636422566117, 1636422566393, 276, 0, 276, 0, 0, 0
7294, 1, 1636422566158, 1636422566422, 264, 0, 264, 0, 0, 0
7295, 1, 1636422566306, 1636422566574, 268, 0, 268, 0, 0, 0
7297, 1, 1636422566533, 1636422566805, 272, 1, 271, 0, 0, 0
7296, 1, 1636422566570, 1636422566857, 287, 0, 287, 0, 0, 0
7298, 1, 1636422566545, 1636422566857, 312, 1, 311, 0, 0, 0
7299, 1, 1636422566665, 1636422566941, 276, 1, 275, 0, 0, 0
7300, 1, 1636422566705, 1636422566973, 268, 1, 267, 0, 0, 0
7301, 1, 1636422566901, 1636422567162, 261, 0, 261, 0, 0, 0
7302, 1, 1636422566909, 1636422567173, 264, 0, 264, 0, 0, 0
7303, 1, 1636422566961, 1636422567229, 268, 0, 268, 0, 0, 0
7305, 1, 1636422567105, 1636422567377, 272, 0, 272, 0, 0, 0
7304, 1, 1636422567117, 1636422567386, 269, 0, 269, 0, 0, 0
7306, 1, 1636422567281, 1636422567550, 269, 1, 268, 0, 1, 1
7308, 1, 1636422567373, 1636422567649, 276, 1, 275, 1, 0, 1
7307, 1, 1636422567373, 1636422567653, 280, 1, 279, 0, 0, 0
7309, 1, 1636422567490, 1636422567750, 260, 0, 260, 0, 0, 0
7310, 1, 1636422567561, 1636422567829, 268, 1, 267, 0, 1, 1
7311, 1, 1636422567649, 1636422567913, 264, 0, 264, 0, 0, 0
7312, 1, 1636422567697, 1636422567961, 264, 0, 264, 0, 0, 0
7313, 1, 1636422567693, 1636422567965, 272, 1, 271, 0, 0, 0
7315, 1, 1636422567850, 1636422568117, 267, 0, 267, 0, 0, 0
7317, 1, 1636422567909, 1636422568173, 264, 1, 263, 0, 0, 0
7314, 1, 1636422567917, 1636422568189, 272, 0, 272, 0, 0, 0
7316, 1, 1636422567917, 1636422568193, 276, 1, 275, 0, 0, 0
7318, 1, 1636422568101, 1636422568366, 265, 0, 265, 0, 0, 0
7319, 1, 1636422568149, 1636422568417, 268, 0, 268, 0, 0, 0
7320, 1, 1636422568153, 1636422568417, 264, 0, 264, 0, 0, 0
7321, 1, 1636422568265, 1636422568533, 268, 1, 267, 0, 1, 1
7322, 1, 1636422568305, 1636422568573, 268, 1, 267, 0, 0, 0
7323, 1, 1636422568346, 1636422568617, 271, 0, 271, 0, 0, 0
7324, 1, 1636422568462, 1636422568725, 263, 0, 263, 0, 0, 0
7325, 1, 1636422568505, 1636422568774, 269, 1, 268, 1, 0, 1
7327, 1, 1636422568633, 1636422568925, 292, 0, 292, 0, 0, 0
7329, 1, 1636422568698, 1636422568961, 263, 0, 263, 0, 0, 0
7330, 1, 1636422568881, 1636422569157, 276, 1, 275, 0, 1, 1
7331, 1, 1636422568949, 1636422569217, 268, 0, 268, 0, 0, 0
7332, 1, 1636422568961, 1636422569233, 272, 1, 271, 0, 1, 1
7334, 1, 1636422569066, 1636422569333, 267, 0, 267, 0, 0, 0
7333, 1, 1636422569105, 1636422569373, 268, 0, 268, 0, 0, 0
7337, 1, 1636422569293, 1636422569557, 264, 0, 264, 0, 0, 0
7338, 1, 1636422569302, 1636422569566, 264, 0, 264, 0, 0, 0
7339, 1, 1636422569446, 1636422569713, 267, 0, 267, 0, 0, 0
7340, 1, 1636422569537, 1636422569809, 272, 0, 272, 0, 0, 0
7341, 1, 1636422569677, 1636422569941, 264, 0, 264, 0, 0, 0
7343, 1, 1636422569749, 1636422570014, 265, 0, 265, 0, 0, 0
7344, 1, 1636422569794, 1636422570061, 267, 0, 267, 0, 0, 0
7345, 1, 1636422569809, 1636422570081, 272, 1, 271, 0, 1, 1
7346, 1, 1636422569841, 1636422570121, 280, 0, 280, 0, 0, 0
7347, 1, 1636422570093, 1636422570366, 273, 1, 272, 0, 0, 0
7348, 1, 1636422570106, 1636422570369, 263, 0, 263, 0, 0, 0
7349, 1, 1636422570230, 1636422570501, 271, 0, 271, 0, 0, 0
7350, 1, 1636422570297, 1636422570566, 269, 1, 268, 1, 0, 1
7351, 1, 1636422570465, 1636422570734, 269, 1, 268, 0, 0, 0
7352, 1, 1636422570521, 1636422570785, 264, 1, 263, 1, 0, 1
7353, 1, 1636422570537, 1636422570806, 269, 1, 268, 0, 1, 1
7354, 1, 1636422570598, 1636422570865, 267, 0, 267, 0, 0, 0
7355, 1, 1636422570653, 1636422570921, 268, 1, 267, 1, 0, 1
7356, 1, 1636422570889, 1636422571157, 268, 1, 267, 0, 1, 1
7357, 1, 1636422570901, 1636422571165, 264, 0, 264, 0, 0, 0
7358, 1, 1636422571022, 1636422571289, 267, 0, 267, 0, 0, 0
7359, 1, 1636422571073, 1636422571350, 277, 1, 276, 0, 1, 1
7360, 1, 1636422571282, 1636422571549, 267, 0, 267, 0, 0, 0
7362, 1, 1636422571337, 1636422571610, 273, 1, 272, 1, 0, 1
7363, 1, 1636422571397, 1636422571665, 268, 0, 268, 0, 0, 0
7364, 1, 1636422571453, 1636422571721, 268, 1, 267, 0, 1, 1
7365, 1, 1636422571690, 1636422571958, 268, 0, 268, 0, 0, 0
7366, 1, 1636422571701, 1636422571973, 272, 1, 271, 0, 0, 0
7367, 1, 1636422571806, 1636422572073, 267, 0, 267, 0, 0, 0
7368, 1, 1636422571882, 1636422572149, 267, 0, 267, 0, 0, 0
7369, 1, 1636422572065, 1636422572333, 268, 1, 267, 0, 0, 0
7370, 1, 1636422572138, 1636422572405, 267, 0, 267, 0, 0, 0
7371, 1, 1636422572193, 1636422572461, 268, 1, 267, 0, 1, 1
7372, 1, 1636422572265, 1636422572533, 268, 0, 268, 0, 0, 0
7374, 1, 1636422572501, 1636422572801, 300, 0, 300, 0, 0, 0
7375, 1, 1636422572621, 1636422572893, 272, 0, 272, 0, 0, 0
7376, 1, 1636422572717, 1636422572985, 268, 0, 268, 0, 0, 0
7377, 1, 1636422572889, 1636422573153, 264, 0, 264, 0, 0, 0
7379, 1, 1636422572933, 1636422573209, 276, 1, 275, 0, 0, 0
7380, 1, 1636422572977, 1636422573281, 304, 0, 304, 0, 0, 0
7382, 1, 1636422573045, 1636422573329, 284, 1, 283, 0, 1, 1
7381, 1, 1636422573065, 1636422573369, 304, 1, 303, 0, 1, 1
7383, 1, 1636422573325, 1636422573590, 265, 1, 264, 0, 0, 0
7384, 1, 1636422573417, 1636422573685, 268, 0, 268, 0, 0, 0
7385, 1, 1636422573490, 1636422573761, 271, 0, 271, 0, 0, 0
7387, 1, 1636422573590, 1636422573853, 263, 0, 263, 0, 0, 0
7388, 1, 1636422573701, 1636422573966, 265, 0, 265, 0, 0, 0
7391, 1, 1636422573789, 1636422574061, 272, 1, 271, 0, 1, 1
7392, 1, 1636422573841, 1636422574113, 272, 1, 271, 1, 0, 1
7390, 1, 1636422573841, 1636422574114, 273, 1, 272, 0, 1, 1
7389, 1, 1636422573857, 1636422574125, 268, 0, 268, 0, 0, 0
7393, 1, 1636422573925, 1636422574197, 272, 0, 272, 0, 0, 0
7394, 1, 1636422574129, 1636422574401, 272, 0, 272, 0, 0, 0
7395, 1, 1636422574197, 1636422574465, 268, 1, 267, 1, 0, 1
7396, 1, 1636422574233, 1636422574497, 264, 0, 264, 0, 0, 0
7398, 1, 1636422574313, 1636422574581, 268, 1, 267, 0, 0, 0
7399, 1, 1636422574469, 1636422574733, 264, 0, 264, 0, 0, 0
7397, 1, 1636422574465, 1636422574737, 272, 1, 271, 1, 0, 1
7402, 1, 1636422574593, 1636422574865, 272, 0, 272, 0, 0, 0
7403, 1, 1636422574625, 1636422574893, 268, 1, 267, 0, 1, 1
7404, 1, 1636422574649, 1636422574921, 272, 1, 271, 0, 0, 0
7405, 1, 1636422574909, 1636422575178, 269, 1, 268, 0, 0, 0
7406, 1, 1636422574929, 1636422575198, 269, 0, 269, 0, 0, 0
7407, 1, 1636422575021, 1636422575290, 269, 0, 269, 0, 0, 0
7408, 1, 1636422575137, 1636422575405, 268, 0, 268, 0, 0, 0
7410, 1, 1636422575269, 1636422575537, 268, 1, 267, 0, 0, 0
7411, 1, 1636422575393, 1636422575661, 268, 1, 267, 0, 0, 0
7412, 1, 1636422575425, 1636422575694, 269, 1, 268, 0, 0, 0
7413, 1, 1636422575457, 1636422575725, 268, 1, 267, 0, 1, 1
7416, 1, 1636422575813, 1636422576085, 272, 1, 271, 0, 0, 0
7417, 1, 1636422575906, 1636422576173, 267, 0, 267, 0, 0, 0
7418, 1, 1636422576073, 1636422576341, 268, 0, 268, 0, 0, 0
7419, 1, 1636422576197, 1636422576465, 268, 1, 267, 1, 0, 1
7420, 1, 1636422576233, 1636422576501, 268, 1, 267, 0, 0, 0
7421, 1, 1636422576265, 1636422576534, 269, 1, 268, 1, 0, 1
7422, 1, 1636422576618, 1636422576885, 267, 0, 267, 0, 0, 0
7423, 1, 1636422576702, 1636422576969, 267, 0, 267, 0, 0, 0
7424, 1, 1636422576881, 1636422577149, 268, 1, 267, 0, 1, 1
7425, 1, 1636422577013, 1636422577278, 265, 0, 265, 0, 0, 0
7427, 1, 1636422577057, 1636422577325, 268, 1, 267, 1, 0, 1
7428, 1, 1636422577417, 1636422577686, 269, 0, 269, 0, 0, 0
7429, 1, 1636422577485, 1636422577757, 272, 0, 272, 0, 0, 0
7430, 1, 1636422577682, 1636422577949, 267, 0, 267, 0, 0, 0
7431, 1, 1636422577809, 1636422578077, 268, 1, 267, 0, 0, 0
7433, 1, 1636422578230, 1636422578497, 267, 0, 267, 0, 0, 0
7434, 1, 1636422578281, 1636422578550, 269, 0, 269, 0, 0, 0
7436, 1, 1636422578649, 1636422578917, 268, 1, 267, 0, 1, 1
7437, 1, 1636422578926, 1636422579233, 307, 0, 307, 0, 0, 0
7438, 1, 1636422578962, 1636422579234, 272, 0, 272, 0, 0, 0
7439, 1, 1636422579057, 1636422579325, 268, 0, 268, 0, 0, 0
7440, 1, 1636422579121, 1636422579389, 268, 1, 267, 1, 0, 1
7442, 1, 1636422579421, 1636422579694, 273, 1, 272, 0, 0, 0
7441, 1, 1636422579425, 1636422579694, 269, 0, 269, 0, 0, 0
7443, 1, 1636422579465, 1636422579737, 272, 1, 271, 0, 0, 0
7444, 1, 1636422579638, 1636422579909, 271, 0, 271, 0, 0, 0
7447, 1, 1636422579890, 1636422580161, 271, 0, 271, 0, 0, 0
7445, 1, 1636422579913, 1636422580178, 265, 1, 264, 0, 1, 1
7448, 1, 1636422580057, 1636422580325, 268, 0, 268, 0, 0, 0
7449, 1, 1636422580181, 1636422580450, 269, 1, 268, 0, 0, 0
7451, 1, 1636422580205, 1636422580469, 264, 1, 263, 0, 0, 0
7452, 1, 1636422580417, 1636422580690, 273, 0, 273, 0, 0, 0
7450, 1, 1636422580450, 1636422580717, 267, 0, 267, 0, 0, 0
7453, 1, 1636422580573, 1636422580842, 269, 1, 268, 1, 0, 1
7454, 1, 1636422580698, 1636422580965, 267, 0, 267, 0, 0, 0
7455, 1, 1636422580761, 1636422581030, 269, 0, 269, 0, 0, 0
7456, 1, 1636422580934, 1636422581201, 267, 0, 267, 0, 0, 0
7457, 1, 1636422581005, 1636422581273, 268, 0, 268, 0, 0, 0
7458, 1, 1636422581121, 1636422581394, 273, 1, 272, 1, 0, 1
7459, 1, 1636422581217, 1636422581486, 269, 0, 269, 0, 0, 0
7460, 1, 1636422581325, 1636422581593, 268, 0, 268, 0, 0, 0
7461, 1, 1636422581498, 1636422581765, 267, 0, 267, 0, 0, 0
7462, 1, 1636422581545, 1636422581813, 268, 0, 268, 0, 0, 0
7463, 1, 1636422581641, 1636422581906, 265, 1, 264, 0, 0, 0
7464, 1, 1636422581729, 1636422581997, 268, 1, 267, 0, 1, 1
7465, 1, 1636422581789, 1636422582061, 272, 1, 271, 0, 0, 0
7466, 1, 1636422581878, 1636422582146, 268, 0, 268, 0, 0, 0
7467, 1, 1636422582029, 1636422582298, 269, 1, 268, 1, 0, 1
7469, 1, 1636422582298, 1636422582562, 264, 0, 264, 0, 0, 0
7470, 1, 1636422582334, 1636422582613, 279, 0, 279, 0, 0, 0
7471, 1, 1636422582370, 1636422582637, 267, 0, 267, 0, 0, 0
7472, 1, 1636422582577, 1636422582853, 276, 1, 275, 0, 1, 1
7473, 1, 1636422582617, 1636422582889, 272, 0, 272, 0, 0, 0
7475, 1, 1636422582789, 1636422583090, 301, 0, 301, 0, 0, 0
7476, 1, 1636422582817, 1636422583090, 273, 0, 273, 0, 0, 0
7477, 1, 1636422583097, 1636422583365, 268, 0, 268, 0, 0, 0
7478, 1, 1636422583141, 1636422583405, 264, 0, 264, 0, 0, 0
7479, 1, 1636422583185, 1636422583453, 268, 1, 267, 0, 1, 1
7480, 1, 1636422583262, 1636422583534, 272, 0, 272, 0, 0, 0
7481, 1, 1636422583337, 1636422583610, 273, 0, 273, 0, 0, 0
7482, 1, 1636422583377, 1636422583677, 300, 0, 300, 0, 0, 0
7483, 1, 1636422583509, 1636422583777, 268, 1, 267, 1, 0, 1
7484, 1, 1636422583637, 1636422583905, 268, 0, 268, 0, 0, 0
7485, 1, 1636422583854, 1636422584125, 271, 0, 271, 0, 0, 0
7486, 1, 1636422583917, 1636422584190, 273, 1, 272, 0, 0, 0
7487, 1, 1636422583929, 1636422584201, 272, 0, 272, 0, 0, 0
7488, 1, 1636422583965, 1636422584234, 269, 0, 269, 0, 0, 0
7489, 1, 1636422583969, 1636422584237, 268, 0, 268, 0, 0, 0
7490, 1, 1636422584149, 1636422584417, 268, 0, 268, 0, 0, 0
7491, 1, 1636422584170, 1636422584433, 263, 0, 263, 0, 0, 0
7492, 1, 1636422584289, 1636422584581, 292, 1, 291, 1, 0, 1
7493, 1, 1636422584437, 1636422584717, 280, 1, 279, 0, 0, 0
7494, 1, 1636422584581, 1636422584853, 272, 1, 271, 0, 0, 0
7495, 1, 1636422584717, 1636422584989, 272, 0, 272, 0, 0, 0
7496, 1, 1636422584750, 1636422585017, 267, 0, 267, 0, 0, 0
7497, 1, 1636422584757, 1636422585029, 272, 1, 271, 0, 0, 0
7498, 1, 1636422584777, 1636422585049, 272, 1, 271, 0, 0, 0
7499, 1, 1636422584853, 1636422585121, 268, 1, 267, 1, 0, 1
7500, 1, 1636422584886, 1636422585174, 288, 0, 288, 0, 0, 0
7502, 1, 1636422584957, 1636422585261, 304, 1, 303, 0, 1, 1
7501, 1, 1636422584953, 1636422585265, 312, 1, 311, 1, 0, 1
7503, 1, 1636422585089, 1636422585357, 268, 0, 268, 0, 0, 0
7504, 1, 1636422585221, 1636422585485, 264, 0, 264, 0, 0, 0
7505, 1, 1636422585385, 1636422585661, 276, 1, 275, 0, 0, 0
7506, 1, 1636422585441, 1636422585713, 272, 0, 272, 0, 0, 0
7507, 1, 1636422585525, 1636422585817, 292, 1, 291, 0, 1, 1
7511, 1, 1636422585577, 1636422585905, 328, 0, 328, 0, 0, 0
7510, 1, 1636422585562, 1636422585905, 343, 0, 343, 0, 0, 0
7509, 1, 1636422585549, 1636422585910, 361, 1, 360, 0, 0, 0
7508, 1, 1636422585545, 1636422585910, 365, 1, 364, 0, 0, 0
7513, 1, 1636422585821, 1636422586085, 264, 0, 264, 0, 0, 0
7514, 1, 1636422585821, 1636422586097, 276, 1, 275, 0, 0, 0
7515, 1, 1636422585909, 1636422586173, 264, 1, 263, 0, 1, 1
7512, 1, 1636422585909, 1636422586177, 268, 1, 267, 0, 1, 1
7516, 1, 1636422586037, 1636422586305, 268, 0, 268, 0, 0, 0
7517, 1, 1636422586041, 1636422586309, 268, 1, 267, 0, 0, 0
7518, 1, 1636422586041, 1636422586309, 268, 0, 268, 0, 0, 0
7520, 1, 1636422586181, 1636422586449, 268, 0, 268, 0, 0, 0
7519, 1, 1636422586181, 1636422586449, 268, 0, 268, 0, 0, 0
7521, 1, 1636422586309, 1636422586573, 264, 1, 263, 0, 0, 0
7523, 1, 1636422586349, 1636422586621, 272, 1, 271, 0, 0, 0
7522, 1, 1636422586349, 1636422586621, 272, 1, 271, 1, 0, 1
7524, 1, 1636422586357, 1636422586625, 268, 0, 268, 0, 0, 0
7527, 1, 1636422586549, 1636422586817, 268, 1, 267, 1, 0, 1
7526, 1, 1636422586577, 1636422586849, 272, 0, 272, 0, 0, 0
7525, 1, 1636422586625, 1636422586889, 264, 0, 264, 0, 0, 0
7529, 1, 1636422586693, 1636422586961, 268, 1, 267, 0, 1, 1
7530, 1, 1636422586753, 1636422587061, 308, 1, 307, 0, 1, 1
7532, 1, 1636422586849, 1636422587157, 308, 1, 307, 0, 1, 1
7533, 1, 1636422586977, 1636422587245, 268, 0, 268, 0, 0, 0
7534, 1, 1636422586993, 1636422587257, 264, 0, 264, 0, 0, 0
7531, 1, 1636422587065, 1636422587333, 268, 0, 268, 0, 0, 0
7535, 1, 1636422587105, 1636422587374, 269, 1, 268, 0, 0, 0
7537, 1, 1636422587157, 1636422587421, 264, 1, 263, 0, 1, 1
7536, 1, 1636422587153, 1636422587422, 269, 1, 268, 0, 1, 1
7538, 1, 1636422587161, 1636422587429, 268, 0, 268, 0, 0, 0
7539, 1, 1636422587293, 1636422587553, 260, 0, 260, 0, 0, 0
7540, 1, 1636422587329, 1636422587597, 268, 1, 267, 1, 0, 1
7541, 1, 1636422587329, 1636422587598, 269, 1, 268, 0, 1, 1
7542, 1, 1636422587369, 1636422587634, 265, 0, 265, 0, 0, 0
7543, 1, 1636422587505, 1636422587777, 272, 1, 271, 0, 1, 1
7544, 1, 1636422587545, 1636422587813, 268, 0, 268, 0, 0, 0
7545, 1, 1636422587645, 1636422587922, 277, 1, 276, 0, 0, 0
7546, 1, 1636422587730, 1636422587997, 267, 0, 267, 0, 0, 0
7547, 1, 1636422587750, 1636422588017, 267, 0, 267, 0, 0, 0
7548, 1, 1636422587809, 1636422588077, 268, 1, 267, 0, 1, 1
7549, 1, 1636422587901, 1636422588169, 268, 1, 267, 0, 1, 1
7552, 1, 1636422587949, 1636422588217, 268, 0, 268, 0, 0, 0
7550, 1, 1636422587985, 1636422588253, 268, 0, 268, 0, 0, 0
7551, 1, 1636422587989, 1636422588261, 272, 1, 271, 0, 1, 1
7553, 1, 1636422588041, 1636422588305, 264, 1, 263, 0, 0, 0
7554, 1, 1636422588057, 1636422588326, 269, 1, 268, 0, 1, 1
7555, 1, 1636422588161, 1636422588433, 272, 1, 271, 1, 0, 1
7557, 1, 1636422588158, 1636422588434, 276, 0, 276, 0, 0, 0
7558, 1, 1636422588305, 1636422588609, 304, 1, 303, 0, 0, 0
7559, 1, 1636422588341, 1636422588610, 269, 1, 268, 0, 0, 0
7560, 1, 1636422588465, 1636422588737, 272, 0, 272, 0, 0, 0
7561, 1, 1636422588525, 1636422588789, 264, 1, 263, 0, 1, 1
7562, 1, 1636422588569, 1636422588833, 264, 0, 264, 0, 0, 0
7563, 1, 1636422588609, 1636422588873, 264, 1, 263, 1, 0, 1
7564, 1, 1636422588677, 1636422588949, 272, 1, 271, 0, 0, 0
7566, 1, 1636422588741, 1636422589009, 268, 0, 268, 0, 0, 0
7567, 1, 1636422588749, 1636422589017, 268, 0, 268, 0, 0, 0
7568, 1, 1636422588773, 1636422589041, 268, 1, 267, 0, 0, 0
7565, 1, 1636422588789, 1636422589057, 268, 0, 268, 0, 0, 0
7570, 1, 1636422588858, 1636422589125, 267, 0, 267, 0, 0, 0
7571, 1, 1636422588865, 1636422589133, 268, 1, 267, 0, 0, 0
7572, 1, 1636422588977, 1636422589249, 272, 0, 272, 0, 0, 0
7573, 1, 1636422589097, 1636422589365, 268, 1, 267, 0, 0, 0
7574, 1, 1636422589153, 1636422589422, 269, 1, 268, 1, 0, 1
7575, 1, 1636422589261, 1636422589533, 272, 0, 272, 0, 0, 0
7577, 1, 1636422589345, 1636422589613, 268, 1, 267, 0, 1, 1
7578, 1, 1636422589393, 1636422589665, 272, 1, 271, 0, 0, 0
7579, 1, 1636422589473, 1636422589741, 268, 1, 267, 0, 0, 0
7580, 1, 1636422589497, 1636422589757, 260, 0, 260, 0, 0, 0
7581, 1, 1636422589529, 1636422589801, 272, 0, 272, 0, 0, 0
7582, 1, 1636422589561, 1636422589829, 268, 1, 267, 0, 1, 1
7583, 1, 1636422589589, 1636422589885, 296, 1, 295, 0, 0, 0
7585, 1, 1636422589673, 1636422589969, 296, 0, 296, 0, 0, 0
7584, 1, 1636422589653, 1636422589970, 317, 0, 317, 0, 0, 0
7586, 1, 1636422589793, 1636422590061, 268, 0, 268, 0, 0, 0
7587, 1, 1636422589925, 1636422590189, 264, 0, 264, 0, 0, 0
7588, 1, 1636422589969, 1636422590237, 268, 1, 267, 0, 1, 1
7589, 1, 1636422590049, 1636422590321, 272, 1, 271, 1, 0, 1
7590, 1, 1636422590145, 1636422590413, 268, 1, 267, 0, 1, 1
7591, 1, 1636422590153, 1636422590425, 272, 0, 272, 0, 0, 0
7592, 1, 1636422590193, 1636422590465, 272, 0, 272, 0, 0, 0
7593, 1, 1636422590257, 1636422590525, 268, 0, 268, 0, 0, 0
7594, 1, 1636422590281, 1636422590545, 264, 0, 264, 0, 0, 0
7595, 1, 1636422590333, 1636422590597, 264, 0, 264, 0, 0, 0
7596, 1, 1636422590361, 1636422590629, 268, 1, 267, 0, 0, 0
7597, 1, 1636422590377, 1636422590645, 268, 1, 267, 1, 0, 1
7598, 1, 1636422590453, 1636422590721, 268, 1, 267, 0, 0, 0
7599, 1, 1636422590481, 1636422590753, 272, 1, 271, 0, 1, 1
7600, 1, 1636422590565, 1636422590841, 276, 1, 275, 0, 0, 0
7601, 1, 1636422590709, 1636422590981, 272, 0, 272, 0, 0, 0
7602, 1, 1636422590745, 1636422591013, 268, 1, 267, 0, 0, 0
7603, 1, 1636422590849, 1636422591117, 268, 0, 268, 0, 0, 0
7604, 1, 1636422590857, 1636422591121, 264, 0, 264, 0, 0, 0
7605, 1, 1636422590941, 1636422591202, 261, 0, 261, 0, 0, 0
7606, 1, 1636422590993, 1636422591253, 260, 0, 260, 0, 0, 0
7607, 1, 1636422591049, 1636422591317, 268, 0, 268, 0, 0, 0
7608, 1, 1636422591077, 1636422591341, 264, 0, 264, 0, 0, 0
7609, 1, 1636422591137, 1636422591405, 268, 1, 267, 0, 1, 1
7610, 1, 1636422591157, 1636422591429, 272, 1, 271, 0, 0, 0
7611, 1, 1636422591161, 1636422591429, 268, 0, 268, 0, 0, 0
7612, 1, 1636422591265, 1636422591533, 268, 1, 267, 0, 1, 1
7613, 1, 1636422591289, 1636422591557, 268, 1, 267, 1, 0, 1
7614, 1, 1636422591349, 1636422591625, 276, 1, 275, 0, 1, 1
7615, 1, 1636422591509, 1636422591773, 264, 0, 264, 0, 0, 0
7616, 1, 1636422591549, 1636422591821, 272, 0, 272, 0, 0, 0
7617, 1, 1636422591629, 1636422591897, 268, 0, 268, 0, 0, 0
7618, 1, 1636422591637, 1636422591909, 272, 1, 271, 0, 0, 0
7619, 1, 1636422591753, 1636422592017, 264, 1, 263, 0, 0, 0
7620, 1, 1636422591793, 1636422592061, 268, 0, 268, 0, 0, 0
7621, 1, 1636422591841, 1636422592157, 316, 1, 315, 0, 1, 1
7622, 1, 1636422591897, 1636422592169, 272, 1, 271, 0, 0, 0
7623, 1, 1636422591933, 1636422592245, 312, 0, 312, 0, 0, 0
7624, 1, 1636422591965, 1636422592245, 280, 1, 279, 0, 0, 0
7625, 1, 1636422591974, 1636422592245, 271, 0, 271, 0, 0, 0
7626, 1, 1636422592069, 1636422592337, 268, 0, 268, 0, 0, 0
7627, 1, 1636422592105, 1636422592369, 264, 1, 263, 1, 0, 1
7628, 1, 1636422592157, 1636422592425, 268, 1, 267, 1, 0, 1
7629, 1, 1636422592321, 1636422592585, 264, 1, 263, 1, 0, 1
7630, 1, 1636422592341, 1636422592609, 268, 0, 268, 0, 0, 0
7634, 1, 1636422592538, 1636422592805, 267, 0, 267, 0, 0, 0
7636, 1, 1636422592633, 1636422592909, 276, 1, 275, 0, 1, 1
7637, 1, 1636422592705, 1636422592973, 268, 1, 267, 0, 1, 1
7638, 1, 1636422592753, 1636422593025, 272, 0, 272, 0, 0, 0
7640, 1, 1636422592794, 1636422593061, 267, 0, 267, 0, 0, 0
7639, 1, 1636422592794, 1636422593069, 275, 0, 275, 0, 0, 0
7641, 1, 1636422592869, 1636422593141, 272, 0, 272, 0, 0, 0
7642, 1, 1636422592909, 1636422593177, 268, 1, 267, 0, 1, 1
7645, 1, 1636422593113, 1636422593381, 268, 1, 267, 0, 0, 0
7646, 1, 1636422593145, 1636422593413, 268, 0, 268, 0, 0, 0
7647, 1, 1636422593325, 1636422593597, 272, 1, 271, 0, 1, 1
7649, 1, 1636422593494, 1636422593761, 267, 0, 267, 0, 0, 0
7652, 1, 1636422593570, 1636422593838, 268, 0, 268, 0, 0, 0
7653, 1, 1636422593669, 1636422593938, 269, 1, 268, 0, 1, 1
7654, 1, 1636422593697, 1636422593966, 269, 0, 269, 0, 0, 0
7655, 1, 1636422593897, 1636422594165, 268, 0, 268, 0, 0, 0
7656, 1, 1636422593966, 1636422594233, 267, 0, 267, 0, 0, 0
7657, 1, 1636422594130, 1636422594397, 267, 0, 267, 0, 0, 0
7658, 1, 1636422594290, 1636422594557, 267, 0, 267, 0, 0, 0
7659, 1, 1636422594385, 1636422594654, 269, 1, 268, 0, 0, 0
7660, 1, 1636422594470, 1636422594737, 267, 0, 267, 0, 0, 0
7661, 1, 1636422594485, 1636422594758, 273, 1, 272, 0, 0, 0
7662, 1, 1636422594682, 1636422594958, 276, 0, 276, 0, 0, 0
7663, 1, 1636422594761, 1636422595030, 269, 0, 269, 0, 0, 0
7664, 1, 1636422594926, 1636422595198, 272, 0, 272, 0, 0, 0
7665, 1, 1636422595077, 1636422595346, 269, 0, 269, 0, 0, 0
7666, 1, 1636422595178, 1636422595445, 267, 0, 267, 0, 0, 0
7667, 1, 1636422595269, 1636422595541, 272, 1, 271, 0, 0, 0
7669, 1, 1636422595470, 1636422595737, 267, 0, 267, 0, 0, 0
7670, 1, 1636422595577, 1636422595846, 269, 1, 268, 0, 0, 0
7671, 1, 1636422595737, 1636422596001, 264, 1, 263, 0, 0, 0
7672, 1, 1636422595882, 1636422596149, 267, 0, 267, 0, 0, 0
7673, 1, 1636422595961, 1636422596230, 269, 0, 269, 0, 0, 0
7674, 1, 1636422596085, 1636422596353, 268, 1, 267, 0, 1, 1
7676, 1, 1636422596365, 1636422596633, 268, 1, 267, 0, 0, 0
7677, 1, 1636422596537, 1636422596805, 268, 1, 267, 0, 0, 0
7678, 1, 1636422596701, 1636422596973, 272, 1, 271, 0, 1, 1
7679, 1, 1636422596757, 1636422597025, 268, 1, 267, 0, 1, 1
7680, 1, 1636422596866, 1636422597129, 263, 0, 263, 0, 0, 0
7681, 1, 1636422596885, 1636422597154, 269, 0, 269, 0, 0, 0
7682, 1, 1636422597146, 1636422597414, 268, 0, 268, 0, 0, 0
7684, 1, 1636422597493, 1636422597757, 264, 1, 263, 0, 0, 0
7685, 1, 1636422597541, 1636422597809, 268, 0, 268, 0, 0, 0
7686, 1, 1636422597585, 1636422597849, 264, 0, 264, 0, 0, 0
7687, 1, 1636422597701, 1636422597969, 268, 1, 267, 1, 0, 1
7688, 1, 1636422597942, 1636422598209, 267, 0, 267, 0, 0, 0
7689, 1, 1636422598309, 1636422598578, 269, 0, 269, 0, 0, 0
7691, 1, 1636422598374, 1636422598641, 267, 0, 267, 0, 0, 0
7693, 1, 1636422598489, 1636422598757, 268, 1, 267, 0, 0, 0
7694, 1, 1636422598734, 1636422599006, 272, 0, 272, 0, 0, 0
7695, 1, 1636422599101, 1636422599413, 312, 0, 312, 0, 0, 0
7696, 1, 1636422599149, 1636422599417, 268, 0, 268, 0, 0, 0
7697, 1, 1636422599173, 1636422599441, 268, 1, 267, 0, 0, 0
7698, 1, 1636422599274, 1636422599541, 267, 0, 267, 0, 0, 0
7701, 1, 1636422599874, 1636422600146, 272, 0, 272, 0, 0, 0
7702, 1, 1636422599901, 1636422600170, 269, 0, 269, 0, 0, 0
7703, 1, 1636422599990, 1636422600253, 263, 0, 263, 0, 0, 0
7704, 1, 1636422600065, 1636422600333, 268, 0, 268, 0, 0, 0
7705, 1, 1636422600678, 1636422600946, 268, 0, 268, 0, 0, 0
7706, 1, 1636422600698, 1636422600966, 268, 0, 268, 0, 0, 0
7707, 1, 1636422600782, 1636422601050, 268, 0, 268, 0, 0, 0
7708, 1, 1636422600858, 1636422601125, 267, 0, 267, 0, 0, 0
7709, 1, 1636422601465, 1636422601733, 268, 1, 267, 0, 1, 1
7710, 1, 1636422601486, 1636422601753, 267, 0, 267, 0, 0, 0
7711, 1, 1636422601578, 1636422601845, 267, 0, 267, 0, 0, 0
7713, 1, 1636422602257, 1636422602641, 384, 1, 383, 0, 0, 0
7715, 1, 1636422602462, 1636422602725, 263, 0, 263, 0, 0, 0
7716, 1, 1636422602769, 1636422603113, 344, 1, 343, 1, 0, 1
7717, 1, 1636422602769, 1636422603113, 344, 1, 343, 0, 0, 0
7718, 1, 1636422602773, 1636422603125, 352, 0, 352, 0, 0, 0
7719, 1, 1636422602937, 1636422603201, 264, 0, 264, 0, 0, 0
7720, 1, 1636422603073, 1636422603342, 269, 0, 269, 0, 0, 0
7721, 1, 1636422603178, 1636422603481, 303, 0, 303, 0, 0, 0
7723, 1, 1636422603277, 1636422603605, 328, 0, 328, 0, 0, 0
7722, 1, 1636422603246, 1636422603605, 359, 0, 359, 0, 0, 0
7725, 1, 1636422603605, 1636422603869, 264, 0, 264, 0, 0, 0
7724, 1, 1636422603609, 1636422603877, 268, 0, 268, 0, 0, 0
7726, 1, 1636422603609, 1636422603881, 272, 0, 272, 0, 0, 0
7727, 1, 1636422603697, 1636422603969, 272, 1, 271, 0, 0, 0
7728, 1, 1636422603821, 1636422604085, 264, 1, 263, 0, 0, 0
7729, 1, 1636422603821, 1636422604085, 264, 1, 263, 0, 1, 1
7730, 1, 1636422603849, 1636422604117, 268, 0, 268, 0, 0, 0
7731, 1, 1636422603866, 1636422604134, 268, 0, 268, 0, 0, 0
7733, 1, 1636422603981, 1636422604249, 268, 1, 267, 0, 1, 1
7732, 1, 1636422604005, 1636422604273, 268, 0, 268, 0, 0, 0
7734, 1, 1636422604033, 1636422604305, 272, 0, 272, 0, 0, 0
7736, 1, 1636422604285, 1636422604549, 264, 0, 264, 0, 0, 0
7735, 1, 1636422604289, 1636422604557, 268, 0, 268, 0, 0, 0
7737, 1, 1636422604297, 1636422604565, 268, 0, 268, 0, 0, 0
7738, 1, 1636422604405, 1636422604674, 269, 1, 268, 1, 0, 1
7739, 1, 1636422604541, 1636422604809, 268, 0, 268, 0, 0, 0
7740, 1, 1636422604545, 1636422604813, 268, 0, 268, 0, 0, 0
7741, 1, 1636422604561, 1636422604830, 269, 0, 269, 0, 0, 0
7742, 1, 1636422604661, 1636422604933, 272, 1, 271, 1, 0, 1
7743, 1, 1636422604757, 1636422605025, 268, 0, 268, 0, 0, 0
7744, 1, 1636422604765, 1636422605033, 268, 1, 267, 1, 0, 1
7745, 1, 1636422604797, 1636422605065, 268, 1, 267, 1, 0, 1
7747, 1, 1636422605081, 1636422605349, 268, 1, 267, 0, 0, 0
7748, 1, 1636422605081, 1636422605349, 268, 0, 268, 0, 0, 0
7751, 1, 1636422605329, 1636422605598, 269, 1, 268, 0, 0, 0
7750, 1, 1636422605329, 1636422605598, 269, 1, 268, 1, 0, 1
7753, 1, 1636422605473, 1636422605742, 269, 0, 269, 0, 0, 0
7757, 1, 1636422605589, 1636422605854, 265, 1, 264, 0, 0, 0
7756, 1, 1636422605585, 1636422605854, 269, 0, 269, 0, 0, 0
7754, 1, 1636422605593, 1636422605857, 264, 0, 264, 0, 0, 0
7758, 1, 1636422605890, 1636422606158, 268, 0, 268, 0, 0, 0
7759, 1, 1636422605901, 1636422606169, 268, 0, 268, 0, 0, 0
7761, 1, 1636422606133, 1636422606401, 268, 0, 268, 0, 0, 0
7762, 1, 1636422606262, 1636422606529, 267, 0, 267, 0, 0, 0
7763, 1, 1636422606313, 1636422606585, 272, 0, 272, 0, 0, 0
7764, 1, 1636422606401, 1636422606669, 268, 1, 267, 0, 0, 0
7765, 1, 1636422606401, 1636422606670, 269, 1, 268, 0, 0, 0
7766, 1, 1636422606577, 1636422606846, 269, 1, 268, 0, 1, 1
7767, 1, 1636422606681, 1636422606949, 268, 0, 268, 0, 0, 0
7768, 1, 1636422606689, 1636422606961, 272, 1, 271, 0, 0, 0
7769, 1, 1636422606946, 1636422607213, 267, 0, 267, 0, 0, 0
7770, 1, 1636422607041, 1636422607313, 272, 0, 272, 0, 0, 0
7771, 1, 1636422607117, 1636422607390, 273, 0, 273, 0, 0, 0
7773, 1, 1636422607189, 1636422607461, 272, 1, 271, 0, 0, 0
7772, 1, 1636422607181, 1636422607462, 281, 1, 280, 0, 0, 0
7774, 1, 1636422607289, 1636422607554, 265, 0, 265, 0, 0, 0
7775, 1, 1636422607469, 1636422607733, 264, 1, 263, 0, 1, 1
7776, 1, 1636422607477, 1636422607750, 273, 1, 272, 0, 0, 0
7777, 1, 1636422607637, 1636422607905, 268, 1, 267, 0, 0, 0
7778, 1, 1636422607741, 1636422608010, 269, 0, 269, 0, 0, 0
7779, 1, 1636422607853, 1636422608122, 269, 1, 268, 0, 0, 0
7780, 1, 1636422607909, 1636422608174, 265, 0, 265, 0, 0, 0
7781, 1, 1636422607974, 1636422608241, 267, 0, 267, 0, 0, 0
7782, 1, 1636422607974, 1636422608242, 268, 0, 268, 0, 0, 0
7785, 1, 1636422608301, 1636422608562, 261, 0, 261, 0, 0, 0
7784, 1, 1636422608305, 1636422608569, 264, 1, 263, 0, 0, 0
7786, 1, 1636422608385, 1636422608658, 273, 1, 272, 0, 0, 0
7787, 1, 1636422608562, 1636422608833, 271, 0, 271, 0, 0, 0
7789, 1, 1636422608658, 1636422608921, 263, 0, 263, 0, 0, 0
7788, 1, 1636422608697, 1636422608965, 268, 0, 268, 0, 0, 0
7791, 1, 1636422608709, 1636422608981, 272, 0, 272, 0, 0, 0
7790, 1, 1636422608730, 1636422608997, 267, 0, 267, 0, 0, 0
7792, 1, 1636422608789, 1636422609057, 268, 1, 267, 0, 0, 0
7793, 1, 1636422608797, 1636422609069, 272, 1, 271, 0, 1, 1
7795, 1, 1636422609085, 1636422609349, 264, 1, 263, 1, 0, 1
7794, 1, 1636422609085, 1636422609354, 269, 1, 268, 0, 1, 1
7796, 1, 1636422609145, 1636422609413, 268, 0, 268, 0, 0, 0
7797, 1, 1636422609337, 1636422609625, 288, 1, 287, 0, 1, 1
7798, 1, 1636422609410, 1636422609713, 303, 0, 303, 0, 0, 0
7799, 1, 1636422609489, 1636422609757, 268, 1, 267, 1, 0, 1
7800, 1, 1636422609489, 1636422609757, 268, 1, 267, 0, 0, 0
7802, 1, 1636422609625, 1636422609893, 268, 1, 267, 0, 0, 0
7803, 1, 1636422609629, 1636422609905, 276, 0, 276, 0, 0, 0
7801, 1, 1636422609717, 1636422609985, 268, 0, 268, 0, 0, 0
7804, 1, 1636422609837, 1636422610101, 264, 0, 264, 0, 0, 0
7806, 1, 1636422609882, 1636422610153, 271, 0, 271, 0, 0, 0
7805, 1, 1636422609882, 1636422610153, 271, 0, 271, 0, 0, 0
7807, 1, 1636422609882, 1636422610153, 271, 0, 271, 0, 0, 0
7809, 1, 1636422610142, 1636422610405, 263, 0, 263, 0, 0, 0
7811, 1, 1636422610245, 1636422610513, 268, 0, 268, 0, 0, 0
7812, 1, 1636422610249, 1636422610517, 268, 0, 268, 0, 0, 0
7814, 1, 1636422610393, 1636422610661, 268, 1, 267, 0, 1, 1
7813, 1, 1636422610393, 1636422610662, 269, 1, 268, 1, 0, 1
7815, 1, 1636422610401, 1636422610665, 264, 1, 263, 0, 0, 0
7816, 1, 1636422610549, 1636422610814, 265, 0, 265, 0, 0, 0
7817, 1, 1636422610593, 1636422610861, 268, 1, 267, 0, 1, 1
7819, 1, 1636422610685, 1636422610958, 273, 1, 272, 0, 0, 0
7818, 1, 1636422610685, 1636422610958, 273, 1, 272, 0, 0, 0
7820, 1, 1636422610946, 1636422611217, 271, 0, 271, 0, 0, 0
7821, 1, 1636422611041, 1636422611310, 269, 1, 268, 0, 0, 0
7823, 1, 1636422611153, 1636422611417, 264, 0, 264, 0, 0, 0
7824, 1, 1636422611181, 1636422611454, 273, 1, 272, 0, 1, 1
7825, 1, 1636422611201, 1636422611470, 269, 0, 269, 0, 0, 0
7827, 1, 1636422611410, 1636422611701, 291, 0, 291, 0, 0, 0
7828, 1, 1636422611470, 1636422611737, 267, 0, 267, 0, 0, 0
7830, 1, 1636422611749, 1636422612017, 268, 0, 268, 0, 0, 0
7831, 1, 1636422611854, 1636422612122, 268, 0, 268, 0, 0, 0
7833, 1, 1636422611945, 1636422612213, 268, 1, 267, 0, 1, 1
7832, 1, 1636422611965, 1636422612233, 268, 1, 267, 1, 0, 1
7834, 1, 1636422612125, 1636422612417, 292, 0, 292, 0, 0, 0
7836, 1, 1636422612237, 1636422612517, 280, 0, 280, 0, 0, 0
7837, 1, 1636422612269, 1636422612538, 269, 1, 268, 0, 1, 1
7838, 1, 1636422612534, 1636422612801, 267, 0, 267, 0, 0, 0
7839, 1, 1636422612589, 1636422612853, 264, 1, 263, 0, 1, 1
7840, 1, 1636422612641, 1636422612909, 268, 0, 268, 0, 0, 0
7841, 1, 1636422612677, 1636422612945, 268, 0, 268, 0, 0, 0
7842, 1, 1636422612758, 1636422613026, 268, 0, 268, 0, 0, 0
7843, 1, 1636422612837, 1636422613105, 268, 1, 267, 0, 1, 1
7844, 1, 1636422613009, 1636422613282, 273, 1, 272, 1, 0, 1
7845, 1, 1636422613057, 1636422613326, 269, 1, 268, 0, 0, 0
7846, 1, 1636422613301, 1636422613570, 269, 0, 269, 0, 0, 0
7847, 1, 1636422613341, 1636422613609, 268, 1, 267, 0, 1, 1
7848, 1, 1636422613426, 1636422613694, 268, 0, 268, 0, 0, 0
7850, 1, 1636422613570, 1636422613838, 268, 0, 268, 0, 0, 0
7851, 1, 1636422613593, 1636422613862, 269, 1, 268, 0, 0, 0
7852, 1, 1636422613806, 1636422614078, 272, 0, 272, 0, 0, 0
7853, 1, 1636422613861, 1636422614129, 268, 1, 267, 0, 0, 0
7855, 1, 1636422614141, 1636422614410, 269, 1, 268, 0, 1, 1
7856, 1, 1636422614230, 1636422614497, 267, 0, 267, 0, 0, 0
7857, 1, 1636422614373, 1636422614645, 272, 0, 272, 0, 0, 0
7858, 1, 1636422614377, 1636422614646, 269, 0, 269, 0, 0, 0
7859, 1, 1636422614594, 1636422614865, 271, 0, 271, 0, 0, 0
7860, 1, 1636422614653, 1636422614921, 268, 0, 268, 0, 0, 0
7861, 1, 1636422614934, 1636422615245, 311, 0, 311, 0, 0, 0
7862, 1, 1636422615038, 1636422615338, 300, 0, 300, 0, 0, 0
7864, 1, 1636422615173, 1636422615441, 268, 0, 268, 0, 0, 0
7863, 1, 1636422615249, 1636422615521, 272, 0, 272, 0, 0, 0
7866, 1, 1636422615421, 1636422615693, 272, 1, 271, 0, 0, 0
7865, 1, 1636422615421, 1636422615693, 272, 1, 271, 1, 0, 1
7868, 1, 1636422615553, 1636422615821, 268, 1, 267, 0, 1, 1
7870, 1, 1636422615737, 1636422616002, 265, 1, 264, 1, 0, 1
7872, 1, 1636422615845, 1636422616114, 269, 1, 268, 0, 0, 0
7871, 1, 1636422615869, 1636422616166, 297, 0, 297, 0, 0, 0
7874, 1, 1636422615978, 1636422616254, 276, 0, 276, 0, 0, 0
7873, 1, 1636422615978, 1636422616254, 276, 0, 276, 0, 0, 0
7875, 1, 1636422616101, 1636422616365, 264, 1, 263, 0, 0, 0
7808, 1, 1636422616121, 1636422616385, 264, 0, 264, 0, 0, 0
7877, 1, 1636422616209, 1636422616473, 264, 0, 264, 0, 0, 0
7876, 1, 1636422616253, 1636422616517, 264, 1, 263, 1, 0, 1
7878, 1, 1636422616425, 1636422616689, 264, 1, 263, 0, 1, 1
7879, 1, 1636422616521, 1636422616789, 268, 1, 267, 0, 0, 0
7880, 1, 1636422616581, 1636422616854, 273, 0, 273, 0, 0, 0
7881, 1, 1636422616642, 1636422616909, 267, 0, 267, 0, 0, 0
7883, 1, 1636422616785, 1636422617054, 269, 1, 268, 1, 0, 1
7884, 1, 1636422616789, 1636422617057, 268, 0, 268, 0, 0, 0
7882, 1, 1636422616785, 1636422617057, 272, 1, 271, 0, 1, 1
7886, 1, 1636422617013, 1636422617282, 269, 0, 269, 0, 0, 0
7887, 1, 1636422617037, 1636422617309, 272, 1, 271, 0, 0, 0
7888, 1, 1636422617153, 1636422617426, 273, 0, 273, 0, 0, 0
7889, 1, 1636422617333, 1636422617605, 272, 1, 271, 0, 0, 0
7892, 1, 1636422617558, 1636422617821, 263, 0, 263, 0, 0, 0
7893, 1, 1636422617594, 1636422617861, 267, 0, 267, 0, 0, 0
7894, 1, 1636422617594, 1636422617861, 267, 0, 267, 0, 0, 0
7895, 1, 1636422617809, 1636422618118, 309, 1, 308, 0, 0, 0
7896, 1, 1636422617825, 1636422618118, 293, 0, 293, 0, 0, 0
7897, 1, 1636422617958, 1636422618225, 267, 0, 267, 0, 0, 0
7898, 1, 1636422618165, 1636422618433, 268, 0, 268, 0, 0, 0
7900, 1, 1636422618365, 1636422618637, 272, 1, 271, 0, 1, 1
7901, 1, 1636422618397, 1636422618665, 268, 1, 267, 0, 1, 1
7902, 1, 1636422618401, 1636422618670, 269, 0, 269, 0, 0, 0
7904, 1, 1636422618637, 1636422618910, 273, 1, 272, 1, 0, 1
7905, 1, 1636422618745, 1636422619014, 269, 1, 268, 1, 0, 1
7906, 1, 1636422618937, 1636422619209, 272, 0, 272, 0, 0, 0
7907, 1, 1636422619149, 1636422619417, 268, 1, 267, 0, 1, 1
7910, 1, 1636422619433, 1636422619701, 268, 1, 267, 0, 0, 0
7911, 1, 1636422619553, 1636422619826, 273, 1, 272, 0, 0, 0
7912, 1, 1636422619745, 1636422620014, 269, 1, 268, 0, 0, 0
7913, 1, 1636422619954, 1636422620242, 288, 0, 288, 0, 0, 0
7914, 1, 1636422620242, 1636422620513, 271, 0, 271, 0, 0, 0
7915, 1, 1636422620357, 1636422620630, 273, 0, 273, 0, 0, 0
7917, 1, 1636422620538, 1636422620806, 268, 0, 268, 0, 0, 0
7918, 1, 1636422620762, 1636422621030, 268, 0, 268, 0, 0, 0
7919, 1, 1636422621030, 1636422621289, 259, 0, 259, 0, 0, 0
7920, 1, 1636422621177, 1636422621525, 348, 0, 348, 0, 0, 0
7922, 1, 1636422621329, 1636422621609, 280, 1, 279, 0, 0, 0
7921, 1, 1636422621390, 1636422621654, 264, 0, 264, 0, 0, 0
7923, 1, 1636422621569, 1636422621837, 268, 0, 268, 0, 0, 0
7925, 1, 1636422621786, 1636422622054, 268, 0, 268, 0, 0, 0
7926, 1, 1636422621837, 1636422622125, 288, 1, 287, 0, 1, 1
7927, 1, 1636422621954, 1636422622222, 268, 0, 268, 0, 0, 0
7928, 1, 1636422622085, 1636422622353, 268, 0, 268, 0, 0, 0
7929, 1, 1636422622137, 1636422622413, 276, 1, 275, 0, 0, 0
7930, 1, 1636422622306, 1636422622574, 268, 0, 268, 0, 0, 0
7931, 1, 1636422622365, 1636422622633, 268, 0, 268, 0, 0, 0
7932, 1, 1636422622493, 1636422622762, 269, 1, 268, 1, 0, 1
7933, 1, 1636422622625, 1636422622894, 269, 1, 268, 0, 0, 0
7935, 1, 1636422622861, 1636422623129, 268, 1, 267, 1, 0, 1
7934, 1, 1636422622897, 1636422623165, 268, 0, 268, 0, 0, 0
7936, 1, 1636422622929, 1636422623197, 268, 1, 267, 0, 1, 1
7937, 1, 1636422623017, 1636422623289, 272, 1, 271, 0, 1, 1
7938, 1, 1636422623181, 1636422623445, 264, 1, 263, 0, 0, 0
7939, 1, 1636422623282, 1636422623549, 267, 0, 267, 0, 0, 0
7940, 1, 1636422623429, 1636422623701, 272, 1, 271, 0, 1, 1
7941, 1, 1636422623561, 1636422623829, 268, 1, 267, 0, 1, 1
7942, 1, 1636422623653, 1636422623922, 269, 1, 268, 0, 0, 0
7944, 1, 1636422623738, 1636422624005, 267, 0, 267, 0, 0, 0
7945, 1, 1636422623805, 1636422624074, 269, 1, 268, 1, 0, 1
7946, 1, 1636422623974, 1636422624238, 264, 0, 264, 0, 0, 0
7947, 1, 1636422624077, 1636422624346, 269, 0, 269, 0, 0, 0
7948, 1, 1636422624229, 1636422624501, 272, 1, 271, 0, 1, 1
7950, 1, 1636422624373, 1636422624641, 268, 1, 267, 0, 1, 1
7951, 1, 1636422624466, 1636422624733, 267, 0, 267, 0, 0, 0
7952, 1, 1636422624541, 1636422624809, 268, 0, 268, 0, 0, 0
7953, 1, 1636422624605, 1636422624877, 272, 1, 271, 0, 1, 1
7954, 1, 1636422624777, 1636422625041, 264, 0, 264, 0, 0, 0
7955, 1, 1636422624893, 1636422625161, 268, 0, 268, 0, 0, 0
7956, 1, 1636422625005, 1636422625277, 272, 1, 271, 1, 0, 1
7957, 1, 1636422625161, 1636422625429, 268, 1, 267, 1, 0, 1
7958, 1, 1636422625257, 1636422625525, 268, 0, 268, 0, 0, 0
7959, 1, 1636422625337, 1636422625606, 269, 0, 269, 0, 0, 0
7960, 1, 1636422625421, 1636422625721, 300, 0, 300, 0, 0, 0
7961, 1, 1636422625633, 1636422625905, 272, 0, 272, 0, 0, 0
7962, 1, 1636422625725, 1636422625993, 268, 1, 267, 1, 0, 1
7964, 1, 1636422625809, 1636422626077, 268, 0, 268, 0, 0, 0
7966, 1, 1636422625953, 1636422626221, 268, 0, 268, 0, 0, 0
7965, 1, 1636422625981, 1636422626258, 277, 0, 277, 0, 0, 0
7967, 1, 1636422626069, 1636422626338, 269, 1, 268, 1, 0, 1
7969, 1, 1636422626193, 1636422626469, 276, 1, 275, 0, 0, 0
7970, 1, 1636422626369, 1636422626638, 269, 1, 268, 0, 0, 0
7971, 1, 1636422626490, 1636422626757, 267, 0, 267, 0, 0, 0
7972, 1, 1636422626602, 1636422626869, 267, 0, 267, 0, 0, 0
7973, 1, 1636422626697, 1636422626966, 269, 1, 268, 0, 0, 0
7974, 1, 1636422626733, 1636422627037, 304, 0, 304, 0, 0, 0
7975, 1, 1636422626865, 1636422627133, 268, 1, 267, 0, 1, 1
7976, 1, 1636422627037, 1636422627301, 264, 1, 263, 1, 0, 1
7977, 1, 1636422627157, 1636422627430, 273, 1, 272, 0, 0, 0
7978, 1, 1636422627217, 1636422627517, 300, 0, 300, 0, 0, 0
7979, 1, 1636422627286, 1636422627569, 283, 0, 283, 0, 0, 0
7980, 1, 1636422627430, 1636422627698, 268, 0, 268, 0, 0, 0
7982, 1, 1636422627569, 1636422627841, 272, 1, 271, 0, 0, 0
7984, 1, 1636422627665, 1636422627930, 265, 0, 265, 0, 0, 0
7983, 1, 1636422627709, 1636422627977, 268, 0, 268, 0, 0, 0
7985, 1, 1636422627738, 1636422628006, 268, 0, 268, 0, 0, 0
7986, 1, 1636422627810, 1636422628077, 267, 0, 267, 0, 0, 0
7988, 1, 1636422627961, 1636422628226, 265, 1, 264, 1, 0, 1
7987, 1, 1636422628006, 1636422628270, 264, 0, 264, 0, 0, 0
7989, 1, 1636422628089, 1636422628357, 268, 0, 268, 0, 0, 0
7991, 1, 1636422628337, 1636422628641, 304, 0, 304, 0, 0, 0
7992, 1, 1636422628426, 1636422628725, 299, 0, 299, 0, 0, 0
7993, 1, 1636422628477, 1636422628749, 272, 1, 271, 0, 0, 0
7994, 1, 1636422628477, 1636422628750, 273, 1, 272, 0, 0, 0
7995, 1, 1636422628641, 1636422628909, 268, 0, 268, 0, 0, 0
7996, 1, 1636422628689, 1636422628958, 269, 0, 269, 0, 0, 0
7997, 1, 1636422628725, 1636422628993, 268, 1, 267, 0, 0, 0
7998, 1, 1636422628757, 1636422629025, 268, 1, 267, 0, 0, 0
7999, 1, 1636422628905, 1636422629169, 264, 1, 263, 0, 1, 1
8000, 1, 1636422628897, 1636422629170, 273, 1, 272, 1, 0, 1
8002, 1, 1636422629285, 1636422629553, 268, 0, 268, 0, 0, 0
8004, 1, 1636422629294, 1636422629561, 267, 0, 267, 0, 0, 0
8003, 1, 1636422629294, 1636422629565, 271, 0, 271, 0, 0, 0
8005, 1, 1636422629397, 1636422629673, 276, 1, 275, 0, 1, 1
8006, 1, 1636422629413, 1636422629685, 272, 1, 271, 0, 1, 1
8007, 1, 1636422629505, 1636422629765, 260, 0, 260, 0, 0, 0
8008, 1, 1636422629521, 1636422629782, 261, 0, 261, 0, 0, 0
8009, 1, 1636422629541, 1636422629810, 269, 0, 269, 0, 0, 0
8011, 1, 1636422629613, 1636422629881, 268, 0, 268, 0, 0, 0
8012, 1, 1636422629713, 1636422629985, 272, 1, 271, 1, 0, 1
8013, 1, 1636422630013, 1636422630277, 264, 0, 264, 0, 0, 0
8014, 1, 1636422630045, 1636422630313, 268, 1, 267, 0, 1, 1
8015, 1, 1636422630058, 1636422630325, 267, 0, 267, 0, 0, 0
8017, 1, 1636422630209, 1636422630478, 269, 1, 268, 0, 1, 1
8018, 1, 1636422630217, 1636422630485, 268, 0, 268, 0, 0, 0
8019, 1, 1636422630349, 1636422630633, 284, 1, 283, 0, 1, 1
8020, 1, 1636422630461, 1636422630725, 264, 0, 264, 0, 0, 0
8021, 1, 1636422630549, 1636422630817, 268, 1, 267, 0, 1, 1
8022, 1, 1636422630810, 1636422631078, 268, 0, 268, 0, 0, 0
8023, 1, 1636422630829, 1636422631101, 272, 1, 271, 0, 0, 0
8024, 1, 1636422630857, 1636422631134, 277, 0, 277, 0, 0, 0
8025, 1, 1636422630869, 1636422631137, 268, 1, 267, 0, 1, 1
8026, 1, 1636422631010, 1636422631281, 271, 0, 271, 0, 0, 0
8028, 1, 1636422631137, 1636422631409, 272, 1, 271, 0, 0, 0
8029, 1, 1636422631205, 1636422631469, 264, 1, 263, 0, 1, 1
8030, 1, 1636422631313, 1636422631585, 272, 0, 272, 0, 0, 0
8031, 1, 1636422631517, 1636422631789, 272, 0, 272, 0, 0, 0
8032, 1, 1636422631614, 1636422631873, 259, 0, 259, 0, 0, 0
8033, 1, 1636422631654, 1636422631918, 264, 0, 264, 0, 0, 0
8034, 1, 1636422631701, 1636422631965, 264, 0, 264, 0, 0, 0
8035, 1, 1636422631822, 1636422632093, 271, 0, 271, 0, 0, 0
8037, 1, 1636422631941, 1636422632205, 264, 1, 263, 1, 0, 1
8036, 1, 1636422631969, 1636422632238, 269, 0, 269, 0, 0, 0
8038, 1, 1636422632021, 1636422632286, 265, 1, 264, 0, 0, 0
8039, 1, 1636422632109, 1636422632374, 265, 0, 265, 0, 0, 0
8041, 1, 1636422632429, 1636422632697, 268, 0, 268, 0, 0, 0
8043, 1, 1636422632461, 1636422632729, 268, 0, 268, 0, 0, 0
8042, 1, 1636422632457, 1636422632737, 280, 1, 279, 0, 1, 1
8044, 1, 1636422632613, 1636422632881, 268, 0, 268, 0, 0, 0
8045, 1, 1636422632701, 1636422632970, 269, 0, 269, 0, 0, 0
8046, 1, 1636422632733, 1636422633005, 272, 0, 272, 0, 0, 0
8047, 1, 1636422632805, 1636422633074, 269, 1, 268, 0, 0, 0
8048, 1, 1636422632893, 1636422633165, 272, 0, 272, 0, 0, 0
8049, 1, 1636422633222, 1636422633494, 272, 0, 272, 0, 0, 0
8050, 1, 1636422633249, 1636422633522, 273, 0, 273, 0, 0, 0
8051, 1, 1636422633281, 1636422633554, 273, 0, 273, 0, 0, 0
8052, 1, 1636422633401, 1636422633674, 273, 1, 272, 0, 0, 0
8054, 1, 1636422633541, 1636422633826, 285, 0, 285, 0, 0, 0
8055, 1, 1636422633617, 1636422633913, 296, 0, 296, 0, 0, 0
8056, 1, 1636422633677, 1636422633949, 272, 0, 272, 0, 0, 0
8057, 1, 1636422634033, 1636422634302, 269, 1, 268, 0, 0, 0
8058, 1, 1636422634037, 1636422634309, 272, 1, 271, 0, 0, 0
8060, 1, 1636422634089, 1636422634353, 264, 0, 264, 0, 0, 0
8059, 1, 1636422634089, 1636422634353, 264, 1, 263, 0, 0, 0
8061, 1, 1636422634178, 1636422634449, 271, 0, 271, 0, 0, 0
8062, 1, 1636422634361, 1636422634629, 268, 0, 268, 0, 0, 0
8063, 1, 1636422634453, 1636422634717, 264, 0, 264, 0, 0, 0
8064, 1, 1636422634497, 1636422634761, 264, 1, 263, 0, 1, 1
8065, 1, 1636422634717, 1636422634981, 264, 0, 264, 0, 0, 0
8066, 1, 1636422634797, 1636422635065, 268, 0, 268, 0, 0, 0
8068, 1, 1636422634842, 1636422635109, 267, 0, 267, 0, 0, 0
8067, 1, 1636422634841, 1636422635113, 272, 1, 271, 0, 0, 0
8069, 1, 1636422634889, 1636422635165, 276, 1, 275, 0, 1, 1
8070, 1, 1636422634965, 1636422635233, 268, 1, 267, 1, 0, 1
8071, 1, 1636422635141, 1636422635409, 268, 1, 267, 0, 0, 0
8072, 1, 1636422635210, 1636422635481, 271, 0, 271, 0, 0, 0
8073, 1, 1636422635265, 1636422635538, 273, 0, 273, 0, 0, 0
8074, 1, 1636422635421, 1636422635693, 272, 0, 272, 0, 0, 0
8076, 1, 1636422635633, 1636422635910, 277, 1, 276, 1, 0, 1
8077, 1, 1636422635633, 1636422635910, 277, 1, 276, 0, 0, 0
8078, 1, 1636422635733, 1636422636001, 268, 0, 268, 0, 0, 0
8079, 1, 1636422635774, 1636422636037, 263, 0, 263, 0, 0, 0
8080, 1, 1636422635946, 1636422636218, 272, 0, 272, 0, 0, 0
8081, 1, 1636422636021, 1636422636293, 272, 1, 271, 0, 1, 1
8083, 1, 1636422636057, 1636422636325, 268, 1, 267, 0, 0, 0
8082, 1, 1636422636113, 1636422636381, 268, 1, 267, 0, 1, 1
8085, 1, 1636422636425, 1636422636697, 272, 0, 272, 0, 0, 0
8087, 1, 1636422636445, 1636422636705, 260, 0, 260, 0, 0, 0
8086, 1, 1636422636469, 1636422636737, 268, 0, 268, 0, 0, 0
8088, 1, 1636422636485, 1636422636758, 273, 0, 273, 0, 0, 0
8089, 1, 1636422636557, 1636422636825, 268, 1, 267, 1, 0, 1
8090, 1, 1636422636757, 1636422637025, 268, 1, 267, 0, 0, 0
8091, 1, 1636422636789, 1636422637058, 269, 0, 269, 0, 0, 0
8092, 1, 1636422636821, 1636422637089, 268, 1, 267, 0, 1, 1
8093, 1, 1636422636849, 1636422637113, 264, 1, 263, 0, 1, 1
8094, 1, 1636422637225, 1636422637493, 268, 1, 267, 0, 0, 0
8095, 1, 1636422637245, 1636422637513, 268, 1, 267, 0, 0, 0
8096, 1, 1636422637297, 1636422637569, 272, 1, 271, 0, 1, 1
8097, 1, 1636422637354, 1636422637657, 303, 0, 303, 0, 0, 0
8098, 1, 1636422637573, 1636422637838, 265, 0, 265, 0, 0, 0
8101, 1, 1636422637617, 1636422637889, 272, 0, 272, 0, 0, 0
8100, 1, 1636422637657, 1636422637929, 272, 1, 271, 0, 1, 1
8102, 1, 1636422637825, 1636422638093, 268, 0, 268, 0, 0, 0
8103, 1, 1636422638009, 1636422638310, 301, 0, 301, 0, 0, 0
8104, 1, 1636422638045, 1636422638310, 265, 1, 264, 0, 1, 1
8105, 1, 1636422638133, 1636422638401, 268, 0, 268, 0, 0, 0
8106, 1, 1636422638154, 1636422638421, 267, 0, 267, 0, 0, 0
8107, 1, 1636422638337, 1636422638601, 264, 0, 264, 0, 0, 0
8108, 1, 1636422638429, 1636422638697, 268, 1, 267, 0, 0, 0
8109, 1, 1636422638445, 1636422638717, 272, 1, 271, 0, 0, 0
8111, 1, 1636422638554, 1636422638822, 268, 0, 268, 0, 0, 0
8113, 1, 1636422638833, 1636422639106, 273, 0, 273, 0, 0, 0
8114, 1, 1636422638885, 1636422639173, 288, 1, 287, 0, 0, 0
8115, 1, 1636422638938, 1636422639210, 272, 0, 272, 0, 0, 0
8116, 1, 1636422639173, 1636422639442, 269, 1, 268, 0, 0, 0
8118, 1, 1636422639225, 1636422639494, 269, 0, 269, 0, 0, 0
8119, 1, 1636422639337, 1636422639606, 269, 1, 268, 0, 0, 0
8121, 1, 1636422639673, 1636422639938, 265, 1, 264, 0, 1, 1
8122, 1, 1636422639682, 1636422639949, 267, 0, 267, 0, 0, 0
8125, 1, 1636422639930, 1636422640241, 311, 0, 311, 0, 0, 0
8126, 1, 1636422640001, 1636422640269, 268, 0, 268, 0, 0, 0
8127, 1, 1636422640157, 1636422640430, 273, 1, 272, 0, 1, 1
8128, 1, 1636422640437, 1636422640705, 268, 0, 268, 0, 0, 0
8130, 1, 1636422640477, 1636422640746, 269, 0, 269, 0, 0, 0
8129, 1, 1636422640505, 1636422640773, 268, 1, 267, 1, 0, 1
8131, 1, 1636422640746, 1636422641009, 263, 0, 263, 0, 0, 0
8132, 1, 1636422640805, 1636422641077, 272, 0, 272, 0, 0, 0
8133, 1, 1636422640973, 1636422641241, 268, 1, 267, 0, 1, 1
8134, 1, 1636422641226, 1636422641493, 267, 0, 267, 0, 0, 0
8135, 1, 1636422641250, 1636422641517, 267, 0, 267, 0, 0, 0
8136, 1, 1636422641285, 1636422641554, 269, 0, 269, 0, 0, 0
8137, 1, 1636422641321, 1636422641590, 269, 0, 269, 0, 0, 0
8138, 1, 1636422641533, 1636422641798, 265, 0, 265, 0, 0, 0
8139, 1, 1636422641585, 1636422641853, 268, 1, 267, 0, 0, 0
8140, 1, 1636422641738, 1636422642005, 267, 0, 267, 0, 0, 0
8141, 1, 1636422642009, 1636422642271, 262, 0, 262, 0, 0, 0
8143, 1, 1636422642046, 1636422642313, 267, 0, 267, 0, 0, 0
8142, 1, 1636422642046, 1636422642314, 268, 0, 268, 0, 0, 0
8144, 1, 1636422642069, 1636422642373, 304, 0, 304, 0, 0, 0
8145, 1, 1636422642373, 1636422642638, 265, 0, 265, 0, 0, 0
8146, 1, 1636422642417, 1636422642685, 268, 0, 268, 0, 0, 0
8147, 1, 1636422642558, 1636422642830, 272, 0, 272, 0, 0, 0
8148, 1, 1636422642638, 1636422642905, 267, 0, 267, 0, 0, 0
8149, 1, 1636422642821, 1636422643089, 268, 0, 268, 0, 0, 0
8150, 1, 1636422642830, 1636422643101, 271, 0, 271, 0, 0, 0
8151, 1, 1636422642853, 1636422643125, 272, 0, 272, 0, 0, 0
8152, 1, 1636422643105, 1636422643369, 264, 0, 264, 0, 0, 0
8153, 1, 1636422643149, 1636422643417, 268, 0, 268, 0, 0, 0
8154, 1, 1636422643177, 1636422643449, 272, 0, 272, 0, 0, 0
8156, 1, 1636422643357, 1636422643625, 268, 1, 267, 0, 0, 0
8155, 1, 1636422643437, 1636422643706, 269, 1, 268, 0, 0, 0
8157, 1, 1636422643625, 1636422643897, 272, 1, 271, 0, 0, 0
8158, 1, 1636422643633, 1636422643901, 268, 0, 268, 0, 0, 0
8159, 1, 1636422643706, 1636422643973, 267, 1, 266, 0, 0, 0
8161, 1, 1636422643785, 1636422644054, 269, 1, 268, 0, 0, 0
8162, 1, 1636422643942, 1636422644209, 267, 0, 267, 0, 0, 0
8163, 1, 1636422643969, 1636422644233, 264, 1, 263, 0, 1, 1
8164, 1, 1636422644145, 1636422644413, 268, 1, 267, 0, 1, 1
8165, 1, 1636422644237, 1636422644501, 264, 0, 264, 0, 0, 0
8166, 1, 1636422644417, 1636422644686, 269, 0, 269, 0, 0, 0
8167, 1, 1636422644445, 1636422644709, 264, 1, 263, 0, 0, 0
8168, 1, 1636422644454, 1636422644729, 275, 0, 275, 0, 0, 0
8169, 1, 1636422644509, 1636422644781, 272, 1, 271, 0, 1, 1
8170, 1, 1636422644733, 1636422645001, 268, 0, 268, 0, 0, 0
8171, 1, 1636422644761, 1636422645029, 268, 0, 268, 0, 0, 0
8172, 1, 1636422644945, 1636422645213, 268, 1, 267, 0, 0, 0
8173, 1, 1636422644958, 1636422645230, 272, 0, 272, 0, 0, 0
8174, 1, 1636422645230, 1636422645501, 271, 0, 271, 0, 0, 0
8176, 1, 1636422645245, 1636422645514, 269, 0, 269, 0, 0, 0
8175, 1, 1636422645245, 1636422645514, 269, 0, 269, 0, 0, 0
8177, 1, 1636422645305, 1636422645569, 264, 0, 264, 0, 0, 0
8178, 1, 1636422645561, 1636422645829, 268, 1, 267, 0, 1, 1
8179, 1, 1636422645561, 1636422645837, 276, 1, 275, 1, 0, 1
8180, 1, 1636422645733, 1636422646001, 268, 1, 267, 0, 1, 1
8181, 1, 1636422645769, 1636422646038, 269, 1, 268, 0, 0, 0
8182, 1, 1636422645913, 1636422646181, 268, 1, 267, 0, 0, 0
8183, 1, 1636422646013, 1636422646293, 280, 0, 280, 0, 0, 0
8184, 1, 1636422646049, 1636422646322, 273, 1, 272, 0, 0, 0
8185, 1, 1636422646049, 1636422646322, 273, 1, 272, 1, 0, 1
8186, 1, 1636422646105, 1636422646381, 276, 0, 276, 0, 0, 0
8187, 1, 1636422646337, 1636422646605, 268, 0, 268, 0, 0, 0
8190, 1, 1636422646545, 1636422646817, 272, 0, 272, 0, 0, 0
8191, 1, 1636422646565, 1636422646834, 269, 1, 268, 1, 0, 1
8189, 1, 1636422646565, 1636422646834, 269, 1, 268, 1, 0, 1
8192, 1, 1636422646630, 1636422646901, 271, 0, 271, 0, 0, 0
8193, 1, 1636422646825, 1636422647094, 269, 1, 268, 0, 0, 0
8194, 1, 1636422646834, 1636422647105, 271, 0, 271, 0, 0, 0
8195, 1, 1636422646841, 1636422647113, 272, 1, 271, 1, 0, 1
8196, 1, 1636422646925, 1636422647189, 264, 0, 264, 0, 0, 0
8197, 1, 1636422647141, 1636422647414, 273, 0, 273, 0, 0, 0
8198, 1, 1636422647285, 1636422647554, 269, 0, 269, 0, 0, 0
8200, 1, 1636422647369, 1636422647658, 289, 0, 289, 0, 0, 0
8199, 1, 1636422647349, 1636422647658, 309, 0, 309, 0, 0, 0
8201, 1, 1636422647414, 1636422647678, 264, 0, 264, 0, 0, 0
8203, 1, 1636422647661, 1636422647925, 264, 1, 263, 1, 0, 1
8204, 1, 1636422647661, 1636422647925, 264, 1, 263, 1, 0, 1
8202, 1, 1636422647661, 1636422647929, 268, 1, 267, 1, 0, 1
8205, 1, 1636422647745, 1636422648005, 260, 0, 260, 0, 0, 0
8206, 1, 1636422647929, 1636422648189, 260, 1, 259, 0, 0, 0
8207, 1, 1636422647942, 1636422648205, 263, 0, 263, 0, 0, 0
8208, 1, 1636422648073, 1636422648341, 268, 1, 267, 1, 0, 1
8209, 1, 1636422648141, 1636422648410, 269, 1, 268, 0, 1, 1
8210, 1, 1636422648174, 1636422648441, 267, 0, 267, 0, 0, 0
8211, 1, 1636422648225, 1636422648525, 300, 1, 299, 1, 0, 1
8213, 1, 1636422648437, 1636422648709, 272, 1, 271, 1, 0, 1
8212, 1, 1636422648437, 1636422648709, 272, 1, 271, 0, 1, 1
8214, 1, 1636422648465, 1636422648729, 264, 0, 264, 0, 0, 0
8215, 1, 1636422648529, 1636422648797, 268, 0, 268, 0, 0, 0
8216, 1, 1636422648645, 1636422648946, 301, 0, 301, 0, 0, 0
8218, 1, 1636422648769, 1636422649037, 268, 0, 268, 0, 0, 0
8217, 1, 1636422648785, 1636422649057, 272, 1, 271, 1, 0, 1
8219, 1, 1636422648902, 1636422649165, 263, 0, 263, 0, 0, 0
8220, 1, 1636422648949, 1636422649213, 264, 0, 264, 0, 0, 0
8221, 1, 1636422648977, 1636422649249, 272, 1, 271, 0, 1, 1
8222, 1, 1636422649037, 1636422649305, 268, 1, 267, 1, 0, 1
8223, 1, 1636422649117, 1636422649389, 272, 0, 272, 0, 0, 0
8224, 1, 1636422649225, 1636422649485, 260, 0, 260, 0, 0, 0
8225, 1, 1636422649237, 1636422649505, 268, 0, 268, 0, 0, 0
8226, 1, 1636422649253, 1636422649565, 312, 1, 311, 0, 1, 1
8227, 1, 1636422649389, 1636422649661, 272, 0, 272, 0, 0, 0
8228, 1, 1636422649481, 1636422649789, 308, 1, 307, 0, 1, 1
8229, 1, 1636422649529, 1636422649801, 272, 0, 272, 0, 0, 0
8230, 1, 1636422649561, 1636422649833, 272, 1, 271, 0, 1, 1
8231, 1, 1636422649701, 1636422649989, 288, 0, 288, 0, 0, 0
8232, 1, 1636422649741, 1636422650009, 268, 0, 268, 0, 0, 0
8234, 1, 1636422649809, 1636422650077, 268, 1, 267, 1, 0, 1
8233, 1, 1636422649809, 1636422650077, 268, 1, 267, 0, 0, 0
8235, 1, 1636422649837, 1636422650097, 260, 1, 259, 1, 0, 1
8236, 1, 1636422649837, 1636422650109, 272, 1, 271, 1, 0, 1
8238, 1, 1636422650029, 1636422650297, 268, 0, 268, 0, 0, 0
8239, 1, 1636422650054, 1636422650321, 267, 0, 267, 0, 0, 0
8237, 1, 1636422650054, 1636422650321, 267, 0, 267, 0, 0, 0
8241, 1, 1636422650121, 1636422650385, 264, 1, 263, 0, 1, 1
8240, 1, 1636422650161, 1636422650429, 268, 0, 268, 0, 0, 0
8242, 1, 1636422650245, 1636422650509, 264, 0, 264, 0, 0, 0
8243, 1, 1636422650289, 1636422650557, 268, 1, 267, 1, 0, 1
8245, 1, 1636422650453, 1636422650722, 269, 1, 268, 0, 1, 1
8246, 1, 1636422650469, 1636422650738, 269, 0, 269, 0, 0, 0
8247, 1, 1636422650537, 1636422650806, 269, 1, 268, 0, 1, 1
8248, 1, 1636422650569, 1636422650842, 273, 1, 272, 0, 1, 1
8249, 1, 1636422650625, 1636422650893, 268, 1, 267, 0, 0, 0
8250, 1, 1636422650721, 1636422650985, 264, 1, 263, 0, 0, 0
8251, 1, 1636422650773, 1636422651045, 272, 0, 272, 0, 0, 0
8252, 1, 1636422650833, 1636422651102, 269, 0, 269, 0, 0, 0
8253, 1, 1636422650861, 1636422651129, 268, 0, 268, 0, 0, 0
8255, 1, 1636422650929, 1636422651201, 272, 1, 271, 0, 0, 0
8254, 1, 1636422650985, 1636422651249, 264, 1, 263, 0, 0, 0
8256, 1, 1636422651057, 1636422651325, 268, 1, 267, 0, 1, 1
8257, 1, 1636422651073, 1636422651337, 264, 0, 264, 0, 0, 0
8259, 1, 1636422651274, 1636422651541, 267, 0, 267, 0, 0, 0
8260, 1, 1636422651337, 1636422651597, 260, 0, 260, 0, 0, 0
8261, 1, 1636422651381, 1636422651645, 264, 0, 264, 0, 0, 0
8262, 1, 1636422651425, 1636422651698, 273, 0, 273, 0, 0, 0
8263, 1, 1636422651437, 1636422651717, 280, 0, 280, 0, 0, 0
8264, 1, 1636422651557, 1636422651830, 273, 1, 272, 0, 0, 0
8265, 1, 1636422651629, 1636422651901, 272, 1, 271, 0, 1, 1
8266, 1, 1636422651666, 1636422651937, 271, 0, 271, 0, 0, 0
8268, 1, 1636422651721, 1636422651989, 268, 0, 268, 0, 0, 0
8269, 1, 1636422651845, 1636422652113, 268, 1, 267, 0, 1, 1
8270, 1, 1636422651881, 1636422652145, 264, 0, 264, 0, 0, 0
8271, 1, 1636422652061, 1636422652333, 272, 1, 271, 0, 0, 0
8272, 1, 1636422652134, 1636422652397, 263, 0, 263, 0, 0, 0
8273, 1, 1636422652181, 1636422652453, 272, 0, 272, 0, 0, 0
8274, 1, 1636422652225, 1636422652505, 280, 0, 280, 0, 0, 0
8275, 1, 1636422652241, 1636422652513, 272, 1, 271, 0, 1, 1
8276, 1, 1636422652365, 1636422652633, 268, 0, 268, 0, 0, 0
8277, 1, 1636422652441, 1636422652709, 268, 0, 268, 0, 0, 0
8278, 1, 1636422652453, 1636422652725, 272, 1, 271, 1, 0, 1
8279, 1, 1636422652525, 1636422652793, 268, 1, 267, 0, 0, 0
8280, 1, 1636422652646, 1636422652913, 267, 0, 267, 0, 0, 0
8281, 1, 1636422652693, 1636422652957, 264, 0, 264, 0, 0, 0
8282, 1, 1636422652873, 1636422653145, 272, 0, 272, 0, 0, 0
8283, 1, 1636422652945, 1636422653214, 269, 0, 269, 0, 0, 0
8284, 1, 1636422652985, 1636422653249, 264, 1, 263, 0, 0, 0
8285, 1, 1636422653029, 1636422653293, 264, 1, 263, 0, 0, 0
8286, 1, 1636422653037, 1636422653301, 264, 0, 264, 0, 0, 0
8287, 1, 1636422653173, 1636422653442, 269, 0, 269, 0, 0, 0
8288, 1, 1636422653233, 1636422653501, 268, 1, 267, 1, 0, 1
8289, 1, 1636422653265, 1636422653533, 268, 1, 267, 0, 1, 1
8290, 1, 1636422653337, 1636422653602, 265, 0, 265, 0, 0, 0
8291, 1, 1636422653445, 1636422653709, 264, 0, 264, 0, 0, 0
8292, 1, 1636422653489, 1636422653754, 265, 1, 264, 0, 0, 0
8293, 1, 1636422653725, 1636422653993, 268, 0, 268, 0, 0, 0
8294, 1, 1636422653753, 1636422654017, 264, 1, 263, 1, 0, 1
8295, 1, 1636422653817, 1636422654078, 261, 0, 261, 0, 0, 0
8296, 1, 1636422653861, 1636422654129, 268, 1, 267, 0, 1, 1
8297, 1, 1636422653861, 1636422654129, 268, 1, 267, 1, 0, 1
8298, 1, 1636422653969, 1636422654233, 264, 0, 264, 0, 0, 0
8301, 1, 1636422654045, 1636422654301, 256, 0, 256, 0, 0, 0
8300, 1, 1636422654041, 1636422654305, 264, 0, 264, 0, 0, 0
8302, 1, 1636422654125, 1636422654393, 268, 0, 268, 0, 0, 0
8303, 1, 1636422654257, 1636422654525, 268, 1, 267, 1, 0, 1
8304, 1, 1636422654289, 1636422654557, 268, 1, 267, 1, 0, 1
8305, 1, 1636422654525, 1636422654794, 269, 1, 268, 1, 0, 1
8306, 1, 1636422654541, 1636422654813, 272, 1, 271, 0, 1, 1
8307, 1, 1636422654581, 1636422654853, 272, 1, 271, 0, 0, 0
8309, 1, 1636422654654, 1636422654917, 263, 0, 263, 0, 0, 0
8308, 1, 1636422654654, 1636422654921, 267, 0, 267, 0, 0, 0
8310, 1, 1636422654769, 1636422655037, 268, 1, 267, 0, 1, 1
8312, 1, 1636422654849, 1636422655117, 268, 1, 267, 0, 0, 0
8313, 1, 1636422654921, 1636422655189, 268, 1, 267, 0, 0, 0
8311, 1, 1636422655041, 1636422655317, 276, 0, 276, 0, 0, 0
8314, 1, 1636422655070, 1636422655337, 267, 0, 267, 0, 0, 0
8315, 1, 1636422655077, 1636422655345, 268, 0, 268, 0, 0, 0
8316, 1, 1636422655282, 1636422655557, 275, 0, 275, 0, 0, 0
8317, 1, 1636422655333, 1636422655602, 269, 1, 268, 0, 1, 1
8318, 1, 1636422655369, 1636422655637, 268, 0, 268, 0, 0, 0
8319, 1, 1636422655450, 1636422655722, 272, 0, 272, 0, 0, 0
8320, 1, 1636422655453, 1636422655725, 272, 1, 271, 1, 0, 1
8321, 1, 1636422655557, 1636422655829, 272, 1, 271, 0, 0, 0
8322, 1, 1636422655641, 1636422655917, 276, 1, 275, 0, 0, 0
8324, 1, 1636422655721, 1636422655985, 264, 1, 263, 0, 0, 0
8325, 1, 1636422655853, 1636422656126, 273, 1, 272, 1, 0, 1
8327, 1, 1636422656089, 1636422656358, 269, 0, 269, 0, 0, 0
8328, 1, 1636422656145, 1636422656425, 280, 1, 279, 0, 0, 0
8326, 1, 1636422656125, 1636422656426, 301, 1, 300, 0, 0, 0
8330, 1, 1636422656249, 1636422656521, 272, 1, 271, 0, 1, 1
8331, 1, 1636422656254, 1636422656525, 271, 0, 271, 0, 0, 0
8329, 1, 1636422656362, 1636422656630, 268, 0, 268, 0, 0, 0
8332, 1, 1636422656429, 1636422656702, 273, 0, 273, 0, 0, 0
8333, 1, 1636422656469, 1636422656733, 264, 0, 264, 0, 0, 0
8334, 1, 1636422656514, 1636422656777, 263, 0, 263, 0, 0, 0
8336, 1, 1636422656657, 1636422656926, 269, 0, 269, 0, 0, 0
8335, 1, 1636422656681, 1636422656945, 264, 1, 263, 0, 0, 0
8337, 1, 1636422656821, 1636422657089, 268, 0, 268, 0, 0, 0
8338, 1, 1636422656890, 1636422657157, 267, 0, 267, 0, 0, 0
8339, 1, 1636422656937, 1636422657209, 272, 0, 272, 0, 0, 0
8340, 1, 1636422657029, 1636422657297, 268, 1, 267, 0, 0, 0
8342, 1, 1636422657042, 1636422657309, 267, 0, 267, 0, 0, 0
8341, 1, 1636422657042, 1636422657309, 267, 0, 267, 0, 0, 0
8343, 1, 1636422657181, 1636422657449, 268, 0, 268, 0, 0, 0
8344, 1, 1636422657253, 1636422657517, 264, 1, 263, 0, 0, 0
8345, 1, 1636422657313, 1636422657573, 260, 0, 260, 0, 0, 0
8346, 1, 1636422657397, 1636422657666, 269, 0, 269, 0, 0, 0
8348, 1, 1636422657577, 1636422657849, 272, 1, 271, 0, 1, 1
8347, 1, 1636422657577, 1636422657853, 276, 1, 275, 1, 0, 1
8349, 1, 1636422657682, 1636422657950, 268, 0, 268, 0, 0, 0
8350, 1, 1636422657745, 1636422658017, 272, 1, 271, 0, 0, 0
8352, 1, 1636422657845, 1636422658113, 268, 1, 267, 1, 0, 1
8353, 1, 1636422657845, 1636422658114, 269, 1, 268, 0, 1, 1
8354, 1, 1636422657977, 1636422658245, 268, 0, 268, 0, 0, 0
8355, 1, 1636422658050, 1636422658317, 267, 0, 267, 0, 0, 0
8356, 1, 1636422658101, 1636422658369, 268, 0, 268, 0, 0, 0
8357, 1, 1636422658198, 1636422658465, 267, 0, 267, 0, 0, 0
8358, 1, 1636422658261, 1636422658533, 272, 1, 271, 1, 0, 1
8359, 1, 1636422658361, 1636422658630, 269, 0, 269, 0, 0, 0
8360, 1, 1636422658482, 1636422658749, 267, 0, 267, 0, 0, 0
8361, 1, 1636422658545, 1636422658813, 268, 1, 267, 0, 1, 1
8362, 1, 1636422658637, 1636422658910, 273, 0, 273, 0, 0, 0
8363, 1, 1636422658653, 1636422658921, 268, 1, 267, 0, 0, 0
8364, 1, 1636422658778, 1636422659045, 267, 0, 267, 0, 0, 0
8365, 1, 1636422658837, 1636422659109, 272, 0, 272, 0, 0, 0
8366, 1, 1636422658910, 1636422659178, 268, 0, 268, 0, 0, 0
8367, 1, 1636422659009, 1636422659273, 264, 0, 264, 0, 0, 0
8368, 1, 1636422659053, 1636422659314, 261, 0, 261, 0, 0, 0
8369, 1, 1636422659161, 1636422659429, 268, 1, 267, 1, 0, 1
8370, 1, 1636422659277, 1636422659545, 268, 0, 268, 0, 0, 0
8371, 1, 1636422659345, 1636422659613, 268, 0, 268, 0, 0, 0
8372, 1, 1636422659445, 1636422659714, 269, 0, 269, 0, 0, 0
8373, 1, 1636422659454, 1636422659722, 268, 0, 268, 0, 0, 0
8375, 1, 1636422659637, 1636422659909, 272, 1, 271, 1, 0, 1
8376, 1, 1636422659714, 1636422659978, 264, 0, 264, 0, 0, 0
8377, 1, 1636422659817, 1636422660081, 264, 1, 263, 1, 0, 1
8378, 1, 1636422659861, 1636422660129, 268, 1, 267, 1, 0, 1
8379, 1, 1636422659965, 1636422660229, 264, 1, 263, 0, 1, 1
8382, 1, 1636422660265, 1636422660533, 268, 1, 267, 0, 0, 0
8381, 1, 1636422660265, 1636422660541, 276, 1, 275, 0, 0, 0
8383, 1, 1636422660441, 1636422660717, 276, 0, 276, 0, 0, 0
8384, 1, 1636422660501, 1636422660773, 272, 0, 272, 0, 0, 0
8385, 1, 1636422660614, 1636422660881, 267, 0, 267, 0, 0, 0
8386, 1, 1636422660614, 1636422660881, 267, 0, 267, 0, 0, 0
8387, 1, 1636422660653, 1636422660925, 272, 0, 272, 0, 0, 0
8388, 1, 1636422660765, 1636422661037, 272, 0, 272, 0, 0, 0
8390, 1, 1636422661054, 1636422661326, 272, 0, 272, 0, 0, 0
8389, 1, 1636422661054, 1636422661326, 272, 0, 272, 0, 0, 0
8391, 1, 1636422661241, 1636422661510, 269, 1, 268, 0, 1, 1
8392, 1, 1636422661301, 1636422661577, 276, 0, 276, 0, 0, 0
8393, 1, 1636422661345, 1636422661613, 268, 0, 268, 0, 0, 0
8394, 1, 1636422661413, 1636422661717, 304, 0, 304, 0, 0, 0
8396, 1, 1636422661561, 1636422661830, 269, 1, 268, 1, 0, 1
8397, 1, 1636422661570, 1636422661837, 267, 0, 267, 0, 0, 0
8398, 1, 1636422661845, 1636422662117, 272, 1, 271, 1, 0, 1
8399, 1, 1636422661862, 1636422662129, 267, 0, 267, 0, 0, 0
8400, 1, 1636422661989, 1636422662258, 269, 1, 268, 0, 1, 1
8401, 1, 1636422662089, 1636422662358, 269, 0, 269, 0, 0, 0
8402, 1, 1636422662125, 1636422662393, 268, 1, 267, 0, 0, 0
8403, 1, 1636422662205, 1636422662473, 268, 1, 267, 0, 1, 1
8404, 1, 1636422662290, 1636422662558, 268, 0, 268, 0, 0, 0
8405, 1, 1636422662349, 1636422662617, 268, 1, 267, 0, 1, 1
8406, 1, 1636422662649, 1636422662917, 268, 0, 268, 0, 0, 0
8408, 1, 1636422662705, 1636422662978, 273, 1, 272, 0, 0, 0
8409, 1, 1636422662877, 1636422663146, 269, 0, 269, 0, 0, 0
8410, 1, 1636422662937, 1636422663209, 272, 0, 272, 0, 0, 0
8411, 1, 1636422663022, 1636422663286, 264, 0, 264, 0, 0, 0
8412, 1, 1636422663069, 1636422663334, 265, 0, 265, 0, 0, 0
8413, 1, 1636422663157, 1636422663425, 268, 1, 267, 0, 0, 0
8414, 1, 1636422663433, 1636422663709, 276, 0, 276, 0, 0, 0
8415, 1, 1636422663489, 1636422663757, 268, 1, 267, 0, 0, 0
8416, 1, 1636422663690, 1636422663962, 272, 0, 272, 0, 0, 0
8417, 1, 1636422663749, 1636422664017, 268, 1, 267, 0, 1, 1
8418, 1, 1636422663826, 1636422664114, 288, 0, 288, 0, 0, 0
8419, 1, 1636422663881, 1636422664149, 268, 1, 267, 0, 0, 0
8420, 1, 1636422663946, 1636422664217, 271, 0, 271, 0, 0, 0
8421, 1, 1636422664241, 1636422664509, 268, 1, 267, 0, 1, 1
8422, 1, 1636422664297, 1636422664569, 272, 1, 271, 0, 1, 1
8423, 1, 1636422664369, 1636422664637, 268, 1, 267, 0, 0, 0
8424, 1, 1636422664489, 1636422664757, 268, 1, 267, 0, 0, 0
8425, 1, 1636422664545, 1636422664813, 268, 1, 267, 0, 0, 0
8426, 1, 1636422664614, 1636422664882, 268, 0, 268, 0, 0, 0
8427, 1, 1636422664693, 1636422664961, 268, 0, 268, 0, 0, 0
8429, 1, 1636422665030, 1636422665297, 267, 0, 267, 0, 0, 0
8430, 1, 1636422665085, 1636422665354, 269, 1, 268, 0, 0, 0
8431, 1, 1636422665105, 1636422665373, 268, 1, 267, 0, 0, 0
8432, 1, 1636422665289, 1636422665553, 264, 1, 263, 0, 1, 1
8433, 1, 1636422665357, 1636422665625, 268, 0, 268, 0, 0, 0
8434, 1, 1636422665418, 1636422665686, 268, 0, 268, 0, 0, 0
8435, 1, 1636422665482, 1636422665757, 275, 0, 275, 0, 0, 0
8436, 1, 1636422665853, 1636422666117, 264, 0, 264, 0, 0, 0
8438, 1, 1636422665898, 1636422666165, 267, 0, 267, 0, 0, 0
8439, 1, 1636422666026, 1636422666293, 267, 0, 267, 0, 0, 0
8440, 1, 1636422666142, 1636422666409, 267, 0, 267, 0, 0, 0
8442, 1, 1636422666297, 1636422666569, 272, 0, 272, 0, 0, 0
8443, 1, 1636422666626, 1636422666894, 268, 0, 268, 0, 0, 0
8444, 1, 1636422666697, 1636422666966, 269, 0, 269, 0, 0, 0
8445, 1, 1636422666741, 1636422667009, 268, 1, 267, 0, 1, 1
8446, 1, 1636422666958, 1636422667226, 268, 0, 268, 0, 0, 0
8447, 1, 1636422667086, 1636422667354, 268, 0, 268, 0, 0, 0
8448, 1, 1636422667430, 1636422667698, 268, 0, 268, 0, 0, 0
8449, 1, 1636422667490, 1636422667758, 268, 0, 268, 0, 0, 0
8450, 1, 1636422667545, 1636422667837, 292, 1, 291, 0, 1, 1
8451, 1, 1636422667758, 1636422668029, 271, 0, 271, 0, 0, 0
8452, 1, 1636422667925, 1636422668193, 268, 1, 267, 1, 0, 1
8453, 1, 1636422668102, 1636422668374, 272, 0, 272, 0, 0, 0
8454, 1, 1636422668306, 1636422668577, 271, 0, 271, 0, 0, 0
8455, 1, 1636422668353, 1636422668622, 269, 1, 268, 0, 0, 0
8456, 1, 1636422668577, 1636422668841, 264, 1, 263, 0, 0, 0
8457, 1, 1636422668705, 1636422668974, 269, 1, 268, 0, 0, 0
8458, 1, 1636422668817, 1636422669094, 277, 1, 276, 1, 0, 1
8459, 1, 1636422669114, 1636422669377, 263, 0, 263, 0, 0, 0
8460, 1, 1636422669174, 1636422669442, 268, 0, 268, 0, 0, 0
8461, 1, 1636422669358, 1636422669629, 271, 0, 271, 0, 0, 0
8462, 1, 1636422669485, 1636422669754, 269, 0, 269, 0, 0, 0
8374, 2, 1636422659714, 1636422669759, 10045, 0, 10045, 0, 0, 0
8463, 1, 1636422669625, 1636422669981, 356, 1, 355, 0, 0, 0
8465, 1, 1636422669941, 1636422670213, 272, 0, 272, 0, 0, 0
8464, 1, 1636422669981, 1636422670246, 265, 1, 264, 0, 0, 0
8466, 1, 1636422670126, 1636422670397, 271, 0, 271, 0, 0, 0
8468, 1, 1636422670297, 1636422670566, 269, 1, 268, 0, 0, 0
8469, 1, 1636422670429, 1636422670698, 269, 0, 269, 0, 0, 0
8470, 1, 1636422670701, 1636422670970, 269, 0, 269, 0, 0, 0
8471, 1, 1636422670749, 1636422671021, 272, 0, 272, 0, 0, 0
8472, 1, 1636422670833, 1636422671102, 269, 1, 268, 0, 0, 0
8474, 1, 1636422671246, 1636422671514, 268, 0, 268, 0, 0, 0
8476, 1, 1636422671542, 1636422671805, 263, 0, 263, 0, 0, 0
8477, 1, 1636422671633, 1636422671902, 269, 1, 268, 0, 0, 0
8478, 1, 1636422672042, 1636422672314, 272, 0, 272, 0, 0, 0
8479, 1, 1636422672426, 1636422672698, 272, 0, 272, 0, 0, 0
8480, 1, 1636422672834, 1636422673110, 276, 0, 276, 0, 0, 0
8481, 1, 1636422673233, 1636422673501, 268, 0, 268, 0, 0, 0
8482, 1, 1636422673630, 1636422673902, 272, 0, 272, 0, 0, 0
8483, 1, 1636422674022, 1636422674290, 268, 0, 268, 0, 0, 0
8485, 1, 1636422675066, 1636422675338, 272, 0, 272, 0, 0, 0
8486, 1, 1636422675781, 1636422676054, 273, 1, 272, 0, 1, 1
8487, 1, 1636422676193, 1636422676461, 268, 1, 267, 1, 0, 1
8488, 1, 1636422676594, 1636422676862, 268, 0, 268, 0, 0, 0
8489, 1, 1636422676921, 1636422677194, 273, 1, 272, 1, 0, 1
8490, 1, 1636422677406, 1636422677674, 268, 0, 268, 0, 0, 0
8491, 1, 1636422677706, 1636422677978, 272, 0, 272, 0, 0, 0
8492, 1, 1636422678222, 1636422678494, 272, 0, 272, 0, 0, 0
8493, 1, 1636422678514, 1636422678785, 271, 0, 271, 0, 0, 0
8494, 1, 1636422679010, 1636422679282, 272, 0, 272, 0, 0, 0
8495, 1, 1636422679322, 1636422679589, 267, 0, 267, 0, 0, 0
8500, 1, 1636422680125, 1636422680394, 269, 0, 269, 0, 0, 0
8499, 1, 1636422680125, 1636422680394, 269, 1, 268, 0, 1, 1
8501, 1, 1636422680473, 1636422680750, 277, 1, 276, 0, 0, 0
8502, 1, 1636422680830, 1636422681101, 271, 0, 271, 0, 0, 0
8503, 1, 1636422680921, 1636422681189, 268, 1, 267, 0, 0, 0
8475, 1, 1636422681105, 1636422681373, 268, 0, 268, 0, 0, 0
8504, 1, 1636422681193, 1636422681461, 268, 0, 268, 0, 0, 0
8505, 1, 1636422681409, 1636422681677, 268, 0, 268, 0, 0, 0
8506, 1, 1636422681625, 1636422681893, 268, 1, 267, 0, 0, 0
8507, 1, 1636422681717, 1636422681985, 268, 1, 267, 0, 0, 0
8508, 1, 1636422681773, 1636422682041, 268, 0, 268, 0, 0, 0
8509, 1, 1636422681997, 1636422682266, 269, 1, 268, 0, 0, 0
8510, 1, 1636422682129, 1636422682398, 269, 0, 269, 0, 0, 0
8511, 1, 1636422682417, 1636422682693, 276, 0, 276, 0, 0, 0
8512, 1, 1636422682530, 1636422682801, 271, 0, 271, 0, 0, 0
8513, 1, 1636422682533, 1636422682805, 272, 0, 272, 0, 0, 0
8514, 1, 1636422682781, 1636422683050, 269, 1, 268, 0, 0, 0
8515, 1, 1636422682930, 1636422683198, 268, 0, 268, 0, 0, 0
8516, 1, 1636422683226, 1636422683493, 267, 0, 267, 0, 0, 0
8517, 1, 1636422683338, 1636422683606, 268, 0, 268, 0, 0, 0
8518, 1, 1636422683338, 1636422683609, 271, 0, 271, 0, 0, 0
8519, 1, 1636422683585, 1636422683857, 272, 0, 272, 0, 0, 0
8520, 1, 1636422683717, 1636422683986, 269, 1, 268, 0, 0, 0
8522, 1, 1636422684122, 1636422684390, 268, 0, 268, 0, 0, 0
8523, 1, 1636422684129, 1636422684398, 269, 0, 269, 0, 0, 0
8525, 1, 1636422684525, 1636422684798, 273, 1, 272, 1, 0, 1
8526, 1, 1636422684934, 1636422685202, 268, 0, 268, 0, 0, 0
8527, 1, 1636422684937, 1636422685209, 272, 1, 271, 0, 1, 1
8528, 1, 1636422685153, 1636422685426, 273, 1, 272, 0, 0, 0
8531, 1, 1636422685734, 1636422686001, 267, 0, 267, 0, 0, 0
8532, 1, 1636422685862, 1636422686133, 271, 0, 271, 0, 0, 0
8533, 1, 1636422686530, 1636422686798, 268, 0, 268, 0, 0, 0
8534, 1, 1636422686666, 1636422686938, 272, 0, 272, 0, 0, 0
8535, 1, 1636422687321, 1636422687590, 269, 1, 268, 0, 0, 0
8536, 1, 1636422687477, 1636422687746, 269, 1, 268, 0, 1, 1
8537, 1, 1636422688122, 1636422688394, 272, 0, 272, 0, 0, 0
8538, 1, 1636422688293, 1636422688566, 273, 1, 272, 0, 0, 0
8539, 1, 1636422688914, 1636422689181, 267, 0, 267, 0, 0, 0
8540, 1, 1636422689082, 1636422689353, 271, 0, 271, 0, 0, 0
8541, 1, 1636422689722, 1636422689990, 268, 0, 268, 0, 0, 0
8542, 1, 1636422690462, 1636422690730, 268, 0, 268, 0, 0, 0
8545, 1, 1636422690514, 1636422690781, 267, 0, 267, 0, 0, 0
8543, 1, 1636422690733, 1636422691005, 272, 1, 271, 0, 0, 0
8544, 1, 1636422691010, 1636422691278, 268, 0, 268, 0, 0, 0
8546, 1, 1636422691170, 1636422691438, 268, 0, 268, 0, 0, 0
8547, 1, 1636422691321, 1636422691589, 268, 1, 267, 0, 1, 1
8548, 1, 1636422691406, 1636422691674, 268, 0, 268, 0, 0, 0
8549, 1, 1636422691678, 1636422691946, 268, 0, 268, 0, 0, 0
8550, 1, 1636422691958, 1636422692225, 267, 0, 267, 0, 0, 0
8551, 1, 1636422692125, 1636422692393, 268, 1, 267, 1, 0, 1
8552, 1, 1636422692173, 1636422692437, 264, 1, 263, 0, 1, 1
8553, 1, 1636422692445, 1636422692717, 272, 1, 271, 0, 1, 1
8554, 1, 1636422692765, 1636422693038, 273, 0, 273, 0, 0, 0
8555, 1, 1636422692917, 1636422693185, 268, 1, 267, 0, 1, 1
8556, 1, 1636422692978, 1636422693246, 268, 0, 268, 0, 0, 0
8557, 1, 1636422693257, 1636422693529, 272, 0, 272, 0, 0, 0
8558, 1, 1636422693573, 1636422693838, 265, 0, 265, 0, 0, 0
8559, 1, 1636422693701, 1636422693969, 268, 0, 268, 0, 0, 0
8560, 1, 1636422693765, 1636422694061, 296, 1, 295, 1, 0, 1
8561, 1, 1636422694065, 1636422694337, 272, 1, 271, 0, 0, 0
8562, 1, 1636422694333, 1636422694598, 265, 0, 265, 0, 0, 0
8563, 1, 1636422694377, 1636422694645, 268, 0, 268, 0, 0, 0
8564, 1, 1636422694513, 1636422694781, 268, 0, 268, 0, 0, 0
8565, 1, 1636422694554, 1636422694817, 263, 0, 263, 0, 0, 0
8566, 1, 1636422694685, 1636422694958, 273, 0, 273, 0, 0, 0
8567, 1, 1636422694849, 1636422695117, 268, 1, 267, 0, 0, 0
8568, 1, 1636422695038, 1636422695310, 272, 0, 272, 0, 0, 0
8569, 1, 1636422695169, 1636422695446, 277, 1, 276, 0, 0, 0
8530, 1, 1636422695317, 1636422695589, 272, 0, 272, 0, 0, 0
8571, 1, 1636422695405, 1636422695674, 269, 0, 269, 0, 0, 0
8570, 1, 1636422695405, 1636422695674, 269, 1, 268, 0, 1, 1
8572, 1, 1636422695621, 1636422695890, 269, 0, 269, 0, 0, 0
8573, 1, 1636422695677, 1636422695941, 264, 0, 264, 0, 0, 0
8574, 1, 1636422695822, 1636422696094, 272, 0, 272, 0, 0, 0
8576, 1, 1636422695965, 1636422696233, 268, 1, 267, 0, 1, 1
8575, 1, 1636422695994, 1636422696261, 267, 0, 267, 0, 0, 0
8577, 1, 1636422696202, 1636422696470, 268, 0, 268, 0, 0, 0
8578, 1, 1636422696337, 1636422696613, 276, 0, 276, 0, 0, 0
8579, 1, 1636422696453, 1636422696721, 268, 1, 267, 0, 1, 1
8580, 1, 1636422696625, 1636422696893, 268, 0, 268, 0, 0, 0
8581, 1, 1636422696737, 1636422697006, 269, 0, 269, 0, 0, 0
8582, 1, 1636422696745, 1636422697013, 268, 1, 267, 1, 0, 1
8583, 1, 1636422697005, 1636422697274, 269, 1, 268, 0, 0, 0
8584, 1, 1636422697138, 1636422697405, 267, 0, 267, 0, 0, 0
8585, 1, 1636422697266, 1636422697533, 267, 0, 267, 0, 0, 0
8586, 1, 1636422697442, 1636422697710, 268, 0, 268, 0, 0, 0
8587, 1, 1636422697526, 1636422697790, 264, 0, 264, 0, 0, 0
8588, 1, 1636422697817, 1636422698085, 268, 0, 268, 0, 0, 0
8589, 1, 1636422697942, 1636422698209, 267, 0, 267, 0, 0, 0
8590, 1, 1636422698253, 1636422698526, 273, 1, 272, 0, 0, 0
8591, 1, 1636422698325, 1636422698593, 268, 1, 267, 0, 0, 0
8592, 1, 1636422698634, 1636422698906, 272, 0, 272, 0, 0, 0
8593, 1, 1636422698757, 1636422699030, 273, 0, 273, 0, 0, 0
8594, 1, 1636422699046, 1636422699314, 268, 0, 268, 0, 0, 0
8595, 1, 1636422699137, 1636422699406, 269, 0, 269, 0, 0, 0
8596, 1, 1636422699425, 1636422699694, 269, 1, 268, 1, 0, 1
8597, 1, 1636422699557, 1636422699834, 277, 0, 277, 0, 0, 0
8598, 1, 1636422699954, 1636422700217, 263, 0, 263, 0, 0, 0
8599, 1, 1636422700346, 1636422700617, 271, 0, 271, 0, 0, 0
8600, 1, 1636422700754, 1636422701026, 272, 0, 272, 0, 0, 0
