Xid, State, StartTime, EndTime, TransactionTime, ExecuteTime, CommunicationTime, ReadTime, WriteTime, DBTime
16, 1, 1636429428421, 1636429428915, 494, 75, 419, 35, 5, 40
18, 1, 1636429429258, 1636429429667, 409, 5, 404, 2, 1, 3
20, 1, 1636429429979, 1636429430386, 407, 3, 404, 1, 1, 2
22, 1, 1636429430654, 1636429431063, 409, 4, 405, 1, 1, 2
24, 1, 1636429431330, 1636429431734, 404, 4, 400, 0, 0, 0
27, 1, 1636429432002, 1636429432410, 408, 3, 405, 3, 0, 3
29, 1, 1636429432678, 1636429433086, 408, 4, 404, 0, 0, 0
31, 1, 1636429433354, 1636429433762, 408, 4, 404, 1, 0, 1
33, 1, 1636429434030, 1636429434442, 412, 3, 409, 3, 0, 3
35, 1, 1636429434710, 1636429435118, 408, 3, 405, 1, 0, 1
37, 1, 1636429435386, 1636429435794, 408, 3, 405, 2, 0, 2
39, 1, 1636429436062, 1636429436467, 405, 4, 401, 2, 0, 2
41, 1, 1636429436734, 1636429437143, 409, 3, 406, 0, 1, 1
43, 1, 1636429437406, 1636429437810, 404, 4, 400, 1, 0, 1
45, 1, 1636429438078, 1636429438486, 408, 1, 407, 0, 1, 1
47, 1, 1636429438754, 1636429439163, 409, 7, 402, 0, 0, 0
49, 1, 1636429439425, 1636429439786, 361, 2, 359, 0, 0, 0
51, 1, 1636429440050, 1636429440414, 364, 2, 362, 0, 0, 0
53, 1, 1636429440682, 1636429441046, 364, 3, 361, 2, 0, 2
55, 1, 1636429441314, 1636429441678, 364, 1, 363, 1, 0, 1
57, 1, 1636429441946, 1636429442310, 364, 2, 362, 0, 0, 0
59, 1, 1636429442578, 1636429442942, 364, 3, 361, 1, 0, 1
61, 1, 1636429443210, 1636429443574, 364, 2, 362, 0, 1, 1
64, 1, 1636429443838, 1636429444202, 364, 2, 362, 0, 0, 0
67, 1, 1636429444466, 1636429444830, 364, 3, 361, 0, 0, 0
70, 1, 1636429445094, 1636429445454, 360, 0, 360, 0, 0, 0
73, 1, 1636429445718, 1636429446082, 364, 2, 362, 1, 0, 1
76, 1, 1636429446346, 1636429446706, 360, 2, 358, 0, 1, 1
78, 1, 1636429446974, 1636429447330, 356, 1, 355, 0, 0, 0
81, 1, 1636429447598, 1636429447966, 368, 1, 367, 0, 1, 1
84, 1, 1636429448230, 1636429448586, 356, 1, 355, 0, 1, 1
87, 1, 1636429448854, 1636429449214, 360, 2, 358, 0, 1, 1
90, 1, 1636429449482, 1636429449850, 368, 1, 367, 0, 0, 0
93, 1, 1636429450118, 1636429450482, 364, 1, 363, 0, 0, 0
96, 1, 1636429450750, 1636429451110, 360, 2, 358, 0, 0, 0
99, 1, 1636429451374, 1636429451738, 364, 1, 363, 0, 1, 1
102, 1, 1636429452006, 1636429452370, 364, 3, 361, 0, 0, 0
105, 1, 1636429452638, 1636429453002, 364, 1, 363, 0, 0, 0
108, 1, 1636429453270, 1636429453630, 360, 0, 360, 0, 0, 0
111, 1, 1636429453898, 1636429454258, 360, 0, 360, 0, 0, 0
114, 1, 1636429454526, 1636429454890, 364, 1, 363, 0, 1, 1
117, 1, 1636429455154, 1636429455514, 360, 2, 358, 0, 0, 0
120, 1, 1636429455778, 1636429456138, 360, 1, 359, 0, 0, 0
123, 1, 1636429456402, 1636429456762, 360, 0, 360, 0, 0, 0
126, 1, 1636429457030, 1636429457390, 360, 0, 360, 0, 0, 0
129, 1, 1636429457654, 1636429458018, 364, 0, 364, 0, 0, 0
132, 1, 1636429458290, 1636429458654, 364, 0, 364, 0, 0, 0
135, 1, 1636429458922, 1636429459290, 368, 0, 368, 0, 0, 0
138, 1, 1636429459558, 1636429459922, 364, 1, 363, 0, 0, 0
141, 1, 1636429460190, 1636429460554, 364, 0, 364, 0, 0, 0
144, 1, 1636429460822, 1636429461186, 364, 0, 364, 0, 0, 0
147, 1, 1636429461450, 1636429461810, 360, 2, 358, 0, 1, 1
150, 1, 1636429462078, 1636429462442, 364, 0, 364, 0, 0, 0
153, 1, 1636429462710, 1636429463078, 368, 0, 368, 0, 0, 0
156, 1, 1636429463338, 1636429463694, 356, 1, 355, 0, 0, 0
159, 1, 1636429463962, 1636429464322, 360, 0, 360, 0, 0, 0
162, 1, 1636429464590, 1636429464954, 364, 1, 363, 0, 0, 0
165, 1, 1636429465217, 1636429465578, 361, 1, 360, 0, 0, 0
168, 1, 1636429465846, 1636429466210, 364, 1, 363, 1, 0, 1
171, 1, 1636429466478, 1636429466842, 364, 1, 363, 0, 0, 0
174, 1, 1636429467106, 1636429467466, 360, 0, 360, 0, 0, 0
177, 1, 1636429467733, 1636429468098, 365, 1, 364, 0, 0, 0
180, 1, 1636429468366, 1636429468730, 364, 1, 363, 0, 0, 0
183, 1, 1636429468994, 1636429469362, 368, 1, 367, 0, 0, 0
186, 1, 1636429469626, 1636429469990, 364, 5, 359, 3, 1, 4
189, 1, 1636429470254, 1636429470614, 360, 2, 358, 0, 0, 0
192, 1, 1636429470886, 1636429471250, 364, 0, 364, 0, 0, 0
195, 1, 1636429471514, 1636429471874, 360, 0, 360, 0, 0, 0
198, 1, 1636429472138, 1636429472502, 364, 0, 364, 0, 0, 0
201, 1, 1636429472762, 1636429473126, 364, 0, 364, 0, 0, 0
204, 1, 1636429473390, 1636429473750, 360, 1, 359, 0, 0, 0
207, 1, 1636429474018, 1636429474378, 360, 2, 358, 1, 0, 1
210, 1, 1636429474642, 1636429475002, 360, 1, 359, 0, 0, 0
213, 1, 1636429475266, 1636429475630, 364, 2, 362, 1, 0, 1
215, 1, 1636429475898, 1636429476262, 364, 1, 363, 0, 1, 1
218, 1, 1636429476526, 1636429476889, 363, 2, 361, 1, 0, 1
221, 1, 1636429477154, 1636429477514, 360, 0, 360, 0, 0, 0
224, 1, 1636429477782, 1636429478142, 360, 0, 360, 0, 0, 0
227, 1, 1636429478406, 1636429478766, 360, 2, 358, 0, 1, 1
230, 1, 1636429479030, 1636429479394, 364, 0, 364, 0, 0, 0
233, 1, 1636429479658, 1636429480022, 364, 0, 364, 0, 0, 0
236, 1, 1636429480286, 1636429480650, 364, 0, 364, 0, 0, 0
239, 1, 1636429480914, 1636429481277, 363, 1, 362, 0, 0, 0
243, 1, 1636429481541, 1636429481902, 361, 2, 359, 0, 1, 1
245, 1, 1636429482165, 1636429482521, 356, 3, 353, 1, 0, 1
248, 1, 1636429482786, 1636429483146, 360, 3, 357, 0, 0, 0
251, 1, 1636429483410, 1636429483774, 364, 1, 363, 0, 0, 0
254, 1, 1636429484042, 1636429484402, 360, 0, 360, 0, 0, 0
257, 1, 1636429484666, 1636429485026, 360, 0, 360, 0, 0, 0
260, 1, 1636429485290, 1636429485650, 360, 0, 360, 0, 0, 0
263, 1, 1636429485914, 1636429486278, 364, 0, 364, 0, 0, 0
266, 1, 1636429486545, 1636429486910, 365, 3, 362, 0, 1, 1
269, 1, 1636429487174, 1636429487530, 356, 0, 356, 0, 0, 0
272, 1, 1636429487798, 1636429488158, 360, 0, 360, 0, 0, 0
275, 1, 1636429488426, 1636429488786, 360, 2, 358, 0, 0, 0
278, 1, 1636429489054, 1636429489418, 364, 1, 363, 0, 0, 0
281, 1, 1636429489686, 1636429490050, 364, 3, 361, 0, 0, 0
284, 1, 1636429490317, 1636429490682, 365, 1, 364, 0, 1, 1
287, 1, 1636429490950, 1636429491310, 360, 0, 360, 0, 0, 0
290, 1, 1636429491574, 1636429491938, 364, 1, 363, 0, 0, 0
293, 1, 1636429492201, 1636429492562, 361, 1, 360, 0, 0, 0
296, 1, 1636429492826, 1636429493186, 360, 0, 360, 0, 0, 0
299, 1, 1636429493450, 1636429493814, 364, 1, 363, 0, 0, 0
302, 1, 1636429494078, 1636429494438, 360, 0, 360, 0, 0, 0
305, 1, 1636429494701, 1636429495070, 369, 1, 368, 0, 0, 0
308, 1, 1636429495333, 1636429495690, 357, 2, 355, 2, 0, 2
311, 1, 1636429495954, 1636429496318, 364, 0, 364, 0, 0, 0
314, 1, 1636429496582, 1636429496946, 364, 0, 364, 0, 0, 0
317, 1, 1636429497214, 1636429497578, 364, 0, 364, 0, 0, 0
320, 1, 1636429497842, 1636429498206, 364, 1, 363, 0, 0, 0
323, 1, 1636429498470, 1636429498838, 368, 1, 367, 1, 0, 1
326, 1, 1636429499106, 1636429499466, 360, 1, 359, 1, 0, 1
329, 1, 1636429499730, 1636429500090, 360, 0, 360, 0, 0, 0
332, 1, 1636429500354, 1636429500713, 359, 0, 359, 0, 0, 0
335, 1, 1636429500981, 1636429501345, 364, 3, 361, 3, 0, 3
338, 1, 1636429501610, 1636429501970, 360, 1, 359, 0, 0, 0
341, 1, 1636429502233, 1636429502594, 361, 1, 360, 0, 0, 0
344, 1, 1636429502862, 1636429503226, 364, 0, 364, 0, 0, 0
347, 1, 1636429503490, 1636429503854, 364, 1, 363, 0, 0, 0
350, 1, 1636429504118, 1636429504482, 364, 0, 364, 0, 0, 0
353, 1, 1636429504746, 1636429505110, 364, 0, 364, 0, 0, 0
356, 1, 1636429505373, 1636429505730, 357, 2, 355, 0, 0, 0
359, 1, 1636429505994, 1636429506358, 364, 0, 364, 0, 0, 0
362, 1, 1636429506626, 1636429506990, 364, 0, 364, 0, 0, 0
365, 1, 1636429507254, 1636429507614, 360, 1, 359, 0, 0, 0
368, 1, 1636429507878, 1636429508238, 360, 1, 359, 0, 0, 0
371, 1, 1636429508502, 1636429508862, 360, 1, 359, 0, 0, 0
374, 1, 1636429509126, 1636429509486, 360, 2, 358, 0, 1, 1
377, 1, 1636429509749, 1636429510109, 360, 1, 359, 0, 0, 0
380, 1, 1636429510374, 1636429510734, 360, 0, 360, 0, 0, 0
383, 1, 1636429511001, 1636429511365, 364, 1, 363, 0, 1, 1
386, 1, 1636429511629, 1636429511990, 361, 1, 360, 0, 0, 0
389, 1, 1636429512254, 1636429512614, 360, 1, 359, 0, 0, 0
392, 1, 1636429512877, 1636429513237, 360, 3, 357, 2, 0, 2
395, 1, 1636429513501, 1636429513862, 361, 1, 360, 0, 0, 0
398, 1, 1636429514126, 1636429514490, 364, 1, 363, 0, 0, 0
401, 1, 1636429514757, 1636429515122, 365, 1, 364, 0, 0, 0
404, 1, 1636429515385, 1636429515749, 364, 1, 363, 1, 0, 1
407, 1, 1636429516017, 1636429516382, 365, 1, 364, 1, 0, 1
410, 1, 1636429516650, 1636429517010, 360, 1, 359, 0, 0, 0
413, 1, 1636429517282, 1636429517646, 364, 1, 363, 1, 0, 1
416, 1, 1636429517910, 1636429518274, 364, 0, 364, 0, 0, 0
419, 1, 1636429518537, 1636429518898, 361, 1, 360, 1, 0, 1
422, 1, 1636429519162, 1636429519522, 360, 0, 360, 0, 0, 0
425, 1, 1636429519789, 1636429520150, 361, 3, 358, 0, 0, 0
428, 1, 1636429520422, 1636429520782, 360, 1, 359, 0, 0, 0
431, 1, 1636429521050, 1636429521406, 356, 0, 356, 0, 0, 0
434, 1, 1636429521670, 1636429522034, 364, 0, 364, 0, 0, 0
437, 1, 1636429522298, 1636429522658, 360, 1, 359, 0, 0, 0
440, 1, 1636429522922, 1636429523286, 364, 0, 364, 0, 0, 0
443, 1, 1636429523550, 1636429523909, 359, 0, 359, 0, 0, 0
446, 1, 1636429524177, 1636429524542, 365, 1, 364, 1, 0, 1
449, 1, 1636429524810, 1636429525174, 364, 1, 363, 1, 0, 1
452, 1, 1636429525438, 1636429525794, 356, 1, 355, 0, 0, 0
455, 1, 1636429526062, 1636429526422, 360, 0, 360, 0, 0, 0
458, 1, 1636429526686, 1636429527050, 364, 0, 364, 0, 0, 0
461, 1, 1636429527321, 1636429527686, 365, 2, 363, 0, 1, 1
464, 1, 1636429527954, 1636429528322, 368, 0, 368, 0, 0, 0
467, 1, 1636429528586, 1636429528950, 364, 1, 363, 0, 0, 0
470, 1, 1636429529218, 1636429529574, 356, 0, 356, 0, 0, 0
473, 1, 1636429529838, 1636429530202, 364, 0, 364, 0, 0, 0
476, 1, 1636429530470, 1636429530830, 360, 0, 360, 0, 0, 0
479, 1, 1636429531094, 1636429531454, 360, 0, 360, 0, 0, 0
482, 1, 1636429531717, 1636429532078, 361, 1, 360, 0, 0, 0
485, 1, 1636429532342, 1636429532706, 364, 2, 362, 0, 0, 0
488, 1, 1636429532966, 1636429533330, 364, 2, 362, 0, 0, 0
491, 1, 1636429533593, 1636429533946, 353, 1, 352, 0, 0, 0
494, 1, 1636429534210, 1636429534574, 364, 1, 363, 1, 0, 1
497, 1, 1636429534838, 1636429535198, 360, 1, 359, 1, 0, 1
500, 1, 1636429535461, 1636429535818, 357, 1, 356, 0, 0, 0
503, 1, 1636429536086, 1636429536450, 364, 1, 363, 0, 0, 0
506, 1, 1636429536710, 1636429537073, 363, 1, 362, 0, 0, 0
509, 1, 1636429537338, 1636429537694, 356, 0, 356, 0, 0, 0
512, 1, 1636429537957, 1636429538322, 365, 1, 364, 0, 0, 0
515, 1, 1636429538586, 1636429538950, 364, 1, 363, 1, 0, 1
518, 1, 1636429539214, 1636429539578, 364, 0, 364, 0, 0, 0
521, 1, 1636429539842, 1636429540202, 360, 1, 359, 0, 0, 0
524, 1, 1636429540466, 1636429540833, 367, 1, 366, 0, 0, 0
527, 1, 1636429541098, 1636429541462, 364, 0, 364, 0, 0, 0
530, 1, 1636429541726, 1636429542082, 356, 1, 355, 0, 0, 0
533, 1, 1636429542346, 1636429542710, 364, 0, 364, 0, 0, 0
536, 1, 1636429542974, 1636429543341, 367, 0, 367, 0, 0, 0
539, 1, 1636429543606, 1636429543966, 360, 1, 359, 0, 0, 0
542, 1, 1636429544229, 1636429544586, 357, 1, 356, 0, 1, 1
545, 1, 1636429544846, 1636429545206, 360, 1, 359, 0, 0, 0
547, 1, 1636429545470, 1636429545830, 360, 0, 360, 0, 0, 0
549, 1, 1636429546093, 1636429546458, 365, 1, 364, 0, 0, 0
551, 1, 1636429546722, 1636429547086, 364, 0, 364, 0, 0, 0
553, 1, 1636429547354, 1636429547714, 360, 0, 360, 0, 0, 0
555, 1, 1636429547978, 1636429548338, 360, 0, 360, 0, 0, 0
557, 1, 1636429548602, 1636429548966, 364, 0, 364, 0, 0, 0
559, 1, 1636429549234, 1636429549598, 364, 0, 364, 0, 0, 0
561, 1, 1636429549866, 1636429550222, 356, 0, 356, 0, 0, 0
563, 1, 1636429550490, 1636429550850, 360, 1, 359, 0, 0, 0
565, 1, 1636429551114, 1636429551478, 364, 1, 363, 0, 0, 0
567, 1, 1636429551742, 1636429552102, 360, 0, 360, 0, 0, 0
569, 1, 1636429552370, 1636429552730, 360, 0, 360, 0, 0, 0
571, 1, 1636429552998, 1636429553358, 360, 0, 360, 0, 0, 0
573, 1, 1636429553622, 1636429553978, 356, 1, 355, 0, 0, 0
575, 1, 1636429554242, 1636429554602, 360, 0, 360, 0, 0, 0
601, 1, 1636429578618, 1636429579010, 392, 12, 380, 0, 0, 0
602, 1, 1636429579233, 1636429579594, 361, 1, 360, 0, 0, 0
603, 1, 1636429579502, 1636429579859, 357, 0, 357, 0, 0, 0
604, 1, 1636429579817, 1636429580177, 360, 1, 359, 0, 1, 1
605, 1, 1636429580086, 1636429580446, 360, 0, 360, 0, 0, 0
607, 1, 1636429580350, 1636429580706, 356, 0, 356, 0, 0, 0
606, 1, 1636429580401, 1636429580761, 360, 2, 358, 2, 0, 2
608, 1, 1636429580670, 1636429581034, 364, 0, 364, 0, 0, 0
610, 1, 1636429580934, 1636429581294, 360, 0, 360, 0, 0, 0
609, 1, 1636429580982, 1636429581338, 356, 0, 356, 0, 0, 0
612, 1, 1636429581198, 1636429581558, 360, 0, 360, 0, 0, 0
613, 1, 1636429581318, 1636429581682, 364, 0, 364, 0, 0, 0
614, 1, 1636429581526, 1636429581885, 359, 0, 359, 0, 0, 0
611, 1, 1636429581561, 1636429581921, 360, 1, 359, 1, 0, 1
616, 1, 1636429581786, 1636429582142, 356, 0, 356, 0, 0, 0
617, 1, 1636429581861, 1636429582214, 353, 2, 351, 0, 0, 0
618, 1, 1636429581970, 1636429582238, 268, 1, 267, 1, 0, 1
619, 1, 1636429582085, 1636429582358, 273, 1, 272, 0, 0, 0
615, 1, 1636429582153, 1636429582470, 317, 1, 316, 0, 0, 0
621, 1, 1636429582322, 1636429582597, 275, 0, 275, 0, 0, 0
622, 1, 1636429582398, 1636429582674, 276, 0, 276, 0, 0, 0
623, 1, 1636429582546, 1636429582822, 276, 0, 276, 0, 0, 0
624, 1, 1636429582622, 1636429582894, 272, 0, 272, 0, 0, 0
626, 1, 1636429582633, 1636429582906, 273, 1, 272, 0, 1, 1
625, 1, 1636429582650, 1636429582926, 276, 0, 276, 0, 0, 0
627, 1, 1636429582781, 1636429583054, 273, 1, 272, 0, 0, 0
628, 1, 1636429582885, 1636429583154, 269, 1, 268, 0, 0, 0
629, 1, 1636429583005, 1636429583282, 277, 1, 276, 1, 0, 1
631, 1, 1636429583070, 1636429583341, 271, 0, 271, 0, 0, 0
632, 1, 1636429583217, 1636429583494, 277, 1, 276, 1, 0, 1
633, 1, 1636429583297, 1636429583573, 276, 1, 275, 0, 0, 0
634, 1, 1636429583310, 1636429583577, 267, 0, 267, 0, 0, 0
635, 1, 1636429583338, 1636429583614, 276, 0, 276, 0, 0, 0
636, 1, 1636429583458, 1636429583729, 271, 0, 271, 0, 0, 0
637, 1, 1636429583549, 1636429583826, 277, 1, 276, 0, 0, 0
638, 1, 1636429583677, 1636429583950, 273, 1, 272, 0, 0, 0
639, 1, 1636429583758, 1636429584029, 271, 0, 271, 0, 0, 0
640, 1, 1636429583893, 1636429584161, 268, 1, 267, 0, 0, 0
641, 1, 1636429583966, 1636429584238, 272, 0, 272, 0, 0, 0
642, 1, 1636429583981, 1636429584254, 273, 1, 272, 0, 0, 0
643, 1, 1636429584014, 1636429584285, 271, 0, 271, 0, 0, 0
644, 1, 1636429584137, 1636429584413, 276, 1, 275, 0, 0, 0
645, 1, 1636429584226, 1636429584498, 272, 0, 272, 0, 0, 0
646, 1, 1636429584358, 1636429584630, 272, 0, 272, 0, 0, 0
647, 1, 1636429584433, 1636429584709, 276, 1, 275, 0, 0, 0
648, 1, 1636429584566, 1636429584838, 272, 0, 272, 0, 0, 0
649, 1, 1636429584633, 1636429584906, 273, 1, 272, 0, 1, 1
652, 1, 1636429584686, 1636429584958, 272, 0, 272, 0, 0, 0
653, 1, 1636429584821, 1636429585098, 277, 1, 276, 0, 0, 0
654, 1, 1636429584906, 1636429585178, 272, 0, 272, 0, 0, 0
655, 1, 1636429585030, 1636429585302, 272, 0, 272, 0, 0, 0
656, 1, 1636429585113, 1636429585390, 277, 1, 276, 0, 0, 0
659, 1, 1636429585317, 1636429585589, 272, 1, 271, 0, 0, 0
660, 1, 1636429585354, 1636429585625, 271, 0, 271, 0, 0, 0
661, 1, 1636429585506, 1636429585778, 272, 0, 272, 0, 0, 0
662, 1, 1636429585582, 1636429585854, 272, 1, 271, 0, 0, 0
664, 1, 1636429585794, 1636429586066, 272, 1, 271, 0, 1, 1
666, 1, 1636429585989, 1636429586258, 269, 1, 268, 0, 0, 0
667, 1, 1636429586033, 1636429586314, 281, 1, 280, 1, 0, 1
669, 1, 1636429586257, 1636429586534, 277, 1, 276, 0, 0, 0
671, 1, 1636429586470, 1636429586742, 272, 0, 272, 0, 0, 0
673, 1, 1636429586717, 1636429586990, 273, 1, 272, 0, 1, 1
675, 1, 1636429586938, 1636429587210, 272, 0, 272, 0, 0, 0
678, 1, 1636429587394, 1636429587666, 272, 0, 272, 0, 0, 0
685, 1, 1636429593501, 1636429593774, 273, 1, 272, 0, 0, 0
686, 1, 1636429593957, 1636429594230, 273, 1, 272, 0, 0, 0
687, 1, 1636429594197, 1636429594470, 273, 0, 273, 0, 0, 0
688, 1, 1636429594665, 1636429594938, 273, 1, 272, 1, 0, 1
689, 1, 1636429594890, 1636429595162, 272, 0, 272, 0, 0, 0
691, 1, 1636429595037, 1636429595342, 305, 1, 304, 0, 0, 0
690, 1, 1636429595029, 1636429595342, 313, 1, 312, 0, 0, 0
692, 1, 1636429595342, 1636429595618, 276, 0, 276, 0, 0, 0
693, 1, 1636429595562, 1636429595866, 304, 0, 304, 0, 0, 0
694, 1, 1636429595661, 1636429595957, 296, 1, 295, 0, 0, 0
695, 1, 1636429595661, 1636429595966, 305, 1, 304, 0, 1, 1
696, 1, 1636429595777, 1636429596046, 269, 1, 268, 1, 0, 1
697, 1, 1636429595790, 1636429596069, 279, 0, 279, 0, 0, 0
698, 1, 1636429596046, 1636429596361, 315, 0, 315, 0, 0, 0
699, 1, 1636429596141, 1636429596450, 309, 1, 308, 0, 0, 0
700, 1, 1636429596174, 1636429596450, 276, 0, 276, 0, 0, 0
701, 1, 1636429596269, 1636429596542, 273, 1, 272, 0, 0, 0
702, 1, 1636429596353, 1636429596630, 277, 1, 276, 1, 0, 1
703, 1, 1636429596397, 1636429596702, 305, 1, 304, 1, 0, 1
704, 1, 1636429596433, 1636429596702, 269, 1, 268, 0, 1, 1
705, 1, 1636429596485, 1636429596797, 312, 1, 311, 1, 0, 1
706, 1, 1636429596633, 1636429596910, 277, 1, 276, 0, 0, 0
707, 1, 1636429596701, 1636429596982, 281, 1, 280, 0, 0, 0
708, 1, 1636429596785, 1636429597053, 268, 1, 267, 1, 0, 1
710, 1, 1636429596877, 1636429597194, 317, 1, 316, 0, 0, 0
709, 1, 1636429596873, 1636429597194, 321, 1, 320, 0, 0, 0
711, 1, 1636429596933, 1636429597209, 276, 1, 275, 0, 1, 1
713, 1, 1636429597026, 1636429597290, 264, 0, 264, 0, 0, 0
715, 1, 1636429597105, 1636429597378, 273, 0, 273, 0, 0, 0
714, 1, 1636429597105, 1636429597378, 273, 0, 273, 0, 0, 0
712, 1, 1636429597105, 1636429597378, 273, 0, 273, 0, 0, 0
716, 1, 1636429597194, 1636429597470, 276, 1, 275, 0, 1, 1
717, 1, 1636429597257, 1636429597534, 277, 1, 276, 1, 0, 1
718, 1, 1636429597378, 1636429597661, 283, 1, 282, 0, 0, 0
719, 1, 1636429597398, 1636429597665, 267, 0, 267, 0, 0, 0
720, 1, 1636429597477, 1636429597753, 276, 1, 275, 0, 0, 0
721, 1, 1636429597573, 1636429597850, 277, 1, 276, 0, 0, 0
722, 1, 1636429597598, 1636429597874, 276, 0, 276, 0, 0, 0
723, 1, 1636429597605, 1636429597877, 272, 1, 271, 0, 0, 0
724, 1, 1636429597605, 1636429597886, 281, 1, 280, 0, 0, 0
725, 1, 1636429597661, 1636429597941, 280, 1, 279, 0, 1, 1
726, 1, 1636429597706, 1636429597978, 272, 0, 272, 0, 0, 0
728, 1, 1636429597793, 1636429598114, 321, 1, 320, 0, 1, 1
729, 1, 1636429597793, 1636429598122, 329, 1, 328, 0, 0, 0
727, 1, 1636429597842, 1636429598122, 280, 0, 280, 0, 0, 0
731, 1, 1636429597933, 1636429598214, 281, 1, 280, 0, 1, 1
730, 1, 1636429597893, 1636429598214, 321, 1, 320, 1, 0, 1
732, 1, 1636429598029, 1636429598306, 277, 1, 276, 0, 0, 0
733, 1, 1636429598057, 1636429598329, 272, 1, 271, 0, 0, 0
734, 1, 1636429598061, 1636429598333, 272, 1, 271, 0, 0, 0
735, 1, 1636429598169, 1636429598493, 324, 2, 322, 0, 0, 0
736, 1, 1636429598169, 1636429598493, 324, 1, 323, 0, 0, 0
738, 1, 1636429598309, 1636429598590, 281, 2, 279, 0, 0, 0
739, 1, 1636429598309, 1636429598590, 281, 2, 279, 1, 1, 2
737, 1, 1636429598309, 1636429598590, 281, 1, 280, 1, 0, 1
742, 1, 1636429598397, 1636429598673, 276, 1, 275, 0, 0, 0
741, 1, 1636429598409, 1636429598677, 268, 1, 267, 0, 0, 0
743, 1, 1636429598485, 1636429598762, 277, 0, 277, 0, 0, 0
746, 1, 1636429598525, 1636429598814, 289, 0, 289, 0, 0, 0
745, 1, 1636429598529, 1636429598817, 288, 1, 287, 0, 1, 1
744, 1, 1636429598529, 1636429598821, 292, 1, 291, 1, 0, 1
748, 1, 1636429598613, 1636429598905, 292, 1, 291, 0, 1, 1
747, 1, 1636429598613, 1636429598906, 293, 1, 292, 0, 1, 1
750, 1, 1636429598729, 1636429599009, 280, 1, 279, 0, 1, 1
751, 1, 1636429598769, 1636429599041, 272, 2, 270, 0, 1, 1
752, 1, 1636429598769, 1636429599045, 276, 1, 275, 0, 0, 0
749, 1, 1636429598769, 1636429599045, 276, 2, 274, 0, 1, 1
754, 1, 1636429598901, 1636429599178, 277, 1, 276, 0, 0, 0
757, 1, 1636429599001, 1636429599278, 277, 1, 276, 0, 0, 0
756, 1, 1636429598993, 1636429599281, 288, 0, 288, 0, 0, 0
755, 1, 1636429598993, 1636429599281, 288, 1, 287, 0, 0, 0
759, 1, 1636429599086, 1636429599374, 288, 0, 288, 0, 0, 0
758, 1, 1636429599073, 1636429599374, 301, 1, 300, 0, 0, 0
760, 1, 1636429599193, 1636429599469, 276, 0, 276, 0, 0, 0
762, 1, 1636429599213, 1636429599489, 276, 1, 275, 1, 0, 1
764, 1, 1636429599230, 1636429599501, 271, 0, 271, 0, 0, 0
761, 1, 1636429599230, 1636429599509, 279, 1, 278, 0, 0, 0
765, 1, 1636429599333, 1636429599605, 272, 1, 271, 0, 1, 1
766, 1, 1636429599333, 1636429599609, 276, 1, 275, 0, 1, 1
767, 1, 1636429599417, 1636429599681, 264, 1, 263, 0, 1, 1
770, 1, 1636429599454, 1636429599721, 267, 0, 267, 0, 0, 0
768, 1, 1636429599465, 1636429599738, 273, 0, 273, 0, 0, 0
769, 1, 1636429599461, 1636429599738, 277, 1, 276, 1, 0, 1
771, 1, 1636429599585, 1636429599857, 272, 1, 271, 0, 0, 0
774, 1, 1636429599678, 1636429599946, 268, 0, 268, 0, 0, 0
775, 1, 1636429599673, 1636429599946, 273, 1, 272, 0, 0, 0
773, 1, 1636429599678, 1636429599953, 275, 1, 274, 0, 0, 0
776, 1, 1636429599789, 1636429600062, 273, 1, 272, 0, 0, 0
779, 1, 1636429599881, 1636429600154, 273, 1, 272, 1, 0, 1
778, 1, 1636429599881, 1636429600154, 273, 1, 272, 0, 0, 0
781, 1, 1636429599897, 1636429600173, 276, 1, 275, 0, 0, 0
780, 1, 1636429599913, 1636429600186, 273, 1, 272, 1, 0, 1
782, 1, 1636429600018, 1636429600282, 264, 0, 264, 0, 0, 0
784, 1, 1636429600073, 1636429600338, 265, 1, 264, 0, 0, 0
785, 1, 1636429600125, 1636429600397, 272, 1, 271, 0, 0, 0
786, 1, 1636429600137, 1636429600414, 277, 1, 276, 1, 0, 1
787, 1, 1636429600142, 1636429600414, 272, 0, 272, 0, 0, 0
788, 1, 1636429600249, 1636429600521, 272, 1, 271, 0, 0, 0
789, 1, 1636429600341, 1636429600609, 268, 1, 267, 0, 0, 0
791, 1, 1636429600361, 1636429600633, 272, 1, 271, 0, 0, 0
792, 1, 1636429600461, 1636429600734, 273, 1, 272, 1, 0, 1
794, 1, 1636429600553, 1636429600825, 272, 1, 271, 0, 0, 0
795, 1, 1636429600577, 1636429600853, 276, 1, 275, 1, 0, 1
796, 1, 1636429600593, 1636429600870, 277, 1, 276, 0, 0, 0
797, 1, 1636429600678, 1636429600954, 276, 0, 276, 0, 0, 0
798, 1, 1636429600733, 1636429601009, 276, 1, 275, 0, 0, 0
800, 1, 1636429600810, 1636429601082, 272, 0, 272, 0, 0, 0
799, 1, 1636429600818, 1636429601089, 271, 0, 271, 0, 0, 0
802, 1, 1636429600921, 1636429601194, 273, 1, 272, 0, 1, 1
804, 1, 1636429601053, 1636429601330, 277, 1, 276, 0, 0, 0
805, 1, 1636429601134, 1636429601402, 268, 0, 268, 0, 0, 0
806, 1, 1636429601225, 1636429601494, 269, 1, 268, 0, 0, 0
807, 1, 1636429601265, 1636429601530, 265, 1, 264, 0, 0, 0
809, 1, 1636429601358, 1636429601629, 271, 0, 271, 0, 0, 0
810, 1, 1636429601405, 1636429601669, 264, 1, 263, 0, 1, 1
812, 1, 1636429601505, 1636429601778, 273, 1, 272, 0, 1, 1
813, 1, 1636429601585, 1636429601857, 272, 1, 271, 1, 0, 1
815, 1, 1636429601809, 1636429602077, 268, 0, 268, 0, 0, 0
816, 1, 1636429601889, 1636429602161, 272, 1, 271, 0, 0, 0
817, 1, 1636429601961, 1636429602234, 273, 1, 272, 0, 0, 0
819, 1, 1636429602070, 1636429602341, 271, 0, 271, 0, 0, 0
821, 1, 1636429602265, 1636429602538, 273, 1, 272, 0, 0, 0
823, 1, 1636429602562, 1636429602834, 272, 0, 272, 0, 0, 0
825, 1, 1636429602742, 1636429603014, 272, 0, 272, 0, 0, 0
827, 1, 1636429603238, 1636429603510, 272, 0, 272, 0, 0, 0
830, 1, 1636429608598, 1636429608870, 272, 0, 272, 0, 0, 0
831, 1, 1636429609218, 1636429609489, 271, 0, 271, 0, 0, 0
832, 1, 1636429609309, 1636429609586, 277, 1, 276, 0, 0, 0
833, 1, 1636429609894, 1636429610170, 276, 0, 276, 0, 0, 0
834, 1, 1636429609973, 1636429610246, 273, 1, 272, 0, 0, 0
835, 1, 1636429609973, 1636429610246, 273, 1, 272, 0, 0, 0
836, 1, 1636429609989, 1636429610261, 272, 1, 271, 0, 0, 0
838, 1, 1636429610326, 1636429610597, 271, 0, 271, 0, 0, 0
837, 1, 1636429610421, 1636429610697, 276, 1, 275, 0, 0, 0
839, 1, 1636429610597, 1636429610870, 273, 1, 272, 0, 1, 1
842, 1, 1636429610662, 1636429610953, 291, 0, 291, 0, 0, 0
843, 1, 1636429610662, 1636429610954, 292, 0, 292, 0, 0, 0
840, 1, 1636429610641, 1636429610954, 313, 1, 312, 0, 0, 0
844, 1, 1636429610862, 1636429611150, 288, 0, 288, 0, 0, 0
841, 1, 1636429610877, 1636429611150, 273, 1, 272, 0, 0, 0
845, 1, 1636429610998, 1636429611317, 319, 0, 319, 0, 0, 0
846, 1, 1636429611133, 1636429611409, 276, 0, 276, 0, 0, 0
848, 1, 1636429611262, 1636429611538, 276, 0, 276, 0, 0, 0
849, 1, 1636429611329, 1636429611614, 285, 1, 284, 0, 0, 0
847, 1, 1636429611333, 1636429611617, 284, 1, 283, 0, 0, 0
852, 1, 1636429611361, 1636429611637, 276, 1, 275, 1, 0, 1
850, 1, 1636429611361, 1636429611641, 280, 1, 279, 0, 1, 1
853, 1, 1636429611589, 1636429611869, 280, 1, 279, 0, 0, 0
854, 1, 1636429611569, 1636429611869, 300, 1, 299, 0, 1, 1
856, 1, 1636429611721, 1636429611994, 273, 1, 272, 0, 0, 0
855, 1, 1636429611794, 1636429612077, 283, 0, 283, 0, 0, 0
857, 1, 1636429611794, 1636429612077, 283, 0, 283, 0, 0, 0
859, 1, 1636429611989, 1636429612261, 272, 1, 271, 0, 0, 0
860, 1, 1636429612057, 1636429612327, 270, 1, 269, 0, 0, 0
861, 1, 1636429612057, 1636429612329, 272, 1, 271, 0, 0, 0
862, 1, 1636429612077, 1636429612349, 272, 1, 271, 1, 0, 1
863, 1, 1636429612077, 1636429612349, 272, 1, 271, 1, 0, 1
824, 1, 1636429612185, 1636429612457, 272, 1, 271, 1, 0, 1
864, 1, 1636429612253, 1636429612525, 272, 1, 271, 0, 0, 0
865, 1, 1636429612281, 1636429612553, 272, 1, 271, 0, 0, 0
867, 1, 1636429612361, 1636429612633, 272, 1, 271, 0, 1, 1
868, 1, 1636429612437, 1636429612709, 272, 1, 271, 0, 0, 0
869, 1, 1636429612505, 1636429612773, 268, 1, 267, 1, 0, 1
870, 1, 1636429612505, 1636429612778, 273, 1, 272, 1, 0, 1
872, 1, 1636429612653, 1636429612925, 272, 1, 271, 0, 0, 0
871, 1, 1636429612709, 1636429612989, 280, 1, 279, 0, 0, 0
874, 1, 1636429612733, 1636429613005, 272, 1, 271, 0, 1, 1
875, 1, 1636429612745, 1636429613022, 277, 1, 276, 0, 0, 0
877, 1, 1636429612806, 1636429613082, 276, 0, 276, 0, 0, 0
876, 1, 1636429612757, 1636429613082, 325, 0, 325, 0, 0, 0
879, 1, 1636429612957, 1636429613229, 272, 1, 271, 0, 0, 0
880, 1, 1636429612993, 1636429613269, 276, 1, 275, 0, 0, 0
881, 1, 1636429613033, 1636429613309, 276, 1, 275, 0, 0, 0
882, 1, 1636429613129, 1636429613409, 280, 1, 279, 0, 0, 0
884, 1, 1636429613181, 1636429613462, 281, 1, 280, 0, 1, 1
878, 1, 1636429613169, 1636429613462, 293, 0, 293, 0, 0, 0
885, 1, 1636429613261, 1636429613554, 293, 0, 293, 0, 0, 0
886, 1, 1636429613373, 1636429613649, 276, 1, 275, 0, 0, 0
887, 1, 1636429613401, 1636429613677, 276, 1, 275, 1, 0, 1
888, 1, 1636429613445, 1636429613717, 272, 1, 271, 0, 0, 0
890, 1, 1636429613517, 1636429613790, 273, 1, 272, 0, 0, 0
891, 1, 1636429613513, 1636429613790, 277, 1, 276, 0, 0, 0
889, 1, 1636429613641, 1636429613962, 321, 1, 320, 0, 1, 1
893, 1, 1636429613665, 1636429613965, 300, 1, 299, 0, 0, 0
894, 1, 1636429613705, 1636429613981, 276, 1, 275, 0, 0, 0
895, 1, 1636429613737, 1636429614053, 316, 0, 316, 0, 0, 0
896, 1, 1636429613822, 1636429614089, 267, 0, 267, 0, 0, 0
897, 1, 1636429613873, 1636429614145, 272, 1, 271, 0, 0, 0
898, 1, 1636429613893, 1636429614157, 264, 1, 263, 0, 0, 0
899, 1, 1636429613973, 1636429614238, 265, 1, 264, 0, 0, 0
901, 1, 1636429614137, 1636429614410, 273, 1, 272, 0, 0, 0
902, 1, 1636429614141, 1636429614410, 269, 1, 268, 1, 0, 1
903, 1, 1636429614193, 1636429614469, 276, 2, 274, 0, 0, 0
905, 1, 1636429614241, 1636429614517, 276, 1, 275, 0, 1, 1
907, 1, 1636429614357, 1636429614633, 276, 1, 275, 0, 0, 0
906, 1, 1636429614365, 1636429614634, 269, 1, 268, 0, 0, 0
908, 1, 1636429614381, 1636429614650, 269, 1, 268, 0, 0, 0
909, 1, 1636429614453, 1636429614725, 272, 1, 271, 0, 0, 0
910, 1, 1636429614490, 1636429614761, 271, 0, 271, 0, 0, 0
912, 1, 1636429614585, 1636429614857, 272, 1, 271, 0, 0, 0
913, 1, 1636429614650, 1636429614925, 275, 0, 275, 0, 0, 0
915, 1, 1636429614817, 1636429615089, 272, 1, 271, 0, 0, 0
914, 1, 1636429614817, 1636429615090, 273, 1, 272, 0, 0, 0
916, 1, 1636429614869, 1636429615145, 276, 0, 276, 0, 0, 0
917, 1, 1636429614909, 1636429615181, 272, 1, 271, 1, 0, 1
918, 1, 1636429615041, 1636429615314, 273, 1, 272, 0, 0, 0
920, 1, 1636429615053, 1636429615321, 268, 0, 268, 0, 0, 0
921, 1, 1636429615113, 1636429615394, 281, 1, 280, 0, 0, 0
922, 1, 1636429615161, 1636429615429, 268, 1, 267, 0, 0, 0
923, 1, 1636429615277, 1636429615546, 269, 0, 269, 0, 0, 0
924, 1, 1636429615321, 1636429615593, 272, 1, 271, 0, 0, 0
925, 1, 1636429615497, 1636429615777, 280, 1, 279, 0, 0, 0
927, 1, 1636429615537, 1636429615805, 268, 1, 267, 1, 0, 1
928, 1, 1636429615578, 1636429615846, 268, 0, 268, 0, 0, 0
929, 1, 1636429615713, 1636429615981, 268, 1, 267, 1, 0, 1
930, 1, 1636429615725, 1636429615998, 273, 1, 272, 0, 1, 1
931, 1, 1636429615785, 1636429616057, 272, 1, 271, 0, 0, 0
932, 1, 1636429615833, 1636429616109, 276, 1, 275, 0, 0, 0
933, 1, 1636429615957, 1636429616226, 269, 0, 269, 0, 0, 0
934, 1, 1636429616005, 1636429616277, 272, 1, 271, 0, 0, 0
935, 1, 1636429616182, 1636429616458, 276, 0, 276, 0, 0, 0
936, 1, 1636429616201, 1636429616473, 272, 1, 271, 1, 0, 1
937, 1, 1636429616242, 1636429616509, 267, 0, 267, 0, 0, 0
938, 1, 1636429616378, 1636429616650, 272, 0, 272, 0, 0, 0
939, 1, 1636429616409, 1636429616682, 273, 1, 272, 0, 0, 0
940, 1, 1636429616461, 1636429616729, 268, 0, 268, 0, 0, 0
942, 1, 1636429616641, 1636429616909, 268, 0, 268, 0, 0, 0
943, 1, 1636429616682, 1636429616950, 268, 0, 268, 0, 0, 0
944, 1, 1636429616858, 1636429617130, 272, 0, 272, 0, 0, 0
945, 1, 1636429616882, 1636429617154, 272, 0, 272, 0, 0, 0
946, 1, 1636429616909, 1636429617177, 268, 1, 267, 1, 0, 1
948, 1, 1636429617085, 1636429617354, 269, 1, 268, 1, 0, 1
949, 1, 1636429617126, 1636429617397, 271, 0, 271, 0, 0, 0
950, 1, 1636429617309, 1636429617586, 277, 1, 276, 0, 0, 0
951, 1, 1636429617346, 1636429617617, 271, 0, 271, 0, 0, 0
953, 1, 1636429617558, 1636429617830, 272, 0, 272, 0, 0, 0
954, 1, 1636429617581, 1636429617853, 272, 1, 271, 1, 0, 1
955, 1, 1636429617761, 1636429618034, 273, 0, 273, 0, 0, 0
956, 1, 1636429617797, 1636429618069, 272, 1, 271, 0, 0, 0
958, 1, 1636429618017, 1636429618290, 273, 1, 272, 1, 0, 1
959, 1, 1636429618233, 1636429618506, 273, 1, 272, 1, 0, 1
960, 1, 1636429618253, 1636429618526, 273, 1, 272, 1, 0, 1
962, 1, 1636429618470, 1636429618742, 272, 0, 272, 0, 0, 0
963, 1, 1636429618689, 1636429618962, 273, 1, 272, 0, 0, 0
965, 1, 1636429618926, 1636429619198, 272, 0, 272, 0, 0, 0
966, 1, 1636429619145, 1636429619418, 273, 1, 272, 1, 0, 1
968, 1, 1636429619602, 1636429619874, 272, 0, 272, 0, 0, 0
971, 1, 1636429621682, 1636429621961, 279, 0, 279, 0, 0, 0
972, 1, 1636429622142, 1636429622414, 272, 0, 272, 0, 0, 0
973, 1, 1636429622366, 1636429622638, 272, 0, 272, 0, 0, 0
974, 1, 1636429622594, 1636429622865, 271, 0, 271, 0, 0, 0
975, 1, 1636429622817, 1636429623089, 272, 1, 271, 1, 0, 1
977, 1, 1636429623038, 1636429623310, 272, 0, 272, 0, 0, 0
976, 1, 1636429623054, 1636429623326, 272, 0, 272, 0, 0, 0
978, 1, 1636429623274, 1636429623545, 271, 0, 271, 0, 0, 0
979, 1, 1636429623493, 1636429623770, 277, 1, 276, 0, 0, 0
980, 1, 1636429623505, 1636429623778, 273, 1, 272, 0, 1, 1
981, 1, 1636429623726, 1636429624001, 275, 0, 275, 0, 0, 0
982, 1, 1636429623733, 1636429624009, 276, 1, 275, 0, 1, 1
983, 1, 1636429623953, 1636429624242, 289, 1, 288, 1, 0, 1
984, 1, 1636429623953, 1636429624242, 289, 0, 289, 0, 0, 0
985, 1, 1636429624177, 1636429624449, 272, 1, 271, 0, 0, 0
986, 1, 1636429624186, 1636429624450, 264, 0, 264, 0, 0, 0
987, 1, 1636429624394, 1636429624678, 284, 0, 284, 0, 0, 0
988, 1, 1636429624421, 1636429624694, 273, 1, 272, 0, 0, 0
989, 1, 1636429624421, 1636429624694, 273, 1, 272, 0, 0, 0
990, 1, 1636429624509, 1636429624785, 276, 1, 275, 1, 0, 1
991, 1, 1636429624634, 1636429624905, 271, 0, 271, 0, 0, 0
992, 1, 1636429624646, 1636429624917, 271, 0, 271, 0, 0, 0
993, 1, 1636429624853, 1636429625126, 273, 1, 272, 1, 0, 1
994, 1, 1636429624869, 1636429625181, 312, 1, 311, 0, 0, 0
995, 1, 1636429624873, 1636429625181, 308, 1, 307, 0, 0, 0
996, 1, 1636429625085, 1636429625365, 280, 1, 279, 0, 1, 1
997, 1, 1636429625097, 1636429625369, 272, 1, 271, 0, 0, 0
998, 1, 1636429625126, 1636429625398, 272, 0, 272, 0, 0, 0
999, 1, 1636429625222, 1636429625490, 268, 0, 268, 0, 0, 0
1002, 1, 1636429625357, 1636429625625, 268, 1, 267, 0, 1, 1
1001, 1, 1636429625325, 1636429625629, 304, 1, 303, 0, 1, 1
1000, 1, 1636429625361, 1636429625633, 272, 1, 271, 1, 0, 1
1003, 1, 1636429625537, 1636429625809, 272, 1, 271, 0, 1, 1
1005, 1, 1636429625585, 1636429625857, 272, 1, 271, 1, 0, 1
1004, 1, 1636429625585, 1636429625857, 272, 1, 271, 0, 1, 1
1006, 1, 1636429625753, 1636429626026, 273, 1, 272, 0, 1, 1
1009, 1, 1636429625805, 1636429626077, 272, 1, 271, 1, 0, 1
1008, 1, 1636429625809, 1636429626077, 268, 1, 267, 0, 0, 0
1007, 1, 1636429625809, 1636429626081, 272, 1, 271, 0, 0, 0
1010, 1, 1636429625889, 1636429626157, 268, 1, 267, 1, 0, 1
1012, 1, 1636429626022, 1636429626293, 271, 0, 271, 0, 0, 0
1013, 1, 1636429626033, 1636429626297, 264, 0, 264, 0, 0, 0
1011, 1, 1636429626033, 1636429626297, 264, 0, 264, 0, 0, 0
1014, 1, 1636429626209, 1636429626485, 276, 1, 275, 0, 0, 0
1016, 1, 1636429626261, 1636429626562, 301, 0, 301, 0, 0, 0
1017, 1, 1636429626469, 1636429626745, 276, 1, 275, 0, 0, 0
1019, 1, 1636429626481, 1636429626749, 268, 1, 267, 0, 1, 1
1018, 1, 1636429626477, 1636429626749, 272, 1, 271, 0, 0, 0
1020, 1, 1636429626481, 1636429626757, 276, 1, 275, 0, 1, 1
1021, 1, 1636429626562, 1636429626829, 267, 0, 267, 0, 0, 0
1022, 1, 1636429626685, 1636429626958, 273, 1, 272, 1, 0, 1
1023, 1, 1636429626685, 1636429626958, 273, 1, 272, 0, 0, 0
1024, 1, 1636429626733, 1636429627005, 272, 0, 272, 0, 0, 0
1025, 1, 1636429626813, 1636429627097, 284, 1, 283, 0, 0, 0
1026, 1, 1636429626925, 1636429627198, 273, 1, 272, 0, 0, 0
1027, 1, 1636429626957, 1636429627229, 272, 1, 271, 0, 0, 0
1015, 1, 1636429627133, 1636429627405, 272, 1, 271, 0, 0, 0
1028, 1, 1636429627141, 1636429627417, 276, 1, 275, 0, 1, 1
1030, 1, 1636429627153, 1636429627421, 268, 1, 267, 0, 0, 0
1029, 1, 1636429627181, 1636429627446, 265, 1, 264, 0, 0, 0
1032, 1, 1636429627225, 1636429627497, 272, 0, 272, 0, 0, 0
1033, 1, 1636429627373, 1636429627666, 293, 1, 292, 0, 1, 1
1036, 1, 1636429627401, 1636429627669, 268, 1, 267, 0, 0, 0
1034, 1, 1636429627357, 1636429627669, 312, 1, 311, 0, 1, 1
1035, 1, 1636429627357, 1636429627673, 316, 1, 315, 0, 1, 1
1037, 1, 1636429627501, 1636429627774, 273, 1, 272, 0, 0, 0
1031, 1, 1636429627581, 1636429627853, 272, 1, 271, 0, 0, 0
1039, 1, 1636429627630, 1636429627901, 271, 1, 270, 1, 0, 1
1038, 1, 1636429627630, 1636429627901, 271, 1, 270, 1, 0, 1
1042, 1, 1636429627842, 1636429628118, 276, 0, 276, 0, 0, 0
1044, 1, 1636429627853, 1636429628121, 268, 1, 267, 1, 0, 1
1040, 1, 1636429627853, 1636429628129, 276, 2, 274, 0, 0, 0
1043, 1, 1636429627853, 1636429628129, 276, 1, 275, 0, 0, 0
1045, 1, 1636429627937, 1636429628209, 272, 1, 271, 0, 1, 1
1041, 1, 1636429628029, 1636429628301, 272, 1, 271, 0, 0, 0
1048, 1, 1636429628073, 1636429628345, 272, 1, 271, 1, 0, 1
1047, 1, 1636429628073, 1636429628345, 272, 1, 271, 1, 0, 1
1049, 1, 1636429628081, 1636429628349, 268, 1, 267, 0, 1, 1
1046, 1, 1636429628081, 1636429628349, 268, 1, 267, 0, 1, 1
1054, 1, 1636429628297, 1636429628569, 272, 1, 271, 0, 0, 0
1051, 1, 1636429628305, 1636429628573, 268, 0, 268, 0, 0, 0
1052, 1, 1636429628309, 1636429628581, 272, 0, 272, 0, 0, 0
1053, 1, 1636429628473, 1636429628745, 272, 1, 271, 0, 0, 0
1055, 1, 1636429628529, 1636429628802, 273, 1, 272, 0, 0, 0
1056, 1, 1636429628529, 1636429628802, 273, 1, 272, 1, 0, 1
1058, 1, 1636429628529, 1636429628802, 273, 2, 271, 0, 1, 1
1057, 1, 1636429628529, 1636429628802, 273, 2, 271, 0, 0, 0
1059, 1, 1636429628605, 1636429628877, 272, 1, 271, 0, 0, 0
1060, 1, 1636429628697, 1636429628965, 268, 0, 268, 0, 0, 0
1061, 1, 1636429628757, 1636429629050, 293, 1, 292, 0, 0, 0
1064, 1, 1636429628749, 1636429629053, 304, 0, 304, 0, 0, 0
1062, 1, 1636429628741, 1636429629053, 312, 1, 311, 0, 1, 1
1066, 1, 1636429628985, 1636429629258, 273, 1, 272, 0, 0, 0
1068, 1, 1636429629001, 1636429629277, 276, 1, 275, 0, 1, 1
1067, 1, 1636429629005, 1636429629281, 276, 1, 275, 1, 0, 1
1069, 1, 1636429629149, 1636429629421, 272, 1, 271, 0, 0, 0
1074, 1, 1636429629230, 1636429629497, 267, 0, 267, 0, 0, 0
1070, 1, 1636429629233, 1636429629501, 268, 0, 268, 0, 0, 0
1073, 1, 1636429629241, 1636429629517, 276, 0, 276, 0, 0, 0
1075, 1, 1636429629321, 1636429629593, 272, 1, 271, 1, 0, 1
1076, 1, 1636429629409, 1636429629681, 272, 1, 271, 0, 0, 0
1078, 1, 1636429629454, 1636429629726, 272, 0, 272, 0, 0, 0
1077, 1, 1636429629454, 1636429629726, 272, 0, 272, 0, 0, 0
1079, 1, 1636429629465, 1636429629741, 276, 1, 275, 0, 0, 0
1082, 1, 1636429629677, 1636429629957, 280, 1, 279, 0, 0, 0
1083, 1, 1636429629694, 1636429629961, 267, 0, 267, 0, 0, 0
970, 1, 1636429629813, 1636429630089, 276, 0, 276, 0, 0, 0
1084, 1, 1636429629865, 1636429630133, 268, 0, 268, 0, 0, 0
1085, 1, 1636429629909, 1636429630182, 273, 1, 272, 0, 0, 0
1087, 1, 1636429629909, 1636429630182, 273, 1, 272, 0, 0, 0
1086, 1, 1636429629925, 1636429630201, 276, 0, 276, 0, 0, 0
1088, 1, 1636429629993, 1636429630261, 268, 0, 268, 0, 0, 0
1089, 1, 1636429630078, 1636429630350, 272, 0, 272, 0, 0, 0
1091, 1, 1636429630137, 1636429630405, 268, 0, 268, 0, 0, 0
1093, 1, 1636429630141, 1636429630417, 276, 0, 276, 0, 0, 0
1094, 1, 1636429630361, 1636429630633, 272, 1, 271, 1, 0, 1
1095, 1, 1636429630385, 1636429630658, 273, 1, 272, 0, 0, 0
1097, 1, 1636429630529, 1636429630798, 269, 0, 269, 0, 0, 0
1096, 1, 1636429630585, 1636429630850, 265, 1, 264, 0, 1, 1
1100, 1, 1636429630606, 1636429630878, 272, 0, 272, 0, 0, 0
1101, 1, 1636429630665, 1636429630929, 264, 1, 263, 1, 0, 1
1102, 1, 1636429630753, 1636429631022, 269, 1, 268, 0, 1, 1
1104, 1, 1636429630809, 1636429631081, 272, 1, 271, 1, 0, 1
1103, 1, 1636429630809, 1636429631082, 273, 1, 272, 0, 1, 1
1106, 1, 1636429631057, 1636429631325, 268, 1, 267, 0, 1, 1
1107, 1, 1636429631201, 1636429631469, 268, 1, 267, 0, 0, 0
1108, 1, 1636429631261, 1636429631542, 281, 1, 280, 0, 0, 0
1109, 1, 1636429631274, 1636429631546, 272, 0, 272, 0, 0, 0
1110, 1, 1636429631329, 1636429631597, 268, 1, 267, 1, 0, 1
1111, 1, 1636429631413, 1636429631685, 272, 1, 271, 0, 0, 0
1114, 1, 1636429631725, 1636429631997, 272, 0, 272, 0, 0, 0
1115, 1, 1636429631874, 1636429632146, 272, 0, 272, 0, 0, 0
1118, 1, 1636429632005, 1636429632282, 277, 0, 277, 0, 0, 0
1119, 1, 1636429632085, 1636429632358, 273, 1, 272, 0, 0, 0
1121, 1, 1636429632546, 1636429632826, 280, 0, 280, 0, 0, 0
1123, 1, 1636429632758, 1636429633034, 276, 0, 276, 0, 0, 0
1124, 1, 1636429633230, 1636429633501, 271, 0, 271, 0, 0, 0
1125, 1, 1636429633433, 1636429633706, 273, 1, 272, 0, 1, 1
1126, 1, 1636429633910, 1636429634182, 272, 0, 272, 0, 0, 0
1127, 1, 1636429634110, 1636429634382, 272, 0, 272, 0, 0, 0
1128, 1, 1636429634590, 1636429634862, 272, 0, 272, 0, 0, 0
1129, 1, 1636429634790, 1636429635062, 272, 0, 272, 0, 0, 0
1130, 1, 1636429635266, 1636429635538, 272, 0, 272, 0, 0, 0
1131, 1, 1636429635466, 1636429635738, 272, 0, 272, 0, 0, 0
1132, 1, 1636429635946, 1636429636217, 271, 0, 271, 0, 0, 0
1133, 1, 1636429636146, 1636429636418, 272, 0, 272, 0, 0, 0
1134, 1, 1636429636622, 1636429636893, 271, 0, 271, 0, 0, 0
1135, 1, 1636429636826, 1636429637098, 272, 0, 272, 0, 0, 0
1136, 1, 1636429637297, 1636429637570, 273, 1, 272, 0, 0, 0
1137, 1, 1636429637490, 1636429637761, 271, 0, 271, 0, 0, 0
1138, 1, 1636429637981, 1636429638254, 273, 1, 272, 0, 0, 0
1139, 1, 1636429638169, 1636429638441, 272, 1, 271, 0, 0, 0
1140, 1, 1636429638754, 1636429639022, 268, 0, 268, 0, 0, 0
1141, 1, 1636429638842, 1636429639114, 272, 0, 272, 0, 0, 0
1142, 1, 1636429639298, 1636429639570, 272, 1, 271, 0, 0, 0
1143, 1, 1636429639298, 1636429639570, 272, 0, 272, 0, 0, 0
1145, 1, 1636429639433, 1636429639746, 313, 0, 313, 0, 0, 0
1146, 1, 1636429639510, 1636429639834, 324, 0, 324, 0, 0, 0
1147, 1, 1636429639750, 1636429640030, 280, 0, 280, 0, 0, 0
1150, 1, 1636429639969, 1636429640305, 336, 1, 335, 0, 1, 1
1151, 1, 1636429639969, 1636429640306, 337, 1, 336, 0, 0, 0
1153, 1, 1636429640213, 1636429640485, 272, 0, 272, 0, 0, 0
1149, 1, 1636429640213, 1636429640489, 276, 1, 275, 0, 0, 0
1154, 1, 1636429640261, 1636429640530, 269, 1, 268, 0, 1, 1
1155, 1, 1636429640485, 1636429640773, 288, 1, 287, 0, 0, 0
1156, 1, 1636429640669, 1636429640941, 272, 1, 271, 0, 0, 0
1158, 1, 1636429640725, 1636429641001, 276, 1, 275, 0, 0, 0
1159, 1, 1636429640729, 1636429641005, 276, 1, 275, 0, 1, 1
1160, 1, 1636429640882, 1636429641166, 284, 0, 284, 0, 0, 0
1161, 1, 1636429640989, 1636429641261, 272, 1, 271, 0, 1, 1
1164, 1, 1636429641117, 1636429641393, 276, 1, 275, 0, 0, 0
1165, 1, 1636429641213, 1636429641574, 361, 1, 360, 0, 1, 1
1167, 1, 1636429641485, 1636429641757, 272, 1, 271, 0, 0, 0
1169, 1, 1636429641485, 1636429641761, 276, 2, 274, 0, 0, 0
1168, 1, 1636429641485, 1636429641761, 276, 1, 275, 0, 0, 0
1162, 1, 1636429641574, 1636429641846, 272, 0, 272, 0, 0, 0
1171, 1, 1636429641757, 1636429642029, 272, 0, 272, 0, 0, 0
1173, 1, 1636429641801, 1636429642117, 316, 0, 316, 0, 0, 0
1175, 1, 1636429642029, 1636429642298, 269, 0, 269, 0, 0, 0
1177, 1, 1636429642165, 1636429642441, 276, 1, 275, 0, 0, 0
1176, 1, 1636429642165, 1636429642445, 280, 1, 279, 0, 1, 1
1178, 1, 1636429642205, 1636429642473, 268, 1, 267, 0, 1, 1
1179, 1, 1636429642250, 1636429642529, 279, 0, 279, 0, 0, 0
1122, 1, 1636429642397, 1636429642669, 272, 1, 271, 1, 0, 1
1182, 1, 1636429642481, 1636429642754, 273, 0, 273, 0, 0, 0
1183, 1, 1636429642513, 1636429642785, 272, 0, 272, 0, 0, 0
1184, 1, 1636429642697, 1636429642973, 276, 1, 275, 0, 0, 0
1186, 1, 1636429642833, 1636429643101, 268, 0, 268, 0, 0, 0
1187, 1, 1636429642841, 1636429643122, 281, 0, 281, 0, 0, 0
1189, 1, 1636429642922, 1636429643190, 268, 0, 268, 0, 0, 0
1188, 1, 1636429642929, 1636429643205, 276, 0, 276, 0, 0, 0
1191, 1, 1636429643157, 1636429643433, 276, 1, 275, 0, 0, 0
1192, 1, 1636429643189, 1636429643457, 268, 1, 267, 0, 0, 0
1193, 1, 1636429643382, 1636429643654, 272, 0, 272, 0, 0, 0
1194, 1, 1636429643502, 1636429643777, 275, 0, 275, 0, 0, 0
1195, 1, 1636429643521, 1636429643793, 272, 1, 271, 0, 1, 1
1196, 1, 1636429643586, 1636429643862, 276, 0, 276, 0, 0, 0
1197, 1, 1636429643613, 1636429643885, 272, 1, 271, 0, 1, 1
1198, 1, 1636429643833, 1636429644106, 273, 1, 272, 0, 1, 1
1199, 1, 1636429643865, 1636429644138, 273, 1, 272, 0, 0, 0
1200, 1, 1636429644061, 1636429644333, 272, 0, 272, 0, 0, 0
1202, 1, 1636429644197, 1636429644466, 269, 1, 268, 0, 0, 0
1203, 1, 1636429644261, 1636429644533, 272, 1, 271, 0, 0, 0
1204, 1, 1636429644285, 1636429644558, 273, 1, 272, 0, 0, 0
1205, 1, 1636429644513, 1636429644786, 273, 1, 272, 0, 0, 0
1206, 1, 1636429644533, 1636429644805, 272, 1, 271, 1, 0, 1
1207, 1, 1636429644729, 1636429645001, 272, 1, 271, 0, 0, 0
1208, 1, 1636429644866, 1636429645137, 271, 0, 271, 0, 0, 0
1209, 1, 1636429644937, 1636429645210, 273, 1, 272, 0, 1, 1
1210, 1, 1636429644966, 1636429645237, 271, 0, 271, 0, 0, 0
1211, 1, 1636429645181, 1636429645454, 273, 1, 272, 0, 0, 0
1212, 1, 1636429645206, 1636429645477, 271, 0, 271, 0, 0, 0
1213, 1, 1636429645401, 1636429645673, 272, 1, 271, 0, 1, 1
1214, 1, 1636429645545, 1636429645817, 272, 1, 271, 0, 1, 1
1215, 1, 1636429645613, 1636429645886, 273, 1, 272, 0, 0, 0
1216, 1, 1636429645633, 1636429645905, 272, 0, 272, 0, 0, 0
1217, 1, 1636429645857, 1636429646129, 272, 1, 271, 0, 0, 0
1218, 1, 1636429645878, 1636429646150, 272, 0, 272, 0, 0, 0
1219, 1, 1636429646078, 1636429646346, 268, 0, 268, 0, 0, 0
1220, 1, 1636429646221, 1636429646489, 268, 1, 267, 1, 0, 1
1221, 1, 1636429646285, 1636429646558, 273, 1, 272, 0, 0, 0
1222, 1, 1636429646301, 1636429646574, 273, 0, 273, 0, 0, 0
1223, 1, 1636429646529, 1636429646801, 272, 1, 271, 0, 1, 1
1224, 1, 1636429646738, 1636429647009, 271, 0, 271, 0, 0, 0
1225, 1, 1636429646749, 1636429647030, 281, 1, 280, 1, 0, 1
1226, 1, 1636429646893, 1636429647161, 268, 1, 267, 0, 1, 1
1227, 1, 1636429646957, 1636429647230, 273, 1, 272, 0, 0, 0
1228, 1, 1636429646982, 1636429647253, 271, 0, 271, 0, 0, 0
1229, 1, 1636429647206, 1636429647477, 271, 0, 271, 0, 0, 0
1230, 1, 1636429647409, 1636429647685, 276, 1, 275, 0, 0, 0
1231, 1, 1636429647429, 1636429647701, 272, 1, 271, 1, 0, 1
1232, 1, 1636429647558, 1636429647830, 272, 0, 272, 0, 0, 0
1233, 1, 1636429647626, 1636429647902, 276, 0, 276, 0, 0, 0
1234, 1, 1636429647657, 1636429647929, 272, 1, 271, 0, 1, 1
1235, 1, 1636429647885, 1636429648158, 273, 1, 272, 0, 0, 0
1236, 1, 1636429648089, 1636429648362, 273, 0, 273, 0, 0, 0
1237, 1, 1636429648109, 1636429648381, 272, 1, 271, 1, 0, 1
1238, 1, 1636429648233, 1636429648505, 272, 1, 271, 0, 1, 1
1239, 1, 1636429648301, 1636429648574, 273, 1, 272, 0, 0, 0
1240, 1, 1636429648337, 1636429648609, 272, 1, 271, 0, 0, 0
1241, 1, 1636429648557, 1636429648826, 269, 1, 268, 0, 1, 1
1242, 1, 1636429648758, 1636429649029, 271, 0, 271, 0, 0, 0
1243, 1, 1636429648782, 1636429649053, 271, 0, 271, 0, 0, 0
1244, 1, 1636429648906, 1636429649177, 271, 0, 271, 0, 0, 0
1246, 1, 1636429649018, 1636429649294, 276, 0, 276, 0, 0, 0
1245, 1, 1636429648977, 1636429649294, 317, 1, 316, 1, 0, 1
1247, 1, 1636429649238, 1636429649509, 271, 0, 271, 0, 0, 0
1249, 1, 1636429649474, 1636429649745, 271, 0, 271, 0, 0, 0
1248, 1, 1636429649474, 1636429649746, 272, 0, 272, 0, 0, 0
1250, 1, 1636429649606, 1636429649881, 275, 0, 275, 0, 0, 0
1252, 1, 1636429649693, 1636429649966, 273, 1, 272, 1, 0, 1
1251, 1, 1636429649693, 1636429649970, 277, 1, 276, 0, 1, 1
1253, 1, 1636429649937, 1636429650209, 272, 1, 271, 0, 1, 1
1256, 1, 1636429650157, 1636429650430, 273, 1, 272, 0, 0, 0
1257, 1, 1636429650157, 1636429650430, 273, 1, 272, 0, 1, 1
1258, 1, 1636429650277, 1636429650573, 296, 1, 295, 0, 0, 0
1261, 1, 1636429650393, 1636429650662, 269, 1, 268, 0, 1, 1
1260, 1, 1636429650393, 1636429650662, 269, 1, 268, 0, 1, 1
1264, 1, 1636429650857, 1636429651129, 272, 1, 271, 0, 0, 0
1265, 1, 1636429650857, 1636429651129, 272, 1, 271, 1, 0, 1
1266, 1, 1636429650990, 1636429651266, 276, 0, 276, 0, 0, 0
1268, 1, 1636429651081, 1636429651385, 304, 1, 303, 1, 0, 1
1267, 1, 1636429651081, 1636429651385, 304, 1, 303, 1, 0, 1
1271, 1, 1636429651533, 1636429651890, 357, 1, 356, 1, 0, 1
1262, 1, 1636429651561, 1636429651890, 329, 1, 328, 0, 1, 1
1270, 1, 1636429651533, 1636429651890, 357, 1, 356, 0, 0, 0
1275, 1, 1636429651801, 1636429652077, 276, 1, 275, 0, 1, 1
1274, 1, 1636429652062, 1636429652341, 279, 0, 279, 0, 0, 0
1190, 1, 1636429652253, 1636429652525, 272, 1, 271, 0, 1, 1
1278, 1, 1636429652345, 1636429652617, 272, 1, 271, 0, 0, 0
1280, 1, 1636429652345, 1636429652617, 272, 1, 271, 0, 0, 0
1277, 1, 1636429652345, 1636429652618, 273, 2, 271, 0, 1, 1
1281, 1, 1636429652345, 1636429652618, 273, 2, 271, 2, 0, 2
1282, 1, 1636429652473, 1636429652750, 277, 1, 276, 0, 0, 0
1284, 1, 1636429652797, 1636429653069, 272, 1, 271, 1, 0, 1
1285, 1, 1636429652797, 1636429653069, 272, 1, 271, 1, 0, 1
1288, 1, 1636429653025, 1636429653293, 268, 1, 267, 1, 0, 1
1290, 1, 1636429653025, 1636429653297, 272, 1, 271, 1, 0, 1
1291, 1, 1636429653025, 1636429653297, 272, 2, 270, 1, 0, 1
1289, 1, 1636429653025, 1636429653297, 272, 1, 271, 1, 0, 1
1287, 1, 1636429653254, 1636429653529, 275, 0, 275, 0, 0, 0
1294, 1, 1636429653478, 1636429653753, 275, 0, 275, 0, 0, 0
1293, 1, 1636429653478, 1636429653753, 275, 0, 275, 0, 0, 0
1295, 1, 1636429653689, 1636429653962, 273, 1, 272, 0, 0, 0
1296, 1, 1636429653698, 1636429653969, 271, 0, 271, 0, 0, 0
1298, 1, 1636429653702, 1636429653978, 276, 0, 276, 0, 0, 0
1299, 1, 1636429653937, 1636429654226, 289, 1, 288, 0, 1, 1
1301, 1, 1636429654157, 1636429654429, 272, 1, 271, 0, 1, 1
1303, 1, 1636429654370, 1636429654641, 271, 1, 270, 0, 1, 1
1304, 1, 1636429654370, 1636429654642, 272, 1, 271, 0, 1, 1
1302, 1, 1636429654370, 1636429654641, 271, 1, 270, 0, 0, 0
1305, 1, 1636429654489, 1636429654761, 272, 1, 271, 0, 1, 1
1306, 1, 1636429654625, 1636429654898, 273, 1, 272, 0, 0, 0
1307, 1, 1636429654825, 1636429655097, 272, 1, 271, 1, 0, 1
1309, 1, 1636429655049, 1636429655322, 273, 1, 272, 0, 0, 0
1308, 1, 1636429655049, 1636429655322, 273, 1, 272, 0, 0, 0
1310, 1, 1636429655049, 1636429655322, 273, 1, 272, 0, 0, 0
1311, 1, 1636429655165, 1636429655437, 272, 1, 271, 0, 0, 0
1312, 1, 1636429655297, 1636429655569, 272, 1, 271, 0, 0, 0
1313, 1, 1636429655501, 1636429655773, 272, 1, 271, 0, 1, 1
1314, 1, 1636429655717, 1636429655990, 273, 1, 272, 0, 1, 1
1316, 1, 1636429655721, 1636429655990, 269, 0, 269, 0, 0, 0
1315, 1, 1636429655717, 1636429655990, 273, 1, 272, 0, 1, 1
1317, 1, 1636429655842, 1636429656113, 271, 0, 271, 0, 0, 0
1318, 1, 1636429655974, 1636429656246, 272, 0, 272, 0, 0, 0
1319, 1, 1636429656182, 1636429656453, 271, 0, 271, 0, 0, 0
1320, 1, 1636429656389, 1636429656662, 273, 1, 272, 0, 0, 0
1321, 1, 1636429656397, 1636429656669, 272, 0, 272, 0, 0, 0
1322, 1, 1636429656393, 1636429656670, 277, 1, 276, 1, 0, 1
1323, 1, 1636429656521, 1636429656794, 273, 1, 272, 0, 0, 0
1324, 1, 1636429656642, 1636429656913, 271, 0, 271, 0, 0, 0
1325, 1, 1636429656862, 1636429657133, 271, 0, 271, 0, 0, 0
1327, 1, 1636429657074, 1636429657346, 272, 0, 272, 0, 0, 0
1328, 1, 1636429657074, 1636429657346, 272, 0, 272, 0, 0, 0
1329, 1, 1636429657197, 1636429657470, 273, 0, 273, 0, 0, 0
1330, 1, 1636429657313, 1636429657585, 272, 1, 271, 0, 1, 1
1331, 1, 1636429657534, 1636429657809, 275, 0, 275, 0, 0, 0
1332, 1, 1636429657741, 1636429658017, 276, 1, 275, 0, 0, 0
1333, 1, 1636429657750, 1636429658022, 272, 0, 272, 0, 0, 0
1326, 1, 1636429657773, 1636429658046, 273, 1, 272, 0, 0, 0
1334, 1, 1636429657873, 1636429658145, 272, 1, 271, 0, 0, 0
1335, 1, 1636429657993, 1636429658265, 272, 1, 271, 0, 1, 1
1336, 1, 1636429658213, 1636429658485, 272, 1, 271, 1, 0, 1
1337, 1, 1636429658417, 1636429658685, 268, 1, 267, 0, 1, 1
1338, 1, 1636429658421, 1636429658689, 268, 1, 267, 1, 0, 1
1339, 1, 1636429658453, 1636429658721, 268, 1, 267, 1, 0, 1
1340, 1, 1636429658538, 1636429658809, 271, 0, 271, 0, 0, 0
1341, 1, 1636429658665, 1636429658938, 273, 0, 273, 0, 0, 0
1342, 1, 1636429658882, 1636429659154, 272, 0, 272, 0, 0, 0
1343, 1, 1636429659089, 1636429659362, 273, 1, 272, 0, 1, 1
1344, 1, 1636429659094, 1636429659366, 272, 0, 272, 0, 0, 0
1345, 1, 1636429659121, 1636429659393, 272, 1, 271, 0, 0, 0
1346, 1, 1636429659205, 1636429659478, 273, 1, 272, 0, 0, 0
1347, 1, 1636429659338, 1636429659610, 272, 0, 272, 0, 0, 0
1348, 1, 1636429659557, 1636429659829, 272, 1, 271, 1, 0, 1
1349, 1, 1636429659761, 1636429660029, 268, 1, 267, 1, 0, 1
1350, 1, 1636429659777, 1636429660057, 280, 1, 279, 0, 1, 1
1352, 1, 1636429659881, 1636429660154, 273, 1, 272, 0, 0, 0
1351, 1, 1636429659793, 1636429660154, 361, 1, 360, 0, 0, 0
1353, 1, 1636429660065, 1636429660341, 276, 0, 276, 0, 0, 0
1354, 1, 1636429660249, 1636429660525, 276, 1, 275, 0, 1, 1
1356, 1, 1636429660381, 1636429660646, 265, 1, 264, 0, 1, 1
1358, 1, 1636429660469, 1636429660737, 268, 1, 267, 1, 0, 1
1357, 1, 1636429660469, 1636429660741, 272, 1, 271, 1, 0, 1
1359, 1, 1636429660553, 1636429660825, 272, 1, 271, 1, 0, 1
1360, 1, 1636429660553, 1636429660829, 276, 1, 275, 0, 0, 0
1362, 1, 1636429660733, 1636429661010, 277, 1, 276, 1, 0, 1
1363, 1, 1636429660933, 1636429661249, 316, 0, 316, 0, 0, 0
1364, 1, 1636429661038, 1636429661341, 303, 0, 303, 0, 0, 0
1367, 1, 1636429661161, 1636429661429, 268, 1, 267, 1, 0, 1
1366, 1, 1636429661161, 1636429661430, 269, 1, 268, 1, 0, 1
1369, 1, 1636429661253, 1636429661526, 273, 1, 272, 0, 0, 0
1368, 1, 1636429661253, 1636429661526, 273, 1, 272, 0, 1, 1
1370, 1, 1636429661429, 1636429661758, 329, 1, 328, 1, 0, 1
1372, 1, 1636429661673, 1636429661945, 272, 1, 271, 1, 0, 1
1373, 1, 1636429661761, 1636429662029, 268, 0, 268, 0, 0, 0
1375, 1, 1636429661849, 1636429662153, 304, 1, 303, 0, 0, 0
1374, 1, 1636429661849, 1636429662154, 305, 1, 304, 0, 0, 0
1376, 1, 1636429661918, 1636429662189, 271, 0, 271, 0, 0, 0
1378, 1, 1636429661977, 1636429662245, 268, 1, 267, 0, 1, 1
1377, 1, 1636429661926, 1636429662245, 319, 0, 319, 0, 0, 0
1380, 1, 1636429662153, 1636429662442, 289, 1, 288, 0, 0, 0
1381, 1, 1636429662349, 1636429662621, 272, 1, 271, 0, 0, 0
1383, 1, 1636429662426, 1636429662701, 275, 0, 275, 0, 0, 0
1384, 1, 1636429662549, 1636429662813, 264, 1, 263, 0, 1, 1
1385, 1, 1636429662553, 1636429662817, 264, 1, 263, 0, 1, 1
1286, 1, 1636429662565, 1636429662829, 264, 1, 263, 0, 0, 0
1386, 1, 1636429662613, 1636429662877, 264, 0, 264, 0, 0, 0
1389, 1, 1636429662649, 1636429662905, 256, 0, 256, 0, 0, 0
1388, 1, 1636429662649, 1636429662909, 260, 0, 260, 0, 0, 0
1387, 1, 1636429662657, 1636429662913, 256, 0, 256, 0, 0, 0
1390, 1, 1636429662829, 1636429663109, 280, 1, 279, 0, 0, 0
1392, 1, 1636429663026, 1636429663301, 275, 0, 275, 0, 0, 0
1393, 1, 1636429663105, 1636429663377, 272, 1, 271, 0, 0, 0
1395, 1, 1636429663245, 1636429663513, 268, 1, 267, 0, 0, 0
1394, 1, 1636429663245, 1636429663517, 272, 1, 271, 0, 0, 0
1397, 1, 1636429663281, 1636429663554, 273, 0, 273, 0, 0, 0
1400, 1, 1636429663329, 1636429663601, 272, 1, 271, 0, 0, 0
1399, 1, 1636429663329, 1636429663601, 272, 1, 271, 0, 0, 0
1401, 1, 1636429663445, 1636429663746, 301, 1, 300, 0, 0, 0
1402, 1, 1636429663497, 1636429663769, 272, 1, 271, 0, 1, 1
1300, 1, 1636429663693, 1636429663970, 277, 0, 277, 0, 0, 0
1398, 1, 1636429663729, 1636429664005, 276, 1, 275, 0, 0, 0
1403, 1, 1636429663745, 1636429664021, 276, 1, 275, 0, 0, 0
1406, 1, 1636429663909, 1636429664173, 264, 0, 264, 0, 0, 0
1407, 1, 1636429663953, 1636429664218, 265, 0, 265, 0, 0, 0
1408, 1, 1636429663997, 1636429664269, 272, 1, 271, 1, 0, 1
1409, 1, 1636429663997, 1636429664273, 276, 1, 275, 0, 0, 0
1410, 1, 1636429664001, 1636429664277, 276, 0, 276, 0, 0, 0
1411, 1, 1636429664145, 1636429664417, 272, 0, 272, 0, 0, 0
1405, 1, 1636429664153, 1636429664426, 273, 1, 272, 0, 0, 0
1412, 1, 1636429664205, 1636429664473, 268, 1, 267, 0, 0, 0
1414, 1, 1636429664397, 1636429664669, 272, 1, 271, 0, 0, 0
1413, 1, 1636429664457, 1636429664733, 276, 1, 275, 0, 0, 0
1416, 1, 1636429664581, 1636429664853, 272, 1, 271, 0, 0, 0
1415, 1, 1636429664605, 1636429664877, 272, 0, 272, 0, 0, 0
1417, 1, 1636429664617, 1636429664894, 277, 0, 277, 0, 0, 0
1419, 1, 1636429664669, 1636429664937, 268, 0, 268, 0, 0, 0
1418, 1, 1636429664661, 1636429664938, 277, 1, 276, 0, 0, 0
1420, 1, 1636429664665, 1636429664941, 276, 0, 276, 0, 0, 0
1421, 1, 1636429664825, 1636429665097, 272, 1, 271, 0, 1, 1
1422, 1, 1636429664913, 1636429665185, 272, 1, 271, 0, 0, 0
1423, 1, 1636429665057, 1636429665330, 273, 1, 272, 0, 1, 1
1424, 1, 1636429665066, 1636429665338, 272, 0, 272, 0, 0, 0
1425, 1, 1636429665129, 1636429665397, 268, 1, 267, 1, 0, 1
1426, 1, 1636429665249, 1636429665521, 272, 1, 271, 0, 0, 0
1428, 1, 1636429665297, 1636429665573, 276, 0, 276, 0, 0, 0
1430, 1, 1636429665329, 1636429665601, 272, 1, 271, 0, 0, 0
1429, 1, 1636429665338, 1636429665609, 271, 1, 270, 0, 1, 1
1431, 1, 1636429665338, 1636429665613, 275, 0, 275, 0, 0, 0
1427, 1, 1636429665361, 1636429665637, 276, 0, 276, 0, 0, 0
1432, 1, 1636429665493, 1636429665765, 272, 0, 272, 0, 0, 0
1404, 1, 1636429665501, 1636429665769, 268, 0, 268, 0, 0, 0
1433, 1, 1636429665573, 1636429665841, 268, 1, 267, 0, 0, 0
1435, 1, 1636429665737, 1636429666010, 273, 1, 272, 1, 0, 1
1436, 1, 1636429665793, 1636429666061, 268, 1, 267, 0, 1, 1
1434, 1, 1636429665817, 1636429666094, 277, 1, 276, 1, 0, 1
1437, 1, 1636429665917, 1636429666189, 272, 0, 272, 0, 0, 0
1438, 1, 1636429665969, 1636429666238, 269, 0, 269, 0, 0, 0
1441, 1, 1636429666009, 1636429666281, 272, 2, 270, 0, 0, 0
1439, 1, 1636429666009, 1636429666281, 272, 1, 271, 1, 0, 1
1440, 1, 1636429666009, 1636429666281, 272, 2, 270, 0, 1, 1
1442, 1, 1636429666033, 1636429666309, 276, 0, 276, 0, 0, 0
1443, 1, 1636429666161, 1636429666433, 272, 0, 272, 0, 0, 0
1444, 1, 1636429666169, 1636429666441, 272, 0, 272, 0, 0, 0
1445, 1, 1636429666237, 1636429666506, 269, 1, 268, 0, 0, 0
1446, 1, 1636429666406, 1636429666677, 271, 0, 271, 0, 0, 0
1447, 1, 1636429666461, 1636429666733, 272, 1, 271, 1, 0, 1
1448, 1, 1636429666489, 1636429666761, 272, 0, 272, 0, 0, 0
1449, 1, 1636429666590, 1636429666861, 271, 0, 271, 0, 0, 0
1450, 1, 1636429666641, 1636429666906, 265, 0, 265, 0, 0, 0
1451, 1, 1636429666681, 1636429666949, 268, 1, 267, 0, 0, 0
1452, 1, 1636429666677, 1636429666950, 273, 1, 272, 0, 0, 0
1453, 1, 1636429666681, 1636429666953, 272, 1, 271, 0, 0, 0
1454, 1, 1636429666709, 1636429666981, 272, 0, 272, 0, 0, 0
1455, 1, 1636429666837, 1636429667105, 268, 1, 267, 0, 1, 1
1456, 1, 1636429666849, 1636429667117, 268, 1, 267, 0, 0, 0
1457, 1, 1636429666917, 1636429667190, 273, 1, 272, 0, 1, 1
1458, 1, 1636429667069, 1636429667337, 268, 1, 267, 1, 0, 1
1459, 1, 1636429667137, 1636429667413, 276, 1, 275, 0, 0, 0
1460, 1, 1636429667157, 1636429667434, 277, 1, 276, 0, 1, 1
1461, 1, 1636429667265, 1636429667533, 268, 0, 268, 0, 0, 0
1462, 1, 1636429667309, 1636429667581, 272, 0, 272, 0, 0, 0
1463, 1, 1636429667353, 1636429667625, 272, 1, 271, 1, 0, 1
1465, 1, 1636429667349, 1636429667625, 276, 1, 275, 1, 0, 1
1464, 1, 1636429667353, 1636429667625, 272, 1, 271, 1, 0, 1
1466, 1, 1636429667373, 1636429667645, 272, 0, 272, 0, 0, 0
1467, 1, 1636429667505, 1636429667777, 272, 1, 271, 0, 1, 1
1468, 1, 1636429667513, 1636429667785, 272, 1, 271, 1, 0, 1
1469, 1, 1636429667589, 1636429667866, 277, 0, 277, 0, 0, 0
1470, 1, 1636429667729, 1636429668001, 272, 1, 271, 0, 0, 0
1471, 1, 1636429667805, 1636429668081, 276, 0, 276, 0, 0, 0
1472, 1, 1636429667821, 1636429668094, 273, 0, 273, 0, 0, 0
1473, 1, 1636429667925, 1636429668201, 276, 1, 275, 0, 0, 0
1474, 1, 1636429667981, 1636429668253, 272, 1, 271, 0, 0, 0
1475, 1, 1636429668026, 1636429668298, 272, 1, 271, 0, 1, 1
1477, 1, 1636429668026, 1636429668301, 275, 1, 274, 0, 1, 1
1476, 1, 1636429668026, 1636429668305, 279, 0, 279, 0, 0, 0
1478, 1, 1636429668049, 1636429668321, 272, 0, 272, 0, 0, 0
1479, 1, 1636429668173, 1636429668446, 273, 0, 273, 0, 0, 0
1480, 1, 1636429668181, 1636429668453, 272, 0, 272, 0, 0, 0
1481, 1, 1636429668265, 1636429668537, 272, 1, 271, 0, 1, 1
1482, 1, 1636429668401, 1636429668673, 272, 1, 271, 0, 1, 1
1483, 1, 1636429668485, 1636429668757, 272, 1, 271, 1, 0, 1
1484, 1, 1636429668501, 1636429668774, 273, 1, 272, 0, 1, 1
1485, 1, 1636429668605, 1636429668874, 269, 1, 268, 0, 1, 1
1486, 1, 1636429668653, 1636429668925, 272, 0, 272, 0, 0, 0
1487, 1, 1636429668697, 1636429668966, 269, 1, 268, 0, 1, 1
1488, 1, 1636429668697, 1636429668966, 269, 1, 268, 0, 1, 1
1489, 1, 1636429668693, 1636429668966, 273, 1, 272, 0, 0, 0
1490, 1, 1636429668713, 1636429668985, 272, 0, 272, 0, 0, 0
1492, 1, 1636429668845, 1636429669113, 268, 1, 267, 1, 0, 1
1491, 1, 1636429668845, 1636429669121, 276, 1, 275, 0, 0, 0
1493, 1, 1636429668933, 1636429669205, 272, 1, 271, 1, 0, 1
1494, 1, 1636429669073, 1636429669345, 272, 1, 271, 0, 1, 1
1495, 1, 1636429669157, 1636429669429, 272, 1, 271, 0, 0, 0
1496, 1, 1636429669165, 1636429669437, 272, 1, 271, 0, 0, 0
1497, 1, 1636429669273, 1636429669545, 272, 1, 271, 0, 0, 0
1498, 1, 1636429669325, 1636429669594, 269, 0, 269, 0, 0, 0
1499, 1, 1636429669361, 1636429669638, 277, 1, 276, 0, 0, 0
1501, 1, 1636429669365, 1636429669638, 273, 1, 272, 0, 0, 0
1500, 1, 1636429669365, 1636429669638, 273, 1, 272, 0, 1, 1
1502, 1, 1636429669381, 1636429669653, 272, 1, 271, 0, 1, 1
1503, 1, 1636429669501, 1636429669777, 276, 1, 275, 0, 1, 1
1504, 1, 1636429669509, 1636429669781, 272, 0, 272, 0, 0, 0
1505, 1, 1636429669605, 1636429669873, 268, 1, 267, 1, 0, 1
1506, 1, 1636429669737, 1636429670009, 272, 0, 272, 0, 0, 0
1508, 1, 1636429669833, 1636429670101, 268, 0, 268, 0, 0, 0
1507, 1, 1636429669822, 1636429670101, 279, 0, 279, 0, 0, 0
1509, 1, 1636429669945, 1636429670213, 268, 0, 268, 0, 0, 0
1510, 1, 1636429669989, 1636429670258, 269, 1, 268, 0, 0, 0
1512, 1, 1636429670037, 1636429670301, 264, 1, 263, 0, 1, 1
1511, 1, 1636429670034, 1636429670301, 267, 0, 267, 0, 0, 0
1513, 1, 1636429670037, 1636429670305, 268, 1, 267, 0, 1, 1
1514, 1, 1636429670053, 1636429670322, 269, 0, 269, 0, 0, 0
1515, 1, 1636429670169, 1636429670437, 268, 0, 268, 0, 0, 0
1517, 1, 1636429670277, 1636429670549, 272, 1, 271, 0, 1, 1
1518, 1, 1636429670433, 1636429670721, 288, 1, 287, 0, 1, 1
1520, 1, 1636429670541, 1636429670814, 273, 1, 272, 1, 0, 1
1519, 1, 1636429670541, 1636429670814, 273, 1, 272, 1, 0, 1
1521, 1, 1636429670633, 1636429670905, 272, 1, 271, 0, 0, 0
1522, 1, 1636429670669, 1636429670937, 268, 0, 268, 0, 0, 0
1523, 1, 1636429670706, 1636429670977, 271, 0, 271, 0, 0, 0
1524, 1, 1636429670706, 1636429670977, 271, 1, 270, 1, 0, 1
1525, 1, 1636429670706, 1636429670981, 275, 1, 274, 0, 0, 0
1526, 1, 1636429670753, 1636429671017, 264, 1, 263, 0, 0, 0
1527, 1, 1636429670825, 1636429671106, 281, 0, 281, 0, 0, 0
1528, 1, 1636429671017, 1636429671289, 272, 1, 271, 1, 0, 1
1516, 1, 1636429671017, 1636429671290, 273, 1, 272, 0, 1, 1
1529, 1, 1636429671157, 1636429671426, 269, 1, 268, 0, 0, 0
1533, 1, 1636429671237, 1636429671510, 273, 1, 272, 0, 0, 0
1532, 1, 1636429671237, 1636429671510, 273, 2, 271, 0, 1, 1
1534, 1, 1636429671306, 1636429671577, 271, 0, 271, 0, 0, 0
1539, 1, 1636429671378, 1636429671657, 279, 1, 278, 0, 1, 1
1538, 1, 1636429671377, 1636429671657, 280, 1, 279, 0, 1, 1
1537, 1, 1636429671377, 1636429671657, 280, 1, 279, 0, 0, 0
1540, 1, 1636429671477, 1636429671749, 272, 1, 271, 1, 0, 1
1535, 1, 1636429671477, 1636429671757, 280, 1, 279, 1, 0, 1
1541, 1, 1636429671509, 1636429671781, 272, 1, 271, 0, 0, 0
1542, 1, 1636429671697, 1636429671969, 272, 1, 271, 1, 0, 1
1543, 1, 1636429671697, 1636429671969, 272, 1, 271, 0, 0, 0
1544, 1, 1636429671817, 1636429672121, 304, 1, 303, 1, 0, 1
1546, 1, 1636429671942, 1636429672213, 271, 0, 271, 0, 0, 0
1547, 1, 1636429671942, 1636429672213, 271, 0, 271, 0, 0, 0
1550, 1, 1636429672078, 1636429672345, 267, 1, 266, 0, 0, 0
1551, 1, 1636429672078, 1636429672349, 271, 0, 271, 0, 0, 0
1554, 1, 1636429672190, 1636429672461, 271, 0, 271, 0, 0, 0
1552, 1, 1636429672161, 1636429672462, 301, 1, 300, 0, 0, 0
1553, 1, 1636429672161, 1636429672462, 301, 1, 300, 0, 0, 0
1549, 1, 1636429672293, 1636429672569, 276, 1, 275, 0, 0, 0
1557, 1, 1636429672373, 1636429672641, 268, 1, 267, 0, 1, 1
1558, 1, 1636429672521, 1636429672789, 268, 1, 267, 0, 1, 1
1559, 1, 1636429672610, 1636429672909, 299, 0, 299, 0, 0, 0
1560, 1, 1636429672641, 1636429672917, 276, 1, 275, 0, 1, 1
1562, 1, 1636429672749, 1636429673022, 273, 1, 272, 0, 1, 1
1563, 1, 1636429672749, 1636429673022, 273, 1, 272, 1, 0, 1
1565, 1, 1636429672861, 1636429673137, 276, 1, 275, 1, 0, 1
1566, 1, 1636429672861, 1636429673137, 276, 1, 275, 1, 0, 1
1396, 1, 1636429672861, 1636429673141, 280, 1, 279, 1, 0, 1
1567, 1, 1636429672965, 1636429673229, 264, 1, 263, 0, 1, 1
1568, 1, 1636429673049, 1636429673321, 272, 1, 271, 0, 1, 1
1570, 1, 1636429673181, 1636429673458, 277, 1, 276, 0, 0, 0
1571, 1, 1636429673310, 1636429673582, 272, 0, 272, 0, 0, 0
1574, 1, 1636429673414, 1636429673686, 272, 0, 272, 0, 0, 0
1573, 1, 1636429673414, 1636429673686, 272, 0, 272, 0, 0, 0
1575, 1, 1636429673541, 1636429673809, 268, 1, 267, 0, 0, 0
1576, 1, 1636429673545, 1636429673813, 268, 0, 268, 0, 0, 0
1578, 1, 1636429673629, 1636429673901, 272, 1, 271, 1, 0, 1
1579, 1, 1636429673714, 1636429673986, 272, 0, 272, 0, 0, 0
1580, 1, 1636429673849, 1636429674125, 276, 0, 276, 0, 0, 0
1581, 1, 1636429673986, 1636429674257, 271, 0, 271, 0, 0, 0
1582, 1, 1636429674097, 1636429674369, 272, 1, 271, 0, 0, 0
1583, 1, 1636429674097, 1636429674370, 273, 1, 272, 0, 0, 0
1584, 1, 1636429674221, 1636429674490, 269, 1, 268, 0, 1, 1
1586, 1, 1636429674298, 1636429674562, 264, 0, 264, 0, 0, 0
1587, 1, 1636429674381, 1636429674658, 277, 1, 276, 0, 0, 0
1588, 1, 1636429674521, 1636429674789, 268, 1, 267, 1, 0, 1
1589, 1, 1636429674665, 1636429674938, 273, 1, 272, 1, 0, 1
1591, 1, 1636429674773, 1636429675046, 273, 1, 272, 0, 0, 0
1590, 1, 1636429674781, 1636429675054, 273, 1, 272, 0, 1, 1
1592, 1, 1636429674894, 1636429675166, 272, 0, 272, 0, 0, 0
1593, 1, 1636429674957, 1636429675230, 273, 1, 272, 0, 0, 0
1594, 1, 1636429675054, 1636429675322, 268, 0, 268, 0, 0, 0
1595, 1, 1636429675185, 1636429675457, 272, 1, 271, 0, 0, 0
1596, 1, 1636429675345, 1636429675617, 272, 1, 271, 1, 0, 1
1598, 1, 1636429675449, 1636429675722, 273, 1, 272, 0, 0, 0
1597, 1, 1636429675449, 1636429675722, 273, 1, 272, 0, 0, 0
1599, 1, 1636429675562, 1636429675834, 272, 0, 272, 0, 0, 0
1600, 1, 1636429675617, 1636429675889, 272, 1, 271, 0, 0, 0
1601, 1, 1636429675717, 1636429675994, 277, 1, 276, 1, 0, 1
1602, 1, 1636429675853, 1636429676121, 268, 1, 267, 0, 0, 0
1603, 1, 1636429676014, 1636429676285, 271, 0, 271, 0, 0, 0
1604, 1, 1636429676117, 1636429676389, 272, 1, 271, 0, 0, 0
1605, 1, 1636429676121, 1636429676390, 269, 1, 268, 0, 0, 0
1606, 1, 1636429676229, 1636429676501, 272, 0, 272, 0, 0, 0
1607, 1, 1636429676293, 1636429676569, 276, 1, 275, 0, 0, 0
1608, 1, 1636429676385, 1636429676662, 277, 1, 276, 0, 1, 1
1609, 1, 1636429676517, 1636429676798, 281, 1, 280, 0, 1, 1
1610, 1, 1636429676690, 1636429676962, 272, 0, 272, 0, 0, 0
1611, 1, 1636429676789, 1636429677057, 268, 1, 267, 0, 0, 0
1612, 1, 1636429676798, 1636429677069, 271, 0, 271, 0, 0, 0
1613, 1, 1636429676897, 1636429677169, 272, 1, 271, 1, 0, 1
1614, 1, 1636429676961, 1636429677233, 272, 1, 271, 0, 0, 0
1615, 1, 1636429677053, 1636429677321, 268, 1, 267, 0, 1, 1
1616, 1, 1636429677197, 1636429677470, 273, 1, 272, 1, 0, 1
1617, 1, 1636429677365, 1636429677633, 268, 0, 268, 0, 0, 0
1618, 1, 1636429677450, 1636429677717, 267, 0, 267, 0, 0, 0
1619, 1, 1636429677477, 1636429677749, 272, 1, 271, 0, 1, 1
1620, 1, 1636429677561, 1636429677837, 276, 1, 275, 1, 0, 1
1621, 1, 1636429677626, 1636429677890, 264, 0, 264, 0, 0, 0
1622, 1, 1636429677709, 1636429677982, 273, 0, 273, 0, 0, 0
1623, 1, 1636429677870, 1636429678142, 272, 0, 272, 0, 0, 0
1624, 1, 1636429678037, 1636429678305, 268, 1, 267, 0, 0, 0
1625, 1, 1636429678122, 1636429678401, 279, 0, 279, 0, 0, 0
1626, 1, 1636429678149, 1636429678426, 277, 1, 276, 0, 0, 0
1627, 1, 1636429678241, 1636429678517, 276, 0, 276, 0, 0, 0
1628, 1, 1636429678285, 1636429678550, 265, 1, 264, 0, 0, 0
1629, 1, 1636429678385, 1636429678653, 268, 1, 267, 0, 1, 1
1630, 1, 1636429678542, 1636429678813, 271, 0, 271, 0, 0, 0
1631, 1, 1636429678709, 1636429678981, 272, 1, 271, 0, 0, 0
1632, 1, 1636429678793, 1636429679065, 272, 1, 271, 0, 0, 0
1633, 1, 1636429678833, 1636429679106, 273, 1, 272, 0, 0, 0
1634, 1, 1636429678914, 1636429679185, 271, 0, 271, 0, 0, 0
1635, 1, 1636429678945, 1636429679221, 276, 1, 275, 0, 0, 0
1636, 1, 1636429679065, 1636429679341, 276, 1, 275, 1, 0, 1
1637, 1, 1636429679214, 1636429679486, 272, 0, 272, 0, 0, 0
1638, 1, 1636429679385, 1636429679657, 272, 1, 271, 0, 0, 0
1639, 1, 1636429679466, 1636429679742, 276, 0, 276, 0, 0, 0
1640, 1, 1636429679497, 1636429679769, 272, 1, 271, 1, 0, 1
1641, 1, 1636429679589, 1636429679861, 272, 1, 271, 0, 1, 1
1642, 1, 1636429679630, 1636429679901, 271, 0, 271, 0, 0, 0
1643, 1, 1636429679742, 1636429680021, 279, 0, 279, 0, 0, 0
1644, 1, 1636429679885, 1636429680153, 268, 0, 268, 0, 0, 0
1645, 1, 1636429680061, 1636429680338, 277, 1, 276, 0, 0, 0
1646, 1, 1636429680133, 1636429680406, 273, 1, 272, 0, 1, 1
1647, 1, 1636429680161, 1636429680433, 272, 1, 271, 0, 0, 0
1648, 1, 1636429680261, 1636429680533, 272, 1, 271, 0, 0, 0
1649, 1, 1636429680309, 1636429680578, 269, 1, 268, 0, 0, 0
1650, 1, 1636429680517, 1636429680785, 268, 1, 267, 0, 0, 0
1651, 1, 1636429680553, 1636429680833, 280, 1, 279, 1, 0, 1
1652, 1, 1636429680745, 1636429681014, 269, 1, 268, 0, 0, 0
1653, 1, 1636429680801, 1636429681073, 272, 1, 271, 0, 0, 0
1654, 1, 1636429680833, 1636429681101, 268, 1, 267, 0, 0, 0
1655, 1, 1636429680933, 1636429681253, 320, 0, 320, 0, 0, 0
1658, 1, 1636429681253, 1636429681530, 277, 1, 276, 1, 0, 1
1657, 1, 1636429681253, 1636429681530, 277, 1, 276, 0, 0, 0
1656, 1, 1636429681325, 1636429681598, 273, 1, 272, 0, 1, 1
1661, 1, 1636429681465, 1636429681737, 272, 1, 271, 1, 0, 1
1663, 1, 1636429681497, 1636429681770, 273, 1, 272, 0, 0, 0
1664, 1, 1636429681657, 1636429681961, 304, 1, 303, 1, 0, 1
1662, 1, 1636429681781, 1636429682061, 280, 1, 279, 0, 0, 0
1666, 1, 1636429681929, 1636429682202, 273, 1, 272, 1, 0, 1
1665, 1, 1636429681929, 1636429682202, 273, 1, 272, 0, 0, 0
1667, 1, 1636429681929, 1636429682202, 273, 1, 272, 0, 0, 0
1668, 1, 1636429682018, 1636429682286, 268, 0, 268, 0, 0, 0
1671, 1, 1636429682165, 1636429682437, 272, 0, 272, 0, 0, 0
1670, 1, 1636429682145, 1636429682438, 293, 1, 292, 0, 0, 0
1659, 1, 1636429682253, 1636429682529, 276, 1, 275, 0, 1, 1
1673, 1, 1636429682473, 1636429682769, 296, 1, 295, 1, 0, 1
1676, 1, 1636429682625, 1636429682913, 288, 0, 288, 0, 0, 0
1674, 1, 1636429682609, 1636429682913, 304, 1, 303, 1, 0, 1
1675, 1, 1636429682609, 1636429682917, 308, 1, 307, 1, 0, 1
1680, 1, 1636429682709, 1636429683001, 292, 2, 290, 0, 0, 0
1679, 1, 1636429682709, 1636429683005, 296, 1, 295, 0, 0, 0
1678, 1, 1636429682685, 1636429683006, 321, 1, 320, 0, 0, 0
1672, 1, 1636429682709, 1636429683005, 296, 2, 294, 0, 1, 1
1681, 1, 1636429682841, 1636429683122, 281, 0, 281, 0, 0, 0
1683, 1, 1636429682957, 1636429683222, 265, 1, 264, 1, 0, 1
1682, 1, 1636429683185, 1636429683461, 276, 1, 275, 1, 0, 1
1577, 1, 1636429683173, 1636429683462, 289, 1, 288, 0, 0, 0
1685, 1, 1636429683185, 1636429683461, 276, 1, 275, 1, 0, 1
1686, 1, 1636429683177, 1636429683461, 284, 1, 283, 0, 1, 1
1585, 1, 1636429683322, 1636429683593, 271, 0, 271, 0, 0, 0
1687, 1, 1636429683369, 1636429683637, 268, 0, 268, 0, 0, 0
1688, 1, 1636429683373, 1636429683641, 268, 0, 268, 0, 0, 0
1693, 1, 1636429683413, 1636429683681, 268, 1, 267, 1, 0, 1
1692, 1, 1636429683417, 1636429683685, 268, 0, 268, 0, 0, 0
1690, 1, 1636429683429, 1636429683701, 272, 1, 271, 0, 1, 1
1691, 1, 1636429683429, 1636429683701, 272, 1, 271, 0, 1, 1
1695, 1, 1636429683521, 1636429683797, 276, 1, 275, 0, 0, 0
1696, 1, 1636429683613, 1636429683885, 272, 0, 272, 0, 0, 0
1697, 1, 1636429683633, 1636429683901, 268, 1, 267, 0, 1, 1
1689, 1, 1636429683769, 1636429684041, 272, 1, 271, 0, 0, 0
1698, 1, 1636429683861, 1636429684129, 268, 1, 267, 0, 0, 0
1700, 1, 1636429683865, 1636429684133, 268, 1, 267, 0, 0, 0
1699, 1, 1636429683881, 1636429684154, 273, 1, 272, 0, 1, 1
1703, 1, 1636429684029, 1636429684306, 277, 0, 277, 0, 0, 0
1704, 1, 1636429684029, 1636429684306, 277, 0, 277, 0, 0, 0
1705, 1, 1636429684069, 1636429684338, 269, 1, 268, 0, 0, 0
1702, 1, 1636429684073, 1636429684345, 272, 0, 272, 0, 0, 0
1706, 1, 1636429684077, 1636429684353, 276, 1, 275, 0, 1, 1
1708, 1, 1636429684109, 1636429684389, 280, 1, 279, 0, 0, 0
1707, 1, 1636429684109, 1636429684390, 281, 1, 280, 0, 0, 0
1710, 1, 1636429684297, 1636429684569, 272, 0, 272, 0, 0, 0
1711, 1, 1636429684325, 1636429684598, 273, 1, 272, 0, 1, 1
1712, 1, 1636429684449, 1636429684730, 281, 1, 280, 0, 1, 1
1709, 1, 1636429684485, 1636429684753, 268, 0, 268, 0, 0, 0
1714, 1, 1636429684521, 1636429684789, 268, 1, 267, 0, 0, 0
1713, 1, 1636429684529, 1636429684793, 264, 1, 263, 0, 0, 0
1715, 1, 1636429684573, 1636429684841, 268, 0, 268, 0, 0, 0
1716, 1, 1636429684701, 1636429684974, 273, 1, 272, 0, 0, 0
1718, 1, 1636429684729, 1636429685005, 276, 1, 275, 0, 0, 0
1720, 1, 1636429684745, 1636429685025, 280, 0, 280, 0, 0, 0
1719, 1, 1636429684777, 1636429685054, 277, 1, 276, 0, 1, 1
1722, 1, 1636429684793, 1636429685065, 272, 1, 271, 0, 0, 0
1721, 1, 1636429684793, 1636429685065, 272, 1, 271, 1, 0, 1
1717, 1, 1636429684933, 1636429685209, 276, 0, 276, 0, 0, 0
1723, 1, 1636429684961, 1636429685241, 280, 1, 279, 0, 1, 1
1724, 1, 1636429685029, 1636429685305, 276, 0, 276, 0, 0, 0
1725, 1, 1636429685125, 1636429685397, 272, 1, 271, 1, 0, 1
1726, 1, 1636429685189, 1636429685461, 272, 1, 271, 1, 0, 1
1728, 1, 1636429685205, 1636429685481, 276, 1, 275, 0, 0, 0
1729, 1, 1636429685253, 1636429685533, 280, 1, 279, 1, 0, 1
1730, 1, 1636429685369, 1636429685641, 272, 1, 271, 0, 1, 1
1731, 1, 1636429685405, 1636429685677, 272, 0, 272, 0, 0, 0
1732, 1, 1636429685425, 1636429685701, 276, 0, 276, 0, 0, 0
1734, 1, 1636429685465, 1636429685737, 272, 1, 271, 0, 0, 0
1735, 1, 1636429685465, 1636429685741, 276, 1, 275, 1, 0, 1
1733, 1, 1636429685485, 1636429685758, 273, 0, 273, 0, 0, 0
1737, 1, 1636429685637, 1636429685913, 276, 1, 275, 1, 0, 1
1738, 1, 1636429685713, 1636429685985, 272, 0, 272, 0, 0, 0
1740, 1, 1636429685857, 1636429686133, 276, 0, 276, 0, 0, 0
1741, 1, 1636429685889, 1636429686161, 272, 1, 271, 0, 0, 0
1742, 1, 1636429685933, 1636429686206, 273, 1, 272, 0, 1, 1
1743, 1, 1636429686045, 1636429686313, 268, 1, 267, 0, 1, 1
1744, 1, 1636429686077, 1636429686350, 273, 1, 272, 0, 1, 1
1747, 1, 1636429686133, 1636429686405, 272, 1, 271, 0, 0, 0
1746, 1, 1636429686133, 1636429686405, 272, 1, 271, 0, 0, 0
1748, 1, 1636429686165, 1636429686437, 272, 0, 272, 0, 0, 0
1750, 1, 1636429686386, 1636429686658, 272, 0, 272, 0, 0, 0
1751, 1, 1636429686529, 1636429686801, 272, 1, 271, 1, 0, 1
1749, 1, 1636429686585, 1636429686866, 281, 1, 280, 1, 0, 1
1753, 1, 1636429686597, 1636429686874, 277, 1, 276, 0, 0, 0
1754, 1, 1636429686713, 1636429686993, 280, 0, 280, 0, 0, 0
1755, 1, 1636429686757, 1636429687030, 273, 1, 272, 0, 0, 0
1757, 1, 1636429686813, 1636429687085, 272, 1, 271, 0, 0, 0
1756, 1, 1636429686813, 1636429687085, 272, 1, 271, 0, 0, 0
1758, 1, 1636429686845, 1636429687122, 277, 1, 276, 0, 1, 1
1759, 1, 1636429687062, 1636429687333, 271, 0, 271, 0, 0, 0
1760, 1, 1636429687197, 1636429687473, 276, 1, 275, 0, 1, 1
1762, 1, 1636429687265, 1636429687533, 268, 1, 267, 1, 0, 1
1761, 1, 1636429687265, 1636429687541, 276, 1, 275, 0, 0, 0
1763, 1, 1636429687397, 1636429687670, 273, 1, 272, 0, 0, 0
1764, 1, 1636429687429, 1636429687697, 268, 1, 267, 0, 1, 1
1765, 1, 1636429687481, 1636429687757, 276, 0, 276, 0, 0, 0
1766, 1, 1636429687518, 1636429687789, 271, 0, 271, 0, 0, 0
1767, 1, 1636429687738, 1636429688009, 271, 0, 271, 0, 0, 0
1768, 1, 1636429687874, 1636429688145, 271, 0, 271, 0, 0, 0
1769, 1, 1636429687937, 1636429688210, 273, 1, 272, 0, 0, 0
1771, 1, 1636429688065, 1636429688338, 273, 1, 272, 0, 0, 0
1772, 1, 1636429688097, 1636429688369, 272, 1, 271, 0, 0, 0
1773, 1, 1636429688169, 1636429688442, 273, 0, 273, 0, 0, 0
1774, 1, 1636429688189, 1636429688461, 272, 1, 271, 0, 0, 0
1775, 1, 1636429688409, 1636429688681, 272, 1, 271, 0, 1, 1
1776, 1, 1636429688537, 1636429688801, 264, 1, 263, 1, 0, 1
1777, 1, 1636429688622, 1636429688893, 271, 0, 271, 0, 0, 0
1778, 1, 1636429688738, 1636429689009, 271, 0, 271, 0, 0, 0
1779, 1, 1636429688769, 1636429689041, 272, 1, 271, 0, 0, 0
1780, 1, 1636429688833, 1636429689106, 273, 1, 272, 0, 0, 0
1781, 1, 1636429688861, 1636429689133, 272, 1, 271, 0, 1, 1
1782, 1, 1636429689085, 1636429689358, 273, 1, 272, 1, 0, 1
1783, 1, 1636429689206, 1636429689478, 272, 0, 272, 0, 0, 0
1784, 1, 1636429689293, 1636429689565, 272, 1, 271, 0, 0, 0
1785, 1, 1636429689417, 1636429689689, 272, 0, 272, 0, 0, 0
1786, 1, 1636429689441, 1636429689714, 273, 1, 272, 0, 0, 0
1787, 1, 1636429689505, 1636429689781, 276, 1, 275, 0, 0, 0
1788, 1, 1636429689537, 1636429689809, 272, 0, 272, 0, 0, 0
1789, 1, 1636429689753, 1636429690026, 273, 1, 272, 0, 0, 0
1790, 1, 1636429689882, 1636429690154, 272, 0, 272, 0, 0, 0
1791, 1, 1636429689961, 1636429690233, 272, 1, 271, 0, 0, 0
1793, 1, 1636429690122, 1636429690389, 267, 0, 267, 0, 0, 0
1794, 1, 1636429690185, 1636429690453, 268, 0, 268, 0, 0, 0
1792, 1, 1636429690205, 1636429690481, 276, 1, 275, 0, 0, 0
1796, 1, 1636429690421, 1636429690694, 273, 1, 272, 1, 0, 1
1798, 1, 1636429690633, 1636429690910, 277, 1, 276, 0, 1, 1
1795, 1, 1636429690661, 1636429690933, 272, 1, 271, 1, 0, 1
1799, 1, 1636429690790, 1636429691058, 268, 0, 268, 0, 0, 0
1800, 1, 1636429690853, 1636429691126, 273, 1, 272, 0, 0, 0
1801, 1, 1636429690878, 1636429691150, 272, 0, 272, 0, 0, 0
1802, 1, 1636429691094, 1636429691366, 272, 0, 272, 0, 0, 0
1803, 1, 1636429691313, 1636429691609, 296, 1, 295, 0, 0, 0
1804, 1, 1636429691325, 1636429691609, 284, 1, 283, 0, 0, 0
1805, 1, 1636429691469, 1636429691742, 273, 1, 272, 0, 1, 1
1806, 1, 1636429691565, 1636429691841, 276, 1, 275, 0, 1, 1
1807, 1, 1636429691565, 1636429691841, 276, 1, 275, 0, 1, 1
1808, 1, 1636429691789, 1636429692061, 272, 1, 271, 1, 0, 1
1810, 1, 1636429692005, 1636429692293, 288, 1, 287, 0, 1, 1
1809, 1, 1636429692026, 1636429692293, 267, 0, 267, 0, 0, 0
1811, 1, 1636429692142, 1636429692414, 272, 0, 272, 0, 0, 0
1812, 1, 1636429692245, 1636429692518, 273, 1, 272, 0, 0, 0
1813, 1, 1636429692245, 1636429692518, 273, 1, 272, 0, 0, 0
1814, 1, 1636429692473, 1636429692769, 296, 1, 295, 0, 1, 1
1818, 1, 1636429692725, 1636429692998, 273, 2, 271, 0, 1, 1
1815, 1, 1636429692725, 1636429692998, 273, 1, 272, 0, 0, 0
1817, 1, 1636429692725, 1636429692998, 273, 2, 271, 0, 0, 0
1819, 1, 1636429692810, 1636429693101, 291, 0, 291, 0, 0, 0
1821, 1, 1636429692929, 1636429693197, 268, 1, 267, 0, 0, 0
1820, 1, 1636429692925, 1636429693202, 277, 1, 276, 0, 0, 0
1823, 1, 1636429693177, 1636429693457, 280, 1, 279, 0, 0, 0
1822, 1, 1636429693177, 1636429693457, 280, 1, 279, 1, 0, 1
1825, 1, 1636429693397, 1636429693669, 272, 0, 272, 0, 0, 0
1827, 1, 1636429693402, 1636429693681, 279, 0, 279, 0, 0, 0
1826, 1, 1636429693402, 1636429693681, 279, 0, 279, 0, 0, 0
1828, 1, 1636429693545, 1636429693813, 268, 1, 267, 0, 0, 0
1830, 1, 1636429693593, 1636429693901, 308, 1, 307, 0, 0, 0
1832, 1, 1636429693853, 1636429694125, 272, 1, 271, 0, 1, 1
1833, 1, 1636429693861, 1636429694133, 272, 1, 271, 0, 1, 1
1797, 1, 1636429693857, 1636429694134, 277, 1, 276, 0, 1, 1
1829, 1, 1636429693861, 1636429694134, 273, 1, 272, 0, 1, 1
1834, 1, 1636429694074, 1636429694346, 272, 0, 272, 0, 0, 0
1835, 1, 1636429694081, 1636429694353, 272, 1, 271, 1, 0, 1
1839, 1, 1636429694301, 1636429694570, 269, 1, 268, 0, 1, 1
1836, 1, 1636429694317, 1636429694593, 276, 0, 276, 0, 0, 0
1840, 1, 1636429694529, 1636429694801, 272, 1, 271, 0, 1, 1
1841, 1, 1636429694538, 1636429694810, 272, 0, 272, 0, 0, 0
1842, 1, 1636429694538, 1636429694813, 275, 0, 275, 0, 0, 0
1844, 1, 1636429694741, 1636429695014, 273, 1, 272, 0, 0, 0
1845, 1, 1636429694750, 1636429695022, 272, 0, 272, 0, 0, 0
1843, 1, 1636429694773, 1636429695045, 272, 0, 272, 0, 0, 0
1846, 1, 1636429694970, 1636429695241, 271, 0, 271, 0, 0, 0
1847, 1, 1636429694993, 1636429695269, 276, 1, 275, 0, 0, 0
1849, 1, 1636429695241, 1636429695509, 268, 1, 267, 0, 0, 0
1850, 1, 1636429695241, 1636429695514, 273, 1, 272, 1, 0, 1
1848, 1, 1636429695241, 1636429695514, 273, 2, 271, 0, 1, 1
1852, 1, 1636429695413, 1636429695686, 273, 1, 272, 0, 0, 0
1853, 1, 1636429695450, 1636429695753, 303, 0, 303, 0, 0, 0
1854, 1, 1636429695662, 1636429695938, 276, 0, 276, 0, 0, 0
1855, 1, 1636429695693, 1636429695965, 272, 1, 271, 1, 0, 1
1856, 1, 1636429695905, 1636429696177, 272, 1, 271, 0, 0, 0
1859, 1, 1636429695989, 1636429696262, 273, 1, 272, 1, 0, 1
1860, 1, 1636429695989, 1636429696262, 273, 1, 272, 0, 0, 0
1861, 1, 1636429696078, 1636429696349, 271, 0, 271, 0, 0, 0
1862, 1, 1636429696145, 1636429696417, 272, 1, 271, 0, 0, 0
1863, 1, 1636429696145, 1636429696417, 272, 1, 271, 0, 0, 0
1864, 1, 1636429696342, 1636429696614, 272, 0, 272, 0, 0, 0
1866, 1, 1636429696441, 1636429696714, 273, 1, 272, 0, 1, 1
1867, 1, 1636429696609, 1636429696882, 273, 1, 272, 0, 0, 0
1868, 1, 1636429696658, 1636429696929, 271, 0, 271, 0, 0, 0
1869, 1, 1636429696669, 1636429696933, 264, 1, 263, 1, 0, 1
1870, 1, 1636429696741, 1636429697013, 272, 1, 271, 0, 0, 0
1872, 1, 1636429696821, 1636429697094, 273, 1, 272, 0, 0, 0
1873, 1, 1636429696889, 1636429697161, 272, 1, 271, 1, 0, 1
1874, 1, 1636429697013, 1636429697285, 272, 1, 271, 1, 0, 1
1875, 1, 1636429697105, 1636429697373, 268, 1, 267, 1, 0, 1
1876, 1, 1636429697281, 1636429697554, 273, 1, 272, 0, 1, 1
1878, 1, 1636429697325, 1636429697597, 272, 0, 272, 0, 0, 0
1877, 1, 1636429697325, 1636429697597, 272, 1, 271, 0, 0, 0
1881, 1, 1636429697553, 1636429697825, 272, 1, 271, 0, 0, 0
1882, 1, 1636429697685, 1636429697989, 304, 0, 304, 0, 0, 0
1883, 1, 1636429697773, 1636429698081, 308, 1, 307, 0, 1, 1
1884, 1, 1636429697981, 1636429698253, 272, 0, 272, 0, 0, 0
1885, 1, 1636429698029, 1636429698298, 269, 1, 268, 0, 1, 1
1886, 1, 1636429698026, 1636429698298, 272, 0, 272, 0, 0, 0
1888, 1, 1636429698246, 1636429698517, 271, 0, 271, 0, 0, 0
1887, 1, 1636429698261, 1636429698533, 272, 1, 271, 0, 0, 0
1889, 1, 1636429698389, 1636429698661, 272, 1, 271, 0, 1, 1
1890, 1, 1636429698477, 1636429698754, 277, 1, 276, 0, 1, 1
1891, 1, 1636429698650, 1636429698929, 279, 0, 279, 0, 0, 0
1893, 1, 1636429698701, 1636429698969, 268, 0, 268, 0, 0, 0
1892, 1, 1636429698697, 1636429698969, 272, 0, 272, 0, 0, 0
1894, 1, 1636429698917, 1636429699190, 273, 0, 273, 0, 0, 0
1895, 1, 1636429698929, 1636429699201, 272, 0, 272, 0, 0, 0
1896, 1, 1636429699062, 1636429699325, 263, 0, 263, 0, 0, 0
1897, 1, 1636429699145, 1636429699413, 268, 1, 267, 0, 0, 0
1898, 1, 1636429699325, 1636429699594, 269, 1, 268, 0, 0, 0
1899, 1, 1636429699369, 1636429699641, 272, 1, 271, 1, 0, 1
1900, 1, 1636429699369, 1636429699642, 273, 1, 272, 0, 0, 0
1901, 1, 1636429699589, 1636429699857, 268, 1, 267, 1, 0, 1
1902, 1, 1636429699593, 1636429699865, 272, 1, 271, 0, 0, 0
1903, 1, 1636429699717, 1636429699990, 273, 1, 272, 0, 0, 0
1904, 1, 1636429699817, 1636429700089, 272, 0, 272, 0, 0, 0
1905, 1, 1636429699985, 1636429700257, 272, 1, 271, 0, 0, 0
1906, 1, 1636429700041, 1636429700313, 272, 1, 271, 1, 0, 1
1907, 1, 1636429700041, 1636429700321, 280, 1, 279, 0, 1, 1
1908, 1, 1636429700257, 1636429700525, 268, 1, 267, 1, 0, 1
1909, 1, 1636429700265, 1636429700533, 268, 1, 267, 1, 0, 1
1911, 1, 1636429700493, 1636429700762, 269, 1, 268, 0, 1, 1
1912, 1, 1636429700658, 1636429700929, 271, 0, 271, 0, 0, 0
1914, 1, 1636429700717, 1636429700986, 269, 1, 268, 0, 1, 1
1913, 1, 1636429700717, 1636429700989, 272, 1, 271, 1, 0, 1
1915, 1, 1636429700926, 1636429701197, 271, 0, 271, 0, 0, 0
1916, 1, 1636429700941, 1636429701217, 276, 1, 275, 0, 0, 0
1917, 1, 1636429701170, 1636429701438, 268, 0, 268, 0, 0, 0
1918, 1, 1636429701325, 1636429701594, 269, 1, 268, 0, 0, 0
1919, 1, 1636429701377, 1636429701646, 269, 1, 268, 0, 0, 0
1920, 1, 1636429701381, 1636429701649, 268, 1, 267, 0, 1, 1
1921, 1, 1636429701594, 1636429701865, 271, 0, 271, 0, 0, 0
1922, 1, 1636429701618, 1636429701889, 271, 0, 271, 0, 0, 0
1923, 1, 1636429701842, 1636429702113, 271, 0, 271, 0, 0, 0
1924, 1, 1636429701990, 1636429702261, 271, 0, 271, 0, 0, 0
1925, 1, 1636429702046, 1636429702317, 271, 0, 271, 0, 0, 0
1926, 1, 1636429702054, 1636429702329, 275, 0, 275, 0, 0, 0
1927, 1, 1636429702261, 1636429702534, 273, 1, 272, 1, 0, 1
1928, 1, 1636429702293, 1636429702566, 273, 0, 273, 0, 0, 0
1929, 1, 1636429702525, 1636429702798, 273, 1, 272, 0, 1, 1
1930, 1, 1636429702681, 1636429702946, 265, 1, 264, 0, 0, 0
1931, 1, 1636429702717, 1636429702993, 276, 1, 275, 0, 1, 1
1932, 1, 1636429702769, 1636429703037, 268, 1, 267, 0, 1, 1
1933, 1, 1636429702941, 1636429703213, 272, 1, 271, 0, 1, 1
1934, 1, 1636429702977, 1636429703250, 273, 1, 272, 0, 1, 1
1935, 1, 1636429703222, 1636429703493, 271, 0, 271, 0, 0, 0
1936, 1, 1636429703342, 1636429703617, 275, 0, 275, 0, 0, 0
1937, 1, 1636429703397, 1636429703669, 272, 0, 272, 0, 0, 0
1938, 1, 1636429703438, 1636429703709, 271, 0, 271, 0, 0, 0
1939, 1, 1636429703610, 1636429703885, 275, 0, 275, 0, 0, 0
1940, 1, 1636429703673, 1636429703946, 273, 1, 272, 0, 0, 0
1941, 1, 1636429703901, 1636429704169, 268, 0, 268, 0, 0, 0
1944, 1, 1636429704009, 1636429704361, 352, 1, 351, 0, 1, 1
1945, 1, 1636429704066, 1636429704361, 295, 0, 295, 0, 0, 0
1947, 1, 1636429704181, 1636429704454, 273, 1, 272, 0, 1, 1
1948, 1, 1636429704313, 1636429704589, 276, 0, 276, 0, 0, 0
1949, 1, 1636429704357, 1636429704630, 273, 0, 273, 0, 0, 0
1951, 1, 1636429704517, 1636429704793, 276, 1, 275, 1, 0, 1
1952, 1, 1636429704629, 1636429704902, 273, 1, 272, 0, 0, 0
1953, 1, 1636429704761, 1636429705033, 272, 1, 271, 0, 0, 0
1954, 1, 1636429704769, 1636429705041, 272, 1, 271, 0, 0, 0
1956, 1, 1636429704993, 1636429705265, 272, 1, 271, 0, 1, 1
1957, 1, 1636429705085, 1636429705357, 272, 1, 271, 0, 1, 1
1958, 1, 1636429705194, 1636429705465, 271, 0, 271, 0, 0, 0
1960, 1, 1636429705462, 1636429705729, 267, 0, 267, 0, 0, 0
1961, 1, 1636429705462, 1636429705733, 271, 0, 271, 0, 0, 0
1962, 1, 1636429705669, 1636429705998, 329, 1, 328, 1, 0, 1
1963, 1, 1636429705710, 1636429706001, 291, 0, 291, 0, 0, 0
1966, 1, 1636429706125, 1636429706413, 288, 1, 287, 0, 0, 0
1967, 1, 1636429706125, 1636429706414, 289, 1, 288, 0, 0, 0
1969, 1, 1636429706217, 1636429706502, 285, 1, 284, 0, 0, 0
1968, 1, 1636429706217, 1636429706505, 288, 1, 287, 1, 0, 1
1970, 1, 1636429706413, 1636429706685, 272, 2, 270, 1, 0, 1
1971, 1, 1636429706413, 1636429706693, 280, 1, 279, 0, 0, 0
1972, 1, 1636429706681, 1636429706958, 277, 1, 276, 0, 0, 0
1973, 1, 1636429706810, 1636429707078, 268, 0, 268, 0, 0, 0
1974, 1, 1636429706814, 1636429707081, 267, 0, 267, 0, 0, 0
1975, 1, 1636429706913, 1636429707189, 276, 1, 275, 0, 0, 0
1978, 1, 1636429707085, 1636429707365, 280, 0, 280, 0, 0, 0
1979, 1, 1636429707137, 1636429707410, 273, 1, 272, 1, 0, 1
1982, 1, 1636429707546, 1636429707813, 267, 0, 267, 0, 0, 0
1981, 1, 1636429707546, 1636429707822, 276, 0, 276, 0, 0, 0
1983, 1, 1636429707585, 1636429707858, 273, 1, 272, 0, 0, 0
1984, 1, 1636429707753, 1636429708025, 272, 1, 271, 1, 0, 1
1985, 1, 1636429707761, 1636429708042, 281, 0, 281, 0, 0, 0
1987, 1, 1636429707805, 1636429708073, 268, 1, 267, 0, 0, 0
1988, 1, 1636429708222, 1636429708494, 272, 0, 272, 0, 0, 0
1989, 1, 1636429708222, 1636429708497, 275, 0, 275, 0, 0, 0
1990, 1, 1636429708258, 1636429708538, 280, 0, 280, 0, 0, 0
1991, 1, 1636429708422, 1636429708698, 276, 0, 276, 0, 0, 0
1993, 1, 1636429708893, 1636429709161, 268, 1, 267, 0, 0, 0
1994, 1, 1636429708901, 1636429709177, 276, 1, 275, 0, 1, 1
1995, 1, 1636429708938, 1636429709209, 271, 0, 271, 0, 0, 0
1996, 1, 1636429709082, 1636429709358, 276, 0, 276, 0, 0, 0
1997, 1, 1636429709565, 1636429709837, 272, 1, 271, 1, 0, 1
1998, 1, 1636429709578, 1636429709854, 276, 0, 276, 0, 0, 0
1999, 1, 1636429709610, 1636429709882, 272, 0, 272, 0, 0, 0
2000, 1, 1636429709762, 1636429710034, 272, 0, 272, 0, 0, 0
2001, 1, 1636429710237, 1636429710529, 292, 1, 291, 0, 1, 1
2002, 1, 1636429710257, 1636429710529, 272, 1, 271, 0, 0, 0
2003, 1, 1636429710282, 1636429710553, 271, 0, 271, 0, 0, 0
1965, 1, 1636429710393, 1636429710665, 272, 0, 272, 0, 0, 0
2004, 1, 1636429710437, 1636429710710, 273, 1, 272, 0, 0, 0
2005, 1, 1636429710693, 1636429710965, 272, 1, 271, 0, 0, 0
2007, 1, 1636429710929, 1636429711201, 272, 1, 271, 1, 0, 1
2006, 1, 1636429710929, 1636429711201, 272, 1, 271, 0, 0, 0
2008, 1, 1636429710949, 1636429711229, 280, 0, 280, 0, 0, 0
2009, 1, 1636429711062, 1636429711333, 271, 0, 271, 0, 0, 0
2010, 1, 1636429711101, 1636429711373, 272, 1, 271, 0, 1, 1
2012, 1, 1636429711593, 1636429711865, 272, 0, 272, 0, 0, 0
2013, 1, 1636429711597, 1636429711878, 281, 0, 281, 0, 0, 0
2014, 1, 1636429711637, 1636429711914, 277, 1, 276, 1, 0, 1
2015, 1, 1636429711773, 1636429712046, 273, 1, 272, 1, 0, 1
2016, 1, 1636429712269, 1636429712542, 273, 0, 273, 0, 0, 0
2017, 1, 1636429712285, 1636429712557, 272, 1, 271, 0, 0, 0
2018, 1, 1636429712314, 1636429712598, 284, 0, 284, 0, 0, 0
2019, 1, 1636429712441, 1636429712710, 269, 1, 268, 1, 0, 1
2020, 1, 1636429712949, 1636429713217, 268, 1, 267, 0, 0, 0
2021, 1, 1636429712965, 1636429713238, 273, 1, 272, 0, 0, 0
2022, 1, 1636429712994, 1636429713262, 268, 0, 268, 0, 0, 0
2023, 1, 1636429713109, 1636429713382, 273, 1, 272, 0, 0, 0
2024, 1, 1636429713617, 1636429713889, 272, 0, 272, 0, 0, 0
2025, 1, 1636429713642, 1636429713913, 271, 0, 271, 0, 0, 0
2026, 1, 1636429713661, 1636429713941, 280, 1, 279, 1, 0, 1
2027, 1, 1636429713782, 1636429714070, 288, 0, 288, 0, 0, 0
1950, 1, 1636429714105, 1636429714378, 273, 1, 272, 1, 0, 1
2028, 1, 1636429714278, 1636429714546, 268, 0, 268, 0, 0, 0
2030, 1, 1636429714285, 1636429714549, 264, 0, 264, 0, 0, 0
2031, 1, 1636429714313, 1636429714582, 269, 1, 268, 0, 0, 0
2032, 1, 1636429714333, 1636429714609, 276, 0, 276, 0, 0, 0
2034, 1, 1636429714465, 1636429714734, 269, 1, 268, 0, 0, 0
2037, 1, 1636429714949, 1636429715221, 272, 0, 272, 0, 0, 0
2036, 1, 1636429714949, 1636429715221, 272, 0, 272, 0, 0, 0
2038, 1, 1636429714977, 1636429715250, 273, 0, 273, 0, 0, 0
2039, 1, 1636429715034, 1636429715301, 267, 0, 267, 0, 0, 0
2041, 1, 1636429715166, 1636429715445, 279, 0, 279, 0, 0, 0
2040, 1, 1636429715133, 1636429715445, 312, 1, 311, 0, 0, 0
2042, 1, 1636429715625, 1636429715897, 272, 1, 271, 1, 0, 1
2044, 1, 1636429715625, 1636429715897, 272, 1, 271, 1, 0, 1
2045, 1, 1636429715641, 1636429715914, 273, 0, 273, 0, 0, 0
2046, 1, 1636429715701, 1636429715973, 272, 0, 272, 0, 0, 0
2048, 1, 1636429715845, 1636429716117, 272, 1, 271, 0, 0, 0
2049, 1, 1636429716081, 1636429716357, 276, 1, 275, 0, 0, 0
2050, 1, 1636429716302, 1636429716573, 271, 0, 271, 0, 0, 0
2051, 1, 1636429716302, 1636429716574, 272, 0, 272, 0, 0, 0
2052, 1, 1636429716317, 1636429716589, 272, 0, 272, 0, 0, 0
2054, 1, 1636429716521, 1636429716794, 273, 1, 272, 0, 1, 1
2055, 1, 1636429716757, 1636429717049, 292, 1, 291, 0, 0, 0
2057, 1, 1636429717042, 1636429717317, 275, 0, 275, 0, 0, 0
2056, 1, 1636429717042, 1636429717318, 276, 1, 275, 1, 0, 1
2058, 1, 1636429717042, 1636429717317, 275, 1, 274, 0, 1, 1
2060, 1, 1636429717217, 1636429717494, 277, 1, 276, 0, 0, 0
2059, 1, 1636429717186, 1636429717494, 308, 0, 308, 0, 0, 0
2061, 1, 1636429717398, 1636429717669, 271, 0, 271, 0, 0, 0
2062, 1, 1636429717497, 1636429717765, 268, 1, 267, 0, 1, 1
2063, 1, 1636429717677, 1636429717962, 285, 1, 284, 0, 0, 0
2064, 1, 1636429717714, 1636429717985, 271, 0, 271, 0, 0, 0
2065, 1, 1636429717761, 1636429718030, 269, 1, 268, 0, 0, 0
2066, 1, 1636429717761, 1636429718030, 269, 1, 268, 1, 0, 1
2067, 1, 1636429717894, 1636429718165, 271, 0, 271, 0, 0, 0
2068, 1, 1636429718069, 1636429718345, 276, 1, 275, 0, 0, 0
2069, 1, 1636429718141, 1636429718413, 272, 1, 271, 0, 0, 0
2070, 1, 1636429718209, 1636429718489, 280, 1, 279, 0, 1, 1
2072, 1, 1636429718401, 1636429718674, 273, 1, 272, 0, 1, 1
2071, 1, 1636429718401, 1636429718674, 273, 1, 272, 0, 1, 1
2073, 1, 1636429718429, 1636429718705, 276, 1, 275, 0, 1, 1
2074, 1, 1636429718561, 1636429718833, 272, 1, 271, 0, 0, 0
2075, 1, 1636429718742, 1636429719013, 271, 0, 271, 0, 0, 0
2076, 1, 1636429718753, 1636429719026, 273, 1, 272, 0, 0, 0
2077, 1, 1636429718854, 1636429719125, 271, 0, 271, 0, 0, 0
2078, 1, 1636429719077, 1636429719346, 269, 1, 268, 0, 0, 0
2079, 1, 1636429719077, 1636429719354, 277, 1, 276, 0, 0, 0
2080, 1, 1636429719105, 1636429719381, 276, 0, 276, 0, 0, 0
2081, 1, 1636429719234, 1636429719506, 272, 0, 272, 0, 0, 0
2082, 1, 1636429719422, 1636429719697, 275, 0, 275, 0, 0, 0
2083, 1, 1636429719422, 1636429719697, 275, 0, 275, 0, 0, 0
2084, 1, 1636429719533, 1636429719806, 273, 1, 272, 1, 0, 1
2085, 1, 1636429719741, 1636429720013, 272, 1, 271, 1, 0, 1
2086, 1, 1636429719745, 1636429720018, 273, 1, 272, 0, 1, 1
2087, 1, 1636429719782, 1636429720053, 271, 0, 271, 0, 0, 0
2088, 1, 1636429719910, 1636429720182, 272, 0, 272, 0, 0, 0
2089, 1, 1636429720098, 1636429720369, 271, 0, 271, 0, 0, 0
2090, 1, 1636429720206, 1636429720481, 275, 0, 275, 0, 0, 0
2091, 1, 1636429720409, 1636429720677, 268, 1, 267, 0, 1, 1
2092, 1, 1636429720409, 1636429720678, 269, 1, 268, 0, 1, 1
2093, 1, 1636429720450, 1636429720717, 267, 0, 267, 0, 0, 0
2094, 1, 1636429720589, 1636429720862, 273, 1, 272, 0, 0, 0
2095, 1, 1636429720769, 1636429721041, 272, 1, 271, 0, 0, 0
2096, 1, 1636429720878, 1636429721149, 271, 0, 271, 0, 0, 0
2098, 1, 1636429721073, 1636429721341, 268, 1, 267, 1, 0, 1
2097, 1, 1636429721073, 1636429721341, 268, 1, 267, 0, 1, 1
2099, 1, 1636429721118, 1636429721406, 288, 0, 288, 0, 0, 0
2100, 1, 1636429721257, 1636429721525, 268, 1, 267, 0, 1, 1
2043, 1, 1636429721361, 1636429721633, 272, 0, 272, 0, 0, 0
2101, 1, 1636429721445, 1636429721717, 272, 1, 271, 0, 1, 1
2102, 1, 1636429721545, 1636429721809, 264, 1, 263, 1, 0, 1
2103, 1, 1636429721670, 1636429721937, 267, 0, 267, 0, 0, 0
2105, 1, 1636429721729, 1636429722006, 277, 1, 276, 1, 0, 1
2104, 1, 1636429721733, 1636429722006, 273, 1, 272, 0, 1, 1
2106, 1, 1636429721801, 1636429722073, 272, 1, 271, 1, 0, 1
2107, 1, 1636429721921, 1636429722198, 277, 0, 277, 0, 0, 0
2108, 1, 1636429722025, 1636429722297, 272, 1, 271, 0, 1, 1
2109, 1, 1636429722117, 1636429722385, 268, 1, 267, 0, 1, 1
2110, 1, 1636429722205, 1636429722481, 276, 1, 275, 1, 0, 1
2111, 1, 1636429722338, 1636429722606, 268, 0, 268, 0, 0, 0
2112, 1, 1636429722401, 1636429722670, 269, 1, 268, 0, 0, 0
2113, 1, 1636429722401, 1636429722670, 269, 1, 268, 1, 0, 1
2114, 1, 1636429722461, 1636429722733, 272, 0, 272, 0, 0, 0
2115, 1, 1636429722585, 1636429722857, 272, 1, 271, 1, 0, 1
2116, 1, 1636429722685, 1636429722961, 276, 1, 275, 0, 0, 0
2117, 1, 1636429722781, 1636429723053, 272, 1, 271, 1, 0, 1
2118, 1, 1636429722882, 1636429723162, 280, 0, 280, 0, 0, 0
2119, 1, 1636429723001, 1636429723274, 273, 1, 272, 0, 1, 1
2120, 1, 1636429723074, 1636429723346, 272, 0, 272, 0, 0, 0
2121, 1, 1636429723074, 1636429723346, 272, 0, 272, 0, 0, 0
2122, 1, 1636429723129, 1636429723401, 272, 1, 271, 0, 1, 1
2123, 1, 1636429723258, 1636429723533, 275, 0, 275, 0, 0, 0
2124, 1, 1636429723361, 1636429723637, 276, 1, 275, 0, 1, 1
2125, 1, 1636429723457, 1636429723729, 272, 1, 271, 0, 0, 0
2126, 1, 1636429723566, 1636429723841, 275, 0, 275, 0, 0, 0
2127, 1, 1636429723677, 1636429723953, 276, 1, 275, 0, 0, 0
2128, 1, 1636429723741, 1636429724010, 269, 1, 268, 0, 0, 0
2129, 1, 1636429723749, 1636429724018, 269, 1, 268, 0, 1, 1
2130, 1, 1636429723793, 1636429724062, 269, 1, 268, 0, 0, 0
2131, 1, 1636429723929, 1636429724197, 268, 1, 267, 0, 0, 0
2132, 1, 1636429724041, 1636429724330, 289, 1, 288, 0, 0, 0
2133, 1, 1636429724130, 1636429724465, 335, 0, 335, 0, 0, 0
2134, 1, 1636429724241, 1636429724557, 316, 0, 316, 0, 0, 0
2135, 1, 1636429724377, 1636429724645, 268, 1, 267, 0, 1, 1
2136, 1, 1636429724406, 1636429724685, 279, 0, 279, 0, 0, 0
2138, 1, 1636429724465, 1636429724730, 265, 0, 265, 0, 0, 0
2137, 1, 1636429724469, 1636429724730, 261, 0, 261, 0, 0, 0
2139, 1, 1636429724593, 1636429724917, 324, 1, 323, 1, 0, 1
2140, 1, 1636429724737, 1636429725018, 281, 0, 281, 0, 0, 0
2141, 1, 1636429724865, 1636429725137, 272, 1, 271, 0, 0, 0
2142, 1, 1636429724949, 1636429725225, 276, 1, 275, 0, 1, 1
2144, 1, 1636429725041, 1636429725317, 276, 1, 275, 0, 0, 0
2146, 1, 1636429725081, 1636429725350, 269, 1, 268, 0, 1, 1
2149, 1, 1636429725125, 1636429725394, 269, 1, 268, 1, 0, 1
2148, 1, 1636429725121, 1636429725394, 273, 1, 272, 0, 0, 0
2150, 1, 1636429725321, 1636429725597, 276, 1, 275, 1, 0, 1
2151, 1, 1636429725417, 1636429725689, 272, 1, 271, 0, 0, 0
2152, 1, 1636429725533, 1636429725801, 268, 1, 267, 1, 0, 1
2153, 1, 1636429725621, 1636429725894, 273, 1, 272, 0, 1, 1
2154, 1, 1636429725713, 1636429725986, 273, 1, 272, 0, 1, 1
2155, 1, 1636429725749, 1636429726022, 273, 1, 272, 0, 0, 0
2157, 1, 1636429725805, 1636429726082, 277, 1, 276, 0, 1, 1
2156, 1, 1636429725805, 1636429726082, 277, 1, 276, 0, 1, 1
2053, 1, 1636429725850, 1636429726117, 267, 0, 267, 0, 0, 0
2158, 1, 1636429726025, 1636429726301, 276, 1, 275, 1, 0, 1
2159, 1, 1636429726081, 1636429726353, 272, 1, 271, 0, 0, 0
2160, 1, 1636429726153, 1636429726426, 273, 1, 272, 0, 1, 1
2161, 1, 1636429726218, 1636429726501, 283, 0, 283, 0, 0, 0
2162, 1, 1636429726297, 1636429726570, 273, 1, 272, 0, 1, 1
2163, 1, 1636429726381, 1636429726653, 272, 1, 271, 0, 0, 0
2164, 1, 1636429726421, 1636429726689, 268, 1, 267, 0, 1, 1
2166, 1, 1636429726477, 1636429726754, 277, 0, 277, 0, 0, 0
2165, 1, 1636429726477, 1636429726754, 277, 0, 277, 0, 0, 0
2167, 1, 1636429726601, 1636429726877, 276, 1, 275, 1, 0, 1
2168, 1, 1636429726693, 1636429726961, 268, 1, 267, 0, 1, 1
2169, 1, 1636429726753, 1636429727017, 264, 1, 263, 0, 0, 0
2170, 1, 1636429726825, 1636429727090, 265, 1, 264, 1, 0, 1
2171, 1, 1636429726909, 1636429727182, 273, 1, 272, 0, 0, 0
2172, 1, 1636429726961, 1636429727229, 268, 1, 267, 1, 0, 1
2173, 1, 1636429727045, 1636429727314, 269, 0, 269, 0, 0, 0
2174, 1, 1636429727090, 1636429727358, 268, 0, 268, 0, 0, 0
2176, 1, 1636429727141, 1636429727414, 273, 1, 272, 0, 1, 1
2175, 1, 1636429727141, 1636429727414, 273, 1, 272, 1, 0, 1
2177, 1, 1636429727269, 1636429727537, 268, 1, 267, 0, 0, 0
2178, 1, 1636429727361, 1636429727633, 272, 1, 271, 0, 1, 1
2179, 1, 1636429727413, 1636429727685, 272, 1, 271, 0, 0, 0
2180, 1, 1636429727485, 1636429727754, 269, 0, 269, 0, 0, 0
2181, 1, 1636429727577, 1636429727845, 268, 0, 268, 0, 0, 0
2182, 1, 1636429727622, 1636429727890, 268, 0, 268, 0, 0, 0
2183, 1, 1636429727709, 1636429727981, 272, 0, 272, 0, 0, 0
2184, 1, 1636429727753, 1636429728025, 272, 1, 271, 0, 0, 0
2185, 1, 1636429727813, 1636429728085, 272, 1, 271, 0, 0, 0
2186, 1, 1636429727813, 1636429728085, 272, 1, 271, 0, 1, 1
2187, 1, 1636429727933, 1636429728205, 272, 0, 272, 0, 0, 0
2189, 1, 1636429728081, 1636429728353, 272, 1, 271, 0, 0, 0
2190, 1, 1636429728153, 1636429728422, 269, 1, 268, 1, 0, 1
2188, 1, 1636429728205, 1636429728473, 268, 1, 267, 1, 0, 1
2191, 1, 1636429728241, 1636429728517, 276, 1, 275, 1, 0, 1
2192, 1, 1636429728293, 1636429728557, 264, 1, 263, 0, 1, 1
2193, 1, 1636429728377, 1636429728646, 269, 1, 268, 0, 0, 0
2194, 1, 1636429728425, 1636429728706, 281, 0, 281, 0, 0, 0
2195, 1, 1636429728473, 1636429728749, 276, 0, 276, 0, 0, 0
2197, 1, 1636429728613, 1636429728890, 277, 1, 276, 0, 1, 1
2196, 1, 1636429728661, 1636429728933, 272, 1, 271, 1, 0, 1
2198, 1, 1636429728749, 1636429729026, 277, 1, 276, 1, 0, 1
2199, 1, 1636429728817, 1636429729089, 272, 1, 271, 0, 0, 0
2201, 1, 1636429728925, 1636429729197, 272, 1, 271, 0, 0, 0
2203, 1, 1636429729041, 1636429729317, 276, 1, 275, 0, 0, 0
2204, 1, 1636429729101, 1636429729373, 272, 0, 272, 0, 0, 0
2202, 1, 1636429729113, 1636429729385, 272, 1, 271, 0, 0, 0
2205, 1, 1636429729145, 1636429729417, 272, 1, 271, 0, 0, 0
2206, 1, 1636429729285, 1636429729549, 264, 1, 263, 0, 1, 1
2208, 1, 1636429729417, 1636429729694, 277, 1, 276, 0, 1, 1
2209, 1, 1636429729485, 1636429729758, 273, 1, 272, 1, 0, 1
2210, 1, 1636429729594, 1636429729865, 271, 0, 271, 0, 0, 0
2211, 1, 1636429729722, 1636429729993, 271, 0, 271, 0, 0, 0
2212, 1, 1636429729773, 1636429730045, 272, 1, 271, 0, 1, 1
2214, 1, 1636429729814, 1636429730085, 271, 0, 271, 0, 0, 0
2215, 1, 1636429729945, 1636429730217, 272, 1, 271, 0, 1, 1
2216, 1, 1636429730089, 1636429730362, 273, 0, 273, 0, 0, 0
2217, 1, 1636429730145, 1636429730417, 272, 1, 271, 0, 1, 1
2219, 1, 1636429730393, 1636429730665, 272, 1, 271, 1, 0, 1
2220, 1, 1636429730445, 1636429730717, 272, 0, 272, 0, 0, 0
2221, 1, 1636429730481, 1636429730749, 268, 0, 268, 0, 0, 0
2222, 1, 1636429730610, 1636429730882, 272, 0, 272, 0, 0, 0
2223, 1, 1636429730753, 1636429731025, 272, 0, 272, 0, 0, 0
2225, 1, 1636429731061, 1636429731330, 269, 0, 269, 0, 0, 0
2226, 1, 1636429731113, 1636429731386, 273, 0, 273, 0, 0, 0
2227, 1, 1636429731150, 1636429731418, 268, 0, 268, 0, 0, 0
2229, 1, 1636429731417, 1636429731689, 272, 1, 271, 0, 0, 0
2230, 1, 1636429731729, 1636429732002, 273, 1, 272, 0, 0, 0
2231, 1, 1636429731777, 1636429732053, 276, 0, 276, 0, 0, 0
2232, 1, 1636429731821, 1636429732093, 272, 1, 271, 1, 0, 1
2233, 1, 1636429732089, 1636429732361, 272, 1, 271, 1, 0, 1
2234, 1, 1636429732405, 1636429732673, 268, 1, 267, 0, 0, 0
2235, 1, 1636429732449, 1636429732717, 268, 1, 267, 0, 0, 0
2236, 1, 1636429732493, 1636429732762, 269, 0, 269, 0, 0, 0
2237, 1, 1636429732762, 1636429733034, 272, 0, 272, 0, 0, 0
2239, 1, 1636429733117, 1636429733390, 273, 0, 273, 0, 0, 0
2240, 1, 1636429733161, 1636429733434, 273, 1, 272, 0, 0, 0
2241, 1, 1636429733430, 1636429733705, 275, 0, 275, 0, 0, 0
2242, 1, 1636429733789, 1636429734058, 269, 1, 268, 0, 0, 0
2243, 1, 1636429733834, 1636429734106, 272, 0, 272, 0, 0, 0
2244, 1, 1636429734105, 1636429734377, 272, 1, 271, 0, 0, 0
2245, 1, 1636429734458, 1636429734730, 272, 0, 272, 0, 0, 0
2247, 1, 1636429734786, 1636429735178, 392, 0, 392, 0, 0, 0
2248, 1, 1636429735185, 1636429735458, 273, 1, 272, 0, 1, 1
2249, 1, 1636429735505, 1636429735778, 273, 1, 272, 0, 0, 0
2252, 1, 1636429735569, 1636429735842, 273, 1, 272, 0, 0, 0
2253, 1, 1636429735858, 1636429736130, 272, 0, 272, 0, 0, 0
2254, 1, 1636429736181, 1636429736454, 273, 1, 272, 1, 0, 1
2255, 1, 1636429736242, 1636429736514, 272, 0, 272, 0, 0, 0
2256, 1, 1636429736537, 1636429736810, 273, 0, 273, 0, 0, 0
2257, 1, 1636429736846, 1636429737118, 272, 0, 272, 0, 0, 0
2258, 1, 1636429736922, 1636429737193, 271, 0, 271, 0, 0, 0
2259, 1, 1636429737213, 1636429737485, 272, 1, 271, 0, 0, 0
2260, 1, 1636429737522, 1636429737794, 272, 0, 272, 0, 0, 0
2262, 1, 1636429737889, 1636429738161, 272, 1, 271, 0, 0, 0
2263, 1, 1636429738193, 1636429738466, 273, 1, 272, 0, 1, 1
2266, 1, 1636429741122, 1636429741418, 296, 0, 296, 0, 0, 0
2267, 1, 1636429741602, 1636429741873, 271, 0, 271, 0, 0, 0
2268, 1, 1636429741822, 1636429742094, 272, 0, 272, 0, 0, 0
2269, 1, 1636429742278, 1636429742550, 272, 0, 272, 0, 0, 0
2270, 1, 1636429742493, 1636429742766, 273, 1, 272, 0, 0, 0
2271, 1, 1636429742958, 1636429743229, 271, 0, 271, 0, 0, 0
2272, 1, 1636429743161, 1636429743433, 272, 0, 272, 0, 0, 0
2273, 1, 1636429743626, 1636429743897, 271, 0, 271, 0, 0, 0
2274, 1, 1636429743838, 1636429744109, 271, 0, 271, 0, 0, 0
2275, 1, 1636429744298, 1636429744570, 272, 0, 272, 0, 0, 0
2276, 1, 1636429744553, 1636429744826, 273, 1, 272, 1, 0, 1
2277, 1, 1636429745006, 1636429745277, 271, 0, 271, 0, 0, 0
2278, 1, 1636429745226, 1636429745498, 272, 0, 272, 0, 0, 0
2264, 1, 1636429745562, 1636429745833, 271, 0, 271, 0, 0, 0
2279, 1, 1636429745698, 1636429745970, 272, 0, 272, 0, 0, 0
2280, 1, 1636429745901, 1636429746178, 277, 1, 276, 0, 0, 0
2281, 1, 1636429746225, 1636429746493, 268, 1, 267, 1, 0, 1
2284, 1, 1636429746369, 1636429746641, 272, 1, 271, 0, 0, 0
2285, 1, 1636429746577, 1636429746849, 272, 0, 272, 0, 0, 0
2286, 1, 1636429746894, 1636429747166, 272, 0, 272, 0, 0, 0
2287, 1, 1636429747050, 1636429747321, 271, 0, 271, 0, 0, 0
2288, 1, 1636429747258, 1636429747533, 275, 0, 275, 0, 0, 0
2289, 1, 1636429747561, 1636429747838, 277, 1, 276, 0, 0, 0
2265, 1, 1636429747590, 1636429747861, 271, 0, 271, 0, 0, 0
2290, 1, 1636429747769, 1636429748041, 272, 1, 271, 0, 1, 1
2291, 1, 1636429747905, 1636429748174, 269, 1, 268, 0, 0, 0
2292, 1, 1636429747938, 1636429748206, 268, 0, 268, 0, 0, 0
2293, 1, 1636429748233, 1636429748506, 273, 1, 272, 1, 0, 1
2294, 1, 1636429748261, 1636429748533, 272, 1, 271, 0, 1, 1
2295, 1, 1636429748442, 1636429748714, 272, 0, 272, 0, 0, 0
2296, 1, 1636429748569, 1636429748845, 276, 0, 276, 0, 0, 0
2297, 1, 1636429748606, 1636429748886, 280, 0, 280, 0, 0, 0
2298, 1, 1636429748933, 1636429749210, 277, 1, 276, 0, 0, 0
2299, 1, 1636429749110, 1636429749377, 267, 0, 267, 0, 0, 0
2300, 1, 1636429749245, 1636429749514, 269, 1, 268, 1, 0, 1
2301, 1, 1636429749282, 1636429749554, 272, 0, 272, 0, 0, 0
2302, 1, 1636429749601, 1636429749874, 273, 1, 272, 0, 0, 0
2303, 1, 1636429749773, 1636429750042, 269, 0, 269, 0, 0, 0
2304, 1, 1636429749910, 1636429750181, 271, 0, 271, 0, 0, 0
2305, 1, 1636429749950, 1636429750221, 271, 0, 271, 0, 0, 0
2306, 1, 1636429750262, 1636429750529, 267, 0, 267, 0, 0, 0
2307, 1, 1636429750438, 1636429750717, 279, 0, 279, 0, 0, 0
2308, 1, 1636429750569, 1636429750847, 278, 0, 278, 0, 0, 0
2309, 1, 1636429750610, 1636429750890, 280, 0, 280, 0, 0, 0
2310, 1, 1636429750925, 1636429751201, 276, 1, 275, 1, 0, 1
2311, 1, 1636429751114, 1636429751385, 271, 0, 271, 0, 0, 0
2312, 1, 1636429751245, 1636429751521, 276, 1, 275, 0, 0, 0
2313, 1, 1636429751285, 1636429751557, 272, 1, 271, 0, 0, 0
2314, 1, 1636429751602, 1636429751873, 271, 0, 271, 0, 0, 0
2315, 1, 1636429751782, 1636429752057, 275, 0, 275, 0, 0, 0
2316, 1, 1636429751925, 1636429752197, 272, 0, 272, 0, 0, 0
2317, 1, 1636429751957, 1636429752229, 272, 1, 271, 0, 1, 1
2318, 1, 1636429752269, 1636429752541, 272, 1, 271, 0, 0, 0
2319, 1, 1636429752449, 1636429752722, 273, 0, 273, 0, 0, 0
2321, 1, 1636429752633, 1636429752909, 276, 0, 276, 0, 0, 0
2320, 1, 1636429752722, 1636429752990, 268, 0, 268, 0, 0, 0
2322, 1, 1636429752946, 1636429753218, 272, 0, 272, 0, 0, 0
2323, 1, 1636429753125, 1636429753397, 272, 1, 271, 0, 1, 1
2324, 1, 1636429753313, 1636429753586, 273, 1, 272, 0, 0, 0
2325, 1, 1636429753393, 1636429753665, 272, 1, 271, 1, 0, 1
2326, 1, 1636429753617, 1636429753889, 272, 0, 272, 0, 0, 0
2327, 1, 1636429753797, 1636429754065, 268, 1, 267, 1, 0, 1
2328, 1, 1636429753989, 1636429754261, 272, 1, 271, 0, 1, 1
2329, 1, 1636429754057, 1636429754329, 272, 0, 272, 0, 0, 0
2330, 1, 1636429754289, 1636429754562, 273, 0, 273, 0, 0, 0
2331, 1, 1636429754469, 1636429754742, 273, 1, 272, 0, 1, 1
2332, 1, 1636429754653, 1636429754929, 276, 1, 275, 0, 0, 0
2333, 1, 1636429754730, 1636429754997, 267, 0, 267, 0, 0, 0
2334, 1, 1636429754965, 1636429755237, 272, 1, 271, 0, 1, 1
2335, 1, 1636429755149, 1636429755422, 273, 0, 273, 0, 0, 0
2336, 1, 1636429755325, 1636429755597, 272, 0, 272, 0, 0, 0
2337, 1, 1636429755401, 1636429755674, 273, 1, 272, 0, 1, 1
2338, 1, 1636429755637, 1636429755909, 272, 1, 271, 0, 0, 0
2339, 1, 1636429755821, 1636429756094, 273, 1, 272, 1, 0, 1
2340, 1, 1636429755993, 1636429756265, 272, 0, 272, 0, 0, 0
2341, 1, 1636429756073, 1636429756365, 292, 1, 291, 0, 0, 0
2342, 1, 1636429756361, 1636429756633, 272, 0, 272, 0, 0, 0
2343, 1, 1636429756497, 1636429756770, 273, 1, 272, 0, 0, 0
2346, 1, 1636429756666, 1636429756938, 272, 0, 272, 0, 0, 0
2347, 1, 1636429756761, 1636429757034, 273, 1, 272, 0, 0, 0
2348, 1, 1636429757037, 1636429757310, 273, 1, 272, 0, 0, 0
2349, 1, 1636429757166, 1636429757437, 271, 0, 271, 0, 0, 0
2350, 1, 1636429757338, 1636429757606, 268, 0, 268, 0, 0, 0
2351, 1, 1636429757433, 1636429757702, 269, 1, 268, 0, 0, 0
2352, 1, 1636429757713, 1636429757989, 276, 1, 275, 0, 0, 0
2353, 1, 1636429757846, 1636429758117, 271, 0, 271, 0, 0, 0
2354, 1, 1636429758005, 1636429758278, 273, 0, 273, 0, 0, 0
2355, 1, 1636429758097, 1636429758374, 277, 1, 276, 0, 0, 0
2356, 1, 1636429758393, 1636429758670, 277, 1, 276, 1, 0, 1
2357, 1, 1636429758522, 1636429758794, 272, 0, 272, 0, 0, 0
2358, 1, 1636429758678, 1636429758950, 272, 0, 272, 0, 0, 0
2359, 1, 1636429758774, 1636429759050, 276, 0, 276, 0, 0, 0
2360, 1, 1636429759073, 1636429759350, 277, 1, 276, 0, 0, 0
2361, 1, 1636429759201, 1636429759474, 273, 1, 272, 0, 0, 0
2362, 1, 1636429759353, 1636429759626, 273, 0, 273, 0, 0, 0
2363, 1, 1636429759458, 1636429759733, 275, 0, 275, 0, 0, 0
2364, 1, 1636429759758, 1636429760025, 267, 0, 267, 0, 0, 0
2365, 1, 1636429759878, 1636429760153, 275, 0, 275, 0, 0, 0
2366, 1, 1636429760022, 1636429760294, 272, 0, 272, 0, 0, 0
2367, 1, 1636429760133, 1636429760406, 273, 1, 272, 0, 1, 1
2368, 1, 1636429760426, 1636429760705, 279, 0, 279, 0, 0, 0
2369, 1, 1636429760561, 1636429760830, 269, 1, 268, 0, 0, 0
2370, 1, 1636429760698, 1636429760969, 271, 0, 271, 0, 0, 0
2371, 1, 1636429760810, 1636429761082, 272, 0, 272, 0, 0, 0
2372, 1, 1636429761097, 1636429761370, 273, 1, 272, 0, 0, 0
2373, 1, 1636429761237, 1636429761510, 273, 1, 272, 1, 0, 1
2374, 1, 1636429761366, 1636429761637, 271, 0, 271, 0, 0, 0
2375, 1, 1636429761486, 1636429761758, 272, 0, 272, 0, 0, 0
2376, 1, 1636429761773, 1636429762049, 276, 1, 275, 0, 0, 0
2377, 1, 1636429761914, 1636429762190, 276, 0, 276, 0, 0, 0
2378, 1, 1636429762037, 1636429762310, 273, 1, 272, 0, 1, 1
2379, 1, 1636429762162, 1636429762433, 271, 0, 271, 0, 0, 0
2380, 1, 1636429762441, 1636429762714, 273, 1, 272, 0, 1, 1
2381, 1, 1636429762585, 1636429762858, 273, 1, 272, 0, 0, 0
2382, 1, 1636429762705, 1636429762977, 272, 1, 271, 1, 0, 1
2383, 1, 1636429762842, 1636429763110, 268, 0, 268, 0, 0, 0
2384, 1, 1636429763110, 1636429763385, 275, 0, 275, 0, 0, 0
2385, 1, 1636429763261, 1636429763538, 277, 1, 276, 0, 0, 0
2386, 1, 1636429763374, 1636429763646, 272, 0, 272, 0, 0, 0
2387, 1, 1636429763521, 1636429763794, 273, 0, 273, 0, 0, 0
2388, 1, 1636429763786, 1636429764058, 272, 0, 272, 0, 0, 0
2389, 1, 1636429763946, 1636429764217, 271, 0, 271, 0, 0, 0
2390, 1, 1636429764042, 1636429764309, 267, 0, 267, 0, 0, 0
2391, 1, 1636429764193, 1636429764469, 276, 1, 275, 0, 0, 0
2392, 1, 1636429764453, 1636429764726, 273, 0, 273, 0, 0, 0
2393, 1, 1636429764625, 1636429764897, 272, 1, 271, 1, 0, 1
2394, 1, 1636429764705, 1636429764977, 272, 1, 271, 0, 0, 0
2395, 1, 1636429764885, 1636429765157, 272, 1, 271, 0, 0, 0
2396, 1, 1636429765126, 1636429765398, 272, 0, 272, 0, 0, 0
2397, 1, 1636429765302, 1636429765582, 280, 0, 280, 0, 0, 0
2398, 1, 1636429765381, 1636429765653, 272, 1, 271, 0, 0, 0
2399, 1, 1636429765558, 1636429765830, 272, 0, 272, 0, 0, 0
2400, 1, 1636429765802, 1636429766074, 272, 0, 272, 0, 0, 0
2401, 1, 1636429765985, 1636429766258, 273, 1, 272, 1, 0, 1
2402, 1, 1636429766050, 1636429766318, 268, 0, 268, 0, 0, 0
2403, 1, 1636429766230, 1636429766498, 268, 0, 268, 0, 0, 0
2404, 1, 1636429766482, 1636429766769, 287, 0, 287, 0, 0, 0
2405, 1, 1636429766677, 1636429766945, 268, 0, 268, 0, 0, 0
2406, 1, 1636429766765, 1636429767033, 268, 1, 267, 1, 0, 1
2407, 1, 1636429766893, 1636429767165, 272, 1, 271, 0, 0, 0
2410, 1, 1636429767162, 1636429767433, 271, 0, 271, 0, 0, 0
2411, 1, 1636429767350, 1636429767622, 272, 0, 272, 0, 0, 0
2412, 1, 1636429767426, 1636429767698, 272, 0, 272, 0, 0, 0
2413, 1, 1636429767565, 1636429767837, 272, 1, 271, 0, 0, 0
2414, 1, 1636429767833, 1636429768101, 268, 0, 268, 0, 0, 0
2415, 1, 1636429768026, 1636429768298, 272, 0, 272, 0, 0, 0
2416, 1, 1636429768094, 1636429768366, 272, 0, 272, 0, 0, 0
2417, 1, 1636429768233, 1636429768509, 276, 1, 275, 1, 0, 1
2418, 1, 1636429768501, 1636429768773, 272, 1, 271, 0, 1, 1
2419, 1, 1636429768702, 1636429768970, 268, 0, 268, 0, 0, 0
2420, 1, 1636429768765, 1636429769034, 269, 1, 268, 0, 1, 1
2421, 1, 1636429768905, 1636429769169, 264, 1, 263, 0, 0, 0
2422, 1, 1636429769169, 1636429769441, 272, 1, 271, 0, 0, 0
2423, 1, 1636429769374, 1636429769642, 268, 0, 268, 0, 0, 0
2424, 1, 1636429769429, 1636429769694, 265, 1, 264, 0, 0, 0
2425, 1, 1636429769573, 1636429769837, 264, 1, 263, 0, 0, 0
2426, 1, 1636429769833, 1636429770106, 273, 1, 272, 0, 1, 1
2427, 1, 1636429770046, 1636429770318, 272, 0, 272, 0, 0, 0
2428, 1, 1636429770093, 1636429770366, 273, 1, 272, 0, 0, 0
2429, 1, 1636429770250, 1636429770517, 267, 0, 267, 0, 0, 0
2430, 1, 1636429770509, 1636429770781, 272, 1, 271, 1, 0, 1
2431, 1, 1636429770729, 1636429771001, 272, 1, 271, 1, 0, 1
2432, 1, 1636429770917, 1636429771190, 273, 1, 272, 0, 1, 1
2433, 1, 1636429771174, 1636429771446, 272, 0, 272, 0, 0, 0
2434, 1, 1636429771602, 1636429771873, 271, 0, 271, 0, 0, 0
2435, 1, 1636429771841, 1636429772110, 269, 1, 268, 1, 0, 1
2436, 1, 1636429772282, 1636429772554, 272, 0, 272, 0, 0, 0
2437, 1, 1636429772518, 1636429772789, 271, 0, 271, 0, 0, 0
2438, 1, 1636429772961, 1636429773234, 273, 1, 272, 0, 1, 1
2439, 1, 1636429773201, 1636429773474, 273, 1, 272, 0, 0, 0
2440, 1, 1636429773633, 1636429773910, 277, 0, 277, 0, 0, 0
2441, 1, 1636429773878, 1636429774150, 272, 0, 272, 0, 0, 0
2442, 1, 1636429774313, 1636429774586, 273, 1, 272, 0, 0, 0
2443, 1, 1636429774558, 1636429774829, 271, 0, 271, 0, 0, 0
2444, 1, 1636429774993, 1636429775266, 273, 1, 272, 1, 0, 1
2445, 1, 1636429775238, 1636429775510, 272, 0, 272, 0, 0, 0
2446, 1, 1636429775666, 1636429775938, 272, 0, 272, 0, 0, 0
2447, 1, 1636429775909, 1636429776182, 273, 1, 272, 0, 0, 0
2448, 1, 1636429776338, 1636429776610, 272, 0, 272, 0, 0, 0
2449, 1, 1636429776794, 1636429777082, 288, 0, 288, 0, 0, 0
2450, 1, 1636429777038, 1636429777309, 271, 0, 271, 0, 0, 0
2453, 1, 1636429777478, 1636429777750, 272, 0, 272, 0, 0, 0
2454, 1, 1636429778150, 1636429778421, 271, 0, 271, 0, 0, 0
2455, 1, 1636429778830, 1636429779102, 272, 0, 272, 0, 0, 0
2456, 1, 1636429779506, 1636429779778, 272, 0, 272, 0, 0, 0
2457, 1, 1636429780186, 1636429780458, 272, 0, 272, 0, 0, 0
2458, 1, 1636429780869, 1636429781142, 273, 1, 272, 0, 0, 0
2459, 1, 1636429781545, 1636429781818, 273, 1, 272, 0, 1, 1
2460, 1, 1636429782226, 1636429782498, 272, 0, 272, 0, 0, 0
2461, 1, 1636429782909, 1636429783182, 273, 1, 272, 0, 0, 0
2462, 1, 1636429783590, 1636429783862, 272, 0, 272, 0, 0, 0
2463, 1, 1636429784258, 1636429784530, 272, 0, 272, 0, 0, 0
2464, 1, 1636429784942, 1636429785218, 276, 0, 276, 0, 0, 0
2465, 1, 1636429785622, 1636429785894, 272, 0, 272, 0, 0, 0
2466, 1, 1636429786302, 1636429786574, 272, 0, 272, 0, 0, 0
2467, 1, 1636429786981, 1636429787302, 321, 0, 321, 0, 0, 0
2470, 1, 1636429787698, 1636429787970, 272, 0, 272, 0, 0, 0
2471, 1, 1636429788374, 1636429788650, 276, 0, 276, 0, 0, 0
2472, 1, 1636429789050, 1636429789322, 272, 0, 272, 0, 0, 0
2473, 1, 1636429789726, 1636429789994, 268, 0, 268, 0, 0, 0
2474, 1, 1636429797570, 1636429797841, 271, 0, 271, 0, 0, 0
2477, 1, 1636429808150, 1636429808422, 272, 0, 272, 0, 0, 0
2478, 1, 1636429808606, 1636429808877, 271, 0, 271, 0, 0, 0
2479, 1, 1636429808830, 1636429809101, 271, 0, 271, 0, 0, 0
2480, 1, 1636429809281, 1636429809554, 273, 1, 272, 1, 0, 1
2481, 1, 1636429809498, 1636429809769, 271, 0, 271, 0, 0, 0
2482, 1, 1636429809962, 1636429810234, 272, 0, 272, 0, 0, 0
2483, 1, 1636429810178, 1636429810450, 272, 0, 272, 0, 0, 0
2484, 1, 1636429810641, 1636429810913, 272, 1, 271, 1, 0, 1
2485, 1, 1636429810854, 1636429811126, 272, 0, 272, 0, 0, 0
2486, 1, 1636429811326, 1636429811598, 272, 0, 272, 0, 0, 0
2487, 1, 1636429811533, 1636429811806, 273, 1, 272, 0, 0, 0
2488, 1, 1636429811998, 1636429812270, 272, 0, 272, 0, 0, 0
2489, 1, 1636429812214, 1636429812486, 272, 0, 272, 0, 0, 0
2490, 1, 1636429812682, 1636429812954, 272, 0, 272, 0, 0, 0
2491, 1, 1636429812893, 1636429813166, 273, 0, 273, 0, 0, 0
2492, 1, 1636429813358, 1636429813629, 271, 0, 271, 0, 0, 0
2493, 1, 1636429813566, 1636429813838, 272, 0, 272, 0, 0, 0
2494, 1, 1636429814030, 1636429814301, 271, 0, 271, 0, 0, 0
2495, 1, 1636429814246, 1636429814518, 272, 0, 272, 0, 0, 0
2496, 1, 1636429814706, 1636429814981, 275, 0, 275, 0, 0, 0
2497, 1, 1636429814922, 1636429815198, 276, 0, 276, 0, 0, 0
2498, 1, 1636429815386, 1636429815658, 272, 0, 272, 0, 0, 0
2499, 1, 1636429815602, 1636429815874, 272, 0, 272, 0, 0, 0
2500, 1, 1636429816066, 1636429816337, 271, 0, 271, 0, 0, 0
2501, 1, 1636429816282, 1636429816554, 272, 0, 272, 0, 0, 0
2502, 1, 1636429816741, 1636429817013, 272, 1, 271, 0, 0, 0
2503, 1, 1636429816961, 1636429817233, 272, 1, 271, 1, 0, 1
2504, 1, 1636429817413, 1636429817685, 272, 0, 272, 0, 0, 0
2505, 1, 1636429817638, 1636429817909, 271, 0, 271, 0, 0, 0
2506, 1, 1636429818094, 1636429818365, 271, 0, 271, 0, 0, 0
2507, 1, 1636429818309, 1636429818582, 273, 1, 272, 0, 0, 0
2508, 1, 1636429818770, 1636429819042, 272, 0, 272, 0, 0, 0
2509, 1, 1636429818985, 1636429819258, 273, 1, 272, 0, 0, 0
2510, 1, 1636429819450, 1636429819722, 272, 0, 272, 0, 0, 0
2511, 1, 1636429819666, 1636429819942, 276, 0, 276, 0, 0, 0
2512, 1, 1636429820126, 1636429820397, 271, 0, 271, 0, 0, 0
2513, 1, 1636429820345, 1636429820617, 272, 1, 271, 0, 0, 0
2514, 1, 1636429820806, 1636429821078, 272, 0, 272, 0, 0, 0
2515, 1, 1636429821026, 1636429821298, 272, 0, 272, 0, 0, 0
2516, 1, 1636429821486, 1636429821758, 272, 0, 272, 0, 0, 0
2517, 1, 1636429821706, 1636429821982, 276, 0, 276, 0, 0, 0
2518, 1, 1636429822166, 1636429822438, 272, 0, 272, 0, 0, 0
2519, 1, 1636429822382, 1636429822654, 272, 0, 272, 0, 0, 0
2520, 1, 1636429822838, 1636429823109, 271, 0, 271, 0, 0, 0
2521, 1, 1636429823062, 1636429823334, 272, 0, 272, 0, 0, 0
2522, 1, 1636429823514, 1636429823782, 268, 0, 268, 0, 0, 0
2523, 1, 1636429823738, 1636429824010, 272, 0, 272, 0, 0, 0
2524, 1, 1636429824194, 1636429824466, 272, 0, 272, 0, 0, 0
2525, 1, 1636429824413, 1636429824686, 273, 0, 273, 0, 0, 0
2526, 1, 1636429824874, 1636429825146, 272, 0, 272, 0, 0, 0
2527, 1, 1636429825094, 1636429825366, 272, 0, 272, 0, 0, 0
2528, 1, 1636429825553, 1636429825825, 272, 1, 271, 1, 0, 1
2529, 1, 1636429825774, 1636429826046, 272, 0, 272, 0, 0, 0
2530, 1, 1636429826230, 1636429826502, 272, 0, 272, 0, 0, 0
2531, 1, 1636429826450, 1636429826722, 272, 0, 272, 0, 0, 0
2532, 1, 1636429826910, 1636429827182, 272, 0, 272, 0, 0, 0
2533, 1, 1636429827122, 1636429827394, 272, 0, 272, 0, 0, 0
2534, 1, 1636429827581, 1636429827853, 272, 1, 271, 1, 0, 1
2535, 1, 1636429827789, 1636429828062, 273, 1, 272, 1, 0, 1
2536, 1, 1636429828254, 1636429828525, 271, 0, 271, 0, 0, 0
2537, 1, 1636429828466, 1636429828738, 272, 0, 272, 0, 0, 0
2538, 1, 1636429828934, 1636429829205, 271, 0, 271, 0, 0, 0
2539, 1, 1636429829146, 1636429829417, 271, 0, 271, 0, 0, 0
2540, 1, 1636429829618, 1636429829890, 272, 0, 272, 0, 0, 0
2541, 1, 1636429829830, 1636429830106, 276, 0, 276, 0, 0, 0
2542, 1, 1636429830298, 1636429830566, 268, 0, 268, 0, 0, 0
2543, 1, 1636429830510, 1636429830782, 272, 0, 272, 0, 0, 0
2544, 1, 1636429830970, 1636429831237, 267, 0, 267, 0, 0, 0
2545, 1, 1636429831190, 1636429831462, 272, 0, 272, 0, 0, 0
2546, 1, 1636429831641, 1636429831914, 273, 1, 272, 0, 1, 1
2547, 1, 1636429831857, 1636429832130, 273, 1, 272, 0, 0, 0
2548, 1, 1636429832318, 1636429832590, 272, 0, 272, 0, 0, 0
2549, 1, 1636429832533, 1636429832806, 273, 1, 272, 0, 1, 1
2550, 1, 1636429832998, 1636429833269, 271, 0, 271, 0, 0, 0
2551, 1, 1636429833210, 1636429833482, 272, 0, 272, 0, 0, 0
2552, 1, 1636429833674, 1636429833945, 271, 0, 271, 0, 0, 0
2553, 1, 1636429833885, 1636429834158, 273, 1, 272, 0, 1, 1
2554, 1, 1636429834346, 1636429834618, 272, 0, 272, 0, 0, 0
2555, 1, 1636429834562, 1636429834829, 267, 0, 267, 0, 0, 0
2556, 1, 1636429835022, 1636429835294, 272, 0, 272, 0, 0, 0
2557, 1, 1636429835230, 1636429835498, 268, 0, 268, 0, 0, 0
2558, 1, 1636429835690, 1636429835961, 271, 0, 271, 0, 0, 0
2559, 1, 1636429835901, 1636429836174, 273, 1, 272, 0, 0, 0
2560, 1, 1636429836366, 1636429836637, 271, 0, 271, 0, 0, 0
2561, 1, 1636429836578, 1636429836849, 271, 0, 271, 0, 0, 0
2562, 1, 1636429837042, 1636429837314, 272, 0, 272, 0, 0, 0
2563, 1, 1636429837254, 1636429837526, 272, 0, 272, 0, 0, 0
2564, 1, 1636429837714, 1636429837986, 272, 0, 272, 0, 0, 0
2565, 1, 1636429837933, 1636429838206, 273, 1, 272, 0, 0, 0
2566, 1, 1636429838385, 1636429838658, 273, 1, 272, 0, 0, 0
2567, 1, 1636429838602, 1636429838874, 272, 0, 272, 0, 0, 0
2568, 1, 1636429839066, 1636429839338, 272, 0, 272, 0, 0, 0
2569, 1, 1636429839286, 1636429839558, 272, 0, 272, 0, 0, 0
2570, 1, 1636429839742, 1636429840013, 271, 0, 271, 0, 0, 0
2571, 1, 1636429839966, 1636429840238, 272, 0, 272, 0, 0, 0
2572, 1, 1636429840421, 1636429840694, 273, 0, 273, 0, 0, 0
2573, 1, 1636429840637, 1636429840910, 273, 0, 273, 0, 0, 0
2574, 1, 1636429841094, 1636429841365, 271, 0, 271, 0, 0, 0
2575, 1, 1636429841310, 1636429841581, 271, 0, 271, 0, 0, 0
2576, 1, 1636429841766, 1636429842038, 272, 0, 272, 0, 0, 0
2577, 1, 1636429841982, 1636429842254, 272, 0, 272, 0, 0, 0
2578, 1, 1636429842446, 1636429842718, 272, 0, 272, 0, 0, 0
2579, 1, 1636429842662, 1636429842933, 271, 0, 271, 0, 0, 0
2580, 1, 1636429843122, 1636429843393, 271, 0, 271, 0, 0, 0
2581, 1, 1636429843337, 1636429843610, 273, 1, 272, 1, 0, 1
2582, 1, 1636429843793, 1636429844065, 272, 1, 271, 0, 1, 1
2583, 1, 1636429844017, 1636429844290, 273, 1, 272, 0, 0, 0
2584, 1, 1636429844470, 1636429844741, 271, 0, 271, 0, 0, 0
2585, 1, 1636429844694, 1636429844966, 272, 0, 272, 0, 0, 0
2586, 1, 1636429845150, 1636429845422, 272, 0, 272, 0, 0, 0
2587, 1, 1636429845374, 1636429845646, 272, 0, 272, 0, 0, 0
2588, 1, 1636429845830, 1636429846102, 272, 0, 272, 0, 0, 0
2589, 1, 1636429846049, 1636429846322, 273, 1, 272, 0, 0, 0
2590, 1, 1636429846502, 1636429846774, 272, 0, 272, 0, 0, 0
2591, 1, 1636429846721, 1636429846994, 273, 1, 272, 1, 0, 1
2592, 1, 1636429847178, 1636429847449, 271, 0, 271, 0, 0, 0
2593, 1, 1636429847401, 1636429847674, 273, 1, 272, 0, 1, 1
2594, 1, 1636429847858, 1636429848129, 271, 0, 271, 0, 0, 0
2595, 1, 1636429848082, 1636429848354, 272, 0, 272, 0, 0, 0
2596, 1, 1636429848533, 1636429848805, 272, 1, 271, 1, 0, 1
2597, 1, 1636429848757, 1636429849030, 273, 1, 272, 1, 0, 1
2598, 1, 1636429849214, 1636429849486, 272, 0, 272, 0, 0, 0
2599, 1, 1636429849430, 1636429849702, 272, 0, 272, 0, 0, 0
2600, 1, 1636429849886, 1636429850162, 276, 0, 276, 0, 0, 0
2601, 1, 1636429869506, 1636429869777, 271, 0, 271, 0, 0, 0
2602, 1, 1636429870365, 1636429870634, 269, 1, 268, 0, 0, 0
2603, 1, 1636429870501, 1636429870770, 269, 1, 268, 1, 0, 1
2604, 1, 1636429871366, 1636429871637, 271, 0, 271, 0, 0, 0
2605, 1, 1636429871494, 1636429871769, 275, 0, 275, 0, 0, 0
2606, 1, 1636429871709, 1636429871982, 273, 1, 272, 1, 0, 1
2607, 1, 1636429872173, 1636429872442, 269, 1, 268, 1, 0, 1
2608, 1, 1636429872346, 1636429872618, 272, 0, 272, 0, 0, 0
2609, 1, 1636429872498, 1636429872770, 272, 0, 272, 0, 0, 0
2610, 1, 1636429872706, 1636429872977, 271, 0, 271, 0, 0, 0
2611, 1, 1636429872798, 1636429873066, 268, 0, 268, 0, 0, 0
2612, 1, 1636429873161, 1636429873429, 268, 1, 267, 1, 0, 1
2613, 1, 1636429873353, 1636429873626, 273, 1, 272, 0, 1, 1
2614, 1, 1636429873393, 1636429873669, 276, 0, 276, 0, 0, 0
2615, 1, 1636429873529, 1636429873801, 272, 1, 271, 0, 0, 0
2616, 1, 1636429873690, 1636429873969, 279, 0, 279, 0, 0, 0
2617, 1, 1636429873786, 1636429874057, 271, 0, 271, 0, 0, 0
2618, 1, 1636429873977, 1636429874250, 273, 1, 272, 0, 1, 1
2619, 1, 1636429874149, 1636429874425, 276, 1, 275, 0, 1, 1
2620, 1, 1636429874378, 1636429874649, 271, 0, 271, 0, 0, 0
2621, 1, 1636429874382, 1636429874649, 267, 0, 267, 0, 0, 0
2622, 1, 1636429874530, 1636429874801, 271, 0, 271, 0, 0, 0
2623, 1, 1636429874693, 1636429874962, 269, 0, 269, 0, 0, 0
2624, 1, 1636429874757, 1636429875034, 277, 1, 276, 1, 0, 1
2625, 1, 1636429874781, 1636429875054, 273, 1, 272, 1, 0, 1
2626, 1, 1636429874957, 1636429875234, 277, 1, 276, 0, 0, 0
2628, 1, 1636429875173, 1636429875445, 272, 1, 271, 0, 1, 1
2627, 1, 1636429875237, 1636429875510, 273, 1, 272, 0, 1, 1
2629, 1, 1636429875357, 1636429875625, 268, 1, 267, 1, 0, 1
2630, 1, 1636429875381, 1636429875653, 272, 1, 271, 0, 0, 0
2631, 1, 1636429875693, 1636429875965, 272, 1, 271, 0, 0, 0
2632, 1, 1636429875714, 1636429875985, 271, 0, 271, 0, 0, 0
2633, 1, 1636429875717, 1636429875985, 268, 1, 267, 0, 0, 0
2635, 1, 1636429875790, 1636429876061, 271, 0, 271, 0, 0, 0
2636, 1, 1636429875945, 1636429876217, 272, 0, 272, 0, 0, 0
2634, 1, 1636429876149, 1636429876421, 272, 1, 271, 1, 0, 1
2637, 1, 1636429876169, 1636429876442, 273, 1, 272, 1, 0, 1
2638, 1, 1636429876205, 1636429876478, 273, 0, 273, 0, 0, 0
2639, 1, 1636429876357, 1636429876633, 276, 1, 275, 0, 1, 1
2641, 1, 1636429876545, 1636429876817, 272, 1, 271, 0, 0, 0
2640, 1, 1636429876601, 1636429876873, 272, 1, 271, 0, 1, 1
2642, 1, 1636429876697, 1636429876961, 264, 1, 263, 1, 0, 1
2643, 1, 1636429876701, 1636429876969, 268, 1, 267, 0, 1, 1
2645, 1, 1636429876813, 1636429877086, 273, 1, 272, 1, 0, 1
2646, 1, 1636429876953, 1636429877226, 273, 1, 272, 1, 0, 1
2647, 1, 1636429877053, 1636429877322, 269, 1, 268, 0, 1, 1
2648, 1, 1636429877145, 1636429877413, 268, 1, 267, 0, 0, 0
2644, 1, 1636429877141, 1636429877413, 272, 1, 271, 0, 1, 1
2650, 1, 1636429877389, 1636429877661, 272, 1, 271, 0, 1, 1
2651, 1, 1636429877405, 1636429877681, 276, 1, 275, 0, 0, 0
2652, 1, 1636429877573, 1636429877841, 268, 1, 267, 0, 1, 1
2649, 1, 1636429877593, 1636429877869, 276, 0, 276, 0, 0, 0
2653, 1, 1636429877717, 1636429877989, 272, 1, 271, 0, 0, 0
2654, 1, 1636429877741, 1636429878013, 272, 1, 271, 1, 0, 1
2655, 1, 1636429877829, 1636429878101, 272, 1, 271, 0, 1, 1
2658, 1, 1636429877986, 1636429878258, 272, 0, 272, 0, 0, 0
2657, 1, 1636429877986, 1636429878258, 272, 0, 272, 0, 0, 0
2656, 1, 1636429878054, 1636429878321, 267, 0, 267, 0, 0, 0
2659, 1, 1636429878189, 1636429878470, 281, 1, 280, 1, 0, 1
2660, 1, 1636429878273, 1636429878545, 272, 0, 272, 0, 0, 0
2661, 1, 1636429878273, 1636429878545, 272, 0, 272, 0, 0, 0
2663, 1, 1636429878413, 1636429878681, 268, 0, 268, 0, 0, 0
2662, 1, 1636429878498, 1636429878769, 271, 0, 271, 0, 0, 0
2664, 1, 1636429878581, 1636429878853, 272, 1, 271, 1, 0, 1
2665, 1, 1636429878741, 1636429879010, 269, 1, 268, 0, 0, 0
2666, 1, 1636429878753, 1636429879021, 268, 1, 267, 1, 0, 1
2667, 1, 1636429878761, 1636429879041, 280, 1, 279, 0, 0, 0
2668, 1, 1636429878781, 1636429879061, 280, 0, 280, 0, 0, 0
2670, 1, 1636429878965, 1636429879237, 272, 1, 271, 1, 0, 1
2671, 1, 1636429878981, 1636429879258, 277, 0, 277, 0, 0, 0
2673, 1, 1636429879201, 1636429879461, 260, 0, 260, 0, 0, 0
2674, 1, 1636429879205, 1636429879469, 264, 0, 264, 0, 0, 0
2672, 1, 1636429879226, 1636429879498, 272, 0, 272, 0, 0, 0
2669, 1, 1636429879237, 1636429879509, 272, 0, 272, 0, 0, 0
2677, 1, 1636429879409, 1636429879681, 272, 1, 271, 1, 0, 1
2678, 1, 1636429879545, 1636429879817, 272, 1, 271, 1, 0, 1
2676, 1, 1636429879694, 1636429879966, 272, 0, 272, 0, 0, 0
2679, 1, 1636429879717, 1636429879997, 280, 0, 280, 0, 0, 0
2681, 1, 1636429879761, 1636429880033, 272, 1, 271, 1, 0, 1
2682, 1, 1636429879769, 1636429880037, 268, 0, 268, 0, 0, 0
2684, 1, 1636429879902, 1636429880173, 271, 0, 271, 0, 0, 0
2685, 1, 1636429879965, 1636429880237, 272, 1, 271, 0, 0, 0
2688, 1, 1636429880169, 1636429880445, 276, 0, 276, 0, 0, 0
2689, 1, 1636429880173, 1636429880445, 272, 1, 271, 0, 1, 1
2687, 1, 1636429880213, 1636429880490, 277, 0, 277, 0, 0, 0
2692, 1, 1636429880386, 1636429880661, 275, 0, 275, 0, 0, 0
2691, 1, 1636429880386, 1636429880665, 279, 1, 278, 0, 0, 0
2693, 1, 1636429880537, 1636429880810, 273, 1, 272, 0, 0, 0
2694, 1, 1636429880706, 1636429880982, 276, 0, 276, 0, 0, 0
2696, 1, 1636429880769, 1636429881041, 272, 1, 271, 0, 0, 0
2697, 1, 1636429880861, 1636429881133, 272, 1, 271, 0, 0, 0
2699, 1, 1636429880993, 1636429881269, 276, 1, 275, 0, 0, 0
2701, 1, 1636429881161, 1636429881433, 272, 1, 271, 0, 0, 0
2702, 1, 1636429881209, 1636429881478, 269, 0, 269, 0, 0, 0
2703, 1, 1636429881354, 1636429881621, 267, 0, 267, 0, 0, 0
2704, 1, 1636429881401, 1636429881674, 273, 1, 272, 0, 0, 0
2705, 1, 1636429881526, 1636429881801, 275, 0, 275, 0, 0, 0
2707, 1, 1636429881701, 1636429881973, 272, 1, 271, 0, 0, 0
2709, 1, 1636429881857, 1636429882130, 273, 1, 272, 0, 0, 0
2708, 1, 1636429881981, 1636429882258, 277, 1, 276, 0, 1, 1
2710, 1, 1636429881986, 1636429882258, 272, 0, 272, 0, 0, 0
2712, 1, 1636429882121, 1636429882393, 272, 1, 271, 0, 1, 1
2713, 1, 1636429882230, 1636429882506, 276, 0, 276, 0, 0, 0
2715, 1, 1636429882434, 1636429882706, 272, 0, 272, 0, 0, 0
2714, 1, 1636429882441, 1636429882717, 276, 1, 275, 0, 1, 1
2716, 1, 1636429882533, 1636429882810, 277, 1, 276, 0, 0, 0
2718, 1, 1636429882721, 1636429882994, 273, 1, 272, 0, 0, 0
2719, 1, 1636429882729, 1636429883005, 276, 0, 276, 0, 0, 0
2720, 1, 1636429882821, 1636429883094, 273, 1, 272, 1, 0, 1
2722, 1, 1636429883129, 1636429883401, 272, 1, 271, 0, 0, 0
2723, 1, 1636429883210, 1636429883478, 268, 0, 268, 0, 0, 0
2724, 1, 1636429883313, 1636429883585, 272, 1, 271, 0, 1, 1
2725, 1, 1636429883397, 1636429883674, 277, 1, 276, 1, 0, 1
2726, 1, 1636429883505, 1636429883773, 268, 1, 267, 0, 0, 0
2727, 1, 1636429883705, 1636429883977, 272, 1, 271, 1, 0, 1
2729, 1, 1636429883853, 1636429884125, 272, 1, 271, 1, 0, 1
2728, 1, 1636429883853, 1636429884125, 272, 1, 271, 0, 1, 1
2730, 1, 1636429884125, 1636429884398, 273, 1, 272, 0, 1, 1
2732, 1, 1636429884290, 1636429884558, 268, 0, 268, 0, 0, 0
2733, 1, 1636429884377, 1636429884650, 273, 1, 272, 0, 0, 0
2734, 1, 1636429884513, 1636429884778, 265, 1, 264, 1, 0, 1
2736, 1, 1636429884741, 1636429885014, 273, 0, 273, 0, 0, 0
2737, 1, 1636429884894, 1636429885165, 271, 0, 271, 0, 0, 0
2738, 1, 1636429885161, 1636429885430, 269, 1, 268, 1, 0, 1
2739, 1, 1636429885297, 1636429885573, 276, 0, 276, 0, 0, 0
2740, 1, 1636429885341, 1636429885606, 265, 1, 264, 0, 0, 0
2741, 1, 1636429885501, 1636429885778, 277, 1, 276, 0, 0, 0
2742, 1, 1636429885721, 1636429885990, 269, 1, 268, 1, 0, 1
2743, 1, 1636429885893, 1636429886165, 272, 1, 271, 1, 0, 1
2744, 1, 1636429886193, 1636429886466, 273, 1, 272, 0, 0, 0
2745, 1, 1636429886290, 1636429886557, 267, 0, 267, 0, 0, 0
2746, 1, 1636429886337, 1636429886609, 272, 1, 271, 0, 0, 0
2747, 1, 1636429886466, 1636429886734, 268, 0, 268, 0, 0, 0
2748, 1, 1636429886733, 1636429887006, 273, 1, 272, 0, 0, 0
2749, 1, 1636429886930, 1636429887205, 275, 0, 275, 0, 0, 0
2750, 1, 1636429887158, 1636429887426, 268, 0, 268, 0, 0, 0
2751, 1, 1636429887286, 1636429887557, 271, 0, 271, 0, 0, 0
2752, 1, 1636429887309, 1636429887586, 277, 1, 276, 0, 0, 0
2753, 1, 1636429887469, 1636429887734, 265, 0, 265, 0, 0, 0
2754, 1, 1636429887733, 1636429888006, 273, 1, 272, 0, 0, 0
2755, 1, 1636429887914, 1636429888186, 272, 0, 272, 0, 0, 0
2756, 1, 1636429888162, 1636429888434, 272, 0, 272, 0, 0, 0
2757, 1, 1636429888317, 1636429888589, 272, 0, 272, 0, 0, 0
2758, 1, 1636429888330, 1636429888597, 267, 0, 267, 0, 0, 0
2759, 1, 1636429888497, 1636429888770, 273, 1, 272, 0, 0, 0
2760, 1, 1636429888729, 1636429889001, 272, 1, 271, 0, 0, 0
2761, 1, 1636429888914, 1636429889189, 275, 0, 275, 0, 0, 0
2762, 1, 1636429889185, 1636429889462, 277, 1, 276, 0, 0, 0
2763, 1, 1636429889373, 1636429889641, 268, 1, 267, 0, 0, 0
2764, 1, 1636429889373, 1636429889641, 268, 1, 267, 0, 1, 1
2765, 1, 1636429889466, 1636429889733, 267, 0, 267, 0, 0, 0
2766, 1, 1636429889729, 1636429890042, 313, 0, 313, 0, 0, 0
2767, 1, 1636429889953, 1636429890226, 273, 1, 272, 0, 0, 0
2768, 1, 1636429890193, 1636429890469, 276, 1, 275, 0, 0, 0
2770, 1, 1636429890337, 1636429890617, 280, 0, 280, 0, 0, 0
2769, 1, 1636429890337, 1636429890617, 280, 0, 280, 0, 0, 0
2773, 1, 1636429890473, 1636429890745, 272, 0, 272, 0, 0, 0
2772, 1, 1636429890473, 1636429890746, 273, 0, 273, 0, 0, 0
2775, 1, 1636429890473, 1636429890745, 272, 0, 272, 0, 0, 0
2777, 1, 1636429890725, 1636429891001, 276, 1, 275, 0, 0, 0
2778, 1, 1636429890993, 1636429891265, 272, 1, 271, 0, 0, 0
2779, 1, 1636429891069, 1636429891345, 276, 1, 275, 0, 1, 1
2781, 1, 1636429891233, 1636429891501, 268, 0, 268, 0, 0, 0
2782, 1, 1636429891278, 1636429891589, 311, 0, 311, 0, 0, 0
2784, 1, 1636429891341, 1636429891614, 273, 1, 272, 0, 0, 0
2783, 1, 1636429891338, 1636429891614, 276, 0, 276, 0, 0, 0
2786, 1, 1636429891389, 1636429891682, 293, 0, 293, 0, 0, 0
2787, 1, 1636429891501, 1636429891773, 272, 1, 271, 0, 0, 0
2785, 1, 1636429891525, 1636429891798, 273, 1, 272, 0, 1, 1
2788, 1, 1636429891717, 1636429891994, 277, 0, 277, 0, 0, 0
2791, 1, 1636429892021, 1636429892289, 268, 1, 267, 0, 1, 1
2790, 1, 1636429892017, 1636429892289, 272, 0, 272, 0, 0, 0
2792, 1, 1636429892198, 1636429892470, 272, 0, 272, 0, 0, 0
2793, 1, 1636429892257, 1636429892534, 277, 0, 277, 0, 0, 0
2797, 1, 1636429892341, 1636429892614, 273, 1, 272, 0, 0, 0
2796, 1, 1636429892341, 1636429892614, 273, 1, 272, 1, 0, 1
2799, 1, 1636429892449, 1636429892721, 272, 1, 271, 0, 0, 0
2795, 1, 1636429892501, 1636429892773, 272, 1, 271, 0, 1, 1
2800, 1, 1636429892685, 1636429892961, 276, 1, 275, 1, 0, 1
2802, 1, 1636429892965, 1636429893237, 272, 1, 271, 0, 1, 1
2803, 1, 1636429892978, 1636429893249, 271, 0, 271, 0, 0, 0
2804, 1, 1636429893162, 1636429893437, 275, 0, 275, 0, 0, 0
2805, 1, 1636429893261, 1636429893534, 273, 0, 273, 0, 0, 0
2807, 1, 1636429893309, 1636429893577, 268, 0, 268, 0, 0, 0
2806, 1, 1636429893317, 1636429893585, 268, 0, 268, 0, 0, 0
2808, 1, 1636429893313, 1636429893585, 272, 0, 272, 0, 0, 0
2809, 1, 1636429893433, 1636429893709, 276, 1, 275, 0, 1, 1
2810, 1, 1636429893465, 1636429893737, 272, 0, 272, 0, 0, 0
2811, 1, 1636429893650, 1636429893917, 267, 0, 267, 0, 0, 0
2812, 1, 1636429893917, 1636429894189, 272, 1, 271, 1, 0, 1
2813, 1, 1636429893938, 1636429894209, 271, 0, 271, 0, 0, 0
2814, 1, 1636429894173, 1636429894441, 268, 0, 268, 0, 0, 0
2735, 1, 1636429894217, 1636429894481, 264, 0, 264, 0, 0, 0
2815, 1, 1636429894261, 1636429894529, 268, 1, 267, 0, 0, 0
2816, 1, 1636429894305, 1636429894573, 268, 0, 268, 0, 0, 0
2817, 1, 1636429894301, 1636429894577, 276, 1, 275, 0, 0, 0
2819, 1, 1636429894345, 1636429894613, 268, 1, 267, 0, 0, 0
2818, 1, 1636429894385, 1636429894658, 273, 1, 272, 1, 0, 1
2820, 1, 1636429894517, 1636429894794, 277, 1, 276, 1, 0, 1
2822, 1, 1636429894613, 1636429894886, 273, 1, 272, 1, 0, 1
2821, 1, 1636429894753, 1636429895029, 276, 0, 276, 0, 0, 0
2823, 1, 1636429894978, 1636429895250, 272, 0, 272, 0, 0, 0
2825, 1, 1636429894978, 1636429895250, 272, 1, 271, 0, 0, 0
2824, 1, 1636429895069, 1636429895341, 272, 0, 272, 0, 0, 0
2826, 1, 1636429895114, 1636429895381, 267, 0, 267, 0, 0, 0
2827, 1, 1636429895209, 1636429895477, 268, 0, 268, 0, 0, 0
2828, 1, 1636429895257, 1636429895529, 272, 0, 272, 0, 0, 0
2829, 1, 1636429895293, 1636429895557, 264, 0, 264, 0, 0, 0
2831, 1, 1636429895337, 1636429895601, 264, 1, 263, 0, 1, 1
2830, 1, 1636429895425, 1636429895689, 264, 1, 263, 0, 1, 1
2832, 1, 1636429895425, 1636429895689, 264, 1, 263, 1, 0, 1
2833, 1, 1636429895465, 1636429895733, 268, 1, 267, 0, 0, 0
2834, 1, 1636429895645, 1636429895921, 276, 1, 275, 1, 0, 1
2835, 1, 1636429895870, 1636429896142, 272, 0, 272, 0, 0, 0
2836, 1, 1636429895906, 1636429896173, 267, 0, 267, 0, 0, 0
2837, 1, 1636429895982, 1636429896257, 275, 0, 275, 0, 0, 0
2838, 1, 1636429896137, 1636429896410, 273, 1, 272, 1, 0, 1
2839, 1, 1636429896169, 1636429896437, 268, 1, 267, 0, 0, 0
2840, 1, 1636429896237, 1636429896513, 276, 0, 276, 0, 0, 0
2841, 1, 1636429896293, 1636429896566, 273, 1, 272, 0, 1, 1
2843, 1, 1636429896345, 1636429896617, 272, 1, 271, 1, 0, 1
2844, 1, 1636429896409, 1636429896674, 265, 1, 264, 0, 0, 0
2842, 1, 1636429896437, 1636429896709, 272, 1, 271, 1, 0, 1
2845, 1, 1636429896445, 1636429896717, 272, 0, 272, 0, 0, 0
2846, 1, 1636429896662, 1636429896933, 271, 0, 271, 0, 0, 0
2847, 1, 1636429896849, 1636429897129, 280, 1, 279, 1, 0, 1
2848, 1, 1636429896930, 1636429897201, 271, 0, 271, 0, 0, 0
2849, 1, 1636429896989, 1636429897265, 276, 1, 275, 1, 0, 1
2850, 1, 1636429897146, 1636429897417, 271, 0, 271, 0, 0, 0
2851, 1, 1636429897209, 1636429897482, 273, 1, 272, 0, 0, 0
2852, 1, 1636429897253, 1636429897525, 272, 1, 271, 0, 0, 0
2855, 1, 1636429897377, 1636429897641, 264, 1, 263, 0, 0, 0
2856, 1, 1636429897409, 1636429897681, 272, 1, 271, 0, 0, 0
2854, 1, 1636429897437, 1636429897705, 268, 0, 268, 0, 0, 0
2857, 1, 1636429897461, 1636429897729, 268, 0, 268, 0, 0, 0
2858, 1, 1636429897626, 1636429897897, 271, 0, 271, 0, 0, 0
2853, 1, 1636429897661, 1636429897938, 277, 1, 276, 0, 0, 0
2859, 1, 1636429897865, 1636429898137, 272, 1, 271, 1, 0, 1
2860, 1, 1636429897925, 1636429898194, 269, 1, 268, 0, 0, 0
2861, 1, 1636429898021, 1636429898293, 272, 1, 271, 0, 1, 1
2863, 1, 1636429898205, 1636429898477, 272, 1, 271, 0, 1, 1
2864, 1, 1636429898270, 1636429898541, 271, 0, 271, 0, 0, 0
2865, 1, 1636429898333, 1636429898601, 268, 0, 268, 0, 0, 0
2862, 1, 1636429898374, 1636429898641, 267, 0, 267, 0, 0, 0
2868, 1, 1636429898421, 1636429898685, 264, 1, 263, 0, 0, 0
2869, 1, 1636429898469, 1636429898737, 268, 1, 267, 0, 0, 0
2866, 1, 1636429898473, 1636429898741, 268, 0, 268, 0, 0, 0
2867, 1, 1636429898717, 1636429898990, 273, 0, 273, 0, 0, 0
2872, 1, 1636429898902, 1636429899177, 275, 0, 275, 0, 0, 0
2874, 1, 1636429899129, 1636429899405, 276, 1, 275, 0, 1, 1
2873, 1, 1636429899169, 1636429899446, 277, 1, 276, 0, 1, 1
2875, 1, 1636429899245, 1636429899513, 268, 1, 267, 0, 0, 0
2876, 1, 1636429899273, 1636429899537, 264, 1, 263, 0, 1, 1
2877, 1, 1636429899301, 1636429899574, 273, 0, 273, 0, 0, 0
2879, 1, 1636429899401, 1636429899665, 264, 0, 264, 0, 0, 0
2880, 1, 1636429899445, 1636429899714, 269, 1, 268, 0, 0, 0
2881, 1, 1636429899445, 1636429899717, 272, 1, 271, 0, 0, 0
2878, 1, 1636429899621, 1636429899897, 276, 1, 275, 1, 0, 1
2882, 1, 1636429899886, 1636429900158, 272, 0, 272, 0, 0, 0
2883, 1, 1636429899985, 1636429900253, 268, 1, 267, 0, 1, 1
2884, 1, 1636429900117, 1636429900390, 273, 0, 273, 0, 0, 0
2886, 1, 1636429900273, 1636429900553, 280, 1, 279, 1, 0, 1
2887, 1, 1636429900273, 1636429900557, 284, 1, 283, 0, 0, 0
2889, 1, 1636429900465, 1636429900733, 268, 1, 267, 1, 0, 1
2888, 1, 1636429900469, 1636429900734, 265, 0, 265, 0, 0, 0
2890, 1, 1636429900465, 1636429900734, 269, 1, 268, 1, 0, 1
2891, 1, 1636429900550, 1636429900822, 272, 0, 272, 0, 0, 0
2894, 1, 1636429900877, 1636429901149, 272, 1, 271, 0, 0, 0
2896, 1, 1636429901013, 1636429901321, 308, 1, 307, 0, 0, 0
2897, 1, 1636429901130, 1636429901413, 283, 0, 283, 0, 0, 0
2898, 1, 1636429901237, 1636429901514, 277, 1, 276, 0, 0, 0
2899, 1, 1636429901241, 1636429901517, 276, 0, 276, 0, 0, 0
2901, 1, 1636429901405, 1636429901673, 268, 1, 267, 0, 1, 1
2902, 1, 1636429901413, 1636429901681, 268, 1, 267, 0, 0, 0
2900, 1, 1636429901497, 1636429901765, 268, 1, 267, 0, 0, 0
2903, 1, 1636429901505, 1636429901769, 264, 1, 263, 0, 1, 1
2905, 1, 1636429901890, 1636429902161, 271, 0, 271, 0, 0, 0
2906, 1, 1636429902033, 1636429902305, 272, 1, 271, 0, 1, 1
2908, 1, 1636429902113, 1636429902458, 345, 1, 344, 1, 0, 1
2909, 1, 1636429902245, 1636429902549, 304, 0, 304, 0, 0, 0
2910, 1, 1636429902245, 1636429902550, 305, 0, 305, 0, 0, 0
2801, 1, 1636429902410, 1636429902682, 272, 0, 272, 0, 0, 0
2912, 1, 1636429902461, 1636429902729, 268, 1, 267, 0, 1, 1
2911, 1, 1636429902485, 1636429902758, 273, 1, 272, 0, 1, 1
2913, 1, 1636429902497, 1636429902769, 272, 1, 271, 0, 1, 1
2916, 1, 1636429902685, 1636429902957, 272, 1, 271, 1, 0, 1
2917, 1, 1636429902877, 1636429903150, 273, 1, 272, 1, 0, 1
2914, 1, 1636429902902, 1636429903173, 271, 0, 271, 0, 0, 0
2920, 1, 1636429903106, 1636429903377, 271, 0, 271, 0, 0, 0
2921, 1, 1636429903217, 1636429903489, 272, 1, 271, 0, 1, 1
2922, 1, 1636429903265, 1636429903537, 272, 1, 271, 0, 1, 1
2919, 1, 1636429903349, 1636429903621, 272, 0, 272, 0, 0, 0
2924, 1, 1636429903401, 1636429903673, 272, 1, 271, 0, 0, 0
2925, 1, 1636429903437, 1636429903709, 272, 1, 271, 0, 0, 0
2926, 1, 1636429903565, 1636429903837, 272, 1, 271, 1, 0, 1
2927, 1, 1636429903713, 1636429903981, 268, 1, 267, 0, 0, 0
2923, 1, 1636429903801, 1636429904074, 273, 1, 272, 0, 0, 0
2928, 1, 1636429903861, 1636429904138, 277, 1, 276, 0, 1, 1
2929, 1, 1636429904050, 1636429904321, 271, 0, 271, 0, 0, 0
2930, 1, 1636429904109, 1636429904385, 276, 1, 275, 0, 1, 1
2931, 1, 1636429904198, 1636429904469, 271, 0, 271, 0, 0, 0
2932, 1, 1636429904266, 1636429904538, 272, 0, 272, 0, 0, 0
2933, 1, 1636429904381, 1636429904654, 273, 1, 272, 0, 0, 0
2934, 1, 1636429904469, 1636429904745, 276, 1, 275, 0, 0, 0
2935, 1, 1636429904477, 1636429904754, 277, 0, 277, 0, 0, 0
2936, 1, 1636429904546, 1636429904818, 272, 0, 272, 0, 0, 0
2937, 1, 1636429904565, 1636429904838, 273, 1, 272, 1, 0, 1
2938, 1, 1636429904870, 1636429905141, 271, 0, 271, 0, 0, 0
2939, 1, 1636429905026, 1636429905302, 276, 0, 276, 0, 0, 0
2940, 1, 1636429905093, 1636429905369, 276, 1, 275, 0, 0, 0
2941, 1, 1636429905193, 1636429905461, 268, 1, 267, 0, 1, 1
2942, 1, 1636429905277, 1636429905546, 269, 1, 268, 0, 0, 0
2943, 1, 1636429905373, 1636429905633, 260, 0, 260, 0, 0, 0
2944, 1, 1636429905445, 1636429905714, 269, 0, 269, 0, 0, 0
2945, 1, 1636429905489, 1636429905761, 272, 1, 271, 1, 0, 1
2946, 1, 1636429905546, 1636429905809, 263, 0, 263, 0, 0, 0
2948, 1, 1636429905849, 1636429906122, 273, 1, 272, 1, 0, 1
2949, 1, 1636429906022, 1636429906293, 271, 0, 271, 0, 0, 0
2950, 1, 1636429906081, 1636429906349, 268, 1, 267, 0, 0, 0
2951, 1, 1636429906205, 1636429906478, 273, 1, 272, 0, 0, 0
2952, 1, 1636429906261, 1636429906537, 276, 1, 275, 0, 0, 0
2953, 1, 1636429906361, 1636429906625, 264, 0, 264, 0, 0, 0
2954, 1, 1636429906441, 1636429906713, 272, 1, 271, 1, 0, 1
2955, 1, 1636429906517, 1636429906785, 268, 0, 268, 0, 0, 0
2956, 1, 1636429906561, 1636429906833, 272, 1, 271, 0, 0, 0
2957, 1, 1636429906830, 1636429907101, 271, 0, 271, 0, 0, 0
2958, 1, 1636429907001, 1636429907273, 272, 1, 271, 0, 0, 0
2959, 1, 1636429907081, 1636429907353, 272, 1, 271, 0, 0, 0
2961, 1, 1636429907237, 1636429907498, 261, 0, 261, 0, 0, 0
2960, 1, 1636429907230, 1636429907498, 268, 0, 268, 0, 0, 0
2962, 1, 1636429907397, 1636429907666, 269, 1, 268, 0, 0, 0
2963, 1, 1636429907401, 1636429907669, 268, 0, 268, 0, 0, 0
2964, 1, 1636429907501, 1636429907765, 264, 0, 264, 0, 0, 0
2965, 1, 1636429907574, 1636429907845, 271, 0, 271, 0, 0, 0
2966, 1, 1636429907834, 1636429908110, 276, 0, 276, 0, 0, 0
2967, 1, 1636429908026, 1636429908294, 268, 0, 268, 0, 0, 0
2968, 1, 1636429908094, 1636429908361, 267, 0, 267, 0, 0, 0
2969, 1, 1636429908205, 1636429908477, 272, 0, 272, 0, 0, 0
2970, 1, 1636429908249, 1636429908517, 268, 1, 267, 0, 0, 0
2971, 1, 1636429908393, 1636429908665, 272, 1, 271, 1, 0, 1
2972, 1, 1636429908429, 1636429908749, 320, 1, 319, 0, 0, 0
2973, 1, 1636429908477, 1636429908749, 272, 0, 272, 0, 0, 0
2974, 1, 1636429908653, 1636429908925, 272, 1, 271, 0, 0, 0
2885, 1, 1636429908789, 1636429909061, 272, 1, 271, 1, 0, 1
2975, 1, 1636429908837, 1636429909114, 277, 1, 276, 0, 0, 0
2976, 1, 1636429909014, 1636429909290, 276, 0, 276, 0, 0, 0
2977, 1, 1636429909113, 1636429909381, 268, 1, 267, 0, 0, 0
2978, 1, 1636429909165, 1636429909437, 272, 1, 271, 0, 1, 1
2979, 1, 1636429909177, 1636429909449, 272, 1, 271, 1, 0, 1
2980, 1, 1636429909205, 1636429909473, 268, 1, 267, 1, 0, 1
2985, 1, 1636429909457, 1636429909721, 264, 1, 263, 1, 0, 1
2984, 1, 1636429909461, 1636429909733, 272, 1, 271, 1, 0, 1
2982, 1, 1636429909469, 1636429909737, 268, 0, 268, 0, 0, 0
2981, 1, 1636429909557, 1636429909822, 265, 0, 265, 0, 0, 0
2986, 1, 1636429909629, 1636429909902, 273, 1, 272, 0, 1, 1
2983, 1, 1636429909629, 1636429909902, 273, 1, 272, 0, 1, 1
2987, 1, 1636429910002, 1636429910273, 271, 0, 271, 0, 0, 0
2988, 1, 1636429910009, 1636429910281, 272, 1, 271, 1, 0, 1
2989, 1, 1636429910085, 1636429910358, 273, 0, 273, 0, 0, 0
2990, 1, 1636429910101, 1636429910373, 272, 0, 272, 0, 0, 0
2991, 1, 1636429910129, 1636429910402, 273, 1, 272, 0, 0, 0
2992, 1, 1636429910229, 1636429910505, 276, 1, 275, 1, 0, 1
2993, 1, 1636429910273, 1636429910545, 272, 1, 271, 0, 0, 0
2994, 1, 1636429910358, 1636429910629, 271, 0, 271, 0, 0, 0
2996, 1, 1636429910433, 1636429910705, 272, 1, 271, 0, 0, 0
2997, 1, 1636429910453, 1636429910721, 268, 1, 267, 1, 0, 1
2995, 1, 1636429910541, 1636429910865, 324, 1, 323, 1, 0, 1
2998, 1, 1636429910629, 1636429910957, 328, 1, 327, 1, 0, 1
2999, 1, 1636429910949, 1636429911225, 276, 0, 276, 0, 0, 0
3000, 1, 1636429910981, 1636429911253, 272, 1, 271, 0, 0, 0
3003, 1, 1636429911081, 1636429911353, 272, 1, 271, 0, 1, 1
3001, 1, 1636429911081, 1636429911353, 272, 1, 271, 0, 1, 1
3004, 1, 1636429911125, 1636429911401, 276, 1, 275, 1, 0, 1
3005, 1, 1636429911161, 1636429911429, 268, 1, 267, 0, 0, 0
3006, 1, 1636429911217, 1636429911485, 268, 0, 268, 0, 0, 0
3008, 1, 1636429911305, 1636429911577, 272, 0, 272, 0, 0, 0
3009, 1, 1636429911345, 1636429911641, 296, 1, 295, 0, 0, 0
3011, 1, 1636429911429, 1636429911733, 304, 1, 303, 0, 0, 0
3012, 1, 1636429911473, 1636429911749, 276, 1, 275, 0, 0, 0
3007, 1, 1636429911553, 1636429911821, 268, 1, 267, 0, 0, 0
3010, 1, 1636429911553, 1636429911821, 268, 1, 267, 0, 0, 0
3013, 1, 1636429911641, 1636429911913, 272, 1, 271, 0, 0, 0
3015, 1, 1636429911873, 1636429912142, 269, 0, 269, 0, 0, 0
3016, 1, 1636429911978, 1636429912289, 311, 0, 311, 0, 0, 0
3014, 1, 1636429912001, 1636429912293, 292, 1, 291, 1, 0, 1
3018, 1, 1636429912041, 1636429912313, 272, 1, 271, 0, 0, 0
3019, 1, 1636429912109, 1636429912381, 272, 1, 271, 0, 0, 0
3020, 1, 1636429912197, 1636429912469, 272, 1, 271, 0, 0, 0
3022, 1, 1636429912241, 1636429912514, 273, 1, 272, 1, 0, 1
3023, 1, 1636429912329, 1636429912606, 277, 1, 276, 1, 0, 1
3024, 1, 1636429912365, 1636429912629, 264, 0, 264, 0, 0, 0
3027, 1, 1636429912445, 1636429912717, 272, 0, 272, 0, 0, 0
3025, 1, 1636429912490, 1636429912762, 272, 0, 272, 0, 0, 0
3029, 1, 1636429912653, 1636429912921, 268, 0, 268, 0, 0, 0
3028, 1, 1636429912689, 1636429912958, 269, 1, 268, 1, 0, 1
3031, 1, 1636429912877, 1636429913154, 277, 1, 276, 0, 0, 0
3033, 1, 1636429913041, 1636429913313, 272, 1, 271, 0, 0, 0
3034, 1, 1636429913041, 1636429913313, 272, 1, 271, 0, 0, 0
2947, 1, 1636429913081, 1636429913357, 276, 0, 276, 0, 0, 0
3035, 1, 1636429913125, 1636429913393, 268, 1, 267, 0, 1, 1
3036, 1, 1636429913221, 1636429913501, 280, 1, 279, 1, 0, 1
3037, 1, 1636429913221, 1636429913501, 280, 1, 279, 0, 1, 1
3038, 1, 1636429913341, 1636429913617, 276, 1, 275, 0, 0, 0
3039, 1, 1636429913341, 1636429913617, 276, 0, 276, 0, 0, 0
3042, 1, 1636429913429, 1636429913701, 272, 1, 271, 0, 1, 1
3043, 1, 1636429913474, 1636429913742, 268, 0, 268, 0, 0, 0
3041, 1, 1636429913493, 1636429913761, 268, 0, 268, 0, 0, 0
3044, 1, 1636429913641, 1636429913914, 273, 1, 272, 0, 0, 0
3045, 1, 1636429913753, 1636429914026, 273, 1, 272, 0, 1, 1
3046, 1, 1636429913877, 1636429914145, 268, 1, 267, 1, 0, 1
3047, 1, 1636429913993, 1636429914261, 268, 0, 268, 0, 0, 0
3048, 1, 1636429914037, 1636429914309, 272, 1, 271, 0, 0, 0
3049, 1, 1636429914121, 1636429914385, 264, 1, 263, 1, 0, 1
3051, 1, 1636429914206, 1636429914477, 271, 0, 271, 0, 0, 0
3052, 1, 1636429914313, 1636429914581, 268, 0, 268, 0, 0, 0
3053, 1, 1636429914329, 1636429914601, 272, 1, 271, 0, 1, 1
3055, 1, 1636429914429, 1636429914697, 268, 1, 267, 0, 0, 0
3056, 1, 1636429914441, 1636429914713, 272, 1, 271, 0, 1, 1
3054, 1, 1636429914485, 1636429914757, 272, 1, 271, 0, 0, 0
3057, 1, 1636429914621, 1636429914889, 268, 0, 268, 0, 0, 0
3058, 1, 1636429914753, 1636429915033, 280, 1, 279, 0, 0, 0
3059, 1, 1636429914913, 1636429915185, 272, 1, 271, 1, 0, 1
3060, 1, 1636429914977, 1636429915249, 272, 0, 272, 0, 0, 0
3061, 1, 1636429915017, 1636429915289, 272, 1, 271, 1, 0, 1
3062, 1, 1636429915109, 1636429915385, 276, 0, 276, 0, 0, 0
3063, 1, 1636429915241, 1636429915513, 272, 1, 271, 0, 0, 0
3064, 1, 1636429915314, 1636429915585, 271, 0, 271, 0, 0, 0
3065, 1, 1636429915314, 1636429915586, 272, 0, 272, 0, 0, 0
3068, 1, 1636429915457, 1636429915733, 276, 1, 275, 0, 1, 1
3066, 1, 1636429915465, 1636429915733, 268, 1, 267, 0, 1, 1
3069, 1, 1636429915589, 1636429915866, 277, 1, 276, 0, 1, 1
3070, 1, 1636429915745, 1636429916018, 273, 1, 272, 0, 1, 1
3071, 1, 1636429915941, 1636429916209, 268, 1, 267, 0, 1, 1
3072, 1, 1636429915977, 1636429916249, 272, 0, 272, 0, 0, 0
3073, 1, 1636429916021, 1636429916294, 273, 1, 272, 1, 0, 1
3074, 1, 1636429916105, 1636429916378, 273, 0, 273, 0, 0, 0
3075, 1, 1636429916217, 1636429916481, 264, 1, 263, 0, 0, 0
3077, 1, 1636429916301, 1636429916569, 268, 1, 267, 1, 0, 1
3076, 1, 1636429916301, 1636429916569, 268, 1, 267, 1, 0, 1
3079, 1, 1636429916474, 1636429916745, 271, 0, 271, 0, 0, 0
3078, 1, 1636429916474, 1636429916746, 272, 0, 272, 0, 0, 0
3080, 1, 1636429916601, 1636429916874, 273, 0, 273, 0, 0, 0
3081, 1, 1636429916766, 1636429917037, 271, 0, 271, 0, 0, 0
3082, 1, 1636429916921, 1636429917193, 272, 0, 272, 0, 0, 0
3083, 1, 1636429916966, 1636429917237, 271, 0, 271, 0, 0, 0
3084, 1, 1636429917037, 1636429917313, 276, 0, 276, 0, 0, 0
3086, 1, 1636429917202, 1636429917474, 272, 0, 272, 0, 0, 0
3087, 1, 1636429917273, 1636429917537, 264, 0, 264, 0, 0, 0
3088, 1, 1636429917305, 1636429917582, 277, 1, 276, 0, 1, 1
3090, 1, 1636429917461, 1636429917738, 277, 1, 276, 1, 0, 1
3089, 1, 1636429917501, 1636429917774, 273, 1, 272, 0, 0, 0
3091, 1, 1636429917574, 1636429917845, 271, 0, 271, 0, 0, 0
3092, 1, 1636429917765, 1636429918033, 268, 1, 267, 0, 0, 0
3093, 1, 1636429917897, 1636429918169, 272, 1, 271, 1, 0, 1
3094, 1, 1636429917945, 1636429918221, 276, 1, 275, 0, 0, 0
3095, 1, 1636429918062, 1636429918333, 271, 0, 271, 0, 0, 0
3096, 1, 1636429918185, 1636429918461, 276, 1, 275, 1, 0, 1
3097, 1, 1636429918273, 1636429918546, 273, 1, 272, 0, 1, 1
3098, 1, 1636429918277, 1636429918546, 269, 1, 268, 0, 1, 1
3100, 1, 1636429918450, 1636429918721, 271, 0, 271, 0, 0, 0
3099, 1, 1636429918514, 1636429918786, 272, 0, 272, 0, 0, 0
3101, 1, 1636429918585, 1636429918862, 277, 1, 276, 0, 1, 1
3102, 1, 1636429918761, 1636429919038, 277, 1, 276, 0, 0, 0
3103, 1, 1636429918878, 1636429919149, 271, 0, 271, 0, 0, 0
3104, 1, 1636429918953, 1636429919226, 273, 1, 272, 0, 0, 0
3105, 1, 1636429919061, 1636429919333, 272, 1, 271, 1, 0, 1
3106, 1, 1636429919189, 1636429919458, 269, 1, 268, 0, 1, 1
3108, 1, 1636429919285, 1636429919558, 273, 1, 272, 1, 0, 1
3107, 1, 1636429919285, 1636429919558, 273, 1, 272, 0, 0, 0
3110, 1, 1636429919457, 1636429919733, 276, 1, 275, 0, 0, 0
3109, 1, 1636429919513, 1636429919781, 268, 1, 267, 0, 0, 0
3111, 1, 1636429919589, 1636429919865, 276, 1, 275, 0, 0, 0
3112, 1, 1636429919757, 1636429920029, 272, 1, 271, 0, 1, 1
3113, 1, 1636429919881, 1636429920141, 260, 0, 260, 0, 0, 0
3114, 1, 1636429919969, 1636429920237, 268, 0, 268, 0, 0, 0
3115, 1, 1636429920081, 1636429920353, 272, 0, 272, 0, 0, 0
3116, 1, 1636429920161, 1636429920430, 269, 1, 268, 0, 1, 1
3117, 1, 1636429920301, 1636429920574, 273, 0, 273, 0, 0, 0
3120, 1, 1636429920433, 1636429920710, 277, 1, 276, 0, 0, 0
3121, 1, 1636429920573, 1636429920846, 273, 1, 272, 0, 0, 0
3122, 1, 1636429920790, 1636429921061, 271, 0, 271, 0, 0, 0
3123, 1, 1636429920874, 1636429921145, 271, 0, 271, 0, 0, 0
3125, 1, 1636429921089, 1636429921358, 269, 1, 268, 0, 1, 1
3126, 1, 1636429921185, 1636429921457, 272, 1, 271, 0, 0, 0
3127, 1, 1636429921281, 1636429921558, 277, 1, 276, 0, 1, 1
3128, 1, 1636429921425, 1636429921693, 268, 0, 268, 0, 0, 0
3129, 1, 1636429921605, 1636429921874, 269, 0, 269, 0, 0, 0
3130, 1, 1636429921785, 1636429922058, 273, 0, 273, 0, 0, 0
3131, 1, 1636429921877, 1636429922154, 277, 1, 276, 0, 0, 0
3132, 1, 1636429922134, 1636429922406, 272, 0, 272, 0, 0, 0
3133, 1, 1636429922205, 1636429922513, 308, 1, 307, 0, 1, 1
3134, 1, 1636429922285, 1636429922609, 324, 1, 323, 0, 0, 0
3135, 1, 1636429922421, 1636429922694, 273, 1, 272, 0, 0, 0
3136, 1, 1636429922617, 1636429922889, 272, 1, 271, 0, 1, 1
3141, 1, 1636429922785, 1636429923057, 272, 1, 271, 0, 0, 0
3142, 1, 1636429922933, 1636429923206, 273, 0, 273, 0, 0, 0
3145, 1, 1636429923201, 1636429923473, 272, 1, 271, 0, 1, 1
3147, 1, 1636429923301, 1636429923573, 272, 1, 271, 0, 0, 0
3144, 1, 1636429923386, 1636429923658, 272, 0, 272, 0, 0, 0
3085, 1, 1636429923398, 1636429923665, 267, 0, 267, 0, 0, 0
3149, 1, 1636429923617, 1636429923885, 268, 0, 268, 0, 0, 0
3151, 1, 1636429923841, 1636429924113, 272, 0, 272, 0, 0, 0
3152, 1, 1636429923885, 1636429924157, 272, 1, 271, 0, 0, 0
3153, 1, 1636429924058, 1636429924329, 271, 0, 271, 0, 0, 0
3154, 1, 1636429924145, 1636429924413, 268, 1, 267, 0, 0, 0
3067, 1, 1636429924189, 1636429924457, 268, 0, 268, 0, 0, 0
3155, 1, 1636429924233, 1636429924502, 269, 0, 269, 0, 0, 0
3156, 1, 1636429924278, 1636429924549, 271, 0, 271, 0, 0, 0
3157, 1, 1636429924502, 1636429924778, 276, 0, 276, 0, 0, 0
3158, 1, 1636429924625, 1636429924893, 268, 1, 267, 0, 0, 0
3159, 1, 1636429924805, 1636429925078, 273, 1, 272, 1, 0, 1
3161, 1, 1636429924898, 1636429925170, 272, 0, 272, 0, 0, 0
3160, 1, 1636429924961, 1636429925234, 273, 1, 272, 1, 0, 1
3162, 1, 1636429924989, 1636429925261, 272, 0, 272, 0, 0, 0
3163, 1, 1636429925121, 1636429925390, 269, 1, 268, 0, 0, 0
3164, 1, 1636429925234, 1636429925505, 271, 0, 271, 0, 0, 0
3165, 1, 1636429925285, 1636429925557, 272, 0, 272, 0, 0, 0
3166, 1, 1636429925390, 1636429925649, 259, 0, 259, 0, 0, 0
3167, 1, 1636429925593, 1636429925870, 277, 1, 276, 0, 0, 0
3168, 1, 1636429925805, 1636429926078, 273, 0, 273, 0, 0, 0
3169, 1, 1636429925825, 1636429926106, 281, 1, 280, 0, 0, 0
3170, 1, 1636429925905, 1636429926178, 273, 1, 272, 1, 0, 1
3171, 1, 1636429925961, 1636429926237, 276, 1, 275, 1, 0, 1
3172, 1, 1636429926101, 1636429926377, 276, 0, 276, 0, 0, 0
3173, 1, 1636429926214, 1636429926485, 271, 0, 271, 0, 0, 0
3174, 1, 1636429926261, 1636429926530, 269, 1, 268, 1, 0, 1
3176, 1, 1636429926585, 1636429926858, 273, 1, 272, 1, 0, 1
3177, 1, 1636429926798, 1636429927069, 271, 0, 271, 0, 0, 0
3179, 1, 1636429926909, 1636429927185, 276, 0, 276, 0, 0, 0
3180, 1, 1636429926954, 1636429927222, 268, 0, 268, 0, 0, 0
3181, 1, 1636429927073, 1636429927346, 273, 1, 272, 0, 0, 0
3182, 1, 1636429927230, 1636429927501, 271, 0, 271, 0, 0, 0
3183, 1, 1636429927245, 1636429927517, 272, 1, 271, 1, 0, 1
3184, 1, 1636429927582, 1636429927849, 267, 0, 267, 0, 0, 0
3185, 1, 1636429927829, 1636429928101, 272, 1, 271, 0, 0, 0
3186, 1, 1636429927925, 1636429928201, 276, 0, 276, 0, 0, 0
3187, 1, 1636429927937, 1636429928209, 272, 0, 272, 0, 0, 0
3189, 1, 1636429928218, 1636429928490, 272, 0, 272, 0, 0, 0
3190, 1, 1636429928233, 1636429928506, 273, 0, 273, 0, 0, 0
3191, 1, 1636429928553, 1636429928822, 269, 1, 268, 1, 0, 1
3192, 1, 1636429928845, 1636429929117, 272, 1, 271, 0, 0, 0
3193, 1, 1636429928921, 1636429929193, 272, 1, 271, 1, 0, 1
3194, 1, 1636429928954, 1636429929225, 271, 0, 271, 0, 0, 0
3195, 1, 1636429929209, 1636429929478, 269, 1, 268, 0, 0, 0
3196, 1, 1636429929209, 1636429929478, 269, 1, 268, 0, 0, 0
3197, 1, 1636429929534, 1636429929810, 276, 0, 276, 0, 0, 0
3198, 1, 1636429929830, 1636429930102, 272, 0, 272, 0, 0, 0
3199, 1, 1636429929890, 1636429930162, 272, 0, 272, 0, 0, 0
3200, 1, 1636429929965, 1636429930237, 272, 1, 271, 0, 1, 1
3201, 1, 1636429930185, 1636429930457, 272, 1, 271, 0, 0, 0
3202, 1, 1636429930209, 1636429930482, 273, 1, 272, 0, 0, 0
3124, 1, 1636429930410, 1636429930681, 271, 0, 271, 0, 0, 0
3203, 1, 1636429930553, 1636429930829, 276, 1, 275, 0, 1, 1
3206, 1, 1636429930837, 1636429931110, 273, 0, 273, 0, 0, 0
3205, 1, 1636429930845, 1636429931113, 268, 1, 267, 1, 0, 1
3204, 1, 1636429930853, 1636429931130, 277, 1, 276, 0, 1, 1
3207, 1, 1636429930874, 1636429931146, 272, 0, 272, 0, 0, 0
3208, 1, 1636429930933, 1636429931201, 268, 1, 267, 0, 1, 1
3210, 1, 1636429931166, 1636429931438, 272, 0, 272, 0, 0, 0
3211, 1, 1636429931181, 1636429931453, 272, 1, 271, 0, 0, 0
3209, 1, 1636429931293, 1636429931561, 268, 1, 267, 0, 1, 1
3212, 1, 1636429931530, 1636429931801, 271, 0, 271, 0, 0, 0
3213, 1, 1636429931753, 1636429932022, 269, 0, 269, 0, 0, 0
3215, 1, 1636429931841, 1636429932113, 272, 1, 271, 0, 0, 0
3216, 1, 1636429931858, 1636429932130, 272, 0, 272, 0, 0, 0
3217, 1, 1636429931905, 1636429932181, 276, 1, 275, 0, 1, 1
3219, 1, 1636429932137, 1636429932414, 277, 1, 276, 1, 0, 1
3220, 1, 1636429932165, 1636429932437, 272, 1, 271, 0, 1, 1
3221, 1, 1636429932494, 1636429932766, 272, 0, 272, 0, 0, 0
3222, 1, 1636429932865, 1636429933137, 272, 0, 272, 0, 0, 0
3143, 1, 1636429932909, 1636429933177, 268, 1, 267, 0, 1, 1
3224, 1, 1636429932957, 1636429933229, 272, 0, 272, 0, 0, 0
3223, 1, 1636429932961, 1636429933229, 268, 0, 268, 0, 0, 0
3225, 1, 1636429932998, 1636429933269, 271, 0, 271, 0, 0, 0
3231, 1, 1636429933141, 1636429933418, 277, 0, 277, 0, 0, 0
3226, 1, 1636429933126, 1636429933421, 295, 0, 295, 0, 0, 0
3230, 1, 1636429933181, 1636429933497, 316, 1, 315, 0, 1, 1
3227, 1, 1636429933181, 1636429933497, 316, 1, 315, 0, 1, 1
3232, 1, 1636429933493, 1636429933765, 272, 0, 272, 0, 0, 0
3236, 1, 1636429933761, 1636429934029, 268, 1, 267, 0, 1, 1
3235, 1, 1636429933757, 1636429934030, 273, 0, 273, 0, 0, 0
3238, 1, 1636429933841, 1636429934113, 272, 1, 271, 0, 0, 0
3237, 1, 1636429933849, 1636429934117, 268, 1, 267, 0, 1, 1
3239, 1, 1636429933933, 1636429934206, 273, 0, 273, 0, 0, 0
3242, 1, 1636429934089, 1636429934357, 268, 1, 267, 0, 1, 1
3243, 1, 1636429934106, 1636429934382, 276, 0, 276, 0, 0, 0
3244, 1, 1636429934117, 1636429934382, 265, 0, 265, 0, 0, 0
3245, 1, 1636429934526, 1636429934801, 275, 0, 275, 0, 0, 0
3246, 1, 1636429934685, 1636429934961, 276, 1, 275, 1, 0, 1
3247, 1, 1636429934785, 1636429935053, 268, 1, 267, 1, 0, 1
3248, 1, 1636429934814, 1636429935085, 271, 0, 271, 0, 0, 0
3250, 1, 1636429934917, 1636429935190, 273, 0, 273, 0, 0, 0
3251, 1, 1636429935081, 1636429935354, 273, 0, 273, 0, 0, 0
3252, 1, 1636429935093, 1636429935365, 272, 1, 271, 0, 0, 0
3253, 1, 1636429935126, 1636429935398, 272, 0, 272, 0, 0, 0
3254, 1, 1636429935490, 1636429935761, 271, 0, 271, 0, 0, 0
3255, 1, 1636429935705, 1636429935969, 264, 1, 263, 0, 0, 0
3256, 1, 1636429935785, 1636429936053, 268, 1, 267, 0, 0, 0
3257, 1, 1636429935790, 1636429936061, 271, 0, 271, 0, 0, 0
3258, 1, 1636429935881, 1636429936149, 268, 0, 268, 0, 0, 0
3259, 1, 1636429936050, 1636429936322, 272, 0, 272, 0, 0, 0
3261, 1, 1636429936101, 1636429936366, 265, 0, 265, 0, 0, 0
3260, 1, 1636429936097, 1636429936369, 272, 0, 272, 0, 0, 0
3262, 1, 1636429936453, 1636429936725, 272, 1, 271, 0, 1, 1
3263, 1, 1636429936670, 1636429936950, 280, 0, 280, 0, 0, 0
3264, 1, 1636429936769, 1636429937041, 272, 1, 271, 1, 0, 1
3265, 1, 1636429936769, 1636429937045, 276, 1, 275, 0, 0, 0
3266, 1, 1636429936797, 1636429937070, 273, 0, 273, 0, 0, 0
3267, 1, 1636429936849, 1636429937126, 277, 0, 277, 0, 0, 0
3268, 1, 1636429937053, 1636429937326, 273, 1, 272, 0, 1, 1
3269, 1, 1636429937069, 1636429937346, 277, 1, 276, 0, 0, 0
3271, 1, 1636429937089, 1636429937362, 273, 1, 272, 0, 0, 0
3270, 1, 1636429937217, 1636429937489, 272, 0, 272, 0, 0, 0
3272, 1, 1636429937425, 1636429937701, 276, 1, 275, 1, 0, 1
3273, 1, 1636429937621, 1636429937889, 268, 1, 267, 0, 0, 0
3274, 1, 1636429937657, 1636429937930, 273, 0, 273, 0, 0, 0
3275, 1, 1636429937773, 1636429938042, 269, 1, 268, 0, 0, 0
3276, 1, 1636429937797, 1636429938069, 272, 1, 271, 0, 0, 0
3277, 1, 1636429937857, 1636429938137, 280, 1, 279, 0, 0, 0
3280, 1, 1636429938049, 1636429938321, 272, 1, 271, 0, 0, 0
3278, 1, 1636429938049, 1636429938321, 272, 1, 271, 0, 0, 0
3279, 1, 1636429938061, 1636429938337, 276, 1, 275, 0, 0, 0
3281, 1, 1636429938069, 1636429938341, 272, 1, 271, 0, 0, 0
3283, 1, 1636429938385, 1636429938653, 268, 1, 267, 0, 1, 1
3282, 1, 1636429938393, 1636429938665, 272, 1, 271, 0, 1, 1
3284, 1, 1636429938590, 1636429938861, 271, 0, 271, 0, 0, 0
3285, 1, 1636429938674, 1636429938949, 275, 0, 275, 0, 0, 0
3286, 1, 1636429938757, 1636429939033, 276, 1, 275, 0, 0, 0
3287, 1, 1636429938841, 1636429939109, 268, 1, 267, 1, 0, 1
3288, 1, 1636429938849, 1636429939121, 272, 1, 271, 1, 0, 1
3289, 1, 1636429938993, 1636429939262, 269, 1, 268, 0, 0, 0
3291, 1, 1636429939017, 1636429939281, 264, 1, 263, 0, 0, 0
3290, 1, 1636429939045, 1636429939317, 272, 1, 271, 0, 0, 0
3292, 1, 1636429939061, 1636429939329, 268, 1, 267, 0, 0, 0
3293, 1, 1636429939317, 1636429939589, 272, 0, 272, 0, 0, 0
3294, 1, 1636429939409, 1636429939681, 272, 0, 272, 0, 0, 0
3295, 1, 1636429939593, 1636429939869, 276, 0, 276, 0, 0, 0
3296, 1, 1636429939677, 1636429939945, 268, 1, 267, 0, 0, 0
3297, 1, 1636429939729, 1636429940001, 272, 1, 271, 0, 0, 0
3298, 1, 1636429939806, 1636429940078, 272, 0, 272, 0, 0, 0
3299, 1, 1636429939885, 1636429940154, 269, 1, 268, 0, 0, 0
3300, 1, 1636429939949, 1636429940222, 273, 1, 272, 0, 0, 0
3301, 1, 1636429940033, 1636429940301, 268, 0, 268, 0, 0, 0
3302, 1, 1636429940045, 1636429940314, 269, 1, 268, 0, 0, 0
3303, 1, 1636429940061, 1636429940333, 272, 0, 272, 0, 0, 0
3304, 1, 1636429940314, 1636429940586, 272, 0, 272, 0, 0, 0
3305, 1, 1636429940457, 1636429940733, 276, 1, 275, 1, 0, 1
3306, 1, 1636429940558, 1636429940829, 271, 0, 271, 0, 0, 0
3307, 1, 1636429940653, 1636429940922, 269, 1, 268, 1, 0, 1
3308, 1, 1636429940725, 1636429941001, 276, 1, 275, 1, 0, 1
3309, 1, 1636429940797, 1636429941073, 276, 1, 275, 0, 0, 0
3310, 1, 1636429940881, 1636429941150, 269, 1, 268, 0, 0, 0
3311, 1, 1636429940945, 1636429941214, 269, 1, 268, 0, 0, 0
3312, 1, 1636429941033, 1636429941298, 265, 0, 265, 0, 0, 0
3313, 1, 1636429941070, 1636429941342, 272, 0, 272, 0, 0, 0
3314, 1, 1636429941070, 1636429941345, 275, 0, 275, 0, 0, 0
3315, 1, 1636429941338, 1636429941609, 271, 0, 271, 0, 0, 0
3316, 1, 1636429941417, 1636429941689, 272, 1, 271, 1, 0, 1
3317, 1, 1636429941593, 1636429941910, 317, 0, 317, 0, 0, 0
3318, 1, 1636429941662, 1636429941933, 271, 0, 271, 0, 0, 0
3319, 1, 1636429941730, 1636429942001, 271, 0, 271, 0, 0, 0
3320, 1, 1636429941813, 1636429942089, 276, 1, 275, 0, 1, 1
3321, 1, 1636429941909, 1636429942181, 272, 1, 271, 0, 0, 0
3322, 1, 1636429942001, 1636429942269, 268, 1, 267, 0, 0, 0
3324, 1, 1636429942037, 1636429942305, 268, 1, 267, 1, 0, 1
3249, 1, 1636429942041, 1636429942309, 268, 0, 268, 0, 0, 0
3323, 1, 1636429942089, 1636429942357, 268, 1, 267, 0, 0, 0
3325, 1, 1636429942085, 1636429942358, 273, 1, 272, 1, 0, 1
3326, 1, 1636429942093, 1636429942357, 264, 0, 264, 0, 0, 0
3328, 1, 1636429942345, 1636429942617, 272, 1, 271, 0, 0, 0
3329, 1, 1636429942417, 1636429942689, 272, 1, 271, 1, 0, 1
3327, 1, 1636429942537, 1636429942809, 272, 1, 271, 1, 0, 1
3330, 1, 1636429942573, 1636429942846, 273, 1, 272, 1, 0, 1
3332, 1, 1636429942677, 1636429942942, 265, 1, 264, 0, 0, 0
3331, 1, 1636429942705, 1636429942977, 272, 0, 272, 0, 0, 0
3333, 1, 1636429942717, 1636429942997, 280, 0, 280, 0, 0, 0
3334, 1, 1636429942829, 1636429943105, 276, 1, 275, 0, 0, 0
3335, 1, 1636429942985, 1636429943273, 288, 0, 288, 0, 0, 0
3339, 1, 1636429943033, 1636429943365, 332, 0, 332, 0, 0, 0
3337, 1, 1636429942997, 1636429943366, 369, 1, 368, 1, 0, 1
3336, 1, 1636429942997, 1636429943365, 368, 1, 367, 0, 1, 1
3338, 1, 1636429943025, 1636429943366, 341, 0, 341, 0, 0, 0
3340, 1, 1636429943185, 1636429943457, 272, 0, 272, 0, 0, 0
3343, 1, 1636429943393, 1636429943673, 280, 0, 280, 0, 0, 0
3342, 1, 1636429943369, 1636429943673, 304, 0, 304, 0, 0, 0
3241, 1, 1636429943585, 1636429943857, 272, 1, 271, 1, 0, 1
3341, 1, 1636429943585, 1636429943857, 272, 1, 271, 1, 0, 1
3344, 1, 1636429943585, 1636429943861, 276, 1, 275, 1, 0, 1
3240, 1, 1636429943625, 1636429943893, 268, 1, 267, 0, 0, 0
3345, 1, 1636429943669, 1636429943941, 272, 0, 272, 0, 0, 0
3346, 1, 1636429943677, 1636429943945, 268, 0, 268, 0, 0, 0
3347, 1, 1636429943757, 1636429944025, 268, 1, 267, 1, 0, 1
3348, 1, 1636429943853, 1636429944121, 268, 0, 268, 0, 0, 0
3350, 1, 1636429943981, 1636429944245, 264, 1, 263, 1, 0, 1
3353, 1, 1636429943985, 1636429944262, 277, 1, 276, 0, 1, 1
3354, 1, 1636429943985, 1636429944262, 277, 1, 276, 0, 1, 1
3355, 1, 1636429944001, 1636429944274, 273, 0, 273, 0, 0, 0
3357, 1, 1636429944013, 1636429944285, 272, 0, 272, 0, 0, 0
3356, 1, 1636429944037, 1636429944306, 269, 0, 269, 0, 0, 0
3349, 1, 1636429944033, 1636429944306, 273, 0, 273, 0, 0, 0
3358, 1, 1636429944081, 1636429944349, 268, 0, 268, 0, 0, 0
3362, 1, 1636429944337, 1636429944609, 272, 0, 272, 0, 0, 0
3363, 1, 1636429944374, 1636429944649, 275, 0, 275, 0, 0, 0
3360, 1, 1636429944437, 1636429944710, 273, 1, 272, 0, 0, 0
3361, 1, 1636429944449, 1636429944721, 272, 1, 271, 0, 0, 0
3364, 1, 1636429944577, 1636429944845, 268, 1, 267, 1, 0, 1
3365, 1, 1636429944633, 1636429944901, 268, 1, 267, 0, 0, 0
3366, 1, 1636429944653, 1636429944921, 268, 0, 268, 0, 0, 0
3367, 1, 1636429944693, 1636429944957, 264, 1, 263, 0, 0, 0
3368, 1, 1636429944821, 1636429945093, 272, 0, 272, 0, 0, 0
3352, 1, 1636429944885, 1636429945162, 277, 1, 276, 0, 1, 1
3370, 1, 1636429944913, 1636429945181, 268, 1, 267, 0, 0, 0
3369, 1, 1636429944913, 1636429945185, 272, 1, 271, 0, 0, 0
3372, 1, 1636429944977, 1636429945249, 272, 1, 271, 0, 1, 1
3373, 1, 1636429944977, 1636429945249, 272, 1, 271, 1, 0, 1
3374, 1, 1636429944985, 1636429945249, 264, 0, 264, 0, 0, 0
3375, 1, 1636429945025, 1636429945289, 264, 0, 264, 0, 0, 0
3376, 1, 1636429945061, 1636429945329, 268, 1, 267, 1, 0, 1
3379, 1, 1636429945353, 1636429945633, 280, 1, 279, 1, 0, 1
3380, 1, 1636429945381, 1636429945649, 268, 1, 267, 0, 0, 0
3377, 1, 1636429945429, 1636429945698, 269, 1, 268, 0, 1, 1
3381, 1, 1636429945562, 1636429945829, 267, 0, 267, 0, 0, 0
3382, 1, 1636429945585, 1636429945853, 268, 1, 267, 0, 1, 1
3383, 1, 1636429945629, 1636429945901, 272, 1, 271, 0, 0, 0
3384, 1, 1636429945662, 1636429945933, 271, 0, 271, 0, 0, 0
3385, 1, 1636429945662, 1636429945933, 271, 0, 271, 0, 0, 0
3386, 1, 1636429945853, 1636429946121, 268, 1, 267, 1, 0, 1
3387, 1, 1636429945881, 1636429946149, 268, 1, 267, 0, 0, 0
3388, 1, 1636429945897, 1636429946174, 277, 0, 277, 0, 0, 0
3389, 1, 1636429945953, 1636429946217, 264, 1, 263, 0, 1, 1
3390, 1, 1636429945957, 1636429946229, 272, 1, 271, 0, 1, 1
3391, 1, 1636429945985, 1636429946257, 272, 1, 271, 0, 0, 0
3392, 1, 1636429946033, 1636429946297, 264, 1, 263, 0, 0, 0
3393, 1, 1636429946085, 1636429946349, 264, 1, 263, 0, 0, 0
3395, 1, 1636429946353, 1636429946621, 268, 0, 268, 0, 0, 0
3394, 1, 1636429946397, 1636429946666, 269, 0, 269, 0, 0, 0
3396, 1, 1636429946385, 1636429946666, 281, 1, 280, 0, 0, 0
3397, 1, 1636429946533, 1636429946809, 276, 0, 276, 0, 0, 0
3398, 1, 1636429946601, 1636429946873, 272, 0, 272, 0, 0, 0
3399, 1, 1636429946609, 1636429946881, 272, 1, 271, 0, 0, 0
3400, 1, 1636429946645, 1636429946917, 272, 1, 271, 0, 0, 0
3401, 1, 1636429946665, 1636429946937, 272, 1, 271, 0, 0, 0
3402, 1, 1636429946829, 1636429947105, 276, 0, 276, 0, 0, 0
3403, 1, 1636429946857, 1636429947126, 269, 0, 269, 0, 0, 0
3404, 1, 1636429946929, 1636429947193, 264, 0, 264, 0, 0, 0
3405, 1, 1636429946937, 1636429947217, 280, 1, 279, 0, 1, 1
3406, 1, 1636429946961, 1636429947238, 277, 0, 277, 0, 0, 0
3407, 1, 1636429946973, 1636429947238, 265, 1, 264, 1, 0, 1
3408, 1, 1636429947049, 1636429947321, 272, 1, 271, 0, 0, 0
3409, 1, 1636429947081, 1636429947353, 272, 1, 271, 1, 0, 1
3411, 1, 1636429947381, 1636429947653, 272, 1, 271, 1, 0, 1
3412, 1, 1636429947385, 1636429947661, 276, 1, 275, 0, 1, 1
3410, 1, 1636429947417, 1636429947693, 276, 0, 276, 0, 0, 0
3413, 1, 1636429947513, 1636429947789, 276, 1, 275, 0, 0, 0
3414, 1, 1636429947569, 1636429947837, 268, 1, 267, 0, 0, 0
3415, 1, 1636429947629, 1636429947897, 268, 1, 267, 0, 0, 0
3416, 1, 1636429947642, 1636429947909, 267, 0, 267, 0, 0, 0
3417, 1, 1636429947689, 1636429947961, 272, 1, 271, 0, 0, 0
3418, 1, 1636429947849, 1636429948121, 272, 1, 271, 0, 0, 0
3419, 1, 1636429947869, 1636429948145, 276, 0, 276, 0, 0, 0
3420, 1, 1636429947913, 1636429948181, 268, 1, 267, 0, 0, 0
3421, 1, 1636429947925, 1636429948201, 276, 1, 275, 0, 0, 0
3422, 1, 1636429947945, 1636429948217, 272, 1, 271, 0, 0, 0
3423, 1, 1636429947997, 1636429948262, 265, 1, 264, 0, 0, 0
3424, 1, 1636429948021, 1636429948293, 272, 1, 271, 0, 0, 0
3425, 1, 1636429948069, 1636429948337, 268, 1, 267, 0, 0, 0
3427, 1, 1636429948377, 1636429948646, 269, 1, 268, 0, 1, 1
3428, 1, 1636429948393, 1636429948657, 264, 0, 264, 0, 0, 0
3426, 1, 1636429948438, 1636429948701, 263, 0, 263, 0, 0, 0
3429, 1, 1636429948485, 1636429948761, 276, 1, 275, 1, 0, 1
3430, 1, 1636429948549, 1636429948817, 268, 1, 267, 0, 0, 0
3431, 1, 1636429948605, 1636429948878, 273, 0, 273, 0, 0, 0
3432, 1, 1636429948621, 1636429948889, 268, 1, 267, 1, 0, 1
3433, 1, 1636429948673, 1636429948945, 272, 1, 271, 0, 1, 1
3434, 1, 1636429948833, 1636429949110, 277, 0, 277, 0, 0, 0
3435, 1, 1636429948877, 1636429949157, 280, 1, 279, 0, 0, 0
3436, 1, 1636429948929, 1636429949201, 272, 1, 271, 0, 0, 0
3437, 1, 1636429948961, 1636429949229, 268, 1, 267, 0, 1, 1
3438, 1, 1636429948965, 1636429949242, 277, 1, 276, 0, 0, 0
3439, 1, 1636429948985, 1636429949257, 272, 0, 272, 0, 0, 0
3440, 1, 1636429949001, 1636429949282, 281, 1, 280, 1, 0, 1
3441, 1, 1636429949085, 1636429949354, 269, 1, 268, 0, 0, 0
3443, 1, 1636429949357, 1636429949629, 272, 0, 272, 0, 0, 0
3444, 1, 1636429949425, 1636429949693, 268, 1, 267, 0, 0, 0
3442, 1, 1636429949437, 1636429949709, 272, 1, 271, 1, 0, 1
3445, 1, 1636429949465, 1636429949737, 272, 1, 271, 1, 0, 1
3446, 1, 1636429949562, 1636429949833, 271, 0, 271, 0, 0, 0
3448, 1, 1636429949605, 1636429949881, 276, 1, 275, 1, 0, 1
3447, 1, 1636429949605, 1636429949885, 280, 1, 279, 0, 0, 0
3449, 1, 1636429949697, 1636429949969, 272, 0, 272, 0, 0, 0
3450, 1, 1636429949837, 1636429950105, 268, 1, 267, 0, 0, 0
3451, 1, 1636429949893, 1636429950157, 264, 1, 263, 0, 0, 0
3452, 1, 1636429949902, 1636429950169, 267, 0, 267, 0, 0, 0
3453, 1, 1636429949953, 1636429950222, 269, 1, 268, 0, 0, 0
3454, 1, 1636429949973, 1636429950245, 272, 0, 272, 0, 0, 0
3456, 1, 1636429950021, 1636429950289, 268, 0, 268, 0, 0, 0
3455, 1, 1636429950017, 1636429950289, 272, 0, 272, 0, 0, 0
3457, 1, 1636429950105, 1636429950377, 272, 1, 271, 0, 0, 0
3459, 1, 1636429950322, 1636429950593, 271, 0, 271, 0, 0, 0
3460, 1, 1636429950409, 1636429950681, 272, 1, 271, 0, 1, 1
3461, 1, 1636429950457, 1636429950733, 276, 1, 275, 0, 0, 0
3458, 1, 1636429950469, 1636429950745, 276, 1, 275, 1, 0, 1
3462, 1, 1636429950565, 1636429950837, 272, 1, 271, 0, 0, 0
3463, 1, 1636429950573, 1636429950837, 264, 0, 264, 0, 0, 0
3464, 1, 1636429950637, 1636429950905, 268, 1, 267, 0, 0, 0
3465, 1, 1636429950729, 1636429951005, 276, 0, 276, 0, 0, 0
3466, 1, 1636429950809, 1636429951082, 273, 1, 272, 0, 0, 0
3467, 1, 1636429950925, 1636429951197, 272, 1, 271, 1, 0, 1
3469, 1, 1636429950925, 1636429951198, 273, 1, 272, 1, 0, 1
3468, 1, 1636429950925, 1636429951197, 272, 1, 271, 0, 0, 0
3470, 1, 1636429950965, 1636429951233, 268, 1, 267, 0, 0, 0
3472, 1, 1636429951037, 1636429951301, 264, 0, 264, 0, 0, 0
3471, 1, 1636429951033, 1636429951301, 268, 0, 268, 0, 0, 0
3473, 1, 1636429951081, 1636429951353, 272, 1, 271, 0, 0, 0
3475, 1, 1636429951329, 1636429951601, 272, 1, 271, 1, 0, 1
3476, 1, 1636429951393, 1636429951666, 273, 1, 272, 1, 0, 1
3477, 1, 1636429951481, 1636429951753, 272, 1, 271, 0, 0, 0
3474, 1, 1636429951481, 1636429951753, 272, 1, 271, 0, 0, 0
3478, 1, 1636429951553, 1636429951825, 272, 0, 272, 0, 0, 0
3479, 1, 1636429951609, 1636429951873, 264, 0, 264, 0, 0, 0
3480, 1, 1636429951653, 1636429951917, 264, 1, 263, 0, 0, 0
3481, 1, 1636429951757, 1636429952025, 268, 0, 268, 0, 0, 0
3482, 1, 1636429951809, 1636429952077, 268, 0, 268, 0, 0, 0
3485, 1, 1636429951917, 1636429952189, 272, 1, 271, 0, 1, 1
3484, 1, 1636429951917, 1636429952189, 272, 1, 271, 0, 0, 0
3483, 1, 1636429951929, 1636429952197, 268, 1, 267, 0, 0, 0
3486, 1, 1636429951949, 1636429952221, 272, 0, 272, 0, 0, 0
3487, 1, 1636429952009, 1636429952277, 268, 1, 267, 0, 0, 0
3488, 1, 1636429952029, 1636429952297, 268, 1, 267, 0, 0, 0
3489, 1, 1636429952069, 1636429952341, 272, 1, 271, 0, 0, 0
3491, 1, 1636429952317, 1636429952589, 272, 1, 271, 0, 0, 0
3492, 1, 1636429952426, 1636429952698, 272, 0, 272, 0, 0, 0
3493, 1, 1636429952433, 1636429952709, 276, 0, 276, 0, 0, 0
3490, 1, 1636429952477, 1636429952749, 272, 1, 271, 1, 0, 1
3494, 1, 1636429952562, 1636429952837, 275, 0, 275, 0, 0, 0
3495, 1, 1636429952641, 1636429952914, 273, 1, 272, 0, 0, 0
3496, 1, 1636429952661, 1636429952945, 284, 0, 284, 0, 0, 0
3497, 1, 1636429952745, 1636429953021, 276, 0, 276, 0, 0, 0
3498, 1, 1636429952801, 1636429953069, 268, 0, 268, 0, 0, 0
3500, 1, 1636429952877, 1636429953145, 268, 1, 267, 0, 0, 0
3499, 1, 1636429952925, 1636429953201, 276, 1, 275, 0, 0, 0
3501, 1, 1636429952921, 1636429953205, 284, 1, 283, 0, 1, 1
3502, 1, 1636429952981, 1636429953249, 268, 1, 267, 0, 0, 0
3503, 1, 1636429953001, 1636429953273, 272, 0, 272, 0, 0, 0
3504, 1, 1636429953017, 1636429953293, 276, 1, 275, 0, 0, 0
3505, 1, 1636429953085, 1636429953358, 273, 1, 272, 0, 0, 0
3507, 1, 1636429953305, 1636429953573, 268, 1, 267, 0, 1, 1
3506, 1, 1636429953449, 1636429953721, 272, 1, 271, 0, 0, 0
3509, 1, 1636429953465, 1636429953742, 277, 1, 276, 0, 0, 0
3510, 1, 1636429953577, 1636429953845, 268, 0, 268, 0, 0, 0
3512, 1, 1636429953629, 1636429953901, 272, 0, 272, 0, 0, 0
3511, 1, 1636429953625, 1636429953905, 280, 0, 280, 0, 0, 0
3513, 1, 1636429953777, 1636429954053, 276, 1, 275, 0, 0, 0
3514, 1, 1636429953789, 1636429954066, 277, 0, 277, 0, 0, 0
3515, 1, 1636429953901, 1636429954169, 268, 1, 267, 0, 0, 0
3516, 1, 1636429953953, 1636429954221, 268, 1, 267, 0, 1, 1
3517, 1, 1636429953953, 1636429954225, 272, 1, 271, 0, 0, 0
3520, 1, 1636429954041, 1636429954309, 268, 1, 267, 1, 0, 1
3519, 1, 1636429954041, 1636429954313, 272, 1, 271, 0, 0, 0
3521, 1, 1636429954125, 1636429954389, 264, 1, 263, 1, 0, 1
3523, 1, 1636429954349, 1636429954621, 272, 0, 272, 0, 0, 0
3524, 1, 1636429954493, 1636429954765, 272, 1, 271, 1, 0, 1
3522, 1, 1636429954493, 1636429954765, 272, 1, 271, 1, 0, 1
3525, 1, 1636429954573, 1636429954841, 268, 0, 268, 0, 0, 0
3526, 1, 1636429954617, 1636429954885, 268, 0, 268, 0, 0, 0
3527, 1, 1636429954625, 1636429954897, 272, 0, 272, 0, 0, 0
3529, 1, 1636429954737, 1636429955054, 317, 0, 317, 0, 0, 0
3530, 1, 1636429954805, 1636429955077, 272, 1, 271, 0, 0, 0
3531, 1, 1636429954805, 1636429955077, 272, 1, 271, 0, 0, 0
3533, 1, 1636429954889, 1636429955162, 273, 1, 272, 0, 0, 0
3532, 1, 1636429954941, 1636429955209, 268, 0, 268, 0, 0, 0
3534, 1, 1636429954965, 1636429955241, 276, 1, 275, 0, 0, 0
3536, 1, 1636429955053, 1636429955326, 273, 1, 272, 0, 0, 0
3535, 1, 1636429955049, 1636429955326, 277, 0, 277, 0, 0, 0
3537, 1, 1636429955101, 1636429955394, 293, 0, 293, 0, 0, 0
3540, 1, 1636429955349, 1636429955617, 268, 1, 267, 0, 1, 1
3539, 1, 1636429955509, 1636429955777, 268, 0, 268, 0, 0, 0
3541, 1, 1636429955525, 1636429955801, 276, 1, 275, 0, 0, 0
3543, 1, 1636429955549, 1636429955817, 268, 1, 267, 0, 1, 1
3544, 1, 1636429955625, 1636429955901, 276, 0, 276, 0, 0, 0
3545, 1, 1636429955641, 1636429955913, 272, 1, 271, 1, 0, 1
3546, 1, 1636429955649, 1636429955925, 276, 1, 275, 0, 1, 1
3547, 1, 1636429955793, 1636429956065, 272, 1, 271, 0, 0, 0
3548, 1, 1636429955813, 1636429956089, 276, 0, 276, 0, 0, 0
3550, 1, 1636429955889, 1636429956157, 268, 1, 267, 1, 0, 1
3549, 1, 1636429955949, 1636429956221, 272, 1, 271, 0, 0, 0
3552, 1, 1636429956026, 1636429956293, 267, 0, 267, 0, 0, 0
3553, 1, 1636429956049, 1636429956322, 273, 1, 272, 0, 0, 0
3554, 1, 1636429956109, 1636429956381, 272, 1, 271, 0, 0, 0
3556, 1, 1636429956333, 1636429956605, 272, 1, 271, 0, 1, 1
3555, 1, 1636429956501, 1636429956777, 276, 1, 275, 1, 0, 1
3557, 1, 1636429956553, 1636429956825, 272, 1, 271, 0, 0, 0
3559, 1, 1636429956637, 1636429956913, 276, 1, 275, 1, 0, 1
3561, 1, 1636429956661, 1636429956937, 276, 1, 275, 0, 0, 0
3562, 1, 1636429956817, 1636429957089, 272, 0, 272, 0, 0, 0
3563, 1, 1636429956854, 1636429957129, 275, 0, 275, 0, 0, 0
3565, 1, 1636429956873, 1636429957145, 272, 0, 272, 0, 0, 0
3567, 1, 1636429957029, 1636429957301, 272, 1, 271, 0, 0, 0
3566, 1, 1636429957029, 1636429957301, 272, 1, 271, 0, 0, 0
3568, 1, 1636429957117, 1636429957389, 272, 1, 271, 0, 0, 0
3570, 1, 1636429957353, 1636429957625, 272, 0, 272, 0, 0, 0
3569, 1, 1636429957481, 1636429957758, 277, 1, 276, 0, 0, 0
3571, 1, 1636429957593, 1636429957865, 272, 0, 272, 0, 0, 0
3572, 1, 1636429957622, 1636429957893, 271, 0, 271, 0, 0, 0
3573, 1, 1636429957641, 1636429957910, 269, 1, 268, 0, 1, 1
3575, 1, 1636429957849, 1636429958114, 265, 0, 265, 0, 0, 0
3574, 1, 1636429957841, 1636429958114, 273, 0, 273, 0, 0, 0
3576, 1, 1636429957865, 1636429958129, 264, 0, 264, 0, 0, 0
3577, 1, 1636429958057, 1636429958330, 273, 1, 272, 0, 0, 0
3578, 1, 1636429958057, 1636429958330, 273, 1, 272, 0, 0, 0
3579, 1, 1636429958093, 1636429958362, 269, 1, 268, 1, 0, 1
3581, 1, 1636429958345, 1636429958621, 276, 0, 276, 0, 0, 0
3580, 1, 1636429958509, 1636429958793, 284, 1, 283, 0, 0, 0
3582, 1, 1636429958609, 1636429958886, 277, 1, 276, 1, 0, 1
3584, 1, 1636429958677, 1636429958953, 276, 1, 275, 0, 1, 1
3585, 1, 1636429958837, 1636429959113, 276, 1, 275, 0, 0, 0
3586, 1, 1636429958863, 1636429959129, 266, 0, 266, 0, 0, 0
3587, 1, 1636429958910, 1636429959173, 263, 0, 263, 0, 0, 0
3588, 1, 1636429959061, 1636429959325, 264, 1, 263, 0, 0, 0
3589, 1, 1636429959081, 1636429959345, 264, 1, 263, 0, 0, 0
3592, 1, 1636429959365, 1636429959629, 264, 0, 264, 0, 0, 0
3591, 1, 1636429959502, 1636429959766, 264, 0, 264, 0, 0, 0
3593, 1, 1636429959609, 1636429959881, 272, 0, 272, 0, 0, 0
3594, 1, 1636429959693, 1636429959965, 272, 0, 272, 0, 0, 0
3595, 1, 1636429959857, 1636429960122, 265, 1, 264, 0, 0, 0
3596, 1, 1636429959873, 1636429960145, 272, 1, 271, 0, 0, 0
3598, 1, 1636429960093, 1636429960366, 273, 1, 272, 0, 1, 1
3599, 1, 1636429960105, 1636429960374, 269, 1, 268, 0, 1, 1
3597, 1, 1636429960330, 1636429960597, 267, 0, 267, 0, 0, 0
3601, 1, 1636429960381, 1636429960657, 276, 1, 275, 1, 0, 1
3600, 1, 1636429960549, 1636429960821, 272, 0, 272, 0, 0, 0
3602, 1, 1636429960578, 1636429960849, 271, 0, 271, 0, 0, 0
3603, 1, 1636429960698, 1636429960970, 272, 0, 272, 0, 0, 0
3604, 1, 1636429960869, 1636429961141, 272, 1, 271, 0, 0, 0
3605, 1, 1636429960878, 1636429961145, 267, 0, 267, 0, 0, 0
3606, 1, 1636429960993, 1636429961265, 272, 1, 271, 0, 0, 0
3607, 1, 1636429961057, 1636429961330, 273, 1, 272, 0, 0, 0
3608, 1, 1636429961109, 1636429961382, 273, 1, 272, 0, 1, 1
3610, 1, 1636429961349, 1636429961622, 273, 1, 272, 0, 0, 0
3609, 1, 1636429961510, 1636429961782, 272, 0, 272, 0, 0, 0
3611, 1, 1636429961609, 1636429961878, 269, 0, 269, 0, 0, 0
3612, 1, 1636429961677, 1636429961953, 276, 1, 275, 0, 1, 1
3613, 1, 1636429961862, 1636429962133, 271, 0, 271, 0, 0, 0
3614, 1, 1636429961878, 1636429962149, 271, 0, 271, 0, 0, 0
3615, 1, 1636429961942, 1636429962213, 271, 0, 271, 0, 0, 0
3616, 1, 1636429962097, 1636429962369, 272, 1, 271, 0, 0, 0
3617, 1, 1636429962097, 1636429962369, 272, 1, 271, 0, 0, 0
3619, 1, 1636429962357, 1636429962629, 272, 0, 272, 0, 0, 0
3618, 1, 1636429962550, 1636429962825, 275, 0, 275, 0, 0, 0
3620, 1, 1636429962633, 1636429962905, 272, 0, 272, 0, 0, 0
3621, 1, 1636429962673, 1636429962945, 272, 0, 272, 0, 0, 0
3622, 1, 1636429962845, 1636429963117, 272, 0, 272, 0, 0, 0
3623, 1, 1636429962870, 1636429963141, 271, 0, 271, 0, 0, 0
3624, 1, 1636429962937, 1636429963205, 268, 1, 267, 0, 0, 0
3625, 1, 1636429963086, 1636429963358, 272, 0, 272, 0, 0, 0
3626, 1, 1636429963117, 1636429963390, 273, 1, 272, 0, 0, 0
3628, 1, 1636429963369, 1636429963642, 273, 1, 272, 0, 0, 0
3627, 1, 1636429963574, 1636429963845, 271, 0, 271, 0, 0, 0
3629, 1, 1636429963641, 1636429963921, 280, 1, 279, 1, 0, 1
3631, 1, 1636429963713, 1636429964001, 288, 1, 287, 0, 1, 1
3632, 1, 1636429963833, 1636429964101, 268, 1, 267, 0, 1, 1
3633, 1, 1636429963845, 1636429964114, 269, 1, 268, 0, 0, 0
3634, 1, 1636429963929, 1636429964201, 272, 1, 271, 1, 0, 1
3635, 1, 1636429964086, 1636429964357, 271, 0, 271, 0, 0, 0
3636, 1, 1636429964129, 1636429964410, 281, 1, 280, 0, 0, 0
3639, 1, 1636429964349, 1636429964621, 272, 1, 271, 0, 0, 0
3638, 1, 1636429964585, 1636429964877, 292, 1, 291, 1, 0, 1
3643, 1, 1636429964829, 1636429965101, 272, 0, 272, 0, 0, 0
3642, 1, 1636429964873, 1636429965145, 272, 1, 271, 0, 0, 0
3644, 1, 1636429964954, 1636429965269, 315, 0, 315, 0, 0, 0
3645, 1, 1636429965054, 1636429965361, 307, 0, 307, 0, 0, 0
3646, 1, 1636429965181, 1636429965453, 272, 1, 271, 0, 0, 0
3647, 1, 1636429965361, 1636429965637, 276, 1, 275, 0, 0, 0
3649, 1, 1636429965541, 1636429965813, 272, 1, 271, 0, 0, 0
3648, 1, 1636429965633, 1636429965905, 272, 0, 272, 0, 0, 0
3652, 1, 1636429965885, 1636429966153, 268, 1, 267, 1, 0, 1
3653, 1, 1636429965885, 1636429966157, 272, 1, 271, 0, 1, 1
3560, 1, 1636429965925, 1636429966194, 269, 1, 268, 0, 0, 0
3654, 1, 1636429965973, 1636429966241, 268, 1, 267, 0, 0, 0
3655, 1, 1636429966057, 1636429966329, 272, 1, 271, 1, 0, 1
3656, 1, 1636429966133, 1636429966406, 273, 1, 272, 0, 1, 1
3659, 1, 1636429966345, 1636429966622, 277, 1, 276, 1, 0, 1
3660, 1, 1636429966433, 1636429966706, 273, 1, 272, 0, 0, 0
3658, 1, 1636429966585, 1636429966857, 272, 1, 271, 0, 0, 0
3662, 1, 1636429966837, 1636429967109, 272, 0, 272, 0, 0, 0
3663, 1, 1636429966841, 1636429967113, 272, 1, 271, 0, 0, 0
3665, 1, 1636429967026, 1636429967301, 275, 0, 275, 0, 0, 0
3666, 1, 1636429967161, 1636429967437, 276, 1, 275, 0, 0, 0
3668, 1, 1636429967273, 1636429967546, 273, 1, 272, 0, 0, 0
3664, 1, 1636429967297, 1636429967570, 273, 1, 272, 0, 1, 1
3670, 1, 1636429967365, 1636429967638, 273, 1, 272, 0, 0, 0
3671, 1, 1636429967445, 1636429967726, 281, 1, 280, 1, 0, 1
3669, 1, 1636429967625, 1636429967893, 268, 0, 268, 0, 0, 0
3672, 1, 1636429967805, 1636429968073, 268, 0, 268, 0, 0, 0
3673, 1, 1636429967845, 1636429968117, 272, 1, 271, 0, 0, 0
3674, 1, 1636429967965, 1636429968237, 272, 1, 271, 0, 0, 0
3675, 1, 1636429968041, 1636429968305, 264, 1, 263, 0, 0, 0
3676, 1, 1636429968149, 1636429968417, 268, 1, 267, 1, 0, 1
3677, 1, 1636429968185, 1636429968454, 269, 0, 269, 0, 0, 0
3679, 1, 1636429968405, 1636429968678, 273, 0, 273, 0, 0, 0
3680, 1, 1636429968429, 1636429968701, 272, 0, 272, 0, 0, 0
3678, 1, 1636429968633, 1636429968905, 272, 1, 271, 0, 1, 1
3681, 1, 1636429968813, 1636429969085, 272, 1, 271, 1, 0, 1
3683, 1, 1636429968885, 1636429969162, 277, 0, 277, 0, 0, 0
3684, 1, 1636429968925, 1636429969229, 304, 0, 304, 0, 0, 0
3685, 1, 1636429969049, 1636429969321, 272, 1, 271, 0, 0, 0
3686, 1, 1636429969181, 1636429969462, 281, 0, 281, 0, 0, 0
3687, 1, 1636429969225, 1636429969498, 273, 1, 272, 0, 0, 0
3690, 1, 1636429969401, 1636429969674, 273, 1, 272, 0, 0, 0
3691, 1, 1636429969401, 1636429969677, 276, 1, 275, 0, 0, 0
3688, 1, 1636429969677, 1636429969945, 268, 0, 268, 0, 0, 0
3692, 1, 1636429969805, 1636429970077, 272, 1, 271, 1, 0, 1
3693, 1, 1636429969865, 1636429970133, 268, 1, 267, 1, 0, 1
3694, 1, 1636429969921, 1636429970190, 269, 1, 268, 1, 0, 1
3695, 1, 1636429970026, 1636429970297, 271, 0, 271, 0, 0, 0
3696, 1, 1636429970161, 1636429970429, 268, 1, 267, 1, 0, 1
3697, 1, 1636429970217, 1636429970490, 273, 0, 273, 0, 0, 0
3700, 1, 1636429970385, 1636429970650, 265, 0, 265, 0, 0, 0
3699, 1, 1636429970377, 1636429970650, 273, 0, 273, 0, 0, 0
3698, 1, 1636429970674, 1636429970950, 276, 0, 276, 0, 0, 0
3701, 1, 1636429970785, 1636429971058, 273, 1, 272, 0, 0, 0
3702, 1, 1636429970841, 1636429971109, 268, 1, 267, 1, 0, 1
3703, 1, 1636429970914, 1636429971186, 272, 0, 272, 0, 0, 0
3704, 1, 1636429971005, 1636429971281, 276, 1, 275, 0, 0, 0
3705, 1, 1636429971145, 1636429971414, 269, 1, 268, 0, 0, 0
3706, 1, 1636429971186, 1636429971457, 271, 0, 271, 0, 0, 0
3708, 1, 1636429971390, 1636429971658, 268, 0, 268, 0, 0, 0
3709, 1, 1636429971414, 1636429971685, 271, 0, 271, 0, 0, 0
3707, 1, 1636429971633, 1636429971905, 272, 0, 272, 0, 0, 0
3710, 1, 1636429971762, 1636429972037, 275, 0, 275, 0, 0, 0
3711, 1, 1636429971837, 1636429972110, 273, 1, 272, 1, 0, 1
3712, 1, 1636429971945, 1636429972213, 268, 1, 267, 0, 1, 1
3713, 1, 1636429972025, 1636429972297, 272, 1, 271, 1, 0, 1
3714, 1, 1636429972161, 1636429972434, 273, 0, 273, 0, 0, 0
3715, 1, 1636429972178, 1636429972442, 264, 0, 264, 0, 0, 0
3718, 1, 1636429972413, 1636429972686, 273, 1, 272, 0, 0, 0
3716, 1, 1636429972626, 1636429972898, 272, 0, 272, 0, 0, 0
3719, 1, 1636429972786, 1636429973057, 271, 0, 271, 0, 0, 0
3721, 1, 1636429972965, 1636429973241, 276, 1, 275, 1, 0, 1
3722, 1, 1636429973042, 1636429973314, 272, 0, 272, 0, 0, 0
3723, 1, 1636429973169, 1636429973446, 277, 1, 276, 0, 0, 0
3724, 1, 1636429973425, 1636429973698, 273, 1, 272, 0, 0, 0
3726, 1, 1636429973437, 1636429973709, 272, 1, 271, 0, 0, 0
3725, 1, 1636429973673, 1636429973945, 272, 1, 271, 0, 0, 0
3727, 1, 1636429973806, 1636429974077, 271, 0, 271, 0, 0, 0
3728, 1, 1636429973957, 1636429974229, 272, 1, 271, 0, 0, 0
3729, 1, 1636429974025, 1636429974313, 288, 1, 287, 0, 0, 0
3730, 1, 1636429974066, 1636429974338, 272, 0, 272, 0, 0, 0
3731, 1, 1636429974225, 1636429974497, 272, 1, 271, 0, 0, 0
3732, 1, 1636429974225, 1636429974498, 273, 1, 272, 0, 0, 0
3734, 1, 1636429974441, 1636429974765, 324, 1, 323, 0, 0, 0
3735, 1, 1636429974570, 1636429974857, 287, 0, 287, 0, 0, 0
3733, 1, 1636429974677, 1636429974949, 272, 1, 271, 0, 0, 0
3736, 1, 1636429974809, 1636429975081, 272, 1, 271, 0, 0, 0
3738, 1, 1636429974941, 1636429975213, 272, 1, 271, 0, 0, 0
3739, 1, 1636429974941, 1636429975214, 273, 1, 272, 0, 1, 1
3737, 1, 1636429974986, 1636429975257, 271, 0, 271, 0, 0, 0
3741, 1, 1636429975065, 1636429975338, 273, 1, 272, 0, 0, 0
3742, 1, 1636429975149, 1636429975430, 281, 1, 280, 0, 0, 0
3743, 1, 1636429975173, 1636429975450, 277, 0, 277, 0, 0, 0
3745, 1, 1636429975437, 1636429975710, 273, 1, 272, 0, 0, 0
3746, 1, 1636429975506, 1636429975777, 271, 0, 271, 0, 0, 0
3744, 1, 1636429975626, 1636429975933, 307, 0, 307, 0, 0, 0
3747, 1, 1636429975790, 1636429976057, 267, 0, 267, 0, 0, 0
3748, 1, 1636429975865, 1636429976138, 273, 1, 272, 0, 0, 0
3749, 1, 1636429975933, 1636429976201, 268, 0, 268, 0, 0, 0
3750, 1, 1636429975978, 1636429976277, 299, 0, 299, 0, 0, 0
3751, 1, 1636429976093, 1636429976369, 276, 1, 275, 0, 0, 0
3752, 1, 1636429976138, 1636429976409, 271, 0, 271, 0, 0, 0
3753, 1, 1636429976189, 1636429976457, 268, 0, 268, 0, 0, 0
3661, 1, 1636429976229, 1636429976501, 272, 1, 271, 0, 0, 0
3755, 1, 1636429976325, 1636429976593, 268, 1, 267, 0, 0, 0
3757, 1, 1636429976398, 1636429976673, 275, 0, 275, 0, 0, 0
3759, 1, 1636429976530, 1636429976802, 272, 0, 272, 0, 0, 0
3758, 1, 1636429976541, 1636429976809, 268, 0, 268, 0, 0, 0
3756, 1, 1636429976585, 1636429976853, 268, 0, 268, 0, 0, 0
3754, 1, 1636429976769, 1636429977041, 272, 0, 272, 0, 0, 0
3760, 1, 1636429976805, 1636429977077, 272, 0, 272, 0, 0, 0
3762, 1, 1636429976897, 1636429977166, 269, 0, 269, 0, 0, 0
3763, 1, 1636429976901, 1636429977166, 265, 0, 265, 0, 0, 0
3764, 1, 1636429976941, 1636429977213, 272, 0, 272, 0, 0, 0
3761, 1, 1636429976986, 1636429977253, 267, 0, 267, 0, 0, 0
3766, 1, 1636429977157, 1636429977425, 268, 1, 267, 0, 0, 0
3767, 1, 1636429977217, 1636429977489, 272, 1, 271, 1, 0, 1
3765, 1, 1636429977217, 1636429977493, 276, 1, 275, 1, 0, 1
3768, 1, 1636429977217, 1636429977493, 276, 1, 275, 1, 0, 1
3771, 1, 1636429977433, 1636429977705, 272, 1, 271, 0, 0, 0
3770, 1, 1636429977441, 1636429977709, 268, 0, 268, 0, 0, 0
3772, 1, 1636429977481, 1636429977753, 272, 0, 272, 0, 0, 0
3773, 1, 1636429977525, 1636429977797, 272, 0, 272, 0, 0, 0
3774, 1, 1636429977569, 1636429977837, 268, 1, 267, 0, 1, 1
3769, 1, 1636429977601, 1636429977877, 276, 0, 276, 0, 0, 0
3775, 1, 1636429977789, 1636429978061, 272, 0, 272, 0, 0, 0
3779, 1, 1636429977906, 1636429978177, 271, 0, 271, 0, 0, 0
3778, 1, 1636429977906, 1636429978177, 271, 0, 271, 0, 0, 0
3780, 1, 1636429978105, 1636429978377, 272, 0, 272, 0, 0, 0
3781, 1, 1636429978149, 1636429978418, 269, 1, 268, 0, 0, 0
3782, 1, 1636429978185, 1636429978449, 264, 0, 264, 0, 0, 0
3783, 1, 1636429978222, 1636429978494, 272, 0, 272, 0, 0, 0
3785, 1, 1636429978393, 1636429978661, 268, 1, 267, 1, 0, 1
3786, 1, 1636429978402, 1636429978674, 272, 0, 272, 0, 0, 0
3788, 1, 1636429978493, 1636429978765, 272, 1, 271, 0, 0, 0
3787, 1, 1636429978493, 1636429978765, 272, 1, 271, 0, 0, 0
3789, 1, 1636429978517, 1636429978789, 272, 0, 272, 0, 0, 0
3784, 1, 1636429978593, 1636429978869, 276, 1, 275, 0, 0, 0
3790, 1, 1636429978797, 1636429979065, 268, 1, 267, 1, 0, 1
3792, 1, 1636429978885, 1636429979158, 273, 1, 272, 1, 0, 1
3791, 1, 1636429978885, 1636429979158, 273, 1, 272, 1, 0, 1
3793, 1, 1636429979105, 1636429979378, 273, 0, 273, 0, 0, 0
3794, 1, 1636429979149, 1636429979437, 288, 1, 287, 0, 0, 0
3797, 1, 1636429979221, 1636429979525, 304, 1, 303, 0, 1, 1
3796, 1, 1636429979217, 1636429979525, 308, 1, 307, 0, 1, 1
3795, 1, 1636429979237, 1636429979525, 288, 1, 287, 0, 0, 0
3799, 1, 1636429979385, 1636429979661, 276, 0, 276, 0, 0, 0
3740, 1, 1636429979397, 1636429979669, 272, 0, 272, 0, 0, 0
3800, 1, 1636429979433, 1636429979705, 272, 0, 272, 0, 0, 0
3803, 1, 1636429979489, 1636429979762, 273, 1, 272, 0, 1, 1
3801, 1, 1636429979485, 1636429979762, 277, 0, 277, 0, 0, 0
3802, 1, 1636429979489, 1636429979769, 280, 1, 279, 1, 0, 1
3798, 1, 1636429979617, 1636429979889, 272, 1, 271, 0, 0, 0
3804, 1, 1636429979705, 1636429979981, 276, 1, 275, 0, 0, 0
3805, 1, 1636429979782, 1636429980054, 272, 0, 272, 0, 0, 0
3807, 1, 1636429979877, 1636429980145, 268, 1, 267, 1, 0, 1
3806, 1, 1636429979877, 1636429980149, 272, 1, 271, 0, 1, 1
3809, 1, 1636429980133, 1636429980397, 264, 0, 264, 0, 0, 0
3810, 1, 1636429980141, 1636429980409, 268, 0, 268, 0, 0, 0
3808, 1, 1636429980153, 1636429980421, 268, 0, 268, 0, 0, 0
3811, 1, 1636429980177, 1636429980445, 268, 1, 267, 0, 1, 1
3812, 1, 1636429980245, 1636429980514, 269, 1, 268, 1, 0, 1
3813, 1, 1636429980245, 1636429980514, 269, 1, 268, 0, 1, 1
3815, 1, 1636429980349, 1636429980621, 272, 0, 272, 0, 0, 0
3816, 1, 1636429980401, 1636429980666, 265, 0, 265, 0, 0, 0
3817, 1, 1636429980437, 1636429980709, 272, 0, 272, 0, 0, 0
3819, 1, 1636429980481, 1636429980750, 269, 1, 268, 1, 0, 1
3818, 1, 1636429980481, 1636429980750, 269, 1, 268, 0, 0, 0
3814, 1, 1636429980589, 1636429980865, 276, 1, 275, 0, 1, 1
3820, 1, 1636429980629, 1636429980897, 268, 0, 268, 0, 0, 0
3822, 1, 1636429980869, 1636429981141, 272, 0, 272, 0, 0, 0
3823, 1, 1636429980917, 1636429981193, 276, 0, 276, 0, 0, 0
3824, 1, 1636429981082, 1636429981353, 271, 0, 271, 0, 0, 0
3825, 1, 1636429981137, 1636429981409, 272, 1, 271, 0, 1, 1
3826, 1, 1636429981145, 1636429981421, 276, 0, 276, 0, 0, 0
3827, 1, 1636429981166, 1636429981437, 271, 0, 271, 0, 0, 0
3828, 1, 1636429981229, 1636429981493, 264, 0, 264, 0, 0, 0
3829, 1, 1636429981273, 1636429981557, 284, 1, 283, 0, 1, 1
3831, 1, 1636429981353, 1636429981629, 276, 1, 275, 0, 1, 1
3833, 1, 1636429981397, 1636429981673, 276, 0, 276, 0, 0, 0
3834, 1, 1636429981458, 1636429981733, 275, 0, 275, 0, 0, 0
3835, 1, 1636429981473, 1636429981741, 268, 1, 267, 0, 0, 0
3830, 1, 1636429981601, 1636429981874, 273, 0, 273, 0, 0, 0
3836, 1, 1636429981617, 1636429981885, 268, 0, 268, 0, 0, 0
3832, 1, 1636429981853, 1636429982121, 268, 1, 267, 0, 1, 1
3837, 1, 1636429981882, 1636429982149, 267, 0, 267, 0, 0, 0
3838, 1, 1636429981901, 1636429982169, 268, 0, 268, 0, 0, 0
3839, 1, 1636429982062, 1636429982333, 271, 0, 271, 0, 0, 0
3840, 1, 1636429982137, 1636429982429, 292, 0, 292, 0, 0, 0
3841, 1, 1636429982161, 1636429982441, 280, 1, 279, 1, 0, 1
3842, 1, 1636429982181, 1636429982453, 272, 1, 271, 0, 1, 1
3843, 1, 1636429982221, 1636429982521, 300, 1, 299, 0, 0, 0
3844, 1, 1636429982242, 1636429982521, 279, 0, 279, 0, 0, 0
3846, 1, 1636429982341, 1636429982613, 272, 0, 272, 0, 0, 0
3720, 1, 1636429982382, 1636429982649, 267, 0, 267, 0, 0, 0
3847, 1, 1636429982425, 1636429982693, 268, 0, 268, 0, 0, 0
3848, 1, 1636429982474, 1636429982749, 275, 0, 275, 0, 0, 0
3849, 1, 1636429982513, 1636429982785, 272, 0, 272, 0, 0, 0
3850, 1, 1636429982557, 1636429982837, 280, 1, 279, 0, 0, 0
3851, 1, 1636429982625, 1636429982893, 268, 0, 268, 0, 0, 0
3845, 1, 1636429982621, 1636429982897, 276, 1, 275, 0, 0, 0
3852, 1, 1636429982689, 1636429982961, 272, 0, 272, 0, 0, 0
3853, 1, 1636429982865, 1636429983133, 268, 1, 267, 1, 0, 1
3854, 1, 1636429982873, 1636429983142, 269, 1, 268, 0, 0, 0
3856, 1, 1636429983073, 1636429983341, 268, 1, 267, 0, 0, 0
3855, 1, 1636429983142, 1636429983409, 267, 0, 267, 0, 0, 0
3857, 1, 1636429983142, 1636429983409, 267, 0, 267, 0, 0, 0
3859, 1, 1636429983169, 1636429983445, 276, 1, 275, 1, 0, 1
3858, 1, 1636429983169, 1636429983446, 277, 1, 276, 1, 0, 1
3860, 1, 1636429983213, 1636429983481, 268, 0, 268, 0, 0, 0
3861, 1, 1636429983233, 1636429983501, 268, 0, 268, 0, 0, 0
3863, 1, 1636429983361, 1636429983629, 268, 0, 268, 0, 0, 0
3864, 1, 1636429983373, 1636429983649, 276, 0, 276, 0, 0, 0
3865, 1, 1636429983461, 1636429983733, 272, 1, 271, 1, 0, 1
3866, 1, 1636429983461, 1636429983733, 272, 1, 271, 0, 1, 1
3868, 1, 1636429983601, 1636429983869, 268, 0, 268, 0, 0, 0
3869, 1, 1636429983626, 1636429983901, 275, 0, 275, 0, 0, 0
3862, 1, 1636429983626, 1636429983901, 275, 0, 275, 0, 0, 0
3867, 1, 1636429983809, 1636429984085, 276, 1, 275, 0, 0, 0
3870, 1, 1636429983881, 1636429984153, 272, 1, 271, 0, 1, 1
3871, 1, 1636429983893, 1636429984166, 273, 1, 272, 0, 1, 1
3872, 1, 1636429984045, 1636429984317, 272, 0, 272, 0, 0, 0
3873, 1, 1636429984085, 1636429984357, 272, 0, 272, 0, 0, 0
3874, 1, 1636429984157, 1636429984429, 272, 0, 272, 0, 0, 0
3875, 1, 1636429984166, 1636429984442, 276, 0, 276, 0, 0, 0
3876, 1, 1636429984169, 1636429984442, 273, 1, 272, 0, 1, 1
3877, 1, 1636429984221, 1636429984489, 268, 1, 267, 0, 0, 0
3878, 1, 1636429984221, 1636429984489, 268, 1, 267, 1, 0, 1
3880, 1, 1636429984401, 1636429984665, 264, 0, 264, 0, 0, 0
3881, 1, 1636429984397, 1636429984665, 268, 1, 267, 0, 1, 1
3882, 1, 1636429984469, 1636429984741, 272, 1, 271, 0, 1, 1
3883, 1, 1636429984477, 1636429984745, 268, 0, 268, 0, 0, 0
3884, 1, 1636429984493, 1636429984757, 264, 0, 264, 0, 0, 0
3879, 1, 1636429984610, 1636429984881, 271, 0, 271, 0, 0, 0
3885, 1, 1636429984617, 1636429984885, 268, 0, 268, 0, 0, 0
3886, 1, 1636429984610, 1636429984885, 275, 0, 275, 0, 0, 0
3887, 1, 1636429984901, 1636429985177, 276, 0, 276, 0, 0, 0
3888, 1, 1636429984909, 1636429985185, 276, 0, 276, 0, 0, 0
3890, 1, 1636429985069, 1636429985341, 272, 1, 271, 1, 0, 1
3889, 1, 1636429985069, 1636429985341, 272, 1, 271, 0, 0, 0
3891, 1, 1636429985137, 1636429985409, 272, 0, 272, 0, 0, 0
3892, 1, 1636429985161, 1636429985433, 272, 0, 272, 0, 0, 0
3893, 1, 1636429985173, 1636429985453, 280, 0, 280, 0, 0, 0
3894, 1, 1636429985205, 1636429985473, 268, 1, 267, 0, 0, 0
3895, 1, 1636429985213, 1636429985493, 280, 1, 279, 0, 0, 0
3897, 1, 1636429985409, 1636429985685, 276, 1, 275, 1, 0, 1
3899, 1, 1636429985433, 1636429985705, 272, 1, 271, 0, 1, 1
3898, 1, 1636429985433, 1636429985713, 280, 1, 279, 0, 1, 1
3901, 1, 1636429985501, 1636429985773, 272, 0, 272, 0, 0, 0
3900, 1, 1636429985501, 1636429985773, 272, 1, 271, 0, 0, 0
3902, 1, 1636429985585, 1636429985857, 272, 0, 272, 0, 0, 0
3903, 1, 1636429985585, 1636429985861, 276, 1, 275, 0, 1, 1
3896, 1, 1636429985629, 1636429985901, 272, 0, 272, 0, 0, 0
3904, 1, 1636429985889, 1636429986161, 272, 1, 271, 0, 1, 1
3905, 1, 1636429985901, 1636429986177, 276, 0, 276, 0, 0, 0
3907, 1, 1636429986038, 1636429986310, 272, 0, 272, 0, 0, 0
3906, 1, 1636429986038, 1636429986310, 272, 0, 272, 0, 0, 0
3909, 1, 1636429986145, 1636429986425, 280, 1, 279, 0, 1, 1
3908, 1, 1636429986145, 1636429986425, 280, 1, 279, 1, 0, 1
3912, 1, 1636429986189, 1636429986458, 269, 0, 269, 0, 0, 0
3910, 1, 1636429986181, 1636429986458, 277, 0, 277, 0, 0, 0
3911, 1, 1636429986197, 1636429986465, 268, 1, 267, 0, 0, 0
3915, 1, 1636429986409, 1636429986678, 269, 0, 269, 0, 0, 0
3914, 1, 1636429986401, 1636429986678, 277, 0, 277, 0, 0, 0
3916, 1, 1636429986433, 1636429986697, 264, 0, 264, 0, 0, 0
3917, 1, 1636429986461, 1636429986737, 276, 1, 275, 0, 1, 1
3918, 1, 1636429986525, 1636429986789, 264, 1, 263, 0, 0, 0
3913, 1, 1636429986609, 1636429986882, 273, 1, 272, 1, 0, 1
3919, 1, 1636429986609, 1636429986882, 273, 1, 272, 1, 0, 1
3922, 1, 1636429986913, 1636429987185, 272, 1, 271, 1, 0, 1
3924, 1, 1636429987057, 1636429987329, 272, 1, 271, 0, 0, 0
3925, 1, 1636429987121, 1636429987393, 272, 1, 271, 1, 0, 1
3927, 1, 1636429987157, 1636429987426, 269, 1, 268, 0, 1, 1
3926, 1, 1636429987149, 1636429987426, 277, 1, 276, 0, 0, 0
3928, 1, 1636429987185, 1636429987457, 272, 1, 271, 0, 1, 1
3929, 1, 1636429987225, 1636429987497, 272, 1, 271, 0, 1, 1
3931, 1, 1636429987405, 1636429987669, 264, 1, 263, 0, 0, 0
3932, 1, 1636429987409, 1636429987677, 268, 0, 268, 0, 0, 0
3934, 1, 1636429987450, 1636429987726, 276, 0, 276, 0, 0, 0
3933, 1, 1636429987509, 1636429987782, 273, 1, 272, 1, 0, 1
3935, 1, 1636429987557, 1636429987833, 276, 1, 275, 0, 0, 0
3936, 1, 1636429987573, 1636429987841, 268, 1, 267, 0, 0, 0
3930, 1, 1636429987601, 1636429987961, 360, 1, 359, 0, 1, 1
3921, 1, 1636429987961, 1636429988233, 272, 1, 271, 0, 1, 1
3937, 1, 1636429988056, 1636429988321, 265, 1, 264, 1, 0, 1
3938, 1, 1636429988089, 1636429988361, 272, 1, 271, 0, 0, 0
3939, 1, 1636429988121, 1636429988397, 276, 1, 275, 0, 0, 0
3940, 1, 1636429988153, 1636429988421, 268, 1, 267, 0, 0, 0
3941, 1, 1636429988185, 1636429988453, 268, 0, 268, 0, 0, 0
3944, 1, 1636429988217, 1636429988493, 276, 0, 276, 0, 0, 0
3942, 1, 1636429988237, 1636429988509, 272, 0, 272, 0, 0, 0
3943, 1, 1636429988249, 1636429988513, 264, 1, 263, 1, 0, 1
3946, 1, 1636429988365, 1636429988637, 272, 0, 272, 0, 0, 0
3947, 1, 1636429988377, 1636429988645, 268, 1, 267, 1, 0, 1
3948, 1, 1636429988429, 1636429988697, 268, 1, 267, 1, 0, 1
3949, 1, 1636429988453, 1636429988725, 272, 1, 271, 0, 1, 1
3950, 1, 1636429988545, 1636429988809, 264, 0, 264, 0, 0, 0
3945, 1, 1636429988577, 1636429988849, 272, 1, 271, 0, 0, 0
3951, 1, 1636429988633, 1636429988906, 273, 0, 273, 0, 0, 0
3952, 1, 1636429988989, 1636429989257, 268, 0, 268, 0, 0, 0
3953, 1, 1636429989098, 1636429989365, 267, 0, 267, 0, 0, 0
3954, 1, 1636429989125, 1636429989393, 268, 1, 267, 1, 0, 1
3957, 1, 1636429989157, 1636429989421, 264, 1, 263, 1, 0, 1
3956, 1, 1636429989157, 1636429989425, 268, 1, 267, 1, 0, 1
3959, 1, 1636429989190, 1636429989453, 263, 0, 263, 0, 0, 0
3961, 1, 1636429989405, 1636429989678, 273, 1, 272, 1, 0, 1
3962, 1, 1636429989417, 1636429989681, 264, 0, 264, 0, 0, 0
3963, 1, 1636429989429, 1636429989706, 277, 0, 277, 0, 0, 0
3964, 1, 1636429989457, 1636429989729, 272, 0, 272, 0, 0, 0
3965, 1, 1636429989557, 1636429989829, 272, 1, 271, 1, 0, 1
3966, 1, 1636429989581, 1636429989853, 272, 1, 271, 0, 0, 0
3967, 1, 1636429990033, 1636429990309, 276, 0, 276, 0, 0, 0
3968, 1, 1636429990065, 1636429990337, 272, 0, 272, 0, 0, 0
3969, 1, 1636429990137, 1636429990402, 265, 1, 264, 0, 1, 1
3970, 1, 1636429990149, 1636429990421, 272, 1, 271, 0, 1, 1
3972, 1, 1636429990222, 1636429990493, 271, 0, 271, 0, 0, 0
3973, 1, 1636429990397, 1636429990669, 272, 0, 272, 0, 0, 0
3974, 1, 1636429990409, 1636429990685, 276, 0, 276, 0, 0, 0
3975, 1, 1636429990425, 1636429990689, 264, 1, 263, 0, 0, 0
3971, 1, 1636429990585, 1636429990862, 277, 1, 276, 0, 1, 1
3976, 1, 1636429990545, 1636429990862, 317, 1, 316, 1, 0, 1
3978, 1, 1636429991041, 1636429991309, 268, 0, 268, 0, 0, 0
3980, 1, 1636429991086, 1636429991354, 268, 0, 268, 0, 0, 0
3979, 1, 1636429991117, 1636429991385, 268, 0, 268, 0, 0, 0
3981, 1, 1636429991125, 1636429991389, 264, 1, 263, 1, 0, 1
3982, 1, 1636429991169, 1636429991433, 264, 1, 263, 0, 0, 0
3983, 1, 1636429991250, 1636429991521, 271, 0, 271, 0, 0, 0
3984, 1, 1636429991250, 1636429991521, 271, 0, 271, 0, 0, 0
3985, 1, 1636429991417, 1636429991690, 273, 0, 273, 0, 0, 0
3986, 1, 1636429991425, 1636429991693, 268, 1, 267, 0, 0, 0
3987, 1, 1636429991433, 1636429991706, 273, 1, 272, 0, 1, 1
3988, 1, 1636429991549, 1636429991821, 272, 0, 272, 0, 0, 0
3989, 1, 1636429992005, 1636429992281, 276, 1, 275, 0, 0, 0
3990, 1, 1636429992065, 1636429992337, 272, 1, 271, 0, 0, 0
3992, 1, 1636429992105, 1636429992373, 268, 0, 268, 0, 0, 0
3991, 1, 1636429992101, 1636429992377, 276, 0, 276, 0, 0, 0
3993, 1, 1636429992169, 1636429992446, 277, 1, 276, 0, 1, 1
3994, 1, 1636429992205, 1636429992477, 272, 0, 272, 0, 0, 0
3995, 1, 1636429992249, 1636429992521, 272, 1, 271, 0, 0, 0
3996, 1, 1636429992413, 1636429992681, 268, 1, 267, 0, 0, 0
3997, 1, 1636429992433, 1636429992697, 264, 0, 264, 0, 0, 0
3998, 1, 1636429992437, 1636429992705, 268, 0, 268, 0, 0, 0
3999, 1, 1636429992549, 1636429992821, 272, 0, 272, 0, 0, 0
4000, 1, 1636429993001, 1636429993274, 273, 0, 273, 0, 0, 0
4001, 1, 1636429993089, 1636429993365, 276, 1, 275, 0, 0, 0
4002, 1, 1636429993089, 1636429993365, 276, 1, 275, 0, 0, 0
4003, 1, 1636429993141, 1636429993409, 268, 0, 268, 0, 0, 0
4004, 1, 1636429993145, 1636429993433, 288, 0, 288, 0, 0, 0
4005, 1, 1636429993205, 1636429993477, 272, 0, 272, 0, 0, 0
4006, 1, 1636429993213, 1636429993485, 272, 1, 271, 1, 0, 1
4007, 1, 1636429993381, 1636429993653, 272, 0, 272, 0, 0, 0
4008, 1, 1636429993417, 1636429993685, 268, 0, 268, 0, 0, 0
4009, 1, 1636429993449, 1636429993722, 273, 0, 273, 0, 0, 0
4010, 1, 1636429993541, 1636429993813, 272, 0, 272, 0, 0, 0
4011, 1, 1636429993993, 1636429994265, 272, 1, 271, 0, 0, 0
4012, 1, 1636429994069, 1636429994341, 272, 1, 271, 0, 1, 1
4013, 1, 1636429994105, 1636429994382, 277, 0, 277, 0, 0, 0
4014, 1, 1636429994105, 1636429994382, 277, 1, 276, 0, 0, 0
4015, 1, 1636429994121, 1636429994397, 276, 0, 276, 0, 0, 0
4016, 1, 1636429994181, 1636429994458, 277, 1, 276, 0, 0, 0
4017, 1, 1636429994205, 1636429994481, 276, 1, 275, 1, 0, 1
4019, 1, 1636429994389, 1636429994662, 273, 1, 272, 0, 0, 0
4018, 1, 1636429994390, 1636429994665, 275, 0, 275, 0, 0, 0
4020, 1, 1636429994433, 1636429994705, 272, 0, 272, 0, 0, 0
4021, 1, 1636429994573, 1636429994841, 268, 1, 267, 0, 0, 0
4022, 1, 1636429995021, 1636429995293, 272, 0, 272, 0, 0, 0
4023, 1, 1636429995041, 1636429995317, 276, 0, 276, 0, 0, 0
4024, 1, 1636429995117, 1636429995390, 273, 1, 272, 0, 0, 0
4026, 1, 1636429995129, 1636429995405, 276, 1, 275, 0, 0, 0
4025, 1, 1636429995129, 1636429995409, 280, 1, 279, 0, 1, 1
4027, 1, 1636429995169, 1636429995437, 268, 1, 267, 0, 1, 1
4028, 1, 1636429995237, 1636429995509, 272, 1, 271, 0, 0, 0
4029, 1, 1636429995361, 1636429995626, 265, 1, 264, 0, 0, 0
4030, 1, 1636429995365, 1636429995629, 264, 1, 263, 0, 0, 0
4031, 1, 1636429995445, 1636429995717, 272, 1, 271, 0, 0, 0
4032, 1, 1636429995589, 1636429995862, 273, 1, 272, 0, 0, 0
4034, 1, 1636429996037, 1636429996309, 272, 1, 271, 1, 0, 1
4033, 1, 1636429996042, 1636429996313, 271, 0, 271, 0, 0, 0
4035, 1, 1636429996101, 1636429996377, 276, 0, 276, 0, 0, 0
4036, 1, 1636429996133, 1636429996406, 273, 0, 273, 0, 0, 0
4037, 1, 1636429996153, 1636429996425, 272, 1, 271, 0, 0, 0
4038, 1, 1636429996189, 1636429996465, 276, 1, 275, 0, 0, 0
4039, 1, 1636429996257, 1636429996529, 272, 1, 271, 1, 0, 1
4040, 1, 1636429996326, 1636429996601, 275, 0, 275, 0, 0, 0
4041, 1, 1636429996381, 1636429996665, 284, 0, 284, 0, 0, 0
4042, 1, 1636429996417, 1636429996694, 277, 1, 276, 0, 0, 0
4043, 1, 1636429996577, 1636429996850, 273, 1, 272, 0, 0, 0
4044, 1, 1636429996954, 1636429997229, 275, 0, 275, 0, 0, 0
4045, 1, 1636429997029, 1636429997305, 276, 1, 275, 0, 0, 0
4046, 1, 1636429997041, 1636429997321, 280, 1, 279, 0, 0, 0
4049, 1, 1636429997133, 1636429997406, 273, 1, 272, 1, 0, 1
4048, 1, 1636429997133, 1636429997406, 273, 1, 272, 0, 1, 1
4047, 1, 1636429997133, 1636429997413, 280, 1, 279, 1, 0, 1
4050, 1, 1636429997213, 1636429997481, 268, 1, 267, 1, 0, 1
4051, 1, 1636429997233, 1636429997506, 273, 0, 273, 0, 0, 0
4054, 1, 1636429997373, 1636429997645, 272, 0, 272, 0, 0, 0
4052, 1, 1636429997409, 1636429997686, 277, 0, 277, 0, 0, 0
4055, 1, 1636429997441, 1636429997714, 273, 1, 272, 0, 0, 0
4056, 1, 1636429997581, 1636429997853, 272, 1, 271, 0, 0, 0
4057, 1, 1636429997849, 1636429998122, 273, 1, 272, 1, 0, 1
4058, 1, 1636429998033, 1636429998305, 272, 1, 271, 0, 1, 1
4059, 1, 1636429998033, 1636429998309, 276, 1, 275, 1, 0, 1
4060, 1, 1636429998097, 1636429998361, 264, 0, 264, 0, 0, 0
4061, 1, 1636429998149, 1636429998425, 276, 0, 276, 0, 0, 0
4062, 1, 1636429998165, 1636429998433, 268, 1, 267, 0, 0, 0
4063, 1, 1636429998177, 1636429998449, 272, 0, 272, 0, 0, 0
4064, 1, 1636429998205, 1636429998477, 272, 1, 271, 0, 0, 0
4065, 1, 1636429998297, 1636429998565, 268, 1, 267, 0, 0, 0
4066, 1, 1636429998373, 1636429998642, 269, 1, 268, 0, 0, 0
4067, 1, 1636429998441, 1636429998714, 273, 0, 273, 0, 0, 0
4068, 1, 1636429998545, 1636429998817, 272, 1, 271, 0, 0, 0
4069, 1, 1636429998877, 1636429999149, 272, 1, 271, 1, 0, 1
4070, 1, 1636429998997, 1636429999385, 388, 1, 387, 0, 0, 0
4071, 1, 1636429999010, 1636429999389, 379, 0, 379, 0, 0, 0
4073, 1, 1636429999165, 1636429999481, 316, 1, 315, 0, 0, 0
4072, 1, 1636429999165, 1636429999481, 316, 1, 315, 0, 0, 0
4076, 1, 1636429999297, 1636429999565, 268, 0, 268, 0, 0, 0
4075, 1, 1636429999301, 1636429999569, 268, 0, 268, 0, 0, 0
4074, 1, 1636429999301, 1636429999569, 268, 1, 267, 0, 0, 0
4077, 1, 1636429999321, 1636429999590, 269, 0, 269, 0, 0, 0
4078, 1, 1636429999385, 1636429999653, 268, 0, 268, 0, 0, 0
4079, 1, 1636429999429, 1636429999694, 265, 1, 264, 0, 0, 0
4081, 1, 1636429999473, 1636429999745, 272, 1, 271, 0, 1, 1
4080, 1, 1636429999509, 1636429999789, 280, 0, 280, 0, 0, 0
4082, 1, 1636429999661, 1636429999933, 272, 1, 271, 0, 1, 1
4084, 1, 1636429999854, 1636430000125, 271, 0, 271, 0, 0, 0
4083, 1, 1636429999929, 1636430000205, 276, 1, 275, 0, 0, 0
4085, 1, 1636430000013, 1636430000285, 272, 1, 271, 0, 0, 0
4086, 1, 1636430000117, 1636430000385, 268, 1, 267, 1, 0, 1
4087, 1, 1636430000117, 1636430000389, 272, 1, 271, 0, 1, 1
4089, 1, 1636430000153, 1636430000426, 273, 0, 273, 0, 0, 0
4090, 1, 1636430000177, 1636430000449, 272, 1, 271, 0, 0, 0
4091, 1, 1636430000297, 1636430000570, 273, 0, 273, 0, 0, 0
4092, 1, 1636430000333, 1636430000633, 300, 0, 300, 0, 0, 0
4093, 1, 1636430000389, 1636430000657, 268, 0, 268, 0, 0, 0
4094, 1, 1636430000389, 1636430000661, 272, 1, 271, 1, 0, 1
4095, 1, 1636430000413, 1636430000721, 308, 0, 308, 0, 0, 0
4096, 1, 1636430000625, 1636430000901, 276, 1, 275, 0, 0, 0
4097, 1, 1636430000625, 1636430000901, 276, 1, 275, 0, 0, 0
4098, 1, 1636430000830, 1636430001101, 271, 0, 271, 0, 0, 0
4099, 1, 1636430000889, 1636430001158, 269, 1, 268, 0, 0, 0
4100, 1, 1636430000981, 1636430001249, 268, 1, 267, 0, 0, 0
4102, 1, 1636430001085, 1636430001357, 272, 1, 271, 0, 0, 0
4101, 1, 1636430001085, 1636430001358, 273, 1, 272, 1, 0, 1
4103, 1, 1636430001157, 1636430001421, 264, 1, 263, 0, 0, 0
4104, 1, 1636430001181, 1636430001449, 268, 1, 267, 0, 0, 0
4105, 1, 1636430001286, 1636430001557, 271, 0, 271, 0, 0, 0
4106, 1, 1636430001337, 1636430001605, 268, 0, 268, 0, 0, 0
4108, 1, 1636430001393, 1636430001662, 269, 0, 269, 0, 0, 0
4107, 1, 1636430001389, 1636430001662, 273, 1, 272, 0, 0, 0
4109, 1, 1636430001437, 1636430001705, 268, 1, 267, 0, 0, 0
4111, 1, 1636430001557, 1636430001826, 269, 1, 268, 0, 0, 0
4110, 1, 1636430001554, 1636430001826, 272, 0, 272, 0, 0, 0
4112, 1, 1636430001781, 1636430002049, 268, 0, 268, 0, 0, 0
4113, 1, 1636430001825, 1636430002097, 272, 1, 271, 0, 0, 0
4114, 1, 1636430001989, 1636430002257, 268, 0, 268, 0, 0, 0
4115, 1, 1636430002005, 1636430002273, 268, 0, 268, 0, 0, 0
4116, 1, 1636430002093, 1636430002361, 268, 1, 267, 0, 0, 0
4118, 1, 1636430002166, 1636430002441, 275, 0, 275, 0, 0, 0
4117, 1, 1636430002166, 1636430002445, 279, 0, 279, 0, 0, 0
4119, 1, 1636430002273, 1636430002549, 276, 1, 275, 0, 0, 0
4120, 1, 1636430002305, 1636430002577, 272, 1, 271, 0, 0, 0
4121, 1, 1636430002365, 1636430002638, 273, 1, 272, 0, 1, 1
4122, 1, 1636430002397, 1636430002670, 273, 0, 273, 0, 0, 0
4123, 1, 1636430002409, 1636430002674, 265, 0, 265, 0, 0, 0
4124, 1, 1636430002557, 1636430002825, 268, 1, 267, 1, 0, 1
4125, 1, 1636430002594, 1636430002866, 272, 0, 272, 0, 0, 0
4126, 1, 1636430002765, 1636430003038, 273, 1, 272, 1, 0, 1
4127, 1, 1636430002821, 1636430003093, 272, 1, 271, 1, 0, 1
4128, 1, 1636430003013, 1636430003285, 272, 1, 271, 0, 0, 0
4129, 1, 1636430003133, 1636430003405, 272, 1, 271, 0, 0, 0
4130, 1, 1636430003161, 1636430003433, 272, 1, 271, 0, 0, 0
4131, 1, 1636430003185, 1636430003458, 273, 1, 272, 0, 0, 0
4132, 1, 1636430003277, 1636430003545, 268, 1, 267, 0, 0, 0
4133, 1, 1636430003285, 1636430003549, 264, 1, 263, 0, 0, 0
4134, 1, 1636430003349, 1636430003617, 268, 1, 267, 1, 0, 1
4135, 1, 1636430003378, 1636430003637, 259, 0, 259, 0, 0, 0
4136, 1, 1636430003413, 1636430003681, 268, 1, 267, 1, 0, 1
4137, 1, 1636430003581, 1636430003850, 269, 1, 268, 1, 0, 1
4138, 1, 1636430003585, 1636430003853, 268, 1, 267, 0, 0, 0
4140, 1, 1636430003793, 1636430004065, 272, 0, 272, 0, 0, 0
4139, 1, 1636430004025, 1636430004293, 268, 1, 267, 0, 0, 0
4142, 1, 1636430004105, 1636430004373, 268, 1, 267, 0, 0, 0
4143, 1, 1636430004169, 1636430004441, 272, 1, 271, 0, 0, 0
4145, 1, 1636430004205, 1636430004469, 264, 0, 264, 0, 0, 0
4144, 1, 1636430004249, 1636430004517, 268, 1, 267, 0, 0, 0
4147, 1, 1636430004337, 1636430004605, 268, 0, 268, 0, 0, 0
4148, 1, 1636430004377, 1636430004650, 273, 0, 273, 0, 0, 0
4149, 1, 1636430004405, 1636430004674, 269, 1, 268, 0, 0, 0
4150, 1, 1636430004574, 1636430004846, 272, 0, 272, 0, 0, 0
4151, 1, 1636430004589, 1636430004861, 272, 0, 272, 0, 0, 0
4152, 1, 1636430004757, 1636430005029, 272, 0, 272, 0, 0, 0
4153, 1, 1636430004770, 1636430005049, 279, 0, 279, 0, 0, 0
4154, 1, 1636430005085, 1636430005358, 273, 1, 272, 0, 0, 0
4155, 1, 1636430005137, 1636430005405, 268, 1, 267, 1, 0, 1
4157, 1, 1636430005205, 1636430005478, 273, 1, 272, 1, 0, 1
4156, 1, 1636430005225, 1636430005497, 272, 1, 271, 0, 0, 0
4158, 1, 1636430005321, 1636430005589, 268, 0, 268, 0, 0, 0
4159, 1, 1636430005358, 1636430005626, 268, 0, 268, 0, 0, 0
4160, 1, 1636430005381, 1636430005646, 265, 0, 265, 0, 0, 0
4161, 1, 1636430005558, 1636430005829, 271, 0, 271, 0, 0, 0
4162, 1, 1636430005585, 1636430005857, 272, 0, 272, 0, 0, 0
4164, 1, 1636430005765, 1636430006033, 268, 1, 267, 0, 0, 0
4163, 1, 1636430005805, 1636430006078, 273, 0, 273, 0, 0, 0
4165, 1, 1636430006110, 1636430006381, 271, 0, 271, 0, 0, 0
4167, 1, 1636430006141, 1636430006417, 276, 0, 276, 0, 0, 0
4166, 1, 1636430006213, 1636430006481, 268, 1, 267, 0, 0, 0
4168, 1, 1636430006226, 1636430006493, 267, 0, 267, 0, 0, 0
4169, 1, 1636430006301, 1636430006573, 272, 1, 271, 0, 0, 0
4170, 1, 1636430006366, 1636430006638, 272, 0, 272, 0, 0, 0
4171, 1, 1636430006417, 1636430006685, 268, 0, 268, 0, 0, 0
4172, 1, 1636430006573, 1636430006838, 265, 0, 265, 0, 0, 0
4173, 1, 1636430006597, 1636430006870, 273, 0, 273, 0, 0, 0
4174, 1, 1636430006745, 1636430007017, 272, 1, 271, 0, 0, 0
4175, 1, 1636430006777, 1636430007054, 277, 1, 276, 0, 1, 1
4176, 1, 1636430007101, 1636430007377, 276, 1, 275, 0, 1, 1
4177, 1, 1636430007197, 1636430007470, 273, 1, 272, 0, 0, 0
4180, 1, 1636430007289, 1636430007561, 272, 1, 271, 0, 0, 0
4179, 1, 1636430007289, 1636430007565, 276, 1, 275, 0, 1, 1
4088, 1, 1636430007329, 1636430007602, 273, 0, 273, 0, 0, 0
4182, 1, 1636430007425, 1636430007701, 276, 1, 275, 1, 0, 1
4181, 1, 1636430007425, 1636430007701, 276, 1, 275, 1, 0, 1
4183, 1, 1636430007561, 1636430007833, 272, 1, 271, 0, 1, 1
4184, 1, 1636430007629, 1636430007901, 272, 1, 271, 0, 0, 0
4185, 1, 1636430007625, 1636430007901, 276, 1, 275, 1, 0, 1
4186, 1, 1636430007745, 1636430008017, 272, 0, 272, 0, 0, 0
4187, 1, 1636430007782, 1636430008054, 272, 0, 272, 0, 0, 0
4188, 1, 1636430008009, 1636430008285, 276, 0, 276, 0, 0, 0
4189, 1, 1636430008126, 1636430008397, 271, 0, 271, 0, 0, 0
4190, 1, 1636430008197, 1636430008466, 269, 1, 268, 0, 0, 0
4191, 1, 1636430008258, 1636430008530, 272, 0, 272, 0, 0, 0
4192, 1, 1636430008261, 1636430008537, 276, 1, 275, 0, 0, 0
4193, 1, 1636430008357, 1636430008630, 273, 0, 273, 0, 0, 0
4194, 1, 1636430008405, 1636430008674, 269, 0, 269, 0, 0, 0
4195, 1, 1636430008553, 1636430008821, 268, 1, 267, 0, 0, 0
4196, 1, 1636430008585, 1636430008854, 269, 0, 269, 0, 0, 0
4197, 1, 1636430008610, 1636430008877, 267, 0, 267, 0, 0, 0
4198, 1, 1636430008790, 1636430009057, 267, 0, 267, 0, 0, 0
4199, 1, 1636430008965, 1636430009238, 273, 1, 272, 0, 1, 1
4200, 1, 1636430009109, 1636430009377, 268, 0, 268, 0, 0, 0
4201, 1, 1636430009230, 1636430009506, 276, 0, 276, 0, 0, 0
4202, 1, 1636430009245, 1636430009517, 272, 1, 271, 0, 0, 0
4203, 1, 1636430009369, 1636430009637, 268, 1, 267, 0, 0, 0
4204, 1, 1636430009437, 1636430009713, 276, 1, 275, 1, 0, 1
4205, 1, 1636430009569, 1636430009837, 268, 1, 267, 1, 0, 1
4206, 1, 1636430009581, 1636430009854, 273, 1, 272, 0, 0, 0
4207, 1, 1636430009581, 1636430009854, 273, 1, 272, 0, 0, 0
4208, 1, 1636430009793, 1636430010062, 269, 1, 268, 1, 0, 1
4209, 1, 1636430009933, 1636430010201, 268, 1, 267, 0, 0, 0
4210, 1, 1636430010150, 1636430010421, 271, 0, 271, 0, 0, 0
4211, 1, 1636430010237, 1636430010509, 272, 0, 272, 0, 0, 0
4212, 1, 1636430010281, 1636430010550, 269, 1, 268, 0, 1, 1
4213, 1, 1636430010394, 1636430010661, 267, 0, 267, 0, 0, 0
4214, 1, 1636430010417, 1636430010690, 273, 0, 273, 0, 0, 0
4215, 1, 1636430010557, 1636430010825, 268, 0, 268, 0, 0, 0
4216, 1, 1636430010601, 1636430010873, 272, 0, 272, 0, 0, 0
4218, 1, 1636430010825, 1636430011094, 269, 1, 268, 0, 0, 0
4217, 1, 1636430010873, 1636430011142, 269, 0, 269, 0, 0, 0
4220, 1, 1636430011149, 1636430011421, 272, 1, 271, 0, 0, 0
4221, 1, 1636430011293, 1636430011561, 268, 1, 267, 0, 0, 0
4222, 1, 1636430011381, 1636430011649, 268, 1, 267, 0, 0, 0
4223, 1, 1636430011398, 1636430011665, 267, 0, 267, 0, 0, 0
4225, 1, 1636430011594, 1636430011869, 275, 0, 275, 0, 0, 0
4224, 1, 1636430011594, 1636430011873, 279, 0, 279, 0, 0, 0
4226, 1, 1636430011821, 1636430012094, 273, 1, 272, 0, 0, 0
4227, 1, 1636430012121, 1636430012393, 272, 0, 272, 0, 0, 0
4228, 1, 1636430012321, 1636430012598, 277, 1, 276, 1, 0, 1
4229, 1, 1636430012345, 1636430012617, 272, 1, 271, 0, 0, 0
4230, 1, 1636430012397, 1636430012665, 268, 1, 267, 0, 0, 0
4231, 1, 1636430012570, 1636430012838, 268, 0, 268, 0, 0, 0
4232, 1, 1636430012581, 1636430012858, 277, 0, 277, 0, 0, 0
4233, 1, 1636430012830, 1636430013101, 271, 0, 271, 0, 0, 0
4234, 1, 1636430013110, 1636430013381, 271, 0, 271, 0, 0, 0
4235, 1, 1636430013354, 1636430013625, 271, 0, 271, 0, 0, 0
4236, 1, 1636430013365, 1636430013637, 272, 1, 271, 0, 0, 0
4238, 1, 1636430013553, 1636430013826, 273, 0, 273, 0, 0, 0
4237, 1, 1636430013562, 1636430013833, 271, 0, 271, 0, 0, 0
4240, 1, 1636430013857, 1636430014129, 272, 1, 271, 0, 0, 0
4239, 1, 1636430014017, 1636430014290, 273, 1, 272, 1, 0, 1
4241, 1, 1636430014146, 1636430014441, 295, 0, 295, 0, 0, 0
4242, 1, 1636430014353, 1636430014621, 268, 1, 267, 0, 1, 1
4244, 1, 1636430014389, 1636430014662, 273, 0, 273, 0, 0, 0
4243, 1, 1636430014385, 1636430014674, 289, 0, 289, 0, 0, 0
4245, 1, 1636430014557, 1636430014829, 272, 1, 271, 0, 0, 0
4246, 1, 1636430014689, 1636430014962, 273, 1, 272, 1, 0, 1
4247, 1, 1636430014781, 1636430015058, 277, 1, 276, 0, 1, 1
4249, 1, 1636430014866, 1636430015133, 267, 0, 267, 0, 0, 0
4248, 1, 1636430015014, 1636430015281, 267, 0, 267, 0, 0, 0
4250, 1, 1636430015125, 1636430015397, 272, 1, 271, 0, 0, 0
4251, 1, 1636430015373, 1636430015642, 269, 0, 269, 0, 0, 0
4252, 1, 1636430015377, 1636430015649, 272, 0, 272, 0, 0, 0
4253, 1, 1636430015386, 1636430015649, 263, 0, 263, 0, 0, 0
4254, 1, 1636430015597, 1636430015873, 276, 1, 275, 1, 0, 1
4255, 1, 1636430015617, 1636430015890, 273, 0, 273, 0, 0, 0
4256, 1, 1636430015678, 1636430015949, 271, 0, 271, 0, 0, 0
4257, 1, 1636430015693, 1636430015966, 273, 1, 272, 1, 0, 1
4258, 1, 1636430015849, 1636430016117, 268, 0, 268, 0, 0, 0
4259, 1, 1636430016133, 1636430016405, 272, 1, 271, 0, 0, 0
4260, 1, 1636430016357, 1636430016625, 268, 0, 268, 0, 0, 0
4261, 1, 1636430016377, 1636430016649, 272, 1, 271, 0, 0, 0
4262, 1, 1636430016397, 1636430016665, 268, 0, 268, 0, 0, 0
4263, 1, 1636430016565, 1636430016841, 276, 1, 275, 1, 0, 1
4264, 1, 1636430016577, 1636430016841, 264, 1, 263, 0, 0, 0
4265, 1, 1636430016641, 1636430016913, 272, 1, 271, 1, 0, 1
4266, 1, 1636430016705, 1636430016973, 268, 1, 267, 1, 0, 1
4267, 1, 1636430016838, 1636430017109, 271, 0, 271, 0, 0, 0
4268, 1, 1636430017125, 1636430017397, 272, 1, 271, 1, 0, 1
4219, 1, 1636430017162, 1636430017429, 267, 0, 267, 0, 0, 0
4269, 1, 1636430017381, 1636430017649, 268, 0, 268, 0, 0, 0
4270, 1, 1636430017409, 1636430017682, 273, 0, 273, 0, 0, 0
4271, 1, 1636430017426, 1636430017693, 267, 0, 267, 0, 0, 0
4272, 1, 1636430017473, 1636430017745, 272, 1, 271, 0, 0, 0
4273, 1, 1636430017549, 1636430017818, 269, 0, 269, 0, 0, 0
4274, 1, 1636430017597, 1636430017869, 272, 0, 272, 0, 0, 0
4275, 1, 1636430017625, 1636430017894, 269, 1, 268, 0, 0, 0
4276, 1, 1636430017681, 1636430017957, 276, 1, 275, 0, 0, 0
4277, 1, 1636430017821, 1636430018093, 272, 1, 271, 0, 0, 0
4278, 1, 1636430017821, 1636430018094, 273, 1, 272, 0, 1, 1
4279, 1, 1636430018133, 1636430018405, 272, 1, 271, 0, 0, 0
4280, 1, 1636430018397, 1636430018661, 264, 0, 264, 0, 0, 0
4281, 1, 1636430018397, 1636430018665, 268, 0, 268, 0, 0, 0
4282, 1, 1636430018413, 1636430018677, 264, 1, 263, 0, 0, 0
4283, 1, 1636430018413, 1636430018685, 272, 1, 271, 0, 0, 0
4284, 1, 1636430018537, 1636430018813, 276, 0, 276, 0, 0, 0
4285, 1, 1636430018613, 1636430018885, 272, 1, 271, 0, 0, 0
4286, 1, 1636430018625, 1636430018898, 273, 1, 272, 0, 1, 1
4287, 1, 1636430018685, 1636430018962, 277, 1, 276, 1, 0, 1
4288, 1, 1636430018769, 1636430019042, 273, 1, 272, 0, 0, 0
4289, 1, 1636430018829, 1636430019101, 272, 1, 271, 1, 0, 1
4290, 1, 1636430019170, 1636430019441, 271, 0, 271, 0, 0, 0
4291, 1, 1636430019381, 1636430019654, 273, 1, 272, 1, 0, 1
4292, 1, 1636430019385, 1636430019654, 269, 0, 269, 0, 0, 0
4294, 1, 1636430019425, 1636430019697, 272, 1, 271, 0, 0, 0
4293, 1, 1636430019430, 1636430019697, 267, 0, 267, 0, 0, 0
4295, 1, 1636430019573, 1636430019841, 268, 0, 268, 0, 0, 0
4296, 1, 1636430019597, 1636430019869, 272, 1, 271, 0, 0, 0
4297, 1, 1636430019610, 1636430019873, 263, 0, 263, 0, 0, 0
4299, 1, 1636430019741, 1636430020021, 280, 1, 279, 0, 0, 0
4300, 1, 1636430019805, 1636430020078, 273, 1, 272, 1, 0, 1
4298, 1, 1636430019837, 1636430020109, 272, 1, 271, 0, 1, 1
4301, 1, 1636430020145, 1636430020417, 272, 1, 271, 0, 0, 0
4302, 1, 1636430020357, 1636430020626, 269, 0, 269, 0, 0, 0
4303, 1, 1636430020373, 1636430020633, 260, 0, 260, 0, 0, 0
4304, 1, 1636430020402, 1636430020678, 276, 0, 276, 0, 0, 0
4305, 1, 1636430020429, 1636430020694, 265, 0, 265, 0, 0, 0
4306, 1, 1636430020553, 1636430020826, 273, 0, 273, 0, 0, 0
4308, 1, 1636430020605, 1636430020869, 264, 0, 264, 0, 0, 0
4309, 1, 1636430020649, 1636430020917, 268, 0, 268, 0, 0, 0
4310, 1, 1636430020809, 1636430021082, 273, 1, 272, 0, 0, 0
4311, 1, 1636430020821, 1636430021089, 268, 1, 267, 0, 0, 0
4307, 1, 1636430021005, 1636430021274, 269, 1, 268, 0, 0, 0
4312, 1, 1636430021121, 1636430021394, 273, 1, 272, 0, 0, 0
4313, 1, 1636430021353, 1636430021621, 268, 0, 268, 0, 0, 0
4314, 1, 1636430021397, 1636430021669, 272, 1, 271, 0, 1, 1
4315, 1, 1636430021461, 1636430021734, 273, 1, 272, 1, 0, 1
4316, 1, 1636430021577, 1636430021850, 273, 0, 273, 0, 0, 0
4317, 1, 1636430021581, 1636430021850, 269, 1, 268, 0, 1, 1
4318, 1, 1636430021617, 1636430021885, 268, 0, 268, 0, 0, 0
4319, 1, 1636430021669, 1636430021937, 268, 1, 267, 1, 0, 1
4320, 1, 1636430021726, 1636430022001, 275, 0, 275, 0, 0, 0
4322, 1, 1636430022101, 1636430022369, 268, 1, 267, 0, 0, 0
4321, 1, 1636430022122, 1636430022393, 271, 0, 271, 0, 0, 0
4324, 1, 1636430022385, 1636430022657, 272, 1, 271, 0, 1, 1
4323, 1, 1636430022385, 1636430022657, 272, 1, 271, 1, 0, 1
4325, 1, 1636430022477, 1636430022749, 272, 0, 272, 0, 0, 0
4326, 1, 1636430022545, 1636430022814, 269, 1, 268, 0, 1, 1
4327, 1, 1636430022605, 1636430022877, 272, 1, 271, 1, 0, 1
4328, 1, 1636430022633, 1636430022905, 272, 0, 272, 0, 0, 0
4329, 1, 1636430022645, 1636430022917, 272, 1, 271, 0, 0, 0
4330, 1, 1636430022701, 1636430022969, 268, 1, 267, 0, 0, 0
4331, 1, 1636430023086, 1636430023357, 271, 0, 271, 0, 0, 0
4332, 1, 1636430023349, 1636430023617, 268, 1, 267, 1, 0, 1
4333, 1, 1636430023390, 1636430023665, 275, 0, 275, 0, 0, 0
4334, 1, 1636430023510, 1636430023777, 267, 0, 267, 0, 0, 0
4335, 1, 1636430023537, 1636430023809, 272, 0, 272, 0, 0, 0
4336, 1, 1636430023637, 1636430023905, 268, 1, 267, 1, 0, 1
4337, 1, 1636430023678, 1636430023946, 268, 0, 268, 0, 0, 0
4338, 1, 1636430023710, 1636430023977, 267, 0, 267, 0, 0, 0
4339, 1, 1636430024081, 1636430024354, 273, 1, 272, 1, 0, 1
4340, 1, 1636430024330, 1636430024602, 272, 0, 272, 0, 0, 0
4341, 1, 1636430024377, 1636430024658, 281, 1, 280, 1, 0, 1
4342, 1, 1636430024541, 1636430024813, 272, 1, 271, 0, 0, 0
4343, 1, 1636430024561, 1636430024833, 272, 1, 271, 0, 0, 0
4344, 1, 1636430024657, 1636430024926, 269, 1, 268, 0, 0, 0
4345, 1, 1636430024665, 1636430024933, 268, 1, 267, 0, 0, 0
4346, 1, 1636430024698, 1636430024973, 275, 0, 275, 0, 0, 0
4347, 1, 1636430025110, 1636430025385, 275, 0, 275, 0, 0, 0
4348, 1, 1636430025333, 1636430025605, 272, 1, 271, 0, 0, 0
4349, 1, 1636430025397, 1636430025669, 272, 0, 272, 0, 0, 0
4350, 1, 1636430025537, 1636430025809, 272, 1, 271, 0, 0, 0
4351, 1, 1636430025598, 1636430025866, 268, 0, 268, 0, 0, 0
4352, 1, 1636430025629, 1636430025897, 268, 0, 268, 0, 0, 0
4353, 1, 1636430025658, 1636430025929, 271, 0, 271, 0, 0, 0
4354, 1, 1636430025661, 1636430025929, 268, 1, 267, 0, 0, 0
4355, 1, 1636430026073, 1636430026346, 273, 0, 273, 0, 0, 0
4356, 1, 1636430026333, 1636430026602, 269, 1, 268, 0, 0, 0
4357, 1, 1636430026413, 1636430026685, 272, 1, 271, 0, 0, 0
4358, 1, 1636430026558, 1636430026822, 264, 0, 264, 0, 0, 0
4359, 1, 1636430026601, 1636430026865, 264, 1, 263, 0, 0, 0
4360, 1, 1636430026629, 1636430026906, 277, 0, 277, 0, 0, 0
4361, 1, 1636430026641, 1636430026909, 268, 1, 267, 0, 0, 0
4362, 1, 1636430026658, 1636430026930, 272, 0, 272, 0, 0, 0
4363, 1, 1636430027109, 1636430027381, 272, 1, 271, 0, 0, 0
4364, 1, 1636430027314, 1636430027586, 272, 0, 272, 0, 0, 0
4365, 1, 1636430027405, 1636430027673, 268, 1, 267, 0, 0, 0
4366, 1, 1636430027561, 1636430027833, 272, 0, 272, 0, 0, 0
4367, 1, 1636430027569, 1636430027842, 273, 0, 273, 0, 0, 0
4368, 1, 1636430027606, 1636430027878, 272, 0, 272, 0, 0, 0
4369, 1, 1636430027633, 1636430027906, 273, 0, 273, 0, 0, 0
4370, 1, 1636430027637, 1636430027909, 272, 1, 271, 0, 0, 0
4371, 1, 1636430028081, 1636430028353, 272, 1, 271, 1, 0, 1
4372, 1, 1636430028289, 1636430028557, 268, 1, 267, 0, 0, 0
4373, 1, 1636430028390, 1636430028657, 267, 0, 267, 0, 0, 0
4374, 1, 1636430028577, 1636430028845, 268, 1, 267, 0, 0, 0
4376, 1, 1636430028605, 1636430028877, 272, 1, 271, 1, 0, 1
4377, 1, 1636430028613, 1636430028878, 265, 1, 264, 0, 0, 0
4375, 1, 1636430028605, 1636430028877, 272, 1, 271, 1, 0, 1
4378, 1, 1636430028645, 1636430028917, 272, 1, 271, 1, 0, 1
4379, 1, 1636430029058, 1636430029330, 272, 0, 272, 0, 0, 0
4380, 1, 1636430029298, 1636430029574, 276, 0, 276, 0, 0, 0
4381, 1, 1636430029362, 1636430029629, 267, 0, 267, 0, 0, 0
4382, 1, 1636430029574, 1636430029841, 267, 0, 267, 0, 0, 0
4383, 1, 1636430029589, 1636430029858, 269, 1, 268, 0, 0, 0
4384, 1, 1636430029598, 1636430029870, 272, 0, 272, 0, 0, 0
4385, 1, 1636430029609, 1636430029877, 268, 1, 267, 0, 0, 0
4386, 1, 1636430029657, 1636430029921, 264, 1, 263, 0, 0, 0
4387, 1, 1636430030042, 1636430030310, 268, 0, 268, 0, 0, 0
4388, 1, 1636430030309, 1636430030578, 269, 1, 268, 0, 0, 0
4389, 1, 1636430030334, 1636430030605, 271, 0, 271, 0, 0, 0
4390, 1, 1636430030545, 1636430030814, 269, 1, 268, 0, 1, 1
4391, 1, 1636430030577, 1636430030849, 272, 1, 271, 0, 0, 0
4392, 1, 1636430030597, 1636430030869, 272, 1, 271, 1, 0, 1
4393, 1, 1636430030617, 1636430030894, 277, 1, 276, 0, 1, 1
4394, 1, 1636430030629, 1636430030901, 272, 1, 271, 0, 0, 0
4395, 1, 1636430031049, 1636430031321, 272, 0, 272, 0, 0, 0
4396, 1, 1636430031313, 1636430031585, 272, 1, 271, 0, 1, 1
4397, 1, 1636430031313, 1636430031585, 272, 1, 271, 0, 1, 1
4398, 1, 1636430031533, 1636430031801, 268, 1, 267, 0, 1, 1
4399, 1, 1636430031593, 1636430031861, 268, 0, 268, 0, 0, 0
4400, 1, 1636430031605, 1636430031878, 273, 0, 273, 0, 0, 0
4401, 1, 1636430031653, 1636430031925, 272, 1, 271, 0, 0, 0
4402, 1, 1636430032042, 1636430032313, 271, 0, 271, 0, 0, 0
4403, 1, 1636430032301, 1636430032570, 269, 1, 268, 0, 0, 0
4404, 1, 1636430032342, 1636430032613, 271, 0, 271, 0, 0, 0
4405, 1, 1636430032526, 1636430032793, 267, 0, 267, 0, 0, 0
4406, 1, 1636430032570, 1636430032833, 263, 0, 263, 0, 0, 0
4407, 1, 1636430032637, 1636430032910, 273, 1, 272, 0, 0, 0
4408, 1, 1636430032661, 1636430032933, 272, 1, 271, 0, 0, 0
4409, 1, 1636430033017, 1636430033289, 272, 0, 272, 0, 0, 0
4410, 1, 1636430033317, 1636430033589, 272, 1, 271, 0, 0, 0
4411, 1, 1636430033329, 1636430033601, 272, 1, 271, 0, 1, 1
4412, 1, 1636430033533, 1636430033801, 268, 1, 267, 0, 0, 0
4413, 1, 1636430033565, 1636430033842, 277, 1, 276, 0, 0, 0
4414, 1, 1636430033637, 1636430033909, 272, 1, 271, 0, 0, 0
4415, 1, 1636430033673, 1636430033945, 272, 1, 271, 0, 0, 0
4416, 1, 1636430034017, 1636430034290, 273, 0, 273, 0, 0, 0
4417, 1, 1636430034301, 1636430034573, 272, 0, 272, 0, 0, 0
4418, 1, 1636430034357, 1636430034630, 273, 0, 273, 0, 0, 0
4419, 1, 1636430034510, 1636430034781, 271, 0, 271, 0, 0, 0
4420, 1, 1636430034537, 1636430034805, 268, 1, 267, 0, 0, 0
4421, 1, 1636430034633, 1636430034906, 273, 0, 273, 0, 0, 0
4422, 1, 1636430034657, 1636430034933, 276, 1, 275, 0, 0, 0
4423, 1, 1636430034986, 1636430035257, 271, 0, 271, 0, 0, 0
4424, 1, 1636430035305, 1636430035578, 273, 0, 273, 0, 0, 0
4425, 1, 1636430035378, 1636430035649, 271, 0, 271, 0, 0, 0
4426, 1, 1636430035477, 1636430035749, 272, 1, 271, 1, 0, 1
4427, 1, 1636430035498, 1636430035770, 272, 0, 272, 0, 0, 0
4428, 1, 1636430035653, 1636430035925, 272, 0, 272, 0, 0, 0
4429, 1, 1636430035694, 1636430035965, 271, 0, 271, 0, 0, 0
4430, 1, 1636430035953, 1636430036226, 273, 0, 273, 0, 0, 0
4431, 1, 1636430036290, 1636430036562, 272, 0, 272, 0, 0, 0
4432, 1, 1636430036473, 1636430036746, 273, 1, 272, 0, 0, 0
4433, 1, 1636430036533, 1636430036805, 272, 0, 272, 0, 0, 0
4434, 1, 1636430036658, 1636430036930, 272, 0, 272, 0, 0, 0
4435, 1, 1636430036705, 1636430036977, 272, 0, 272, 0, 0, 0
4436, 1, 1636430036985, 1636430037258, 273, 0, 273, 0, 0, 0
4437, 1, 1636430037314, 1636430037585, 271, 0, 271, 0, 0, 0
4438, 1, 1636430037478, 1636430037749, 271, 0, 271, 0, 0, 0
4439, 1, 1636430037506, 1636430037778, 272, 0, 272, 0, 0, 0
4440, 1, 1636430037630, 1636430037902, 272, 0, 272, 0, 0, 0
4441, 1, 1636430037705, 1636430037978, 273, 1, 272, 0, 1, 1
4442, 1, 1636430037957, 1636430038230, 273, 1, 272, 0, 1, 1
4443, 1, 1636430038342, 1636430038614, 272, 0, 272, 0, 0, 0
4444, 1, 1636430038462, 1636430038733, 271, 0, 271, 0, 0, 0
4445, 1, 1636430038485, 1636430038757, 272, 1, 271, 0, 1, 1
4446, 1, 1636430038633, 1636430038901, 268, 0, 268, 0, 0, 0
4447, 1, 1636430038725, 1636430038993, 268, 1, 267, 0, 0, 0
4448, 1, 1636430038941, 1636430039213, 272, 1, 271, 0, 0, 0
4449, 1, 1636430039305, 1636430039578, 273, 1, 272, 0, 0, 0
4450, 1, 1636430039449, 1636430039721, 272, 1, 271, 0, 1, 1
4451, 1, 1636430039465, 1636430039733, 268, 0, 268, 0, 0, 0
4453, 1, 1636430039762, 1636430040034, 272, 0, 272, 0, 0, 0
4452, 1, 1636430039762, 1636430040034, 272, 0, 272, 0, 0, 0
4454, 1, 1636430039917, 1636430040181, 264, 0, 264, 0, 0, 0
4455, 1, 1636430040365, 1636430040638, 273, 1, 272, 1, 0, 1
4457, 1, 1636430040457, 1636430040725, 268, 1, 267, 1, 0, 1
4456, 1, 1636430040454, 1636430040726, 272, 0, 272, 0, 0, 0
4458, 1, 1636430040613, 1636430040885, 272, 1, 271, 0, 0, 0
4459, 1, 1636430040729, 1636430040998, 269, 0, 269, 0, 0, 0
4460, 1, 1636430040905, 1636430041178, 273, 1, 272, 1, 0, 1
4461, 1, 1636430041245, 1636430041521, 276, 1, 275, 1, 0, 1
4462, 1, 1636430041466, 1636430041738, 272, 0, 272, 0, 0, 0
4463, 1, 1636430041481, 1636430041753, 272, 0, 272, 0, 0, 0
4464, 1, 1636430041601, 1636430041878, 277, 0, 277, 0, 0, 0
4465, 1, 1636430041729, 1636430042005, 276, 0, 276, 0, 0, 0
4466, 1, 1636430041938, 1636430042210, 272, 0, 272, 0, 0, 0
4467, 1, 1636430042221, 1636430042489, 268, 1, 267, 0, 0, 0
4468, 1, 1636430042482, 1636430042753, 271, 0, 271, 0, 0, 0
4469, 1, 1636430042506, 1636430042778, 272, 0, 272, 0, 0, 0
4470, 1, 1636430042629, 1636430042902, 273, 1, 272, 0, 0, 0
4471, 1, 1636430042706, 1636430042977, 271, 0, 271, 0, 0, 0
4472, 1, 1636430042957, 1636430043230, 273, 1, 272, 0, 0, 0
4473, 1, 1636430043198, 1636430043466, 268, 0, 268, 0, 0, 0
4475, 1, 1636430043466, 1636430043737, 271, 0, 271, 0, 0, 0
4474, 1, 1636430043466, 1636430043737, 271, 0, 271, 0, 0, 0
4476, 1, 1636430043621, 1636430043894, 273, 1, 272, 0, 1, 1
4477, 1, 1636430043685, 1636430043958, 273, 1, 272, 0, 1, 1
4478, 1, 1636430043913, 1636430044185, 272, 1, 271, 1, 0, 1
4479, 1, 1636430044230, 1636430044494, 264, 0, 264, 0, 0, 0
4480, 1, 1636430044461, 1636430044730, 269, 1, 268, 0, 0, 0
4481, 1, 1636430044481, 1636430044754, 273, 1, 272, 0, 0, 0
4482, 1, 1636430044598, 1636430044869, 271, 0, 271, 0, 0, 0
4483, 1, 1636430044654, 1636430044926, 272, 0, 272, 0, 0, 0
4484, 1, 1636430044914, 1636430045186, 272, 0, 272, 0, 0, 0
4485, 1, 1636430045214, 1636430045485, 271, 0, 271, 0, 0, 0
4486, 1, 1636430045442, 1636430045713, 271, 0, 271, 0, 0, 0
4487, 1, 1636430045461, 1636430045733, 272, 1, 271, 0, 0, 0
4488, 1, 1636430045601, 1636430045874, 273, 1, 272, 0, 0, 0
4489, 1, 1636430045665, 1636430045938, 273, 1, 272, 0, 1, 1
4490, 1, 1636430045893, 1636430046166, 273, 1, 272, 0, 0, 0
4491, 1, 1636430046426, 1636430046697, 271, 1, 270, 0, 0, 0
4492, 1, 1636430046470, 1636430046737, 267, 0, 267, 0, 0, 0
4493, 1, 1636430046589, 1636430046861, 272, 0, 272, 0, 0, 0
4494, 1, 1636430046625, 1636430046897, 272, 1, 271, 0, 0, 0
4495, 1, 1636430046882, 1636430047158, 276, 0, 276, 0, 0, 0
4496, 1, 1636430047406, 1636430047677, 271, 0, 271, 0, 0, 0
4497, 1, 1636430047458, 1636430047725, 267, 0, 267, 0, 0, 0
4498, 1, 1636430047613, 1636430047886, 273, 1, 272, 0, 0, 0
4499, 1, 1636430047622, 1636430047886, 264, 0, 264, 0, 0, 0
4500, 1, 1636430047857, 1636430048130, 273, 1, 272, 0, 0, 0
4501, 1, 1636430048397, 1636430048670, 273, 1, 272, 0, 0, 0
4502, 1, 1636430048489, 1636430048761, 272, 1, 271, 0, 0, 0
4503, 1, 1636430048633, 1636430048905, 272, 1, 271, 0, 1, 1
4504, 1, 1636430048646, 1636430048917, 271, 0, 271, 0, 0, 0
4505, 1, 1636430048853, 1636430049126, 273, 1, 272, 0, 1, 1
4506, 1, 1636430049377, 1636430049649, 272, 0, 272, 0, 0, 0
4507, 1, 1636430049498, 1636430049769, 271, 0, 271, 0, 0, 0
4508, 1, 1636430049597, 1636430049869, 272, 0, 272, 0, 0, 0
4509, 1, 1636430049633, 1636430049901, 268, 1, 267, 1, 0, 1
4510, 1, 1636430049825, 1636430050094, 269, 1, 268, 0, 0, 0
4511, 1, 1636430050397, 1636430050673, 276, 1, 275, 0, 0, 0
4512, 1, 1636430050470, 1636430050742, 272, 0, 272, 0, 0, 0
4513, 1, 1636430050621, 1636430050890, 269, 0, 269, 0, 0, 0
4514, 1, 1636430050665, 1636430050937, 272, 1, 271, 0, 0, 0
4515, 1, 1636430050849, 1636430051122, 273, 1, 272, 0, 0, 0
4516, 1, 1636430051413, 1636430051685, 272, 1, 271, 0, 0, 0
4517, 1, 1636430051458, 1636430051726, 268, 0, 268, 0, 0, 0
4518, 1, 1636430051641, 1636430051914, 273, 1, 272, 0, 0, 0
4519, 1, 1636430051681, 1636430051950, 269, 1, 268, 0, 0, 0
4520, 1, 1636430051870, 1636430052142, 272, 0, 272, 0, 0, 0
4521, 1, 1636430052398, 1636430052670, 272, 0, 272, 0, 0, 0
4522, 1, 1636430052429, 1636430052701, 272, 1, 271, 0, 0, 0
4523, 1, 1636430052629, 1636430052902, 273, 0, 273, 0, 0, 0
4524, 1, 1636430052661, 1636430052934, 273, 1, 272, 0, 0, 0
4525, 1, 1636430052850, 1636430053122, 272, 0, 272, 0, 0, 0
4526, 1, 1636430053378, 1636430053650, 272, 0, 272, 0, 0, 0
4527, 1, 1636430053397, 1636430053670, 273, 1, 272, 0, 0, 0
4528, 1, 1636430053670, 1636430053941, 271, 0, 271, 0, 0, 0
4529, 1, 1636430053670, 1636430053941, 271, 0, 271, 0, 0, 0
4530, 1, 1636430053826, 1636430054093, 267, 0, 267, 0, 0, 0
4531, 1, 1636430054377, 1636430054645, 268, 1, 267, 0, 0, 0
4532, 1, 1636430054414, 1636430054682, 268, 0, 268, 0, 0, 0
4533, 1, 1636430054654, 1636430054926, 272, 0, 272, 0, 0, 0
4534, 1, 1636430054682, 1636430054953, 271, 0, 271, 0, 0, 0
4535, 1, 1636430054861, 1636430055134, 273, 1, 272, 0, 1, 1
4536, 1, 1636430055382, 1636430055649, 267, 0, 267, 0, 0, 0
4537, 1, 1636430055417, 1636430055689, 272, 1, 271, 0, 1, 1
4538, 1, 1636430055670, 1636430055937, 267, 0, 267, 0, 0, 0
4539, 1, 1636430055670, 1636430055941, 271, 0, 271, 0, 0, 0
4540, 1, 1636430055829, 1636430056102, 273, 1, 272, 0, 1, 1
4541, 1, 1636430056374, 1636430056645, 271, 0, 271, 0, 0, 0
4542, 1, 1636430056390, 1636430056657, 267, 0, 267, 0, 0, 0
4544, 1, 1636430056681, 1636430056958, 277, 1, 276, 0, 1, 1
4543, 1, 1636430056681, 1636430056958, 277, 1, 276, 0, 0, 0
4545, 1, 1636430056822, 1636430057094, 272, 0, 272, 0, 0, 0
4546, 1, 1636430057394, 1636430057666, 272, 0, 272, 0, 0, 0
4547, 1, 1636430057677, 1636430057946, 269, 1, 268, 1, 0, 1
4548, 1, 1636430057673, 1636430057946, 273, 1, 272, 0, 0, 0
4549, 1, 1636430057842, 1636430058114, 272, 0, 272, 0, 0, 0
4550, 1, 1636430058410, 1636430058686, 276, 0, 276, 0, 0, 0
4551, 1, 1636430058677, 1636430058950, 273, 0, 273, 0, 0, 0
4552, 1, 1636430058685, 1636430058962, 277, 1, 276, 0, 0, 0
4553, 1, 1636430058865, 1636430059138, 273, 0, 273, 0, 0, 0
4554, 1, 1636430059429, 1636430059701, 272, 1, 271, 0, 0, 0
4555, 1, 1636430059690, 1636430059962, 272, 0, 272, 0, 0, 0
4556, 1, 1636430059698, 1636430059969, 271, 0, 271, 0, 0, 0
4557, 1, 1636430059882, 1636430060154, 272, 0, 272, 0, 0, 0
4558, 1, 1636430060413, 1636430060686, 273, 1, 272, 0, 0, 0
4559, 1, 1636430060661, 1636430060933, 272, 1, 271, 0, 1, 1
4560, 1, 1636430060681, 1636430060954, 273, 1, 272, 0, 0, 0
4561, 1, 1636430060865, 1636430061138, 273, 1, 272, 0, 0, 0
4562, 1, 1636430061390, 1636430061670, 280, 0, 280, 0, 0, 0
4563, 1, 1636430061649, 1636430061922, 273, 0, 273, 0, 0, 0
4564, 1, 1636430061670, 1636430061946, 276, 0, 276, 0, 0, 0
4565, 1, 1636430061850, 1636430062122, 272, 0, 272, 0, 0, 0
4566, 1, 1636430062374, 1636430062646, 272, 0, 272, 0, 0, 0
4567, 1, 1636430062678, 1636430062950, 272, 0, 272, 0, 0, 0
4568, 1, 1636430062682, 1636430062953, 271, 0, 271, 0, 0, 0
4569, 1, 1636430062821, 1636430063090, 269, 1, 268, 0, 0, 0
4570, 1, 1636430063374, 1636430063650, 276, 0, 276, 0, 0, 0
4571, 1, 1636430063641, 1636430063909, 268, 1, 267, 0, 0, 0
4573, 1, 1636430063686, 1636430063949, 263, 0, 263, 0, 0, 0
4572, 1, 1636430063829, 1636430064097, 268, 1, 267, 1, 0, 1
4574, 1, 1636430064370, 1636430064641, 271, 0, 271, 0, 0, 0
4577, 1, 1636430064674, 1636430064946, 272, 0, 272, 0, 0, 0
4576, 1, 1636430064674, 1636430064946, 272, 0, 272, 0, 0, 0
4575, 1, 1636430064817, 1636430065090, 273, 0, 273, 0, 0, 0
4578, 1, 1636430065654, 1636430065922, 268, 0, 268, 0, 0, 0
4579, 1, 1636430065686, 1636430065958, 272, 0, 272, 0, 0, 0
4580, 1, 1636430066649, 1636430066922, 273, 1, 272, 0, 0, 0
4581, 1, 1636430066670, 1636430066942, 272, 0, 272, 0, 0, 0
4582, 1, 1636430067670, 1636430067942, 272, 0, 272, 0, 0, 0
4583, 1, 1636430067674, 1636430067950, 276, 0, 276, 0, 0, 0
4584, 1, 1636430068666, 1636430068938, 272, 0, 272, 0, 0, 0
4585, 1, 1636430068666, 1636430068938, 272, 0, 272, 0, 0, 0
4586, 1, 1636430069650, 1636430069922, 272, 0, 272, 0, 0, 0
4587, 1, 1636430069673, 1636430069946, 273, 1, 272, 1, 0, 1
4588, 1, 1636430070674, 1636430070946, 272, 1, 271, 0, 0, 0
4589, 1, 1636430070674, 1636430070946, 272, 0, 272, 0, 0, 0
4590, 1, 1636430071669, 1636430071942, 273, 1, 272, 1, 0, 1
4591, 1, 1636430071681, 1636430071954, 273, 1, 272, 0, 0, 0
4592, 1, 1636430072658, 1636430072930, 272, 0, 272, 0, 0, 0
4593, 1, 1636430072705, 1636430072974, 269, 1, 268, 0, 0, 0
4594, 1, 1636430073685, 1636430073958, 273, 1, 272, 0, 0, 0
4595, 1, 1636430073693, 1636430073962, 269, 1, 268, 0, 0, 0
4596, 1, 1636430074686, 1636430074958, 272, 0, 272, 0, 0, 0
4597, 1, 1636430074714, 1636430074986, 272, 0, 272, 0, 0, 0
4598, 1, 1636430075714, 1636430075986, 272, 0, 272, 0, 0, 0
4599, 1, 1636430076710, 1636430076982, 272, 0, 272, 0, 0, 0
4600, 1, 1636430077738, 1636430078010, 272, 0, 272, 0, 0, 0
4601, 1, 1636430167722, 1636430167994, 272, 0, 272, 0, 0, 0
4602, 1, 1636430168198, 1636430168470, 272, 0, 272, 0, 0, 0
4603, 1, 1636430168694, 1636430168962, 268, 0, 268, 0, 0, 0
4604, 1, 1636430169406, 1636430169673, 267, 0, 267, 0, 0, 0
4605, 1, 1636430169626, 1636430169898, 272, 0, 272, 0, 0, 0
4606, 1, 1636430169854, 1636430170126, 272, 0, 272, 0, 0, 0
4607, 1, 1636430170194, 1636430170466, 272, 0, 272, 0, 0, 0
4608, 1, 1636430170454, 1636430170726, 272, 0, 272, 0, 0, 0
4609, 1, 1636430170649, 1636430170921, 272, 0, 272, 0, 0, 0
4610, 1, 1636430170986, 1636430171258, 272, 0, 272, 0, 0, 0
4611, 1, 1636430171266, 1636430171538, 272, 0, 272, 0, 0, 0
4612, 1, 1636430171574, 1636430171845, 271, 0, 271, 0, 0, 0
4613, 1, 1636430171574, 1636430171845, 271, 0, 271, 0, 0, 0
4614, 1, 1636430171717, 1636430171989, 272, 0, 272, 0, 0, 0
4615, 1, 1636430172029, 1636430172302, 273, 1, 272, 1, 0, 1
4616, 1, 1636430172145, 1636430172418, 273, 1, 272, 1, 0, 1
4618, 1, 1636430172454, 1636430172729, 275, 0, 275, 0, 0, 0
4617, 1, 1636430172602, 1636430172873, 271, 0, 271, 0, 0, 0
4620, 1, 1636430172853, 1636430173126, 273, 1, 272, 0, 0, 0
4619, 1, 1636430172909, 1636430173186, 277, 1, 276, 1, 0, 1
4621, 1, 1636430173222, 1636430173493, 271, 0, 271, 0, 0, 0
4622, 1, 1636430173442, 1636430173714, 272, 0, 272, 0, 0, 0
4624, 1, 1636430173586, 1636430173858, 272, 0, 272, 0, 0, 0
4623, 1, 1636430173673, 1636430173946, 273, 0, 273, 0, 0, 0
4625, 1, 1636430173954, 1636430174230, 276, 0, 276, 0, 0, 0
4626, 1, 1636430174162, 1636430174433, 271, 0, 271, 0, 0, 0
4627, 1, 1636430174213, 1636430174486, 273, 1, 272, 0, 0, 0
4628, 1, 1636430174402, 1636430174673, 271, 0, 271, 0, 0, 0
4629, 1, 1636430174617, 1636430174885, 268, 1, 267, 0, 0, 0
4630, 1, 1636430174673, 1636430174941, 268, 0, 268, 0, 0, 0
4632, 1, 1636430174853, 1636430175117, 264, 1, 263, 0, 0, 0
4631, 1, 1636430174857, 1636430175125, 268, 1, 267, 0, 0, 0
4633, 1, 1636430175117, 1636430175390, 273, 1, 272, 0, 0, 0
4634, 1, 1636430175226, 1636430175502, 276, 0, 276, 0, 0, 0
4635, 1, 1636430175386, 1636430175658, 272, 0, 272, 0, 0, 0
4636, 1, 1636430175569, 1636430175837, 268, 1, 267, 0, 0, 0
4637, 1, 1636430175685, 1636430175953, 268, 1, 267, 1, 0, 1
4638, 1, 1636430175713, 1636430175985, 272, 1, 271, 1, 0, 1
4639, 1, 1636430175901, 1636430176186, 285, 0, 285, 0, 0, 0
4640, 1, 1636430176021, 1636430176298, 277, 1, 276, 0, 0, 0
4641, 1, 1636430176073, 1636430176342, 269, 1, 268, 0, 0, 0
4642, 1, 1636430176242, 1636430176509, 267, 0, 267, 0, 0, 0
4643, 1, 1636430176413, 1636430176686, 273, 1, 272, 0, 0, 0
4645, 1, 1636430176518, 1636430176789, 271, 0, 271, 0, 0, 0
4646, 1, 1636430176589, 1636430176862, 273, 1, 272, 0, 0, 0
4644, 1, 1636430176689, 1636430176957, 268, 1, 267, 0, 0, 0
4647, 1, 1636430176809, 1636430177082, 273, 1, 272, 1, 0, 1
4648, 1, 1636430176909, 1636430177181, 272, 1, 271, 0, 0, 0
4649, 1, 1636430176973, 1636430177242, 269, 1, 268, 1, 0, 1
4650, 1, 1636430177078, 1636430177342, 264, 0, 264, 0, 0, 0
4651, 1, 1636430177322, 1636430177593, 271, 0, 271, 0, 0, 0
4652, 1, 1636430177426, 1636430177694, 268, 0, 268, 0, 0, 0
4653, 1, 1636430177438, 1636430177710, 272, 0, 272, 0, 0, 0
4654, 1, 1636430177605, 1636430177877, 272, 1, 271, 0, 0, 0
4655, 1, 1636430177621, 1636430177898, 277, 0, 277, 0, 0, 0
4656, 1, 1636430177773, 1636430178046, 273, 1, 272, 0, 0, 0
4657, 1, 1636430177977, 1636430178254, 277, 1, 276, 1, 0, 1
4658, 1, 1636430178009, 1636430178281, 272, 0, 272, 0, 0, 0
4659, 1, 1636430178053, 1636430178321, 268, 1, 267, 0, 1, 1
4660, 1, 1636430178149, 1636430178409, 260, 1, 259, 0, 0, 0
4661, 1, 1636430178186, 1636430178457, 271, 0, 271, 0, 0, 0
4663, 1, 1636430178453, 1636430178721, 268, 1, 267, 0, 0, 0
4664, 1, 1636430178501, 1636430178769, 268, 0, 268, 0, 0, 0
4665, 1, 1636430178541, 1636430178809, 268, 0, 268, 0, 0, 0
4662, 1, 1636430178589, 1636430178861, 272, 0, 272, 0, 0, 0
4666, 1, 1636430178762, 1636430179033, 271, 0, 271, 0, 0, 0
4667, 1, 1636430178809, 1636430179085, 276, 0, 276, 0, 0, 0
4668, 1, 1636430178945, 1636430179222, 277, 1, 276, 0, 0, 0
4669, 1, 1636430179037, 1636430179313, 276, 0, 276, 0, 0, 0
4670, 1, 1636430179078, 1636430179350, 272, 0, 272, 0, 0, 0
4671, 1, 1636430179186, 1636430179461, 275, 0, 275, 0, 0, 0
4672, 1, 1636430179401, 1636430179669, 268, 1, 267, 0, 1, 1
4673, 1, 1636430179493, 1636430179757, 264, 0, 264, 0, 0, 0
4674, 1, 1636430179606, 1636430179873, 267, 0, 267, 0, 0, 0
4675, 1, 1636430179669, 1636430179942, 273, 1, 272, 0, 1, 1
4676, 1, 1636430179745, 1636430180017, 272, 1, 271, 0, 1, 1
4677, 1, 1636430179925, 1636430180197, 272, 1, 271, 0, 0, 0
4678, 1, 1636430180057, 1636430180321, 264, 1, 263, 0, 1, 1
4679, 1, 1636430180097, 1636430180369, 272, 1, 271, 0, 0, 0
4680, 1, 1636430180129, 1636430180405, 276, 1, 275, 0, 0, 0
4681, 1, 1636430180217, 1636430180493, 276, 1, 275, 0, 0, 0
4682, 1, 1636430180405, 1636430180677, 272, 1, 271, 0, 1, 1
4683, 1, 1636430180429, 1636430180705, 276, 1, 275, 0, 0, 0
4685, 1, 1636430180541, 1636430180813, 272, 1, 271, 0, 0, 0
4686, 1, 1636430180625, 1636430180897, 272, 0, 272, 0, 0, 0
4684, 1, 1636430180669, 1636430180942, 273, 0, 273, 0, 0, 0
4687, 1, 1636430180910, 1636430181182, 272, 0, 272, 0, 0, 0
4688, 1, 1636430180942, 1636430181213, 271, 0, 271, 0, 0, 0
4689, 1, 1636430180993, 1636430181265, 272, 1, 271, 0, 1, 1
4690, 1, 1636430181022, 1636430181297, 275, 0, 275, 0, 0, 0
4692, 1, 1636430181301, 1636430181573, 272, 1, 271, 0, 0, 0
4693, 1, 1636430181369, 1636430181641, 272, 1, 271, 0, 1, 1
4691, 1, 1636430181445, 1636430181721, 276, 1, 275, 0, 1, 1
4694, 1, 1636430181557, 1636430181829, 272, 1, 271, 0, 1, 1
4695, 1, 1636430181789, 1636430182061, 272, 1, 271, 0, 0, 0
4696, 1, 1636430181798, 1636430182074, 276, 0, 276, 0, 0, 0
4697, 1, 1636430181941, 1636430182213, 272, 1, 271, 0, 0, 0
4698, 1, 1636430182009, 1636430182277, 268, 1, 267, 1, 0, 1
4699, 1, 1636430182033, 1636430182309, 276, 0, 276, 0, 0, 0
4700, 1, 1636430182221, 1636430182497, 276, 1, 275, 0, 1, 1
4701, 1, 1636430182273, 1636430182549, 276, 1, 275, 0, 0, 0
4702, 1, 1636430182469, 1636430182742, 273, 1, 272, 1, 0, 1
4703, 1, 1636430182525, 1636430182797, 272, 1, 271, 0, 0, 0
4705, 1, 1636430182581, 1636430182858, 277, 1, 276, 1, 0, 1
4706, 1, 1636430182681, 1636430182945, 264, 0, 264, 0, 0, 0
4704, 1, 1636430182725, 1636430182993, 268, 1, 267, 1, 0, 1
4707, 1, 1636430182853, 1636430183125, 272, 1, 271, 0, 0, 0
4709, 1, 1636430183033, 1636430183306, 273, 1, 272, 0, 0, 0
4710, 1, 1636430183062, 1636430183334, 272, 0, 272, 0, 0, 0
4708, 1, 1636430183129, 1636430183406, 277, 0, 277, 0, 0, 0
4712, 1, 1636430183361, 1636430183637, 276, 1, 275, 0, 0, 0
4713, 1, 1636430183494, 1636430183765, 271, 0, 271, 0, 0, 0
4711, 1, 1636430183586, 1636430183857, 271, 0, 271, 0, 0, 0
4714, 1, 1636430183597, 1636430183861, 264, 0, 264, 0, 0, 0
4715, 1, 1636430183845, 1636430184113, 268, 1, 267, 0, 0, 0
4716, 1, 1636430183889, 1636430184157, 268, 1, 267, 1, 0, 1
4717, 1, 1636430184041, 1636430184305, 264, 0, 264, 0, 0, 0
4718, 1, 1636430184069, 1636430184333, 264, 0, 264, 0, 0, 0
4719, 1, 1636430184085, 1636430184362, 277, 0, 277, 0, 0, 0
4720, 1, 1636430184153, 1636430184425, 272, 1, 271, 0, 0, 0
4721, 1, 1636430184341, 1636430184613, 272, 1, 271, 0, 0, 0
4722, 1, 1636430184541, 1636430184817, 276, 0, 276, 0, 0, 0
4723, 1, 1636430184585, 1636430184854, 269, 1, 268, 0, 0, 0
4725, 1, 1636430184593, 1636430184857, 264, 0, 264, 0, 0, 0
4724, 1, 1636430184585, 1636430184857, 272, 1, 271, 1, 0, 1
4726, 1, 1636430184797, 1636430185070, 273, 0, 273, 0, 0, 0
4728, 1, 1636430184981, 1636430185253, 272, 1, 271, 0, 0, 0
4727, 1, 1636430184989, 1636430185261, 272, 1, 271, 0, 1, 1
4729, 1, 1636430185081, 1636430185353, 272, 1, 271, 0, 0, 0
4730, 1, 1636430185137, 1636430185401, 264, 1, 263, 1, 0, 1
4732, 1, 1636430185433, 1636430185701, 268, 1, 267, 0, 0, 0
4731, 1, 1636430185437, 1636430185702, 265, 1, 264, 0, 1, 1
4733, 1, 1636430185545, 1636430185817, 272, 1, 271, 0, 1, 1
4734, 1, 1636430185726, 1636430186001, 275, 0, 275, 0, 0, 0
4735, 1, 1636430185913, 1636430186181, 268, 1, 267, 0, 1, 1
4736, 1, 1636430185937, 1636430186209, 272, 1, 271, 0, 0, 0
4737, 1, 1636430185949, 1636430186217, 268, 1, 267, 0, 0, 0
4738, 1, 1636430186177, 1636430186437, 260, 1, 259, 0, 0, 0
4739, 1, 1636430186197, 1636430186457, 260, 1, 259, 1, 0, 1
4740, 1, 1636430186205, 1636430186477, 272, 1, 271, 0, 0, 0
4741, 1, 1636430186401, 1636430186669, 268, 0, 268, 0, 0, 0
4742, 1, 1636430186461, 1636430186725, 264, 0, 264, 0, 0, 0
4744, 1, 1636430186654, 1636430186921, 267, 0, 267, 0, 0, 0
4743, 1, 1636430186658, 1636430186925, 267, 0, 267, 0, 0, 0
4745, 1, 1636430186713, 1636430186977, 264, 0, 264, 0, 0, 0
4746, 1, 1636430186846, 1636430187121, 275, 0, 275, 0, 0, 0
4748, 1, 1636430187037, 1636430187309, 272, 1, 271, 0, 0, 0
4749, 1, 1636430187045, 1636430187325, 280, 1, 279, 0, 1, 1
4747, 1, 1636430187109, 1636430187385, 276, 1, 275, 0, 0, 0
4750, 1, 1636430187149, 1636430187426, 277, 1, 276, 1, 0, 1
4752, 1, 1636430187505, 1636430187778, 273, 1, 272, 0, 0, 0
4751, 1, 1636430187557, 1636430187829, 272, 1, 271, 1, 0, 1
4753, 1, 1636430187593, 1636430187861, 268, 1, 267, 0, 0, 0
4754, 1, 1636430187617, 1636430187890, 273, 1, 272, 0, 0, 0
4755, 1, 1636430187937, 1636430188210, 273, 0, 273, 0, 0, 0
4757, 1, 1636430187977, 1636430188245, 268, 1, 267, 0, 0, 0
4756, 1, 1636430188049, 1636430188321, 272, 1, 271, 0, 1, 1
4758, 1, 1636430188065, 1636430188337, 272, 1, 271, 0, 0, 0
4759, 1, 1636430188242, 1636430188517, 275, 0, 275, 0, 0, 0
4760, 1, 1636430188266, 1636430188541, 275, 0, 275, 0, 0, 0
4761, 1, 1636430188389, 1636430188662, 273, 1, 272, 0, 0, 0
4762, 1, 1636430188529, 1636430188805, 276, 1, 275, 1, 0, 1
4763, 1, 1636430188589, 1636430188869, 280, 1, 279, 1, 0, 1
4766, 1, 1636430188722, 1636430188993, 271, 0, 271, 0, 0, 0
4764, 1, 1636430188722, 1636430188993, 271, 0, 271, 0, 0, 0
4765, 1, 1636430188837, 1636430189113, 276, 1, 275, 0, 0, 0
4768, 1, 1636430189110, 1636430189381, 271, 0, 271, 0, 0, 0
4769, 1, 1636430189161, 1636430189433, 272, 1, 271, 0, 0, 0
4767, 1, 1636430189173, 1636430189445, 272, 1, 271, 0, 1, 1
4770, 1, 1636430189214, 1636430189485, 271, 0, 271, 0, 0, 0
4772, 1, 1636430189461, 1636430189737, 276, 1, 275, 1, 0, 1
4771, 1, 1636430189634, 1636430189902, 268, 0, 268, 0, 0, 0
4773, 1, 1636430189681, 1636430189946, 265, 1, 264, 1, 0, 1
4774, 1, 1636430189710, 1636430189978, 268, 0, 268, 0, 0, 0
4775, 1, 1636430189814, 1636430190081, 267, 0, 267, 0, 0, 0
4776, 1, 1636430189969, 1636430190245, 276, 1, 275, 0, 1, 1
4778, 1, 1636430190126, 1636430190401, 275, 0, 275, 0, 0, 0
4777, 1, 1636430190154, 1636430190421, 267, 0, 267, 0, 0, 0
4779, 1, 1636430190261, 1636430190538, 277, 1, 276, 1, 0, 1
4780, 1, 1636430190289, 1636430190557, 268, 0, 268, 0, 0, 0
4781, 1, 1636430190333, 1636430190610, 277, 1, 276, 0, 0, 0
4782, 1, 1636430190585, 1636430190857, 272, 1, 271, 0, 0, 0
4786, 1, 1636430190717, 1636430190985, 268, 0, 268, 0, 0, 0
4783, 1, 1636430190721, 1636430190990, 269, 0, 269, 0, 0, 0
4785, 1, 1636430190713, 1636430190993, 280, 0, 280, 0, 0, 0
4784, 1, 1636430190797, 1636430191065, 268, 0, 268, 0, 0, 0
4788, 1, 1636430191181, 1636430191450, 269, 0, 269, 0, 0, 0
4789, 1, 1636430191201, 1636430191465, 264, 1, 263, 1, 0, 1
4790, 1, 1636430191225, 1636430191497, 272, 1, 271, 0, 0, 0
4787, 1, 1636430191245, 1636430191517, 272, 1, 271, 0, 1, 1
4792, 1, 1636430191373, 1636430191653, 280, 1, 279, 1, 0, 1
4793, 1, 1636430191649, 1636430191921, 272, 0, 272, 0, 0, 0
4791, 1, 1636430191689, 1636430191961, 272, 1, 271, 0, 0, 0
4795, 1, 1636430191762, 1636430192033, 271, 0, 271, 0, 0, 0
4796, 1, 1636430191917, 1636430192190, 273, 0, 273, 0, 0, 0
4794, 1, 1636430192101, 1636430192374, 273, 0, 273, 0, 0, 0
4799, 1, 1636430192210, 1636430192482, 272, 0, 272, 0, 0, 0
4797, 1, 1636430192210, 1636430192485, 275, 0, 275, 0, 0, 0
4801, 1, 1636430192402, 1636430192673, 271, 0, 271, 0, 0, 0
4804, 1, 1636430192670, 1636430192942, 272, 0, 272, 0, 0, 0
4803, 1, 1636430192670, 1636430192942, 272, 0, 272, 0, 0, 0
4806, 1, 1636430192781, 1636430193049, 268, 1, 267, 0, 0, 0
4805, 1, 1636430192849, 1636430193122, 273, 1, 272, 0, 0, 0
4808, 1, 1636430193169, 1636430193442, 273, 0, 273, 0, 0, 0
4810, 1, 1636430193290, 1636430193557, 267, 0, 267, 0, 0, 0
4809, 1, 1636430193298, 1636430193566, 268, 0, 268, 0, 0, 0
4813, 1, 1636430193626, 1636430193898, 272, 0, 272, 0, 0, 0
4812, 1, 1636430193746, 1636430194014, 268, 0, 268, 0, 0, 0
4814, 1, 1636430193790, 1636430194066, 276, 0, 276, 0, 0, 0
4815, 1, 1636430193829, 1636430194101, 272, 1, 271, 0, 0, 0
4818, 1, 1636430194250, 1636430194522, 272, 0, 272, 0, 0, 0
4817, 1, 1636430194277, 1636430194549, 272, 0, 272, 0, 0, 0
4821, 1, 1636430194698, 1636430194969, 271, 0, 271, 0, 0, 0
4823, 1, 1636430194862, 1636430195134, 272, 0, 272, 0, 0, 0
4827, 1, 1636430195413, 1636430195690, 277, 1, 276, 0, 0, 0
4829, 1, 1636430195774, 1636430196050, 276, 0, 276, 0, 0, 0
4830, 1, 1636430195954, 1636430196226, 272, 0, 272, 0, 0, 0
4831, 1, 1636430196410, 1636430196682, 272, 0, 272, 0, 0, 0
4834, 1, 1636430196905, 1636430197178, 273, 1, 272, 0, 0, 0
4836, 1, 1636430197874, 1636430198146, 272, 0, 272, 0, 0, 0
4840, 1, 1636430199782, 1636430200054, 272, 0, 272, 0, 0, 0
4841, 1, 1636430201734, 1636430202006, 272, 0, 272, 0, 0, 0
4843, 1, 1636430202865, 1636430203177, 312, 1, 311, 0, 0, 0
4842, 1, 1636430202862, 1636430203181, 319, 0, 319, 0, 0, 0
4844, 1, 1636430203353, 1636430203626, 273, 1, 272, 0, 0, 0
4845, 1, 1636430203433, 1636430203705, 272, 1, 271, 0, 0, 0
4847, 1, 1636430203746, 1636430204022, 276, 0, 276, 0, 0, 0
4846, 1, 1636430203810, 1636430204081, 271, 0, 271, 0, 0, 0
4848, 1, 1636430204262, 1636430204538, 276, 0, 276, 0, 0, 0
4849, 1, 1636430204713, 1636430204985, 272, 1, 271, 0, 0, 0
4853, 1, 1636430204893, 1636430205165, 272, 0, 272, 0, 0, 0
4851, 1, 1636430204937, 1636430205233, 296, 1, 295, 0, 0, 0
4854, 1, 1636430205193, 1636430205477, 284, 0, 284, 0, 0, 0
4855, 1, 1636430205433, 1636430205705, 272, 0, 272, 0, 0, 0
4856, 1, 1636430205477, 1636430205753, 276, 1, 275, 1, 0, 1
4857, 1, 1636430205653, 1636430205926, 273, 1, 272, 1, 0, 1
4861, 1, 1636430205869, 1636430206141, 272, 1, 271, 0, 0, 0
4860, 1, 1636430205889, 1636430206162, 273, 1, 272, 0, 0, 0
4859, 1, 1636430206105, 1636430206378, 273, 1, 272, 0, 1, 1
4863, 1, 1636430206557, 1636430206825, 268, 1, 267, 1, 0, 1
4864, 1, 1636430206737, 1636430207001, 264, 1, 263, 1, 0, 1
4866, 1, 1636430206998, 1636430207266, 268, 0, 268, 0, 0, 0
4867, 1, 1636430206998, 1636430207273, 275, 0, 275, 0, 0, 0
4868, 1, 1636430207177, 1636430207454, 277, 1, 276, 0, 0, 0
4870, 1, 1636430207537, 1636430207809, 272, 1, 271, 0, 0, 0
4871, 1, 1636430207629, 1636430207897, 268, 1, 267, 1, 0, 1
4872, 1, 1636430207717, 1636430207985, 268, 0, 268, 0, 0, 0
4875, 1, 1636430207853, 1636430208126, 273, 1, 272, 0, 0, 0
4839, 1, 1636430208058, 1636430208329, 271, 0, 271, 0, 0, 0
4874, 1, 1636430208073, 1636430208346, 273, 1, 272, 0, 0, 0
4876, 1, 1636430208249, 1636430208525, 276, 1, 275, 0, 1, 1
4878, 1, 1636430208529, 1636430208801, 272, 1, 271, 0, 0, 0
4877, 1, 1636430208701, 1636430208969, 268, 1, 267, 0, 0, 0
4880, 1, 1636430208737, 1636430209010, 273, 1, 272, 0, 0, 0
4881, 1, 1636430208977, 1636430209249, 272, 1, 271, 0, 0, 0
4879, 1, 1636430209153, 1636430209426, 273, 1, 272, 0, 0, 0
4883, 1, 1636430209190, 1636430209462, 272, 0, 272, 0, 0, 0
4885, 1, 1636430209665, 1636430209938, 273, 1, 272, 1, 0, 1
4886, 1, 1636430209705, 1636430209982, 277, 1, 276, 1, 0, 1
4888, 1, 1636430209794, 1636430210066, 272, 0, 272, 0, 0, 0
4887, 1, 1636430210117, 1636430210390, 273, 0, 273, 0, 0, 0
4889, 1, 1636430210242, 1636430210513, 271, 0, 271, 0, 0, 0
4891, 1, 1636430210602, 1636430210874, 272, 0, 272, 0, 0, 0
4890, 1, 1636430210694, 1636430210966, 272, 0, 272, 0, 0, 0
4894, 1, 1636430211050, 1636430211322, 272, 0, 272, 0, 0, 0
4892, 1, 1636430211149, 1636430211422, 273, 1, 272, 0, 0, 0
4896, 1, 1636430211682, 1636430211957, 275, 0, 275, 0, 0, 0
4898, 1, 1636430211778, 1636430212049, 271, 0, 271, 0, 0, 0
4900, 1, 1636430212245, 1636430212517, 272, 1, 271, 0, 0, 0
4901, 1, 1636430212697, 1636430212973, 276, 1, 275, 0, 1, 1
4903, 1, 1636430213154, 1636430213426, 272, 0, 272, 0, 0, 0
4905, 1, 1636430213609, 1636430213882, 273, 1, 272, 0, 0, 0
4912, 1, 1636430215750, 1636430216022, 272, 0, 272, 0, 0, 0
4917, 1, 1636430217841, 1636430218114, 273, 1, 272, 0, 0, 0
4920, 1, 1636430219817, 1636430220090, 273, 0, 273, 0, 0, 0
4924, 1, 1636430221826, 1636430222098, 272, 0, 272, 0, 0, 0
4929, 1, 1636430223865, 1636430224137, 272, 1, 271, 1, 0, 1
4909, 1, 1636430224474, 1636430224750, 276, 0, 276, 0, 0, 0
4936, 1, 1636430226010, 1636430226282, 272, 0, 272, 0, 0, 0
4940, 1, 1636430227966, 1636430228238, 272, 0, 272, 0, 0, 0
4944, 1, 1636430229901, 1636430230174, 273, 0, 273, 0, 0, 0
4948, 1, 1636430231826, 1636430232098, 272, 0, 272, 0, 0, 0
4953, 1, 1636430233965, 1636430234242, 277, 0, 277, 0, 0, 0
4933, 1, 1636430234778, 1636430235046, 268, 0, 268, 0, 0, 0
4960, 1, 1636430235942, 1636430236213, 271, 0, 271, 0, 0, 0
4964, 1, 1636430238085, 1636430238358, 273, 1, 272, 0, 0, 0
4968, 1, 1636430239942, 1636430240214, 272, 0, 272, 0, 0, 0
4971, 1, 1636430241870, 1636430242142, 272, 0, 272, 0, 0, 0
4976, 1, 1636430243877, 1636430244150, 273, 1, 272, 0, 1, 1
4957, 1, 1636430245085, 1636430245358, 273, 1, 272, 0, 0, 0
4982, 1, 1636430245989, 1636430246262, 273, 1, 272, 0, 0, 0
4983, 1, 1636430246093, 1636430246366, 273, 1, 272, 1, 0, 1
4984, 1, 1636430246542, 1636430246814, 272, 0, 272, 0, 0, 0
4985, 1, 1636430247001, 1636430247273, 272, 1, 271, 0, 1, 1
4986, 1, 1636430247458, 1636430247730, 272, 0, 272, 0, 0, 0
4987, 1, 1636430248018, 1636430248289, 271, 0, 271, 0, 0, 0
4988, 1, 1636430248038, 1636430248309, 271, 0, 271, 0, 0, 0
4989, 1, 1636430248109, 1636430248398, 289, 1, 288, 1, 0, 1
4990, 1, 1636430248490, 1636430248770, 280, 0, 280, 0, 0, 0
4991, 1, 1636430248654, 1636430248926, 272, 0, 272, 0, 0, 0
4992, 1, 1636430248953, 1636430249226, 273, 1, 272, 1, 0, 1
4993, 1, 1636430249109, 1636430249382, 273, 1, 272, 0, 0, 0
4994, 1, 1636430249409, 1636430249681, 272, 1, 271, 0, 0, 0
4995, 1, 1636430249965, 1636430250233, 268, 1, 267, 0, 0, 0
4997, 1, 1636430250054, 1636430250325, 271, 0, 271, 0, 0, 0
4999, 1, 1636430250229, 1636430250502, 273, 1, 272, 0, 0, 0
5000, 1, 1636430250697, 1636430250969, 272, 1, 271, 0, 0, 0
5002, 1, 1636430250870, 1636430251142, 272, 0, 272, 0, 0, 0
5003, 1, 1636430251154, 1636430251426, 272, 0, 272, 0, 0, 0
5005, 1, 1636430251869, 1636430252142, 273, 1, 272, 0, 0, 0
5007, 1, 1636430252050, 1636430252326, 276, 0, 276, 0, 0, 0
5008, 1, 1636430252262, 1636430252533, 271, 0, 271, 0, 0, 0
5009, 1, 1636430252502, 1636430252818, 316, 0, 316, 0, 0, 0
5011, 1, 1636430252905, 1636430253178, 273, 0, 273, 0, 0, 0
5013, 1, 1636430252997, 1636430253270, 273, 0, 273, 0, 0, 0
5014, 1, 1636430253449, 1636430253750, 301, 1, 300, 1, 0, 1
5015, 1, 1636430253926, 1636430254202, 276, 0, 276, 0, 0, 0
5017, 1, 1636430254009, 1636430254282, 273, 1, 272, 1, 0, 1
5016, 1, 1636430254014, 1636430254289, 275, 0, 275, 0, 0, 0
5019, 1, 1636430254377, 1636430254658, 281, 1, 280, 0, 1, 1
5020, 1, 1636430254466, 1636430254749, 283, 0, 283, 0, 0, 0
5021, 1, 1636430254930, 1636430255225, 295, 0, 295, 0, 0, 0
5023, 1, 1636430255017, 1636430255317, 300, 0, 300, 0, 0, 0
4981, 1, 1636430255397, 1636430255670, 273, 0, 273, 0, 0, 0
5024, 1, 1636430255405, 1636430255677, 272, 0, 272, 0, 0, 0
5025, 1, 1636430255501, 1636430255769, 268, 1, 267, 0, 1, 1
5027, 1, 1636430255857, 1636430256125, 268, 1, 267, 0, 0, 0
5026, 1, 1636430255949, 1636430256217, 268, 1, 267, 0, 0, 0
5030, 1, 1636430256066, 1636430256337, 271, 0, 271, 0, 0, 0
5031, 1, 1636430256305, 1636430256578, 273, 1, 272, 1, 0, 1
5029, 1, 1636430256397, 1636430256669, 272, 1, 271, 0, 0, 0
5034, 1, 1636430256985, 1636430257258, 273, 1, 272, 0, 0, 0
5036, 1, 1636430257518, 1636430257789, 271, 0, 271, 0, 0, 0
5037, 1, 1636430257973, 1636430258246, 273, 1, 272, 1, 0, 1
5039, 1, 1636430257985, 1636430258258, 273, 1, 272, 0, 1, 1
5040, 1, 1636430258430, 1636430258706, 276, 0, 276, 0, 0, 0
5046, 1, 1636430260146, 1636430260422, 276, 0, 276, 0, 0, 0
5048, 1, 1636430260370, 1636430260642, 272, 0, 272, 0, 0, 0
5047, 1, 1636430260826, 1636430261098, 272, 0, 272, 0, 0, 0
5049, 1, 1636430261285, 1636430261557, 272, 1, 271, 0, 1, 1
5050, 1, 1636430261742, 1636430262046, 304, 0, 304, 0, 0, 0
5051, 1, 1636430262130, 1636430262401, 271, 0, 271, 0, 0, 0
5052, 1, 1636430262222, 1636430262489, 267, 0, 267, 0, 0, 0
5053, 1, 1636430262301, 1636430262574, 273, 1, 272, 0, 1, 1
5054, 1, 1636430262758, 1636430263061, 303, 0, 303, 0, 0, 0
5055, 1, 1636430262970, 1636430263242, 272, 0, 272, 0, 0, 0
5056, 1, 1636430263238, 1636430263509, 271, 0, 271, 0, 0, 0
5057, 1, 1636430263417, 1636430263690, 273, 1, 272, 1, 0, 1
5058, 1, 1636430263694, 1636430263966, 272, 0, 272, 0, 0, 0
5059, 1, 1636430264026, 1636430264341, 315, 0, 315, 0, 0, 0
5060, 1, 1636430264157, 1636430264433, 276, 1, 275, 0, 0, 0
5061, 1, 1636430264334, 1636430264606, 272, 0, 272, 0, 0, 0
5063, 1, 1636430264502, 1636430264774, 272, 0, 272, 0, 0, 0
5062, 1, 1636430264789, 1636430265061, 272, 0, 272, 0, 0, 0
5064, 1, 1636430264942, 1636430265214, 272, 0, 272, 0, 0, 0
5065, 1, 1636430265202, 1636430265473, 271, 0, 271, 0, 0, 0
5067, 1, 1636430265241, 1636430265514, 273, 1, 272, 1, 0, 1
5066, 1, 1636430265398, 1636430265666, 268, 0, 268, 0, 0, 0
5068, 1, 1636430265730, 1636430266001, 271, 0, 271, 0, 0, 0
5069, 1, 1636430265978, 1636430266249, 271, 0, 271, 0, 0, 0
5070, 1, 1636430266253, 1636430266522, 269, 1, 268, 1, 0, 1
5071, 1, 1636430266253, 1636430266522, 269, 1, 268, 1, 0, 1
5072, 1, 1636430266253, 1636430266522, 269, 1, 268, 0, 0, 0
5074, 1, 1636430266425, 1636430266694, 269, 0, 269, 0, 0, 0
5073, 1, 1636430266701, 1636430267014, 313, 1, 312, 0, 0, 0
5075, 1, 1636430266701, 1636430267014, 313, 1, 312, 0, 0, 0
5076, 1, 1636430267009, 1636430267281, 272, 1, 271, 1, 0, 1
5078, 1, 1636430267161, 1636430267430, 269, 1, 268, 0, 0, 0
5079, 1, 1636430267193, 1636430267461, 268, 1, 267, 0, 0, 0
5077, 1, 1636430267205, 1636430267481, 276, 1, 275, 0, 1, 1
5080, 1, 1636430267465, 1636430267738, 273, 0, 273, 0, 0, 0
5082, 1, 1636430267689, 1636430267969, 280, 1, 279, 0, 0, 0
5081, 1, 1636430267670, 1636430267969, 299, 0, 299, 0, 0, 0
5083, 1, 1636430268085, 1636430268377, 292, 1, 291, 1, 0, 1
5085, 1, 1636430268193, 1636430268465, 272, 1, 271, 0, 1, 1
5086, 1, 1636430268193, 1636430268465, 272, 1, 271, 1, 0, 1
5087, 1, 1636430268193, 1636430268465, 272, 1, 271, 1, 0, 1
5084, 1, 1636430268193, 1636430268469, 276, 1, 275, 0, 1, 1
5089, 1, 1636430268461, 1636430268730, 269, 0, 269, 0, 0, 0
5088, 1, 1636430268641, 1636430268914, 273, 1, 272, 0, 0, 0
5091, 1, 1636430268650, 1636430268921, 271, 0, 271, 0, 0, 0
5090, 1, 1636430268650, 1636430268921, 271, 0, 271, 0, 0, 0
5092, 1, 1636430268917, 1636430269190, 273, 0, 273, 0, 0, 0
5093, 1, 1636430269093, 1636430269362, 269, 0, 269, 0, 0, 0
5094, 1, 1636430269161, 1636430269429, 268, 1, 267, 0, 0, 0
5097, 1, 1636430269245, 1636430269561, 316, 1, 315, 1, 0, 1
5096, 1, 1636430269273, 1636430269565, 292, 1, 291, 0, 0, 0
5095, 1, 1636430269362, 1636430269653, 291, 0, 291, 0, 0, 0
5045, 1, 1636430269605, 1636430269877, 272, 1, 271, 0, 0, 0
5098, 1, 1636430269605, 1636430269878, 273, 1, 272, 0, 0, 0
5099, 1, 1636430269705, 1636430269985, 280, 1, 279, 1, 0, 1
5100, 1, 1636430269817, 1636430270090, 273, 1, 272, 1, 0, 1
5102, 1, 1636430270065, 1636430270337, 272, 1, 271, 0, 0, 0
5104, 1, 1636430270105, 1636430270377, 272, 1, 271, 0, 0, 0
5105, 1, 1636430270165, 1636430270438, 273, 1, 272, 1, 0, 1
5103, 1, 1636430270165, 1636430270438, 273, 1, 272, 1, 0, 1
5108, 1, 1636430270257, 1636430270533, 276, 0, 276, 0, 0, 0
5101, 1, 1636430270269, 1636430270537, 268, 1, 267, 0, 0, 0
5109, 1, 1636430270441, 1636430270721, 280, 0, 280, 0, 0, 0
5110, 1, 1636430270529, 1636430270797, 268, 0, 268, 0, 0, 0
5106, 1, 1636430270617, 1636430270885, 268, 0, 268, 0, 0, 0
5107, 1, 1636430270709, 1636430270973, 264, 1, 263, 0, 0, 0
5111, 1, 1636430270709, 1636430270977, 268, 1, 267, 0, 0, 0
5112, 1, 1636430270793, 1636430271066, 273, 1, 272, 0, 0, 0
5113, 1, 1636430271065, 1636430271333, 268, 1, 267, 0, 0, 0
5115, 1, 1636430271178, 1636430271449, 271, 0, 271, 0, 0, 0
5116, 1, 1636430271193, 1636430271466, 273, 1, 272, 1, 0, 1
5114, 1, 1636430271237, 1636430271501, 264, 1, 263, 0, 0, 0
5117, 1, 1636430271245, 1636430271510, 265, 1, 264, 0, 0, 0
5118, 1, 1636430271633, 1636430271901, 268, 0, 268, 0, 0, 0
5119, 1, 1636430271653, 1636430271922, 269, 0, 269, 0, 0, 0
5120, 1, 1636430271741, 1636430272013, 272, 1, 271, 0, 0, 0
5123, 1, 1636430272105, 1636430272381, 276, 1, 275, 0, 1, 1
5122, 1, 1636430272105, 1636430272381, 276, 1, 275, 0, 1, 1
5124, 1, 1636430272125, 1636430272397, 272, 0, 272, 0, 0, 0
5126, 1, 1636430272185, 1636430272453, 268, 1, 267, 0, 0, 0
5121, 1, 1636430272197, 1636430272466, 269, 1, 268, 0, 0, 0
5127, 1, 1636430272218, 1636430272493, 275, 0, 275, 0, 0, 0
5129, 1, 1636430272313, 1636430272585, 272, 1, 271, 0, 1, 1
5125, 1, 1636430272561, 1636430272842, 281, 1, 280, 0, 0, 0
5130, 1, 1636430272626, 1636430272897, 271, 0, 271, 0, 0, 0
5128, 1, 1636430272649, 1636430272921, 272, 1, 271, 0, 0, 0
5131, 1, 1636430272673, 1636430272953, 280, 1, 279, 1, 0, 1
5132, 1, 1636430272673, 1636430272953, 280, 1, 279, 0, 0, 0
5133, 1, 1636430273022, 1636430273297, 275, 0, 275, 0, 0, 0
5135, 1, 1636430273133, 1636430273406, 273, 0, 273, 0, 0, 0
5134, 1, 1636430273137, 1636430273414, 277, 0, 277, 0, 0, 0
5136, 1, 1636430273158, 1636430273430, 272, 0, 272, 0, 0, 0
5138, 1, 1636430273321, 1636430273590, 269, 1, 268, 1, 0, 1
5139, 1, 1636430273565, 1636430273841, 276, 1, 275, 1, 0, 1
5137, 1, 1636430273606, 1636430273881, 275, 0, 275, 0, 0, 0
5140, 1, 1636430273865, 1636430274137, 272, 0, 272, 0, 0, 0
5143, 1, 1636430274005, 1636430274277, 272, 1, 271, 0, 0, 0
5142, 1, 1636430274022, 1636430274293, 271, 0, 271, 0, 0, 0
5144, 1, 1636430274106, 1636430274382, 276, 0, 276, 0, 0, 0
5145, 1, 1636430274161, 1636430274425, 264, 0, 264, 0, 0, 0
5146, 1, 1636430274169, 1636430274445, 276, 1, 275, 1, 0, 1
5147, 1, 1636430274202, 1636430274470, 268, 0, 268, 0, 0, 0
5148, 1, 1636430274561, 1636430274830, 269, 0, 269, 0, 0, 0
5150, 1, 1636430274602, 1636430274874, 272, 0, 272, 0, 0, 0
5152, 1, 1636430274606, 1636430274874, 268, 0, 268, 0, 0, 0
5151, 1, 1636430274622, 1636430274893, 271, 0, 271, 0, 0, 0
5153, 1, 1636430275005, 1636430275278, 273, 0, 273, 0, 0, 0
5155, 1, 1636430275025, 1636430275297, 272, 1, 271, 0, 0, 0
5154, 1, 1636430275057, 1636430275330, 273, 1, 272, 0, 1, 1
5156, 1, 1636430275077, 1636430275349, 272, 1, 271, 0, 0, 0
5158, 1, 1636430275289, 1636430275566, 277, 1, 276, 0, 0, 0
5157, 1, 1636430275525, 1636430275797, 272, 0, 272, 0, 0, 0
5159, 1, 1636430275566, 1636430275837, 271, 0, 271, 0, 0, 0
5160, 1, 1636430275841, 1636430276117, 276, 0, 276, 0, 0, 0
5161, 1, 1636430276038, 1636430276305, 267, 0, 267, 0, 0, 0
5162, 1, 1636430276093, 1636430276362, 269, 1, 268, 0, 1, 1
5163, 1, 1636430276097, 1636430276365, 268, 0, 268, 0, 0, 0
5164, 1, 1636430276137, 1636430276405, 268, 1, 267, 0, 0, 0
5165, 1, 1636430276149, 1636430276417, 268, 1, 267, 0, 0, 0
5169, 1, 1636430276581, 1636430276853, 272, 1, 271, 0, 0, 0
5170, 1, 1636430276606, 1636430276878, 272, 0, 272, 0, 0, 0
5171, 1, 1636430276950, 1636430277230, 280, 0, 280, 0, 0, 0
5172, 1, 1636430277025, 1636430277297, 272, 0, 272, 0, 0, 0
5173, 1, 1636430277069, 1636430277341, 272, 1, 271, 1, 0, 1
5175, 1, 1636430277478, 1636430277750, 272, 0, 272, 0, 0, 0
5179, 1, 1636430277933, 1636430278209, 276, 1, 275, 0, 0, 0
5180, 1, 1636430278090, 1636430278362, 272, 0, 272, 0, 0, 0
5182, 1, 1636430278145, 1636430278422, 277, 1, 276, 0, 1, 1
5183, 1, 1636430278158, 1636430278429, 271, 0, 271, 0, 0, 0
5184, 1, 1636430278542, 1636430278810, 268, 0, 268, 0, 0, 0
5187, 1, 1636430278989, 1636430279262, 273, 1, 272, 0, 0, 0
5186, 1, 1636430278993, 1636430279262, 269, 0, 269, 0, 0, 0
5189, 1, 1636430279442, 1636430279714, 272, 0, 272, 0, 0, 0
5190, 1, 1636430279901, 1636430280169, 268, 1, 267, 0, 0, 0
5192, 1, 1636430280201, 1636430280474, 273, 0, 273, 0, 0, 0
5193, 1, 1636430280209, 1636430280481, 272, 0, 272, 0, 0, 0
5194, 1, 1636430280666, 1636430280938, 272, 0, 272, 0, 0, 0
5195, 1, 1636430281122, 1636430281394, 272, 0, 272, 0, 0, 0
5197, 1, 1636430281574, 1636430281846, 272, 0, 272, 0, 0, 0
5198, 1, 1636430282029, 1636430282298, 269, 1, 268, 0, 0, 0
5199, 1, 1636430282106, 1636430282378, 272, 0, 272, 0, 0, 0
5205, 1, 1636430284146, 1636430284449, 303, 0, 303, 0, 0, 0
5208, 1, 1636430286225, 1636430286497, 272, 1, 271, 0, 0, 0
5209, 1, 1636430286793, 1636430287065, 272, 1, 271, 0, 0, 0
5213, 1, 1636430287545, 1636430287838, 293, 1, 292, 0, 0, 0
5215, 1, 1636430288153, 1636430288421, 268, 1, 267, 0, 0, 0
5216, 1, 1636430288241, 1636430288509, 268, 1, 267, 1, 0, 1
5218, 1, 1636430288717, 1636430288990, 273, 0, 273, 0, 0, 0
5220, 1, 1636430289337, 1636430289610, 273, 0, 273, 0, 0, 0
5222, 1, 1636430289910, 1636430290225, 315, 0, 315, 0, 0, 0
5223, 1, 1636430290325, 1636430290597, 272, 1, 271, 0, 0, 0
5225, 1, 1636430290774, 1636430291062, 288, 0, 288, 0, 0, 0
5227, 1, 1636430291357, 1636430291633, 276, 0, 276, 0, 0, 0
5228, 1, 1636430291989, 1636430292282, 293, 1, 292, 0, 0, 0
5229, 1, 1636430292282, 1636430292554, 272, 0, 272, 0, 0, 0
5204, 1, 1636430293337, 1636430293606, 269, 1, 268, 1, 0, 1
5238, 1, 1636430294262, 1636430294534, 272, 0, 272, 0, 0, 0
5239, 1, 1636430294934, 1636430295205, 271, 0, 271, 0, 0, 0
5240, 1, 1636430295390, 1636430295662, 272, 0, 272, 0, 0, 0
5241, 1, 1636430296397, 1636430296670, 273, 1, 272, 0, 0, 0
5242, 1, 1636430296797, 1636430297069, 272, 1, 271, 0, 0, 0
5243, 1, 1636430297245, 1636430297550, 305, 1, 304, 0, 1, 1
5250, 1, 1636430298685, 1636430298957, 272, 1, 271, 0, 1, 1
5251, 1, 1636430299133, 1636430299406, 273, 1, 272, 0, 1, 1
5254, 1, 1636430300726, 1636430301001, 275, 0, 275, 0, 0, 0
5256, 1, 1636430301185, 1636430301453, 268, 1, 267, 0, 1, 1
5258, 1, 1636430302833, 1636430303138, 305, 1, 304, 0, 0, 0
5261, 1, 1636430303049, 1636430303361, 312, 1, 311, 0, 0, 0
5260, 1, 1636430303341, 1636430303614, 273, 1, 272, 0, 1, 1
5263, 1, 1636430303690, 1636430304053, 363, 0, 363, 0, 0, 0
5248, 1, 1636430304005, 1636430304278, 273, 0, 273, 0, 0, 0
5266, 1, 1636430304233, 1636430304506, 273, 0, 273, 0, 0, 0
5268, 1, 1636430304674, 1636430304946, 272, 0, 272, 0, 0, 0
5269, 1, 1636430304745, 1636430305017, 272, 0, 272, 0, 0, 0
5270, 1, 1636430305197, 1636430305470, 273, 1, 272, 0, 0, 0
5274, 1, 1636430306506, 1636430306782, 276, 0, 276, 0, 0, 0
5280, 1, 1636430308442, 1636430308714, 272, 0, 272, 0, 0, 0
5285, 1, 1636430310382, 1636430310653, 271, 0, 271, 0, 0, 0
5288, 1, 1636430312386, 1636430312657, 271, 0, 271, 0, 0, 0
5293, 1, 1636430314454, 1636430314726, 272, 0, 272, 0, 0, 0
5298, 1, 1636430316446, 1636430316718, 272, 0, 272, 0, 0, 0
5276, 1, 1636430316769, 1636430317041, 272, 1, 271, 0, 0, 0
5304, 1, 1636430318382, 1636430318658, 276, 0, 276, 0, 0, 0
5308, 1, 1636430320333, 1636430320610, 277, 0, 277, 0, 0, 0
5312, 1, 1636430322278, 1636430322550, 272, 0, 272, 0, 0, 0
5315, 1, 1636430324229, 1636430324506, 277, 1, 276, 1, 0, 1
5321, 1, 1636430326242, 1636430326514, 272, 0, 272, 0, 0, 0
5300, 1, 1636430327078, 1636430327350, 272, 0, 272, 0, 0, 0
5327, 1, 1636430328102, 1636430328390, 288, 0, 288, 0, 0, 0
5332, 1, 1636430330217, 1636430330526, 309, 1, 308, 0, 1, 1
5335, 1, 1636430332210, 1636430332482, 272, 0, 272, 0, 0, 0
5338, 1, 1636430334149, 1636430334458, 309, 0, 309, 0, 0, 0
5344, 1, 1636430336058, 1636430336337, 279, 0, 279, 0, 0, 0
5324, 1, 1636430337385, 1636430337658, 273, 1, 272, 0, 0, 0
5349, 1, 1636430338149, 1636430338430, 281, 1, 280, 0, 0, 0
5355, 1, 1636430340062, 1636430340378, 316, 0, 316, 0, 0, 0
5358, 1, 1636430341970, 1636430342242, 272, 0, 272, 0, 0, 0
5361, 1, 1636430344025, 1636430344298, 273, 1, 272, 0, 1, 1
5367, 1, 1636430346070, 1636430346342, 272, 0, 272, 0, 0, 0
5348, 1, 1636430347698, 1636430347974, 276, 0, 276, 0, 0, 0
5372, 1, 1636430348149, 1636430348465, 316, 1, 315, 0, 0, 0
5378, 1, 1636430350058, 1636430350330, 272, 0, 272, 0, 0, 0
5382, 1, 1636430352009, 1636430352282, 273, 1, 272, 0, 1, 1
5385, 1, 1636430358370, 1636430358641, 271, 0, 271, 0, 0, 0
5398, 1, 1636430359034, 1636430359330, 296, 0, 296, 0, 0, 0
5402, 1, 1636430361038, 1636430361310, 272, 0, 272, 0, 0, 0
5406, 1, 1636430363126, 1636430363398, 272, 0, 272, 0, 0, 0
5409, 1, 1636430364993, 1636430365266, 273, 1, 272, 1, 0, 1
5415, 1, 1636430366862, 1636430367178, 316, 0, 316, 0, 0, 0
5395, 1, 1636430368314, 1636430368586, 272, 0, 272, 0, 0, 0
5419, 1, 1636430368770, 1636430369082, 312, 0, 312, 0, 0, 0
5426, 1, 1636430370866, 1636430371137, 271, 0, 271, 0, 0, 0
5429, 1, 1636430372846, 1636430373118, 272, 0, 272, 0, 0, 0
5420, 1, 1636430378622, 1636430378894, 272, 0, 272, 0, 0, 0
5441, 1, 1636430388938, 1636430389210, 272, 0, 272, 0, 0, 0
5462, 1, 1636430389926, 1636430390198, 272, 0, 272, 0, 0, 0
5461, 1, 1636430390381, 1636430390654, 273, 0, 273, 0, 0, 0
5463, 1, 1636430390838, 1636430391110, 272, 0, 272, 0, 0, 0
5464, 1, 1636430391286, 1636430391558, 272, 0, 272, 0, 0, 0
5465, 1, 1636430391749, 1636430392017, 268, 0, 268, 0, 0, 0
5466, 1, 1636430391837, 1636430392109, 272, 1, 271, 1, 0, 1
5468, 1, 1636430392201, 1636430392474, 273, 1, 272, 0, 0, 0
5467, 1, 1636430392285, 1636430392558, 273, 1, 272, 0, 0, 0
5469, 1, 1636430392649, 1636430392922, 273, 1, 272, 0, 0, 0
5470, 1, 1636430392738, 1636430393009, 271, 0, 271, 0, 0, 0
5471, 1, 1636430393225, 1636430393498, 273, 1, 272, 0, 0, 0
5473, 1, 1636430393578, 1636430393850, 272, 0, 272, 0, 0, 0
5472, 1, 1636430393682, 1636430393954, 272, 0, 272, 0, 0, 0
5474, 1, 1636430393917, 1636430394225, 308, 0, 308, 0, 0, 0
5476, 1, 1636430394129, 1636430394398, 269, 1, 268, 1, 0, 1
5477, 1, 1636430394398, 1636430394673, 275, 0, 275, 0, 0, 0
5475, 1, 1636430394409, 1636430394681, 272, 1, 271, 0, 0, 0
5478, 1, 1636430394577, 1636430394850, 273, 0, 273, 0, 0, 0
5479, 1, 1636430394865, 1636430395134, 269, 1, 268, 1, 0, 1
5480, 1, 1636430395318, 1636430395589, 271, 0, 271, 0, 0, 0
5482, 1, 1636430395546, 1636430395822, 276, 0, 276, 0, 0, 0
5483, 1, 1636430395650, 1636430395926, 276, 0, 276, 0, 0, 0
5481, 1, 1636430395761, 1636430396030, 269, 0, 269, 0, 0, 0
5484, 1, 1636430395850, 1636430396121, 271, 0, 271, 0, 0, 0
5486, 1, 1636430396113, 1636430396385, 272, 1, 271, 0, 1, 1
5487, 1, 1636430396210, 1636430396482, 272, 0, 272, 0, 0, 0
5485, 1, 1636430396306, 1636430396573, 267, 0, 267, 0, 0, 0
5488, 1, 1636430396385, 1636430396658, 273, 1, 272, 1, 0, 1
5490, 1, 1636430396569, 1636430396857, 288, 1, 287, 1, 0, 1
5491, 1, 1636430396661, 1636430396946, 285, 1, 284, 1, 0, 1
5489, 1, 1636430396769, 1636430397037, 268, 0, 268, 0, 0, 0
5492, 1, 1636430397037, 1636430397309, 272, 1, 271, 0, 1, 1
5493, 1, 1636430397213, 1636430397490, 277, 1, 276, 0, 0, 0
5494, 1, 1636430397497, 1636430397765, 268, 1, 267, 0, 1, 1
5496, 1, 1636430397565, 1636430397833, 268, 0, 268, 0, 0, 0
5497, 1, 1636430397610, 1636430397878, 268, 0, 268, 0, 0, 0
5495, 1, 1636430397669, 1636430397942, 273, 1, 272, 0, 0, 0
5498, 1, 1636430397682, 1636430397954, 272, 0, 272, 0, 0, 0
5499, 1, 1636430397942, 1636430398209, 267, 0, 267, 0, 0, 0
5502, 1, 1636430398105, 1636430398378, 273, 0, 273, 0, 0, 0
5501, 1, 1636430398121, 1636430398393, 272, 0, 272, 0, 0, 0
5500, 1, 1636430398129, 1636430398402, 273, 1, 272, 0, 0, 0
5503, 1, 1636430398390, 1636430398670, 280, 0, 280, 0, 0, 0
5504, 1, 1636430398393, 1636430398670, 277, 1, 276, 0, 1, 1
5506, 1, 1636430398581, 1636430398854, 273, 1, 272, 1, 0, 1
5507, 1, 1636430398581, 1636430398854, 273, 1, 272, 1, 0, 1
5505, 1, 1636430398585, 1636430398857, 272, 0, 272, 0, 0, 0
5509, 1, 1636430398929, 1636430399201, 272, 1, 271, 0, 0, 0
5508, 1, 1636430399037, 1636430399309, 272, 0, 272, 0, 0, 0
5510, 1, 1636430399042, 1636430399321, 279, 0, 279, 0, 0, 0
5460, 1, 1636430399246, 1636430399521, 275, 0, 275, 0, 0, 0
5513, 1, 1636430399441, 1636430399710, 269, 0, 269, 0, 0, 0
5511, 1, 1636430399485, 1636430399753, 268, 1, 267, 0, 0, 0
5512, 1, 1636430399501, 1636430399773, 272, 1, 271, 0, 0, 0
5514, 1, 1636430399545, 1636430399810, 265, 1, 264, 0, 0, 0
5515, 1, 1636430399609, 1636430399881, 272, 0, 272, 0, 0, 0
5516, 1, 1636430399657, 1636430399930, 273, 1, 272, 1, 0, 1
5517, 1, 1636430399929, 1636430400198, 269, 1, 268, 0, 0, 0
5519, 1, 1636430399990, 1636430400261, 271, 0, 271, 0, 0, 0
5520, 1, 1636430400041, 1636430400309, 268, 0, 268, 0, 0, 0
5518, 1, 1636430400101, 1636430400373, 272, 1, 271, 0, 1, 1
5521, 1, 1636430400197, 1636430400465, 268, 1, 267, 0, 0, 0
5522, 1, 1636430400281, 1636430400550, 269, 0, 269, 0, 0, 0
5523, 1, 1636430400373, 1636430400645, 272, 1, 271, 1, 0, 1
5525, 1, 1636430400490, 1636430400754, 264, 0, 264, 0, 0, 0
5524, 1, 1636430400553, 1636430400825, 272, 0, 272, 0, 0, 0
5526, 1, 1636430400641, 1636430400910, 269, 1, 268, 0, 0, 0
5529, 1, 1636430400933, 1636430401205, 272, 1, 271, 0, 0, 0
5528, 1, 1636430401005, 1636430401277, 272, 1, 271, 0, 0, 0
5527, 1, 1636430401085, 1636430401357, 272, 1, 271, 0, 1, 1
5532, 1, 1636430401385, 1636430401657, 272, 1, 271, 0, 0, 0
5531, 1, 1636430401465, 1636430401737, 272, 0, 272, 0, 0, 0
5530, 1, 1636430401529, 1636430401793, 264, 0, 264, 0, 0, 0
5533, 1, 1636430401569, 1636430401841, 272, 0, 272, 0, 0, 0
5534, 1, 1636430401573, 1636430401841, 268, 0, 268, 0, 0, 0
5535, 1, 1636430401637, 1636430401914, 277, 0, 277, 0, 0, 0
5537, 1, 1636430401973, 1636430402241, 268, 0, 268, 0, 0, 0
5539, 1, 1636430401989, 1636430402261, 272, 0, 272, 0, 0, 0
5538, 1, 1636430402017, 1636430402285, 268, 0, 268, 0, 0, 0
5536, 1, 1636430402093, 1636430402370, 277, 1, 276, 0, 0, 0
5540, 1, 1636430402153, 1636430402426, 273, 1, 272, 0, 0, 0
5541, 1, 1636430402221, 1636430402494, 273, 0, 273, 0, 0, 0
5544, 1, 1636430402426, 1636430402706, 280, 0, 280, 0, 0, 0
5543, 1, 1636430402438, 1636430402709, 271, 0, 271, 0, 0, 0
5542, 1, 1636430402550, 1636430402822, 272, 0, 272, 0, 0, 0
5545, 1, 1636430402606, 1636430402873, 267, 0, 267, 0, 0, 0
5547, 1, 1636430403002, 1636430403278, 276, 0, 276, 0, 0, 0
5548, 1, 1636430403010, 1636430403285, 275, 0, 275, 0, 0, 0
5546, 1, 1636430403049, 1636430403322, 273, 0, 273, 0, 0, 0
5551, 1, 1636430403357, 1636430403633, 276, 1, 275, 1, 0, 1
5550, 1, 1636430403457, 1636430403734, 277, 0, 277, 0, 0, 0
5549, 1, 1636430403501, 1636430403765, 264, 1, 263, 0, 1, 1
5552, 1, 1636430403525, 1636430403797, 272, 1, 271, 1, 0, 1
5553, 1, 1636430403525, 1636430403801, 276, 1, 275, 0, 0, 0
5555, 1, 1636430403709, 1636430403977, 268, 0, 268, 0, 0, 0
5557, 1, 1636430403917, 1636430404189, 272, 0, 272, 0, 0, 0
5554, 1, 1636430403953, 1636430404229, 276, 1, 275, 0, 0, 0
5556, 1, 1636430403977, 1636430404253, 276, 1, 275, 0, 0, 0
5559, 1, 1636430404101, 1636430404373, 272, 1, 271, 0, 0, 0
5558, 1, 1636430404161, 1636430404433, 272, 1, 271, 1, 0, 1
5560, 1, 1636430404189, 1636430404465, 276, 1, 275, 0, 0, 0
5562, 1, 1636430404373, 1636430404642, 269, 1, 268, 0, 0, 0
5563, 1, 1636430404413, 1636430404685, 272, 0, 272, 0, 0, 0
5561, 1, 1636430404433, 1636430404710, 277, 1, 276, 0, 0, 0
5564, 1, 1636430404553, 1636430404826, 273, 1, 272, 1, 0, 1
5566, 1, 1636430404893, 1636430405162, 269, 1, 268, 1, 0, 1
5567, 1, 1636430404889, 1636430405162, 273, 1, 272, 1, 0, 1
5565, 1, 1636430405009, 1636430405281, 272, 1, 271, 0, 0, 0
5570, 1, 1636430405277, 1636430405554, 277, 1, 276, 0, 0, 0
5569, 1, 1636430405345, 1636430405622, 277, 1, 276, 0, 0, 0
5571, 1, 1636430405421, 1636430405693, 272, 0, 272, 0, 0, 0
5568, 1, 1636430405466, 1636430405733, 267, 0, 267, 0, 0, 0
5572, 1, 1636430405497, 1636430405765, 268, 1, 267, 1, 0, 1
5573, 1, 1636430405669, 1636430405938, 269, 1, 268, 0, 0, 0
5576, 1, 1636430405825, 1636430406097, 272, 0, 272, 0, 0, 0
5575, 1, 1636430405905, 1636430406174, 269, 0, 269, 0, 0, 0
5574, 1, 1636430405949, 1636430406217, 268, 1, 267, 0, 0, 0
5578, 1, 1636430406073, 1636430406346, 273, 0, 273, 0, 0, 0
5577, 1, 1636430406117, 1636430406390, 273, 1, 272, 0, 0, 0
5580, 1, 1636430406173, 1636430406441, 268, 1, 267, 0, 0, 0
5582, 1, 1636430406277, 1636430406549, 272, 1, 271, 1, 0, 1
5581, 1, 1636430406349, 1636430406621, 272, 0, 272, 0, 0, 0
5579, 1, 1636430406393, 1636430406661, 268, 0, 268, 0, 0, 0
5583, 1, 1636430406529, 1636430406797, 268, 1, 267, 0, 0, 0
5586, 1, 1636430406810, 1636430407081, 271, 0, 271, 0, 0, 0
5585, 1, 1636430406845, 1636430407117, 272, 1, 271, 0, 0, 0
5584, 1, 1636430406981, 1636430407253, 272, 1, 271, 1, 0, 1
5588, 1, 1636430407237, 1636430407510, 273, 0, 273, 0, 0, 0
5589, 1, 1636430407298, 1636430407561, 263, 0, 263, 0, 0, 0
5590, 1, 1636430407406, 1636430407678, 272, 0, 272, 0, 0, 0
5587, 1, 1636430407433, 1636430407706, 273, 0, 273, 0, 0, 0
5591, 1, 1636430407597, 1636430407866, 269, 1, 268, 0, 0, 0
5592, 1, 1636430407617, 1636430407885, 268, 1, 267, 0, 1, 1
5595, 1, 1636430407801, 1636430408077, 276, 0, 276, 0, 0, 0
5593, 1, 1636430407889, 1636430408153, 264, 1, 263, 1, 0, 1
5594, 1, 1636430408049, 1636430408321, 272, 1, 271, 0, 0, 0
5597, 1, 1636430408053, 1636430408321, 268, 1, 267, 0, 1, 1
5598, 1, 1636430408057, 1636430408333, 276, 0, 276, 0, 0, 0
5596, 1, 1636430408061, 1636430408342, 281, 0, 281, 0, 0, 0
5600, 1, 1636430408262, 1636430408537, 275, 0, 275, 0, 0, 0
5599, 1, 1636430408333, 1636430408609, 276, 0, 276, 0, 0, 0
5602, 1, 1636430408506, 1636430408777, 271, 0, 271, 0, 0, 0
5601, 1, 1636430408506, 1636430408781, 275, 0, 275, 0, 0, 0
5605, 1, 1636430408790, 1636430409061, 271, 0, 271, 0, 0, 0
5603, 1, 1636430408961, 1636430409233, 272, 1, 271, 0, 0, 0
5604, 1, 1636430408961, 1636430409233, 272, 1, 271, 1, 0, 1
5607, 1, 1636430409194, 1636430409465, 271, 0, 271, 0, 0, 0
5608, 1, 1636430409278, 1636430409553, 275, 0, 275, 0, 0, 0
5606, 1, 1636430409413, 1636430409681, 268, 1, 267, 0, 0, 0
5609, 1, 1636430409413, 1636430409685, 272, 1, 271, 0, 0, 0
5610, 1, 1636430409473, 1636430409741, 268, 0, 268, 0, 0, 0
5611, 1, 1636430409557, 1636430409833, 276, 0, 276, 0, 0, 0
5612, 1, 1636430409857, 1636430410125, 268, 1, 267, 0, 1, 1
5615, 1, 1636430409865, 1636430410133, 268, 1, 267, 0, 0, 0
5613, 1, 1636430409921, 1636430410193, 272, 1, 271, 0, 0, 0
5616, 1, 1636430409938, 1636430410201, 263, 0, 263, 0, 0, 0
5617, 1, 1636430410029, 1636430410294, 265, 1, 264, 0, 1, 1
5614, 1, 1636430410017, 1636430410294, 277, 1, 276, 0, 0, 0
5618, 1, 1636430410305, 1636430410581, 276, 1, 275, 0, 1, 1
5620, 1, 1636430410309, 1636430410585, 276, 1, 275, 0, 0, 0
5619, 1, 1636430410377, 1636430410649, 272, 1, 271, 0, 1, 1
5621, 1, 1636430410381, 1636430410649, 268, 0, 268, 0, 0, 0
5624, 1, 1636430410766, 1636430411038, 272, 0, 272, 0, 0, 0
5622, 1, 1636430410829, 1636430411101, 272, 1, 271, 0, 0, 0
5623, 1, 1636430410829, 1636430411105, 276, 1, 275, 1, 0, 1
5626, 1, 1636430411237, 1636430411502, 265, 0, 265, 0, 0, 0
5625, 1, 1636430411281, 1636430411553, 272, 1, 271, 0, 0, 0
5627, 1, 1636430411293, 1636430411561, 268, 1, 267, 0, 0, 0
5628, 1, 1636430411317, 1636430411589, 272, 1, 271, 0, 1, 1
5629, 1, 1636430411461, 1636430411733, 272, 1, 271, 0, 1, 1
5630, 1, 1636430411541, 1636430411817, 276, 1, 275, 1, 0, 1
5631, 1, 1636430411733, 1636430412001, 268, 0, 268, 0, 0, 0
5634, 1, 1636430411853, 1636430412126, 273, 1, 272, 0, 0, 0
5635, 1, 1636430411853, 1636430412126, 273, 1, 272, 0, 0, 0
5633, 1, 1636430411913, 1636430412182, 269, 0, 269, 0, 0, 0
5632, 1, 1636430411997, 1636430412277, 280, 0, 280, 0, 0, 0
5636, 1, 1636430412041, 1636430412317, 276, 1, 275, 0, 1, 1
5637, 1, 1636430412177, 1636430412445, 268, 0, 268, 0, 0, 0
5640, 1, 1636430412306, 1636430412578, 272, 0, 272, 0, 0, 0
5638, 1, 1636430412306, 1636430412578, 272, 0, 272, 0, 0, 0
5639, 1, 1636430412353, 1636430412622, 269, 0, 269, 0, 0, 0
5643, 1, 1636430412662, 1636430412933, 271, 0, 271, 0, 0, 0
5641, 1, 1636430412753, 1636430413022, 269, 1, 268, 0, 0, 0
5642, 1, 1636430412798, 1636430413069, 271, 0, 271, 0, 0, 0
5645, 1, 1636430413173, 1636430413445, 272, 1, 271, 0, 0, 0
5644, 1, 1636430413201, 1636430413469, 268, 1, 267, 0, 1, 1
5646, 1, 1636430413241, 1636430413513, 272, 0, 272, 0, 0, 0
5647, 1, 1636430413265, 1636430413537, 272, 0, 272, 0, 0, 0
5648, 1, 1636430413385, 1636430413662, 277, 0, 277, 0, 0, 0
5649, 1, 1636430413429, 1636430413697, 268, 0, 268, 0, 0, 0
5650, 1, 1636430413645, 1636430413913, 268, 1, 267, 0, 0, 0
5653, 1, 1636430413785, 1636430414049, 264, 1, 263, 0, 0, 0
5652, 1, 1636430413833, 1636430414105, 272, 0, 272, 0, 0, 0
5651, 1, 1636430413869, 1636430414133, 264, 1, 263, 0, 0, 0
5654, 1, 1636430413917, 1636430414185, 268, 0, 268, 0, 0, 0
5655, 1, 1636430413958, 1636430414225, 267, 0, 267, 0, 0, 0
5656, 1, 1636430414090, 1636430414361, 271, 0, 271, 0, 0, 0
5657, 1, 1636430414237, 1636430414514, 277, 1, 276, 0, 1, 1
5658, 1, 1636430414293, 1636430414565, 272, 1, 271, 0, 0, 0
5659, 1, 1636430414409, 1636430414681, 272, 1, 271, 1, 0, 1
5662, 1, 1636430414625, 1636430414894, 269, 1, 268, 1, 0, 1
5661, 1, 1636430414749, 1636430415021, 272, 1, 271, 0, 1, 1
5664, 1, 1636430415109, 1636430415382, 273, 1, 272, 1, 0, 1
5665, 1, 1636430415126, 1636430415398, 272, 0, 272, 0, 0, 0
5666, 1, 1636430415225, 1636430415497, 272, 1, 271, 0, 0, 0
5667, 1, 1636430415378, 1636430415649, 271, 0, 271, 0, 0, 0
5668, 1, 1636430415469, 1636430415741, 272, 1, 271, 1, 0, 1
5671, 1, 1636430415745, 1636430416014, 269, 1, 268, 0, 0, 0
5669, 1, 1636430415833, 1636430416098, 265, 0, 265, 0, 0, 0
5673, 1, 1636430415837, 1636430416101, 264, 1, 263, 1, 0, 1
5674, 1, 1636430415906, 1636430416169, 263, 0, 263, 0, 0, 0
5672, 1, 1636430415914, 1636430416185, 271, 0, 271, 0, 0, 0
5676, 1, 1636430416194, 1636430416466, 272, 0, 272, 0, 0, 0
5678, 1, 1636430416278, 1636430416550, 272, 0, 272, 0, 0, 0
5677, 1, 1636430416366, 1636430416633, 267, 0, 267, 0, 0, 0
5679, 1, 1636430416817, 1636430417089, 272, 1, 271, 0, 1, 1
5681, 1, 1636430417030, 1636430417301, 271, 0, 271, 0, 0, 0
5682, 1, 1636430417069, 1636430417342, 273, 1, 272, 0, 0, 0
5683, 1, 1636430417301, 1636430417573, 272, 1, 271, 0, 0, 0
5685, 1, 1636430417541, 1636430417813, 272, 1, 271, 0, 0, 0
5688, 1, 1636430417766, 1636430418041, 275, 0, 275, 0, 0, 0
5689, 1, 1636430417813, 1636430418081, 268, 1, 267, 0, 1, 1
5690, 1, 1636430417865, 1636430418133, 268, 1, 267, 0, 1, 1
5687, 1, 1636430417993, 1636430418262, 269, 1, 268, 1, 0, 1
5691, 1, 1636430418217, 1636430418485, 268, 0, 268, 0, 0, 0
5692, 1, 1636430418262, 1636430418533, 271, 0, 271, 0, 0, 0
5693, 1, 1636430418442, 1636430418710, 268, 0, 268, 0, 0, 0
5694, 1, 1636430418893, 1636430419165, 272, 1, 271, 0, 0, 0
5695, 1, 1636430419026, 1636430419298, 272, 0, 272, 0, 0, 0
5696, 1, 1636430419117, 1636430419393, 276, 1, 275, 1, 0, 1
5697, 1, 1636430419378, 1636430419654, 276, 0, 276, 0, 0, 0
5698, 1, 1636430419649, 1636430419929, 280, 1, 279, 1, 0, 1
5700, 1, 1636430419782, 1636430420049, 267, 0, 267, 0, 0, 0
5701, 1, 1636430419849, 1636430420117, 268, 0, 268, 0, 0, 0
5702, 1, 1636430419889, 1636430420153, 264, 0, 264, 0, 0, 0
5699, 1, 1636430420109, 1636430420377, 268, 1, 267, 1, 0, 1
5703, 1, 1636430420229, 1636430420502, 273, 1, 272, 1, 0, 1
5704, 1, 1636430420294, 1636430420566, 272, 0, 272, 0, 0, 0
5705, 1, 1636430420558, 1636430420830, 272, 0, 272, 0, 0, 0
5706, 1, 1636430421013, 1636430421286, 273, 1, 272, 0, 1, 1
5707, 1, 1636430421113, 1636430421386, 273, 1, 272, 0, 0, 0
5708, 1, 1636430421205, 1636430421478, 273, 1, 272, 0, 0, 0
5709, 1, 1636430421486, 1636430421753, 267, 0, 267, 0, 0, 0
5710, 1, 1636430421637, 1636430421910, 273, 1, 272, 0, 0, 0
5712, 1, 1636430421861, 1636430422133, 272, 0, 272, 0, 0, 0
5713, 1, 1636430421949, 1636430422222, 273, 1, 272, 0, 0, 0
5714, 1, 1636430422009, 1636430422282, 273, 1, 272, 0, 0, 0
5711, 1, 1636430422093, 1636430422365, 272, 1, 271, 1, 0, 1
5715, 1, 1636430422317, 1636430422585, 268, 0, 268, 0, 0, 0
5717, 1, 1636430422401, 1636430422674, 273, 1, 272, 0, 1, 1
5716, 1, 1636430422545, 1636430422817, 272, 0, 272, 0, 0, 0
5718, 1, 1636430423002, 1636430423273, 271, 0, 271, 0, 0, 0
5719, 1, 1636430423185, 1636430423458, 273, 1, 272, 0, 0, 0
5720, 1, 1636430423242, 1636430423513, 271, 0, 271, 0, 0, 0
5721, 1, 1636430423454, 1636430423722, 268, 0, 268, 0, 0, 0
5724, 1, 1636430423905, 1636430424177, 272, 0, 272, 0, 0, 0
5725, 1, 1636430423942, 1636430424214, 272, 0, 272, 0, 0, 0
5726, 1, 1636430424033, 1636430424306, 273, 0, 273, 0, 0, 0
5727, 1, 1636430424386, 1636430424658, 272, 0, 272, 0, 0, 0
5728, 1, 1636430424397, 1636430424669, 272, 1, 271, 0, 0, 0
5732, 1, 1636430425169, 1636430425441, 272, 1, 271, 0, 0, 0
5733, 1, 1636430425226, 1636430425494, 268, 0, 268, 0, 0, 0
5734, 1, 1636430425289, 1636430425566, 277, 1, 276, 0, 1, 1
5731, 1, 1636430425617, 1636430425889, 272, 0, 272, 0, 0, 0
5738, 1, 1636430425962, 1636430426233, 271, 0, 271, 0, 0, 0
5739, 1, 1636430426017, 1636430426281, 264, 0, 264, 0, 0, 0
5736, 1, 1636430426062, 1636430426325, 263, 0, 263, 0, 0, 0
5742, 1, 1636430426461, 1636430426770, 309, 0, 309, 0, 0, 0
5741, 1, 1636430426506, 1636430426782, 276, 0, 276, 0, 0, 0
5743, 1, 1636430427029, 1636430427297, 268, 1, 267, 0, 1, 1
5744, 1, 1636430427121, 1636430427397, 276, 1, 275, 0, 0, 0
5747, 1, 1636430427278, 1636430427550, 272, 0, 272, 0, 0, 0
5686, 1, 1636430427482, 1636430427754, 272, 0, 272, 0, 0, 0
5745, 1, 1636430427573, 1636430427845, 272, 1, 271, 1, 0, 1
5749, 1, 1636430427785, 1636430428057, 272, 1, 271, 0, 1, 1
5750, 1, 1636430427934, 1636430428205, 271, 0, 271, 0, 0, 0
5748, 1, 1636430428025, 1636430428301, 276, 1, 275, 0, 0, 0
5752, 1, 1636430428242, 1636430428514, 272, 0, 272, 0, 0, 0
5753, 1, 1636430428389, 1636430428662, 273, 1, 272, 1, 0, 1
5754, 1, 1636430428481, 1636430428753, 272, 1, 271, 0, 1, 1
5755, 1, 1636430428990, 1636430429262, 272, 0, 272, 0, 0, 0
5756, 1, 1636430429153, 1636430429426, 273, 1, 272, 1, 0, 1
5757, 1, 1636430429609, 1636430429881, 272, 1, 271, 0, 0, 0
5759, 1, 1636430429745, 1636430430018, 273, 1, 272, 0, 0, 0
5760, 1, 1636430430065, 1636430430337, 272, 0, 272, 0, 0, 0
5762, 1, 1636430430230, 1636430430502, 272, 0, 272, 0, 0, 0
5764, 1, 1636430430513, 1636430430786, 273, 1, 272, 0, 1, 1
5765, 1, 1636430431009, 1636430431282, 273, 1, 272, 0, 0, 0
5766, 1, 1636430431029, 1636430431302, 273, 1, 272, 1, 0, 1
5767, 1, 1636430431486, 1636430431758, 272, 0, 272, 0, 0, 0
5769, 1, 1636430431769, 1636430432042, 273, 1, 272, 0, 1, 1
5768, 1, 1636430431941, 1636430432213, 272, 1, 271, 0, 1, 1
5770, 1, 1636430432306, 1636430432574, 268, 0, 268, 0, 0, 0
5771, 1, 1636430432398, 1636430432670, 272, 0, 272, 0, 0, 0
5772, 1, 1636430432890, 1636430433161, 271, 0, 271, 0, 0, 0
5773, 1, 1636430433009, 1636430433282, 273, 1, 272, 0, 0, 0
5774, 1, 1636430433462, 1636430433734, 272, 0, 272, 0, 0, 0
5776, 1, 1636430433754, 1636430434025, 271, 0, 271, 0, 0, 0
5775, 1, 1636430433909, 1636430434182, 273, 0, 273, 0, 0, 0
5779, 1, 1636430434261, 1636430434533, 272, 1, 271, 0, 0, 0
5780, 1, 1636430434393, 1636430434666, 273, 1, 272, 0, 1, 1
5782, 1, 1636430434846, 1636430435117, 271, 0, 271, 0, 0, 0
5784, 1, 1636430435109, 1636430435377, 268, 1, 267, 0, 0, 0
5785, 1, 1636430435561, 1636430435834, 273, 1, 272, 0, 0, 0
5786, 1, 1636430435613, 1636430435886, 273, 1, 272, 0, 0, 0
5787, 1, 1636430436014, 1636430436313, 299, 0, 299, 0, 0, 0
5789, 1, 1636430436225, 1636430436490, 265, 1, 264, 0, 0, 0
5791, 1, 1636430436494, 1636430436766, 272, 0, 272, 0, 0, 0
5793, 1, 1636430436950, 1636430437222, 272, 0, 272, 0, 0, 0
5794, 1, 1636430437217, 1636430437490, 273, 0, 273, 0, 0, 0
5797, 1, 1636430437614, 1636430437885, 271, 0, 271, 0, 0, 0
5795, 1, 1636430437674, 1636430437946, 272, 0, 272, 0, 0, 0
5798, 1, 1636430438125, 1636430438398, 273, 1, 272, 0, 0, 0
5800, 1, 1636430438306, 1636430438570, 264, 0, 264, 0, 0, 0
5801, 1, 1636430438573, 1636430438849, 276, 0, 276, 0, 0, 0
5802, 1, 1636430439065, 1636430439341, 276, 1, 275, 0, 0, 0
5803, 1, 1636430439113, 1636430439382, 269, 1, 268, 0, 0, 0
5804, 1, 1636430439562, 1636430439833, 271, 0, 271, 0, 0, 0
5807, 1, 1636430439718, 1636430440001, 283, 0, 283, 0, 0, 0
5763, 1, 1636430439953, 1636430440221, 268, 0, 268, 0, 0, 0
5805, 1, 1636430440009, 1636430440277, 268, 1, 267, 0, 0, 0
5809, 1, 1636430440401, 1636430440670, 269, 1, 268, 0, 0, 0
5810, 1, 1636430440482, 1636430440753, 271, 0, 271, 0, 0, 0
5812, 1, 1636430440969, 1636430441242, 273, 1, 272, 0, 1, 1
5816, 1, 1636430441710, 1636430441981, 271, 0, 271, 0, 0, 0
5817, 1, 1636430442330, 1636430442606, 276, 0, 276, 0, 0, 0
5822, 1, 1636430444382, 1636430444654, 272, 0, 272, 0, 0, 0
5821, 1, 1636430444830, 1636430445114, 284, 0, 284, 0, 0, 0
5827, 1, 1636430446226, 1636430446502, 276, 0, 276, 0, 0, 0
5828, 1, 1636430446686, 1636430446958, 272, 0, 272, 0, 0, 0
5832, 1, 1636430448274, 1636430448546, 272, 0, 272, 0, 0, 0
5833, 1, 1636430448730, 1636430449001, 271, 0, 271, 0, 0, 0
5836, 1, 1636430450397, 1636430450674, 277, 0, 277, 0, 0, 0
5837, 1, 1636430450853, 1636430451126, 273, 1, 272, 0, 0, 0
5843, 1, 1636430452290, 1636430452594, 304, 0, 304, 0, 0, 0
5844, 1, 1636430452769, 1636430453086, 317, 1, 316, 0, 1, 1
5823, 1, 1636430453782, 1636430454053, 271, 0, 271, 0, 0, 0
5848, 1, 1636430454305, 1636430454578, 273, 1, 272, 1, 0, 1
5850, 1, 1636430454762, 1636430455066, 304, 0, 304, 0, 0, 0
5852, 1, 1636430455606, 1636430455878, 272, 0, 272, 0, 0, 0
5851, 1, 1636430456061, 1636430456333, 272, 0, 272, 0, 0, 0
5853, 1, 1636430456405, 1636430456702, 297, 1, 296, 1, 0, 1
5854, 1, 1636430456521, 1636430456790, 269, 1, 268, 0, 0, 0
5855, 1, 1636430456877, 1636430457150, 273, 0, 273, 0, 0, 0
5856, 1, 1636430456966, 1636430457238, 272, 0, 272, 0, 0, 0
5857, 1, 1636430457421, 1636430457693, 272, 1, 271, 0, 1, 1
5858, 1, 1636430457521, 1636430457793, 272, 1, 271, 0, 0, 0
5859, 1, 1636430457970, 1636430458242, 272, 0, 272, 0, 0, 0
5860, 1, 1636430458170, 1636430458442, 272, 0, 272, 0, 0, 0
5861, 1, 1636430458398, 1636430458665, 267, 0, 267, 0, 0, 0
5862, 1, 1636430458453, 1636430458733, 280, 1, 279, 1, 0, 1
5863, 1, 1636430458846, 1636430459118, 272, 0, 272, 0, 0, 0
5865, 1, 1636430458897, 1636430459170, 273, 1, 272, 0, 0, 0
5864, 1, 1636430458914, 1636430459186, 272, 0, 272, 0, 0, 0
5866, 1, 1636430459370, 1636430459642, 272, 0, 272, 0, 0, 0
5867, 1, 1636430459517, 1636430459790, 273, 1, 272, 0, 0, 0
5868, 1, 1636430459981, 1636430460254, 273, 1, 272, 0, 1, 1
5869, 1, 1636430460105, 1636430460377, 272, 1, 271, 1, 0, 1
5870, 1, 1636430460330, 1636430460622, 292, 0, 292, 0, 0, 0
5871, 1, 1636430460441, 1636430460713, 272, 1, 271, 0, 0, 0
5872, 1, 1636430460533, 1636430460806, 273, 0, 273, 0, 0, 0
5875, 1, 1636430460889, 1636430461157, 268, 1, 267, 0, 0, 0
5876, 1, 1636430460889, 1636430461158, 269, 1, 268, 0, 0, 0
5874, 1, 1636430460889, 1636430461161, 272, 1, 271, 0, 0, 0
5873, 1, 1636430460981, 1636430461249, 268, 0, 268, 0, 0, 0
5878, 1, 1636430461341, 1636430461626, 285, 0, 285, 0, 0, 0
5877, 1, 1636430461341, 1636430461626, 285, 1, 284, 0, 0, 0
5881, 1, 1636430461837, 1636430462118, 281, 1, 280, 0, 1, 1
5883, 1, 1636430462025, 1636430462297, 272, 0, 272, 0, 0, 0
5885, 1, 1636430462286, 1636430462558, 272, 0, 272, 0, 0, 0
5884, 1, 1636430462293, 1636430462570, 277, 1, 276, 1, 0, 1
5887, 1, 1636430462426, 1636430462694, 268, 0, 268, 0, 0, 0
5889, 1, 1636430462717, 1636430462997, 280, 0, 280, 0, 0, 0
5882, 1, 1636430462749, 1636430463017, 268, 1, 267, 0, 0, 0
5888, 1, 1636430462865, 1636430463133, 268, 0, 268, 0, 0, 0
5890, 1, 1636430462910, 1636430463174, 264, 0, 264, 0, 0, 0
5893, 1, 1636430463194, 1636430463494, 300, 0, 300, 0, 0, 0
5894, 1, 1636430463353, 1636430463621, 268, 1, 267, 0, 0, 0
5895, 1, 1636430463669, 1636430463942, 273, 1, 272, 0, 0, 0
5896, 1, 1636430463798, 1636430464069, 271, 0, 271, 0, 0, 0
5849, 1, 1636430464077, 1636430464354, 277, 1, 276, 1, 0, 1
5897, 1, 1636430464242, 1636430464513, 271, 0, 271, 0, 0, 0
5900, 1, 1636430464289, 1636430464561, 272, 1, 271, 1, 0, 1
5901, 1, 1636430464393, 1636430464669, 276, 1, 275, 0, 0, 0
5902, 1, 1636430464409, 1636430464678, 269, 0, 269, 0, 0, 0
5899, 1, 1636430464693, 1636430464965, 272, 1, 271, 0, 1, 1
5904, 1, 1636430464849, 1636430465121, 272, 1, 271, 1, 0, 1
5903, 1, 1636430464858, 1636430465129, 271, 0, 271, 0, 0, 0
5906, 1, 1636430464874, 1636430465141, 267, 0, 267, 0, 0, 0
5907, 1, 1636430465141, 1636430465418, 277, 1, 276, 0, 0, 0
5908, 1, 1636430465330, 1636430465602, 272, 0, 272, 0, 0, 0
5909, 1, 1636430465653, 1636430465926, 273, 1, 272, 0, 1, 1
5910, 1, 1636430465786, 1636430466058, 272, 0, 272, 0, 0, 0
5911, 1, 1636430466242, 1636430466513, 271, 0, 271, 0, 0, 0
5913, 1, 1636430466321, 1636430466590, 269, 1, 268, 0, 0, 0
5914, 1, 1636430466393, 1636430466661, 268, 1, 267, 0, 0, 0
5912, 1, 1636430466693, 1636430466966, 273, 1, 272, 0, 1, 1
5916, 1, 1636430466769, 1636430467042, 273, 1, 272, 0, 0, 0
5917, 1, 1636430466841, 1636430467113, 272, 0, 272, 0, 0, 0
5918, 1, 1636430467150, 1636430467421, 271, 0, 271, 0, 0, 0
5921, 1, 1636430467606, 1636430467882, 276, 0, 276, 0, 0, 0
5924, 1, 1636430468290, 1636430468562, 272, 0, 272, 0, 0, 0
5926, 1, 1636430468402, 1636430468670, 268, 0, 268, 0, 0, 0
5927, 1, 1636430468746, 1636430469018, 272, 0, 272, 0, 0, 0
5928, 1, 1636430468850, 1636430469122, 272, 0, 272, 0, 0, 0
5931, 1, 1636430470225, 1636430470501, 276, 1, 275, 1, 0, 1
5932, 1, 1636430470682, 1636430470954, 272, 0, 272, 0, 0, 0
5935, 1, 1636430471973, 1636430472246, 273, 1, 272, 0, 0, 0
5937, 1, 1636430472093, 1636430472365, 272, 0, 272, 0, 0, 0
5936, 1, 1636430472426, 1636430472698, 272, 0, 272, 0, 0, 0
5938, 1, 1636430472549, 1636430472821, 272, 1, 271, 0, 0, 0
5939, 1, 1636430472881, 1636430473154, 273, 1, 272, 1, 0, 1
5940, 1, 1636430473337, 1636430473610, 273, 0, 273, 0, 0, 0
5941, 1, 1636430473794, 1636430474085, 291, 0, 291, 0, 0, 0
5942, 1, 1636430473914, 1636430474185, 271, 0, 271, 0, 0, 0
5944, 1, 1636430474085, 1636430474365, 280, 1, 279, 0, 1, 1
5945, 1, 1636430474342, 1636430474613, 271, 0, 271, 0, 0, 0
5943, 1, 1636430474361, 1636430474633, 272, 1, 271, 1, 0, 1
5946, 1, 1636430474549, 1636430474821, 272, 1, 271, 0, 0, 0
5947, 1, 1636430474813, 1636430475085, 272, 1, 271, 0, 0, 0
5948, 1, 1636430475129, 1636430475402, 273, 1, 272, 0, 0, 0
5949, 1, 1636430475266, 1636430475538, 272, 0, 272, 0, 0, 0
5950, 1, 1636430475721, 1636430475993, 272, 1, 271, 1, 0, 1
5951, 1, 1636430475933, 1636430476201, 268, 0, 268, 0, 0, 0
5953, 1, 1636430476062, 1636430476333, 271, 0, 271, 0, 0, 0
5955, 1, 1636430476377, 1636430476649, 272, 1, 271, 0, 0, 0
5952, 1, 1636430476381, 1636430476653, 272, 1, 271, 0, 0, 0
5954, 1, 1636430476510, 1636430476781, 271, 0, 271, 0, 0, 0
5956, 1, 1636430476726, 1636430476997, 271, 0, 271, 0, 0, 0
5957, 1, 1636430476862, 1636430477142, 280, 0, 280, 0, 0, 0
5958, 1, 1636430477161, 1636430477433, 272, 1, 271, 1, 0, 1
5960, 1, 1636430477305, 1636430477578, 273, 1, 272, 0, 0, 0
5959, 1, 1636430477326, 1636430477601, 275, 0, 275, 0, 0, 0
5962, 1, 1636430477761, 1636430478033, 272, 1, 271, 0, 0, 0
5961, 1, 1636430477781, 1636430478050, 269, 1, 268, 0, 1, 1
5963, 1, 1636430477833, 1636430478105, 272, 0, 272, 0, 0, 0
5965, 1, 1636430477970, 1636430478241, 271, 0, 271, 0, 0, 0
5967, 1, 1636430478217, 1636430478493, 276, 0, 276, 0, 0, 0
5964, 1, 1636430478289, 1636430478557, 268, 1, 267, 0, 1, 1
5968, 1, 1636430478425, 1636430478694, 269, 0, 269, 0, 0, 0
5969, 1, 1636430478469, 1636430478745, 276, 0, 276, 0, 0, 0
5971, 1, 1636430478674, 1636430478946, 272, 0, 272, 0, 0, 0
5972, 1, 1636430478745, 1636430479050, 305, 1, 304, 0, 0, 0
5974, 1, 1636430479233, 1636430479502, 269, 0, 269, 0, 0, 0
5973, 1, 1636430479229, 1636430479502, 273, 1, 272, 0, 0, 0
5975, 1, 1636430479249, 1636430479513, 264, 0, 264, 0, 0, 0
5978, 1, 1636430479694, 1636430479961, 267, 0, 267, 0, 0, 0
5977, 1, 1636430479689, 1636430479961, 272, 1, 271, 0, 0, 0
5979, 1, 1636430479837, 1636430480106, 269, 1, 268, 1, 0, 1
5982, 1, 1636430480065, 1636430480341, 276, 1, 275, 0, 0, 0
5983, 1, 1636430480153, 1636430480421, 268, 0, 268, 0, 0, 0
5981, 1, 1636430480289, 1636430480562, 273, 1, 272, 0, 0, 0
5985, 1, 1636430480349, 1636430480641, 292, 1, 291, 0, 0, 0
5934, 1, 1636430480501, 1636430480774, 273, 0, 273, 0, 0, 0
5984, 1, 1636430480521, 1636430480793, 272, 0, 272, 0, 0, 0
5986, 1, 1636430480693, 1636430480966, 273, 1, 272, 0, 1, 1
5987, 1, 1636430480774, 1636430481045, 271, 0, 271, 0, 0, 0
5990, 1, 1636430481190, 1636430481454, 264, 0, 264, 0, 0, 0
5991, 1, 1636430481229, 1636430481493, 264, 1, 263, 1, 0, 1
5992, 1, 1636430481277, 1636430481541, 264, 1, 263, 0, 0, 0
5993, 1, 1636430481673, 1636430481941, 268, 0, 268, 0, 0, 0
5994, 1, 1636430481717, 1636430481985, 268, 1, 267, 1, 0, 1
5995, 1, 1636430481862, 1636430482141, 279, 0, 279, 0, 0, 0
5996, 1, 1636430481945, 1636430482218, 273, 1, 272, 0, 0, 0
5999, 1, 1636430482181, 1636430482453, 272, 1, 271, 0, 0, 0
5997, 1, 1636430482325, 1636430482602, 277, 0, 277, 0, 0, 0
6000, 1, 1636430482369, 1636430482638, 269, 1, 268, 0, 0, 0
5998, 1, 1636430482401, 1636430482669, 268, 1, 267, 0, 1, 1
6001, 1, 1636430482581, 1636430482854, 273, 1, 272, 0, 0, 0
6002, 1, 1636430482798, 1636430483070, 272, 0, 272, 0, 0, 0
6003, 1, 1636430483194, 1636430483466, 272, 0, 272, 0, 0, 0
6004, 1, 1636430483230, 1636430483497, 267, 0, 267, 0, 0, 0
6005, 1, 1636430483265, 1636430483538, 273, 1, 272, 0, 0, 0
6007, 1, 1636430483673, 1636430483949, 276, 0, 276, 0, 0, 0
6006, 1, 1636430483717, 1636430483990, 273, 0, 273, 0, 0, 0
6008, 1, 1636430483906, 1636430484178, 272, 0, 272, 0, 0, 0
6009, 1, 1636430483953, 1636430484229, 276, 0, 276, 0, 0, 0
6011, 1, 1636430484141, 1636430484417, 276, 0, 276, 0, 0, 0
6012, 1, 1636430484361, 1636430484637, 276, 1, 275, 0, 0, 0
6010, 1, 1636430484402, 1636430484674, 272, 0, 272, 0, 0, 0
6013, 1, 1636430484409, 1636430484674, 265, 0, 265, 0, 0, 0
6014, 1, 1636430484586, 1636430484857, 271, 0, 271, 0, 0, 0
6015, 1, 1636430484894, 1636430485166, 272, 0, 272, 0, 0, 0
6016, 1, 1636430485213, 1636430485486, 273, 1, 272, 1, 0, 1
6017, 1, 1636430485234, 1636430485506, 272, 0, 272, 0, 0, 0
6018, 1, 1636430485350, 1636430485622, 272, 0, 272, 0, 0, 0
6020, 1, 1636430485686, 1636430485958, 272, 0, 272, 0, 0, 0
6019, 1, 1636430485805, 1636430486081, 276, 0, 276, 0, 0, 0
6021, 1, 1636430485842, 1636430486113, 271, 0, 271, 0, 0, 0
6022, 1, 1636430485958, 1636430486229, 271, 0, 271, 0, 0, 0
6025, 1, 1636430486149, 1636430486417, 268, 0, 268, 0, 0, 0
6024, 1, 1636430486298, 1636430486570, 272, 0, 272, 0, 0, 0
6023, 1, 1636430486409, 1636430486685, 276, 1, 275, 0, 0, 0
6026, 1, 1636430486497, 1636430486769, 272, 0, 272, 0, 0, 0
6027, 1, 1636430486626, 1636430486898, 272, 0, 272, 0, 0, 0
6028, 1, 1636430486866, 1636430487137, 271, 0, 271, 0, 0, 0
6029, 1, 1636430487257, 1636430487530, 273, 1, 272, 1, 0, 1
6030, 1, 1636430487269, 1636430487545, 276, 0, 276, 0, 0, 0
6031, 1, 1636430487313, 1636430487586, 273, 0, 273, 0, 0, 0
6033, 1, 1636430487713, 1636430487986, 273, 1, 272, 0, 1, 1
6032, 1, 1636430487761, 1636430488033, 272, 0, 272, 0, 0, 0
6034, 1, 1636430487773, 1636430488045, 272, 0, 272, 0, 0, 0
6035, 1, 1636430487993, 1636430488265, 272, 1, 271, 0, 0, 0
6036, 1, 1636430488221, 1636430488493, 272, 1, 271, 0, 0, 0
6038, 1, 1636430488229, 1636430488505, 276, 1, 275, 0, 1, 1
6039, 1, 1636430488405, 1636430488690, 285, 0, 285, 0, 0, 0
6037, 1, 1636430488449, 1636430488714, 265, 1, 264, 0, 0, 0
6040, 1, 1636430488726, 1636430488998, 272, 0, 272, 0, 0, 0
6041, 1, 1636430488894, 1636430489162, 268, 0, 268, 0, 0, 0
6042, 1, 1636430488978, 1636430489246, 268, 0, 268, 0, 0, 0
6044, 1, 1636430489173, 1636430489453, 280, 1, 279, 0, 0, 0
6045, 1, 1636430489341, 1636430489605, 264, 1, 263, 1, 0, 1
6046, 1, 1636430489358, 1636430489622, 264, 0, 264, 0, 0, 0
6043, 1, 1636430489425, 1636430489694, 269, 1, 268, 1, 0, 1
6047, 1, 1636430489789, 1636430490070, 281, 1, 280, 1, 0, 1
6049, 1, 1636430489805, 1636430490073, 268, 1, 267, 0, 1, 1
6050, 1, 1636430489814, 1636430490085, 271, 0, 271, 0, 0, 0
6048, 1, 1636430489889, 1636430490161, 272, 1, 271, 0, 0, 0
6051, 1, 1636430490093, 1636430490365, 272, 1, 271, 0, 0, 0
6052, 1, 1636430490266, 1636430490533, 267, 0, 267, 0, 0, 0
6055, 1, 1636430490266, 1636430490534, 268, 0, 268, 0, 0, 0
6054, 1, 1636430490354, 1636430490626, 272, 0, 272, 0, 0, 0
6056, 1, 1636430490497, 1636430490773, 276, 0, 276, 0, 0, 0
6053, 1, 1636430490541, 1636430490849, 308, 0, 308, 0, 0, 0
6057, 1, 1636430490625, 1636430490893, 268, 1, 267, 0, 0, 0
5989, 1, 1636430490805, 1636430491078, 273, 0, 273, 0, 0, 0
6059, 1, 1636430490961, 1636430491233, 272, 1, 271, 0, 1, 1
6058, 1, 1636430491034, 1636430491306, 272, 0, 272, 0, 0, 0
6061, 1, 1636430491113, 1636430491381, 268, 1, 267, 0, 1, 1
6062, 1, 1636430491261, 1636430491533, 272, 1, 271, 1, 0, 1
6063, 1, 1636430491270, 1636430491537, 267, 0, 267, 0, 0, 0
6060, 1, 1636430491405, 1636430491681, 276, 0, 276, 0, 0, 0
6066, 1, 1636430491485, 1636430491754, 269, 1, 268, 0, 0, 0
6065, 1, 1636430491566, 1636430491838, 272, 0, 272, 0, 0, 0
6068, 1, 1636430491713, 1636430491985, 272, 1, 271, 0, 0, 0
6067, 1, 1636430491865, 1636430492141, 276, 1, 275, 1, 0, 1
6069, 1, 1636430491922, 1636430492193, 271, 0, 271, 0, 0, 0
6064, 1, 1636430491933, 1636430492209, 276, 1, 275, 0, 0, 0
6070, 1, 1636430492117, 1636430492393, 276, 0, 276, 0, 0, 0
6074, 1, 1636430492261, 1636430492533, 272, 1, 271, 1, 0, 1
6073, 1, 1636430492325, 1636430492594, 269, 0, 269, 0, 0, 0
6072, 1, 1636430492369, 1636430492646, 277, 1, 276, 0, 0, 0
6071, 1, 1636430492578, 1636430492846, 268, 0, 268, 0, 0, 0
6075, 1, 1636430492605, 1636430492878, 273, 0, 273, 0, 0, 0
6076, 1, 1636430492693, 1636430492965, 272, 1, 271, 0, 0, 0
6078, 1, 1636430492997, 1636430493269, 272, 1, 271, 1, 0, 1
6077, 1, 1636430493025, 1636430493298, 273, 1, 272, 0, 0, 0
6080, 1, 1636430493142, 1636430493414, 272, 0, 272, 0, 0, 0
6081, 1, 1636430493297, 1636430493573, 276, 1, 275, 0, 0, 0
6082, 1, 1636430493373, 1636430493645, 272, 1, 271, 0, 0, 0
6079, 1, 1636430493446, 1636430493717, 271, 0, 271, 0, 0, 0
6084, 1, 1636430493478, 1636430493749, 271, 0, 271, 0, 0, 0
6085, 1, 1636430493597, 1636430493869, 272, 1, 271, 0, 0, 0
6087, 1, 1636430493745, 1636430494017, 272, 1, 271, 0, 0, 0
6088, 1, 1636430493797, 1636430494077, 280, 0, 280, 0, 0, 0
6086, 1, 1636430493893, 1636430494165, 272, 1, 271, 1, 0, 1
6083, 1, 1636430493929, 1636430494201, 272, 1, 271, 0, 0, 0
6090, 1, 1636430494209, 1636430494481, 272, 0, 272, 0, 0, 0
6089, 1, 1636430494253, 1636430494517, 264, 0, 264, 0, 0, 0
6093, 1, 1636430494294, 1636430494561, 267, 0, 267, 0, 0, 0
6092, 1, 1636430494337, 1636430494606, 269, 0, 269, 0, 0, 0
6094, 1, 1636430494641, 1636430494914, 273, 0, 273, 0, 0, 0
6091, 1, 1636430494665, 1636430494937, 272, 1, 271, 0, 0, 0
6095, 1, 1636430494822, 1636430495093, 271, 0, 271, 0, 0, 0
6096, 1, 1636430494929, 1636430495205, 276, 1, 275, 1, 0, 1
6097, 1, 1636430495117, 1636430495389, 272, 1, 271, 0, 0, 0
6099, 1, 1636430495281, 1636430495549, 268, 1, 267, 0, 1, 1
6098, 1, 1636430495385, 1636430495661, 276, 0, 276, 0, 0, 0
6100, 1, 1636430495425, 1636430495697, 272, 1, 271, 0, 0, 0
6102, 1, 1636430495501, 1636430495773, 272, 1, 271, 0, 0, 0
6101, 1, 1636430495569, 1636430495846, 277, 1, 276, 0, 0, 0
6106, 1, 1636430495681, 1636430495950, 269, 1, 268, 0, 0, 0
6103, 1, 1636430495725, 1636430496002, 277, 1, 276, 0, 0, 0
6104, 1, 1636430495846, 1636430496121, 275, 0, 275, 0, 0, 0
6107, 1, 1636430495881, 1636430496153, 272, 1, 271, 1, 0, 1
6105, 1, 1636430496029, 1636430496297, 268, 1, 267, 0, 0, 0
6108, 1, 1636430496133, 1636430496410, 277, 1, 276, 0, 0, 0
6109, 1, 1636430496157, 1636430496430, 273, 0, 273, 0, 0, 0
6111, 1, 1636430496297, 1636430496565, 268, 1, 267, 0, 0, 0
6112, 1, 1636430496369, 1636430496633, 264, 1, 263, 0, 0, 0
6110, 1, 1636430496605, 1636430496878, 273, 1, 272, 0, 0, 0
6113, 1, 1636430496725, 1636430497001, 276, 0, 276, 0, 0, 0
6114, 1, 1636430496933, 1636430497205, 272, 1, 271, 0, 0, 0
6115, 1, 1636430496949, 1636430497222, 273, 1, 272, 0, 1, 1
6116, 1, 1636430497058, 1636430497337, 279, 0, 279, 0, 0, 0
6118, 1, 1636430497213, 1636430497485, 272, 1, 271, 0, 1, 1
6117, 1, 1636430497385, 1636430497649, 264, 0, 264, 0, 0, 0
6121, 1, 1636430497513, 1636430497790, 277, 1, 276, 0, 0, 0
6122, 1, 1636430497553, 1636430497826, 273, 1, 272, 0, 0, 0
6123, 1, 1636430497569, 1636430497837, 268, 1, 267, 0, 1, 1
6124, 1, 1636430497590, 1636430497862, 272, 0, 272, 0, 0, 0
6120, 1, 1636430497665, 1636430497937, 272, 1, 271, 1, 0, 1
6125, 1, 1636430497837, 1636430498109, 272, 1, 271, 0, 1, 1
6119, 1, 1636430497969, 1636430498233, 264, 0, 264, 0, 0, 0
6126, 1, 1636430498005, 1636430498278, 273, 1, 272, 1, 0, 1
6127, 1, 1636430498013, 1636430498281, 268, 1, 267, 0, 1, 1
6128, 1, 1636430498169, 1636430498441, 272, 1, 271, 0, 0, 0
6130, 1, 1636430498285, 1636430498557, 272, 1, 271, 0, 0, 0
6131, 1, 1636430498457, 1636430498726, 269, 1, 268, 1, 0, 1
6129, 1, 1636430498625, 1636430498897, 272, 1, 271, 0, 1, 1
6132, 1, 1636430498685, 1636430498958, 273, 0, 273, 0, 0, 0
6133, 1, 1636430498857, 1636430499129, 272, 1, 271, 0, 0, 0
6134, 1, 1636430499042, 1636430499314, 272, 0, 272, 0, 0, 0
6136, 1, 1636430499073, 1636430499345, 272, 0, 272, 0, 0, 0
6137, 1, 1636430499217, 1636430499493, 276, 0, 276, 0, 0, 0
6135, 1, 1636430499309, 1636430499585, 276, 1, 275, 0, 0, 0
6140, 1, 1636430499501, 1636430499773, 272, 1, 271, 0, 0, 0
6138, 1, 1636430499525, 1636430499798, 273, 1, 272, 0, 0, 0
6141, 1, 1636430499537, 1636430499813, 276, 1, 275, 0, 0, 0
6144, 1, 1636430499645, 1636430499913, 268, 1, 267, 0, 1, 1
6139, 1, 1636430499669, 1636430499942, 273, 1, 272, 0, 0, 0
6143, 1, 1636430499761, 1636430500033, 272, 0, 272, 0, 0, 0
6142, 1, 1636430499974, 1636430500246, 272, 0, 272, 0, 0, 0
6146, 1, 1636430499997, 1636430500269, 272, 1, 271, 1, 0, 1
6145, 1, 1636430500090, 1636430500361, 271, 0, 271, 0, 0, 0
6147, 1, 1636430500213, 1636430500482, 269, 1, 268, 0, 0, 0
6148, 1, 1636430500302, 1636430500570, 268, 0, 268, 0, 0, 0
6150, 1, 1636430500541, 1636430500813, 272, 1, 271, 0, 0, 0
6151, 1, 1636430500697, 1636430500970, 273, 1, 272, 0, 0, 0
6152, 1, 1636430500713, 1636430500985, 272, 1, 271, 0, 0, 0
6149, 1, 1636430500749, 1636430501022, 273, 1, 272, 0, 0, 0
6153, 1, 1636430500949, 1636430501225, 276, 1, 275, 0, 0, 0
6155, 1, 1636430501133, 1636430501401, 268, 1, 267, 0, 0, 0
6154, 1, 1636430501165, 1636430501438, 273, 1, 272, 0, 0, 0
6156, 1, 1636430501206, 1636430501481, 275, 0, 275, 0, 0, 0
6158, 1, 1636430501458, 1636430501733, 275, 0, 275, 0, 0, 0
6159, 1, 1636430501513, 1636430501785, 272, 0, 272, 0, 0, 0
6162, 1, 1636430501557, 1636430501830, 273, 0, 273, 0, 0, 0
6157, 1, 1636430501577, 1636430501845, 268, 0, 268, 0, 0, 0
6161, 1, 1636430501617, 1636430501889, 272, 0, 272, 0, 0, 0
6165, 1, 1636430501933, 1636430502210, 277, 1, 276, 0, 1, 1
6164, 1, 1636430502009, 1636430502281, 272, 1, 271, 0, 1, 1
6166, 1, 1636430502098, 1636430502369, 271, 0, 271, 0, 0, 0
6167, 1, 1636430502309, 1636430502578, 269, 0, 269, 0, 0, 0
6168, 1, 1636430502457, 1636430502730, 273, 0, 273, 0, 0, 0
6170, 1, 1636430502629, 1636430502901, 272, 1, 271, 1, 0, 1
6169, 1, 1636430502761, 1636430503033, 272, 1, 271, 0, 0, 0
6173, 1, 1636430502982, 1636430503258, 276, 0, 276, 0, 0, 0
6172, 1, 1636430503073, 1636430503349, 276, 0, 276, 0, 0, 0
6174, 1, 1636430503117, 1636430503385, 268, 1, 267, 0, 0, 0
6175, 1, 1636430503285, 1636430503557, 272, 1, 271, 0, 1, 1
6177, 1, 1636430503529, 1636430503801, 272, 1, 271, 0, 0, 0
6179, 1, 1636430503529, 1636430503801, 272, 1, 271, 0, 0, 0
6176, 1, 1636430503561, 1636430503833, 272, 1, 271, 1, 0, 1
6180, 1, 1636430503561, 1636430503833, 272, 1, 271, 0, 1, 1
6183, 1, 1636430504014, 1636430504285, 271, 1, 270, 0, 0, 0
6181, 1, 1636430504014, 1636430504286, 272, 0, 272, 0, 0, 0
6182, 1, 1636430504014, 1636430504286, 272, 0, 272, 0, 0, 0
6184, 1, 1636430504213, 1636430504489, 276, 1, 275, 1, 0, 1
6186, 1, 1636430504485, 1636430504757, 272, 1, 271, 1, 0, 1
6187, 1, 1636430504593, 1636430504865, 272, 1, 271, 0, 0, 0
6185, 1, 1636430504669, 1636430504942, 273, 1, 272, 0, 0, 0
6188, 1, 1636430505049, 1636430505321, 272, 1, 271, 0, 1, 1
6189, 1, 1636430505053, 1636430505329, 276, 0, 276, 0, 0, 0
6191, 1, 1636430505190, 1636430505462, 272, 0, 272, 0, 0, 0
6194, 1, 1636430505445, 1636430505721, 276, 1, 275, 0, 0, 0
6193, 1, 1636430505497, 1636430505766, 269, 1, 268, 0, 0, 0
6192, 1, 1636430505513, 1636430505785, 272, 1, 271, 0, 0, 0
6196, 1, 1636430505910, 1636430506181, 271, 0, 271, 0, 0, 0
6198, 1, 1636430505965, 1636430506238, 273, 1, 272, 0, 1, 1
6199, 1, 1636430506121, 1636430506394, 273, 0, 273, 0, 0, 0
6200, 1, 1636430506578, 1636430506854, 276, 0, 276, 0, 0, 0
6202, 1, 1636430506594, 1636430506862, 268, 0, 268, 0, 0, 0
6204, 1, 1636430507001, 1636430507274, 273, 1, 272, 0, 0, 0
6203, 1, 1636430507033, 1636430507306, 273, 1, 272, 0, 1, 1
6205, 1, 1636430507089, 1636430507362, 273, 0, 273, 0, 0, 0
6207, 1, 1636430507461, 1636430507734, 273, 1, 272, 0, 0, 0
6206, 1, 1636430507485, 1636430507758, 273, 0, 273, 0, 0, 0
6208, 1, 1636430507529, 1636430507802, 273, 1, 272, 1, 0, 1
6209, 1, 1636430507933, 1636430508205, 272, 0, 272, 0, 0, 0
6210, 1, 1636430507981, 1636430508254, 273, 1, 272, 0, 1, 1
6211, 1, 1636430508006, 1636430508278, 272, 0, 272, 0, 0, 0
6212, 1, 1636430508461, 1636430508734, 273, 0, 273, 0, 0, 0
6213, 1, 1636430508513, 1636430508786, 273, 1, 272, 0, 0, 0
6214, 1, 1636430508970, 1636430509241, 271, 0, 271, 0, 0, 0
6215, 1, 1636430508981, 1636430509258, 277, 1, 276, 0, 0, 0
6216, 1, 1636430509001, 1636430509274, 273, 1, 272, 1, 0, 1
6217, 1, 1636430509421, 1636430509698, 277, 0, 277, 0, 0, 0
6218, 1, 1636430509458, 1636430509733, 275, 0, 275, 0, 0, 0
6219, 1, 1636430509637, 1636430509910, 273, 0, 273, 0, 0, 0
6220, 1, 1636430509882, 1636430510154, 272, 0, 272, 0, 0, 0
6222, 1, 1636430510001, 1636430510273, 272, 1, 271, 0, 1, 1
6221, 1, 1636430510089, 1636430510362, 273, 1, 272, 0, 0, 0
6223, 1, 1636430510458, 1636430510730, 272, 0, 272, 0, 0, 0
6224, 1, 1636430510509, 1636430510782, 273, 1, 272, 0, 1, 1
6226, 1, 1636430510910, 1636430511182, 272, 0, 272, 0, 0, 0
6227, 1, 1636430510921, 1636430511201, 280, 0, 280, 0, 0, 0
6225, 1, 1636430510966, 1636430511237, 271, 0, 271, 0, 0, 0
6229, 1, 1636430511385, 1636430511665, 280, 1, 279, 1, 0, 1
6228, 1, 1636430511417, 1636430511733, 316, 1, 315, 0, 0, 0
6230, 1, 1636430511574, 1636430511849, 275, 0, 275, 0, 0, 0
6231, 1, 1636430511917, 1636430512190, 273, 1, 272, 0, 0, 0
6233, 1, 1636430511969, 1636430512241, 272, 1, 271, 0, 0, 0
6234, 1, 1636430512025, 1636430512294, 269, 0, 269, 0, 0, 0
6235, 1, 1636430512070, 1636430512341, 271, 0, 271, 0, 0, 0
6232, 1, 1636430512417, 1636430512690, 273, 0, 273, 0, 0, 0
6237, 1, 1636430512454, 1636430512726, 272, 0, 272, 0, 0, 0
6236, 1, 1636430512521, 1636430512794, 273, 1, 272, 0, 0, 0
6239, 1, 1636430512873, 1636430513150, 277, 1, 276, 0, 0, 0
6238, 1, 1636430512906, 1636430513178, 272, 0, 272, 0, 0, 0
6240, 1, 1636430512973, 1636430513249, 276, 1, 275, 0, 0, 0
6241, 1, 1636430513129, 1636430513402, 273, 1, 272, 1, 0, 1
6243, 1, 1636430513333, 1636430513606, 273, 0, 273, 0, 0, 0
6242, 1, 1636430513358, 1636430513669, 311, 0, 311, 0, 0, 0
6244, 1, 1636430513490, 1636430513762, 272, 0, 272, 0, 0, 0
6247, 1, 1636430513798, 1636430514069, 271, 0, 271, 0, 0, 0
6246, 1, 1636430513833, 1636430514106, 273, 1, 272, 0, 0, 0
6245, 1, 1636430513853, 1636430514129, 276, 1, 275, 0, 0, 0
6249, 1, 1636430513946, 1636430514217, 271, 0, 271, 0, 0, 0
6250, 1, 1636430514042, 1636430514309, 267, 0, 267, 0, 0, 0
6248, 1, 1636430514254, 1636430514526, 272, 0, 272, 0, 0, 0
6252, 1, 1636430514346, 1636430514617, 271, 0, 271, 0, 0, 0
6251, 1, 1636430514490, 1636430514762, 272, 0, 272, 0, 0, 0
6254, 1, 1636430514762, 1636430515033, 271, 0, 271, 0, 0, 0
6253, 1, 1636430514794, 1636430515066, 272, 0, 272, 0, 0, 0
6255, 1, 1636430514941, 1636430515258, 317, 0, 317, 0, 0, 0
6256, 1, 1636430514985, 1636430515258, 273, 1, 272, 0, 0, 0
6258, 1, 1636430515214, 1636430515489, 275, 0, 275, 0, 0, 0
6257, 1, 1636430515249, 1636430515522, 273, 0, 273, 0, 0, 0
6259, 1, 1636430515425, 1636430515721, 296, 0, 296, 0, 0, 0
6260, 1, 1636430515541, 1636430515817, 276, 1, 275, 0, 0, 0
6261, 1, 1636430515701, 1636430515985, 284, 1, 283, 0, 0, 0
6262, 1, 1636430515717, 1636430515989, 272, 0, 272, 0, 0, 0
6263, 1, 1636430515757, 1636430516077, 320, 1, 319, 0, 1, 1
6265, 1, 1636430515897, 1636430516165, 268, 0, 268, 0, 0, 0
6201, 1, 1636430515933, 1636430516205, 272, 0, 272, 0, 0, 0
6266, 1, 1636430515981, 1636430516249, 268, 1, 267, 0, 1, 1
6267, 1, 1636430516025, 1636430516294, 269, 0, 269, 0, 0, 0
6264, 1, 1636430516253, 1636430516521, 268, 1, 267, 0, 1, 1
6269, 1, 1636430516337, 1636430516609, 272, 0, 272, 0, 0, 0
6268, 1, 1636430516426, 1636430516697, 271, 0, 271, 0, 0, 0
6273, 1, 1636430516661, 1636430516933, 272, 1, 271, 1, 0, 1
6274, 1, 1636430516878, 1636430517150, 272, 0, 272, 0, 0, 0
6275, 1, 1636430516981, 1636430517253, 272, 0, 272, 0, 0, 0
6276, 1, 1636430517117, 1636430517394, 277, 0, 277, 0, 0, 0
6278, 1, 1636430517209, 1636430517481, 272, 1, 271, 1, 0, 1
6279, 1, 1636430517502, 1636430517777, 275, 0, 275, 0, 0, 0
6281, 1, 1636430517637, 1636430517913, 276, 0, 276, 0, 0, 0
6282, 1, 1636430517681, 1636430517954, 273, 1, 272, 1, 0, 1
6284, 1, 1636430517745, 1636430518021, 276, 1, 275, 1, 0, 1
6286, 1, 1636430517973, 1636430518245, 272, 1, 271, 1, 0, 1
6285, 1, 1636430517977, 1636430518253, 276, 0, 276, 0, 0, 0
6283, 1, 1636430518138, 1636430518410, 272, 0, 272, 0, 0, 0
6288, 1, 1636430518202, 1636430518473, 271, 0, 271, 0, 0, 0
6287, 1, 1636430518425, 1636430518701, 276, 1, 275, 0, 0, 0
6290, 1, 1636430518882, 1636430519154, 272, 0, 272, 0, 0, 0
6291, 1, 1636430518910, 1636430519181, 271, 0, 271, 0, 0, 0
6293, 1, 1636430519174, 1636430519445, 271, 0, 271, 0, 0, 0
6294, 1, 1636430519378, 1636430519649, 271, 0, 271, 0, 0, 0
6295, 1, 1636430519573, 1636430519854, 281, 1, 280, 0, 1, 1
6296, 1, 1636430519661, 1636430519938, 277, 0, 277, 0, 0, 0
6298, 1, 1636430519745, 1636430520017, 272, 0, 272, 0, 0, 0
6299, 1, 1636430519853, 1636430520125, 272, 1, 271, 0, 0, 0
6300, 1, 1636430519905, 1636430520178, 273, 1, 272, 1, 0, 1
6297, 1, 1636430520113, 1636430520381, 268, 1, 267, 0, 0, 0
6301, 1, 1636430520202, 1636430520470, 268, 0, 268, 0, 0, 0
6302, 1, 1636430520354, 1636430520626, 272, 0, 272, 0, 0, 0
6303, 1, 1636430520809, 1636430521082, 273, 1, 272, 1, 0, 1
6304, 1, 1636430520898, 1636430521170, 272, 0, 272, 0, 0, 0
6305, 1, 1636430521101, 1636430521374, 273, 1, 272, 0, 1, 1
6306, 1, 1636430521461, 1636430521730, 269, 0, 269, 0, 0, 0
6307, 1, 1636430521513, 1636430521785, 272, 0, 272, 0, 0, 0
6308, 1, 1636430521673, 1636430521945, 272, 1, 271, 1, 0, 1
6309, 1, 1636430521697, 1636430521969, 272, 0, 272, 0, 0, 0
6311, 1, 1636430521805, 1636430522078, 273, 1, 272, 1, 0, 1
6312, 1, 1636430521917, 1636430522190, 273, 0, 273, 0, 0, 0
6313, 1, 1636430522121, 1636430522390, 269, 1, 268, 0, 0, 0
6310, 1, 1636430522154, 1636430522422, 268, 0, 268, 0, 0, 0
6314, 1, 1636430522257, 1636430522533, 276, 1, 275, 0, 1, 1
6315, 1, 1636430522714, 1636430522986, 272, 0, 272, 0, 0, 0
6316, 1, 1636430522898, 1636430523170, 272, 0, 272, 0, 0, 0
6317, 1, 1636430523082, 1636430523354, 272, 0, 272, 0, 0, 0
6318, 1, 1636430523514, 1636430523786, 272, 0, 272, 0, 0, 0
6319, 1, 1636430523521, 1636430523789, 268, 1, 267, 0, 0, 0
6320, 1, 1636430523657, 1636430523921, 264, 1, 263, 0, 0, 0
6321, 1, 1636430523705, 1636430523978, 273, 0, 273, 0, 0, 0
6322, 1, 1636430523742, 1636430524010, 268, 0, 268, 0, 0, 0
6324, 1, 1636430523990, 1636430524265, 275, 0, 275, 0, 0, 0
6325, 1, 1636430524097, 1636430524369, 272, 1, 271, 0, 0, 0
6326, 1, 1636430524153, 1636430524426, 273, 1, 272, 1, 0, 1
6323, 1, 1636430524185, 1636430524458, 273, 1, 272, 0, 1, 1
6327, 1, 1636430524610, 1636430524882, 272, 0, 272, 0, 0, 0
6328, 1, 1636430525010, 1636430525282, 272, 0, 272, 0, 0, 0
6329, 1, 1636430525122, 1636430525394, 272, 0, 272, 0, 0, 0
6330, 1, 1636430525625, 1636430525897, 272, 1, 271, 0, 0, 0
6331, 1, 1636430525662, 1636430525938, 276, 0, 276, 0, 0, 0
6332, 1, 1636430525698, 1636430525969, 271, 0, 271, 0, 0, 0
6334, 1, 1636430525841, 1636430526113, 272, 1, 271, 0, 0, 0
6333, 1, 1636430526117, 1636430526389, 272, 0, 272, 0, 0, 0
6335, 1, 1636430526153, 1636430526473, 320, 0, 320, 0, 0, 0
6336, 1, 1636430526294, 1636430526562, 268, 0, 268, 0, 0, 0
6337, 1, 1636430526741, 1636430527014, 273, 1, 272, 0, 1, 1
6338, 1, 1636430526873, 1636430527141, 268, 0, 268, 0, 0, 0
6340, 1, 1636430527125, 1636430527398, 273, 0, 273, 0, 0, 0
6342, 1, 1636430527217, 1636430527489, 272, 1, 271, 0, 0, 0
6344, 1, 1636430527521, 1636430527793, 272, 1, 271, 0, 0, 0
6343, 1, 1636430527569, 1636430527845, 276, 1, 275, 0, 1, 1
6346, 1, 1636430527654, 1636430527925, 271, 0, 271, 0, 0, 0
6347, 1, 1636430527753, 1636430528022, 269, 1, 268, 0, 1, 1
6349, 1, 1636430527918, 1636430528189, 271, 0, 271, 0, 0, 0
6345, 1, 1636430528101, 1636430528374, 273, 0, 273, 0, 0, 0
6350, 1, 1636430528197, 1636430528465, 268, 1, 267, 0, 1, 1
6351, 1, 1636430528374, 1636430528646, 272, 0, 272, 0, 0, 0
6292, 1, 1636430528729, 1636430529001, 272, 1, 271, 0, 0, 0
6353, 1, 1636430528821, 1636430529094, 273, 1, 272, 0, 1, 1
6352, 1, 1636430528866, 1636430529138, 272, 0, 272, 0, 0, 0
6355, 1, 1636430529013, 1636430529286, 273, 1, 272, 0, 0, 0
6356, 1, 1636430529153, 1636430529426, 273, 1, 272, 0, 1, 1
6359, 1, 1636430529410, 1636430529681, 271, 0, 271, 0, 0, 0
6358, 1, 1636430529466, 1636430529738, 272, 0, 272, 0, 0, 0
6360, 1, 1636430529609, 1636430529881, 272, 1, 271, 1, 0, 1
6362, 1, 1636430529678, 1636430529946, 268, 0, 268, 0, 0, 0
6363, 1, 1636430529933, 1636430530206, 273, 1, 272, 0, 0, 0
6361, 1, 1636430530065, 1636430530338, 273, 1, 272, 0, 1, 1
6364, 1, 1636430530126, 1636430530398, 272, 0, 272, 0, 0, 0
6365, 1, 1636430530398, 1636430530666, 268, 0, 268, 0, 0, 0
6366, 1, 1636430530837, 1636430531110, 273, 1, 272, 0, 1, 1
6367, 1, 1636430530873, 1636430531146, 273, 1, 272, 0, 1, 1
6368, 1, 1636430530973, 1636430531246, 273, 1, 272, 0, 1, 1
6369, 1, 1636430531146, 1636430531417, 271, 0, 271, 0, 0, 0
6371, 1, 1636430531362, 1636430531633, 271, 0, 271, 0, 0, 0
6370, 1, 1636430531425, 1636430531697, 272, 1, 271, 0, 0, 0
6372, 1, 1636430531549, 1636430531822, 273, 1, 272, 1, 0, 1
6374, 1, 1636430531665, 1636430531938, 273, 1, 272, 0, 0, 0
6375, 1, 1636430531906, 1636430532178, 272, 0, 272, 0, 0, 0
6373, 1, 1636430532001, 1636430532274, 273, 1, 272, 0, 0, 0
6376, 1, 1636430532121, 1636430532397, 276, 0, 276, 0, 0, 0
6377, 1, 1636430532377, 1636430532649, 272, 1, 271, 0, 0, 0
6378, 1, 1636430532782, 1636430533058, 276, 0, 276, 0, 0, 0
6379, 1, 1636430532861, 1636430533134, 273, 1, 272, 0, 1, 1
6380, 1, 1636430533045, 1636430533317, 272, 1, 271, 0, 1, 1
6381, 1, 1636430533093, 1636430533362, 269, 0, 269, 0, 0, 0
6382, 1, 1636430533297, 1636430533574, 277, 1, 276, 1, 0, 1
6384, 1, 1636430533457, 1636430533733, 276, 0, 276, 0, 0, 0
6383, 1, 1636430533493, 1636430533765, 272, 0, 272, 0, 0, 0
6386, 1, 1636430533621, 1636430533893, 272, 1, 271, 0, 0, 0
6385, 1, 1636430533922, 1636430534194, 272, 0, 272, 0, 0, 0
6388, 1, 1636430533937, 1636430534214, 277, 1, 276, 0, 0, 0
6387, 1, 1636430534074, 1636430534345, 271, 0, 271, 0, 0, 0
6389, 1, 1636430534401, 1636430534674, 273, 0, 273, 0, 0, 0
6390, 1, 1636430534702, 1636430534974, 272, 0, 272, 0, 0, 0
6391, 1, 1636430534930, 1636430535202, 272, 0, 272, 0, 0, 0
6392, 1, 1636430535042, 1636430535314, 272, 0, 272, 0, 0, 0
6394, 1, 1636430535209, 1636430535485, 276, 1, 275, 0, 0, 0
6393, 1, 1636430535385, 1636430535657, 272, 0, 272, 0, 0, 0
6396, 1, 1636430535517, 1636430535790, 273, 1, 272, 0, 0, 0
6397, 1, 1636430535569, 1636430535841, 272, 1, 271, 0, 1, 1
6399, 1, 1636430535805, 1636430536082, 277, 1, 276, 0, 0, 0
6395, 1, 1636430535837, 1636430536109, 272, 1, 271, 0, 0, 0
6398, 1, 1636430535969, 1636430536241, 272, 1, 271, 1, 0, 1
6400, 1, 1636430536021, 1636430536289, 268, 0, 268, 0, 0, 0
6401, 1, 1636430536366, 1636430536634, 268, 0, 268, 0, 0, 0
6402, 1, 1636430536726, 1636430537001, 275, 0, 275, 0, 0, 0
6403, 1, 1636430536817, 1636430537089, 272, 1, 271, 0, 0, 0
6404, 1, 1636430536906, 1636430537186, 280, 0, 280, 0, 0, 0
6405, 1, 1636430537097, 1636430537366, 269, 0, 269, 0, 0, 0
6406, 1, 1636430537230, 1636430537501, 271, 0, 271, 0, 0, 0
6408, 1, 1636430537429, 1636430537702, 273, 0, 273, 0, 0, 0
6409, 1, 1636430537474, 1636430537746, 272, 0, 272, 0, 0, 0
6407, 1, 1636430537546, 1636430537817, 271, 0, 271, 0, 0, 0
6412, 1, 1636430537825, 1636430538097, 272, 1, 271, 0, 0, 0
6410, 1, 1636430537877, 1636430538149, 272, 0, 272, 0, 0, 0
6411, 1, 1636430537921, 1636430538190, 269, 1, 268, 0, 0, 0
6414, 1, 1636430538337, 1636430538614, 277, 1, 276, 1, 0, 1
6416, 1, 1636430538489, 1636430538762, 273, 0, 273, 0, 0, 0
6417, 1, 1636430538593, 1636430538865, 272, 1, 271, 0, 0, 0
6413, 1, 1636430538794, 1636430539085, 291, 0, 291, 0, 0, 0
6418, 1, 1636430538946, 1636430539217, 271, 0, 271, 0, 0, 0
6419, 1, 1636430538997, 1636430539265, 268, 0, 268, 0, 0, 0
6357, 1, 1636430539037, 1636430539310, 273, 1, 272, 0, 0, 0
6421, 1, 1636430539129, 1636430539401, 272, 0, 272, 0, 0, 0
6420, 1, 1636430539173, 1636430539445, 272, 1, 271, 0, 0, 0
6415, 1, 1636430539269, 1636430539533, 264, 1, 263, 0, 0, 0
6424, 1, 1636430539489, 1636430539758, 269, 0, 269, 0, 0, 0
6425, 1, 1636430539493, 1636430539761, 268, 0, 268, 0, 0, 0
6423, 1, 1636430539582, 1636430539853, 271, 0, 271, 0, 0, 0
6428, 1, 1636430539713, 1636430539985, 272, 1, 271, 0, 0, 0
6427, 1, 1636430539713, 1636430539985, 272, 1, 271, 1, 0, 1
6429, 1, 1636430539938, 1636430540210, 272, 0, 272, 0, 0, 0
6426, 1, 1636430539941, 1636430540221, 280, 1, 279, 1, 0, 1
6430, 1, 1636430540177, 1636430540445, 268, 0, 268, 0, 0, 0
6422, 1, 1636430540173, 1636430540445, 272, 1, 271, 0, 1, 1
6433, 1, 1636430540389, 1636430540662, 273, 1, 272, 0, 0, 0
6434, 1, 1636430540662, 1636430540933, 271, 0, 271, 0, 0, 0
6436, 1, 1636430540841, 1636430541109, 268, 1, 267, 0, 0, 0
6435, 1, 1636430540841, 1636430541109, 268, 1, 267, 1, 0, 1
6437, 1, 1636430541050, 1636430541322, 272, 0, 272, 0, 0, 0
6439, 1, 1636430541238, 1636430541509, 271, 0, 271, 0, 0, 0
6441, 1, 1636430541433, 1636430541705, 272, 0, 272, 0, 0, 0
6440, 1, 1636430541501, 1636430541769, 268, 0, 268, 0, 0, 0
6442, 1, 1636430541545, 1636430541822, 277, 1, 276, 0, 0, 0
6446, 1, 1636430541841, 1636430542113, 272, 0, 272, 0, 0, 0
6445, 1, 1636430541885, 1636430542157, 272, 1, 271, 0, 0, 0
6444, 1, 1636430542001, 1636430542274, 273, 1, 272, 0, 0, 0
6447, 1, 1636430542061, 1636430542333, 272, 1, 271, 0, 0, 0
6448, 1, 1636430542461, 1636430542738, 277, 1, 276, 0, 1, 1
6449, 1, 1636430542769, 1636430543042, 273, 1, 272, 0, 0, 0
6450, 1, 1636430542913, 1636430543186, 273, 1, 272, 0, 0, 0
6451, 1, 1636430542946, 1636430543217, 271, 0, 271, 0, 0, 0
6452, 1, 1636430543165, 1636430543437, 272, 1, 271, 0, 0, 0
6453, 1, 1636430543342, 1636430543614, 272, 0, 272, 0, 0, 0
6455, 1, 1636430543478, 1636430543746, 268, 0, 268, 0, 0, 0
6456, 1, 1636430543525, 1636430543798, 273, 1, 272, 0, 0, 0
6454, 1, 1636430543614, 1636430543881, 267, 0, 267, 0, 0, 0
6457, 1, 1636430543921, 1636430544186, 265, 0, 265, 0, 0, 0
6459, 1, 1636430543941, 1636430544202, 261, 0, 261, 0, 0, 0
6458, 1, 1636430543973, 1636430544237, 264, 0, 264, 0, 0, 0
6460, 1, 1636430544706, 1636430544978, 272, 0, 272, 0, 0, 0
6461, 1, 1636430545061, 1636430545333, 272, 1, 271, 1, 0, 1
6463, 1, 1636430545286, 1636430545550, 264, 0, 264, 0, 0, 0
6462, 1, 1636430545278, 1636430545550, 272, 0, 272, 0, 0, 0
6467, 1, 1636430545637, 1636430545910, 273, 1, 272, 0, 1, 1
6469, 1, 1636430545814, 1636430546086, 272, 0, 272, 0, 0, 0
6468, 1, 1636430546086, 1636430546358, 272, 0, 272, 0, 0, 0
6471, 1, 1636430547034, 1636430547306, 272, 0, 272, 0, 0, 0
6473, 1, 1636430547282, 1636430547554, 272, 0, 272, 0, 0, 0
6474, 1, 1636430547609, 1636430547878, 269, 1, 268, 1, 0, 1
6476, 1, 1636430547925, 1636430548198, 273, 1, 272, 0, 0, 0
6475, 1, 1636430548054, 1636430548326, 272, 0, 272, 0, 0, 0
6478, 1, 1636430549370, 1636430549641, 271, 0, 271, 0, 0, 0
6481, 1, 1636430549906, 1636430550178, 272, 0, 272, 0, 0, 0
6482, 1, 1636430550938, 1636430551209, 271, 0, 271, 0, 0, 0
6443, 1, 1636430551229, 1636430551501, 272, 1, 271, 1, 0, 1
6483, 1, 1636430551386, 1636430551658, 272, 0, 272, 0, 0, 0
6484, 1, 1636430551494, 1636430551766, 272, 0, 272, 0, 0, 0
6485, 1, 1636430551841, 1636430552110, 269, 1, 268, 0, 0, 0
6487, 1, 1636430551873, 1636430552146, 273, 1, 272, 0, 0, 0
6486, 1, 1636430552293, 1636430552566, 273, 1, 272, 1, 0, 1
6488, 1, 1636430552774, 1636430553046, 272, 0, 272, 0, 0, 0
6489, 1, 1636430553230, 1636430553502, 272, 0, 272, 0, 0, 0
6491, 1, 1636430553493, 1636430553766, 273, 1, 272, 0, 1, 1
6490, 1, 1636430553682, 1636430553954, 272, 0, 272, 0, 0, 0
6493, 1, 1636430553950, 1636430554222, 272, 0, 272, 0, 0, 0
6492, 1, 1636430554133, 1636430554406, 273, 1, 272, 0, 0, 0
6494, 1, 1636430554710, 1636430554982, 272, 0, 272, 0, 0, 0
6495, 1, 1636430555165, 1636430555502, 337, 1, 336, 0, 0, 0
6497, 1, 1636430555502, 1636430555774, 272, 0, 272, 0, 0, 0
6496, 1, 1636430555686, 1636430555957, 271, 0, 271, 0, 0, 0
6499, 1, 1636430555909, 1636430556182, 273, 1, 272, 0, 0, 0
6502, 1, 1636430556038, 1636430556310, 272, 0, 272, 0, 0, 0
6498, 1, 1636430556137, 1636430556406, 269, 0, 269, 0, 0, 0
6501, 1, 1636430556365, 1636430556646, 281, 0, 281, 0, 0, 0
6500, 1, 1636430556490, 1636430556754, 264, 0, 264, 0, 0, 0
6503, 1, 1636430556738, 1636430557014, 276, 0, 276, 0, 0, 0
6505, 1, 1636430556934, 1636430557226, 292, 0, 292, 0, 0, 0
6504, 1, 1636430557193, 1636430557465, 272, 1, 271, 0, 1, 1
6507, 1, 1636430557482, 1636430557750, 268, 0, 268, 0, 0, 0
6508, 1, 1636430557501, 1636430557773, 272, 1, 271, 0, 0, 0
6506, 1, 1636430557649, 1636430557925, 276, 1, 275, 0, 1, 1
6509, 1, 1636430557817, 1636430558086, 269, 0, 269, 0, 0, 0
6511, 1, 1636430557906, 1636430558177, 271, 0, 271, 0, 0, 0
6510, 1, 1636430558110, 1636430558382, 272, 0, 272, 0, 0, 0
6513, 1, 1636430558270, 1636430558537, 267, 0, 267, 0, 0, 0
6512, 1, 1636430558358, 1636430558630, 272, 0, 272, 0, 0, 0
6514, 1, 1636430558769, 1636430559042, 273, 0, 273, 0, 0, 0
6515, 1, 1636430558814, 1636430559102, 288, 0, 288, 0, 0, 0
6517, 1, 1636430559270, 1636430559541, 271, 0, 271, 0, 0, 0
6516, 1, 1636430559225, 1636430559541, 316, 0, 316, 0, 0, 0
6518, 1, 1636430559374, 1636430559641, 267, 0, 267, 0, 0, 0
6519, 1, 1636430559465, 1636430559737, 272, 1, 271, 1, 0, 1
6480, 1, 1636430559490, 1636430559761, 271, 0, 271, 0, 0, 0
6520, 1, 1636430559725, 1636430560001, 276, 1, 275, 0, 0, 0
6521, 1, 1636430559745, 1636430560017, 272, 1, 271, 0, 0, 0
6522, 1, 1636430559805, 1636430560082, 277, 1, 276, 1, 0, 1
6525, 1, 1636430559977, 1636430560249, 272, 1, 271, 0, 0, 0
6524, 1, 1636430560181, 1636430560446, 265, 1, 264, 0, 0, 0
6523, 1, 1636430560202, 1636430560477, 275, 0, 275, 0, 0, 0
6527, 1, 1636430560265, 1636430560537, 272, 1, 271, 0, 0, 0
6526, 1, 1636430560426, 1636430560698, 272, 0, 272, 0, 0, 0
6528, 1, 1636430560714, 1636430560986, 272, 0, 272, 0, 0, 0
6530, 1, 1636430560902, 1636430561174, 272, 0, 272, 0, 0, 0
6531, 1, 1636430561157, 1636430561430, 273, 1, 272, 1, 0, 1
6529, 1, 1636430561166, 1636430561433, 267, 0, 267, 0, 0, 0
6533, 1, 1636430561450, 1636430561725, 275, 0, 275, 0, 0, 0
6534, 1, 1636430561593, 1636430561865, 272, 0, 272, 0, 0, 0
6532, 1, 1636430561614, 1636430561886, 272, 0, 272, 0, 0, 0
6535, 1, 1636430561698, 1636430561966, 268, 0, 268, 0, 0, 0
6536, 1, 1636430561845, 1636430562117, 272, 0, 272, 0, 0, 0
6537, 1, 1636430562073, 1636430562349, 276, 1, 275, 0, 1, 1
6539, 1, 1636430562145, 1636430562417, 272, 1, 271, 1, 0, 1
6538, 1, 1636430562301, 1636430562573, 272, 1, 271, 0, 0, 0
6540, 1, 1636430562701, 1636430562974, 273, 1, 272, 0, 0, 0
6541, 1, 1636430563158, 1636430563430, 272, 0, 272, 0, 0, 0
6542, 1, 1636430563241, 1636430563517, 276, 1, 275, 0, 1, 1
6544, 1, 1636430563586, 1636430563857, 271, 0, 271, 0, 0, 0
6543, 1, 1636430563614, 1636430563885, 271, 0, 271, 0, 0, 0
6545, 1, 1636430563778, 1636430564050, 272, 0, 272, 0, 0, 0
6546, 1, 1636430563869, 1636430564141, 272, 1, 271, 0, 0, 0
6547, 1, 1636430564065, 1636430564337, 272, 0, 272, 0, 0, 0
6549, 1, 1636430564233, 1636430564506, 273, 1, 272, 1, 0, 1
6548, 1, 1636430564325, 1636430564598, 273, 1, 272, 0, 0, 0
6550, 1, 1636430564626, 1636430564902, 276, 0, 276, 0, 0, 0
6551, 1, 1636430565090, 1636430565366, 276, 0, 276, 0, 0, 0
6552, 1, 1636430565550, 1636430565818, 268, 0, 268, 0, 0, 0
6553, 1, 1636430565662, 1636430565933, 271, 0, 271, 0, 0, 0
6555, 1, 1636430565890, 1636430566162, 272, 0, 272, 0, 0, 0
6554, 1, 1636430565994, 1636430566269, 275, 0, 275, 0, 0, 0
6556, 1, 1636430566346, 1636430566618, 272, 0, 272, 0, 0, 0
6557, 1, 1636430566501, 1636430566774, 273, 1, 272, 0, 1, 1
6558, 1, 1636430566954, 1636430567226, 272, 0, 272, 0, 0, 0
6559, 1, 1636430567410, 1636430567682, 272, 0, 272, 0, 0, 0
6561, 1, 1636430567842, 1636430568114, 272, 0, 272, 0, 0, 0
6560, 1, 1636430567858, 1636430568129, 271, 0, 271, 0, 0, 0
6562, 1, 1636430568298, 1636430568570, 272, 0, 272, 0, 0, 0
6563, 1, 1636430568413, 1636430568686, 273, 1, 272, 1, 0, 1
6564, 1, 1636430568869, 1636430569146, 277, 1, 276, 0, 0, 0
6565, 1, 1636430569330, 1636430569602, 272, 0, 272, 0, 0, 0
6566, 1, 1636430569782, 1636430570053, 271, 0, 271, 0, 0, 0
6567, 1, 1636430569909, 1636430570182, 273, 1, 272, 0, 0, 0
6568, 1, 1636430570366, 1636430570637, 271, 0, 271, 0, 0, 0
6569, 1, 1636430570486, 1636430570762, 276, 0, 276, 0, 0, 0
6570, 1, 1636430570946, 1636430571218, 272, 0, 272, 0, 0, 0
6571, 1, 1636430571402, 1636430571673, 271, 0, 271, 0, 0, 0
6572, 1, 1636430571861, 1636430572134, 273, 1, 272, 0, 0, 0
6573, 1, 1636430571882, 1636430572158, 276, 0, 276, 0, 0, 0
6574, 1, 1636430572333, 1636430572610, 277, 1, 276, 0, 1, 1
6575, 1, 1636430572450, 1636430572722, 272, 0, 272, 0, 0, 0
6576, 1, 1636430572906, 1636430573182, 276, 0, 276, 0, 0, 0
6577, 1, 1636430573366, 1636430573638, 272, 0, 272, 0, 0, 0
6578, 1, 1636430573822, 1636430574094, 272, 0, 272, 0, 0, 0
6579, 1, 1636430573885, 1636430574153, 268, 0, 268, 0, 0, 0
6580, 1, 1636430574337, 1636430574610, 273, 0, 273, 0, 0, 0
6581, 1, 1636430574554, 1636430574826, 272, 0, 272, 0, 0, 0
6582, 1, 1636430575010, 1636430575286, 276, 0, 276, 0, 0, 0
6583, 1, 1636430575470, 1636430575742, 272, 0, 272, 0, 0, 0
6584, 1, 1636430575926, 1636430576198, 272, 0, 272, 0, 0, 0
6586, 1, 1636430576658, 1636430576930, 272, 0, 272, 0, 0, 0
6587, 1, 1636430577114, 1636430577386, 272, 0, 272, 0, 0, 0
6585, 1, 1636430577570, 1636430577842, 272, 0, 272, 0, 0, 0
6588, 1, 1636430578026, 1636430578298, 272, 0, 272, 0, 0, 0
6589, 1, 1636430578598, 1636430578870, 272, 0, 272, 0, 0, 0
6591, 1, 1636430579053, 1636430579326, 273, 1, 272, 0, 0, 0
6590, 1, 1636430579510, 1636430579781, 271, 0, 271, 0, 0, 0
6592, 1, 1636430579966, 1636430580238, 272, 0, 272, 0, 0, 0
6593, 1, 1636430580498, 1636430580766, 268, 0, 268, 0, 0, 0
6597, 1, 1636430582549, 1636430582821, 272, 1, 271, 0, 0, 0
6596, 1, 1636430590922, 1636430591194, 272, 0, 272, 0, 0, 0
6599, 1, 1636430591253, 1636430591526, 273, 1, 272, 0, 0, 0
6600, 1, 1636430591710, 1636430591986, 276, 0, 276, 0, 0, 0
6598, 1, 1636430592166, 1636430592438, 272, 0, 272, 0, 0, 0
6601, 1, 1636430665626, 1636430665898, 272, 0, 272, 0, 0, 0
6602, 1, 1636430666338, 1636430666610, 272, 0, 272, 0, 0, 0
6603, 1, 1636430666789, 1636430667066, 277, 1, 276, 0, 0, 0
6604, 1, 1636430667010, 1636430667281, 271, 0, 271, 0, 0, 0
6606, 1, 1636430667489, 1636430667761, 272, 1, 271, 0, 0, 0
6605, 1, 1636430667501, 1636430667778, 277, 0, 277, 0, 0, 0
6607, 1, 1636430667682, 1636430667954, 272, 0, 272, 0, 0, 0
6608, 1, 1636430668097, 1636430668370, 273, 1, 272, 0, 0, 0
6609, 1, 1636430668173, 1636430668446, 273, 1, 272, 0, 0, 0
6610, 1, 1636430668198, 1636430668469, 271, 0, 271, 0, 0, 0
6611, 1, 1636430668349, 1636430668621, 272, 1, 271, 1, 0, 1
6612, 1, 1636430668605, 1636430668873, 268, 1, 267, 1, 0, 1
6613, 1, 1636430668801, 1636430669070, 269, 0, 269, 0, 0, 0
6614, 1, 1636430668846, 1636430669121, 275, 0, 275, 0, 0, 0
6615, 1, 1636430668869, 1636430669145, 276, 0, 276, 0, 0, 0
6616, 1, 1636430669026, 1636430669298, 272, 0, 272, 0, 0, 0
6617, 1, 1636430669093, 1636430669365, 272, 1, 271, 0, 0, 0
6618, 1, 1636430669314, 1636430669585, 271, 0, 271, 0, 0, 0
6619, 1, 1636430669469, 1636430669738, 269, 1, 268, 0, 1, 1
6620, 1, 1636430669522, 1636430669793, 271, 0, 271, 0, 0, 0
6621, 1, 1636430669545, 1636430669817, 272, 1, 271, 0, 0, 0
6622, 1, 1636430669578, 1636430669853, 275, 0, 275, 0, 0, 0
6624, 1, 1636430669801, 1636430670073, 272, 1, 271, 0, 1, 1
6625, 1, 1636430669997, 1636430670269, 272, 1, 271, 0, 1, 1
6623, 1, 1636430670038, 1636430670310, 272, 0, 272, 0, 0, 0
6627, 1, 1636430670141, 1636430670417, 276, 1, 275, 0, 0, 0
6628, 1, 1636430670201, 1636430670473, 272, 1, 271, 0, 0, 0
6629, 1, 1636430670221, 1636430670497, 276, 0, 276, 0, 0, 0
6630, 1, 1636430670285, 1636430670557, 272, 1, 271, 0, 1, 1
6631, 1, 1636430670469, 1636430670741, 272, 0, 272, 0, 0, 0
6626, 1, 1636430670485, 1636430670757, 272, 0, 272, 0, 0, 0
6633, 1, 1636430670682, 1636430670957, 275, 0, 275, 0, 0, 0
6634, 1, 1636430670705, 1636430670985, 280, 0, 280, 0, 0, 0
6635, 1, 1636430670821, 1636430671089, 268, 0, 268, 0, 0, 0
6637, 1, 1636430670897, 1636430671169, 272, 1, 271, 0, 0, 0
6636, 1, 1636430670937, 1636430671205, 268, 0, 268, 0, 0, 0
6638, 1, 1636430670957, 1636430671229, 272, 0, 272, 0, 0, 0
6639, 1, 1636430671146, 1636430671421, 275, 0, 275, 0, 0, 0
6640, 1, 1636430671153, 1636430671433, 280, 1, 279, 1, 0, 1
6641, 1, 1636430671357, 1636430671633, 276, 1, 275, 1, 0, 1
6642, 1, 1636430671381, 1636430671653, 272, 0, 272, 0, 0, 0
6632, 1, 1636430671385, 1636430671657, 272, 1, 271, 0, 0, 0
6643, 1, 1636430671490, 1636430671757, 267, 0, 267, 0, 0, 0
6645, 1, 1636430671610, 1636430671885, 275, 0, 275, 0, 0, 0
6646, 1, 1636430671633, 1636430671905, 272, 0, 272, 0, 0, 0
6647, 1, 1636430671817, 1636430672089, 272, 1, 271, 0, 1, 1
6648, 1, 1636430671817, 1636430672089, 272, 1, 271, 0, 1, 1
6644, 1, 1636430671833, 1636430672101, 268, 0, 268, 0, 0, 0
6650, 1, 1636430672033, 1636430672301, 268, 0, 268, 0, 0, 0
6652, 1, 1636430672053, 1636430672317, 264, 1, 263, 0, 0, 0
6651, 1, 1636430672065, 1636430672333, 268, 0, 268, 0, 0, 0
6653, 1, 1636430672277, 1636430672549, 272, 0, 272, 0, 0, 0
6654, 1, 1636430672289, 1636430672561, 272, 0, 272, 0, 0, 0
6655, 1, 1636430672301, 1636430672569, 268, 1, 267, 0, 0, 0
6656, 1, 1636430672486, 1636430672753, 267, 0, 267, 0, 0, 0
6657, 1, 1636430672493, 1636430672761, 268, 1, 267, 0, 1, 1
6658, 1, 1636430672497, 1636430672765, 268, 0, 268, 0, 0, 0
6662, 1, 1636430672725, 1636430672997, 272, 1, 271, 1, 0, 1
6661, 1, 1636430672725, 1636430672998, 273, 1, 272, 0, 0, 0
6665, 1, 1636430672969, 1636430673233, 264, 0, 264, 0, 0, 0
6663, 1, 1636430672962, 1636430673233, 271, 0, 271, 0, 0, 0
6664, 1, 1636430672962, 1636430673233, 271, 0, 271, 0, 0, 0
6669, 1, 1636430673166, 1636430673433, 267, 0, 267, 0, 0, 0
6668, 1, 1636430673166, 1636430673433, 267, 0, 267, 0, 0, 0
6671, 1, 1636430673390, 1636430673661, 271, 0, 271, 0, 0, 0
6670, 1, 1636430673390, 1636430673661, 271, 0, 271, 0, 0, 0
6673, 1, 1636430673629, 1636430673901, 272, 1, 271, 0, 0, 0
6672, 1, 1636430673629, 1636430673901, 272, 1, 271, 0, 0, 0
6676, 1, 1636430673833, 1636430674109, 276, 1, 275, 0, 0, 0
6677, 1, 1636430673850, 1636430674122, 272, 0, 272, 0, 0, 0
6679, 1, 1636430674062, 1636430674333, 271, 0, 271, 0, 0, 0
6678, 1, 1636430674062, 1636430674333, 271, 0, 271, 0, 0, 0
6674, 1, 1636430674077, 1636430674341, 264, 1, 263, 0, 0, 0
6681, 1, 1636430674301, 1636430674573, 272, 0, 272, 0, 0, 0
6682, 1, 1636430674305, 1636430674574, 269, 1, 268, 0, 0, 0
6683, 1, 1636430674513, 1636430674785, 272, 0, 272, 0, 0, 0
6684, 1, 1636430674517, 1636430674793, 276, 1, 275, 0, 0, 0
6685, 1, 1636430674733, 1636430675005, 272, 1, 271, 0, 1, 1
6686, 1, 1636430674737, 1636430675005, 268, 1, 267, 0, 0, 0
6687, 1, 1636430674749, 1636430675029, 280, 0, 280, 0, 0, 0
6690, 1, 1636430674969, 1636430675241, 272, 0, 272, 0, 0, 0
6689, 1, 1636430674977, 1636430675249, 272, 1, 271, 1, 0, 1
6692, 1, 1636430675189, 1636430675453, 264, 1, 263, 0, 0, 0
6691, 1, 1636430675181, 1636430675453, 272, 1, 271, 0, 1, 1
6695, 1, 1636430675401, 1636430675669, 268, 0, 268, 0, 0, 0
6694, 1, 1636430675401, 1636430675669, 268, 0, 268, 0, 0, 0
6696, 1, 1636430675425, 1636430675693, 268, 0, 268, 0, 0, 0
6697, 1, 1636430675629, 1636430675905, 276, 0, 276, 0, 0, 0
6698, 1, 1636430675665, 1636430675937, 272, 1, 271, 0, 1, 1
6700, 1, 1636430675858, 1636430676129, 271, 0, 271, 0, 0, 0
6702, 1, 1636430676070, 1636430676342, 272, 0, 272, 0, 0, 0
6703, 1, 1636430676070, 1636430676342, 272, 0, 272, 0, 0, 0
6704, 1, 1636430676094, 1636430676361, 267, 0, 267, 0, 0, 0
6705, 1, 1636430676313, 1636430676585, 272, 0, 272, 0, 0, 0
6706, 1, 1636430676338, 1636430676609, 271, 0, 271, 0, 0, 0
6708, 1, 1636430676533, 1636430676806, 273, 1, 272, 0, 0, 0
6711, 1, 1636430676774, 1636430677045, 271, 0, 271, 0, 0, 0
6713, 1, 1636430676986, 1636430677257, 271, 0, 271, 0, 0, 0
6714, 1, 1636430677009, 1636430677282, 273, 1, 272, 0, 1, 1
6715, 1, 1636430677202, 1636430677474, 272, 0, 272, 0, 0, 0
6716, 1, 1636430677449, 1636430677721, 272, 1, 271, 0, 1, 1
6717, 1, 1636430677649, 1636430677921, 272, 1, 271, 0, 0, 0
6719, 1, 1636430677869, 1636430678142, 273, 0, 273, 0, 0, 0
6720, 1, 1636430678121, 1636430678393, 272, 1, 271, 1, 0, 1
6721, 1, 1636430678325, 1636430678598, 273, 1, 272, 0, 1, 1
6723, 1, 1636430678794, 1636430679066, 272, 0, 272, 0, 0, 0
6728, 1, 1636430683113, 1636430683381, 268, 0, 268, 0, 0, 0
6726, 1, 1636430683113, 1636430683385, 272, 0, 272, 0, 0, 0
6729, 1, 1636430683561, 1636430683845, 284, 1, 283, 0, 0, 0
6730, 1, 1636430683557, 1636430683845, 288, 1, 287, 1, 0, 1
6731, 1, 1636430683805, 1636430684077, 272, 1, 271, 0, 0, 0
6732, 1, 1636430683805, 1636430684077, 272, 1, 271, 1, 0, 1
6735, 1, 1636430684262, 1636430684534, 272, 0, 272, 0, 0, 0
6737, 1, 1636430684477, 1636430684749, 272, 1, 271, 0, 0, 0
6736, 1, 1636430684477, 1636430684749, 272, 1, 271, 1, 0, 1
6739, 1, 1636430684933, 1636430685214, 281, 1, 280, 0, 0, 0
6742, 1, 1636430685146, 1636430685453, 307, 0, 307, 0, 0, 0
6741, 1, 1636430685146, 1636430685454, 308, 0, 308, 0, 0, 0
6743, 1, 1636430685633, 1636430685929, 296, 1, 295, 0, 0, 0
6746, 1, 1636430685925, 1636430686197, 272, 1, 271, 0, 0, 0
6745, 1, 1636430685929, 1636430686201, 272, 1, 271, 0, 1, 1
6748, 1, 1636430686161, 1636430686469, 308, 0, 308, 0, 0, 0
6749, 1, 1636430686373, 1636430686642, 269, 0, 269, 0, 0, 0
6750, 1, 1636430686594, 1636430686929, 335, 0, 335, 0, 0, 0
6751, 1, 1636430686598, 1636430686929, 331, 0, 331, 0, 0, 0
6753, 1, 1636430686885, 1636430687157, 272, 1, 271, 0, 0, 0
6755, 1, 1636430687053, 1636430687326, 273, 1, 272, 0, 1, 1
6754, 1, 1636430687105, 1636430687377, 272, 1, 271, 0, 0, 0
6756, 1, 1636430687105, 1636430687377, 272, 1, 271, 1, 0, 1
6759, 1, 1636430687326, 1636430687597, 271, 0, 271, 0, 0, 0
6760, 1, 1636430687550, 1636430687826, 276, 0, 276, 0, 0, 0
6761, 1, 1636430687729, 1636430687998, 269, 1, 268, 0, 0, 0
6762, 1, 1636430687773, 1636430688042, 269, 1, 268, 0, 1, 1
6764, 1, 1636430687998, 1636430688269, 271, 0, 271, 0, 0, 0
6766, 1, 1636430688221, 1636430688493, 272, 1, 271, 0, 0, 0
6767, 1, 1636430688397, 1636430688690, 293, 0, 293, 0, 0, 0
6768, 1, 1636430688441, 1636430688713, 272, 1, 271, 0, 0, 0
6769, 1, 1636430688669, 1636430688942, 273, 0, 273, 0, 0, 0
6770, 1, 1636430688858, 1636430689141, 283, 0, 283, 0, 0, 0
6771, 1, 1636430688889, 1636430689157, 268, 1, 267, 0, 0, 0
6772, 1, 1636430689090, 1636430689362, 272, 0, 272, 0, 0, 0
6773, 1, 1636430689101, 1636430689374, 273, 0, 273, 0, 0, 0
6774, 1, 1636430689317, 1636430689609, 292, 0, 292, 0, 0, 0
6775, 1, 1636430689337, 1636430689609, 272, 0, 272, 0, 0, 0
6765, 1, 1636430689469, 1636430689745, 276, 0, 276, 0, 0, 0
6776, 1, 1636430689557, 1636430689829, 272, 1, 271, 1, 0, 1
6777, 1, 1636430689557, 1636430689829, 272, 1, 271, 1, 0, 1
6778, 1, 1636430689765, 1636430690037, 272, 0, 272, 0, 0, 0
6780, 1, 1636430689781, 1636430690053, 272, 1, 271, 0, 1, 1
6779, 1, 1636430689786, 1636430690053, 267, 0, 267, 0, 0, 0
6782, 1, 1636430690005, 1636430690281, 276, 1, 275, 0, 0, 0
6781, 1, 1636430690013, 1636430690285, 272, 0, 272, 0, 0, 0
6783, 1, 1636430690138, 1636430690410, 272, 0, 272, 0, 0, 0
6785, 1, 1636430690233, 1636430690505, 272, 0, 272, 0, 0, 0
6786, 1, 1636430690437, 1636430690709, 272, 1, 271, 0, 0, 0
6787, 1, 1636430690457, 1636430690725, 268, 1, 267, 0, 1, 1
6788, 1, 1636430690461, 1636430690726, 265, 0, 265, 0, 0, 0
6789, 1, 1636430690677, 1636430690949, 272, 0, 272, 0, 0, 0
6790, 1, 1636430690681, 1636430690949, 268, 0, 268, 0, 0, 0
6791, 1, 1636430690809, 1636430691077, 268, 0, 268, 0, 0, 0
6792, 1, 1636430690898, 1636430691169, 271, 0, 271, 0, 0, 0
6795, 1, 1636430691121, 1636430691393, 272, 1, 271, 0, 0, 0
6794, 1, 1636430691121, 1636430691393, 272, 0, 272, 0, 0, 0
6796, 1, 1636430691350, 1636430691621, 271, 0, 271, 0, 0, 0
6797, 1, 1636430691350, 1636430691622, 272, 0, 272, 0, 0, 0
6798, 1, 1636430691473, 1636430691745, 272, 0, 272, 0, 0, 0
6799, 1, 1636430691565, 1636430691837, 272, 0, 272, 0, 0, 0
6734, 1, 1636430691573, 1636430691841, 268, 1, 267, 0, 1, 1
6800, 1, 1636430691786, 1636430692062, 276, 0, 276, 0, 0, 0
6801, 1, 1636430691797, 1636430692069, 272, 0, 272, 0, 0, 0
6803, 1, 1636430692021, 1636430692289, 268, 0, 268, 0, 0, 0
6802, 1, 1636430692017, 1636430692290, 273, 1, 272, 0, 0, 0
6804, 1, 1636430692145, 1636430692417, 272, 1, 271, 0, 1, 1
6806, 1, 1636430692237, 1636430692505, 268, 0, 268, 0, 0, 0
6805, 1, 1636430692233, 1636430692506, 273, 1, 272, 0, 0, 0
6807, 1, 1636430692457, 1636430692725, 268, 1, 267, 0, 1, 1
6808, 1, 1636430692461, 1636430692733, 272, 1, 271, 0, 0, 0
6810, 1, 1636430692690, 1636430692954, 264, 0, 264, 0, 0, 0
6809, 1, 1636430692682, 1636430692954, 272, 0, 272, 0, 0, 0
6811, 1, 1636430692813, 1636430693101, 288, 1, 287, 0, 1, 1
6813, 1, 1636430692905, 1636430693189, 284, 1, 283, 1, 0, 1
6812, 1, 1636430692905, 1636430693189, 284, 1, 283, 1, 0, 1
6814, 1, 1636430693146, 1636430693417, 271, 0, 271, 0, 0, 0
6815, 1, 1636430693146, 1636430693417, 271, 0, 271, 0, 0, 0
6817, 1, 1636430693358, 1636430693630, 272, 0, 272, 0, 0, 0
6816, 1, 1636430693369, 1636430693637, 268, 1, 267, 0, 0, 0
6818, 1, 1636430693497, 1636430693769, 272, 0, 272, 0, 0, 0
6819, 1, 1636430693582, 1636430693853, 271, 0, 271, 0, 0, 0
6820, 1, 1636430693589, 1636430693861, 272, 0, 272, 0, 0, 0
6821, 1, 1636430693809, 1636430694081, 272, 1, 271, 1, 0, 1
6822, 1, 1636430693817, 1636430694089, 272, 0, 272, 0, 0, 0
6824, 1, 1636430694062, 1636430694333, 271, 0, 271, 0, 0, 0
6823, 1, 1636430694062, 1636430694333, 271, 0, 271, 0, 0, 0
6827, 1, 1636430694262, 1636430694570, 308, 0, 308, 0, 0, 0
6826, 1, 1636430694250, 1636430694570, 320, 0, 320, 0, 0, 0
6828, 1, 1636430694329, 1636430694601, 272, 1, 271, 1, 0, 1
6830, 1, 1636430694481, 1636430694753, 272, 1, 271, 0, 0, 0
6831, 1, 1636430694513, 1636430694781, 268, 1, 267, 0, 1, 1
6832, 1, 1636430694733, 1636430695001, 268, 0, 268, 0, 0, 0
6833, 1, 1636430694753, 1636430695025, 272, 0, 272, 0, 0, 0
6829, 1, 1636430694777, 1636430695046, 269, 1, 268, 0, 1, 1
6835, 1, 1636430694970, 1636430695237, 267, 0, 267, 0, 0, 0
6836, 1, 1636430694970, 1636430695237, 267, 0, 267, 0, 0, 0
6837, 1, 1636430695017, 1636430695282, 265, 0, 265, 0, 0, 0
6838, 1, 1636430695149, 1636430695417, 268, 1, 267, 0, 0, 0
6839, 1, 1636430695205, 1636430695478, 273, 0, 273, 0, 0, 0
6834, 1, 1636430695217, 1636430695485, 268, 1, 267, 0, 0, 0
6841, 1, 1636430695401, 1636430695674, 273, 0, 273, 0, 0, 0
6842, 1, 1636430695417, 1636430695689, 272, 0, 272, 0, 0, 0
6843, 1, 1636430695457, 1636430695773, 316, 0, 316, 0, 0, 0
6844, 1, 1636430695673, 1636430695937, 264, 1, 263, 0, 0, 0
6840, 1, 1636430695665, 1636430695937, 272, 1, 271, 0, 0, 0
6845, 1, 1636430695681, 1636430695961, 280, 0, 280, 0, 0, 0
6846, 1, 1636430695721, 1636430695985, 264, 0, 264, 0, 0, 0
6847, 1, 1636430695817, 1636430696085, 268, 0, 268, 0, 0, 0
6848, 1, 1636430695877, 1636430696197, 320, 1, 319, 0, 0, 0
6849, 1, 1636430695953, 1636430696226, 273, 0, 273, 0, 0, 0
6850, 1, 1636430696109, 1636430696373, 264, 1, 263, 0, 0, 0
6851, 1, 1636430696105, 1636430696374, 269, 0, 269, 0, 0, 0
6852, 1, 1636430696141, 1636430696405, 264, 1, 263, 0, 1, 1
6853, 1, 1636430696185, 1636430696450, 265, 0, 265, 0, 0, 0
6855, 1, 1636430696337, 1636430696605, 268, 0, 268, 0, 0, 0
6856, 1, 1636430696350, 1636430696621, 271, 0, 271, 0, 0, 0
6854, 1, 1636430696405, 1636430696674, 269, 1, 268, 0, 1, 1
6857, 1, 1636430696373, 1636430696677, 304, 1, 303, 0, 1, 1
6859, 1, 1636430696490, 1636430696773, 283, 0, 283, 0, 0, 0
6860, 1, 1636430696589, 1636430696865, 276, 1, 275, 0, 1, 1
6858, 1, 1636430696589, 1636430696865, 276, 1, 275, 0, 0, 0
6861, 1, 1636430696629, 1636430696901, 272, 0, 272, 0, 0, 0
6863, 1, 1636430696809, 1636430697077, 268, 0, 268, 0, 0, 0
6862, 1, 1636430696805, 1636430697085, 280, 1, 279, 0, 0, 0
6865, 1, 1636430696853, 1636430697117, 264, 0, 264, 0, 0, 0
6864, 1, 1636430696849, 1636430697121, 272, 0, 272, 0, 0, 0
6868, 1, 1636430697021, 1636430697293, 272, 1, 271, 0, 1, 1
6867, 1, 1636430696997, 1636430697297, 300, 1, 299, 0, 1, 1
6866, 1, 1636430697050, 1636430697317, 267, 0, 267, 0, 0, 0
6870, 1, 1636430697113, 1636430697381, 268, 1, 267, 0, 0, 0
6869, 1, 1636430697113, 1636430697389, 276, 1, 275, 1, 0, 1
6871, 1, 1636430697201, 1636430697469, 268, 0, 268, 0, 0, 0
6873, 1, 1636430697285, 1636430697545, 260, 0, 260, 0, 0, 0
6872, 1, 1636430697297, 1636430697558, 261, 1, 260, 0, 0, 0
6874, 1, 1636430697373, 1636430697637, 264, 1, 263, 0, 1, 1
6875, 1, 1636430697494, 1636430697765, 271, 0, 271, 0, 0, 0
6878, 1, 1636430697553, 1636430697817, 264, 1, 263, 0, 0, 0
6877, 1, 1636430697513, 1636430697817, 304, 0, 304, 0, 0, 0
6876, 1, 1636430697505, 1636430697817, 312, 1, 311, 0, 0, 0
6879, 1, 1636430697561, 1636430697837, 276, 0, 276, 0, 0, 0
6880, 1, 1636430697633, 1636430697909, 276, 0, 276, 0, 0, 0
6881, 1, 1636430697681, 1636430697946, 265, 1, 264, 0, 0, 0
6882, 1, 1636430697729, 1636430697997, 268, 1, 267, 0, 0, 0
6883, 1, 1636430697729, 1636430697997, 268, 0, 268, 0, 0, 0
6884, 1, 1636430697769, 1636430698037, 268, 0, 268, 0, 0, 0
6885, 1, 1636430697813, 1636430698089, 276, 1, 275, 0, 0, 0
6886, 1, 1636430697857, 1636430698125, 268, 0, 268, 0, 0, 0
6887, 1, 1636430697997, 1636430698265, 268, 1, 267, 1, 0, 1
6889, 1, 1636430698029, 1636430698301, 272, 1, 271, 0, 1, 1
6888, 1, 1636430698025, 1636430698305, 280, 1, 279, 0, 0, 0
6890, 1, 1636430698089, 1636430698357, 268, 1, 267, 0, 1, 1
6891, 1, 1636430698177, 1636430698449, 272, 0, 272, 0, 0, 0
6893, 1, 1636430698213, 1636430698485, 272, 1, 271, 1, 0, 1
6892, 1, 1636430698213, 1636430698486, 273, 1, 272, 0, 1, 1
6894, 1, 1636430698225, 1636430698489, 264, 0, 264, 0, 0, 0
6895, 1, 1636430698261, 1636430698533, 272, 0, 272, 0, 0, 0
6896, 1, 1636430698305, 1636430698573, 268, 1, 267, 1, 0, 1
6897, 1, 1636430698357, 1636430698625, 268, 1, 267, 0, 0, 0
6898, 1, 1636430698393, 1636430698665, 272, 0, 272, 0, 0, 0
6900, 1, 1636430698441, 1636430698717, 276, 0, 276, 0, 0, 0
6901, 1, 1636430698485, 1636430698757, 272, 1, 271, 0, 1, 1
6899, 1, 1636430698482, 1636430698757, 275, 0, 275, 0, 0, 0
6902, 1, 1636430698537, 1636430698809, 272, 0, 272, 0, 0, 0
6903, 1, 1636430698657, 1636430698926, 269, 0, 269, 0, 0, 0
6904, 1, 1636430698701, 1636430698973, 272, 0, 272, 0, 0, 0
6905, 1, 1636430698709, 1636430698977, 268, 0, 268, 0, 0, 0
6906, 1, 1636430698753, 1636430699017, 264, 1, 263, 0, 0, 0
6908, 1, 1636430698881, 1636430699154, 273, 0, 273, 0, 0, 0
6909, 1, 1636430698889, 1636430699157, 268, 0, 268, 0, 0, 0
6910, 1, 1636430698889, 1636430699157, 268, 0, 268, 0, 0, 0
6911, 1, 1636430698929, 1636430699197, 268, 0, 268, 0, 0, 0
6907, 1, 1636430698937, 1636430699221, 284, 0, 284, 0, 0, 0
6913, 1, 1636430699017, 1636430699289, 272, 0, 272, 0, 0, 0
6914, 1, 1636430699057, 1636430699333, 276, 1, 275, 0, 0, 0
6915, 1, 1636430699109, 1636430699374, 265, 0, 265, 0, 0, 0
6917, 1, 1636430699153, 1636430699425, 272, 1, 271, 0, 0, 0
6916, 1, 1636430699153, 1636430699429, 276, 1, 275, 0, 0, 0
6918, 1, 1636430699205, 1636430699461, 256, 0, 256, 0, 0, 0
6919, 1, 1636430699325, 1636430699593, 268, 1, 267, 0, 0, 0
6912, 1, 1636430699337, 1636430699601, 264, 0, 264, 0, 0, 0
6921, 1, 1636430699369, 1636430699641, 272, 1, 271, 0, 0, 0
6923, 1, 1636430699545, 1636430699817, 272, 1, 271, 0, 0, 0
6924, 1, 1636430699557, 1636430699821, 264, 0, 264, 0, 0, 0
6925, 1, 1636430699553, 1636430699821, 268, 0, 268, 0, 0, 0
6926, 1, 1636430699601, 1636430699861, 260, 0, 260, 0, 0, 0
6927, 1, 1636430699621, 1636430699893, 272, 1, 271, 0, 1, 1
6928, 1, 1636430699689, 1636430699949, 260, 0, 260, 0, 0, 0
6929, 1, 1636430699729, 1636430700005, 276, 0, 276, 0, 0, 0
6930, 1, 1636430699773, 1636430700041, 268, 0, 268, 0, 0, 0
6932, 1, 1636430699817, 1636430700085, 268, 1, 267, 0, 1, 1
6933, 1, 1636430699865, 1636430700133, 268, 0, 268, 0, 0, 0
6934, 1, 1636430700005, 1636430700273, 268, 0, 268, 0, 0, 0
6935, 1, 1636430700005, 1636430700273, 268, 0, 268, 0, 0, 0
6936, 1, 1636430700037, 1636430700313, 276, 1, 275, 1, 0, 1
6937, 1, 1636430700217, 1636430700489, 272, 0, 272, 0, 0, 0
6938, 1, 1636430700265, 1636430700529, 264, 0, 264, 0, 0, 0
6939, 1, 1636430700273, 1636430700549, 276, 0, 276, 0, 0, 0
6941, 1, 1636430700309, 1636430700577, 268, 0, 268, 0, 0, 0
6942, 1, 1636430700353, 1636430700621, 268, 1, 267, 0, 1, 1
6944, 1, 1636430700433, 1636430700705, 272, 0, 272, 0, 0, 0
6945, 1, 1636430700489, 1636430700753, 264, 0, 264, 0, 0, 0
6947, 1, 1636430700533, 1636430700809, 276, 1, 275, 0, 1, 1
6946, 1, 1636430700533, 1636430700810, 277, 0, 277, 0, 0, 0
6949, 1, 1636430700665, 1636430700933, 268, 0, 268, 0, 0, 0
6948, 1, 1636430700661, 1636430700933, 272, 0, 272, 0, 0, 0
6951, 1, 1636430700881, 1636430701157, 276, 0, 276, 0, 0, 0
6952, 1, 1636430700926, 1636430701193, 267, 0, 267, 0, 0, 0
6954, 1, 1636430700973, 1636430701249, 276, 0, 276, 0, 0, 0
6953, 1, 1636430700945, 1636430701249, 304, 0, 304, 0, 0, 0
6955, 1, 1636430701017, 1636430701289, 272, 1, 271, 1, 0, 1
6956, 1, 1636430701105, 1636430701373, 268, 0, 268, 0, 0, 0
6958, 1, 1636430701197, 1636430701461, 264, 0, 264, 0, 0, 0
6959, 1, 1636430701205, 1636430701469, 264, 0, 264, 0, 0, 0
6960, 1, 1636430701333, 1636430701601, 268, 0, 268, 0, 0, 0
6961, 1, 1636430701333, 1636430701609, 276, 1, 275, 0, 1, 1
6962, 1, 1636430701413, 1636430701685, 272, 1, 271, 0, 0, 0
6963, 1, 1636430701549, 1636430701817, 268, 1, 267, 0, 0, 0
6964, 1, 1636430701585, 1636430701849, 264, 0, 264, 0, 0, 0
6965, 1, 1636430701645, 1636430701905, 260, 1, 259, 0, 0, 0
6967, 1, 1636430701681, 1636430701949, 268, 0, 268, 0, 0, 0
6968, 1, 1636430701769, 1636430702045, 276, 0, 276, 0, 0, 0
6969, 1, 1636430701873, 1636430702149, 276, 0, 276, 0, 0, 0
6971, 1, 1636430702001, 1636430702277, 276, 0, 276, 0, 0, 0
6972, 1, 1636430702009, 1636430702289, 280, 1, 279, 0, 1, 1
6973, 1, 1636430702081, 1636430702353, 272, 1, 271, 0, 0, 0
6974, 1, 1636430702217, 1636430702489, 272, 0, 272, 0, 0, 0
6976, 1, 1636430702313, 1636430702585, 272, 0, 272, 0, 0, 0
6977, 1, 1636430702353, 1636430702626, 273, 1, 272, 0, 0, 0
6978, 1, 1636430702441, 1636430702717, 276, 1, 275, 0, 0, 0
6979, 1, 1636430702549, 1636430702821, 272, 0, 272, 0, 0, 0
6980, 1, 1636430702673, 1636430702945, 272, 1, 271, 1, 0, 1
6981, 1, 1636430702681, 1636430702965, 284, 1, 283, 0, 0, 0
6983, 1, 1636430702881, 1636430703157, 276, 1, 275, 0, 0, 0
6984, 1, 1636430702977, 1636430703249, 272, 0, 272, 0, 0, 0
6985, 1, 1636430703021, 1636430703297, 276, 1, 275, 0, 0, 0
6987, 1, 1636430703222, 1636430703494, 272, 0, 272, 0, 0, 0
6988, 1, 1636430703337, 1636430703605, 268, 1, 267, 0, 1, 1
6989, 1, 1636430703370, 1636430703645, 275, 0, 275, 0, 0, 0
6990, 1, 1636430703558, 1636430703822, 264, 0, 264, 0, 0, 0
6991, 1, 1636430703641, 1636430703917, 276, 1, 275, 0, 1, 1
6992, 1, 1636430703705, 1636430703977, 272, 1, 271, 0, 0, 0
6993, 1, 1636430703893, 1636430704161, 268, 1, 267, 0, 0, 0
6994, 1, 1636430704005, 1636430704277, 272, 0, 272, 0, 0, 0
6995, 1, 1636430704037, 1636430704337, 300, 1, 299, 0, 1, 1
6996, 1, 1636430704249, 1636430704517, 268, 0, 268, 0, 0, 0
6997, 1, 1636430704317, 1636430704585, 268, 1, 267, 0, 1, 1
6998, 1, 1636430704377, 1636430704649, 272, 1, 271, 0, 1, 1
6999, 1, 1636430704510, 1636430704781, 271, 0, 271, 0, 0, 0
7000, 1, 1636430704557, 1636430704825, 268, 0, 268, 0, 0, 0
7001, 1, 1636430704694, 1636430704961, 267, 0, 267, 0, 0, 0
7002, 1, 1636430704729, 1636430705001, 272, 1, 271, 1, 0, 1
7003, 1, 1636430704909, 1636430705181, 272, 0, 272, 0, 0, 0
7004, 1, 1636430704986, 1636430705257, 271, 0, 271, 0, 0, 0
7005, 1, 1636430705041, 1636430705313, 272, 1, 271, 1, 0, 1
7006, 1, 1636430705178, 1636430705449, 271, 0, 271, 0, 0, 0
7007, 1, 1636430705225, 1636430705490, 265, 1, 264, 0, 0, 0
7008, 1, 1636430705361, 1636430705629, 268, 0, 268, 0, 0, 0
7009, 1, 1636430705401, 1636430705669, 268, 0, 268, 0, 0, 0
7010, 1, 1636430705574, 1636430705838, 264, 0, 264, 0, 0, 0
7011, 1, 1636430705657, 1636430705926, 269, 1, 268, 0, 0, 0
7012, 1, 1636430705709, 1636430705981, 272, 0, 272, 0, 0, 0
7014, 1, 1636430705893, 1636430706169, 276, 1, 275, 0, 0, 0
7015, 1, 1636430706021, 1636430706289, 268, 0, 268, 0, 0, 0
7016, 1, 1636430706066, 1636430706333, 267, 0, 267, 0, 0, 0
7017, 1, 1636430706245, 1636430706509, 264, 0, 264, 0, 0, 0
7018, 1, 1636430706325, 1636430706597, 272, 1, 271, 0, 0, 0
7019, 1, 1636430706377, 1636430706649, 272, 1, 271, 1, 0, 1
7020, 1, 1636430706570, 1636430706841, 271, 0, 271, 0, 0, 0
7021, 1, 1636430706693, 1636430706962, 269, 1, 268, 0, 0, 0
7022, 1, 1636430706729, 1636430706997, 268, 1, 267, 0, 0, 0
7023, 1, 1636430706909, 1636430707178, 269, 0, 269, 0, 0, 0
7025, 1, 1636430707045, 1636430707317, 272, 0, 272, 0, 0, 0
7024, 1, 1636430707181, 1636430707453, 272, 1, 271, 0, 0, 0
7026, 1, 1636430707233, 1636430707497, 264, 0, 264, 0, 0, 0
7027, 1, 1636430707361, 1636430707646, 285, 1, 284, 0, 0, 0
7029, 1, 1636430707577, 1636430707850, 273, 1, 272, 0, 0, 0
7028, 1, 1636430707673, 1636430707945, 272, 1, 271, 0, 0, 0
7030, 1, 1636430707713, 1636430707986, 273, 1, 272, 0, 0, 0
7031, 1, 1636430707849, 1636430708121, 272, 1, 271, 0, 1, 1
7032, 1, 1636430707897, 1636430708161, 264, 1, 263, 1, 0, 1
7033, 1, 1636430708049, 1636430708317, 268, 0, 268, 0, 0, 0
7034, 1, 1636430708249, 1636430708521, 272, 0, 272, 0, 0, 0
7035, 1, 1636430708337, 1636430708609, 272, 0, 272, 0, 0, 0
7036, 1, 1636430708389, 1636430708658, 269, 1, 268, 1, 0, 1
7037, 1, 1636430708513, 1636430708786, 273, 1, 272, 0, 1, 1
7038, 1, 1636430708565, 1636430708837, 272, 1, 271, 1, 0, 1
7039, 1, 1636430708721, 1636430708994, 273, 1, 272, 0, 0, 0
7040, 1, 1636430708921, 1636430709197, 276, 1, 275, 0, 0, 0
7041, 1, 1636430709005, 1636430709273, 268, 1, 267, 0, 0, 0
7042, 1, 1636430709061, 1636430709325, 264, 0, 264, 0, 0, 0
7043, 1, 1636430709185, 1636430709473, 288, 0, 288, 0, 0, 0
7044, 1, 1636430709237, 1636430709509, 272, 0, 272, 0, 0, 0
7045, 1, 1636430709413, 1636430709686, 273, 0, 273, 0, 0, 0
7046, 1, 1636430709597, 1636430709873, 276, 1, 275, 0, 0, 0
7047, 1, 1636430709669, 1636430709953, 284, 0, 284, 0, 0, 0
7048, 1, 1636430709725, 1636430709993, 268, 1, 267, 0, 1, 1
7049, 1, 1636430709861, 1636430710125, 264, 0, 264, 0, 0, 0
7050, 1, 1636430709901, 1636430710165, 264, 0, 264, 0, 0, 0
7052, 1, 1636430710081, 1636430710345, 264, 1, 263, 0, 1, 1
7051, 1, 1636430710077, 1636430710345, 268, 0, 268, 0, 0, 0
7055, 1, 1636430710261, 1636430710553, 292, 0, 292, 0, 0, 0
7056, 1, 1636430710365, 1636430710637, 272, 1, 271, 0, 0, 0
7057, 1, 1636430710385, 1636430710657, 272, 1, 271, 0, 1, 1
7053, 1, 1636430710529, 1636430710837, 308, 0, 308, 0, 0, 0
7054, 1, 1636430710529, 1636430710838, 309, 1, 308, 0, 1, 1
7058, 1, 1636430710533, 1636430710841, 308, 0, 308, 0, 0, 0
7060, 1, 1636430710597, 1636430710861, 264, 1, 263, 0, 0, 0
7061, 1, 1636430710701, 1636430710973, 272, 0, 272, 0, 0, 0
7063, 1, 1636430710753, 1636430711030, 277, 1, 276, 1, 0, 1
7062, 1, 1636430710753, 1636430711030, 277, 1, 276, 0, 0, 0
7064, 1, 1636430710941, 1636430711213, 272, 0, 272, 0, 0, 0
7065, 1, 1636430711013, 1636430711290, 277, 1, 276, 0, 1, 1
7067, 1, 1636430711057, 1636430711325, 268, 1, 267, 0, 0, 0
7066, 1, 1636430711049, 1636430711326, 277, 1, 276, 1, 0, 1
7070, 1, 1636430711249, 1636430711509, 260, 0, 260, 0, 0, 0
7071, 1, 1636430711261, 1636430711529, 268, 1, 267, 0, 0, 0
7068, 1, 1636430711253, 1636430711530, 277, 0, 277, 0, 0, 0
7069, 1, 1636430711253, 1636430711530, 277, 0, 277, 0, 0, 0
7072, 1, 1636430711369, 1636430711641, 272, 1, 271, 1, 0, 1
7074, 1, 1636430711421, 1636430711701, 280, 1, 279, 0, 1, 1
7073, 1, 1636430711421, 1636430711701, 280, 1, 279, 1, 0, 1
7076, 1, 1636430711613, 1636430711921, 308, 0, 308, 0, 0, 0
7077, 1, 1636430711705, 1636430712005, 300, 0, 300, 0, 0, 0
7079, 1, 1636430711741, 1636430712009, 268, 1, 267, 0, 0, 0
7078, 1, 1636430711741, 1636430712009, 268, 1, 267, 1, 0, 1
7080, 1, 1636430711913, 1636430712181, 268, 1, 267, 0, 0, 0
7081, 1, 1636430711917, 1636430712181, 264, 0, 264, 0, 0, 0
7083, 1, 1636430711961, 1636430712233, 272, 0, 272, 0, 0, 0
7082, 1, 1636430711957, 1636430712233, 276, 1, 275, 0, 0, 0
7086, 1, 1636430712101, 1636430712401, 300, 1, 299, 0, 1, 1
7087, 1, 1636430712097, 1636430712401, 304, 1, 303, 0, 1, 1
7088, 1, 1636430712221, 1636430712489, 268, 0, 268, 0, 0, 0
6986, 1, 1636430712261, 1636430712533, 272, 0, 272, 0, 0, 0
7089, 1, 1636430712350, 1636430712621, 271, 0, 271, 0, 0, 0
7091, 1, 1636430712445, 1636430712717, 272, 1, 271, 1, 0, 1
7090, 1, 1636430712445, 1636430712717, 272, 1, 271, 0, 0, 0
7092, 1, 1636430712445, 1636430712717, 272, 1, 271, 1, 0, 1
7096, 1, 1636430712621, 1636430712882, 261, 1, 260, 1, 0, 1
7094, 1, 1636430712581, 1636430712882, 301, 0, 301, 0, 0, 0
7095, 1, 1636430712597, 1636430712882, 285, 1, 284, 0, 1, 1
7093, 1, 1636430712565, 1636430712882, 317, 1, 316, 0, 0, 0
7097, 1, 1636430712637, 1636430712906, 269, 1, 268, 0, 1, 1
7098, 1, 1636430712793, 1636430713065, 272, 1, 271, 1, 0, 1
7099, 1, 1636430712793, 1636430713066, 273, 1, 272, 0, 1, 1
7100, 1, 1636430712917, 1636430713185, 268, 0, 268, 0, 0, 0
7102, 1, 1636430713009, 1636430713281, 272, 0, 272, 0, 0, 0
7103, 1, 1636430713049, 1636430713317, 268, 0, 268, 0, 0, 0
7101, 1, 1636430713061, 1636430713333, 272, 1, 271, 0, 0, 0
7105, 1, 1636430713117, 1636430713393, 276, 1, 275, 0, 0, 0
7104, 1, 1636430713121, 1636430713397, 276, 1, 275, 0, 0, 0
7106, 1, 1636430713121, 1636430713405, 284, 1, 283, 0, 0, 0
7107, 1, 1636430713273, 1636430713545, 272, 0, 272, 0, 0, 0
7109, 1, 1636430713285, 1636430713561, 276, 1, 275, 0, 0, 0
7108, 1, 1636430713285, 1636430713565, 280, 1, 279, 1, 0, 1
7110, 1, 1636430713293, 1636430713565, 272, 0, 272, 0, 0, 0
7111, 1, 1636430713301, 1636430713573, 272, 0, 272, 0, 0, 0
7112, 1, 1636430713465, 1636430713741, 276, 1, 275, 0, 0, 0
7113, 1, 1636430713465, 1636430713742, 277, 1, 276, 1, 0, 1
7114, 1, 1636430713589, 1636430713861, 272, 1, 271, 0, 1, 1
7115, 1, 1636430713678, 1636430713945, 267, 0, 267, 0, 0, 0
7116, 1, 1636430713709, 1636430713977, 268, 1, 267, 0, 0, 0
7117, 1, 1636430713745, 1636430714013, 268, 0, 268, 0, 0, 0
7119, 1, 1636430713797, 1636430714069, 272, 1, 271, 1, 0, 1
7118, 1, 1636430713797, 1636430714070, 273, 0, 273, 0, 0, 0
7120, 1, 1636430713797, 1636430714070, 273, 0, 273, 0, 0, 0
7121, 1, 1636430713949, 1636430714217, 268, 1, 267, 0, 0, 0
7125, 1, 1636430713965, 1636430714238, 273, 1, 272, 1, 0, 1
7124, 1, 1636430713965, 1636430714238, 273, 1, 272, 1, 0, 1
7123, 1, 1636430713965, 1636430714238, 273, 1, 272, 0, 1, 1
7126, 1, 1636430714141, 1636430714417, 276, 1, 275, 0, 0, 0
7127, 1, 1636430714141, 1636430714417, 276, 1, 275, 0, 0, 0
7128, 1, 1636430714261, 1636430714537, 276, 1, 275, 0, 0, 0
7129, 1, 1636430714341, 1636430714609, 268, 0, 268, 0, 0, 0
7130, 1, 1636430714381, 1636430714657, 276, 0, 276, 0, 0, 0
7132, 1, 1636430714465, 1636430714738, 273, 1, 272, 1, 0, 1
7133, 1, 1636430714477, 1636430714745, 268, 1, 267, 1, 0, 1
7134, 1, 1636430714477, 1636430714757, 280, 1, 279, 1, 0, 1
7135, 1, 1636430714621, 1636430714881, 260, 1, 259, 0, 1, 1
7136, 1, 1636430714633, 1636430714906, 273, 1, 272, 0, 1, 1
7138, 1, 1636430714641, 1636430714906, 265, 0, 265, 0, 0, 0
7137, 1, 1636430714633, 1636430714909, 276, 1, 275, 1, 0, 1
7139, 1, 1636430714809, 1636430715085, 276, 1, 275, 0, 1, 1
7140, 1, 1636430714817, 1636430715089, 272, 1, 271, 0, 0, 0
7141, 1, 1636430714926, 1636430715209, 283, 0, 283, 0, 0, 0
7142, 1, 1636430715009, 1636430715281, 272, 0, 272, 0, 0, 0
7143, 1, 1636430715053, 1636430715321, 268, 1, 267, 0, 0, 0
7145, 1, 1636430715137, 1636430715409, 272, 1, 271, 0, 0, 0
7144, 1, 1636430715129, 1636430715409, 280, 1, 279, 0, 1, 1
7146, 1, 1636430715153, 1636430715429, 276, 1, 275, 0, 0, 0
7147, 1, 1636430715285, 1636430715562, 277, 0, 277, 0, 0, 0
7150, 1, 1636430715313, 1636430715581, 268, 1, 267, 0, 0, 0
7149, 1, 1636430715313, 1636430715582, 269, 1, 268, 1, 0, 1
7151, 1, 1636430715485, 1636430715761, 276, 1, 275, 0, 0, 0
7152, 1, 1636430715493, 1636430715769, 276, 1, 275, 0, 1, 1
7153, 1, 1636430715618, 1636430715893, 275, 0, 275, 0, 0, 0
7155, 1, 1636430715713, 1636430715981, 268, 1, 267, 0, 0, 0
7154, 1, 1636430715677, 1636430715981, 304, 0, 304, 0, 0, 0
7157, 1, 1636430715806, 1636430716073, 267, 0, 267, 0, 0, 0
7156, 1, 1636430715806, 1636430716073, 267, 0, 267, 0, 0, 0
7158, 1, 1636430715838, 1636430716109, 271, 0, 271, 0, 0, 0
7159, 1, 1636430715957, 1636430716230, 273, 1, 272, 1, 0, 1
7160, 1, 1636430715981, 1636430716257, 276, 1, 275, 0, 0, 0
7161, 1, 1636430716025, 1636430716297, 272, 0, 272, 0, 0, 0
7163, 1, 1636430716161, 1636430716429, 268, 1, 267, 0, 0, 0
7162, 1, 1636430716161, 1636430716429, 268, 1, 267, 1, 0, 1
7165, 1, 1636430716297, 1636430716569, 272, 0, 272, 0, 0, 0
7166, 1, 1636430716373, 1636430716641, 268, 1, 267, 0, 1, 1
7167, 1, 1636430716381, 1636430716653, 272, 1, 271, 0, 0, 0
7168, 1, 1636430716465, 1636430716737, 272, 0, 272, 0, 0, 0
7169, 1, 1636430716473, 1636430716741, 268, 0, 268, 0, 0, 0
7170, 1, 1636430716510, 1636430716785, 275, 0, 275, 0, 0, 0
7171, 1, 1636430716634, 1636430716906, 272, 0, 272, 0, 0, 0
7175, 1, 1636430716829, 1636430717093, 264, 1, 263, 0, 0, 0
7174, 1, 1636430716825, 1636430717093, 268, 1, 267, 0, 1, 1
7176, 1, 1636430716957, 1636430717221, 264, 0, 264, 0, 0, 0
7177, 1, 1636430717037, 1636430717309, 272, 1, 271, 0, 1, 1
7178, 1, 1636430717045, 1636430717325, 280, 0, 280, 0, 0, 0
7180, 1, 1636430717138, 1636430717417, 279, 0, 279, 0, 0, 0
7181, 1, 1636430717185, 1636430717457, 272, 1, 271, 0, 0, 0
7182, 1, 1636430717305, 1636430717574, 269, 0, 269, 0, 0, 0
7183, 1, 1636430717497, 1636430717769, 272, 1, 271, 1, 0, 1
7184, 1, 1636430717501, 1636430717769, 268, 1, 267, 0, 0, 0
7185, 1, 1636430717625, 1636430717901, 276, 1, 275, 0, 1, 1
7187, 1, 1636430717710, 1636430717978, 268, 0, 268, 0, 0, 0
7186, 1, 1636430717710, 1636430717981, 271, 0, 271, 0, 0, 0
7188, 1, 1636430717815, 1636430718089, 274, 0, 274, 0, 0, 0
7189, 1, 1636430717857, 1636430718125, 268, 1, 267, 1, 0, 1
7190, 1, 1636430717974, 1636430718246, 272, 0, 272, 0, 0, 0
7192, 1, 1636430718165, 1636430718433, 268, 1, 267, 1, 0, 1
7191, 1, 1636430718165, 1636430718441, 276, 1, 275, 1, 0, 1
7193, 1, 1636430718297, 1636430718562, 265, 1, 264, 0, 0, 0
7194, 1, 1636430718377, 1636430718649, 272, 1, 271, 0, 1, 1
7195, 1, 1636430718381, 1636430718649, 268, 1, 267, 0, 1, 1
7196, 1, 1636430718477, 1636430718749, 272, 1, 271, 1, 0, 1
7197, 1, 1636430718537, 1636430718810, 273, 0, 273, 0, 0, 0
7198, 1, 1636430718641, 1636430718914, 273, 1, 272, 0, 0, 0
7199, 1, 1636430718829, 1636430719101, 272, 1, 271, 0, 0, 0
7200, 1, 1636430718833, 1636430719105, 272, 0, 272, 0, 0, 0
7201, 1, 1636430718961, 1636430719238, 277, 1, 276, 0, 1, 1
7203, 1, 1636430719050, 1636430719321, 271, 0, 271, 0, 0, 0
7204, 1, 1636430719149, 1636430719421, 272, 0, 272, 0, 0, 0
7205, 1, 1636430719205, 1636430719478, 273, 1, 272, 0, 1, 1
7206, 1, 1636430719305, 1636430719578, 273, 0, 273, 0, 0, 0
7208, 1, 1636430719509, 1636430719782, 273, 0, 273, 0, 0, 0
7209, 1, 1636430719633, 1636430719902, 269, 0, 269, 0, 0, 0
7210, 1, 1636430719721, 1636430719993, 272, 1, 271, 0, 1, 1
7211, 1, 1636430719813, 1636430720085, 272, 0, 272, 0, 0, 0
7212, 1, 1636430719877, 1636430720150, 273, 0, 273, 0, 0, 0
7213, 1, 1636430719986, 1636430720257, 271, 0, 271, 0, 0, 0
7214, 1, 1636430720177, 1636430720453, 276, 0, 276, 0, 0, 0
7215, 1, 1636430720302, 1636430720570, 268, 0, 268, 0, 0, 0
7216, 1, 1636430720390, 1636430720661, 271, 0, 271, 0, 0, 0
7217, 1, 1636430720493, 1636430720765, 272, 1, 271, 0, 1, 1
7218, 1, 1636430720545, 1636430720817, 272, 1, 271, 0, 0, 0
7219, 1, 1636430720677, 1636430720958, 281, 1, 280, 0, 0, 0
7220, 1, 1636430720853, 1636430721121, 268, 1, 267, 0, 0, 0
7221, 1, 1636430720970, 1636430721242, 272, 0, 272, 0, 0, 0
7222, 1, 1636430721069, 1636430721341, 272, 1, 271, 0, 0, 0
7223, 1, 1636430721169, 1636430721437, 268, 0, 268, 0, 0, 0
7225, 1, 1636430721357, 1636430721630, 273, 1, 272, 0, 1, 1
7084, 1, 1636430721457, 1636430721726, 269, 0, 269, 0, 0, 0
7226, 1, 1636430721549, 1636430721817, 268, 1, 267, 0, 0, 0
7224, 1, 1636430721613, 1636430721885, 272, 1, 271, 1, 0, 1
7227, 1, 1636430721630, 1636430721893, 263, 0, 263, 0, 0, 0
7228, 1, 1636430721737, 1636430722005, 268, 0, 268, 0, 0, 0
7231, 1, 1636430721829, 1636430722093, 264, 0, 264, 0, 0, 0
7229, 1, 1636430721782, 1636430722093, 311, 0, 311, 0, 0, 0
7232, 1, 1636430722025, 1636430722298, 273, 1, 272, 1, 0, 1
7234, 1, 1636430722225, 1636430722494, 269, 0, 269, 0, 0, 0
7235, 1, 1636430722277, 1636430722553, 276, 1, 275, 0, 1, 1
7237, 1, 1636430722350, 1636430722621, 271, 0, 271, 0, 0, 0
7238, 1, 1636430722405, 1636430722677, 272, 1, 271, 0, 0, 0
7236, 1, 1636430722477, 1636430722749, 272, 0, 272, 0, 0, 0
7239, 1, 1636430722493, 1636430722761, 268, 1, 267, 0, 0, 0
7240, 1, 1636430722497, 1636430722769, 272, 0, 272, 0, 0, 0
7241, 1, 1636430722698, 1636430722969, 271, 0, 271, 0, 0, 0
7242, 1, 1636430722893, 1636430723165, 272, 0, 272, 0, 0, 0
7243, 1, 1636430722958, 1636430723230, 272, 0, 272, 0, 0, 0
7245, 1, 1636430723077, 1636430723353, 276, 1, 275, 0, 0, 0
7246, 1, 1636430723146, 1636430723417, 271, 0, 271, 0, 0, 0
7247, 1, 1636430723162, 1636430723433, 271, 0, 271, 0, 0, 0
7249, 1, 1636430723357, 1636430723621, 264, 1, 263, 0, 0, 0
7244, 1, 1636430723401, 1636430723666, 265, 1, 264, 0, 0, 0
7248, 1, 1636430723533, 1636430723801, 268, 0, 268, 0, 0, 0
7251, 1, 1636430723621, 1636430723897, 276, 1, 275, 0, 0, 0
7252, 1, 1636430723754, 1636430724025, 271, 0, 271, 0, 0, 0
7253, 1, 1636430723817, 1636430724097, 280, 0, 280, 0, 0, 0
7254, 1, 1636430723830, 1636430724105, 275, 0, 275, 0, 0, 0
7250, 1, 1636430723981, 1636430724262, 281, 1, 280, 0, 0, 0
7256, 1, 1636430724061, 1636430724333, 272, 1, 271, 0, 0, 0
7257, 1, 1636430724201, 1636430724473, 272, 0, 272, 0, 0, 0
7258, 1, 1636430724269, 1636430724549, 280, 1, 279, 1, 0, 1
7260, 1, 1636430724461, 1636430724725, 264, 1, 263, 0, 0, 0
7261, 1, 1636430724498, 1636430724770, 272, 0, 272, 0, 0, 0
7262, 1, 1636430724498, 1636430724777, 279, 0, 279, 0, 0, 0
7263, 1, 1636430724658, 1636430724930, 272, 0, 272, 0, 0, 0
7264, 1, 1636430724725, 1636430724993, 268, 1, 267, 1, 0, 1
7265, 1, 1636430724725, 1636430724994, 269, 1, 268, 0, 0, 0
7266, 1, 1636430724869, 1636430725142, 273, 0, 273, 0, 0, 0
7267, 1, 1636430724945, 1636430725221, 276, 1, 275, 0, 0, 0
7268, 1, 1636430725121, 1636430725393, 272, 0, 272, 0, 0, 0
7269, 1, 1636430725165, 1636430725441, 276, 1, 275, 1, 0, 1
7270, 1, 1636430725169, 1636430725441, 272, 0, 272, 0, 0, 0
7271, 1, 1636430725349, 1636430725617, 268, 0, 268, 0, 0, 0
7272, 1, 1636430725393, 1636430725661, 268, 1, 267, 0, 0, 0
7273, 1, 1636430725393, 1636430725669, 276, 1, 275, 0, 0, 0
7274, 1, 1636430725541, 1636430725813, 272, 0, 272, 0, 0, 0
7276, 1, 1636430725613, 1636430725885, 272, 1, 271, 1, 0, 1
7275, 1, 1636430725613, 1636430725893, 280, 1, 279, 1, 0, 1
7277, 1, 1636430725790, 1636430726058, 268, 0, 268, 0, 0, 0
7279, 1, 1636430725837, 1636430726113, 276, 0, 276, 0, 0, 0
7280, 1, 1636430726014, 1636430726301, 287, 0, 287, 0, 0, 0
7281, 1, 1636430726058, 1636430726329, 271, 0, 271, 0, 0, 0
7282, 1, 1636430726066, 1636430726333, 267, 0, 267, 0, 0, 0
7179, 1, 1636430726161, 1636430726433, 272, 1, 271, 0, 0, 0
7283, 1, 1636430726205, 1636430726473, 268, 1, 267, 0, 0, 0
7284, 1, 1636430726281, 1636430726546, 265, 1, 264, 0, 0, 0
7285, 1, 1636430726285, 1636430726553, 268, 0, 268, 0, 0, 0
7286, 1, 1636430726457, 1636430726757, 300, 0, 300, 0, 0, 0
7287, 1, 1636430726473, 1636430726758, 285, 1, 284, 0, 0, 0
7288, 1, 1636430726505, 1636430726849, 344, 0, 344, 0, 0, 0
7289, 1, 1636430726757, 1636430727033, 276, 1, 275, 0, 0, 0
7291, 1, 1636430726757, 1636430727033, 276, 1, 275, 0, 0, 0
7290, 1, 1636430726757, 1636430727033, 276, 1, 275, 0, 0, 0
7293, 1, 1636430726889, 1636430727165, 276, 1, 275, 0, 0, 0
7292, 1, 1636430726937, 1636430727205, 268, 0, 268, 0, 0, 0
7294, 1, 1636430726945, 1636430727209, 264, 1, 263, 0, 1, 1
7295, 1, 1636430726949, 1636430727230, 281, 0, 281, 0, 0, 0
7297, 1, 1636430727158, 1636430727430, 272, 0, 272, 0, 0, 0
7296, 1, 1636430727158, 1636430727433, 275, 0, 275, 0, 0, 0
7299, 1, 1636430727225, 1636430727498, 273, 1, 272, 0, 0, 0
7300, 1, 1636430727242, 1636430727506, 264, 0, 264, 0, 0, 0
7301, 1, 1636430727417, 1636430727681, 264, 0, 264, 0, 0, 0
7302, 1, 1636430727421, 1636430727694, 273, 0, 273, 0, 0, 0
7303, 1, 1636430727429, 1636430727705, 276, 1, 275, 0, 0, 0
7304, 1, 1636430727561, 1636430727829, 268, 1, 267, 0, 0, 0
7307, 1, 1636430727630, 1636430727901, 271, 0, 271, 0, 0, 0
7308, 1, 1636430727825, 1636430728097, 272, 0, 272, 0, 0, 0
7306, 1, 1636430727865, 1636430728137, 272, 0, 272, 0, 0, 0
7310, 1, 1636430727901, 1636430728170, 269, 0, 269, 0, 0, 0
7311, 1, 1636430727905, 1636430728170, 265, 0, 265, 0, 0, 0
7313, 1, 1636430728097, 1636430728369, 272, 1, 271, 0, 0, 0
7314, 1, 1636430728105, 1636430728385, 280, 0, 280, 0, 0, 0
7315, 1, 1636430728241, 1636430728514, 273, 1, 272, 1, 0, 1
7316, 1, 1636430728293, 1636430728566, 273, 0, 273, 0, 0, 0
7312, 1, 1636430728313, 1636430728585, 272, 1, 271, 0, 0, 0
7317, 1, 1636430728497, 1636430728765, 268, 0, 268, 0, 0, 0
7318, 1, 1636430728553, 1636430728826, 273, 0, 273, 0, 0, 0
7319, 1, 1636430728573, 1636430728845, 272, 1, 271, 0, 0, 0
7321, 1, 1636430728765, 1636430729037, 272, 1, 271, 0, 0, 0
7322, 1, 1636430728781, 1636430729093, 312, 1, 311, 1, 0, 1
7324, 1, 1636430728958, 1636430729234, 276, 0, 276, 0, 0, 0
7325, 1, 1636430729005, 1636430729277, 272, 1, 271, 0, 0, 0
7326, 1, 1636430729166, 1636430729438, 272, 0, 272, 0, 0, 0
7328, 1, 1636430729233, 1636430729549, 316, 1, 315, 0, 0, 0
7327, 1, 1636430729225, 1636430729549, 324, 1, 323, 0, 1, 1
7329, 1, 1636430729354, 1636430729637, 283, 0, 283, 0, 0, 0
7330, 1, 1636430729461, 1636430729729, 268, 1, 267, 0, 1, 1
7331, 1, 1636430729490, 1636430729766, 276, 0, 276, 0, 0, 0
7333, 1, 1636430729673, 1636430729945, 272, 1, 271, 0, 0, 0
7332, 1, 1636430729729, 1636430729989, 260, 1, 259, 0, 0, 0
7334, 1, 1636430729809, 1636430730081, 272, 1, 271, 1, 0, 1
7335, 1, 1636430729842, 1636430730117, 275, 0, 275, 0, 0, 0
7337, 1, 1636430729941, 1636430730210, 269, 1, 268, 0, 0, 0
7336, 1, 1636430729941, 1636430730210, 269, 1, 268, 0, 0, 0
7338, 1, 1636430730029, 1636430730301, 272, 1, 271, 0, 0, 0
7339, 1, 1636430730121, 1636430730393, 272, 0, 272, 0, 0, 0
7340, 1, 1636430730162, 1636430730430, 268, 0, 268, 0, 0, 0
7342, 1, 1636430730389, 1636430730665, 276, 0, 276, 0, 0, 0
7343, 1, 1636430730481, 1636430730758, 277, 0, 277, 0, 0, 0
7344, 1, 1636430730517, 1636430730789, 272, 0, 272, 0, 0, 0
7341, 1, 1636430730609, 1636430730881, 272, 1, 271, 0, 1, 1
7346, 1, 1636430730621, 1636430730893, 272, 1, 271, 1, 0, 1
7345, 1, 1636430730621, 1636430730897, 276, 1, 275, 1, 0, 1
7347, 1, 1636430730697, 1636430730962, 265, 1, 264, 0, 0, 0
7348, 1, 1636430730789, 1636430731049, 260, 0, 260, 0, 0, 0
7349, 1, 1636430730830, 1636430731093, 263, 0, 263, 0, 0, 0
7350, 1, 1636430731074, 1636430731345, 271, 0, 271, 0, 0, 0
7351, 1, 1636430731153, 1636430731425, 272, 1, 271, 0, 1, 1
7352, 1, 1636430731182, 1636430731461, 279, 0, 279, 0, 0, 0
7353, 1, 1636430731273, 1636430731545, 272, 1, 271, 0, 0, 0
7354, 1, 1636430731298, 1636430731565, 267, 0, 267, 0, 0, 0
7355, 1, 1636430731301, 1636430731577, 276, 0, 276, 0, 0, 0
7356, 1, 1636430731369, 1636430731641, 272, 0, 272, 0, 0, 0
7357, 1, 1636430731453, 1636430731717, 264, 1, 263, 0, 1, 1
7358, 1, 1636430731493, 1636430731761, 268, 1, 267, 0, 0, 0
7359, 1, 1636430731749, 1636430732021, 272, 1, 271, 0, 0, 0
7233, 1, 1636430731781, 1636430732053, 272, 1, 271, 0, 0, 0
7360, 1, 1636430731833, 1636430732105, 272, 0, 272, 0, 0, 0
7361, 1, 1636430731869, 1636430732137, 268, 0, 268, 0, 0, 0
7362, 1, 1636430731957, 1636430732225, 268, 0, 268, 0, 0, 0
7363, 1, 1636430731965, 1636430732229, 264, 1, 263, 0, 0, 0
7364, 1, 1636430731973, 1636430732241, 268, 1, 267, 0, 0, 0
7365, 1, 1636430732037, 1636430732305, 268, 0, 268, 0, 0, 0
7366, 1, 1636430732117, 1636430732386, 269, 0, 269, 0, 0, 0
7367, 1, 1636430732162, 1636430732429, 267, 0, 267, 0, 0, 0
7368, 1, 1636430732413, 1636430732673, 260, 0, 260, 0, 0, 0
7369, 1, 1636430732453, 1636430732713, 260, 0, 260, 0, 0, 0
7370, 1, 1636430732497, 1636430732765, 268, 1, 267, 1, 0, 1
7371, 1, 1636430732533, 1636430732801, 268, 0, 268, 0, 0, 0
7374, 1, 1636430732629, 1636430732893, 264, 0, 264, 0, 0, 0
7373, 1, 1636430732617, 1636430732894, 277, 0, 277, 0, 0, 0
7375, 1, 1636430732645, 1636430732913, 268, 0, 268, 0, 0, 0
7376, 1, 1636430732706, 1636430732978, 272, 0, 272, 0, 0, 0
7377, 1, 1636430732790, 1636430733058, 268, 0, 268, 0, 0, 0
7372, 1, 1636430732893, 1636430733161, 268, 1, 267, 0, 1, 1
7379, 1, 1636430733077, 1636430733341, 264, 0, 264, 0, 0, 0
7380, 1, 1636430733109, 1636430733381, 272, 0, 272, 0, 0, 0
7381, 1, 1636430733161, 1636430733433, 272, 1, 271, 0, 0, 0
7382, 1, 1636430733198, 1636430733469, 271, 0, 271, 0, 0, 0
7383, 1, 1636430733289, 1636430733557, 268, 1, 267, 1, 0, 1
7384, 1, 1636430733301, 1636430733569, 268, 0, 268, 0, 0, 0
7386, 1, 1636430733373, 1636430733642, 269, 0, 269, 0, 0, 0
7387, 1, 1636430733453, 1636430733726, 273, 1, 272, 0, 1, 1
7388, 1, 1636430733553, 1636430733825, 272, 0, 272, 0, 0, 0
7389, 1, 1636430733749, 1636430734026, 277, 1, 276, 0, 0, 0
7390, 1, 1636430733785, 1636430734101, 316, 0, 316, 0, 0, 0
7391, 1, 1636430733837, 1636430734105, 268, 1, 267, 0, 1, 1
7392, 1, 1636430733865, 1636430734137, 272, 1, 271, 0, 1, 1
7393, 1, 1636430733953, 1636430734226, 273, 1, 272, 1, 0, 1
7394, 1, 1636430733965, 1636430734229, 264, 1, 263, 1, 0, 1
7396, 1, 1636430734141, 1636430734433, 292, 0, 292, 0, 0, 0
7397, 1, 1636430734285, 1636430734561, 276, 1, 275, 0, 0, 0
7398, 1, 1636430734385, 1636430734657, 272, 0, 272, 0, 0, 0
7399, 1, 1636430734417, 1636430734685, 268, 0, 268, 0, 0, 0
7400, 1, 1636430734501, 1636430734773, 272, 1, 271, 0, 0, 0
7401, 1, 1636430734505, 1636430734777, 272, 0, 272, 0, 0, 0
7402, 1, 1636430734537, 1636430734806, 269, 1, 268, 0, 0, 0
7404, 1, 1636430734621, 1636430734889, 268, 1, 267, 0, 0, 0
7405, 1, 1636430734637, 1636430734914, 277, 1, 276, 0, 0, 0
7406, 1, 1636430734825, 1636430735097, 272, 1, 271, 0, 1, 1
7407, 1, 1636430734953, 1636430735221, 268, 1, 267, 0, 0, 0
7408, 1, 1636430735049, 1636430735313, 264, 0, 264, 0, 0, 0
7409, 1, 1636430735085, 1636430735357, 272, 1, 271, 0, 1, 1
7410, 1, 1636430735177, 1636430735449, 272, 1, 271, 0, 0, 0
7411, 1, 1636430735177, 1636430735450, 273, 1, 272, 0, 0, 0
7412, 1, 1636430735205, 1636430735473, 268, 0, 268, 0, 0, 0
7413, 1, 1636430735289, 1636430735553, 264, 1, 263, 0, 0, 0
7415, 1, 1636430735493, 1636430735761, 268, 1, 267, 0, 0, 0
7416, 1, 1636430735629, 1636430735902, 273, 1, 272, 0, 0, 0
7417, 1, 1636430735721, 1636430735997, 276, 0, 276, 0, 0, 0
7418, 1, 1636430735797, 1636430736069, 272, 0, 272, 0, 0, 0
7419, 1, 1636430735885, 1636430736157, 272, 0, 272, 0, 0, 0
7421, 1, 1636430735893, 1636430736161, 268, 1, 267, 0, 0, 0
7422, 1, 1636430735949, 1636430736217, 268, 0, 268, 0, 0, 0
7423, 1, 1636430736153, 1636430736421, 268, 1, 267, 0, 0, 0
7425, 1, 1636430736333, 1636430736601, 268, 0, 268, 0, 0, 0
7426, 1, 1636430736393, 1636430736666, 273, 1, 272, 0, 0, 0
7427, 1, 1636430736466, 1636430736737, 271, 0, 271, 0, 0, 0
7428, 1, 1636430736565, 1636430736837, 272, 1, 271, 0, 0, 0
7429, 1, 1636430736565, 1636430736846, 281, 1, 280, 0, 0, 0
7430, 1, 1636430736625, 1636430736893, 268, 0, 268, 0, 0, 0
7431, 1, 1636430736813, 1636430737086, 273, 1, 272, 0, 1, 1
7432, 1, 1636430737026, 1636430737301, 275, 0, 275, 0, 0, 0
7433, 1, 1636430737066, 1636430737369, 303, 0, 303, 0, 0, 0
7435, 1, 1636430737282, 1636430737554, 272, 0, 272, 0, 0, 0
7436, 1, 1636430737282, 1636430737554, 272, 0, 272, 0, 0, 0
7437, 1, 1636430737321, 1636430737589, 268, 1, 267, 0, 1, 1
7438, 1, 1636430737490, 1636430737761, 271, 0, 271, 0, 0, 0
7439, 1, 1636430737738, 1636430738010, 272, 0, 272, 0, 0, 0
7440, 1, 1636430737793, 1636430738065, 272, 0, 272, 0, 0, 0
7441, 1, 1636430737917, 1636430738189, 272, 0, 272, 0, 0, 0
7442, 1, 1636430737921, 1636430738190, 269, 0, 269, 0, 0, 0
7443, 1, 1636430737945, 1636430738217, 272, 1, 271, 0, 1, 1
7444, 1, 1636430737954, 1636430738221, 267, 0, 267, 0, 0, 0
7445, 1, 1636430738009, 1636430738281, 272, 1, 271, 0, 0, 0
7446, 1, 1636430738133, 1636430738405, 272, 0, 272, 0, 0, 0
7447, 1, 1636430738169, 1636430738441, 272, 1, 271, 0, 0, 0
7448, 1, 1636430738401, 1636430738709, 308, 0, 308, 0, 0, 0
7449, 1, 1636430738461, 1636430738733, 272, 1, 271, 0, 0, 0
7451, 1, 1636430738621, 1636430738889, 268, 1, 267, 0, 0, 0
7450, 1, 1636430738617, 1636430738890, 273, 1, 272, 0, 1, 1
7453, 1, 1636430738621, 1636430738889, 268, 0, 268, 0, 0, 0
7454, 1, 1636430738673, 1636430738961, 288, 0, 288, 0, 0, 0
7455, 1, 1636430738801, 1636430739074, 273, 1, 272, 0, 1, 1
7457, 1, 1636430738877, 1636430739141, 264, 1, 263, 0, 0, 0
7456, 1, 1636430738873, 1636430739141, 268, 0, 268, 0, 0, 0
7459, 1, 1636430739133, 1636430739405, 272, 1, 271, 0, 0, 0
7460, 1, 1636430739217, 1636430739489, 272, 0, 272, 0, 0, 0
7463, 1, 1636430739290, 1636430739557, 267, 0, 267, 0, 0, 0
7462, 1, 1636430739290, 1636430739557, 267, 0, 267, 0, 0, 0
7461, 1, 1636430739290, 1636430739561, 271, 0, 271, 0, 0, 0
7464, 1, 1636430739349, 1636430739621, 272, 1, 271, 0, 1, 1
7465, 1, 1636430739465, 1636430739737, 272, 0, 272, 0, 0, 0
7466, 1, 1636430739533, 1636430739801, 268, 1, 267, 0, 1, 1
7467, 1, 1636430739533, 1636430739810, 277, 1, 276, 1, 0, 1
7468, 1, 1636430739801, 1636430740069, 268, 1, 267, 0, 0, 0
7469, 1, 1636430739885, 1636430740157, 272, 0, 272, 0, 0, 0
7470, 1, 1636430739957, 1636430740225, 268, 1, 267, 1, 0, 1
7472, 1, 1636430739957, 1636430740229, 272, 1, 271, 1, 0, 1
7471, 1, 1636430739957, 1636430740229, 272, 1, 271, 0, 0, 0
7473, 1, 1636430740017, 1636430740285, 268, 0, 268, 0, 0, 0
7474, 1, 1636430740137, 1636430740409, 272, 0, 272, 0, 0, 0
7475, 1, 1636430740214, 1636430740486, 272, 0, 272, 0, 0, 0
7476, 1, 1636430740214, 1636430740486, 272, 0, 272, 0, 0, 0
7477, 1, 1636430740469, 1636430740741, 272, 1, 271, 0, 1, 1
7478, 1, 1636430740553, 1636430740825, 272, 1, 271, 0, 1, 1
7480, 1, 1636430740629, 1636430740901, 272, 0, 272, 0, 0, 0
7479, 1, 1636430740633, 1636430740905, 272, 1, 271, 1, 0, 1
7481, 1, 1636430740633, 1636430740909, 276, 1, 275, 0, 1, 1
7482, 1, 1636430740681, 1636430740950, 269, 0, 269, 0, 0, 0
7483, 1, 1636430740813, 1636430741082, 269, 1, 268, 0, 0, 0
7484, 1, 1636430740881, 1636430741154, 273, 1, 272, 1, 0, 1
7485, 1, 1636430740881, 1636430741154, 273, 1, 272, 0, 1, 1
7486, 1, 1636430741133, 1636430741401, 268, 0, 268, 0, 0, 0
7487, 1, 1636430741218, 1636430741489, 271, 0, 271, 0, 0, 0
7488, 1, 1636430741293, 1636430741569, 276, 1, 275, 0, 0, 0
7489, 1, 1636430741301, 1636430741569, 268, 1, 267, 1, 0, 1
7490, 1, 1636430741309, 1636430741581, 272, 0, 272, 0, 0, 0
7491, 1, 1636430741349, 1636430741617, 268, 0, 268, 0, 0, 0
7492, 1, 1636430741481, 1636430741753, 272, 0, 272, 0, 0, 0
7493, 1, 1636430741549, 1636430741822, 273, 0, 273, 0, 0, 0
7494, 1, 1636430741557, 1636430741829, 272, 0, 272, 0, 0, 0
7495, 1, 1636430741801, 1636430742069, 268, 1, 267, 0, 1, 1
7496, 1, 1636430741889, 1636430742149, 260, 0, 260, 0, 0, 0
7498, 1, 1636430741970, 1636430742241, 271, 0, 271, 0, 0, 0
7497, 1, 1636430741970, 1636430742241, 271, 0, 271, 0, 0, 0
7499, 1, 1636430741977, 1636430742241, 264, 0, 264, 0, 0, 0
7500, 1, 1636430742017, 1636430742289, 272, 0, 272, 0, 0, 0
7501, 1, 1636430742153, 1636430742425, 272, 0, 272, 0, 0, 0
7503, 1, 1636430742222, 1636430742494, 272, 0, 272, 0, 0, 0
7502, 1, 1636430742226, 1636430742497, 271, 0, 271, 0, 0, 0
7504, 1, 1636430742465, 1636430742733, 268, 1, 267, 0, 1, 1
7505, 1, 1636430742601, 1636430742877, 276, 0, 276, 0, 0, 0
7506, 1, 1636430742641, 1636430742913, 272, 0, 272, 0, 0, 0
7508, 1, 1636430742649, 1636430742969, 320, 0, 320, 0, 0, 0
7509, 1, 1636430742678, 1636430742969, 291, 0, 291, 0, 0, 0
7510, 1, 1636430742818, 1636430743089, 271, 0, 271, 0, 0, 0
7512, 1, 1636430742917, 1636430743185, 268, 0, 268, 0, 0, 0
7511, 1, 1636430742921, 1636430743193, 272, 0, 272, 0, 0, 0
7514, 1, 1636430743133, 1636430743441, 308, 0, 308, 0, 0, 0
7513, 1, 1636430743133, 1636430743453, 320, 0, 320, 0, 0, 0
7515, 1, 1636430743273, 1636430743545, 272, 0, 272, 0, 0, 0
7516, 1, 1636430743305, 1636430743586, 281, 0, 281, 0, 0, 0
7518, 1, 1636430743393, 1636430743665, 272, 1, 271, 0, 0, 0
7517, 1, 1636430743393, 1636430743669, 276, 1, 275, 0, 0, 0
7519, 1, 1636430743486, 1636430743753, 267, 0, 267, 0, 0, 0
7520, 1, 1636430743573, 1636430743845, 272, 0, 272, 0, 0, 0
7521, 1, 1636430743593, 1636430743865, 272, 0, 272, 0, 0, 0
7522, 1, 1636430743613, 1636430743885, 272, 1, 271, 0, 0, 0
7523, 1, 1636430743837, 1636430744109, 272, 1, 271, 0, 0, 0
7524, 1, 1636430743845, 1636430744117, 272, 0, 272, 0, 0, 0
7526, 1, 1636430744001, 1636430744274, 273, 0, 273, 0, 0, 0
7527, 1, 1636430744085, 1636430744361, 276, 1, 275, 1, 0, 1
7528, 1, 1636430744085, 1636430744361, 276, 1, 275, 0, 0, 0
7529, 1, 1636430744149, 1636430744417, 268, 1, 267, 0, 1, 1
7530, 1, 1636430744250, 1636430744521, 271, 0, 271, 0, 0, 0
7531, 1, 1636430744266, 1636430744538, 272, 0, 272, 0, 0, 0
7533, 1, 1636430744341, 1636430744649, 308, 0, 308, 0, 0, 0
7534, 1, 1636430744505, 1636430744777, 272, 1, 271, 0, 0, 0
7535, 1, 1636430744561, 1636430744833, 272, 0, 272, 0, 0, 0
7536, 1, 1636430744689, 1636430744961, 272, 1, 271, 0, 1, 1
7537, 1, 1636430744781, 1636430745053, 272, 0, 272, 0, 0, 0
7538, 1, 1636430744785, 1636430745054, 269, 0, 269, 0, 0, 0
7539, 1, 1636430744817, 1636430745089, 272, 0, 272, 0, 0, 0
7540, 1, 1636430744905, 1636430745177, 272, 1, 271, 0, 1, 1
7541, 1, 1636430744909, 1636430745177, 268, 1, 267, 0, 0, 0
7542, 1, 1636430744942, 1636430745213, 271, 0, 271, 0, 0, 0
7544, 1, 1636430745173, 1636430745457, 284, 0, 284, 0, 0, 0
7545, 1, 1636430745273, 1636430745549, 276, 0, 276, 0, 0, 0
7546, 1, 1636430745357, 1636430745629, 272, 1, 271, 0, 1, 1
7547, 1, 1636430745485, 1636430745753, 268, 0, 268, 0, 0, 0
7548, 1, 1636430745497, 1636430745773, 276, 1, 275, 0, 0, 0
7549, 1, 1636430745497, 1636430745774, 277, 0, 277, 0, 0, 0
7551, 1, 1636430745573, 1636430745849, 276, 1, 275, 1, 0, 1
7550, 1, 1636430745573, 1636430745853, 280, 1, 279, 0, 1, 1
7553, 1, 1636430745609, 1636430745881, 272, 1, 271, 1, 0, 1
7552, 1, 1636430745609, 1636430745933, 324, 1, 323, 0, 0, 0
7555, 1, 1636430745973, 1636430746249, 276, 1, 275, 0, 1, 1
7556, 1, 1636430746065, 1636430746333, 268, 0, 268, 0, 0, 0
7557, 1, 1636430746154, 1636430746426, 272, 0, 272, 0, 0, 0
7560, 1, 1636430746209, 1636430746482, 273, 1, 272, 0, 1, 1
7559, 1, 1636430746209, 1636430746482, 273, 1, 272, 0, 1, 1
7558, 1, 1636430746209, 1636430746482, 273, 0, 273, 0, 0, 0
7561, 1, 1636430746245, 1636430746513, 268, 0, 268, 0, 0, 0
7562, 1, 1636430746249, 1636430746526, 277, 0, 277, 0, 0, 0
7563, 1, 1636430746282, 1636430746554, 272, 0, 272, 0, 0, 0
7564, 1, 1636430746337, 1636430746609, 272, 0, 272, 0, 0, 0
7565, 1, 1636430746465, 1636430746741, 276, 0, 276, 0, 0, 0
7566, 1, 1636430746649, 1636430746917, 268, 1, 267, 0, 1, 1
7567, 1, 1636430746733, 1636430746997, 264, 0, 264, 0, 0, 0
7568, 1, 1636430746821, 1636430747089, 268, 1, 267, 0, 1, 1
7571, 1, 1636430746885, 1636430747177, 292, 0, 292, 0, 0, 0
7572, 1, 1636430746909, 1636430747181, 272, 0, 272, 0, 0, 0
7573, 1, 1636430746917, 1636430747185, 268, 1, 267, 0, 0, 0
7569, 1, 1636430746873, 1636430747189, 316, 0, 316, 0, 0, 0
7574, 1, 1636430746950, 1636430747217, 267, 0, 267, 0, 0, 0
7575, 1, 1636430746997, 1636430747277, 280, 1, 279, 0, 0, 0
7576, 1, 1636430747126, 1636430747401, 275, 0, 275, 0, 0, 0
7577, 1, 1636430747313, 1636430747585, 272, 1, 271, 0, 0, 0
7578, 1, 1636430747397, 1636430747661, 264, 1, 263, 0, 1, 1
7579, 1, 1636430747441, 1636430747705, 264, 0, 264, 0, 0, 0
7580, 1, 1636430747485, 1636430747753, 268, 1, 267, 0, 0, 0
7581, 1, 1636430747570, 1636430747837, 267, 0, 267, 0, 0, 0
7582, 1, 1636430747573, 1636430747845, 272, 0, 272, 0, 0, 0
7583, 1, 1636430747577, 1636430747853, 276, 0, 276, 0, 0, 0
7584, 1, 1636430747581, 1636430747857, 276, 0, 276, 0, 0, 0
7585, 1, 1636430747613, 1636430747882, 269, 1, 268, 0, 0, 0
7586, 1, 1636430747665, 1636430747937, 272, 0, 272, 0, 0, 0
7587, 1, 1636430747797, 1636430748065, 268, 1, 267, 0, 0, 0
7588, 1, 1636430747977, 1636430748245, 268, 0, 268, 0, 0, 0
7589, 1, 1636430748065, 1636430748337, 272, 1, 271, 0, 1, 1
7590, 1, 1636430748098, 1636430748370, 272, 0, 272, 0, 0, 0
7592, 1, 1636430748233, 1636430748506, 273, 0, 273, 0, 0, 0
7594, 1, 1636430748249, 1636430748513, 264, 0, 264, 0, 0, 0
7593, 1, 1636430748249, 1636430748521, 272, 0, 272, 0, 0, 0
7595, 1, 1636430748265, 1636430748533, 268, 0, 268, 0, 0, 0
7596, 1, 1636430748281, 1636430748550, 269, 0, 269, 0, 0, 0
7597, 1, 1636430748341, 1636430748609, 268, 0, 268, 0, 0, 0
7598, 1, 1636430748461, 1636430748761, 300, 0, 300, 0, 0, 0
7591, 1, 1636430748521, 1636430748793, 272, 1, 271, 0, 0, 0
7599, 1, 1636430748669, 1636430748945, 276, 1, 275, 0, 1, 1
7600, 1, 1636430748733, 1636430748993, 260, 1, 259, 0, 0, 0
7601, 1, 1636430748801, 1636430749078, 277, 0, 277, 0, 0, 0
7602, 1, 1636430748897, 1636430749169, 272, 0, 272, 0, 0, 0
7603, 1, 1636430748913, 1636430749181, 268, 1, 267, 0, 0, 0
7605, 1, 1636430748930, 1636430749245, 315, 0, 315, 0, 0, 0
7606, 1, 1636430748930, 1636430749245, 315, 0, 315, 0, 0, 0
7607, 1, 1636430748941, 1636430749245, 304, 0, 304, 0, 0, 0
7525, 1, 1636430749109, 1636430749385, 276, 1, 275, 0, 0, 0
7610, 1, 1636430749197, 1636430749469, 272, 1, 271, 0, 0, 0
7609, 1, 1636430749197, 1636430749469, 272, 1, 271, 0, 0, 0
7611, 1, 1636430749337, 1636430749605, 268, 0, 268, 0, 0, 0
7608, 1, 1636430749353, 1636430749629, 276, 0, 276, 0, 0, 0
7612, 1, 1636430749393, 1636430749665, 272, 1, 271, 0, 1, 1
7613, 1, 1636430749425, 1636430749689, 264, 0, 264, 0, 0, 0
7614, 1, 1636430749465, 1636430749733, 268, 0, 268, 0, 0, 0
7615, 1, 1636430749581, 1636430749846, 265, 0, 265, 0, 0, 0
7616, 1, 1636430749577, 1636430749846, 269, 1, 268, 0, 0, 0
7618, 1, 1636430749641, 1636430749913, 272, 0, 272, 0, 0, 0
7617, 1, 1636430749637, 1636430749913, 276, 0, 276, 0, 0, 0
7619, 1, 1636430749649, 1636430749929, 280, 0, 280, 0, 0, 0
7620, 1, 1636430749781, 1636430750057, 276, 0, 276, 0, 0, 0
7621, 1, 1636430749865, 1636430750138, 273, 0, 273, 0, 0, 0
7622, 1, 1636430749873, 1636430750145, 272, 0, 272, 0, 0, 0
7623, 1, 1636430750017, 1636430750285, 268, 0, 268, 0, 0, 0
7624, 1, 1636430750025, 1636430750297, 272, 0, 272, 0, 0, 0
7625, 1, 1636430750061, 1636430750330, 269, 1, 268, 0, 0, 0
7626, 1, 1636430750093, 1636430750357, 264, 0, 264, 0, 0, 0
7627, 1, 1636430750137, 1636430750401, 264, 1, 263, 1, 0, 1
7629, 1, 1636430750245, 1636430750517, 272, 1, 271, 1, 0, 1
7628, 1, 1636430750245, 1636430750517, 272, 1, 271, 1, 0, 1
7631, 1, 1636430750310, 1636430750581, 271, 0, 271, 0, 0, 0
7630, 1, 1636430750310, 1636430750581, 271, 0, 271, 0, 0, 0
7632, 1, 1636430750330, 1636430750597, 267, 0, 267, 0, 0, 0
7634, 1, 1636430750529, 1636430750798, 269, 0, 269, 0, 0, 0
7635, 1, 1636430750537, 1636430750805, 268, 1, 267, 0, 0, 0
7636, 1, 1636430750673, 1636430750945, 272, 1, 271, 0, 0, 0
7637, 1, 1636430750697, 1636430750969, 272, 1, 271, 0, 1, 1
7638, 1, 1636430750733, 1636430751006, 273, 0, 273, 0, 0, 0
7639, 1, 1636430750757, 1636430751037, 280, 0, 280, 0, 0, 0
7640, 1, 1636430750798, 1636430751069, 271, 0, 271, 0, 0, 0
7641, 1, 1636430750909, 1636430751177, 268, 1, 267, 0, 1, 1
7642, 1, 1636430750917, 1636430751185, 268, 0, 268, 0, 0, 0
7644, 1, 1636430750973, 1636430751242, 269, 0, 269, 0, 0, 0
7643, 1, 1636430750981, 1636430751249, 268, 0, 268, 0, 0, 0
7645, 1, 1636430751006, 1636430751277, 271, 0, 271, 0, 0, 0
7646, 1, 1636430751201, 1636430751473, 272, 0, 272, 0, 0, 0
7648, 1, 1636430751349, 1636430751626, 277, 0, 277, 0, 0, 0
7649, 1, 1636430751365, 1636430751637, 272, 1, 271, 0, 1, 1
7650, 1, 1636430751401, 1636430751669, 268, 0, 268, 0, 0, 0
7651, 1, 1636430751429, 1636430751698, 269, 0, 269, 0, 0, 0
7652, 1, 1636430751469, 1636430751741, 272, 0, 272, 0, 0, 0
7653, 1, 1636430751585, 1636430751857, 272, 0, 272, 0, 0, 0
7656, 1, 1636430751646, 1636430751922, 276, 0, 276, 0, 0, 0
7655, 1, 1636430751646, 1636430751922, 276, 0, 276, 0, 0, 0
7657, 1, 1636430751669, 1636430751945, 276, 0, 276, 0, 0, 0
7658, 1, 1636430751873, 1636430752149, 276, 1, 275, 1, 0, 1
7659, 1, 1636430752025, 1636430752297, 272, 1, 271, 1, 0, 1
7660, 1, 1636430752042, 1636430752313, 271, 0, 271, 0, 0, 0
7661, 1, 1636430752061, 1636430752333, 272, 1, 271, 0, 0, 0
7662, 1, 1636430752101, 1636430752369, 268, 0, 268, 0, 0, 0
7663, 1, 1636430752133, 1636430752409, 276, 0, 276, 0, 0, 0
7666, 1, 1636430752322, 1636430752593, 271, 0, 271, 0, 0, 0
7665, 1, 1636430752317, 1636430752593, 276, 0, 276, 0, 0, 0
7667, 1, 1636430752341, 1636430752617, 276, 0, 276, 0, 0, 0
7664, 1, 1636430752513, 1636430752781, 268, 1, 267, 0, 0, 0
7668, 1, 1636430752545, 1636430752817, 272, 1, 271, 0, 0, 0
7669, 1, 1636430752693, 1636430752969, 276, 0, 276, 0, 0, 0
7670, 1, 1636430752741, 1636430753009, 268, 0, 268, 0, 0, 0
7672, 1, 1636430752773, 1636430753045, 272, 1, 271, 1, 0, 1
7673, 1, 1636430752817, 1636430753082, 265, 0, 265, 0, 0, 0
7674, 1, 1636430752973, 1636430753241, 268, 0, 268, 0, 0, 0
7675, 1, 1636430752993, 1636430753265, 272, 1, 271, 1, 0, 1
7676, 1, 1636430752993, 1636430753269, 276, 1, 275, 1, 0, 1
7677, 1, 1636430753005, 1636430753273, 268, 0, 268, 0, 0, 0
7671, 1, 1636430753141, 1636430753409, 268, 0, 268, 0, 0, 0
7678, 1, 1636430753185, 1636430753461, 276, 1, 275, 0, 1, 1
7679, 1, 1636430753209, 1636430753481, 272, 1, 271, 0, 0, 0
7680, 1, 1636430753361, 1636430753625, 264, 0, 264, 0, 0, 0
7681, 1, 1636430753401, 1636430753665, 264, 0, 264, 0, 0, 0
7682, 1, 1636430753449, 1636430753713, 264, 0, 264, 0, 0, 0
7683, 1, 1636430753489, 1636430753757, 268, 0, 268, 0, 0, 0
7684, 1, 1636430753637, 1636430753905, 268, 0, 268, 0, 0, 0
7685, 1, 1636430753661, 1636430753934, 273, 1, 272, 0, 0, 0
7686, 1, 1636430753661, 1636430753934, 273, 1, 272, 1, 0, 1
7687, 1, 1636430753677, 1636430753941, 264, 1, 263, 0, 1, 1
7688, 1, 1636430753809, 1636430754073, 264, 0, 264, 0, 0, 0
7689, 1, 1636430753849, 1636430754113, 264, 0, 264, 0, 0, 0
7690, 1, 1636430753933, 1636430754202, 269, 1, 268, 0, 0, 0
7692, 1, 1636430754085, 1636430754357, 272, 0, 272, 0, 0, 0
7694, 1, 1636430754157, 1636430754421, 264, 1, 263, 1, 0, 1
7693, 1, 1636430754113, 1636430754421, 308, 0, 308, 0, 0, 0
7691, 1, 1636430754289, 1636430754553, 264, 0, 264, 0, 0, 0
7695, 1, 1636430754329, 1636430754605, 276, 1, 275, 0, 1, 1
7696, 1, 1636430754329, 1636430754606, 277, 1, 276, 1, 0, 1
7697, 1, 1636430754329, 1636430754605, 276, 1, 275, 0, 0, 0
7698, 1, 1636430754373, 1636430754650, 277, 1, 276, 0, 1, 1
7699, 1, 1636430754477, 1636430754749, 272, 0, 272, 0, 0, 0
7700, 1, 1636430754513, 1636430754781, 268, 1, 267, 0, 0, 0
7702, 1, 1636430754598, 1636430754865, 267, 0, 267, 0, 0, 0
7701, 1, 1636430754593, 1636430754865, 272, 1, 271, 0, 0, 0
7704, 1, 1636430754813, 1636430755097, 284, 0, 284, 0, 0, 0
7705, 1, 1636430754821, 1636430755098, 277, 1, 276, 0, 0, 0
7703, 1, 1636430754781, 1636430755097, 316, 0, 316, 0, 0, 0
7707, 1, 1636430755009, 1636430755281, 272, 1, 271, 1, 0, 1
7708, 1, 1636430755009, 1636430755281, 272, 1, 271, 1, 0, 1
7710, 1, 1636430755089, 1636430755361, 272, 1, 271, 0, 0, 0
7711, 1, 1636430755141, 1636430755405, 264, 1, 263, 0, 1, 1
7712, 1, 1636430755225, 1636430755501, 276, 0, 276, 0, 0, 0
7713, 1, 1636430755261, 1636430755533, 272, 0, 272, 0, 0, 0
7714, 1, 1636430755261, 1636430755533, 272, 0, 272, 0, 0, 0
7709, 1, 1636430755281, 1636430755545, 264, 0, 264, 0, 0, 0
7715, 1, 1636430755349, 1636430755618, 269, 1, 268, 0, 0, 0
7716, 1, 1636430755485, 1636430755757, 272, 0, 272, 0, 0, 0
7718, 1, 1636430755497, 1636430755769, 272, 0, 272, 0, 0, 0
7720, 1, 1636430755681, 1636430755989, 308, 1, 307, 1, 0, 1
7717, 1, 1636430755721, 1636430755989, 268, 0, 268, 0, 0, 0
7719, 1, 1636430755681, 1636430755989, 308, 1, 307, 0, 0, 0
7721, 1, 1636430755753, 1636430756029, 276, 0, 276, 0, 0, 0
7722, 1, 1636430755813, 1636430756081, 268, 0, 268, 0, 0, 0
7723, 1, 1636430755897, 1636430756158, 261, 0, 261, 0, 0, 0
7724, 1, 1636430755937, 1636430756209, 272, 1, 271, 0, 0, 0
7725, 1, 1636430755937, 1636430756209, 272, 1, 271, 0, 1, 1
7726, 1, 1636430755941, 1636430756213, 272, 0, 272, 0, 0, 0
7727, 1, 1636430756029, 1636430756297, 268, 1, 267, 0, 0, 0
7730, 1, 1636430756165, 1636430756429, 264, 0, 264, 0, 0, 0
7728, 1, 1636430756157, 1636430756430, 273, 1, 272, 0, 0, 0
7729, 1, 1636430756157, 1636430756430, 273, 1, 272, 0, 0, 0
7731, 1, 1636430756385, 1636430756653, 268, 0, 268, 0, 0, 0
7732, 1, 1636430756389, 1636430756653, 264, 0, 264, 0, 0, 0
7733, 1, 1636430756389, 1636430756665, 276, 0, 276, 0, 0, 0
7734, 1, 1636430756429, 1636430756693, 264, 1, 263, 1, 0, 1
7735, 1, 1636430756473, 1636430756741, 268, 1, 267, 0, 0, 0
7736, 1, 1636430756561, 1636430756829, 268, 0, 268, 0, 0, 0
7739, 1, 1636430756609, 1636430756921, 312, 1, 311, 1, 0, 1
7738, 1, 1636430756609, 1636430756922, 313, 1, 312, 0, 1, 1
7740, 1, 1636430756693, 1636430756965, 272, 1, 271, 0, 1, 1
7742, 1, 1636430756833, 1636430757101, 268, 1, 267, 1, 0, 1
7741, 1, 1636430756833, 1636430757101, 268, 1, 267, 0, 1, 1
7743, 1, 1636430756833, 1636430757105, 272, 1, 271, 0, 1, 1
7737, 1, 1636430756873, 1636430757141, 268, 0, 268, 0, 0, 0
7744, 1, 1636430757053, 1636430757317, 264, 0, 264, 0, 0, 0
7745, 1, 1636430757053, 1636430757321, 268, 0, 268, 0, 0, 0
7746, 1, 1636430757097, 1636430757361, 264, 1, 263, 1, 0, 1
7747, 1, 1636430757097, 1636430757369, 272, 1, 271, 0, 1, 1
7748, 1, 1636430757145, 1636430757409, 264, 0, 264, 0, 0, 0
7749, 1, 1636430757173, 1636430757445, 272, 1, 271, 0, 0, 0
7750, 1, 1636430757229, 1636430757497, 268, 0, 268, 0, 0, 0
7752, 1, 1636430757321, 1636430757585, 264, 0, 264, 0, 0, 0
7751, 1, 1636430757313, 1636430757585, 272, 1, 271, 0, 0, 0
7753, 1, 1636430757365, 1636430757633, 268, 0, 268, 0, 0, 0
7756, 1, 1636430757497, 1636430757761, 264, 0, 264, 0, 0, 0
7755, 1, 1636430757489, 1636430757765, 276, 0, 276, 0, 0, 0
7757, 1, 1636430757533, 1636430757798, 265, 1, 264, 0, 0, 0
7758, 1, 1636430757713, 1636430757986, 273, 1, 272, 0, 1, 1
7759, 1, 1636430757717, 1636430757989, 272, 0, 272, 0, 0, 0
7760, 1, 1636430757761, 1636430758041, 280, 1, 279, 0, 0, 0
7761, 1, 1636430757765, 1636430758045, 280, 0, 280, 0, 0, 0
7763, 1, 1636430757837, 1636430758105, 268, 0, 268, 0, 0, 0
7764, 1, 1636430757893, 1636430758169, 276, 1, 275, 0, 1, 1
7762, 1, 1636430757941, 1636430758213, 272, 1, 271, 1, 0, 1
7765, 1, 1636430757973, 1636430758241, 268, 0, 268, 0, 0, 0
7766, 1, 1636430757986, 1636430758254, 268, 0, 268, 0, 0, 0
7767, 1, 1636430758029, 1636430758305, 276, 0, 276, 0, 0, 0
7768, 1, 1636430758169, 1636430758433, 264, 1, 263, 0, 0, 0
7769, 1, 1636430758173, 1636430758433, 260, 0, 260, 0, 0, 0
7770, 1, 1636430758209, 1636430758477, 268, 0, 268, 0, 0, 0
7772, 1, 1636430758385, 1636430758653, 268, 1, 267, 0, 1, 1
7774, 1, 1636430758433, 1636430758705, 272, 1, 271, 0, 0, 0
7773, 1, 1636430758429, 1636430758705, 276, 1, 275, 0, 1, 1
7775, 1, 1636430758502, 1636430758773, 271, 0, 271, 0, 0, 0
7776, 1, 1636430758565, 1636430758833, 268, 1, 267, 0, 0, 0
7777, 1, 1636430758605, 1636430758873, 268, 1, 267, 0, 0, 0
7778, 1, 1636430758645, 1636430758961, 316, 1, 315, 0, 0, 0
7779, 1, 1636430758645, 1636430758962, 317, 1, 316, 1, 0, 1
7780, 1, 1636430758697, 1636430758962, 265, 0, 265, 0, 0, 0
7782, 1, 1636430758873, 1636430759141, 268, 1, 267, 0, 0, 0
7783, 1, 1636430758873, 1636430759142, 269, 1, 268, 0, 0, 0
7781, 1, 1636430758873, 1636430759141, 268, 1, 267, 0, 0, 0
7784, 1, 1636430759093, 1636430759365, 272, 0, 272, 0, 0, 0
7786, 1, 1636430759105, 1636430759373, 268, 1, 267, 0, 0, 0
7785, 1, 1636430759145, 1636430759409, 264, 0, 264, 0, 0, 0
7787, 1, 1636430759169, 1636430759437, 268, 1, 267, 1, 0, 1
7788, 1, 1636430759217, 1636430759481, 264, 0, 264, 0, 0, 0
7789, 1, 1636430759229, 1636430759497, 268, 1, 267, 0, 1, 1
7790, 1, 1636430759277, 1636430759545, 268, 0, 268, 0, 0, 0
7792, 1, 1636430759357, 1636430759629, 272, 1, 271, 0, 1, 1
7793, 1, 1636430759361, 1636430759633, 272, 1, 271, 0, 0, 0
7794, 1, 1636430759545, 1636430759813, 268, 1, 267, 0, 0, 0
7796, 1, 1636430759541, 1636430759817, 276, 0, 276, 0, 0, 0
7795, 1, 1636430759662, 1636430759922, 260, 0, 260, 0, 0, 0
7798, 1, 1636430759769, 1636430760037, 268, 1, 267, 0, 1, 1
7797, 1, 1636430759765, 1636430760037, 272, 0, 272, 0, 0, 0
7799, 1, 1636430759813, 1636430760085, 272, 1, 271, 0, 1, 1
7800, 1, 1636430759837, 1636430760109, 272, 1, 271, 0, 0, 0
7801, 1, 1636430759877, 1636430760145, 268, 0, 268, 0, 0, 0
7802, 1, 1636430759897, 1636430760165, 268, 1, 267, 0, 0, 0
7803, 1, 1636430759937, 1636430760205, 268, 1, 267, 1, 0, 1
7804, 1, 1636430760021, 1636430760293, 272, 0, 272, 0, 0, 0
7805, 1, 1636430760029, 1636430760297, 268, 0, 268, 0, 0, 0
7806, 1, 1636430760221, 1636430760497, 276, 1, 275, 0, 1, 1
7807, 1, 1636430760209, 1636430760505, 296, 0, 296, 0, 0, 0
7808, 1, 1636430760325, 1636430760593, 268, 1, 267, 0, 1, 1
7810, 1, 1636430760441, 1636430760713, 272, 1, 271, 0, 0, 0
7809, 1, 1636430760441, 1636430760717, 276, 1, 275, 0, 1, 1
7812, 1, 1636430760497, 1636430760762, 265, 0, 265, 0, 0, 0
7811, 1, 1636430760497, 1636430760762, 265, 1, 264, 0, 1, 1
7813, 1, 1636430760541, 1636430760809, 268, 1, 267, 0, 1, 1
7814, 1, 1636430760557, 1636430760829, 272, 1, 271, 0, 0, 0
7815, 1, 1636430760633, 1636430760909, 276, 0, 276, 0, 0, 0
7817, 1, 1636430760693, 1636430760965, 272, 1, 271, 1, 0, 1
7816, 1, 1636430760693, 1636430760966, 273, 1, 272, 0, 0, 0
7818, 1, 1636430760757, 1636430761025, 268, 1, 267, 0, 0, 0
7819, 1, 1636430760893, 1636430761161, 268, 0, 268, 0, 0, 0
7820, 1, 1636430760897, 1636430761169, 272, 0, 272, 0, 0, 0
7821, 1, 1636430760989, 1636430761265, 276, 1, 275, 0, 0, 0
7822, 1, 1636430761165, 1636430761437, 272, 1, 271, 1, 0, 1
7824, 1, 1636430761165, 1636430761438, 273, 1, 272, 1, 0, 1
7823, 1, 1636430761165, 1636430761437, 272, 1, 271, 0, 1, 1
7825, 1, 1636430761169, 1636430761437, 268, 0, 268, 0, 0, 0
7826, 1, 1636430761253, 1636430761525, 272, 1, 271, 0, 0, 0
7828, 1, 1636430761305, 1636430761569, 264, 0, 264, 0, 0, 0
7829, 1, 1636430761381, 1636430761654, 273, 1, 272, 0, 0, 0
7830, 1, 1636430761377, 1636430761654, 277, 0, 277, 0, 0, 0
7831, 1, 1636430761421, 1636430761725, 304, 0, 304, 0, 0, 0
7832, 1, 1636430761541, 1636430761813, 272, 1, 271, 0, 0, 0
7834, 1, 1636430761569, 1636430761845, 276, 1, 275, 0, 0, 0
7833, 1, 1636430761621, 1636430761893, 272, 1, 271, 0, 0, 0
7835, 1, 1636430761673, 1636430761937, 264, 0, 264, 0, 0, 0
7836, 1, 1636430761837, 1636430762109, 272, 1, 271, 0, 1, 1
7838, 1, 1636430761845, 1636430762117, 272, 1, 271, 1, 0, 1
7837, 1, 1636430761845, 1636430762121, 276, 1, 275, 0, 0, 0
7839, 1, 1636430761845, 1636430762122, 277, 1, 276, 0, 1, 1
7840, 1, 1636430761893, 1636430762161, 268, 0, 268, 0, 0, 0
7841, 1, 1636430761925, 1636430762201, 276, 0, 276, 0, 0, 0
7842, 1, 1636430761977, 1636430762249, 272, 0, 272, 0, 0, 0
7843, 1, 1636430762053, 1636430762325, 272, 1, 271, 0, 1, 1
7844, 1, 1636430762057, 1636430762333, 276, 1, 275, 1, 0, 1
7845, 1, 1636430762121, 1636430762397, 276, 0, 276, 0, 0, 0
7846, 1, 1636430762213, 1636430762489, 276, 0, 276, 0, 0, 0
7847, 1, 1636430762241, 1636430762513, 272, 1, 271, 1, 0, 1
7848, 1, 1636430762289, 1636430762553, 264, 0, 264, 0, 0, 0
7849, 1, 1636430762341, 1636430762614, 273, 0, 273, 0, 0, 0
7850, 1, 1636430762505, 1636430762777, 272, 1, 271, 0, 1, 1
7851, 1, 1636430762509, 1636430762778, 269, 0, 269, 0, 0, 0
7852, 1, 1636430762513, 1636430762778, 265, 1, 264, 0, 0, 0
7853, 1, 1636430762525, 1636430762797, 272, 0, 272, 0, 0, 0
7854, 1, 1636430762557, 1636430762825, 268, 0, 268, 0, 0, 0
7855, 1, 1636430762589, 1636430762865, 276, 0, 276, 0, 0, 0
7856, 1, 1636430762641, 1636430762913, 272, 0, 272, 0, 0, 0
7858, 1, 1636430762725, 1636430762994, 269, 1, 268, 0, 0, 0
7857, 1, 1636430762721, 1636430762994, 273, 1, 272, 0, 0, 0
7859, 1, 1636430762801, 1636430763073, 272, 0, 272, 0, 0, 0
7860, 1, 1636430762885, 1636430763161, 276, 0, 276, 0, 0, 0
7861, 1, 1636430762925, 1636430763189, 264, 1, 263, 0, 1, 1
7862, 1, 1636430762953, 1636430763226, 273, 0, 273, 0, 0, 0
7863, 1, 1636430763005, 1636430763277, 272, 0, 272, 0, 0, 0
7864, 1, 1636430763181, 1636430763445, 264, 1, 263, 1, 0, 1
7865, 1, 1636430763189, 1636430763461, 272, 1, 271, 0, 1, 1
7866, 1, 1636430763189, 1636430763462, 273, 1, 272, 0, 1, 1
7867, 1, 1636430763197, 1636430763473, 276, 0, 276, 0, 0, 0
7868, 1, 1636430763226, 1636430763497, 271, 0, 271, 0, 0, 0
7869, 1, 1636430763261, 1636430763538, 277, 0, 277, 0, 0, 0
7872, 1, 1636430763470, 1636430763741, 271, 0, 271, 0, 0, 0
7873, 1, 1636430763549, 1636430763817, 268, 0, 268, 0, 0, 0
7875, 1, 1636430763625, 1636430763893, 268, 0, 268, 0, 0, 0
7874, 1, 1636430763633, 1636430763909, 276, 0, 276, 0, 0, 0
7878, 1, 1636430763857, 1636430764126, 269, 0, 269, 0, 0, 0
7879, 1, 1636430763853, 1636430764126, 273, 0, 273, 0, 0, 0
7881, 1, 1636430763893, 1636430764170, 277, 1, 276, 0, 0, 0
7882, 1, 1636430763930, 1636430764201, 271, 0, 271, 0, 0, 0
7880, 1, 1636430764073, 1636430764346, 273, 0, 273, 0, 0, 0
7883, 1, 1636430764137, 1636430764413, 276, 1, 275, 1, 0, 1
7884, 1, 1636430764225, 1636430764497, 272, 1, 271, 0, 0, 0
7886, 1, 1636430764301, 1636430764569, 268, 0, 268, 0, 0, 0
7887, 1, 1636430764525, 1636430764801, 276, 1, 275, 0, 0, 0
7888, 1, 1636430764525, 1636430764802, 277, 1, 276, 1, 0, 1
7889, 1, 1636430764565, 1636430764837, 272, 0, 272, 0, 0, 0
7890, 1, 1636430764601, 1636430764877, 276, 1, 275, 0, 1, 1
7891, 1, 1636430764817, 1636430765089, 272, 0, 272, 0, 0, 0
7892, 1, 1636430764905, 1636430765173, 268, 0, 268, 0, 0, 0
7893, 1, 1636430764994, 1636430765269, 275, 0, 275, 0, 0, 0
7896, 1, 1636430765233, 1636430765498, 265, 0, 265, 0, 0, 0
7898, 1, 1636430765261, 1636430765533, 272, 1, 271, 1, 0, 1
7897, 1, 1636430765261, 1636430765541, 280, 1, 279, 1, 0, 1
7899, 1, 1636430765481, 1636430765745, 264, 1, 263, 0, 0, 0
7900, 1, 1636430765557, 1636430765829, 272, 0, 272, 0, 0, 0
7902, 1, 1636430765906, 1636430766173, 267, 0, 267, 0, 0, 0
7904, 1, 1636430765937, 1636430766205, 268, 1, 267, 0, 1, 1
7903, 1, 1636430765942, 1636430766213, 271, 0, 271, 0, 0, 0
7905, 1, 1636430766153, 1636430766430, 277, 1, 276, 0, 1, 1
7906, 1, 1636430766233, 1636430766505, 272, 0, 272, 0, 0, 0
7907, 1, 1636430766573, 1636430766838, 265, 1, 264, 1, 0, 1
7909, 1, 1636430766609, 1636430766881, 272, 1, 271, 0, 1, 1
7910, 1, 1636430766829, 1636430767102, 273, 1, 272, 0, 1, 1
7911, 1, 1636430766905, 1636430767178, 273, 1, 272, 0, 0, 0
7912, 1, 1636430767237, 1636430767542, 305, 1, 304, 0, 0, 0
7913, 1, 1636430767277, 1636430767549, 272, 1, 271, 0, 0, 0
7914, 1, 1636430767542, 1636430767814, 272, 0, 272, 0, 0, 0
7916, 1, 1636430767798, 1636430768070, 272, 0, 272, 0, 0, 0
7917, 1, 1636430767937, 1636430768206, 269, 0, 269, 0, 0, 0
7918, 1, 1636430767945, 1636430768213, 268, 0, 268, 0, 0, 0
7919, 1, 1636430768206, 1636430768474, 268, 0, 268, 0, 0, 0
7920, 1, 1636430768481, 1636430768757, 276, 1, 275, 0, 0, 0
7921, 1, 1636430768601, 1636430768869, 268, 1, 267, 0, 0, 0
7922, 1, 1636430768617, 1636430768885, 268, 0, 268, 0, 0, 0
7924, 1, 1636430768869, 1636430769142, 273, 1, 272, 0, 0, 0
7923, 1, 1636430769065, 1636430769337, 272, 1, 271, 0, 0, 0
7925, 1, 1636430769158, 1636430769429, 271, 0, 271, 0, 0, 0
7927, 1, 1636430769309, 1636430769582, 273, 1, 272, 0, 0, 0
7926, 1, 1636430769309, 1636430769582, 273, 1, 272, 1, 0, 1
7928, 1, 1636430769549, 1636430769821, 272, 1, 271, 0, 1, 1
7929, 1, 1636430769657, 1636430769933, 276, 1, 275, 0, 0, 0
7930, 1, 1636430769733, 1636430770001, 268, 0, 268, 0, 0, 0
7931, 1, 1636430769817, 1636430770089, 272, 0, 272, 0, 0, 0
7932, 1, 1636430769993, 1636430770262, 269, 1, 268, 0, 0, 0
7933, 1, 1636430769993, 1636430770262, 269, 1, 268, 0, 0, 0
7934, 1, 1636430770221, 1636430770485, 264, 0, 264, 0, 0, 0
7935, 1, 1636430770333, 1636430770601, 268, 0, 268, 0, 0, 0
7936, 1, 1636430770401, 1636430770665, 264, 0, 264, 0, 0, 0
7937, 1, 1636430770485, 1636430770753, 268, 1, 267, 0, 1, 1
7939, 1, 1636430770665, 1636430770937, 272, 0, 272, 0, 0, 0
7940, 1, 1636430770885, 1636430771158, 273, 1, 272, 0, 0, 0
7941, 1, 1636430771010, 1636430771297, 287, 0, 287, 0, 0, 0
7942, 1, 1636430771069, 1636430771338, 269, 1, 268, 1, 0, 1
7943, 1, 1636430771158, 1636430771430, 272, 0, 272, 0, 0, 0
7944, 1, 1636430771341, 1636430771614, 273, 0, 273, 0, 0, 0
7947, 1, 1636430771689, 1636430771958, 269, 0, 269, 0, 0, 0
7948, 1, 1636430771733, 1636430771997, 264, 0, 264, 0, 0, 0
7946, 1, 1636430771789, 1636430772061, 272, 1, 271, 0, 1, 1
7949, 1, 1636430771817, 1636430772090, 273, 1, 272, 0, 0, 0
7950, 1, 1636430772010, 1636430772282, 272, 0, 272, 0, 0, 0
7951, 1, 1636430772357, 1636430772633, 276, 0, 276, 0, 0, 0
7952, 1, 1636430772402, 1636430772677, 275, 0, 275, 0, 0, 0
7953, 1, 1636430772461, 1636430772733, 272, 1, 271, 1, 0, 1
7954, 1, 1636430772485, 1636430772757, 272, 1, 271, 0, 0, 0
7956, 1, 1636430773033, 1636430773302, 269, 0, 269, 0, 0, 0
7957, 1, 1636430773078, 1636430773345, 267, 0, 267, 0, 0, 0
7959, 1, 1636430773162, 1636430773482, 320, 0, 320, 0, 0, 0
7958, 1, 1636430773125, 1636430773482, 357, 0, 357, 0, 0, 0
7960, 1, 1636430773725, 1636430773997, 272, 1, 271, 0, 0, 0
7961, 1, 1636430773725, 1636430774001, 276, 1, 275, 0, 0, 0
7962, 1, 1636430773725, 1636430774002, 277, 1, 276, 0, 0, 0
7963, 1, 1636430773805, 1636430774069, 264, 0, 264, 0, 0, 0
7964, 1, 1636430773893, 1636430774169, 276, 1, 275, 1, 0, 1
7965, 1, 1636430773893, 1636430774169, 276, 1, 275, 1, 0, 1
7967, 1, 1636430774157, 1636430774425, 268, 1, 267, 1, 0, 1
7966, 1, 1636430774342, 1636430774613, 271, 0, 271, 0, 0, 0
7969, 1, 1636430774397, 1636430774669, 272, 1, 271, 1, 0, 1
7968, 1, 1636430774401, 1636430774673, 272, 1, 271, 0, 0, 0
7970, 1, 1636430774401, 1636430774673, 272, 1, 271, 1, 0, 1
7971, 1, 1636430774461, 1636430774730, 269, 1, 268, 1, 0, 1
7972, 1, 1636430774569, 1636430774837, 268, 0, 268, 0, 0, 0
7973, 1, 1636430774569, 1636430774841, 272, 1, 271, 0, 0, 0
7974, 1, 1636430774613, 1636430774882, 269, 1, 268, 0, 1, 1
7975, 1, 1636430774829, 1636430775101, 272, 0, 272, 0, 0, 0
7976, 1, 1636430775005, 1636430775293, 288, 0, 288, 0, 0, 0
7979, 1, 1636430775073, 1636430775389, 316, 0, 316, 0, 0, 0
7977, 1, 1636430775074, 1636430775390, 316, 0, 316, 0, 0, 0
7978, 1, 1636430775074, 1636430775390, 316, 0, 316, 0, 0, 0
7980, 1, 1636430775201, 1636430775473, 272, 0, 272, 0, 0, 0
7983, 1, 1636430775297, 1636430775569, 272, 0, 272, 0, 0, 0
7986, 1, 1636430775517, 1636430775801, 284, 0, 284, 0, 0, 0
7984, 1, 1636430775498, 1636430775801, 303, 0, 303, 0, 0, 0
7985, 1, 1636430775498, 1636430775801, 303, 0, 303, 0, 0, 0
7982, 1, 1636430775565, 1636430775833, 268, 0, 268, 0, 0, 0
7987, 1, 1636430775701, 1636430775965, 264, 0, 264, 0, 0, 0
7988, 1, 1636430775777, 1636430776045, 268, 0, 268, 0, 0, 0
7990, 1, 1636430775785, 1636430776053, 268, 0, 268, 0, 0, 0
7991, 1, 1636430775862, 1636430776129, 267, 0, 267, 0, 0, 0
7993, 1, 1636430775973, 1636430776250, 277, 1, 276, 0, 1, 1
7992, 1, 1636430775977, 1636430776250, 273, 0, 273, 0, 0, 0
7995, 1, 1636430776193, 1636430776461, 268, 0, 268, 0, 0, 0
7996, 1, 1636430776205, 1636430776482, 277, 1, 276, 0, 1, 1
7994, 1, 1636430776205, 1636430776482, 277, 1, 276, 1, 0, 1
7997, 1, 1636430776233, 1636430776493, 260, 0, 260, 0, 0, 0
7998, 1, 1636430776362, 1636430776653, 291, 0, 291, 0, 0, 0
8000, 1, 1636430776449, 1636430776750, 301, 1, 300, 1, 0, 1
7999, 1, 1636430776449, 1636430776750, 301, 1, 300, 0, 0, 0
8001, 1, 1636430776565, 1636430776841, 276, 1, 275, 0, 0, 0
8003, 1, 1636430776658, 1636430776929, 271, 0, 271, 0, 0, 0
8002, 1, 1636430776661, 1636430776933, 272, 0, 272, 0, 0, 0
8004, 1, 1636430776861, 1636430777129, 268, 1, 267, 0, 0, 0
8005, 1, 1636430776881, 1636430777153, 272, 1, 271, 0, 0, 0
8007, 1, 1636430776889, 1636430777154, 265, 0, 265, 0, 0, 0
8006, 1, 1636430776881, 1636430777161, 280, 0, 280, 0, 0, 0
8008, 1, 1636430776909, 1636430777173, 264, 0, 264, 0, 0, 0
8009, 1, 1636430777049, 1636430777317, 268, 0, 268, 0, 0, 0
8011, 1, 1636430777137, 1636430777413, 276, 0, 276, 0, 0, 0
8012, 1, 1636430777233, 1636430777505, 272, 0, 272, 0, 0, 0
8013, 1, 1636430777326, 1636430777629, 303, 0, 303, 0, 0, 0
8014, 1, 1636430777326, 1636430777633, 307, 0, 307, 0, 0, 0
8015, 1, 1636430777541, 1636430777805, 264, 1, 263, 0, 0, 0
8016, 1, 1636430777541, 1636430777805, 264, 1, 263, 1, 0, 1
8017, 1, 1636430777561, 1636430777821, 260, 0, 260, 0, 0, 0
8018, 1, 1636430777565, 1636430777841, 276, 0, 276, 0, 0, 0
8019, 1, 1636430777565, 1636430777841, 276, 0, 276, 0, 0, 0
8021, 1, 1636430777801, 1636430778077, 276, 0, 276, 0, 0, 0
8020, 1, 1636430777805, 1636430778081, 276, 0, 276, 0, 0, 0
8022, 1, 1636430777885, 1636430778153, 268, 1, 267, 0, 1, 1
8023, 1, 1636430777909, 1636430778185, 276, 1, 275, 1, 0, 1
8024, 1, 1636430778021, 1636430778298, 277, 0, 277, 0, 0, 0
8025, 1, 1636430778030, 1636430778298, 268, 0, 268, 0, 0, 0
8026, 1, 1636430778193, 1636430778469, 276, 0, 276, 0, 0, 0
8027, 1, 1636430778213, 1636430778493, 280, 0, 280, 0, 0, 0
8028, 1, 1636430778221, 1636430778494, 273, 1, 272, 0, 0, 0
8029, 1, 1636430778237, 1636430778509, 272, 1, 271, 1, 0, 1
8030, 1, 1636430778237, 1636430778510, 273, 1, 272, 0, 0, 0
8031, 1, 1636430778477, 1636430778753, 276, 0, 276, 0, 0, 0
8032, 1, 1636430778485, 1636430778761, 276, 0, 276, 0, 0, 0
8033, 1, 1636430778550, 1636430778821, 271, 0, 271, 0, 0, 0
8034, 1, 1636430778569, 1636430778849, 280, 1, 279, 0, 0, 0
8035, 1, 1636430778701, 1636430778973, 272, 1, 271, 1, 0, 1
8036, 1, 1636430778701, 1636430778973, 272, 1, 271, 1, 0, 1
8037, 1, 1636430778865, 1636430779142, 277, 0, 277, 0, 0, 0
8039, 1, 1636430778885, 1636430779157, 272, 1, 271, 1, 0, 1
8038, 1, 1636430778885, 1636430779158, 273, 1, 272, 0, 1, 1
8041, 1, 1636430778909, 1636430779173, 264, 1, 263, 0, 0, 0
8042, 1, 1636430779153, 1636430779417, 264, 0, 264, 0, 0, 0
8043, 1, 1636430779157, 1636430779425, 268, 1, 267, 1, 0, 1
8044, 1, 1636430779217, 1636430779489, 272, 0, 272, 0, 0, 0
8045, 1, 1636430779245, 1636430779509, 264, 1, 263, 1, 0, 1
8040, 1, 1636430779317, 1636430779593, 276, 0, 276, 0, 0, 0
8047, 1, 1636430779369, 1636430779637, 268, 0, 268, 0, 0, 0
8048, 1, 1636430779533, 1636430779810, 277, 0, 277, 0, 0, 0
8049, 1, 1636430779565, 1636430779837, 272, 0, 272, 0, 0, 0
8050, 1, 1636430779565, 1636430779841, 276, 1, 275, 0, 0, 0
8051, 1, 1636430779569, 1636430779841, 272, 0, 272, 0, 0, 0
8046, 1, 1636430779769, 1636430780041, 272, 0, 272, 0, 0, 0
8052, 1, 1636430779817, 1636430780089, 272, 0, 272, 0, 0, 0
8053, 1, 1636430779825, 1636430780097, 272, 0, 272, 0, 0, 0
8055, 1, 1636430779913, 1636430780181, 268, 0, 268, 0, 0, 0
8056, 1, 1636430779985, 1636430780261, 276, 1, 275, 0, 1, 1
8057, 1, 1636430780041, 1636430780313, 272, 1, 271, 0, 0, 0
8058, 1, 1636430780205, 1636430780473, 268, 1, 267, 0, 0, 0
8054, 1, 1636430780225, 1636430780501, 276, 0, 276, 0, 0, 0
8059, 1, 1636430780241, 1636430780513, 272, 1, 271, 0, 0, 0
8060, 1, 1636430780241, 1636430780517, 276, 1, 275, 1, 0, 1
8062, 1, 1636430780442, 1636430780709, 267, 0, 267, 0, 0, 0
8064, 1, 1636430780497, 1636430780797, 300, 1, 299, 0, 0, 0
8063, 1, 1636430780481, 1636430780805, 324, 0, 324, 0, 0, 0
8065, 1, 1636430780618, 1636430780881, 263, 0, 263, 0, 0, 0
8066, 1, 1636430780649, 1636430780917, 268, 1, 267, 0, 0, 0
8068, 1, 1636430780869, 1636430781133, 264, 0, 264, 0, 0, 0
8067, 1, 1636430780885, 1636430781153, 268, 0, 268, 0, 0, 0
8069, 1, 1636430780893, 1636430781170, 277, 1, 276, 0, 0, 0
8071, 1, 1636430780909, 1636430781181, 272, 1, 271, 0, 0, 0
8070, 1, 1636430780909, 1636430781185, 276, 1, 275, 0, 0, 0
8072, 1, 1636430780973, 1636430781245, 272, 1, 271, 1, 0, 1
8074, 1, 1636430781193, 1636430781466, 273, 1, 272, 0, 1, 1
8075, 1, 1636430781205, 1636430781477, 272, 0, 272, 0, 0, 0
8076, 1, 1636430781277, 1636430781541, 264, 1, 263, 0, 0, 0
8073, 1, 1636430781421, 1636430781693, 272, 0, 272, 0, 0, 0
8078, 1, 1636430781537, 1636430781809, 272, 1, 271, 0, 1, 1
8079, 1, 1636430781549, 1636430781825, 276, 1, 275, 1, 0, 1
8061, 1, 1636430781549, 1636430781825, 276, 1, 275, 1, 0, 1
8081, 1, 1636430781601, 1636430781865, 264, 0, 264, 0, 0, 0
8082, 1, 1636430781605, 1636430781869, 264, 1, 263, 1, 0, 1
8080, 1, 1636430781605, 1636430781877, 272, 1, 271, 0, 1, 1
8083, 1, 1636430781641, 1636430781910, 269, 0, 269, 0, 0, 0
8077, 1, 1636430781721, 1636430781993, 272, 1, 271, 0, 0, 0
8084, 1, 1636430781865, 1636430782141, 276, 1, 275, 0, 0, 0
8086, 1, 1636430781881, 1636430782158, 277, 0, 277, 0, 0, 0
8087, 1, 1636430781941, 1636430782213, 272, 1, 271, 0, 1, 1
8088, 1, 1636430782089, 1636430782361, 272, 1, 271, 0, 0, 0
8085, 1, 1636430782173, 1636430782441, 268, 0, 268, 0, 0, 0
8089, 1, 1636430782205, 1636430782485, 280, 0, 280, 0, 0, 0
8091, 1, 1636430782221, 1636430782489, 268, 0, 268, 0, 0, 0
8092, 1, 1636430782257, 1636430782526, 269, 1, 268, 0, 0, 0
8093, 1, 1636430782265, 1636430782533, 268, 0, 268, 0, 0, 0
8094, 1, 1636430782261, 1636430782537, 276, 0, 276, 0, 0, 0
8095, 1, 1636430782301, 1636430782570, 269, 1, 268, 1, 0, 1
8090, 1, 1636430782325, 1636430782593, 268, 0, 268, 0, 0, 0
8096, 1, 1636430782393, 1636430782661, 268, 0, 268, 0, 0, 0
8097, 1, 1636430782541, 1636430782817, 276, 0, 276, 0, 0, 0
8098, 1, 1636430782557, 1636430782833, 276, 1, 275, 0, 0, 0
8099, 1, 1636430782637, 1636430782913, 276, 1, 275, 1, 0, 1
8100, 1, 1636430782769, 1636430783041, 272, 1, 271, 0, 1, 1
8101, 1, 1636430782861, 1636430783133, 272, 1, 271, 0, 0, 0
8102, 1, 1636430782877, 1636430783157, 280, 0, 280, 0, 0, 0
8103, 1, 1636430782893, 1636430783165, 272, 0, 272, 0, 0, 0
8104, 1, 1636430782921, 1636430783197, 276, 1, 275, 0, 0, 0
8106, 1, 1636430782937, 1636430783213, 276, 0, 276, 0, 0, 0
8107, 1, 1636430782977, 1636430783249, 272, 0, 272, 0, 0, 0
8109, 1, 1636430782998, 1636430783265, 267, 0, 267, 0, 0, 0
8108, 1, 1636430782998, 1636430783265, 267, 0, 267, 0, 0, 0
8110, 1, 1636430783089, 1636430783353, 264, 0, 264, 0, 0, 0
8111, 1, 1636430783213, 1636430783485, 272, 0, 272, 0, 0, 0
8112, 1, 1636430783229, 1636430783489, 260, 0, 260, 0, 0, 0
8113, 1, 1636430783305, 1636430783573, 268, 1, 267, 0, 0, 0
8114, 1, 1636430783441, 1636430783713, 272, 1, 271, 1, 0, 1
8115, 1, 1636430783529, 1636430783797, 268, 0, 268, 0, 0, 0
8116, 1, 1636430783549, 1636430783825, 276, 0, 276, 0, 0, 0
8117, 1, 1636430783557, 1636430783825, 268, 0, 268, 0, 0, 0
8118, 1, 1636430783597, 1636430783865, 268, 0, 268, 0, 0, 0
8120, 1, 1636430783641, 1636430783917, 276, 0, 276, 0, 0, 0
8122, 1, 1636430783653, 1636430783917, 264, 1, 263, 0, 0, 0
8121, 1, 1636430783657, 1636430783933, 276, 1, 275, 0, 1, 1
8123, 1, 1636430783749, 1636430784021, 272, 1, 271, 0, 0, 0
8124, 1, 1636430783897, 1636430784169, 272, 1, 271, 0, 1, 1
8126, 1, 1636430783965, 1636430784237, 272, 0, 272, 0, 0, 0
8125, 1, 1636430784001, 1636430784277, 276, 0, 276, 0, 0, 0
8119, 1, 1636430784001, 1636430784277, 276, 1, 275, 1, 0, 1
8128, 1, 1636430784225, 1636430784497, 272, 1, 271, 0, 0, 0
8127, 1, 1636430784225, 1636430784501, 276, 1, 275, 1, 0, 1
8130, 1, 1636430784313, 1636430784581, 268, 1, 267, 0, 1, 1
8131, 1, 1636430784325, 1636430784597, 272, 0, 272, 0, 0, 0
8132, 1, 1636430784353, 1636430784625, 272, 1, 271, 0, 0, 0
8133, 1, 1636430784421, 1636430784693, 272, 0, 272, 0, 0, 0
8129, 1, 1636430784457, 1636430784725, 268, 0, 268, 0, 0, 0
8134, 1, 1636430784569, 1636430784841, 272, 1, 271, 0, 0, 0
8135, 1, 1636430784637, 1636430784901, 264, 0, 264, 0, 0, 0
8137, 1, 1636430784669, 1636430784941, 272, 1, 271, 0, 0, 0
8136, 1, 1636430784669, 1636430784942, 273, 1, 272, 1, 0, 1
8138, 1, 1636430784889, 1636430785157, 268, 0, 268, 0, 0, 0
8139, 1, 1636430784901, 1636430785169, 268, 0, 268, 0, 0, 0
8140, 1, 1636430784977, 1636430785293, 316, 1, 315, 0, 0, 0
8142, 1, 1636430785025, 1636430785294, 269, 0, 269, 0, 0, 0
8141, 1, 1636430784989, 1636430785293, 304, 0, 304, 0, 0, 0
8143, 1, 1636430785085, 1636430785381, 296, 0, 296, 0, 0, 0
8144, 1, 1636430785122, 1636430785401, 279, 0, 279, 0, 0, 0
8145, 1, 1636430785241, 1636430785513, 272, 1, 271, 1, 0, 1
8146, 1, 1636430785330, 1636430785597, 267, 0, 267, 0, 0, 0
8147, 1, 1636430785341, 1636430785613, 272, 0, 272, 0, 0, 0
8148, 1, 1636430785345, 1636430785613, 268, 0, 268, 0, 0, 0
8149, 1, 1636430785557, 1636430785837, 280, 0, 280, 0, 0, 0
8150, 1, 1636430785594, 1636430785865, 271, 0, 271, 0, 0, 0
8151, 1, 1636430785682, 1636430785953, 271, 0, 271, 0, 0, 0
8152, 1, 1636430785693, 1636430785953, 260, 1, 259, 0, 0, 0
8153, 1, 1636430785689, 1636430785957, 268, 1, 267, 0, 0, 0
8154, 1, 1636430785773, 1636430786045, 272, 0, 272, 0, 0, 0
8155, 1, 1636430785837, 1636430786110, 273, 1, 272, 0, 0, 0
8156, 1, 1636430785910, 1636430786178, 268, 0, 268, 0, 0, 0
8158, 1, 1636430785997, 1636430786265, 268, 1, 267, 0, 0, 0
8157, 1, 1636430785997, 1636430786265, 268, 1, 267, 1, 0, 1
8159, 1, 1636430786009, 1636430786269, 260, 0, 260, 0, 0, 0
8160, 1, 1636430786133, 1636430786401, 268, 1, 267, 1, 0, 1
8162, 1, 1636430786258, 1636430786533, 275, 0, 275, 0, 0, 0
8163, 1, 1636430786357, 1636430786629, 272, 1, 271, 0, 0, 0
8165, 1, 1636430786357, 1636430786633, 276, 1, 275, 0, 0, 0
8164, 1, 1636430786357, 1636430786633, 276, 1, 275, 0, 1, 1
8166, 1, 1636430786449, 1636430786725, 276, 0, 276, 0, 0, 0
8167, 1, 1636430786505, 1636430786777, 272, 0, 272, 0, 0, 0
8168, 1, 1636430786577, 1636430786845, 268, 1, 267, 0, 1, 1
8171, 1, 1636430786669, 1636430786937, 268, 0, 268, 0, 0, 0
8170, 1, 1636430786669, 1636430786938, 269, 1, 268, 0, 0, 0
8169, 1, 1636430786665, 1636430786937, 272, 1, 271, 0, 1, 1
8172, 1, 1636430786789, 1636430787065, 276, 1, 275, 0, 0, 0
8173, 1, 1636430786933, 1636430787205, 272, 0, 272, 0, 0, 0
8175, 1, 1636430787025, 1636430787301, 276, 0, 276, 0, 0, 0
8174, 1, 1636430787033, 1636430787305, 272, 1, 271, 1, 0, 1
8176, 1, 1636430787033, 1636430787305, 272, 1, 271, 1, 0, 1
8177, 1, 1636430787125, 1636430787397, 272, 0, 272, 0, 0, 0
8179, 1, 1636430787245, 1636430787514, 269, 1, 268, 0, 0, 0
8181, 1, 1636430787337, 1636430787606, 269, 0, 269, 0, 0, 0
8180, 1, 1636430787341, 1636430787606, 265, 0, 265, 0, 0, 0
8182, 1, 1636430787345, 1636430787609, 264, 0, 264, 0, 0, 0
8183, 1, 1636430787457, 1636430787721, 264, 0, 264, 0, 0, 0
8184, 1, 1636430787462, 1636430787725, 263, 0, 263, 0, 0, 0
8185, 1, 1636430787597, 1636430787869, 272, 1, 271, 0, 1, 1
8188, 1, 1636430787705, 1636430787973, 268, 1, 267, 0, 0, 0
8187, 1, 1636430787705, 1636430787974, 269, 1, 268, 1, 0, 1
8186, 1, 1636430787697, 1636430787974, 277, 0, 277, 0, 0, 0
8189, 1, 1636430787793, 1636430788061, 268, 1, 267, 0, 1, 1
8190, 1, 1636430787913, 1636430788177, 264, 0, 264, 0, 0, 0
8191, 1, 1636430787997, 1636430788266, 269, 0, 269, 0, 0, 0
8192, 1, 1636430788001, 1636430788269, 268, 1, 267, 0, 0, 0
8193, 1, 1636430788045, 1636430788326, 281, 0, 281, 0, 0, 0
8195, 1, 1636430788125, 1636430788393, 268, 0, 268, 0, 0, 0
8194, 1, 1636430788117, 1636430788393, 276, 0, 276, 0, 0, 0
8196, 1, 1636430788266, 1636430788537, 271, 0, 271, 0, 0, 0
8198, 1, 1636430788377, 1636430788654, 277, 1, 276, 0, 0, 0
8199, 1, 1636430788377, 1636430788654, 277, 1, 276, 0, 0, 0
8197, 1, 1636430788377, 1636430788654, 277, 1, 276, 0, 0, 0
8200, 1, 1636430788461, 1636430788738, 277, 1, 276, 0, 0, 0
8201, 1, 1636430788577, 1636430788853, 276, 1, 275, 0, 0, 0
8202, 1, 1636430788665, 1636430788937, 272, 1, 271, 0, 0, 0
8203, 1, 1636430788673, 1636430788945, 272, 0, 272, 0, 0, 0
8204, 1, 1636430788725, 1636430788997, 272, 1, 271, 1, 0, 1
8205, 1, 1636430788785, 1636430789061, 276, 0, 276, 0, 0, 0
8206, 1, 1636430788789, 1636430789061, 272, 0, 272, 0, 0, 0
8207, 1, 1636430788933, 1636430789202, 269, 0, 269, 0, 0, 0
8209, 1, 1636430789049, 1636430789314, 265, 0, 265, 0, 0, 0
8210, 1, 1636430789045, 1636430789314, 269, 1, 268, 0, 1, 1
8208, 1, 1636430789045, 1636430789314, 269, 1, 268, 1, 0, 1
8212, 1, 1636430789249, 1636430789517, 268, 0, 268, 0, 0, 0
8213, 1, 1636430789333, 1636430789606, 273, 1, 272, 0, 0, 0
8214, 1, 1636430789333, 1636430789606, 273, 0, 273, 0, 0, 0
8215, 1, 1636430789389, 1636430789649, 260, 1, 259, 1, 0, 1
8211, 1, 1636430789377, 1636430789657, 280, 1, 279, 0, 0, 0
8217, 1, 1636430789457, 1636430789729, 272, 1, 271, 0, 1, 1
8218, 1, 1636430789593, 1636430789869, 276, 1, 275, 0, 1, 1
8219, 1, 1636430789709, 1636430789981, 272, 0, 272, 0, 0, 0
8221, 1, 1636430789721, 1636430789989, 268, 1, 267, 1, 0, 1
8216, 1, 1636430789777, 1636430790045, 268, 1, 267, 0, 0, 0
8222, 1, 1636430789921, 1636430790193, 272, 0, 272, 0, 0, 0
8223, 1, 1636430790001, 1636430790269, 268, 1, 267, 0, 1, 1
8224, 1, 1636430790009, 1636430790281, 272, 0, 272, 0, 0, 0
8225, 1, 1636430790049, 1636430790313, 264, 0, 264, 0, 0, 0
8226, 1, 1636430790057, 1636430790326, 269, 1, 268, 0, 1, 1
8227, 1, 1636430790130, 1636430790397, 267, 0, 267, 0, 0, 0
8228, 1, 1636430790261, 1636430790533, 272, 1, 271, 0, 0, 0
8229, 1, 1636430790377, 1636430790649, 272, 1, 271, 0, 0, 0
8230, 1, 1636430790386, 1636430790657, 271, 0, 271, 0, 0, 0
8231, 1, 1636430790437, 1636430790709, 272, 1, 271, 1, 0, 1
8232, 1, 1636430790673, 1636430790945, 272, 0, 272, 0, 0, 0
8233, 1, 1636430790677, 1636430790949, 272, 0, 272, 0, 0, 0
8234, 1, 1636430790721, 1636430790994, 273, 0, 273, 0, 0, 0
8235, 1, 1636430790725, 1636430790997, 272, 0, 272, 0, 0, 0
8236, 1, 1636430790798, 1636430791073, 275, 0, 275, 0, 0, 0
8237, 1, 1636430790925, 1636430791197, 272, 1, 271, 0, 1, 1
8239, 1, 1636430791053, 1636430791326, 273, 1, 272, 0, 0, 0
8238, 1, 1636430791053, 1636430791326, 273, 1, 272, 0, 0, 0
8240, 1, 1636430791109, 1636430791381, 272, 0, 272, 0, 0, 0
8242, 1, 1636430791353, 1636430791621, 268, 0, 268, 0, 0, 0
8244, 1, 1636430791398, 1636430791669, 271, 0, 271, 0, 0, 0
8243, 1, 1636430791398, 1636430791669, 271, 0, 271, 0, 0, 0
8245, 1, 1636430791473, 1636430791741, 268, 0, 268, 0, 0, 0
8241, 1, 1636430791557, 1636430791825, 268, 0, 268, 0, 0, 0
8246, 1, 1636430791601, 1636430791869, 268, 1, 267, 0, 1, 1
8247, 1, 1636430791726, 1636430791993, 267, 0, 267, 0, 0, 0
8248, 1, 1636430791729, 1636430791997, 268, 0, 268, 0, 0, 0
8249, 1, 1636430791770, 1636430792049, 279, 0, 279, 0, 0, 0
8250, 1, 1636430792017, 1636430792290, 273, 0, 273, 0, 0, 0
8252, 1, 1636430792065, 1636430792333, 268, 1, 267, 0, 1, 1
8251, 1, 1636430792065, 1636430792334, 269, 1, 268, 1, 0, 1
8253, 1, 1636430792133, 1636430792405, 272, 0, 272, 0, 0, 0
8254, 1, 1636430792221, 1636430792498, 277, 1, 276, 0, 1, 1
8255, 1, 1636430792257, 1636430792530, 273, 1, 272, 0, 1, 1
8256, 1, 1636430792397, 1636430792669, 272, 1, 271, 0, 0, 0
8257, 1, 1636430792397, 1636430792669, 272, 1, 271, 1, 0, 1
8258, 1, 1636430792441, 1636430792709, 268, 1, 267, 0, 0, 0
8259, 1, 1636430792693, 1636430792981, 288, 0, 288, 0, 0, 0
8261, 1, 1636430792729, 1636430792998, 269, 1, 268, 1, 0, 1
8260, 1, 1636430792729, 1636430792998, 269, 1, 268, 1, 0, 1
8262, 1, 1636430792797, 1636430793073, 276, 1, 275, 0, 0, 0
8263, 1, 1636430792894, 1636430793165, 271, 0, 271, 0, 0, 0
8264, 1, 1636430792933, 1636430793205, 272, 0, 272, 0, 0, 0
8265, 1, 1636430793065, 1636430793333, 268, 1, 267, 0, 0, 0
8266, 1, 1636430793065, 1636430793333, 268, 1, 267, 1, 0, 1
8267, 1, 1636430793173, 1636430793446, 273, 0, 273, 0, 0, 0
8268, 1, 1636430793245, 1636430793521, 276, 1, 275, 0, 0, 0
8269, 1, 1636430793378, 1636430793645, 267, 0, 267, 0, 0, 0
8271, 1, 1636430793402, 1636430793673, 271, 0, 271, 0, 0, 0
8270, 1, 1636430793393, 1636430793673, 280, 1, 279, 1, 0, 1
8273, 1, 1636430793557, 1636430793829, 272, 0, 272, 0, 0, 0
8274, 1, 1636430793597, 1636430793869, 272, 0, 272, 0, 0, 0
8275, 1, 1636430793730, 1636430794001, 271, 0, 271, 0, 0, 0
8276, 1, 1636430793845, 1636430794114, 269, 1, 268, 0, 1, 1
8277, 1, 1636430793913, 1636430794189, 276, 1, 275, 0, 0, 0
8278, 1, 1636430794037, 1636430794302, 265, 0, 265, 0, 0, 0
8279, 1, 1636430794077, 1636430794349, 272, 1, 271, 0, 0, 0
8280, 1, 1636430794077, 1636430794350, 273, 1, 272, 1, 0, 1
8281, 1, 1636430794233, 1636430794506, 273, 0, 273, 0, 0, 0
8282, 1, 1636430794265, 1636430794533, 268, 1, 267, 0, 1, 1
8283, 1, 1636430794394, 1636430794665, 271, 0, 271, 0, 0, 0
8284, 1, 1636430794506, 1636430794782, 276, 0, 276, 0, 0, 0
8285, 1, 1636430794585, 1636430794857, 272, 1, 271, 0, 0, 0
8286, 1, 1636430794710, 1636430794985, 275, 0, 275, 0, 0, 0
8287, 1, 1636430794745, 1636430795017, 272, 0, 272, 0, 0, 0
8288, 1, 1636430794749, 1636430795021, 272, 0, 272, 0, 0, 0
8289, 1, 1636430794894, 1636430795165, 271, 0, 271, 0, 0, 0
8290, 1, 1636430794929, 1636430795198, 269, 1, 268, 0, 1, 1
8291, 1, 1636430795062, 1636430795337, 275, 0, 275, 0, 0, 0
8292, 1, 1636430795181, 1636430795453, 272, 1, 271, 0, 1, 1
8293, 1, 1636430795249, 1636430795521, 272, 0, 272, 0, 0, 0
8294, 1, 1636430795377, 1636430795645, 268, 0, 268, 0, 0, 0
8295, 1, 1636430795413, 1636430795685, 272, 0, 272, 0, 0, 0
8296, 1, 1636430795418, 1636430795689, 271, 0, 271, 0, 0, 0
8297, 1, 1636430795557, 1636430795830, 273, 1, 272, 0, 1, 1
8298, 1, 1636430795598, 1636430795873, 275, 0, 275, 0, 0, 0
8299, 1, 1636430795733, 1636430796009, 276, 1, 275, 1, 0, 1
8300, 1, 1636430795854, 1636430796122, 268, 0, 268, 0, 0, 0
8301, 1, 1636430795917, 1636430796193, 276, 0, 276, 0, 0, 0
8302, 1, 1636430796049, 1636430796361, 312, 1, 311, 0, 0, 0
8303, 1, 1636430796086, 1636430796365, 279, 0, 279, 0, 0, 0
8304, 1, 1636430796225, 1636430796489, 264, 1, 263, 0, 0, 0
8305, 1, 1636430796273, 1636430796541, 268, 1, 267, 0, 0, 0
8306, 1, 1636430796401, 1636430796673, 272, 1, 271, 0, 0, 0
8307, 1, 1636430796517, 1636430796785, 268, 0, 268, 0, 0, 0
8308, 1, 1636430796526, 1636430796789, 263, 0, 263, 0, 0, 0
8309, 1, 1636430796581, 1636430796853, 272, 1, 271, 1, 0, 1
8310, 1, 1636430796749, 1636430797017, 268, 0, 268, 0, 0, 0
8311, 1, 1636430796893, 1636430797165, 272, 1, 271, 0, 0, 0
8312, 1, 1636430796929, 1636430797193, 264, 1, 263, 0, 0, 0
8313, 1, 1636430797077, 1636430797345, 268, 1, 267, 0, 0, 0
8315, 1, 1636430797189, 1636430797458, 269, 1, 268, 0, 0, 0
8314, 1, 1636430797189, 1636430797461, 272, 1, 271, 0, 0, 0
8316, 1, 1636430797281, 1636430797545, 264, 0, 264, 0, 0, 0
8317, 1, 1636430797414, 1636430797681, 267, 0, 267, 0, 0, 0
8318, 1, 1636430797502, 1636430797777, 275, 0, 275, 0, 0, 0
8319, 1, 1636430797593, 1636430797873, 280, 0, 280, 0, 0, 0
8320, 1, 1636430797749, 1636430798022, 273, 1, 272, 1, 0, 1
8321, 1, 1636430797853, 1636430798121, 268, 1, 267, 0, 0, 0
8322, 1, 1636430797853, 1636430798122, 269, 1, 268, 1, 0, 1
8323, 1, 1636430797946, 1636430798217, 271, 0, 271, 0, 0, 0
8324, 1, 1636430798081, 1636430798349, 268, 0, 268, 0, 0, 0
8325, 1, 1636430798173, 1636430798437, 264, 1, 263, 0, 0, 0
8326, 1, 1636430798261, 1636430798530, 269, 0, 269, 0, 0, 0
8327, 1, 1636430798417, 1636430798690, 273, 1, 272, 0, 0, 0
8328, 1, 1636430798521, 1636430798790, 269, 1, 268, 0, 0, 0
8329, 1, 1636430798517, 1636430798790, 273, 0, 273, 0, 0, 0
8330, 1, 1636430798610, 1636430798881, 271, 0, 271, 0, 0, 0
8331, 1, 1636430798753, 1636430799017, 264, 1, 263, 0, 0, 0
8332, 1, 1636430798837, 1636430799105, 268, 0, 268, 0, 0, 0
8333, 1, 1636430798933, 1636430799197, 264, 0, 264, 0, 0, 0
8334, 1, 1636430799093, 1636430799362, 269, 1, 268, 0, 0, 0
8335, 1, 1636430799193, 1636430799461, 268, 1, 267, 1, 0, 1
8336, 1, 1636430799193, 1636430799469, 276, 1, 275, 1, 0, 1
8337, 1, 1636430799274, 1636430799546, 272, 0, 272, 0, 0, 0
8338, 1, 1636430799417, 1636430799685, 268, 0, 268, 0, 0, 0
8339, 1, 1636430799505, 1636430799777, 272, 0, 272, 0, 0, 0
8340, 1, 1636430799597, 1636430799869, 272, 0, 272, 0, 0, 0
8272, 1, 1636430799717, 1636430799989, 272, 0, 272, 0, 0, 0
8341, 1, 1636430799761, 1636430800030, 269, 1, 268, 0, 1, 1
8342, 1, 1636430799893, 1636430800162, 269, 1, 268, 0, 0, 0
8343, 1, 1636430799901, 1636430800165, 264, 0, 264, 0, 0, 0
8344, 1, 1636430799941, 1636430800206, 265, 1, 264, 0, 0, 0
8345, 1, 1636430800026, 1636430800297, 271, 0, 271, 0, 0, 0
8346, 1, 1636430800190, 1636430800462, 272, 0, 272, 0, 0, 0
8347, 1, 1636430800265, 1636430800537, 272, 0, 272, 0, 0, 0
8348, 1, 1636430800481, 1636430800757, 276, 1, 275, 1, 0, 1
8349, 1, 1636430800562, 1636430800833, 271, 0, 271, 0, 0, 0
8350, 1, 1636430800569, 1636430800838, 269, 0, 269, 0, 0, 0
8351, 1, 1636430800613, 1636430800889, 276, 1, 275, 0, 0, 0
8352, 1, 1636430800701, 1636430800977, 276, 0, 276, 0, 0, 0
8353, 1, 1636430800865, 1636430801138, 273, 0, 273, 0, 0, 0
8354, 1, 1636430800933, 1636430801209, 276, 0, 276, 0, 0, 0
8355, 1, 1636430801153, 1636430801426, 273, 1, 272, 0, 0, 0
8356, 1, 1636430801230, 1636430801501, 271, 0, 271, 0, 0, 0
8357, 1, 1636430801241, 1636430801505, 264, 0, 264, 0, 0, 0
8358, 1, 1636430801285, 1636430801553, 268, 1, 267, 1, 0, 1
8359, 1, 1636430801370, 1636430801637, 267, 0, 267, 0, 0, 0
8360, 1, 1636430801537, 1636430801809, 272, 1, 271, 0, 0, 0
8361, 1, 1636430801601, 1636430801869, 268, 0, 268, 0, 0, 0
8362, 1, 1636430801821, 1636430802093, 272, 1, 271, 1, 0, 1
8363, 1, 1636430801897, 1636430802169, 272, 0, 272, 0, 0, 0
8364, 1, 1636430801905, 1636430802181, 276, 1, 275, 1, 0, 1
8365, 1, 1636430801957, 1636430802225, 268, 1, 267, 0, 1, 1
8366, 1, 1636430802037, 1636430802310, 273, 1, 272, 1, 0, 1
8367, 1, 1636430802209, 1636430802481, 272, 0, 272, 0, 0, 0
8368, 1, 1636430802265, 1636430802529, 264, 1, 263, 0, 1, 1
8369, 1, 1636430802493, 1636430802765, 272, 1, 271, 1, 0, 1
8370, 1, 1636430802561, 1636430802830, 269, 1, 268, 0, 1, 1
8372, 1, 1636430802617, 1636430802889, 272, 0, 272, 0, 0, 0
8373, 1, 1636430802697, 1636430802969, 272, 1, 271, 1, 0, 1
8374, 1, 1636430802877, 1636430803153, 276, 1, 275, 0, 0, 0
8375, 1, 1636430802929, 1636430803193, 264, 0, 264, 0, 0, 0
8371, 1, 1636430802945, 1636430803213, 268, 1, 267, 0, 1, 1
8376, 1, 1636430803161, 1636430803429, 268, 1, 267, 0, 0, 0
8377, 1, 1636430803229, 1636430803501, 272, 1, 271, 0, 1, 1
8378, 1, 1636430803285, 1636430803557, 272, 0, 272, 0, 0, 0
8379, 1, 1636430803369, 1636430803641, 272, 0, 272, 0, 0, 0
8380, 1, 1636430803553, 1636430803822, 269, 1, 268, 0, 0, 0
8381, 1, 1636430803598, 1636430803865, 267, 0, 267, 0, 0, 0
8382, 1, 1636430803609, 1636430803881, 272, 1, 271, 0, 0, 0
8383, 1, 1636430803822, 1636430804089, 267, 0, 267, 0, 0, 0
8384, 1, 1636430803893, 1636430804166, 273, 1, 272, 1, 0, 1
8385, 1, 1636430803953, 1636430804225, 272, 1, 271, 1, 0, 1
8386, 1, 1636430804042, 1636430804309, 267, 0, 267, 0, 0, 0
8387, 1, 1636430804221, 1636430804485, 264, 0, 264, 0, 0, 0
8388, 1, 1636430804265, 1636430804530, 265, 1, 264, 0, 0, 0
8389, 1, 1636430804285, 1636430804558, 273, 0, 273, 0, 0, 0
8390, 1, 1636430804489, 1636430804757, 268, 0, 268, 0, 0, 0
8391, 1, 1636430804558, 1636430804833, 275, 0, 275, 0, 0, 0
8392, 1, 1636430804621, 1636430804893, 272, 1, 271, 0, 0, 0
8393, 1, 1636430804705, 1636430804977, 272, 1, 271, 0, 1, 1
8394, 1, 1636430804889, 1636430805161, 272, 1, 271, 0, 1, 1
8395, 1, 1636430804925, 1636430805201, 276, 1, 275, 1, 0, 1
8396, 1, 1636430804954, 1636430805225, 271, 0, 271, 0, 0, 0
8397, 1, 1636430805161, 1636430805438, 277, 1, 276, 0, 0, 0
8399, 1, 1636430805294, 1636430805565, 271, 0, 271, 0, 0, 0
8398, 1, 1636430805349, 1636430805617, 268, 0, 268, 0, 0, 0
8400, 1, 1636430805373, 1636430805642, 269, 1, 268, 0, 0, 0
8401, 1, 1636430805562, 1636430805834, 272, 0, 272, 0, 0, 0
8402, 1, 1636430805598, 1636430805869, 271, 0, 271, 0, 0, 0
8403, 1, 1636430805617, 1636430805889, 272, 0, 272, 0, 0, 0
8404, 1, 1636430805834, 1636430806101, 267, 0, 267, 0, 0, 0
8405, 1, 1636430805961, 1636430806225, 264, 0, 264, 0, 0, 0
8406, 1, 1636430806010, 1636430806282, 272, 0, 272, 0, 0, 0
8407, 1, 1636430806033, 1636430806305, 272, 1, 271, 0, 0, 0
8408, 1, 1636430806225, 1636430806489, 264, 0, 264, 0, 0, 0
8409, 1, 1636430806270, 1636430806533, 263, 0, 263, 0, 0, 0
8410, 1, 1636430806293, 1636430806566, 273, 0, 273, 0, 0, 0
8411, 1, 1636430806501, 1636430806774, 273, 0, 273, 0, 0, 0
8412, 1, 1636430806630, 1636430806901, 271, 0, 271, 0, 0, 0
8413, 1, 1636430806677, 1636430806942, 265, 0, 265, 0, 0, 0
8414, 1, 1636430806705, 1636430806977, 272, 1, 271, 0, 0, 0
8415, 1, 1636430806897, 1636430807166, 269, 1, 268, 1, 0, 1
8416, 1, 1636430806925, 1636430807198, 273, 1, 272, 1, 0, 1
8417, 1, 1636430807166, 1636430807441, 275, 0, 275, 0, 0, 0
8418, 1, 1636430807301, 1636430807573, 272, 0, 272, 0, 0, 0
8419, 1, 1636430807333, 1636430807605, 272, 1, 271, 0, 0, 0
8420, 1, 1636430807370, 1636430807641, 271, 0, 271, 0, 0, 0
8421, 1, 1636430807561, 1636430807833, 272, 1, 271, 0, 0, 0
8422, 1, 1636430807597, 1636430807861, 264, 1, 263, 0, 1, 1
8423, 1, 1636430807837, 1636430808101, 264, 1, 263, 0, 0, 0
8424, 1, 1636430807977, 1636430808253, 276, 1, 275, 0, 0, 0
8425, 1, 1636430808009, 1636430808285, 276, 1, 275, 1, 0, 1
8426, 1, 1636430808037, 1636430808309, 272, 1, 271, 0, 0, 0
8427, 1, 1636430808233, 1636430808498, 265, 0, 265, 0, 0, 0
8428, 1, 1636430808497, 1636430808765, 268, 1, 267, 0, 0, 0
8429, 1, 1636430808649, 1636430808913, 264, 0, 264, 0, 0, 0
8430, 1, 1636430808681, 1636430808945, 264, 0, 264, 0, 0, 0
8431, 1, 1636430808705, 1636430808969, 264, 1, 263, 0, 0, 0
8432, 1, 1636430808893, 1636430809162, 269, 1, 268, 1, 0, 1
8433, 1, 1636430809169, 1636430809446, 277, 1, 276, 0, 1, 1
8434, 1, 1636430809317, 1636430809602, 285, 0, 285, 0, 0, 0
8435, 1, 1636430809349, 1636430809621, 272, 1, 271, 0, 0, 0
8436, 1, 1636430809365, 1636430809645, 280, 0, 280, 0, 0, 0
8437, 1, 1636430809561, 1636430809829, 268, 0, 268, 0, 0, 0
8438, 1, 1636430809841, 1636430810109, 268, 0, 268, 0, 0, 0
8439, 1, 1636430810005, 1636430810273, 268, 0, 268, 0, 0, 0
8440, 1, 1636430810009, 1636430810273, 264, 0, 264, 0, 0, 0
8441, 1, 1636430810041, 1636430810309, 268, 0, 268, 0, 0, 0
8442, 1, 1636430810233, 1636430810501, 268, 0, 268, 0, 0, 0
8443, 1, 1636430810501, 1636430810765, 264, 0, 264, 0, 0, 0
8444, 1, 1636430810661, 1636430810925, 264, 1, 263, 0, 0, 0
8445, 1, 1636430810677, 1636430810949, 272, 0, 272, 0, 0, 0
8446, 1, 1636430810697, 1636430810957, 260, 0, 260, 0, 0, 0
8447, 1, 1636430810905, 1636430811177, 272, 1, 271, 0, 0, 0
8448, 1, 1636430811169, 1636430811441, 272, 1, 271, 0, 0, 0
8449, 1, 1636430811333, 1636430811605, 272, 1, 271, 0, 0, 0
8450, 1, 1636430811357, 1636430811637, 280, 1, 279, 0, 0, 0
8451, 1, 1636430811373, 1636430811646, 273, 1, 272, 0, 0, 0
8452, 1, 1636430811578, 1636430811849, 271, 0, 271, 0, 0, 0
8453, 1, 1636430811845, 1636430812109, 264, 0, 264, 0, 0, 0
8454, 1, 1636430812030, 1636430812297, 267, 0, 267, 0, 0, 0
8455, 1, 1636430812049, 1636430812321, 272, 1, 271, 0, 1, 1
8456, 1, 1636430812241, 1636430812513, 272, 0, 272, 0, 0, 0
8457, 1, 1636430812501, 1636430812774, 273, 1, 272, 0, 1, 1
8458, 1, 1636430812697, 1636430812969, 272, 1, 271, 0, 0, 0
8459, 1, 1636430812717, 1636430812989, 272, 1, 271, 0, 1, 1
8460, 1, 1636430812917, 1636430813189, 272, 0, 272, 0, 0, 0
8461, 1, 1636430813173, 1636430813445, 272, 1, 271, 1, 0, 1
8462, 1, 1636430813369, 1636430813641, 272, 1, 271, 1, 0, 1
8463, 1, 1636430813386, 1636430813661, 275, 0, 275, 0, 0, 0
8464, 1, 1636430813594, 1636430813865, 271, 0, 271, 0, 0, 0
8465, 1, 1636430813850, 1636430814117, 267, 0, 267, 0, 0, 0
8466, 1, 1636430814033, 1636430814305, 272, 0, 272, 0, 0, 0
8467, 1, 1636430814049, 1636430814325, 276, 0, 276, 0, 0, 0
8468, 1, 1636430814262, 1636430814533, 271, 0, 271, 0, 0, 0
8469, 1, 1636430814525, 1636430814798, 273, 0, 273, 0, 0, 0
8470, 1, 1636430814705, 1636430814977, 272, 1, 271, 0, 0, 0
8471, 1, 1636430814726, 1636430814997, 271, 0, 271, 0, 0, 0
8472, 1, 1636430814926, 1636430815197, 271, 0, 271, 0, 0, 0
8473, 1, 1636430815197, 1636430815465, 268, 1, 267, 1, 0, 1
8474, 1, 1636430815377, 1636430815645, 268, 1, 267, 0, 0, 0
8475, 1, 1636430815402, 1636430815669, 267, 0, 267, 0, 0, 0
8476, 1, 1636430815597, 1636430815873, 276, 0, 276, 0, 0, 0
8477, 1, 1636430815861, 1636430816125, 264, 1, 263, 0, 0, 0
8478, 1, 1636430816049, 1636430816317, 268, 1, 267, 0, 1, 1
8479, 1, 1636430816073, 1636430816341, 268, 1, 267, 1, 0, 1
8480, 1, 1636430816269, 1636430816537, 268, 0, 268, 0, 0, 0
8481, 1, 1636430816701, 1636430816973, 272, 0, 272, 0, 0, 0
8482, 1, 1636430816741, 1636430817014, 273, 0, 273, 0, 0, 0
8483, 1, 1636430816933, 1636430817206, 273, 0, 273, 0, 0, 0
8484, 1, 1636430817377, 1636430817645, 268, 0, 268, 0, 0, 0
8485, 1, 1636430817414, 1636430817685, 271, 0, 271, 0, 0, 0
8486, 1, 1636430817601, 1636430817865, 264, 1, 263, 0, 0, 0
8487, 1, 1636430818037, 1636430818305, 268, 1, 267, 0, 0, 0
8488, 1, 1636430818077, 1636430818349, 272, 1, 271, 0, 0, 0
8489, 1, 1636430818281, 1636430818545, 264, 0, 264, 0, 0, 0
8490, 1, 1636430818721, 1636430818997, 276, 0, 276, 0, 0, 0
8491, 1, 1636430818737, 1636430819005, 268, 1, 267, 1, 0, 1
8492, 1, 1636430818941, 1636430819217, 276, 1, 275, 0, 0, 0
8493, 1, 1636430819401, 1636430819673, 272, 1, 271, 0, 0, 0
8494, 1, 1636430819417, 1636430819690, 273, 0, 273, 0, 0, 0
8495, 1, 1636430819609, 1636430819885, 276, 1, 275, 0, 1, 1
8496, 1, 1636430820065, 1636430820337, 272, 0, 272, 0, 0, 0
8497, 1, 1636430820285, 1636430820557, 272, 1, 271, 1, 0, 1
8498, 1, 1636430820729, 1636430820993, 264, 1, 263, 1, 0, 1
8499, 1, 1636430820949, 1636430821221, 272, 1, 271, 0, 0, 0
8500, 1, 1636430821401, 1636430821666, 265, 0, 265, 0, 0, 0
8501, 1, 1636431074321, 1636431074594, 273, 1, 272, 0, 0, 0
8502, 1, 1636431074817, 1636431075094, 277, 0, 277, 0, 0, 0
8503, 1, 1636431075446, 1636431075717, 271, 0, 271, 0, 0, 0
8504, 1, 1636431075622, 1636431075893, 271, 0, 271, 0, 0, 0
8505, 1, 1636431075981, 1636431076254, 273, 1, 272, 1, 0, 1
8506, 1, 1636431076130, 1636431076402, 272, 0, 272, 0, 0, 0
8507, 1, 1636431076558, 1636431076829, 271, 0, 271, 0, 0, 0
8508, 1, 1636431076758, 1636431077030, 272, 0, 272, 0, 0, 0
8509, 1, 1636431076954, 1636431077226, 272, 0, 272, 0, 0, 0
8510, 1, 1636431077250, 1636431077521, 271, 0, 271, 0, 0, 0
8511, 1, 1636431077301, 1636431077574, 273, 0, 273, 0, 0, 0
8512, 1, 1636431077454, 1636431077726, 272, 0, 272, 0, 0, 0
8513, 1, 1636431077805, 1636431078073, 268, 1, 267, 0, 0, 0
8514, 1, 1636431077846, 1636431078117, 271, 0, 271, 0, 0, 0
8515, 1, 1636431078089, 1636431078362, 273, 0, 273, 0, 0, 0
8516, 1, 1636431078325, 1636431078593, 268, 0, 268, 0, 0, 0
8517, 1, 1636431078361, 1636431078637, 276, 1, 275, 0, 0, 0
8518, 1, 1636431078562, 1636431078837, 275, 0, 275, 0, 0, 0
8519, 1, 1636431078637, 1636431078913, 276, 1, 275, 0, 1, 1
8520, 1, 1636431078797, 1636431079069, 272, 0, 272, 0, 0, 0
8521, 1, 1636431078958, 1636431079229, 271, 0, 271, 0, 0, 0
8522, 1, 1636431079094, 1636431079365, 271, 0, 271, 0, 0, 0
8523, 1, 1636431079177, 1636431079450, 273, 1, 272, 0, 0, 0
8524, 1, 1636431079409, 1636431079681, 272, 1, 271, 0, 0, 0
8525, 1, 1636431079481, 1636431079761, 280, 1, 279, 0, 0, 0
8526, 1, 1636431079653, 1636431079921, 268, 0, 268, 0, 0, 0
8527, 1, 1636431079717, 1636431079990, 273, 1, 272, 0, 0, 0
8528, 1, 1636431079862, 1636431080138, 276, 0, 276, 0, 0, 0
8529, 1, 1636431080021, 1636431080293, 272, 1, 271, 0, 0, 0
8530, 1, 1636431080169, 1636431080445, 276, 1, 275, 0, 0, 0
8531, 1, 1636431080261, 1636431080538, 277, 0, 277, 0, 0, 0
8532, 1, 1636431080421, 1636431080693, 272, 1, 271, 1, 0, 1
8533, 1, 1636431080549, 1636431080822, 273, 0, 273, 0, 0, 0
8534, 1, 1636431080669, 1636431080941, 272, 0, 272, 0, 0, 0
8535, 1, 1636431080709, 1636431080982, 273, 1, 272, 1, 0, 1
8536, 1, 1636431080873, 1636431081146, 273, 0, 273, 0, 0, 0
8537, 1, 1636431080982, 1636431081254, 272, 0, 272, 0, 0, 0
8539, 1, 1636431081241, 1636431081514, 273, 1, 272, 1, 0, 1
8538, 1, 1636431081333, 1636431081601, 268, 0, 268, 0, 0, 0
8540, 1, 1636431081377, 1636431081649, 272, 0, 272, 0, 0, 0
8543, 1, 1636431081594, 1636431081865, 271, 0, 271, 0, 0, 0
8542, 1, 1636431081786, 1636431082057, 271, 0, 271, 0, 0, 0
8544, 1, 1636431081797, 1636431082069, 272, 0, 272, 0, 0, 0
8546, 1, 1636431081965, 1636431082234, 269, 1, 268, 0, 0, 0
8547, 1, 1636431082005, 1636431082277, 272, 0, 272, 0, 0, 0
8548, 1, 1636431082049, 1636431082317, 268, 1, 267, 0, 0, 0
8550, 1, 1636431082317, 1636431082586, 269, 0, 269, 0, 0, 0
8551, 1, 1636431082450, 1636431082726, 276, 0, 276, 0, 0, 0
8554, 1, 1636431082697, 1636431082970, 273, 1, 272, 1, 0, 1
8556, 1, 1636431082981, 1636431083253, 272, 1, 271, 0, 0, 0
8559, 1, 1636431083289, 1636431083561, 272, 1, 271, 1, 0, 1
8560, 1, 1636431083330, 1636431083601, 271, 0, 271, 0, 0, 0
8561, 1, 1636431083426, 1636431083697, 271, 0, 271, 0, 0, 0
8564, 1, 1636431083770, 1636431084041, 271, 0, 271, 0, 0, 0
8565, 1, 1636431084030, 1636431084302, 272, 0, 272, 0, 0, 0
8569, 1, 1636431084638, 1636431084910, 272, 0, 272, 0, 0, 0
8570, 1, 1636431084638, 1636431084910, 272, 0, 272, 0, 0, 0
8573, 1, 1636431085126, 1636431085394, 268, 0, 268, 0, 0, 0
8574, 1, 1636431085409, 1636431085682, 273, 1, 272, 0, 0, 0
8577, 1, 1636431086017, 1636431086290, 273, 0, 273, 0, 0, 0
8578, 1, 1636431086530, 1636431086801, 271, 0, 271, 0, 0, 0
8581, 1, 1636431087797, 1636431088069, 272, 1, 271, 0, 0, 0
8582, 1, 1636431089106, 1636431089378, 272, 0, 272, 0, 0, 0
8583, 1, 1636431090390, 1636431090662, 272, 0, 272, 0, 0, 0
8584, 1, 1636431091790, 1636431092062, 272, 0, 272, 0, 0, 0
8585, 1, 1636431092589, 1636431092861, 272, 1, 271, 1, 0, 1
8586, 1, 1636431092589, 1636431092861, 272, 1, 271, 0, 0, 0
8589, 1, 1636431093141, 1636431093414, 273, 0, 273, 0, 0, 0
8590, 1, 1636431093281, 1636431093549, 268, 1, 267, 0, 1, 1
8594, 1, 1636431093757, 1636431094021, 264, 0, 264, 0, 0, 0
8595, 1, 1636431093798, 1636431094110, 312, 0, 312, 0, 0, 0
8600, 1, 1636431094493, 1636431094765, 272, 0, 272, 0, 0, 0
8599, 1, 1636431094493, 1636431094765, 272, 0, 272, 0, 0, 0
8575, 1, 1636431095021, 1636431095293, 272, 0, 272, 0, 0, 0
8605, 1, 1636431095066, 1636431095333, 267, 0, 267, 0, 0, 0
8604, 1, 1636431095073, 1636431095345, 272, 1, 271, 0, 1, 1
8608, 1, 1636431095746, 1636431096022, 276, 0, 276, 0, 0, 0
8609, 1, 1636431095770, 1636431096041, 271, 0, 271, 0, 0, 0
8611, 1, 1636431096306, 1636431096578, 272, 0, 272, 0, 0, 0
8612, 1, 1636431096341, 1636431096614, 273, 1, 272, 0, 1, 1
8613, 1, 1636431097062, 1636431097334, 272, 0, 272, 0, 0, 0
8615, 1, 1636431097066, 1636431097334, 268, 0, 268, 0, 0, 0
8616, 1, 1636431097597, 1636431097874, 277, 1, 276, 0, 1, 1
8617, 1, 1636431097669, 1636431097942, 273, 1, 272, 1, 0, 1
8619, 1, 1636431098438, 1636431098710, 272, 0, 272, 0, 0, 0
8620, 1, 1636431098449, 1636431098717, 268, 0, 268, 0, 0, 0
8621, 1, 1636431098958, 1636431099230, 272, 0, 272, 0, 0, 0
8622, 1, 1636431098986, 1636431099257, 271, 0, 271, 0, 0, 0
8623, 1, 1636431099806, 1636431100078, 272, 0, 272, 0, 0, 0
8624, 1, 1636431099817, 1636431100093, 276, 1, 275, 0, 0, 0
8625, 1, 1636431100342, 1636431100614, 272, 0, 272, 0, 0, 0
8626, 1, 1636431100361, 1636431100633, 272, 0, 272, 0, 0, 0
8627, 1, 1636431101126, 1636431101398, 272, 0, 272, 0, 0, 0
8628, 1, 1636431101189, 1636431101462, 273, 1, 272, 0, 0, 0
8629, 1, 1636431101729, 1636431102001, 272, 1, 271, 0, 0, 0
8630, 1, 1636431101729, 1636431102002, 273, 1, 272, 0, 0, 0
8631, 1, 1636431102454, 1636431102726, 272, 0, 272, 0, 0, 0
8632, 1, 1636431102534, 1636431102806, 272, 0, 272, 0, 0, 0
8633, 1, 1636431103110, 1636431103433, 323, 0, 323, 0, 0, 0
8634, 1, 1636431103114, 1636431103438, 324, 0, 324, 0, 0, 0
8637, 1, 1636431103589, 1636431103854, 265, 1, 264, 1, 0, 1
8639, 1, 1636431103757, 1636431104070, 313, 1, 312, 0, 0, 0
8641, 1, 1636431103841, 1636431104162, 321, 1, 320, 0, 1, 1
8638, 1, 1636431104025, 1636431104293, 268, 1, 267, 0, 1, 1
8644, 1, 1636431104421, 1636431104698, 277, 1, 276, 1, 0, 1
8642, 1, 1636431104473, 1636431104773, 300, 0, 300, 0, 0, 0
8645, 1, 1636431104510, 1636431104777, 267, 0, 267, 0, 0, 0
8647, 1, 1636431104821, 1636431105121, 300, 1, 299, 1, 0, 1
8646, 1, 1636431104953, 1636431105221, 268, 0, 268, 0, 0, 0
8650, 1, 1636431105041, 1636431105314, 273, 1, 272, 0, 0, 0
8651, 1, 1636431105121, 1636431105393, 272, 1, 271, 0, 1, 1
8649, 1, 1636431105293, 1636431105562, 269, 0, 269, 0, 0, 0
8607, 1, 1636431105333, 1636431105605, 272, 1, 271, 0, 1, 1
8652, 1, 1636431105401, 1636431105677, 276, 1, 275, 0, 1, 1
8656, 1, 1636431105693, 1636431105966, 273, 0, 273, 0, 0, 0
8654, 1, 1636431105733, 1636431105998, 265, 0, 265, 0, 0, 0
8657, 1, 1636431105817, 1636431106089, 272, 0, 272, 0, 0, 0
8655, 1, 1636431105853, 1636431106126, 273, 1, 272, 0, 1, 1
8658, 1, 1636431106182, 1636431106454, 272, 0, 272, 0, 0, 0
8659, 1, 1636431106310, 1636431106582, 272, 0, 272, 0, 0, 0
8663, 1, 1636431106433, 1636431106705, 272, 0, 272, 0, 0, 0
8664, 1, 1636431106454, 1636431106726, 272, 0, 272, 0, 0, 0
8662, 1, 1636431106625, 1636431106894, 269, 1, 268, 0, 0, 0
8668, 1, 1636431107061, 1636431107329, 268, 1, 267, 0, 1, 1
8667, 1, 1636431107073, 1636431107342, 269, 0, 269, 0, 0, 0
8618, 1, 1636431107101, 1636431107366, 265, 1, 264, 0, 1, 1
8669, 1, 1636431107145, 1636431107417, 272, 0, 272, 0, 0, 0
8671, 1, 1636431107526, 1636431107806, 280, 0, 280, 0, 0, 0
8675, 1, 1636431107805, 1636431108078, 273, 1, 272, 0, 0, 0
8676, 1, 1636431107809, 1636431108086, 277, 0, 277, 0, 0, 0
8678, 1, 1636431108414, 1636431108689, 275, 0, 275, 0, 0, 0
8679, 1, 1636431108549, 1636431108822, 273, 1, 272, 0, 0, 0
8681, 1, 1636431109097, 1636431109370, 273, 1, 272, 0, 1, 1
8682, 1, 1636431109202, 1636431109474, 272, 0, 272, 0, 0, 0
8683, 1, 1636431109809, 1636431110082, 273, 1, 272, 0, 0, 0
8684, 1, 1636431109893, 1636431110165, 272, 1, 271, 0, 1, 1
8685, 1, 1636431110410, 1636431110682, 272, 0, 272, 0, 0, 0
8686, 1, 1636431110514, 1636431110785, 271, 0, 271, 0, 0, 0
8687, 1, 1636431111142, 1636431111413, 271, 0, 271, 0, 0, 0
8688, 1, 1636431111294, 1636431111566, 272, 0, 272, 0, 0, 0
8689, 1, 1636431111766, 1636431112038, 272, 0, 272, 0, 0, 0
8690, 1, 1636431111794, 1636431112070, 276, 0, 276, 0, 0, 0
8691, 1, 1636431112450, 1636431112722, 272, 0, 272, 0, 0, 0
8692, 1, 1636431112589, 1636431112862, 273, 1, 272, 0, 0, 0
8693, 1, 1636431113117, 1636431113457, 340, 0, 340, 0, 0, 0
8694, 1, 1636431113154, 1636431113457, 303, 0, 303, 0, 0, 0
8697, 1, 1636431113766, 1636431114041, 275, 0, 275, 0, 0, 0
8698, 1, 1636431113902, 1636431114174, 272, 0, 272, 0, 0, 0
8700, 1, 1636431114422, 1636431114694, 272, 0, 272, 0, 0, 0
8701, 1, 1636431114917, 1636431115185, 268, 0, 268, 0, 0, 0
8704, 1, 1636431115185, 1636431115458, 273, 1, 272, 0, 1, 1
8703, 1, 1636431115369, 1636431115641, 272, 1, 271, 0, 1, 1
8707, 1, 1636431115737, 1636431116010, 273, 1, 272, 0, 0, 0
8708, 1, 1636431115770, 1636431116042, 272, 0, 272, 0, 0, 0
8709, 1, 1636431116409, 1636431116682, 273, 1, 272, 1, 0, 1
8711, 1, 1636431116494, 1636431116773, 279, 0, 279, 0, 0, 0
8712, 1, 1636431116861, 1636431117138, 277, 1, 276, 0, 0, 0
8715, 1, 1636431117034, 1636431117333, 299, 0, 299, 0, 0, 0
8716, 1, 1636431117057, 1636431117333, 276, 1, 275, 0, 0, 0
8714, 1, 1636431117309, 1636431117582, 273, 0, 273, 0, 0, 0
8717, 1, 1636431117758, 1636431118026, 268, 0, 268, 0, 0, 0
8680, 1, 1636431118197, 1636431118470, 273, 1, 272, 0, 1, 1
8724, 1, 1636431118326, 1636431118598, 272, 0, 272, 0, 0, 0
8726, 1, 1636431118429, 1636431118701, 272, 0, 272, 0, 0, 0
8730, 1, 1636431119593, 1636431119866, 273, 0, 273, 0, 0, 0
8731, 1, 1636431119762, 1636431120033, 271, 0, 271, 0, 0, 0
8732, 1, 1636431120877, 1636431121150, 273, 0, 273, 0, 0, 0
8733, 1, 1636431121118, 1636431121389, 271, 0, 271, 0, 0, 0
8734, 1, 1636431122254, 1636431122526, 272, 0, 272, 0, 0, 0
8735, 1, 1636431122441, 1636431122717, 276, 1, 275, 0, 0, 0
8736, 1, 1636431123577, 1636431123865, 288, 0, 288, 0, 0, 0
8737, 1, 1636431123773, 1636431124050, 277, 0, 277, 0, 0, 0
8741, 1, 1636431124861, 1636431125133, 272, 0, 272, 0, 0, 0
8743, 1, 1636431125090, 1636431125406, 316, 0, 316, 0, 0, 0
8746, 1, 1636431126246, 1636431126561, 315, 0, 315, 0, 0, 0
8747, 1, 1636431126462, 1636431126733, 271, 0, 271, 0, 0, 0
8749, 1, 1636431127554, 1636431127826, 272, 0, 272, 0, 0, 0
8750, 1, 1636431127866, 1636431128214, 348, 0, 348, 0, 0, 0
8751, 1, 1636431128125, 1636431128425, 300, 0, 300, 0, 0, 0
8728, 1, 1636431128281, 1636431128549, 268, 1, 267, 1, 0, 1
8729, 1, 1636431128501, 1636431128773, 272, 0, 272, 0, 0, 0
8757, 1, 1636431128546, 1636431128821, 275, 0, 275, 0, 0, 0
8756, 1, 1636431128546, 1636431128821, 275, 0, 275, 0, 0, 0
8758, 1, 1636431128601, 1636431128865, 264, 0, 264, 0, 0, 0
8760, 1, 1636431128857, 1636431129129, 272, 1, 271, 1, 0, 1
8755, 1, 1636431128993, 1636431129261, 268, 1, 267, 0, 0, 0
8759, 1, 1636431128997, 1636431129269, 272, 0, 272, 0, 0, 0
8761, 1, 1636431129041, 1636431129306, 265, 0, 265, 0, 0, 0
8762, 1, 1636431129121, 1636431129393, 272, 1, 271, 0, 1, 1
8763, 1, 1636431129445, 1636431129717, 272, 1, 271, 0, 0, 0
8753, 1, 1636431129486, 1636431129757, 271, 0, 271, 0, 0, 0
8766, 1, 1636431129781, 1636431130049, 268, 0, 268, 0, 0, 0
8765, 1, 1636431129941, 1636431130213, 272, 1, 271, 1, 0, 1
8770, 1, 1636431130157, 1636431130425, 268, 1, 267, 0, 1, 1
8771, 1, 1636431130205, 1636431130473, 268, 0, 268, 0, 0, 0
8767, 1, 1636431130233, 1636431130505, 272, 1, 271, 0, 1, 1
8773, 1, 1636431130385, 1636431130654, 269, 1, 268, 0, 0, 0
8769, 1, 1636431130393, 1636431130657, 264, 1, 263, 0, 0, 0
8774, 1, 1636431130837, 1636431131110, 273, 1, 272, 1, 0, 1
8776, 1, 1636431131113, 1636431131386, 273, 0, 273, 0, 0, 0
8779, 1, 1636431131478, 1636431131745, 267, 0, 267, 0, 0, 0
8777, 1, 1636431131566, 1636431131833, 267, 0, 267, 0, 0, 0
8780, 1, 1636431131566, 1636431131833, 267, 0, 267, 0, 0, 0
8781, 1, 1636431131745, 1636431132013, 268, 0, 268, 0, 0, 0
8783, 1, 1636431132494, 1636431132765, 271, 0, 271, 0, 0, 0
8785, 1, 1636431132761, 1636431133030, 269, 1, 268, 1, 0, 1
8786, 1, 1636431132922, 1636431133193, 271, 0, 271, 0, 0, 0
8784, 1, 1636431132942, 1636431133214, 272, 0, 272, 0, 0, 0
8787, 1, 1636431133106, 1636431133377, 271, 0, 271, 0, 0, 0
8788, 1, 1636431133810, 1636431134090, 280, 0, 280, 0, 0, 0
8790, 1, 1636431134090, 1636431134362, 272, 0, 272, 0, 0, 0
8789, 1, 1636431134265, 1636431134561, 296, 1, 295, 1, 0, 1
8793, 1, 1636431134306, 1636431134577, 271, 0, 271, 0, 0, 0
8794, 1, 1636431134382, 1636431134654, 272, 0, 272, 0, 0, 0
8796, 1, 1636431135094, 1636431135366, 272, 0, 272, 0, 0, 0
8799, 1, 1636431135382, 1636431135654, 272, 0, 272, 0, 0, 0
8797, 1, 1636431135541, 1636431135817, 276, 0, 276, 0, 0, 0
8800, 1, 1636431135705, 1636431135973, 268, 0, 268, 0, 0, 0
8801, 1, 1636431135750, 1636431136033, 283, 0, 283, 0, 0, 0
8804, 1, 1636431136474, 1636431136745, 271, 0, 271, 0, 0, 0
8806, 1, 1636431136726, 1636431136997, 271, 0, 271, 0, 0, 0
8805, 1, 1636431136922, 1636431137197, 275, 0, 275, 0, 0, 0
8807, 1, 1636431137041, 1636431137354, 313, 1, 312, 0, 0, 0
8808, 1, 1636431137114, 1636431137386, 272, 0, 272, 0, 0, 0
8810, 1, 1636431137826, 1636431138105, 279, 0, 279, 0, 0, 0
8811, 1, 1636431138290, 1636431138561, 271, 0, 271, 0, 0, 0
8813, 1, 1636431138425, 1636431138693, 268, 0, 268, 0, 0, 0
8815, 1, 1636431138470, 1636431138738, 268, 0, 268, 0, 0, 0
8812, 1, 1636431138738, 1636431139010, 272, 0, 272, 0, 0, 0
8817, 1, 1636431139186, 1636431139457, 271, 0, 271, 0, 0, 0
8819, 1, 1636431139457, 1636431139729, 272, 1, 271, 1, 0, 1
8818, 1, 1636431139637, 1636431139910, 273, 1, 272, 0, 1, 1
8821, 1, 1636431139661, 1636431139965, 304, 1, 303, 1, 0, 1
8822, 1, 1636431139785, 1636431140061, 276, 0, 276, 0, 0, 0
8824, 1, 1636431140462, 1636431140734, 272, 0, 272, 0, 0, 0
8827, 1, 1636431140826, 1636431141118, 292, 0, 292, 0, 0, 0
8826, 1, 1636431140914, 1636431141209, 295, 0, 295, 0, 0, 0
8829, 1, 1636431141165, 1636431141438, 273, 0, 273, 0, 0, 0
8828, 1, 1636431141789, 1636431142065, 276, 0, 276, 0, 0, 0
8832, 1, 1636431141833, 1636431142106, 273, 0, 273, 0, 0, 0
8835, 1, 1636431142134, 1636431142401, 267, 0, 267, 0, 0, 0
8833, 1, 1636431142285, 1636431142554, 269, 1, 268, 0, 1, 1
8836, 1, 1636431142465, 1636431142738, 273, 0, 273, 0, 0, 0
8838, 1, 1636431143069, 1636431143342, 273, 1, 272, 0, 0, 0
8840, 1, 1636431143454, 1636431143726, 272, 0, 272, 0, 0, 0
8839, 1, 1636431143526, 1636431143798, 272, 0, 272, 0, 0, 0
8841, 1, 1636431143773, 1636431144046, 273, 1, 272, 0, 0, 0
8846, 1, 1636431144826, 1636431145094, 268, 0, 268, 0, 0, 0
8848, 1, 1636431145109, 1636431145390, 281, 1, 280, 0, 0, 0
8850, 1, 1636431146109, 1636431146382, 273, 0, 273, 0, 0, 0
8852, 1, 1636431146446, 1636431146717, 271, 0, 271, 0, 0, 0
8854, 1, 1636431147486, 1636431147753, 267, 0, 267, 0, 0, 0
8856, 1, 1636431147797, 1636431148070, 273, 1, 272, 0, 0, 0
8858, 1, 1636431148822, 1636431149093, 271, 0, 271, 0, 0, 0
8860, 1, 1636431149070, 1636431149342, 272, 0, 272, 0, 0, 0
8862, 1, 1636431150226, 1636431150497, 271, 0, 271, 0, 0, 0
8863, 1, 1636431150386, 1636431150677, 291, 0, 291, 0, 0, 0
8866, 1, 1636431151517, 1636431151817, 300, 0, 300, 0, 0, 0
8867, 1, 1636431151682, 1636431151954, 272, 0, 272, 0, 0, 0
8871, 1, 1636431152757, 1636431153026, 269, 1, 268, 1, 0, 1
8872, 1, 1636431152769, 1636431153038, 269, 0, 269, 0, 0, 0
8873, 1, 1636431152958, 1636431153230, 272, 0, 272, 0, 0, 0
8874, 1, 1636431153970, 1636431154242, 272, 0, 272, 0, 0, 0
8875, 1, 1636431154157, 1636431154501, 344, 1, 343, 0, 1, 1
8876, 1, 1636431154261, 1636431154593, 332, 1, 331, 0, 1, 1
8879, 1, 1636431154946, 1636431155222, 276, 0, 276, 0, 0, 0
8882, 1, 1636431155369, 1636431155642, 273, 0, 273, 0, 0, 0
8883, 1, 1636431155549, 1636431155829, 280, 1, 279, 0, 0, 0
8884, 1, 1636431155597, 1636431155869, 272, 0, 272, 0, 0, 0
8886, 1, 1636431156178, 1636431156450, 272, 0, 272, 0, 0, 0
8888, 1, 1636431156745, 1636431157017, 272, 1, 271, 0, 1, 1
8889, 1, 1636431156862, 1636431157133, 271, 0, 271, 0, 0, 0
8891, 1, 1636431156885, 1636431157157, 272, 0, 272, 0, 0, 0
8892, 1, 1636431157438, 1636431157710, 272, 0, 272, 0, 0, 0
8894, 1, 1636431158094, 1636431158366, 272, 0, 272, 0, 0, 0
8895, 1, 1636431158170, 1636431158442, 272, 0, 272, 0, 0, 0
8896, 1, 1636431158233, 1636431158505, 272, 0, 272, 0, 0, 0
8897, 1, 1636431158738, 1636431159038, 300, 0, 300, 0, 0, 0
8900, 1, 1636431159409, 1636431159682, 273, 1, 272, 0, 0, 0
8901, 1, 1636431159497, 1636431159769, 272, 1, 271, 0, 0, 0
8902, 1, 1636431159606, 1636431159882, 276, 0, 276, 0, 0, 0
8903, 1, 1636431160093, 1636431160366, 273, 1, 272, 0, 1, 1
8906, 1, 1636431160805, 1636431161077, 272, 1, 271, 0, 0, 0
8907, 1, 1636431160897, 1636431161166, 269, 0, 269, 0, 0, 0
8908, 1, 1636431160942, 1636431161213, 271, 0, 271, 0, 0, 0
8910, 1, 1636431161441, 1636431161714, 273, 0, 273, 0, 0, 0
8870, 1, 1636431161985, 1636431162250, 265, 0, 265, 0, 0, 0
8912, 1, 1636431162150, 1636431162421, 271, 0, 271, 0, 0, 0
8913, 1, 1636431162173, 1636431162445, 272, 1, 271, 0, 0, 0
8914, 1, 1636431162185, 1636431162458, 273, 1, 272, 0, 0, 0
8917, 1, 1636431162810, 1636431163082, 272, 0, 272, 0, 0, 0
8918, 1, 1636431163430, 1636431163702, 272, 0, 272, 0, 0, 0
8919, 1, 1636431163449, 1636431163722, 273, 0, 273, 0, 0, 0
8920, 1, 1636431163577, 1636431163850, 273, 1, 272, 1, 0, 1
8921, 1, 1636431164158, 1636431164430, 272, 0, 272, 0, 0, 0
8922, 1, 1636431164813, 1636431165081, 268, 1, 267, 0, 0, 0
8923, 1, 1636431164817, 1636431165085, 268, 0, 268, 0, 0, 0
8924, 1, 1636431164989, 1636431165257, 268, 0, 268, 0, 0, 0
8925, 1, 1636431165033, 1636431165305, 272, 1, 271, 0, 0, 0
8926, 1, 1636431165481, 1636431165754, 273, 0, 273, 0, 0, 0
8927, 1, 1636431165494, 1636431165765, 271, 0, 271, 0, 0, 0
8930, 1, 1636431166014, 1636431166285, 271, 0, 271, 0, 0, 0
8932, 1, 1636431166133, 1636431166406, 273, 1, 272, 1, 0, 1
8933, 1, 1636431166242, 1636431166542, 300, 0, 300, 0, 0, 0
8934, 1, 1636431166290, 1636431166558, 268, 0, 268, 0, 0, 0
8935, 1, 1636431166738, 1636431167050, 312, 0, 312, 0, 0, 0
8937, 1, 1636431166785, 1636431167058, 273, 0, 273, 0, 0, 0
8939, 1, 1636431167369, 1636431167641, 272, 1, 271, 0, 0, 0
8940, 1, 1636431167449, 1636431167722, 273, 0, 273, 0, 0, 0
8941, 1, 1636431167570, 1636431167837, 267, 0, 267, 0, 0, 0
8942, 1, 1636431167641, 1636431167914, 273, 0, 273, 0, 0, 0
8943, 1, 1636431168097, 1636431168370, 273, 0, 273, 0, 0, 0
8946, 1, 1636431168757, 1636431169033, 276, 1, 275, 0, 0, 0
8947, 1, 1636431168821, 1636431169093, 272, 1, 271, 0, 1, 1
8948, 1, 1636431168890, 1636431169173, 283, 0, 283, 0, 0, 0
8949, 1, 1636431168994, 1636431169261, 267, 0, 267, 0, 0, 0
8950, 1, 1636431169445, 1636431169717, 272, 0, 272, 0, 0, 0
8953, 1, 1636431170026, 1636431170289, 263, 0, 263, 0, 0, 0
8954, 1, 1636431170105, 1636431170373, 268, 1, 267, 0, 0, 0
8955, 1, 1636431170189, 1636431170462, 273, 0, 273, 0, 0, 0
8956, 1, 1636431170362, 1636431170634, 272, 0, 272, 0, 0, 0
8957, 1, 1636431170809, 1636431171082, 273, 1, 272, 0, 0, 0
8960, 1, 1636431171310, 1636431171577, 267, 0, 267, 0, 0, 0
8961, 1, 1636431171390, 1636431171657, 267, 0, 267, 0, 0, 0
8963, 1, 1636431171474, 1636431171741, 267, 0, 267, 0, 0, 0
8964, 1, 1636431171717, 1636431171989, 272, 1, 271, 0, 0, 0
8965, 1, 1636431172165, 1636431172438, 273, 1, 272, 0, 0, 0
8968, 1, 1636431172605, 1636431172882, 277, 1, 276, 0, 0, 0
8944, 1, 1636431172646, 1636431172917, 271, 0, 271, 0, 0, 0
8969, 1, 1636431172738, 1636431173010, 272, 0, 272, 0, 0, 0
8970, 1, 1636431172785, 1636431173057, 272, 0, 272, 0, 0, 0
8972, 1, 1636431173078, 1636431173346, 268, 0, 268, 0, 0, 0
8974, 1, 1636431173322, 1636431173594, 272, 0, 272, 0, 0, 0
8973, 1, 1636431173530, 1636431173802, 272, 0, 272, 0, 0, 0
8975, 1, 1636431173894, 1636431174165, 271, 0, 271, 0, 0, 0
8976, 1, 1636431174066, 1636431174338, 272, 0, 272, 0, 0, 0
8977, 1, 1636431174117, 1636431174385, 268, 1, 267, 0, 0, 0
8978, 1, 1636431174393, 1636431174662, 269, 1, 268, 0, 0, 0
8980, 1, 1636431174581, 1636431174854, 273, 1, 272, 0, 0, 0
8979, 1, 1636431174842, 1636431175114, 272, 0, 272, 0, 0, 0
8981, 1, 1636431175201, 1636431175473, 272, 1, 271, 0, 0, 0
8982, 1, 1636431175341, 1636431175621, 280, 1, 279, 0, 0, 0
8983, 1, 1636431175425, 1636431175693, 268, 0, 268, 0, 0, 0
8984, 1, 1636431175705, 1636431175981, 276, 1, 275, 0, 0, 0
8986, 1, 1636431175914, 1636431176205, 291, 0, 291, 0, 0, 0
8987, 1, 1636431176013, 1636431176298, 285, 1, 284, 0, 0, 0
8985, 1, 1636431176161, 1636431176422, 261, 0, 261, 0, 0, 0
8989, 1, 1636431176477, 1636431176749, 272, 1, 271, 1, 0, 1
8990, 1, 1636431176529, 1636431176793, 264, 1, 263, 0, 0, 0
8991, 1, 1636431176641, 1636431176945, 304, 1, 303, 0, 0, 0
8992, 1, 1636431176761, 1636431177029, 268, 1, 267, 0, 0, 0
8988, 1, 1636431176925, 1636431177193, 268, 0, 268, 0, 0, 0
8993, 1, 1636431176933, 1636431177201, 268, 0, 268, 0, 0, 0
8997, 1, 1636431177301, 1636431177570, 269, 1, 268, 0, 0, 0
8996, 1, 1636431177301, 1636431177570, 269, 1, 268, 0, 0, 0
8995, 1, 1636431177369, 1636431177641, 272, 1, 271, 0, 0, 0
8994, 1, 1636431177373, 1636431177645, 272, 1, 271, 1, 0, 1
8999, 1, 1636431177593, 1636431177862, 269, 1, 268, 0, 1, 1
9000, 1, 1636431177753, 1636431178026, 273, 1, 272, 0, 1, 1
9001, 1, 1636431177821, 1636431178093, 272, 1, 271, 0, 0, 0
8998, 1, 1636431177821, 1636431178093, 272, 1, 271, 0, 1, 1
9002, 1, 1636431177985, 1636431178257, 272, 1, 271, 0, 0, 0
9003, 1, 1636431178037, 1636431178305, 268, 1, 267, 0, 0, 0
9004, 1, 1636431178333, 1636431178606, 273, 1, 272, 0, 0, 0
9005, 1, 1636431178406, 1636431178682, 276, 0, 276, 0, 0, 0
9007, 1, 1636431178609, 1636431178877, 268, 0, 268, 0, 0, 0
9008, 1, 1636431178657, 1636431178930, 273, 1, 272, 0, 0, 0
9009, 1, 1636431178762, 1636431179025, 263, 0, 263, 0, 0, 0
9006, 1, 1636431178777, 1636431179041, 264, 1, 263, 1, 0, 1
9011, 1, 1636431178825, 1636431179097, 272, 1, 271, 0, 0, 0
9010, 1, 1636431178858, 1636431179130, 272, 0, 272, 0, 0, 0
9012, 1, 1636431179113, 1636431179381, 268, 1, 267, 1, 0, 1
9013, 1, 1636431179221, 1636431179489, 268, 1, 267, 0, 1, 1
9014, 1, 1636431179297, 1636431179574, 277, 1, 276, 0, 0, 0
9015, 1, 1636431179469, 1636431179746, 277, 1, 276, 0, 1, 1
9016, 1, 1636431179650, 1636431179922, 272, 0, 272, 0, 0, 0
9017, 1, 1636431179650, 1636431179922, 272, 0, 272, 0, 0, 0
9019, 1, 1636431179753, 1636431180029, 276, 0, 276, 0, 0, 0
9021, 1, 1636431179917, 1636431180186, 269, 0, 269, 0, 0, 0
9022, 1, 1636431179938, 1636431180201, 263, 0, 263, 0, 0, 0
9023, 1, 1636431180009, 1636431180277, 268, 0, 268, 0, 0, 0
9018, 1, 1636431180097, 1636431180366, 269, 1, 268, 1, 0, 1
9020, 1, 1636431180097, 1636431180366, 269, 1, 268, 0, 0, 0
9025, 1, 1636431180209, 1636431180513, 304, 1, 303, 0, 1, 1
9026, 1, 1636431180422, 1636431180693, 271, 0, 271, 0, 0, 0
9024, 1, 1636431180542, 1636431180813, 271, 0, 271, 0, 0, 0
9027, 1, 1636431180557, 1636431180829, 272, 1, 271, 0, 0, 0
9028, 1, 1636431180633, 1636431180906, 273, 0, 273, 0, 0, 0
9030, 1, 1636431180798, 1636431181090, 292, 0, 292, 0, 0, 0
9031, 1, 1636431180906, 1636431181181, 275, 0, 275, 0, 0, 0
9029, 1, 1636431180997, 1636431181273, 276, 0, 276, 0, 0, 0
9032, 1, 1636431181001, 1636431181277, 276, 0, 276, 0, 0, 0
9033, 1, 1636431181029, 1636431181301, 272, 1, 271, 0, 1, 1
9036, 1, 1636431181217, 1636431181521, 304, 0, 304, 0, 0, 0
9037, 1, 1636431181298, 1636431181613, 315, 0, 315, 0, 0, 0
9035, 1, 1636431181361, 1636431181641, 280, 0, 280, 0, 0, 0
9039, 1, 1636431181433, 1636431181701, 268, 0, 268, 0, 0, 0
9038, 1, 1636431181445, 1636431181714, 269, 0, 269, 0, 0, 0
9034, 1, 1636431181457, 1636431181733, 276, 0, 276, 0, 0, 0
9041, 1, 1636431181517, 1636431181789, 272, 0, 272, 0, 0, 0
9040, 1, 1636431181517, 1636431181789, 272, 0, 272, 0, 0, 0
9042, 1, 1636431181697, 1636431181969, 272, 1, 271, 1, 0, 1
9044, 1, 1636431181845, 1636431182117, 272, 1, 271, 0, 0, 0
9043, 1, 1636431181893, 1636431182162, 269, 0, 269, 0, 0, 0
9045, 1, 1636431182021, 1636431182293, 272, 1, 271, 0, 1, 1
9046, 1, 1636431182061, 1636431182333, 272, 1, 271, 0, 1, 1
9047, 1, 1636431182173, 1636431182474, 301, 1, 300, 0, 0, 0
9049, 1, 1636431182333, 1636431182645, 312, 1, 311, 0, 1, 1
9053, 1, 1636431182557, 1636431182825, 268, 0, 268, 0, 0, 0
8971, 1, 1636431182598, 1636431182861, 263, 0, 263, 0, 0, 0
9054, 1, 1636431182641, 1636431182905, 264, 1, 263, 0, 0, 0
9055, 1, 1636431182641, 1636431182909, 268, 1, 267, 0, 0, 0
9056, 1, 1636431182689, 1636431182949, 260, 0, 260, 0, 0, 0
9058, 1, 1636431182821, 1636431183093, 272, 0, 272, 0, 0, 0
9060, 1, 1636431182886, 1636431183158, 272, 0, 272, 0, 0, 0
9061, 1, 1636431183005, 1636431183265, 260, 1, 259, 0, 1, 1
9059, 1, 1636431183081, 1636431183353, 272, 0, 272, 0, 0, 0
9062, 1, 1636431183090, 1636431183357, 267, 0, 267, 0, 0, 0
9063, 1, 1636431183137, 1636431183409, 272, 1, 271, 1, 0, 1
9065, 1, 1636431183361, 1636431183633, 272, 1, 271, 1, 0, 1
9057, 1, 1636431183445, 1636431183722, 277, 0, 277, 0, 0, 0
9067, 1, 1636431183453, 1636431183725, 272, 1, 271, 0, 0, 0
9064, 1, 1636431183533, 1636431183805, 272, 1, 271, 1, 0, 1
9068, 1, 1636431183897, 1636431184161, 264, 0, 264, 0, 0, 0
9069, 1, 1636431183894, 1636431184161, 267, 0, 267, 0, 0, 0
9070, 1, 1636431183941, 1636431184206, 265, 0, 265, 0, 0, 0
9071, 1, 1636431183977, 1636431184249, 272, 1, 271, 1, 0, 1
9073, 1, 1636431184121, 1636431184389, 268, 0, 268, 0, 0, 0
9076, 1, 1636431184249, 1636431184526, 277, 1, 276, 1, 0, 1
9075, 1, 1636431184341, 1636431184613, 272, 1, 271, 0, 1, 1
9074, 1, 1636431184341, 1636431184613, 272, 1, 271, 0, 0, 0
9077, 1, 1636431184386, 1636431184658, 272, 0, 272, 0, 0, 0
9079, 1, 1636431184486, 1636431184761, 275, 0, 275, 0, 0, 0
9081, 1, 1636431184753, 1636431185021, 268, 0, 268, 0, 0, 0
9080, 1, 1636431184794, 1636431185065, 271, 0, 271, 0, 0, 0
9082, 1, 1636431184841, 1636431185105, 264, 1, 263, 0, 0, 0
9083, 1, 1636431185017, 1636431185285, 268, 0, 268, 0, 0, 0
9084, 1, 1636431185237, 1636431185513, 276, 1, 275, 1, 0, 1
9086, 1, 1636431185353, 1636431185625, 272, 1, 271, 1, 0, 1
9087, 1, 1636431185473, 1636431185741, 268, 1, 267, 0, 0, 0
9088, 1, 1636431185473, 1636431185749, 276, 1, 275, 0, 1, 1
9090, 1, 1636431185593, 1636431185861, 268, 0, 268, 0, 0, 0
9091, 1, 1636431185694, 1636431185961, 267, 0, 267, 0, 0, 0
9092, 1, 1636431185781, 1636431186054, 273, 0, 273, 0, 0, 0
9094, 1, 1636431186154, 1636431186425, 271, 0, 271, 0, 0, 0
9095, 1, 1636431186217, 1636431186489, 272, 1, 271, 0, 1, 1
9096, 1, 1636431186314, 1636431186581, 267, 0, 267, 0, 0, 0
9097, 1, 1636431186633, 1636431186901, 268, 0, 268, 0, 0, 0
9098, 1, 1636431186713, 1636431186985, 272, 1, 271, 0, 0, 0
9099, 1, 1636431186761, 1636431187030, 269, 0, 269, 0, 0, 0
9100, 1, 1636431186841, 1636431187117, 276, 1, 275, 0, 0, 0
9101, 1, 1636431186901, 1636431187165, 264, 0, 264, 0, 0, 0
9102, 1, 1636431187085, 1636431187353, 268, 1, 267, 0, 1, 1
9103, 1, 1636431187094, 1636431187361, 267, 0, 267, 0, 0, 0
9104, 1, 1636431187485, 1636431187758, 273, 1, 272, 0, 1, 1
9105, 1, 1636431187577, 1636431187845, 268, 0, 268, 0, 0, 0
9106, 1, 1636431187665, 1636431187930, 265, 1, 264, 0, 0, 0
9107, 1, 1636431187949, 1636431188218, 269, 0, 269, 0, 0, 0
9108, 1, 1636431187997, 1636431188262, 265, 1, 264, 0, 1, 1
9109, 1, 1636431188157, 1636431188417, 260, 0, 260, 0, 0, 0
9110, 1, 1636431188201, 1636431188457, 256, 0, 256, 0, 0, 0
9111, 1, 1636431188234, 1636431188490, 256, 0, 256, 0, 0, 0
9112, 1, 1636431188397, 1636431188657, 260, 1, 259, 0, 0, 0
9113, 1, 1636431188481, 1636431188742, 261, 0, 261, 0, 0, 0
9114, 1, 1636431188829, 1636431189105, 276, 0, 276, 0, 0, 0
9115, 1, 1636431188890, 1636431189157, 267, 0, 267, 0, 0, 0
9116, 1, 1636431188921, 1636431189190, 269, 1, 268, 1, 0, 1
9117, 1, 1636431189245, 1636431189501, 256, 1, 255, 0, 1, 1
9118, 1, 1636431189281, 1636431189541, 260, 1, 259, 0, 1, 1
9119, 1, 1636431189450, 1636431189714, 264, 0, 264, 0, 0, 0
9120, 1, 1636431189554, 1636431189817, 263, 0, 263, 0, 0, 0
9121, 1, 1636431189597, 1636431189865, 268, 0, 268, 0, 0, 0
9122, 1, 1636431189681, 1636431189950, 269, 1, 268, 0, 0, 0
9123, 1, 1636431189821, 1636431190086, 265, 0, 265, 0, 0, 0
9124, 1, 1636431190149, 1636431190406, 257, 1, 256, 0, 0, 0
9125, 1, 1636431190225, 1636431190482, 257, 0, 257, 0, 0, 0
9126, 1, 1636431190269, 1636431190525, 256, 1, 255, 1, 0, 1
9127, 1, 1636431190617, 1636431190885, 268, 0, 268, 0, 0, 0
9128, 1, 1636431190662, 1636431190933, 271, 0, 271, 0, 0, 0
9129, 1, 1636431190741, 1636431191006, 265, 1, 264, 0, 0, 0
9130, 1, 1636431190821, 1636431191082, 261, 1, 260, 1, 0, 1
9131, 1, 1636431190973, 1636431191229, 256, 0, 256, 0, 0, 0
9132, 1, 1636431191065, 1636431191321, 256, 1, 255, 0, 1, 1
9133, 1, 1636431191225, 1636431191489, 264, 1, 263, 0, 0, 0
9134, 1, 1636431191549, 1636431191822, 273, 0, 273, 0, 0, 0
9135, 1, 1636431191585, 1636431191841, 256, 0, 256, 0, 0, 0
9136, 1, 1636431191622, 1636431191881, 259, 0, 259, 0, 0, 0
9137, 1, 1636431191989, 1636431192257, 268, 1, 267, 0, 0, 0
9138, 1, 1636431192054, 1636431192322, 268, 0, 268, 0, 0, 0
9139, 1, 1636431192117, 1636431192473, 356, 0, 356, 0, 0, 0
9140, 1, 1636431192221, 1636431192577, 356, 0, 356, 0, 0, 0
9141, 1, 1636431192429, 1636431192685, 256, 1, 255, 0, 1, 1
9142, 1, 1636431192493, 1636431192753, 260, 0, 260, 0, 0, 0
9143, 1, 1636431192517, 1636431192773, 256, 0, 256, 0, 0, 0
9145, 1, 1636431192705, 1636431192961, 256, 1, 255, 0, 0, 0
9146, 1, 1636431192885, 1636431193146, 261, 1, 260, 1, 0, 1
9147, 1, 1636431192901, 1636431193161, 260, 1, 259, 0, 0, 0
9149, 1, 1636431192953, 1636431193209, 256, 0, 256, 0, 0, 0
9150, 1, 1636431192961, 1636431193221, 260, 1, 259, 0, 0, 0
9144, 1, 1636431193137, 1636431193405, 268, 1, 267, 0, 0, 0
9151, 1, 1636431193269, 1636431193554, 285, 0, 285, 0, 0, 0
9152, 1, 1636431193386, 1636431193649, 263, 0, 263, 0, 0, 0
9148, 1, 1636431193386, 1636431193649, 263, 0, 263, 0, 0, 0
9153, 1, 1636431193509, 1636431193765, 256, 1, 255, 1, 0, 1
9154, 1, 1636431193589, 1636431193853, 264, 0, 264, 0, 0, 0
9158, 1, 1636431193798, 1636431194089, 291, 0, 291, 0, 0, 0
9155, 1, 1636431193829, 1636431194093, 264, 1, 263, 0, 0, 0
9159, 1, 1636431193942, 1636431194213, 271, 0, 271, 0, 0, 0
9161, 1, 1636431194181, 1636431194441, 260, 1, 259, 1, 0, 1
9162, 1, 1636431194205, 1636431194505, 300, 0, 300, 0, 0, 0
9165, 1, 1636431194249, 1636431194509, 260, 1, 259, 1, 0, 1
9166, 1, 1636431194341, 1636431194605, 264, 1, 263, 0, 0, 0
9160, 1, 1636431194425, 1636431194682, 257, 0, 257, 0, 0, 0
9167, 1, 1636431194601, 1636431194869, 268, 0, 268, 0, 0, 0
9163, 1, 1636431194681, 1636431194957, 276, 1, 275, 0, 0, 0
9169, 1, 1636431194781, 1636431195053, 272, 1, 271, 1, 0, 1
9171, 1, 1636431194961, 1636431195238, 277, 0, 277, 0, 0, 0
9173, 1, 1636431195138, 1636431195413, 275, 0, 275, 0, 0, 0
9174, 1, 1636431195225, 1636431195497, 272, 1, 271, 0, 0, 0
9178, 1, 1636431195577, 1636431195853, 276, 1, 275, 0, 0, 0
9177, 1, 1636431195577, 1636431195854, 277, 0, 277, 0, 0, 0
9172, 1, 1636431195585, 1636431195857, 272, 0, 272, 0, 0, 0
9176, 1, 1636431195577, 1636431195857, 280, 1, 279, 1, 0, 1
9179, 1, 1636431195622, 1636431195889, 267, 0, 267, 0, 0, 0
9175, 1, 1636431195669, 1636431195937, 268, 0, 268, 0, 0, 0
9183, 1, 1636431195917, 1636431196190, 273, 0, 273, 0, 0, 0
9168, 1, 1636431195957, 1636431196233, 276, 0, 276, 0, 0, 0
9180, 1, 1636431196033, 1636431196297, 264, 1, 263, 0, 0, 0
9181, 1, 1636431196034, 1636431196305, 271, 0, 271, 0, 0, 0
9182, 1, 1636431196034, 1636431196305, 271, 0, 271, 0, 0, 0
9188, 1, 1636431196382, 1636431196649, 267, 0, 267, 0, 0, 0
9187, 1, 1636431196473, 1636431196741, 268, 0, 268, 0, 0, 0
9186, 1, 1636431196485, 1636431196753, 268, 1, 267, 0, 1, 1
9184, 1, 1636431196485, 1636431196753, 268, 1, 267, 0, 0, 0
9189, 1, 1636431196570, 1636431196842, 272, 0, 272, 0, 0, 0
9190, 1, 1636431196629, 1636431196901, 272, 0, 272, 0, 0, 0
9194, 1, 1636431196893, 1636431197161, 268, 0, 268, 0, 0, 0
9195, 1, 1636431196901, 1636431197165, 264, 0, 264, 0, 0, 0
9192, 1, 1636431196933, 1636431197209, 276, 0, 276, 0, 0, 0
9197, 1, 1636431196949, 1636431197222, 273, 1, 272, 0, 0, 0
9193, 1, 1636431197021, 1636431197293, 272, 1, 271, 0, 0, 0
9199, 1, 1636431197222, 1636431197493, 271, 0, 271, 0, 0, 0
9196, 1, 1636431197341, 1636431197617, 276, 0, 276, 0, 0, 0
9198, 1, 1636431197381, 1636431197653, 272, 1, 271, 0, 1, 1
9200, 1, 1636431197397, 1636431197673, 276, 1, 275, 0, 1, 1
9191, 1, 1636431197473, 1636431197749, 276, 0, 276, 0, 0, 0
9203, 1, 1636431197713, 1636431197977, 264, 1, 263, 0, 0, 0
9202, 1, 1636431197797, 1636431198061, 264, 0, 264, 0, 0, 0
9201, 1, 1636431197841, 1636431198106, 265, 0, 265, 0, 0, 0
9204, 1, 1636431197878, 1636431198149, 271, 0, 271, 0, 0, 0
9205, 1, 1636431197913, 1636431198189, 276, 1, 275, 0, 0, 0
9206, 1, 1636431198157, 1636431198437, 280, 1, 279, 0, 0, 0
9207, 1, 1636431198173, 1636431198442, 269, 1, 268, 0, 1, 1
9208, 1, 1636431198225, 1636431198505, 280, 1, 279, 1, 0, 1
9209, 1, 1636431198241, 1636431198505, 264, 1, 263, 0, 0, 0
9210, 1, 1636431198277, 1636431198545, 268, 0, 268, 0, 0, 0
9212, 1, 1636431198309, 1636431198581, 272, 1, 271, 0, 1, 1
9214, 1, 1636431198609, 1636431198881, 272, 1, 271, 0, 0, 0
9213, 1, 1636431198677, 1636431198949, 272, 0, 272, 0, 0, 0
9211, 1, 1636431198721, 1636431198989, 268, 0, 268, 0, 0, 0
9215, 1, 1636431198765, 1636431199041, 276, 1, 275, 0, 0, 0
9217, 1, 1636431199021, 1636431199294, 273, 1, 272, 0, 0, 0
9216, 1, 1636431199122, 1636431199393, 271, 0, 271, 0, 0, 0
9218, 1, 1636431199169, 1636431199433, 264, 1, 263, 0, 1, 1
9219, 1, 1636431199213, 1636431199485, 272, 1, 271, 0, 1, 1
9220, 1, 1636431199254, 1636431199525, 271, 0, 271, 0, 0, 0
9221, 1, 1636431199453, 1636431199725, 272, 1, 271, 0, 1, 1
9222, 1, 1636431199481, 1636431199749, 268, 1, 267, 0, 0, 0
9223, 1, 1636431199565, 1636431199841, 276, 1, 275, 0, 0, 0
9224, 1, 1636431199585, 1636431199857, 272, 1, 271, 0, 0, 0
9225, 1, 1636431199605, 1636431199877, 272, 1, 271, 0, 0, 0
9227, 1, 1636431199697, 1636431199966, 269, 0, 269, 0, 0, 0
9228, 1, 1636431200033, 1636431200310, 277, 1, 276, 0, 0, 0
9229, 1, 1636431200053, 1636431200325, 272, 1, 271, 0, 0, 0
9230, 1, 1636431200145, 1636431200417, 272, 0, 272, 0, 0, 0
9232, 1, 1636431200338, 1636431200609, 271, 0, 271, 0, 0, 0
9231, 1, 1636431200493, 1636431200765, 272, 1, 271, 0, 0, 0
9233, 1, 1636431200505, 1636431200773, 268, 0, 268, 0, 0, 0
9234, 1, 1636431200573, 1636431200849, 276, 1, 275, 1, 0, 1
9235, 1, 1636431200609, 1636431200881, 272, 1, 271, 0, 0, 0
9236, 1, 1636431200817, 1636431201089, 272, 0, 272, 0, 0, 0
9237, 1, 1636431200837, 1636431201106, 269, 1, 268, 0, 0, 0
9238, 1, 1636431200853, 1636431201125, 272, 0, 272, 0, 0, 0
9239, 1, 1636431200926, 1636431201197, 271, 0, 271, 0, 0, 0
9226, 1, 1636431200953, 1636431201221, 268, 1, 267, 0, 1, 1
9240, 1, 1636431200981, 1636431201261, 280, 0, 280, 0, 0, 0
9243, 1, 1636431201277, 1636431201549, 272, 1, 271, 1, 0, 1
9241, 1, 1636431201405, 1636431201678, 273, 1, 272, 0, 1, 1
9242, 1, 1636431201442, 1636431201714, 272, 0, 272, 0, 0, 0
9245, 1, 1636431201625, 1636431201894, 269, 0, 269, 0, 0, 0
9246, 1, 1636431201637, 1636431201905, 268, 0, 268, 0, 0, 0
9248, 1, 1636431201677, 1636431201945, 268, 1, 267, 0, 0, 0
9244, 1, 1636431201861, 1636431202125, 264, 1, 263, 0, 0, 0
9249, 1, 1636431201877, 1636431202149, 272, 0, 272, 0, 0, 0
9247, 1, 1636431201894, 1636431202161, 267, 0, 267, 0, 0, 0
9250, 1, 1636431201905, 1636431202169, 264, 1, 263, 0, 0, 0
9251, 1, 1636431202109, 1636431202377, 268, 0, 268, 0, 0, 0
9252, 1, 1636431202161, 1636431202429, 268, 1, 267, 0, 0, 0
9253, 1, 1636431202177, 1636431202450, 273, 0, 273, 0, 0, 0
9254, 1, 1636431202305, 1636431202573, 268, 1, 267, 0, 0, 0
9255, 1, 1636431202321, 1636431202593, 272, 1, 271, 0, 0, 0
9256, 1, 1636431202329, 1636431202601, 272, 1, 271, 1, 0, 1
9258, 1, 1636431202630, 1636431202889, 259, 0, 259, 0, 0, 0
9257, 1, 1636431202757, 1636431203013, 256, 1, 255, 0, 0, 0
9259, 1, 1636431202769, 1636431203025, 256, 1, 255, 0, 0, 0
9261, 1, 1636431202977, 1636431203254, 277, 1, 276, 1, 0, 1
9262, 1, 1636431202977, 1636431203254, 277, 1, 276, 0, 0, 0
9263, 1, 1636431203085, 1636431203345, 260, 0, 260, 0, 0, 0
9264, 1, 1636431203189, 1636431203458, 269, 1, 268, 0, 0, 0
9260, 1, 1636431203197, 1636431203465, 268, 1, 267, 0, 0, 0
9265, 1, 1636431203217, 1636431203486, 269, 0, 269, 0, 0, 0
9266, 1, 1636431203505, 1636431203793, 288, 0, 288, 0, 0, 0
9268, 1, 1636431203569, 1636431203873, 304, 1, 303, 1, 0, 1
9267, 1, 1636431203517, 1636431203877, 360, 0, 360, 0, 0, 0
9269, 1, 1636431203586, 1636431203881, 295, 0, 295, 0, 0, 0
9270, 1, 1636431203786, 1636431204049, 263, 0, 263, 0, 0, 0
9271, 1, 1636431203786, 1636431204050, 264, 0, 264, 0, 0, 0
9273, 1, 1636431203981, 1636431204273, 292, 1, 291, 0, 0, 0
9274, 1, 1636431204029, 1636431204301, 272, 0, 272, 0, 0, 0
9275, 1, 1636431204041, 1636431204318, 277, 1, 276, 0, 0, 0
9272, 1, 1636431204049, 1636431204361, 312, 1, 311, 0, 0, 0
9276, 1, 1636431204229, 1636431204493, 264, 1, 263, 0, 1, 1
9278, 1, 1636431204317, 1636431204581, 264, 1, 263, 1, 0, 1
9279, 1, 1636431204357, 1636431204625, 268, 1, 267, 0, 0, 0
9280, 1, 1636431204470, 1636431204733, 263, 0, 263, 0, 0, 0
9281, 1, 1636431204470, 1636431204741, 271, 0, 271, 0, 0, 0
9282, 1, 1636431204533, 1636431204833, 300, 1, 299, 0, 0, 0
9277, 1, 1636431204537, 1636431204833, 296, 0, 296, 0, 0, 0
9283, 1, 1636431204553, 1636431204833, 280, 1, 279, 0, 1, 1
9185, 1, 1636431204785, 1636431205073, 288, 1, 287, 0, 0, 0
9285, 1, 1636431204877, 1636431205165, 288, 1, 287, 1, 0, 1
9286, 1, 1636431204877, 1636431205166, 289, 1, 288, 0, 0, 0
9284, 1, 1636431204917, 1636431205193, 276, 1, 275, 1, 0, 1
9287, 1, 1636431204917, 1636431205194, 277, 1, 276, 1, 0, 1
9289, 1, 1636431205077, 1636431205354, 277, 1, 276, 0, 1, 1
9288, 1, 1636431205085, 1636431205357, 272, 1, 271, 0, 0, 0
9292, 1, 1636431205229, 1636431205497, 268, 1, 267, 0, 1, 1
9293, 1, 1636431205289, 1636431205557, 268, 1, 267, 0, 0, 0
9294, 1, 1636431205345, 1636431205613, 268, 0, 268, 0, 0, 0
9291, 1, 1636431205377, 1636431205649, 272, 1, 271, 0, 1, 1
9290, 1, 1636431205377, 1636431205649, 272, 0, 272, 0, 0, 0
9296, 1, 1636431205469, 1636431205737, 268, 0, 268, 0, 0, 0
9298, 1, 1636431205621, 1636431205885, 264, 0, 264, 0, 0, 0
9299, 1, 1636431205649, 1636431205921, 272, 0, 272, 0, 0, 0
9300, 1, 1636431205753, 1636431206021, 268, 1, 267, 1, 0, 1
9301, 1, 1636431205825, 1636431206098, 273, 0, 273, 0, 0, 0
9302, 1, 1636431205833, 1636431206105, 272, 0, 272, 0, 0, 0
9295, 1, 1636431205829, 1636431206105, 276, 1, 275, 0, 1, 1
9297, 1, 1636431205829, 1636431206109, 280, 1, 279, 1, 0, 1
9303, 1, 1636431205885, 1636431206149, 264, 1, 263, 0, 1, 1
9304, 1, 1636431206145, 1636431206414, 269, 0, 269, 0, 0, 0
9305, 1, 1636431206189, 1636431206457, 268, 1, 267, 1, 0, 1
9306, 1, 1636431206237, 1636431206502, 265, 0, 265, 0, 0, 0
9307, 1, 1636431206282, 1636431206545, 263, 0, 263, 0, 0, 0
9308, 1, 1636431206289, 1636431206557, 268, 0, 268, 0, 0, 0
9309, 1, 1636431206377, 1636431206654, 277, 1, 276, 0, 0, 0
9310, 1, 1636431206494, 1636431206773, 279, 0, 279, 0, 0, 0
9312, 1, 1636431206574, 1636431206841, 267, 0, 267, 0, 0, 0
9313, 1, 1636431206585, 1636431206857, 272, 0, 272, 0, 0, 0
9311, 1, 1636431206717, 1636431206989, 272, 1, 271, 1, 0, 1
9315, 1, 1636431206717, 1636431206989, 272, 1, 271, 0, 1, 1
9316, 1, 1636431206957, 1636431207230, 273, 0, 273, 0, 0, 0
9318, 1, 1636431206981, 1636431207253, 272, 1, 271, 0, 1, 1
9314, 1, 1636431207017, 1636431207290, 273, 0, 273, 0, 0, 0
9320, 1, 1636431207113, 1636431207385, 272, 1, 271, 0, 0, 0
9321, 1, 1636431207169, 1636431207441, 272, 1, 271, 1, 0, 1
9317, 1, 1636431207169, 1636431207453, 284, 1, 283, 0, 0, 0
9322, 1, 1636431207169, 1636431207453, 284, 1, 283, 0, 0, 0
9319, 1, 1636431207469, 1636431207737, 268, 0, 268, 0, 0, 0
9323, 1, 1636431207529, 1636431207798, 269, 0, 269, 0, 0, 0
9324, 1, 1636431207541, 1636431207817, 276, 1, 275, 0, 1, 1
9326, 1, 1636431207625, 1636431207897, 272, 1, 271, 0, 1, 1
9327, 1, 1636431207662, 1636431207933, 271, 0, 271, 0, 0, 0
9328, 1, 1636431207685, 1636431207957, 272, 0, 272, 0, 0, 0
9329, 1, 1636431207798, 1636431208065, 267, 0, 267, 0, 0, 0
9330, 1, 1636431207909, 1636431208181, 272, 0, 272, 0, 0, 0
9332, 1, 1636431207917, 1636431208185, 268, 1, 267, 1, 0, 1
9325, 1, 1636431207917, 1636431208197, 280, 1, 279, 0, 0, 0
9333, 1, 1636431207977, 1636431208245, 268, 1, 267, 0, 0, 0
9334, 1, 1636431207997, 1636431208270, 273, 1, 272, 1, 0, 1
9331, 1, 1636431208110, 1636431208377, 267, 0, 267, 0, 0, 0
9335, 1, 1636431208245, 1636431208514, 269, 0, 269, 0, 0, 0
9336, 1, 1636431208317, 1636431208590, 273, 0, 273, 0, 0, 0
9338, 1, 1636431208410, 1636431208686, 276, 0, 276, 0, 0, 0
9339, 1, 1636431208437, 1636431208705, 268, 0, 268, 0, 0, 0
9341, 1, 1636431208482, 1636431208750, 268, 0, 268, 0, 0, 0
9337, 1, 1636431208553, 1636431208829, 276, 1, 275, 0, 1, 1
9340, 1, 1636431208689, 1636431208965, 276, 0, 276, 0, 0, 0
9342, 1, 1636431208825, 1636431209093, 268, 1, 267, 0, 1, 1
9343, 1, 1636431208825, 1636431209093, 268, 1, 267, 1, 0, 1
9344, 1, 1636431208949, 1636431209226, 277, 1, 276, 1, 0, 1
9346, 1, 1636431209017, 1636431209285, 268, 1, 267, 0, 1, 1
9347, 1, 1636431209017, 1636431209289, 272, 1, 271, 1, 0, 1
9348, 1, 1636431209121, 1636431209382, 261, 0, 261, 0, 0, 0
9345, 1, 1636431209137, 1636431209409, 272, 0, 272, 0, 0, 0
9350, 1, 1636431209201, 1636431209465, 264, 1, 263, 0, 0, 0
9351, 1, 1636431209237, 1636431209510, 273, 1, 272, 0, 0, 0
9352, 1, 1636431209285, 1636431209553, 268, 0, 268, 0, 0, 0
9353, 1, 1636431209337, 1636431209605, 268, 0, 268, 0, 0, 0
9354, 1, 1636431209557, 1636431209829, 272, 1, 271, 0, 0, 0
9349, 1, 1636431209585, 1636431209862, 277, 0, 277, 0, 0, 0
9355, 1, 1636431209621, 1636431209894, 273, 0, 273, 0, 0, 0
9357, 1, 1636431209705, 1636431209973, 268, 0, 268, 0, 0, 0
9358, 1, 1636431209793, 1636431210065, 272, 1, 271, 1, 0, 1
9360, 1, 1636431209805, 1636431210073, 268, 0, 268, 0, 0, 0
9359, 1, 1636431209797, 1636431210073, 276, 1, 275, 0, 1, 1
9356, 1, 1636431210045, 1636431210317, 272, 1, 271, 0, 1, 1
9361, 1, 1636431210093, 1636431210369, 276, 1, 275, 0, 0, 0
9362, 1, 1636431210233, 1636431210497, 264, 0, 264, 0, 0, 0
9363, 1, 1636431210249, 1636431210521, 272, 1, 271, 0, 0, 0
9364, 1, 1636431210269, 1636431210545, 276, 0, 276, 0, 0, 0
9365, 1, 1636431210305, 1636431210581, 276, 1, 275, 0, 0, 0
9366, 1, 1636431210350, 1636431210617, 267, 0, 267, 0, 0, 0
9367, 1, 1636431210441, 1636431210709, 268, 1, 267, 0, 0, 0
9370, 1, 1636431210573, 1636431210841, 268, 0, 268, 0, 0, 0
9371, 1, 1636431210625, 1636431210905, 280, 1, 279, 1, 0, 1
9368, 1, 1636431210702, 1636431210973, 271, 0, 271, 0, 0, 0
9373, 1, 1636431210709, 1636431210982, 273, 1, 272, 0, 0, 0
9369, 1, 1636431210725, 1636431210997, 272, 0, 272, 0, 0, 0
9372, 1, 1636431210893, 1636431211157, 264, 0, 264, 0, 0, 0
9374, 1, 1636431210905, 1636431211182, 277, 1, 276, 1, 0, 1
9377, 1, 1636431211097, 1636431211373, 276, 0, 276, 0, 0, 0
9378, 1, 1636431211141, 1636431211409, 268, 0, 268, 0, 0, 0
9376, 1, 1636431211149, 1636431211421, 272, 0, 272, 0, 0, 0
9379, 1, 1636431211166, 1636431211446, 280, 0, 280, 0, 0, 0
9375, 1, 1636431211177, 1636431211446, 269, 1, 268, 0, 0, 0
9380, 1, 1636431211449, 1636431211718, 269, 0, 269, 0, 0, 0
9382, 1, 1636431211557, 1636431211829, 272, 0, 272, 0, 0, 0
9381, 1, 1636431211601, 1636431211873, 272, 0, 272, 0, 0, 0
9383, 1, 1636431211629, 1636431211897, 268, 0, 268, 0, 0, 0
9384, 1, 1636431211665, 1636431211925, 260, 0, 260, 0, 0, 0
9385, 1, 1636431211685, 1636431211949, 264, 1, 263, 1, 0, 1
9386, 1, 1636431211781, 1636431212046, 265, 1, 264, 0, 0, 0
9390, 1, 1636431211957, 1636431212225, 268, 1, 267, 0, 0, 0
9389, 1, 1636431211945, 1636431212225, 280, 1, 279, 0, 1, 1
9388, 1, 1636431212001, 1636431212269, 268, 0, 268, 0, 0, 0
9391, 1, 1636431212009, 1636431212281, 272, 0, 272, 0, 0, 0
9387, 1, 1636431212105, 1636431212378, 273, 1, 272, 0, 1, 1
9392, 1, 1636431212221, 1636431212493, 272, 0, 272, 0, 0, 0
9394, 1, 1636431212297, 1636431212573, 276, 0, 276, 0, 0, 0
9396, 1, 1636431212441, 1636431212713, 272, 0, 272, 0, 0, 0
9393, 1, 1636431212449, 1636431212713, 264, 1, 263, 0, 0, 0
9397, 1, 1636431212477, 1636431212749, 272, 1, 271, 0, 0, 0
9398, 1, 1636431212489, 1636431212757, 268, 0, 268, 0, 0, 0
9395, 1, 1636431212561, 1636431212833, 272, 1, 271, 0, 0, 0
9399, 1, 1636431212757, 1636431213029, 272, 0, 272, 0, 0, 0
9401, 1, 1636431212889, 1636431213161, 272, 0, 272, 0, 0, 0
9402, 1, 1636431212906, 1636431213177, 271, 0, 271, 0, 0, 0
9403, 1, 1636431213017, 1636431213281, 264, 0, 264, 0, 0, 0
9400, 1, 1636431213009, 1636431213282, 273, 0, 273, 0, 0, 0
9404, 1, 1636431213041, 1636431213313, 272, 0, 272, 0, 0, 0
9405, 1, 1636431213093, 1636431213365, 272, 0, 272, 0, 0, 0
9407, 1, 1636431213105, 1636431213377, 272, 1, 271, 0, 1, 1
9408, 1, 1636431213297, 1636431213566, 269, 0, 269, 0, 0, 0
9409, 1, 1636431213341, 1636431213609, 268, 0, 268, 0, 0, 0
9406, 1, 1636431213341, 1636431213614, 273, 0, 273, 0, 0, 0
9411, 1, 1636431213393, 1636431213665, 272, 0, 272, 0, 0, 0
9410, 1, 1636431213549, 1636431213821, 272, 0, 272, 0, 0, 0
9413, 1, 1636431213629, 1636431213905, 276, 1, 275, 0, 0, 0
9414, 1, 1636431213661, 1636431213933, 272, 0, 272, 0, 0, 0
9415, 1, 1636431213765, 1636431214037, 272, 1, 271, 0, 0, 0
9412, 1, 1636431213793, 1636431214070, 277, 1, 276, 0, 1, 1
9416, 1, 1636431213798, 1636431214070, 272, 0, 272, 0, 0, 0
9417, 1, 1636431213853, 1636431214121, 268, 1, 267, 0, 1, 1
9418, 1, 1636431214125, 1636431214401, 276, 0, 276, 0, 0, 0
9419, 1, 1636431214137, 1636431214409, 272, 1, 271, 1, 0, 1
9420, 1, 1636431214230, 1636431214506, 276, 0, 276, 0, 0, 0
9421, 1, 1636431214305, 1636431214577, 272, 1, 271, 0, 1, 1
9422, 1, 1636431214322, 1636431214597, 275, 0, 275, 0, 0, 0
9426, 1, 1636431214489, 1636431214766, 277, 0, 277, 0, 0, 0
9427, 1, 1636431214581, 1636431214849, 268, 1, 267, 0, 0, 0
9428, 1, 1636431214653, 1636431214925, 272, 0, 272, 0, 0, 0
9425, 1, 1636431214681, 1636431214949, 268, 0, 268, 0, 0, 0
9430, 1, 1636431214769, 1636431215041, 272, 1, 271, 0, 0, 0
9429, 1, 1636431214773, 1636431215050, 277, 0, 277, 0, 0, 0
9432, 1, 1636431214957, 1636431215229, 272, 1, 271, 0, 0, 0
9433, 1, 1636431215021, 1636431215290, 269, 1, 268, 0, 0, 0
9431, 1, 1636431215125, 1636431215397, 272, 1, 271, 0, 0, 0
9435, 1, 1636431215137, 1636431215413, 276, 0, 276, 0, 0, 0
9436, 1, 1636431215189, 1636431215461, 272, 0, 272, 0, 0, 0
9437, 1, 1636431215433, 1636431215709, 276, 0, 276, 0, 0, 0
9438, 1, 1636431215501, 1636431215769, 268, 1, 267, 0, 0, 0
9440, 1, 1636431215585, 1636431215854, 269, 0, 269, 0, 0, 0
9441, 1, 1636431215705, 1636431215973, 268, 0, 268, 0, 0, 0
9442, 1, 1636431215777, 1636431216049, 272, 1, 271, 1, 0, 1
9444, 1, 1636431215857, 1636431216121, 264, 0, 264, 0, 0, 0
9445, 1, 1636431215946, 1636431216221, 275, 0, 275, 0, 0, 0
9447, 1, 1636431216094, 1636431216361, 267, 0, 267, 0, 0, 0
9449, 1, 1636431216309, 1636431216577, 268, 1, 267, 0, 0, 0
9450, 1, 1636431216313, 1636431216581, 268, 1, 267, 0, 1, 1
9451, 1, 1636431216485, 1636431216753, 268, 0, 268, 0, 0, 0
9452, 1, 1636431216525, 1636431216793, 268, 0, 268, 0, 0, 0
9453, 1, 1636431216785, 1636431217057, 272, 1, 271, 1, 0, 1
9454, 1, 1636431216822, 1636431217093, 271, 0, 271, 0, 0, 0
9455, 1, 1636431216857, 1636431217137, 280, 0, 280, 0, 0, 0
9456, 1, 1636431217029, 1636431217301, 272, 1, 271, 1, 0, 1
9457, 1, 1636431217077, 1636431217345, 268, 0, 268, 0, 0, 0
9458, 1, 1636431217197, 1636431217470, 273, 1, 272, 1, 0, 1
9459, 1, 1636431217294, 1636431217565, 271, 0, 271, 0, 0, 0
9460, 1, 1636431217374, 1636431217646, 272, 0, 272, 0, 0, 0
9461, 1, 1636431217605, 1636431217878, 273, 0, 273, 0, 0, 0
9462, 1, 1636431217657, 1636431217922, 265, 1, 264, 0, 1, 1
9463, 1, 1636431217818, 1636431218085, 267, 0, 267, 0, 0, 0
9464, 1, 1636431217877, 1636431218145, 268, 1, 267, 0, 0, 0
9465, 1, 1636431218085, 1636431218358, 273, 1, 272, 1, 0, 1
9466, 1, 1636431218221, 1636431218489, 268, 1, 267, 1, 0, 1
9467, 1, 1636431218238, 1636431218506, 268, 0, 268, 0, 0, 0
9468, 1, 1636431218373, 1636431218637, 264, 1, 263, 0, 1, 1
9469, 1, 1636431218461, 1636431218737, 276, 0, 276, 0, 0, 0
9470, 1, 1636431218570, 1636431218841, 271, 0, 271, 0, 0, 0
9471, 1, 1636431218633, 1636431218905, 272, 0, 272, 0, 0, 0
9472, 1, 1636431218749, 1636431219022, 273, 1, 272, 0, 0, 0
9473, 1, 1636431218941, 1636431219205, 264, 1, 263, 0, 1, 1
9474, 1, 1636431218989, 1636431219261, 272, 1, 271, 0, 0, 0
9475, 1, 1636431219165, 1636431219437, 272, 0, 272, 0, 0, 0
9476, 1, 1636431219205, 1636431219485, 280, 1, 279, 0, 0, 0
9477, 1, 1636431219477, 1636431219750, 273, 1, 272, 0, 0, 0
9478, 1, 1636431219494, 1636431219766, 272, 0, 272, 0, 0, 0
9479, 1, 1636431219557, 1636431219825, 268, 1, 267, 0, 0, 0
9480, 1, 1636431219694, 1636431219966, 272, 0, 272, 0, 0, 0
9481, 1, 1636431219749, 1636431220021, 272, 1, 271, 0, 0, 0
9482, 1, 1636431219909, 1636431220173, 264, 1, 263, 0, 0, 0
9483, 1, 1636431219965, 1636431220238, 273, 1, 272, 0, 0, 0
9484, 1, 1636431220142, 1636431220410, 268, 0, 268, 0, 0, 0
9485, 1, 1636431220217, 1636431220485, 268, 1, 267, 0, 1, 1
9486, 1, 1636431220281, 1636431220549, 268, 1, 267, 0, 1, 1
9487, 1, 1636431220509, 1636431220785, 276, 0, 276, 0, 0, 0
9488, 1, 1636431220549, 1636431220821, 272, 1, 271, 0, 0, 0
9489, 1, 1636431220769, 1636431221041, 272, 0, 272, 0, 0, 0
9490, 1, 1636431220801, 1636431221069, 268, 0, 268, 0, 0, 0
9491, 1, 1636431220845, 1636431221114, 269, 0, 269, 0, 0, 0
9492, 1, 1636431221045, 1636431221317, 272, 0, 272, 0, 0, 0
9493, 1, 1636431221065, 1636431221325, 260, 0, 260, 0, 0, 0
9494, 1, 1636431221193, 1636431221462, 269, 1, 268, 0, 0, 0
9495, 1, 1636431221277, 1636431221546, 269, 0, 269, 0, 0, 0
9496, 1, 1636431221429, 1636431221701, 272, 1, 271, 0, 0, 0
9497, 1, 1636431221569, 1636431221841, 272, 0, 272, 0, 0, 0
9498, 1, 1636431221597, 1636431221873, 276, 0, 276, 0, 0, 0
9499, 1, 1636431221821, 1636431222094, 273, 1, 272, 0, 0, 0
9500, 1, 1636431221877, 1636431222154, 277, 0, 277, 0, 0, 0
9501, 1, 1636431222049, 1636431222321, 272, 1, 271, 0, 0, 0
9502, 1, 1636431222090, 1636431222357, 267, 0, 267, 0, 0, 0
9503, 1, 1636431222226, 1636431222485, 259, 0, 259, 0, 0, 0
9504, 1, 1636431222413, 1636431222681, 268, 1, 267, 0, 0, 0
9505, 1, 1636431222441, 1636431222709, 268, 1, 267, 1, 0, 1
9506, 1, 1636431222493, 1636431222765, 272, 1, 271, 0, 0, 0
9508, 1, 1636431222725, 1636431222997, 272, 0, 272, 0, 0, 0
9509, 1, 1636431222938, 1636431223209, 271, 0, 271, 0, 0, 0
9507, 1, 1636431222941, 1636431223209, 268, 1, 267, 0, 0, 0
9510, 1, 1636431222977, 1636431223250, 273, 1, 272, 1, 0, 1
9511, 1, 1636431223185, 1636431223458, 273, 0, 273, 0, 0, 0
9512, 1, 1636431223193, 1636431223465, 272, 0, 272, 0, 0, 0
9513, 1, 1636431223397, 1636431223669, 272, 1, 271, 0, 0, 0
9514, 1, 1636431223485, 1636431223757, 272, 0, 272, 0, 0, 0
9515, 1, 1636431223509, 1636431223782, 273, 0, 273, 0, 0, 0
9516, 1, 1636431223737, 1636431224009, 272, 0, 272, 0, 0, 0
9517, 1, 1636431223770, 1636431224042, 272, 0, 272, 0, 0, 0
9518, 1, 1636431223797, 1636431224065, 268, 0, 268, 0, 0, 0
9519, 1, 1636431223953, 1636431224226, 273, 0, 273, 0, 0, 0
9520, 1, 1636431224013, 1636431224285, 272, 0, 272, 0, 0, 0
9522, 1, 1636431224289, 1636431224605, 316, 0, 316, 0, 0, 0
9521, 1, 1636431224265, 1636431224605, 340, 0, 340, 0, 0, 0
9523, 1, 1636431224558, 1636431224829, 271, 0, 271, 0, 0, 0
9524, 1, 1636431224561, 1636431224833, 272, 0, 272, 0, 0, 0
9525, 1, 1636431224782, 1636431225053, 271, 0, 271, 0, 0, 0
9526, 1, 1636431224798, 1636431225069, 271, 0, 271, 0, 0, 0
9527, 1, 1636431224806, 1636431225077, 271, 0, 271, 0, 0, 0
9530, 1, 1636431225137, 1636431225410, 273, 1, 272, 1, 0, 1
9529, 1, 1636431225137, 1636431225413, 276, 1, 275, 1, 0, 1
9528, 1, 1636431225137, 1636431225413, 276, 1, 275, 0, 0, 0
9531, 1, 1636431225293, 1636431225577, 284, 1, 283, 1, 0, 1
9532, 1, 1636431225313, 1636431225585, 272, 1, 271, 1, 0, 1
9535, 1, 1636431225577, 1636431225849, 272, 1, 271, 0, 1, 1
9533, 1, 1636431225581, 1636431225850, 269, 0, 269, 0, 0, 0
9534, 1, 1636431225577, 1636431225850, 273, 1, 272, 0, 1, 1
9536, 1, 1636431225613, 1636431225881, 268, 1, 267, 1, 0, 1
9537, 1, 1636431225673, 1636431225954, 281, 1, 280, 0, 1, 1
9539, 1, 1636431225833, 1636431226149, 316, 0, 316, 0, 0, 0
9540, 1, 1636431225961, 1636431226233, 272, 0, 272, 0, 0, 0
9448, 1, 1636431226006, 1636431226278, 272, 0, 272, 0, 0, 0
9538, 1, 1636431226025, 1636431226298, 273, 1, 272, 1, 0, 1
9542, 1, 1636431226141, 1636431226409, 268, 1, 267, 0, 0, 0
9543, 1, 1636431226141, 1636431226417, 276, 1, 275, 0, 0, 0
9544, 1, 1636431226301, 1636431226573, 272, 0, 272, 0, 0, 0
9545, 1, 1636431226357, 1636431226625, 268, 1, 267, 0, 0, 0
9546, 1, 1636431226437, 1636431226713, 276, 1, 275, 0, 0, 0
9541, 1, 1636431226473, 1636431226749, 276, 0, 276, 0, 0, 0
9547, 1, 1636431226518, 1636431226790, 272, 0, 272, 0, 0, 0
9548, 1, 1636431226613, 1636431226885, 272, 1, 271, 0, 1, 1
9551, 1, 1636431226749, 1636431227021, 272, 1, 271, 1, 0, 1
9549, 1, 1636431226749, 1636431227022, 273, 1, 272, 1, 0, 1
9553, 1, 1636431226813, 1636431227085, 272, 1, 271, 0, 0, 0
9554, 1, 1636431226933, 1636431227209, 276, 0, 276, 0, 0, 0
9550, 1, 1636431226933, 1636431227209, 276, 0, 276, 0, 0, 0
9555, 1, 1636431227021, 1636431227293, 272, 1, 271, 1, 0, 1
9557, 1, 1636431227201, 1636431227474, 273, 1, 272, 1, 0, 1
9556, 1, 1636431227201, 1636431227474, 273, 1, 272, 0, 1, 1
9558, 1, 1636431227297, 1636431227561, 264, 0, 264, 0, 0, 0
9560, 1, 1636431227481, 1636431227749, 268, 0, 268, 0, 0, 0
9561, 1, 1636431227493, 1636431227761, 268, 1, 267, 1, 0, 1
9562, 1, 1636431227557, 1636431227829, 272, 1, 271, 0, 0, 0
9563, 1, 1636431227689, 1636431227965, 276, 1, 275, 1, 0, 1
9564, 1, 1636431227701, 1636431227973, 272, 1, 271, 0, 0, 0
9565, 1, 1636431227905, 1636431228177, 272, 0, 272, 0, 0, 0
9566, 1, 1636431227925, 1636431228193, 268, 0, 268, 0, 0, 0
9567, 1, 1636431227949, 1636431228217, 268, 1, 267, 0, 0, 0
9569, 1, 1636431228041, 1636431228322, 281, 1, 280, 0, 1, 1
9570, 1, 1636431228138, 1636431228414, 276, 0, 276, 0, 0, 0
9571, 1, 1636431228217, 1636431228489, 272, 1, 271, 1, 0, 1
9572, 1, 1636431228393, 1636431228665, 272, 1, 271, 1, 0, 1
9573, 1, 1636431228482, 1636431228757, 275, 0, 275, 0, 0, 0
9574, 1, 1636431228574, 1636431228845, 271, 0, 271, 0, 0, 0
9575, 1, 1636431228610, 1636431228881, 271, 0, 271, 0, 0, 0
9576, 1, 1636431228845, 1636431229121, 276, 1, 275, 0, 0, 0
9578, 1, 1636431228881, 1636431229153, 272, 1, 271, 0, 0, 0
9579, 1, 1636431229013, 1636431229289, 276, 0, 276, 0, 0, 0
9580, 1, 1636431229017, 1636431229293, 276, 0, 276, 0, 0, 0
9581, 1, 1636431229242, 1636431229517, 275, 0, 275, 0, 0, 0
9582, 1, 1636431229281, 1636431229553, 272, 0, 272, 0, 0, 0
9577, 1, 1636431229305, 1636431229581, 276, 1, 275, 1, 0, 1
9583, 1, 1636431229313, 1636431229582, 269, 0, 269, 0, 0, 0
9584, 1, 1636431229350, 1636431229621, 271, 0, 271, 0, 0, 0
9585, 1, 1636431229405, 1636431229681, 276, 1, 275, 0, 0, 0
9586, 1, 1636431229517, 1636431229790, 273, 1, 272, 0, 0, 0
9587, 1, 1636431229729, 1636431230001, 272, 0, 272, 0, 0, 0
9588, 1, 1636431229813, 1636431230077, 264, 1, 263, 0, 1, 1
9589, 1, 1636431229841, 1636431230106, 265, 1, 264, 0, 0, 0
9590, 1, 1636431229998, 1636431230269, 271, 0, 271, 0, 0, 0
9591, 1, 1636431230157, 1636431230430, 273, 0, 273, 0, 0, 0
9593, 1, 1636431230205, 1636431230473, 268, 0, 268, 0, 0, 0
9592, 1, 1636431230198, 1636431230473, 275, 0, 275, 0, 0, 0
9594, 1, 1636431230313, 1636431230589, 276, 1, 275, 0, 0, 0
9595, 1, 1636431230349, 1636431230621, 272, 1, 271, 0, 1, 1
9597, 1, 1636431230585, 1636431230854, 269, 0, 269, 0, 0, 0
9596, 1, 1636431230581, 1636431230854, 273, 0, 273, 0, 0, 0
9598, 1, 1636431230605, 1636431230881, 276, 0, 276, 0, 0, 0
9599, 1, 1636431230742, 1636431231005, 263, 0, 263, 0, 0, 0
9600, 1, 1636431230789, 1636431231053, 264, 0, 264, 0, 0, 0
9601, 1, 1636431230829, 1636431231101, 272, 0, 272, 0, 0, 0
9602, 1, 1636431231085, 1636431231361, 276, 0, 276, 0, 0, 0
9603, 1, 1636431231093, 1636431231361, 268, 0, 268, 0, 0, 0
9604, 1, 1636431231150, 1636431231421, 271, 0, 271, 0, 0, 0
9605, 1, 1636431231406, 1636431231681, 275, 0, 275, 0, 0, 0
9606, 1, 1636431231541, 1636431231805, 264, 0, 264, 0, 0, 0
9607, 1, 1636431231561, 1636431231829, 268, 0, 268, 0, 0, 0
9608, 1, 1636431231569, 1636431231841, 272, 0, 272, 0, 0, 0
9609, 1, 1636431231585, 1636431231857, 272, 0, 272, 0, 0, 0
9610, 1, 1636431231641, 1636431231905, 264, 0, 264, 0, 0, 0
9611, 1, 1636431231881, 1636431232153, 272, 1, 271, 0, 0, 0
9612, 1, 1636431231905, 1636431232169, 264, 1, 263, 0, 0, 0
9614, 1, 1636431232077, 1636431232349, 272, 1, 271, 1, 0, 1
9613, 1, 1636431232081, 1636431232357, 276, 1, 275, 1, 0, 1
9615, 1, 1636431232161, 1636431232437, 276, 1, 275, 1, 0, 1
9616, 1, 1636431232186, 1636431232461, 275, 0, 275, 0, 0, 0
9619, 1, 1636431232521, 1636431232793, 272, 0, 272, 0, 0, 0
9617, 1, 1636431232541, 1636431232813, 272, 0, 272, 0, 0, 0
9618, 1, 1636431232645, 1636431232925, 280, 1, 279, 0, 1, 1
9620, 1, 1636431232758, 1636431233038, 280, 0, 280, 0, 0, 0
9621, 1, 1636431232897, 1636431233173, 276, 0, 276, 0, 0, 0
9622, 1, 1636431232909, 1636431233177, 268, 0, 268, 0, 0, 0
9625, 1, 1636431232993, 1636431233265, 272, 0, 272, 0, 0, 0
9623, 1, 1636431233001, 1636431233273, 272, 1, 271, 0, 0, 0
9624, 1, 1636431233001, 1636431233273, 272, 1, 271, 0, 1, 1
9626, 1, 1636431233158, 1636431233430, 272, 0, 272, 0, 0, 0
9627, 1, 1636431233305, 1636431233578, 273, 0, 273, 0, 0, 0
9628, 1, 1636431233313, 1636431233585, 272, 0, 272, 0, 0, 0
9629, 1, 1636431233369, 1636431233633, 264, 0, 264, 0, 0, 0
9630, 1, 1636431233457, 1636431233725, 268, 0, 268, 0, 0, 0
9631, 1, 1636431233494, 1636431233761, 267, 0, 267, 0, 0, 0
9632, 1, 1636431233822, 1636431234094, 272, 0, 272, 0, 0, 0
9633, 1, 1636431233830, 1636431234101, 271, 0, 271, 0, 0, 0
9634, 1, 1636431233846, 1636431234117, 271, 0, 271, 0, 0, 0
9635, 1, 1636431234157, 1636431234429, 272, 0, 272, 0, 0, 0
9636, 1, 1636431234229, 1636431234505, 276, 1, 275, 0, 1, 1
9637, 1, 1636431234237, 1636431234509, 272, 0, 272, 0, 0, 0
9638, 1, 1636431234281, 1636431234549, 268, 1, 267, 0, 0, 0
9639, 1, 1636431234321, 1636431234590, 269, 1, 268, 0, 1, 1
9640, 1, 1636431234386, 1636431234662, 276, 0, 276, 0, 0, 0
9641, 1, 1636431234549, 1636431234825, 276, 1, 275, 1, 0, 1
9642, 1, 1636431234601, 1636431234873, 272, 0, 272, 0, 0, 0
9643, 1, 1636431234649, 1636431234921, 272, 0, 272, 0, 0, 0
9644, 1, 1636431234665, 1636431234933, 268, 0, 268, 0, 0, 0
9645, 1, 1636431234737, 1636431235010, 273, 0, 273, 0, 0, 0
9646, 1, 1636431234793, 1636431235065, 272, 1, 271, 0, 0, 0
9647, 1, 1636431235153, 1636431235425, 272, 1, 271, 0, 1, 1
9648, 1, 1636431235170, 1636431235441, 271, 0, 271, 0, 0, 0
9649, 1, 1636431235205, 1636431235478, 273, 1, 272, 0, 0, 0
9650, 1, 1636431235461, 1636431235733, 272, 1, 271, 0, 1, 1
9651, 1, 1636431235541, 1636431235813, 272, 1, 271, 0, 1, 1
9652, 1, 1636431235593, 1636431235861, 268, 1, 267, 0, 0, 0
9653, 1, 1636431235626, 1636431235897, 271, 0, 271, 0, 0, 0
9654, 1, 1636431235638, 1636431235914, 276, 0, 276, 0, 0, 0
9656, 1, 1636431235877, 1636431236150, 273, 1, 272, 0, 1, 1
9657, 1, 1636431235929, 1636431236194, 265, 1, 264, 1, 0, 1
9658, 1, 1636431235933, 1636431236209, 276, 0, 276, 0, 0, 0
9655, 1, 1636431235993, 1636431236265, 272, 1, 271, 0, 1, 1
9659, 1, 1636431236014, 1636431236285, 271, 0, 271, 0, 0, 0
9660, 1, 1636431236061, 1636431236330, 269, 1, 268, 0, 0, 0
9661, 1, 1636431236061, 1636431236330, 269, 1, 268, 1, 0, 1
9662, 1, 1636431236417, 1636431236686, 269, 0, 269, 0, 0, 0
9663, 1, 1636431236469, 1636431236737, 268, 0, 268, 0, 0, 0
9664, 1, 1636431236509, 1636431236781, 272, 1, 271, 0, 0, 0
9666, 1, 1636431236893, 1636431237161, 268, 0, 268, 0, 0, 0
9665, 1, 1636431236913, 1636431237190, 277, 1, 276, 0, 1, 1
9667, 1, 1636431236937, 1636431237213, 276, 1, 275, 0, 0, 0
9668, 1, 1636431236953, 1636431237225, 272, 0, 272, 0, 0, 0
9669, 1, 1636431236993, 1636431237257, 264, 1, 263, 0, 0, 0
9670, 1, 1636431237057, 1636431237329, 272, 0, 272, 0, 0, 0
9671, 1, 1636431237197, 1636431237497, 300, 1, 299, 0, 1, 1
9672, 1, 1636431237249, 1636431237521, 272, 0, 272, 0, 0, 0
9674, 1, 1636431237325, 1636431237602, 277, 0, 277, 0, 0, 0
9568, 1, 1636431237357, 1636431237626, 269, 0, 269, 0, 0, 0
9673, 1, 1636431237365, 1636431237638, 273, 0, 273, 0, 0, 0
9675, 1, 1636431237405, 1636431237669, 264, 1, 263, 0, 0, 0
9676, 1, 1636431237490, 1636431237757, 267, 0, 267, 0, 0, 0
9677, 1, 1636431237705, 1636431237977, 272, 1, 271, 0, 0, 0
9678, 1, 1636431237753, 1636431238022, 269, 1, 268, 0, 0, 0
9679, 1, 1636431237862, 1636431238133, 271, 0, 271, 0, 0, 0
9681, 1, 1636431237965, 1636431238233, 268, 0, 268, 0, 0, 0
9683, 1, 1636431238186, 1636431238453, 267, 0, 267, 0, 0, 0
9685, 1, 1636431238193, 1636431238461, 268, 0, 268, 0, 0, 0
9684, 1, 1636431238197, 1636431238465, 268, 0, 268, 0, 0, 0
9686, 1, 1636431238233, 1636431238497, 264, 0, 264, 0, 0, 0
9687, 1, 1636431238277, 1636431238549, 272, 1, 271, 0, 0, 0
9682, 1, 1636431238409, 1636431238673, 264, 1, 263, 1, 0, 1
9689, 1, 1636431238522, 1636431238794, 272, 0, 272, 0, 0, 0
9690, 1, 1636431238569, 1636431238846, 277, 1, 276, 0, 1, 1
9691, 1, 1636431238581, 1636431238853, 272, 0, 272, 0, 0, 0
9692, 1, 1636431238673, 1636431238953, 280, 1, 279, 0, 0, 0
9693, 1, 1636431238705, 1636431238969, 264, 1, 263, 0, 0, 0
9680, 1, 1636431238845, 1636431239113, 268, 1, 267, 0, 0, 0
9694, 1, 1636431238845, 1636431239113, 268, 1, 267, 0, 0, 0
9695, 1, 1636431239065, 1636431239337, 272, 0, 272, 0, 0, 0
9696, 1, 1636431239085, 1636431239361, 276, 0, 276, 0, 0, 0
9688, 1, 1636431239125, 1636431239389, 264, 0, 264, 0, 0, 0
9697, 1, 1636431239149, 1636431239421, 272, 0, 272, 0, 0, 0
9698, 1, 1636431239225, 1636431239493, 268, 1, 267, 0, 0, 0
9700, 1, 1636431239517, 1636431239781, 264, 0, 264, 0, 0, 0
9702, 1, 1636431239533, 1636431239805, 272, 1, 271, 0, 0, 0
9701, 1, 1636431239561, 1636431239833, 272, 1, 271, 1, 0, 1
9703, 1, 1636431239561, 1636431239833, 272, 1, 271, 1, 0, 1
9704, 1, 1636431239589, 1636431239857, 268, 1, 267, 1, 0, 1
9699, 1, 1636431239601, 1636431239869, 268, 1, 267, 0, 1, 1
9706, 1, 1636431239825, 1636431240097, 272, 1, 271, 1, 0, 1
9707, 1, 1636431239845, 1636431240121, 276, 0, 276, 0, 0, 0
9708, 1, 1636431239885, 1636431240153, 268, 0, 268, 0, 0, 0
9710, 1, 1636431239989, 1636431240261, 272, 1, 271, 1, 0, 1
9709, 1, 1636431240013, 1636431240286, 273, 0, 273, 0, 0, 0
9705, 1, 1636431240033, 1636431240297, 264, 0, 264, 0, 0, 0
9712, 1, 1636431240253, 1636431240521, 268, 1, 267, 0, 0, 0
9711, 1, 1636431240333, 1636431240601, 268, 0, 268, 0, 0, 0
9713, 1, 1636431240357, 1636431240634, 277, 1, 276, 0, 1, 1
9714, 1, 1636431240465, 1636431240733, 268, 1, 267, 0, 0, 0
9716, 1, 1636431240517, 1636431240790, 273, 0, 273, 0, 0, 0
9718, 1, 1636431240745, 1636431241013, 268, 1, 267, 0, 1, 1
9719, 1, 1636431240781, 1636431241054, 273, 0, 273, 0, 0, 0
9722, 1, 1636431240877, 1636431241157, 280, 1, 279, 1, 0, 1
9717, 1, 1636431240913, 1636431241189, 276, 1, 275, 0, 0, 0
9723, 1, 1636431240954, 1636431241226, 272, 0, 272, 0, 0, 0
9724, 1, 1636431241126, 1636431241397, 271, 0, 271, 0, 0, 0
9725, 1, 1636431241181, 1636431241449, 268, 1, 267, 0, 0, 0
9726, 1, 1636431241189, 1636431241461, 272, 0, 272, 0, 0, 0
9721, 1, 1636431241233, 1636431241501, 268, 1, 267, 0, 1, 1
9728, 1, 1636431241325, 1636431241593, 268, 0, 268, 0, 0, 0
9727, 1, 1636431241317, 1636431241593, 276, 0, 276, 0, 0, 0
9729, 1, 1636431241377, 1636431241637, 260, 0, 260, 0, 0, 0
9715, 1, 1636431241369, 1636431241637, 268, 0, 268, 0, 0, 0
9730, 1, 1636431241577, 1636431241857, 280, 1, 279, 0, 0, 0
9731, 1, 1636431241677, 1636431241949, 272, 1, 271, 0, 1, 1
9732, 1, 1636431241709, 1636431241977, 268, 1, 267, 0, 1, 1
9733, 1, 1636431241833, 1636431242109, 276, 0, 276, 0, 0, 0
9734, 1, 1636431241981, 1636431242245, 264, 0, 264, 0, 0, 0
9735, 1, 1636431242021, 1636431242289, 268, 0, 268, 0, 0, 0
9720, 1, 1636431242129, 1636431242402, 273, 1, 272, 1, 0, 1
9738, 1, 1636431242190, 1636431242461, 271, 0, 271, 0, 0, 0
9739, 1, 1636431242237, 1636431242509, 272, 0, 272, 0, 0, 0
9740, 1, 1636431242289, 1636431242553, 264, 1, 263, 0, 0, 0
9737, 1, 1636431242461, 1636431242729, 268, 1, 267, 0, 0, 0
9741, 1, 1636431242457, 1636431242729, 272, 0, 272, 0, 0, 0
9742, 1, 1636431242549, 1636431242821, 272, 1, 271, 0, 1, 1
9743, 1, 1636431242569, 1636431242837, 268, 1, 267, 0, 1, 1
9744, 1, 1636431242649, 1636431242913, 264, 0, 264, 0, 0, 0
9746, 1, 1636431242693, 1636431242965, 272, 1, 271, 0, 0, 0
9745, 1, 1636431242693, 1636431242969, 276, 0, 276, 0, 0, 0
9736, 1, 1636431242733, 1636431243001, 268, 0, 268, 0, 0, 0
9747, 1, 1636431242805, 1636431243078, 273, 0, 273, 0, 0, 0
9750, 1, 1636431243085, 1636431243357, 272, 0, 272, 0, 0, 0
9749, 1, 1636431243177, 1636431243441, 264, 0, 264, 0, 0, 0
9751, 1, 1636431243193, 1636431243465, 272, 0, 272, 0, 0, 0
9752, 1, 1636431243249, 1636431243522, 273, 0, 273, 0, 0, 0
9748, 1, 1636431243253, 1636431243522, 269, 1, 268, 0, 1, 1
9753, 1, 1636431243297, 1636431243565, 268, 1, 267, 0, 1, 1
9755, 1, 1636431243453, 1636431243726, 273, 1, 272, 0, 0, 0
9756, 1, 1636431243453, 1636431243726, 273, 1, 272, 1, 0, 1
9757, 1, 1636431243597, 1636431243869, 272, 1, 271, 1, 0, 1
9758, 1, 1636431243637, 1636431243910, 273, 0, 273, 0, 0, 0
9754, 1, 1636431243697, 1636431243965, 268, 1, 267, 0, 0, 0
9759, 1, 1636431243841, 1636431244113, 272, 1, 271, 1, 0, 1
9760, 1, 1636431243869, 1636431244129, 260, 0, 260, 0, 0, 0
9761, 1, 1636431243929, 1636431244197, 268, 1, 267, 0, 1, 1
9763, 1, 1636431243954, 1636431244222, 268, 0, 268, 0, 0, 0
9762, 1, 1636431243945, 1636431244222, 277, 0, 277, 0, 0, 0
9764, 1, 1636431244085, 1636431244357, 272, 1, 271, 0, 1, 1
9765, 1, 1636431244109, 1636431244377, 268, 1, 267, 0, 1, 1
9766, 1, 1636431244329, 1636431244601, 272, 0, 272, 0, 0, 0
9768, 1, 1636431244405, 1636431244681, 276, 1, 275, 0, 1, 1
9769, 1, 1636431244510, 1636431244778, 268, 0, 268, 0, 0, 0
9770, 1, 1636431244541, 1636431244809, 268, 1, 267, 0, 0, 0
9767, 1, 1636431244553, 1636431244829, 276, 1, 275, 0, 0, 0
9771, 1, 1636431244589, 1636431244865, 276, 0, 276, 0, 0, 0
9772, 1, 1636431244753, 1636431245025, 272, 1, 271, 0, 0, 0
9774, 1, 1636431244781, 1636431245053, 272, 0, 272, 0, 0, 0
9775, 1, 1636431244909, 1636431245181, 272, 1, 271, 0, 0, 0
9776, 1, 1636431244945, 1636431245221, 276, 1, 275, 0, 1, 1
9773, 1, 1636431244985, 1636431245257, 272, 0, 272, 0, 0, 0
9778, 1, 1636431245194, 1636431245461, 267, 0, 267, 0, 0, 0
9777, 1, 1636431245194, 1636431245461, 267, 0, 267, 0, 0, 0
9779, 1, 1636431245217, 1636431245486, 269, 0, 269, 0, 0, 0
9780, 1, 1636431245253, 1636431245525, 272, 0, 272, 0, 0, 0
9781, 1, 1636431245345, 1636431245617, 272, 0, 272, 0, 0, 0
9782, 1, 1636431245454, 1636431245730, 276, 0, 276, 0, 0, 0
9783, 1, 1636431245465, 1636431245733, 268, 0, 268, 0, 0, 0
9784, 1, 1636431245657, 1636431245929, 272, 1, 271, 1, 0, 1
9786, 1, 1636431245749, 1636431246025, 276, 0, 276, 0, 0, 0
9787, 1, 1636431245869, 1636431246141, 272, 0, 272, 0, 0, 0
9788, 1, 1636431245881, 1636431246153, 272, 0, 272, 0, 0, 0
9785, 1, 1636431245905, 1636431246173, 268, 0, 268, 0, 0, 0
9789, 1, 1636431245933, 1636431246205, 272, 0, 272, 0, 0, 0
9790, 1, 1636431246117, 1636431246393, 276, 0, 276, 0, 0, 0
9792, 1, 1636431246141, 1636431246414, 273, 1, 272, 0, 0, 0
9793, 1, 1636431246297, 1636431246561, 264, 0, 264, 0, 0, 0
9794, 1, 1636431246337, 1636431246606, 269, 1, 268, 0, 1, 1
9791, 1, 1636431246385, 1636431246653, 268, 0, 268, 0, 0, 0
9795, 1, 1636431246473, 1636431246745, 272, 1, 271, 0, 1, 1
9796, 1, 1636431246485, 1636431246753, 268, 0, 268, 0, 0, 0
9797, 1, 1636431246589, 1636431246849, 260, 1, 259, 0, 0, 0
9798, 1, 1636431246625, 1636431246889, 264, 0, 264, 0, 0, 0
9799, 1, 1636431246689, 1636431246958, 269, 0, 269, 0, 0, 0
9800, 1, 1636431246761, 1636431247033, 272, 0, 272, 0, 0, 0
9801, 1, 1636431246798, 1636431247069, 271, 0, 271, 0, 0, 0
9802, 1, 1636431246989, 1636431247261, 272, 0, 272, 0, 0, 0
9804, 1, 1636431247157, 1636431247429, 272, 1, 271, 0, 1, 1
9805, 1, 1636431247193, 1636431247469, 276, 1, 275, 0, 1, 1
9803, 1, 1636431247209, 1636431247485, 276, 1, 275, 0, 1, 1
9806, 1, 1636431247213, 1636431247485, 272, 1, 271, 0, 0, 0
9807, 1, 1636431247249, 1636431247521, 272, 1, 271, 0, 0, 0
9809, 1, 1636431247442, 1636431247713, 271, 0, 271, 0, 0, 0
9810, 1, 1636431247502, 1636431247782, 280, 0, 280, 0, 0, 0
9808, 1, 1636431247665, 1636431247933, 268, 0, 268, 0, 0, 0
9811, 1, 1636431247693, 1636431247961, 268, 1, 267, 0, 1, 1
9812, 1, 1636431247709, 1636431247977, 268, 1, 267, 0, 0, 0
9813, 1, 1636431247829, 1636431248097, 268, 1, 267, 1, 0, 1
9814, 1, 1636431247833, 1636431248105, 272, 1, 271, 0, 1, 1
9815, 1, 1636431247913, 1636431248185, 272, 1, 271, 0, 1, 1
9816, 1, 1636431247973, 1636431248233, 260, 1, 259, 1, 0, 1
9817, 1, 1636431247977, 1636431248250, 273, 1, 272, 1, 0, 1
9818, 1, 1636431248137, 1636431248405, 268, 0, 268, 0, 0, 0
9819, 1, 1636431248181, 1636431248453, 272, 1, 271, 0, 1, 1
9821, 1, 1636431248389, 1636431248657, 268, 1, 267, 1, 0, 1
9822, 1, 1636431248449, 1636431248717, 268, 0, 268, 0, 0, 0
9823, 1, 1636431248493, 1636431248761, 268, 0, 268, 0, 0, 0
9824, 1, 1636431248581, 1636431248849, 268, 1, 267, 0, 1, 1
9820, 1, 1636431248585, 1636431248849, 264, 0, 264, 0, 0, 0
9826, 1, 1636431248717, 1636431248989, 272, 1, 271, 0, 1, 1
9828, 1, 1636431248889, 1636431249161, 272, 1, 271, 0, 0, 0
9827, 1, 1636431248933, 1636431249209, 276, 1, 275, 0, 0, 0
9829, 1, 1636431248993, 1636431249257, 264, 0, 264, 0, 0, 0
9830, 1, 1636431249026, 1636431249301, 275, 0, 275, 0, 0, 0
9825, 1, 1636431249029, 1636431249301, 272, 0, 272, 0, 0, 0
9831, 1, 1636431249125, 1636431249405, 280, 0, 280, 0, 0, 0
9832, 1, 1636431249205, 1636431249478, 273, 0, 273, 0, 0, 0
9833, 1, 1636431249273, 1636431249545, 272, 1, 271, 0, 1, 1
9834, 1, 1636431249337, 1636431249609, 272, 0, 272, 0, 0, 0
9835, 1, 1636431249377, 1636431249645, 268, 1, 267, 1, 0, 1
9836, 1, 1636431249457, 1636431249733, 276, 0, 276, 0, 0, 0
9837, 1, 1636431249493, 1636431249765, 272, 0, 272, 0, 0, 0
9839, 1, 1636431249761, 1636431250029, 268, 1, 267, 0, 0, 0
9840, 1, 1636431249809, 1636431250081, 272, 0, 272, 0, 0, 0
9841, 1, 1636431249873, 1636431250146, 273, 0, 273, 0, 0, 0
9838, 1, 1636431249941, 1636431250217, 276, 1, 275, 0, 1, 1
9842, 1, 1636431249941, 1636431250217, 276, 1, 275, 0, 0, 0
9843, 1, 1636431249965, 1636431250237, 272, 0, 272, 0, 0, 0
9845, 1, 1636431250073, 1636431250341, 268, 1, 267, 1, 0, 1
9846, 1, 1636431250281, 1636431250549, 268, 1, 267, 1, 0, 1
9847, 1, 1636431250293, 1636431250565, 272, 1, 271, 0, 0, 0
9844, 1, 1636431250325, 1636431250597, 272, 0, 272, 0, 0, 0
9848, 1, 1636431250389, 1636431250653, 264, 0, 264, 0, 0, 0
9849, 1, 1636431250429, 1636431250710, 281, 1, 280, 0, 0, 0
9850, 1, 1636431250537, 1636431250802, 265, 0, 265, 0, 0, 0
9851, 1, 1636431250549, 1636431250821, 272, 0, 272, 0, 0, 0
9852, 1, 1636431250681, 1636431250954, 273, 0, 273, 0, 0, 0
9854, 1, 1636431250769, 1636431251041, 272, 0, 272, 0, 0, 0
9855, 1, 1636431250813, 1636431251089, 276, 0, 276, 0, 0, 0
9853, 1, 1636431250981, 1636431251253, 272, 1, 271, 0, 0, 0
9857, 1, 1636431251078, 1636431251346, 268, 0, 268, 0, 0, 0
9856, 1, 1636431251217, 1636431251489, 272, 1, 271, 0, 1, 1
9859, 1, 1636431251217, 1636431251490, 273, 1, 272, 1, 0, 1
9860, 1, 1636431251233, 1636431251501, 268, 0, 268, 0, 0, 0
9858, 1, 1636431251269, 1636431251537, 268, 1, 267, 0, 0, 0
9861, 1, 1636431251277, 1636431251546, 269, 1, 268, 0, 1, 1
9862, 1, 1636431251382, 1636431251657, 275, 0, 275, 0, 0, 0
9864, 1, 1636431251601, 1636431251878, 277, 1, 276, 0, 0, 0
9865, 1, 1636431251621, 1636431251893, 272, 0, 272, 0, 0, 0
9866, 1, 1636431251685, 1636431251953, 268, 0, 268, 0, 0, 0
9863, 1, 1636431251677, 1636431251954, 277, 1, 276, 1, 0, 1
9867, 1, 1636431251817, 1636431252085, 268, 0, 268, 0, 0, 0
9868, 1, 1636431251849, 1636431252125, 276, 1, 275, 0, 0, 0
9869, 1, 1636431251905, 1636431252173, 268, 1, 267, 0, 0, 0
9870, 1, 1636431252025, 1636431252293, 268, 1, 267, 1, 0, 1
9871, 1, 1636431252077, 1636431252345, 268, 1, 267, 0, 0, 0
9872, 1, 1636431252109, 1636431252385, 276, 1, 275, 1, 0, 1
9873, 1, 1636431252265, 1636431252533, 268, 0, 268, 0, 0, 0
9874, 1, 1636431252377, 1636431252649, 272, 0, 272, 0, 0, 0
9876, 1, 1636431252433, 1636431252705, 272, 1, 271, 0, 1, 1
9877, 1, 1636431252509, 1636431252778, 269, 1, 268, 0, 0, 0
9878, 1, 1636431252561, 1636431252829, 268, 1, 267, 0, 1, 1
9875, 1, 1636431252561, 1636431252837, 276, 1, 275, 1, 0, 1
9879, 1, 1636431252598, 1636431252869, 271, 0, 271, 0, 0, 0
9880, 1, 1636431252657, 1636431252925, 268, 0, 268, 0, 0, 0
9882, 1, 1636431253009, 1636431253281, 272, 0, 272, 0, 0, 0
9883, 1, 1636431253013, 1636431253285, 272, 1, 271, 0, 0, 0
9881, 1, 1636431253045, 1636431253317, 272, 1, 271, 1, 0, 1
9884, 1, 1636431253177, 1636431253449, 272, 1, 271, 0, 1, 1
9885, 1, 1636431253205, 1636431253474, 269, 1, 268, 0, 0, 0
9886, 1, 1636431253225, 1636431253497, 272, 1, 271, 0, 0, 0
9887, 1, 1636431253401, 1636431253677, 276, 1, 275, 0, 1, 1
9888, 1, 1636431253449, 1636431253721, 272, 0, 272, 0, 0, 0
9889, 1, 1636431253490, 1636431253757, 267, 0, 267, 0, 0, 0
9890, 1, 1636431253541, 1636431253805, 264, 0, 264, 0, 0, 0
9891, 1, 1636431253665, 1636431253929, 264, 1, 263, 0, 0, 0
9893, 1, 1636431253825, 1636431254089, 264, 1, 263, 1, 0, 1
9894, 1, 1636431253841, 1636431254105, 264, 0, 264, 0, 0, 0
9895, 1, 1636431253917, 1636431254181, 264, 0, 264, 0, 0, 0
9892, 1, 1636431253929, 1636431254197, 268, 0, 268, 0, 0, 0
9896, 1, 1636431253949, 1636431254221, 272, 1, 271, 0, 0, 0
9897, 1, 1636431253977, 1636431254249, 272, 0, 272, 0, 0, 0
9899, 1, 1636431254306, 1636431254577, 271, 0, 271, 0, 0, 0
9900, 1, 1636431254369, 1636431254641, 272, 1, 271, 0, 1, 1
9898, 1, 1636431254425, 1636431254697, 272, 1, 271, 0, 0, 0
9901, 1, 1636431254449, 1636431254722, 273, 0, 273, 0, 0, 0
9902, 1, 1636431254541, 1636431254813, 272, 1, 271, 0, 0, 0
9903, 1, 1636431254617, 1636431254890, 273, 0, 273, 0, 0, 0
9904, 1, 1636431254689, 1636431254957, 268, 0, 268, 0, 0, 0
9906, 1, 1636431254813, 1636431255081, 268, 1, 267, 1, 0, 1
9907, 1, 1636431254853, 1636431255122, 269, 0, 269, 0, 0, 0
9905, 1, 1636431254898, 1636431255169, 271, 0, 271, 0, 0, 0
9910, 1, 1636431255185, 1636431255461, 276, 0, 276, 0, 0, 0
9911, 1, 1636431255301, 1636431255573, 272, 0, 272, 0, 0, 0
9912, 1, 1636431255321, 1636431255593, 272, 0, 272, 0, 0, 0
9913, 1, 1636431255349, 1636431255614, 265, 0, 265, 0, 0, 0
9916, 1, 1636431255742, 1636431256010, 268, 0, 268, 0, 0, 0
9917, 1, 1636431255757, 1636431256029, 272, 1, 271, 0, 1, 1
9914, 1, 1636431255794, 1636431256061, 267, 0, 267, 0, 0, 0
9918, 1, 1636431255853, 1636431256125, 272, 1, 271, 0, 0, 0
9919, 1, 1636431255878, 1636431256145, 267, 0, 267, 0, 0, 0
9920, 1, 1636431255973, 1636431256238, 265, 0, 265, 0, 0, 0
9922, 1, 1636431256145, 1636431256413, 268, 1, 267, 1, 0, 1
9921, 1, 1636431256145, 1636431256421, 276, 1, 275, 0, 0, 0
9923, 1, 1636431256145, 1636431256422, 277, 1, 276, 0, 0, 0
9924, 1, 1636431256533, 1636431256806, 273, 0, 273, 0, 0, 0
9925, 1, 1636431256637, 1636431256913, 276, 1, 275, 0, 1, 1
9926, 1, 1636431256669, 1636431256946, 277, 1, 276, 0, 1, 1
9927, 1, 1636431256746, 1636431257018, 272, 0, 272, 0, 0, 0
9929, 1, 1636431257049, 1636431257322, 273, 0, 273, 0, 0, 0
9930, 1, 1636431257077, 1636431257349, 272, 1, 271, 0, 1, 1
9931, 1, 1636431257185, 1636431257457, 272, 1, 271, 0, 1, 1
9928, 1, 1636431257197, 1636431257461, 264, 0, 264, 0, 0, 0
9932, 1, 1636431257209, 1636431257486, 277, 1, 276, 0, 0, 0
9933, 1, 1636431257241, 1636431257505, 264, 1, 263, 1, 0, 1
9934, 1, 1636431257417, 1636431257690, 273, 0, 273, 0, 0, 0
9935, 1, 1636431257442, 1636431257709, 267, 0, 267, 0, 0, 0
9936, 1, 1636431257538, 1636431257809, 271, 0, 271, 0, 0, 0
9937, 1, 1636431257854, 1636431258122, 268, 0, 268, 0, 0, 0
9938, 1, 1636431257917, 1636431258186, 269, 0, 269, 0, 0, 0
9939, 1, 1636431258061, 1636431258333, 272, 0, 272, 0, 0, 0
9940, 1, 1636431258097, 1636431258369, 272, 0, 272, 0, 0, 0
9942, 1, 1636431258385, 1636431258658, 273, 1, 272, 0, 1, 1
9943, 1, 1636431258445, 1636431258717, 272, 1, 271, 0, 1, 1
9944, 1, 1636431258461, 1636431258729, 268, 1, 267, 0, 1, 1
9945, 1, 1636431258482, 1636431258745, 263, 0, 263, 0, 0, 0
9941, 1, 1636431258545, 1636431258809, 264, 0, 264, 0, 0, 0
9946, 1, 1636431258590, 1636431258854, 264, 0, 264, 0, 0, 0
9947, 1, 1636431258713, 1636431258982, 269, 1, 268, 0, 1, 1
9948, 1, 1636431258761, 1636431259029, 268, 0, 268, 0, 0, 0
9949, 1, 1636431258921, 1636431259190, 269, 1, 268, 0, 1, 1
9950, 1, 1636431259182, 1636431259454, 272, 0, 272, 0, 0, 0
9951, 1, 1636431259241, 1636431259517, 276, 1, 275, 0, 1, 1
9952, 1, 1636431259365, 1636431259637, 272, 1, 271, 0, 0, 0
9953, 1, 1636431259450, 1636431259722, 272, 0, 272, 0, 0, 0
9955, 1, 1636431259678, 1636431259954, 276, 0, 276, 0, 0, 0
9956, 1, 1636431259725, 1636431259989, 264, 0, 264, 0, 0, 0
9957, 1, 1636431259769, 1636431260033, 264, 1, 263, 0, 0, 0
9958, 1, 1636431259785, 1636431260053, 268, 1, 267, 0, 0, 0
9954, 1, 1636431259898, 1636431260166, 268, 0, 268, 0, 0, 0
9960, 1, 1636431260025, 1636431260294, 269, 1, 268, 0, 1, 1
9962, 1, 1636431260166, 1636431260437, 271, 0, 271, 0, 0, 0
9959, 1, 1636431260225, 1636431260497, 272, 1, 271, 0, 0, 0
9961, 1, 1636431260478, 1636431260749, 271, 0, 271, 0, 0, 0
9963, 1, 1636431260537, 1636431260810, 273, 1, 272, 1, 0, 1
9964, 1, 1636431260681, 1636431260949, 268, 1, 267, 0, 1, 1
9965, 1, 1636431260769, 1636431261041, 272, 0, 272, 0, 0, 0
9966, 1, 1636431260817, 1636431261081, 264, 0, 264, 0, 0, 0
9968, 1, 1636431260949, 1636431261221, 272, 1, 271, 0, 1, 1
9969, 1, 1636431260997, 1636431261265, 268, 0, 268, 0, 0, 0
9970, 1, 1636431261070, 1636431261341, 271, 0, 271, 0, 0, 0
9971, 1, 1636431261117, 1636431261385, 268, 0, 268, 0, 0, 0
9972, 1, 1636431261161, 1636431261429, 268, 0, 268, 0, 0, 0
9967, 1, 1636431261253, 1636431261517, 264, 0, 264, 0, 0, 0
9974, 1, 1636431261373, 1636431261646, 273, 0, 273, 0, 0, 0
9973, 1, 1636431261381, 1636431261653, 272, 1, 271, 1, 0, 1
9975, 1, 1636431261506, 1636431261778, 272, 0, 272, 0, 0, 0
9976, 1, 1636431261889, 1636431262166, 277, 1, 276, 0, 0, 0
9977, 1, 1636431261917, 1636431262189, 272, 0, 272, 0, 0, 0
9978, 1, 1636431262097, 1636431262366, 269, 0, 269, 0, 0, 0
9979, 1, 1636431262142, 1636431262410, 268, 0, 268, 0, 0, 0
9981, 1, 1636431262298, 1636431262561, 263, 0, 263, 0, 0, 0
9982, 1, 1636431262309, 1636431262577, 268, 1, 267, 1, 0, 1
9983, 1, 1636431262422, 1636431262689, 267, 0, 267, 0, 0, 0
9984, 1, 1636431262437, 1636431262705, 268, 1, 267, 0, 0, 0
9985, 1, 1636431262509, 1636431262781, 272, 0, 272, 0, 0, 0
9980, 1, 1636431262585, 1636431262854, 269, 0, 269, 0, 0, 0
9986, 1, 1636431262669, 1636431262945, 276, 0, 276, 0, 0, 0
9987, 1, 1636431262701, 1636431262974, 273, 0, 273, 0, 0, 0
9989, 1, 1636431263209, 1636431263481, 272, 1, 271, 0, 1, 1
9990, 1, 1636431263277, 1636431263545, 268, 1, 267, 0, 0, 0
9991, 1, 1636431263406, 1636431263677, 271, 0, 271, 0, 0, 0
9992, 1, 1636431263430, 1636431263701, 271, 0, 271, 0, 0, 0
9994, 1, 1636431263613, 1636431263886, 273, 1, 272, 0, 1, 1
9995, 1, 1636431263625, 1636431263905, 280, 1, 279, 0, 0, 0
9997, 1, 1636431263825, 1636431264097, 272, 1, 271, 0, 0, 0
9993, 1, 1636431263857, 1636431264129, 272, 1, 271, 1, 0, 1
9999, 1, 1636431263958, 1636431264230, 272, 0, 272, 0, 0, 0
9998, 1, 1636431264066, 1636431264338, 272, 0, 272, 0, 0, 0
10000, 1, 1636431264310, 1636431264582, 272, 0, 272, 0, 0, 0
10001, 1, 1636431264577, 1636431264849, 272, 1, 271, 0, 0, 0
10003, 1, 1636431264710, 1636431264982, 272, 0, 272, 0, 0, 0
10004, 1, 1636431264765, 1636431265082, 317, 1, 316, 0, 1, 1
10006, 1, 1636431264910, 1636431265177, 267, 0, 267, 0, 0, 0
10005, 1, 1636431265165, 1636431265434, 269, 1, 268, 0, 1, 1
10007, 1, 1636431265169, 1636431265437, 268, 0, 268, 0, 0, 0
10008, 1, 1636431265194, 1636431265462, 268, 0, 268, 0, 0, 0
10009, 1, 1636431265345, 1636431265621, 276, 1, 275, 0, 0, 0
10010, 1, 1636431265390, 1636431265661, 271, 0, 271, 0, 0, 0
10011, 1, 1636431265669, 1636431265937, 268, 1, 267, 1, 0, 1
10012, 1, 1636431265669, 1636431265937, 268, 1, 267, 1, 0, 1
10014, 1, 1636431265909, 1636431266181, 272, 0, 272, 0, 0, 0
10015, 1, 1636431266102, 1636431266369, 267, 0, 267, 0, 0, 0
10016, 1, 1636431266110, 1636431266381, 271, 0, 271, 0, 0, 0
10013, 1, 1636431266117, 1636431266382, 265, 1, 264, 0, 0, 0
10018, 1, 1636431266189, 1636431266457, 268, 1, 267, 0, 1, 1
10019, 1, 1636431266517, 1636431266789, 272, 0, 272, 0, 0, 0
10020, 1, 1636431266533, 1636431266802, 269, 1, 268, 0, 0, 0
10017, 1, 1636431266550, 1636431266813, 263, 0, 263, 0, 0, 0
10021, 1, 1636431266649, 1636431266921, 272, 1, 271, 1, 0, 1
10023, 1, 1636431266906, 1636431267174, 268, 0, 268, 0, 0, 0
10024, 1, 1636431266949, 1636431267225, 276, 0, 276, 0, 0, 0
10022, 1, 1636431266994, 1636431267265, 271, 0, 271, 0, 0, 0
10026, 1, 1636431267210, 1636431267482, 272, 0, 272, 0, 0, 0
10025, 1, 1636431267349, 1636431267622, 273, 1, 272, 1, 0, 1
10027, 1, 1636431267373, 1636431267645, 272, 0, 272, 0, 0, 0
10030, 1, 1636431267497, 1636431267769, 272, 1, 271, 0, 0, 0
10029, 1, 1636431267497, 1636431267770, 273, 1, 272, 0, 0, 0
10031, 1, 1636431267810, 1636431268086, 276, 0, 276, 0, 0, 0
10028, 1, 1636431267829, 1636431268101, 272, 1, 271, 0, 1, 1
10032, 1, 1636431267865, 1636431268137, 272, 1, 271, 0, 1, 1
10034, 1, 1636431267997, 1636431268262, 265, 0, 265, 0, 0, 0
10033, 1, 1636431267990, 1636431268262, 272, 0, 272, 0, 0, 0
10035, 1, 1636431268197, 1636431268473, 276, 1, 275, 1, 0, 1
10036, 1, 1636431268282, 1636431268554, 272, 0, 272, 0, 0, 0
10038, 1, 1636431268518, 1636431268786, 268, 0, 268, 0, 0, 0
10037, 1, 1636431268653, 1636431268930, 277, 1, 276, 0, 1, 1
10039, 1, 1636431268741, 1636431269013, 272, 1, 271, 0, 0, 0
10040, 1, 1636431268821, 1636431269093, 272, 1, 271, 1, 0, 1
10042, 1, 1636431268850, 1636431269122, 272, 0, 272, 0, 0, 0
10041, 1, 1636431269197, 1636431269469, 272, 1, 271, 0, 0, 0
10043, 1, 1636431269205, 1636431269477, 272, 1, 271, 0, 1, 1
10044, 1, 1636431269270, 1636431269541, 271, 0, 271, 0, 0, 0
10045, 1, 1636431269353, 1636431269626, 273, 0, 273, 0, 0, 0
10046, 1, 1636431269385, 1636431269657, 272, 1, 271, 0, 0, 0
10047, 1, 1636431269493, 1636431269770, 277, 0, 277, 0, 0, 0
10048, 1, 1636431269609, 1636431269877, 268, 1, 267, 1, 0, 1
10050, 1, 1636431269865, 1636431270133, 268, 1, 267, 0, 0, 0
10049, 1, 1636431269949, 1636431270222, 273, 1, 272, 0, 0, 0
10051, 1, 1636431270101, 1636431270370, 269, 1, 268, 0, 0, 0
10052, 1, 1636431270122, 1636431270394, 272, 0, 272, 0, 0, 0
10054, 1, 1636431270230, 1636431270501, 271, 0, 271, 0, 0, 0
10053, 1, 1636431270553, 1636431270825, 272, 1, 271, 0, 1, 1
10055, 1, 1636431270601, 1636431270870, 269, 1, 268, 0, 0, 0
10056, 1, 1636431270605, 1636431270870, 265, 1, 264, 1, 0, 1
10057, 1, 1636431270686, 1636431270954, 268, 0, 268, 0, 0, 0
10058, 1, 1636431270733, 1636431271005, 272, 1, 271, 0, 0, 0
10059, 1, 1636431270873, 1636431271142, 269, 0, 269, 0, 0, 0
10060, 1, 1636431271009, 1636431271282, 273, 1, 272, 0, 0, 0
10062, 1, 1636431271206, 1636431271478, 272, 0, 272, 0, 0, 0
10061, 1, 1636431271313, 1636431271590, 277, 1, 276, 0, 1, 1
10063, 1, 1636431271402, 1636431271674, 272, 0, 272, 0, 0, 0
10064, 1, 1636431271421, 1636431271698, 277, 0, 277, 0, 0, 0
10066, 1, 1636431271553, 1636431271826, 273, 1, 272, 0, 0, 0
10065, 1, 1636431271881, 1636431272153, 272, 1, 271, 0, 0, 0
10067, 1, 1636431271933, 1636431272205, 272, 1, 271, 0, 1, 1
10068, 1, 1636431271973, 1636431272246, 273, 0, 273, 0, 0, 0
10069, 1, 1636431272033, 1636431272302, 269, 0, 269, 0, 0, 0
10070, 1, 1636431272117, 1636431272381, 264, 1, 263, 0, 0, 0
10071, 1, 1636431272201, 1636431272469, 268, 1, 267, 0, 0, 0
10072, 1, 1636431272361, 1636431272633, 272, 1, 271, 0, 1, 1
10074, 1, 1636431272586, 1636431272857, 271, 0, 271, 0, 0, 0
10073, 1, 1636431272649, 1636431272933, 284, 1, 283, 0, 1, 1
10075, 1, 1636431272701, 1636431272974, 273, 1, 272, 0, 1, 1
10076, 1, 1636431272769, 1636431273038, 269, 0, 269, 0, 0, 0
10077, 1, 1636431272853, 1636431273126, 273, 0, 273, 0, 0, 0
10079, 1, 1636431273189, 1636431273461, 272, 1, 271, 1, 0, 1
10078, 1, 1636431273218, 1636431273489, 271, 0, 271, 0, 0, 0
10080, 1, 1636431273273, 1636431273546, 273, 1, 272, 0, 0, 0
10081, 1, 1636431273305, 1636431273581, 276, 1, 275, 0, 1, 1
10083, 1, 1636431273389, 1636431273661, 272, 1, 271, 1, 0, 1
10084, 1, 1636431273605, 1636431273878, 273, 1, 272, 0, 1, 1
10082, 1, 1636431273642, 1636431273945, 303, 0, 303, 0, 0, 0
10085, 1, 1636431273697, 1636431273969, 272, 1, 271, 0, 1, 1
10002, 1, 1636431273801, 1636431274077, 276, 0, 276, 0, 0, 0
10087, 1, 1636431273893, 1636431274169, 276, 0, 276, 0, 0, 0
10088, 1, 1636431273989, 1636431274257, 268, 0, 268, 0, 0, 0
10086, 1, 1636431274053, 1636431274325, 272, 1, 271, 1, 0, 1
10090, 1, 1636431274105, 1636431274381, 276, 1, 275, 0, 0, 0
10089, 1, 1636431274122, 1636431274393, 271, 0, 271, 0, 0, 0
10091, 1, 1636431274117, 1636431274394, 277, 1, 276, 0, 0, 0
10094, 1, 1636431274437, 1636431274705, 268, 1, 267, 0, 1, 1
10093, 1, 1636431274565, 1636431274834, 269, 0, 269, 0, 0, 0
10092, 1, 1636431274561, 1636431274834, 273, 0, 273, 0, 0, 0
10095, 1, 1636431274610, 1636431274881, 271, 0, 271, 0, 0, 0
10096, 1, 1636431274673, 1636431274945, 272, 1, 271, 0, 0, 0
10097, 1, 1636431274685, 1636431274954, 269, 0, 269, 0, 0, 0
10099, 1, 1636431274969, 1636431275245, 276, 1, 275, 1, 0, 1
10100, 1, 1636431274969, 1636431275246, 277, 1, 276, 0, 1, 1
10098, 1, 1636431275013, 1636431275281, 268, 0, 268, 0, 0, 0
10103, 1, 1636431275369, 1636431275649, 280, 0, 280, 0, 0, 0
10104, 1, 1636431275397, 1636431275669, 272, 0, 272, 0, 0, 0
10101, 1, 1636431275429, 1636431275701, 272, 0, 272, 0, 0, 0
10106, 1, 1636431275445, 1636431275713, 268, 0, 268, 0, 0, 0
10105, 1, 1636431275441, 1636431275713, 272, 0, 272, 0, 0, 0
10102, 1, 1636431275461, 1636431275737, 276, 0, 276, 0, 0, 0
10109, 1, 1636431275809, 1636431276078, 269, 1, 268, 0, 0, 0
10108, 1, 1636431275849, 1636431276125, 276, 0, 276, 0, 0, 0
10107, 1, 1636431275898, 1636431276161, 263, 0, 263, 0, 0, 0
10110, 1, 1636431275973, 1636431276245, 272, 0, 272, 0, 0, 0
10112, 1, 1636431276069, 1636431276337, 268, 1, 267, 0, 1, 1
10113, 1, 1636431276081, 1636431276357, 276, 0, 276, 0, 0, 0
10114, 1, 1636431276285, 1636431276562, 277, 0, 277, 0, 0, 0
10115, 1, 1636431276337, 1636431276609, 272, 1, 271, 0, 1, 1
10111, 1, 1636431276337, 1636431276609, 272, 1, 271, 0, 0, 0
10117, 1, 1636431276637, 1636431276913, 276, 0, 276, 0, 0, 0
10118, 1, 1636431276681, 1636431276958, 277, 0, 277, 0, 0, 0
10116, 1, 1636431276741, 1636431277013, 272, 1, 271, 0, 1, 1
10119, 1, 1636431276745, 1636431277017, 272, 1, 271, 0, 0, 0
10120, 1, 1636431276761, 1636431277033, 272, 0, 272, 0, 0, 0
10121, 1, 1636431276805, 1636431277078, 273, 1, 272, 0, 1, 1
10124, 1, 1636431277141, 1636431277417, 276, 1, 275, 0, 1, 1
10123, 1, 1636431277193, 1636431277465, 272, 1, 271, 0, 1, 1
10122, 1, 1636431277253, 1636431277521, 268, 1, 267, 0, 1, 1
10125, 1, 1636431277317, 1636431277585, 268, 1, 267, 0, 0, 0
10126, 1, 1636431277333, 1636431277609, 276, 1, 275, 0, 1, 1
10127, 1, 1636431277349, 1636431277617, 268, 1, 267, 0, 1, 1
10128, 1, 1636431277433, 1636431277701, 268, 1, 267, 0, 1, 1
10129, 1, 1636431277681, 1636431277953, 272, 0, 272, 0, 0, 0
10130, 1, 1636431277701, 1636431277974, 273, 1, 272, 1, 0, 1
10132, 1, 1636431277993, 1636431278261, 268, 0, 268, 0, 0, 0
10133, 1, 1636431278069, 1636431278338, 269, 1, 268, 0, 1, 1
10134, 1, 1636431278081, 1636431278349, 268, 0, 268, 0, 0, 0
10135, 1, 1636431278125, 1636431278393, 268, 1, 267, 0, 0, 0
10131, 1, 1636431278141, 1636431278401, 260, 1, 259, 0, 0, 0
10136, 1, 1636431278518, 1636431278785, 267, 0, 267, 0, 0, 0
10137, 1, 1636431278533, 1636431278806, 273, 0, 273, 0, 0, 0
10138, 1, 1636431278538, 1636431278806, 268, 0, 268, 0, 0, 0
10139, 1, 1636431278613, 1636431278889, 276, 1, 275, 0, 0, 0
10140, 1, 1636431278733, 1636431279001, 268, 0, 268, 0, 0, 0
10142, 1, 1636431278769, 1636431279037, 268, 0, 268, 0, 0, 0
10141, 1, 1636431279069, 1636431279337, 268, 1, 267, 0, 0, 0
10143, 1, 1636431279081, 1636431279357, 276, 0, 276, 0, 0, 0
10144, 1, 1636431279085, 1636431279357, 272, 0, 272, 0, 0, 0
10146, 1, 1636431279282, 1636431279549, 267, 0, 267, 0, 0, 0
10147, 1, 1636431279402, 1636431279669, 267, 0, 267, 0, 0, 0
10148, 1, 1636431279421, 1636431279694, 273, 1, 272, 1, 0, 1
10149, 1, 1636431279469, 1636431279741, 272, 0, 272, 0, 0, 0
10145, 1, 1636431279537, 1636431279813, 276, 1, 275, 0, 0, 0
10150, 1, 1636431279853, 1636431280129, 276, 1, 275, 1, 0, 1
10151, 1, 1636431279922, 1636431280193, 271, 0, 271, 0, 0, 0
10153, 1, 1636431279997, 1636431280269, 272, 0, 272, 0, 0, 0
10154, 1, 1636431280097, 1636431280366, 269, 1, 268, 1, 0, 1
10155, 1, 1636431280101, 1636431280366, 265, 0, 265, 0, 0, 0
10156, 1, 1636431280121, 1636431280393, 272, 1, 271, 0, 1, 1
10152, 1, 1636431280369, 1636431280633, 264, 0, 264, 0, 0, 0
10157, 1, 1636431280386, 1636431280657, 271, 0, 271, 0, 0, 0
10158, 1, 1636431280409, 1636431280678, 269, 0, 269, 0, 0, 0
10161, 1, 1636431280693, 1636431280961, 268, 0, 268, 0, 0, 0
10162, 1, 1636431280813, 1636431281085, 272, 1, 271, 1, 0, 1
10160, 1, 1636431280813, 1636431281085, 272, 1, 271, 0, 1, 1
10159, 1, 1636431280854, 1636431281122, 268, 0, 268, 0, 0, 0
10164, 1, 1636431281146, 1636431281422, 276, 0, 276, 0, 0, 0
10165, 1, 1636431281265, 1636431281537, 272, 0, 272, 0, 0, 0
10166, 1, 1636431281289, 1636431281561, 272, 1, 271, 0, 1, 1
10167, 1, 1636431281386, 1636431281657, 271, 0, 271, 0, 0, 0
10169, 1, 1636431281402, 1636431281669, 267, 0, 267, 0, 0, 0
10168, 1, 1636431281394, 1636431281669, 275, 0, 275, 0, 0, 0
10170, 1, 1636431281518, 1636431281785, 267, 0, 267, 0, 0, 0
10171, 1, 1636431281677, 1636431281946, 269, 0, 269, 0, 0, 0
10163, 1, 1636431281721, 1636431281990, 269, 1, 268, 0, 1, 1
10172, 1, 1636431281789, 1636431282065, 276, 0, 276, 0, 0, 0
10174, 1, 1636431281961, 1636431282233, 272, 1, 271, 0, 0, 0
10176, 1, 1636431282153, 1636431282421, 268, 0, 268, 0, 0, 0
10175, 1, 1636431282169, 1636431282441, 272, 1, 271, 0, 0, 0
10173, 1, 1636431282245, 1636431282517, 272, 0, 272, 0, 0, 0
10178, 1, 1636431282385, 1636431282661, 276, 0, 276, 0, 0, 0
10177, 1, 1636431282413, 1636431282681, 268, 1, 267, 1, 0, 1
10179, 1, 1636431282469, 1636431282738, 269, 1, 268, 0, 0, 0
10180, 1, 1636431282637, 1636431282905, 268, 0, 268, 0, 0, 0
10181, 1, 1636431282673, 1636431282945, 272, 0, 272, 0, 0, 0
10182, 1, 1636431282717, 1636431282985, 268, 1, 267, 0, 0, 0
10183, 1, 1636431282781, 1636431283049, 268, 1, 267, 1, 0, 1
10184, 1, 1636431282805, 1636431283077, 272, 1, 271, 1, 0, 1
10185, 1, 1636431282945, 1636431283222, 277, 1, 276, 0, 0, 0
10186, 1, 1636431283118, 1636431283394, 276, 0, 276, 0, 0, 0
10188, 1, 1636431283273, 1636431283542, 269, 1, 268, 1, 0, 1
10189, 1, 1636431283374, 1636431283649, 275, 0, 275, 0, 0, 0
10190, 1, 1636431283441, 1636431283714, 273, 0, 273, 0, 0, 0
10187, 1, 1636431283581, 1636431283849, 268, 1, 267, 0, 0, 0
10192, 1, 1636431283658, 1636431283925, 267, 0, 267, 0, 0, 0
10191, 1, 1636431283717, 1636431283981, 264, 0, 264, 0, 0, 0
10193, 1, 1636431283861, 1636431284129, 268, 1, 267, 0, 1, 1
10194, 1, 1636431283941, 1636431284213, 272, 0, 272, 0, 0, 0
10195, 1, 1636431283957, 1636431284233, 276, 0, 276, 0, 0, 0
10196, 1, 1636431284081, 1636431284349, 268, 0, 268, 0, 0, 0
10198, 1, 1636431284157, 1636431284433, 276, 1, 275, 0, 0, 0
10199, 1, 1636431284241, 1636431284513, 272, 1, 271, 1, 0, 1
10197, 1, 1636431284309, 1636431284582, 273, 1, 272, 0, 0, 0
10200, 1, 1636431284489, 1636431284766, 277, 1, 276, 1, 0, 1
10202, 1, 1636431284589, 1636431284853, 264, 1, 263, 0, 0, 0
10203, 1, 1636431284741, 1636431285009, 268, 0, 268, 0, 0, 0
10204, 1, 1636431284773, 1636431285045, 272, 1, 271, 0, 0, 0
10206, 1, 1636431284929, 1636431285201, 272, 0, 272, 0, 0, 0
10201, 1, 1636431284941, 1636431285217, 276, 0, 276, 0, 0, 0
10205, 1, 1636431285033, 1636431285305, 272, 0, 272, 0, 0, 0
10207, 1, 1636431285158, 1636431285430, 272, 0, 272, 0, 0, 0
10208, 1, 1636431285293, 1636431285565, 272, 0, 272, 0, 0, 0
10209, 1, 1636431285301, 1636431285566, 265, 0, 265, 0, 0, 0
10210, 1, 1636431285393, 1636431285666, 273, 1, 272, 0, 0, 0
10211, 1, 1636431285393, 1636431285666, 273, 1, 272, 1, 0, 1
10212, 1, 1636431285430, 1636431285701, 271, 0, 271, 0, 0, 0
10213, 1, 1636431285581, 1636431285845, 264, 1, 263, 1, 0, 1
10215, 1, 1636431285862, 1636431286133, 271, 0, 271, 0, 0, 0
10214, 1, 1636431285866, 1636431286137, 271, 0, 271, 0, 0, 0
10217, 1, 1636431286070, 1636431286342, 272, 0, 272, 0, 0, 0
10219, 1, 1636431286133, 1636431286401, 268, 1, 267, 0, 1, 1
10220, 1, 1636431286217, 1636431286490, 273, 1, 272, 0, 0, 0
10216, 1, 1636431286317, 1636431286586, 269, 1, 268, 1, 0, 1
10218, 1, 1636431286317, 1636431286586, 269, 1, 268, 0, 0, 0
10221, 1, 1636431286521, 1636431286801, 280, 1, 279, 0, 1, 1
10222, 1, 1636431286586, 1636431286865, 279, 0, 279, 0, 0, 0
10223, 1, 1636431286689, 1636431286962, 273, 0, 273, 0, 0, 0
10224, 1, 1636431286701, 1636431286973, 272, 1, 271, 0, 0, 0
10225, 1, 1636431286733, 1636431287005, 272, 0, 272, 0, 0, 0
10226, 1, 1636431286769, 1636431287045, 276, 1, 275, 0, 0, 0
10227, 1, 1636431286889, 1636431287158, 269, 1, 268, 0, 0, 0
10228, 1, 1636431287117, 1636431287389, 272, 0, 272, 0, 0, 0
10229, 1, 1636431287141, 1636431287413, 272, 1, 271, 1, 0, 1
10232, 1, 1636431287426, 1636431287698, 272, 0, 272, 0, 0, 0
10233, 1, 1636431287433, 1636431287705, 272, 1, 271, 0, 0, 0
10234, 1, 1636431287545, 1636431287818, 273, 0, 273, 0, 0, 0
10230, 1, 1636431287569, 1636431287845, 276, 0, 276, 0, 0, 0
10231, 1, 1636431287590, 1636431287861, 271, 0, 271, 0, 0, 0
10235, 1, 1636431287881, 1636431288154, 273, 1, 272, 0, 0, 0
10236, 1, 1636431287965, 1636431288238, 273, 1, 272, 0, 0, 0
10237, 1, 1636431287985, 1636431288261, 276, 0, 276, 0, 0, 0
10238, 1, 1636431288074, 1636431288341, 267, 0, 267, 0, 0, 0
10239, 1, 1636431288077, 1636431288345, 268, 0, 268, 0, 0, 0
10240, 1, 1636431288081,