Xid, State, StartTime, EndTime, TransactionTime, ExecuteTime, CommunicationTime, ReadTime, WriteTime, DBTime
1, 1, 1636428084668, 1636428085149, 481, 58, 423, 20, 5, 25
2, 1, 1636428085522, 1636428085929, 407, 3, 404, 0, 1, 1
3, 1, 1636428086245, 1636428086654, 409, 6, 403, 0, 1, 1
4, 1, 1636428086969, 1636428087377, 408, 4, 404, 1, 1, 2
5, 1, 1636428087689, 1636428088098, 409, 2, 407, 0, 1, 1
6, 1, 1636428088409, 1636428088817, 408, 4, 404, 0, 1, 1
7, 1, 1636428089129, 1636428089538, 409, 4, 405, 1, 0, 1
8, 1, 1636428089849, 1636428090258, 409, 3, 406, 1, 0, 1
9, 1, 1636428090569, 1636428090986, 417, 4, 413, 0, 1, 1
10, 1, 1636428091297, 1636428091705, 408, 4, 404, 0, 0, 0
11, 1, 1636428092017, 1636428092425, 408, 2, 406, 1, 0, 1
12, 1, 1636428092737, 1636428093146, 409, 4, 405, 2, 0, 2
13, 1, 1636428093457, 1636428093865, 408, 4, 404, 1, 0, 1
15, 1, 1636428094177, 1636428094585, 408, 3, 405, 2, 0, 2
17, 1, 1636428094897, 1636428095305, 408, 3, 405, 2, 0, 2
19, 1, 1636428095617, 1636428096026, 409, 6, 403, 1, 1, 2
21, 1, 1636428096297, 1636428096661, 364, 4, 360, 0, 0, 0
23, 1, 1636428096928, 1636428097293, 365, 3, 362, 2, 0, 2
25, 1, 1636428097561, 1636428097925, 364, 2, 362, 1, 0, 1
27, 1, 1636428098201, 1636428098565, 364, 3, 361, 1, 1, 2
28, 1, 1636428098833, 1636428099197, 364, 2, 362, 2, 0, 2
30, 1, 1636428099469, 1636428099833, 364, 3, 361, 0, 0, 0
32, 1, 1636428100105, 1636428100465, 360, 2, 358, 2, 0, 2
34, 1, 1636428100737, 1636428101101, 364, 3, 361, 3, 0, 3
36, 1, 1636428101373, 1636428101737, 364, 2, 362, 0, 1, 1
38, 1, 1636428102005, 1636428102361, 356, 1, 355, 0, 0, 0
41, 1, 1636428102629, 1636428102993, 364, 3, 361, 0, 0, 0
44, 1, 1636428103265, 1636428103625, 360, 2, 358, 0, 0, 0
47, 1, 1636428103897, 1636428104257, 360, 2, 358, 1, 0, 1
50, 1, 1636428104525, 1636428104885, 360, 2, 358, 0, 1, 1
53, 1, 1636428105157, 1636428105521, 364, 2, 362, 0, 0, 0
56, 1, 1636428105793, 1636428106153, 360, 2, 358, 0, 1, 1
59, 1, 1636428106425, 1636428106793, 368, 1, 367, 0, 0, 0
62, 1, 1636428107065, 1636428107425, 360, 2, 358, 0, 1, 1
65, 1, 1636428107693, 1636428108052, 359, 1, 358, 0, 1, 1
68, 1, 1636428108321, 1636428108685, 364, 0, 364, 0, 0, 0
70, 1, 1636428108957, 1636428109321, 364, 2, 362, 0, 0, 0
73, 1, 1636428109593, 1636428109953, 360, 2, 358, 0, 1, 1
76, 1, 1636428110225, 1636428110593, 368, 2, 366, 0, 0, 0
79, 1, 1636428110861, 1636428111225, 364, 1, 363, 0, 1, 1
82, 1, 1636428111493, 1636428111853, 360, 1, 359, 0, 0, 0
85, 1, 1636428112125, 1636428112485, 360, 1, 359, 0, 0, 0
88, 1, 1636428112753, 1636428113113, 360, 2, 358, 1, 1, 2
91, 1, 1636428113385, 1636428113749, 364, 2, 362, 0, 0, 0
94, 1, 1636428114016, 1636428114377, 361, 3, 358, 1, 0, 1
97, 1, 1636428114645, 1636428115005, 360, 2, 358, 1, 1, 2
100, 1, 1636428115269, 1636428115633, 364, 2, 362, 0, 0, 0
103, 1, 1636428115900, 1636428116261, 361, 2, 359, 0, 0, 0
106, 1, 1636428116529, 1636428116889, 360, 1, 359, 0, 1, 1
109, 1, 1636428117157, 1636428117521, 364, 3, 361, 0, 0, 0
112, 1, 1636428117789, 1636428118153, 364, 1, 363, 0, 0, 0
115, 1, 1636428118425, 1636428118785, 360, 1, 359, 0, 1, 1
118, 1, 1636428119053, 1636428119413, 360, 2, 358, 0, 0, 0
121, 1, 1636428119685, 1636428120048, 363, 0, 363, 0, 0, 0
124, 1, 1636428120313, 1636428120677, 364, 0, 364, 0, 0, 0
127, 1, 1636428120945, 1636428121309, 364, 2, 362, 0, 1, 1
130, 1, 1636428121581, 1636428121949, 368, 1, 367, 0, 0, 0
133, 1, 1636428122217, 1636428122581, 364, 1, 363, 0, 1, 1
136, 1, 1636428122849, 1636428123213, 364, 1, 363, 0, 0, 0
139, 1, 1636428123481, 1636428123841, 360, 2, 358, 0, 0, 0
142, 1, 1636428124109, 1636428124469, 360, 0, 360, 0, 0, 0
145, 1, 1636428124737, 1636428125101, 364, 0, 364, 0, 0, 0
148, 1, 1636428125369, 1636428125745, 376, 1, 375, 0, 1, 1
151, 1, 1636428126013, 1636428126373, 360, 0, 360, 0, 0, 0
154, 1, 1636428126641, 1636428127001, 360, 2, 358, 1, 0, 1
157, 1, 1636428127273, 1636428127637, 364, 1, 363, 0, 0, 0
160, 1, 1636428127904, 1636428128261, 357, 2, 355, 2, 0, 2
163, 1, 1636428128529, 1636428128893, 364, 0, 364, 0, 0, 0
166, 1, 1636428129161, 1636428129525, 364, 1, 363, 0, 0, 0
169, 1, 1636428129793, 1636428130149, 356, 1, 355, 0, 0, 0
172, 1, 1636428130417, 1636428130777, 360, 0, 360, 0, 0, 0
175, 1, 1636428131041, 1636428131401, 360, 0, 360, 0, 0, 0
178, 1, 1636428131669, 1636428132033, 364, 1, 363, 0, 0, 0
181, 1, 1636428132305, 1636428132665, 360, 0, 360, 0, 0, 0
184, 1, 1636428132933, 1636428133297, 364, 2, 362, 0, 0, 0
187, 1, 1636428133564, 1636428133916, 352, 3, 349, 2, 0, 2
190, 1, 1636428134181, 1636428134537, 356, 0, 356, 0, 0, 0
193, 1, 1636428134805, 1636428135165, 360, 0, 360, 0, 0, 0
196, 1, 1636428135433, 1636428135785, 352, 3, 349, 0, 0, 0
199, 1, 1636428136057, 1636428136416, 359, 1, 358, 0, 1, 1
202, 1, 1636428136681, 1636428137041, 360, 1, 359, 0, 0, 0
205, 1, 1636428137309, 1636428137673, 364, 0, 364, 0, 0, 0
208, 1, 1636428137940, 1636428138305, 365, 1, 364, 0, 0, 0
211, 1, 1636428138573, 1636428138937, 364, 1, 363, 0, 0, 0
214, 1, 1636428139205, 1636428139561, 356, 0, 356, 0, 0, 0
217, 1, 1636428139829, 1636428140184, 355, 1, 354, 0, 0, 0
220, 1, 1636428140449, 1636428140817, 368, 0, 368, 0, 0, 0
223, 1, 1636428141085, 1636428141449, 364, 0, 364, 0, 0, 0
226, 1, 1636428141717, 1636428142077, 360, 0, 360, 0, 0, 0
229, 1, 1636428142345, 1636428142705, 360, 0, 360, 0, 0, 0
232, 1, 1636428142973, 1636428143337, 364, 1, 363, 0, 0, 0
235, 1, 1636428143605, 1636428143965, 360, 0, 360, 0, 0, 0
238, 1, 1636428144233, 1636428144589, 356, 0, 356, 0, 0, 0
241, 1, 1636428144857, 1636428145221, 364, 0, 364, 0, 0, 0
244, 1, 1636428145493, 1636428145849, 356, 1, 355, 0, 0, 0
247, 1, 1636428146121, 1636428146477, 356, 1, 355, 0, 0, 0
250, 1, 1636428146745, 1636428147105, 360, 2, 358, 1, 1, 2
253, 1, 1636428147373, 1636428147720, 347, 1, 346, 0, 0, 0
256, 1, 1636428147981, 1636428148341, 360, 1, 359, 0, 0, 0
259, 1, 1636428148613, 1636428148973, 360, 0, 360, 0, 0, 0
262, 1, 1636428149241, 1636428149605, 364, 1, 363, 0, 0, 0
265, 1, 1636428149873, 1636428150241, 368, 1, 367, 0, 0, 0
268, 1, 1636428150505, 1636428150869, 364, 0, 364, 0, 0, 0
271, 1, 1636428151141, 1636428151505, 364, 1, 363, 0, 0, 0
274, 1, 1636428151773, 1636428152137, 364, 1, 363, 0, 0, 0
277, 1, 1636428152405, 1636428152765, 360, 0, 360, 0, 0, 0
280, 1, 1636428153033, 1636428153389, 356, 1, 355, 0, 0, 0
283, 1, 1636428153657, 1636428154017, 360, 2, 358, 0, 0, 0
286, 1, 1636428154285, 1636428154649, 364, 0, 364, 0, 0, 0
289, 1, 1636428154917, 1636428155277, 360, 0, 360, 0, 0, 0
292, 1, 1636428155545, 1636428155909, 364, 0, 364, 0, 0, 0
295, 1, 1636428156177, 1636428156533, 356, 1, 355, 0, 0, 0
298, 1, 1636428156797, 1636428157161, 364, 0, 364, 0, 0, 0
301, 1, 1636428157428, 1636428157780, 352, 1, 351, 1, 0, 1
304, 1, 1636428158040, 1636428158393, 353, 2, 351, 1, 0, 1
307, 1, 1636428158661, 1636428159025, 364, 1, 363, 0, 0, 0
310, 1, 1636428159293, 1636428159657, 364, 1, 363, 0, 0, 0
313, 1, 1636428159925, 1636428160284, 359, 3, 356, 2, 0, 2
316, 1, 1636428160549, 1636428160913, 364, 2, 362, 1, 1, 2
319, 1, 1636428161181, 1636428161545, 364, 0, 364, 0, 0, 0
322, 1, 1636428161813, 1636428162177, 364, 0, 364, 0, 0, 0
325, 1, 1636428162445, 1636428162805, 360, 0, 360, 0, 0, 0
328, 1, 1636428163073, 1636428163433, 360, 0, 360, 0, 0, 0
331, 1, 1636428163701, 1636428164065, 364, 0, 364, 0, 0, 0
334, 1, 1636428164333, 1636428164689, 356, 0, 356, 0, 0, 0
337, 1, 1636428164957, 1636428165317, 360, 0, 360, 0, 0, 0
340, 1, 1636428165589, 1636428165953, 364, 0, 364, 0, 0, 0
343, 1, 1636428166221, 1636428166577, 356, 1, 355, 0, 0, 0
346, 1, 1636428166840, 1636428167205, 365, 3, 362, 0, 0, 0
349, 1, 1636428167473, 1636428167833, 360, 1, 359, 0, 1, 1
352, 1, 1636428168101, 1636428168457, 356, 2, 354, 1, 0, 1
355, 1, 1636428168725, 1636428169085, 360, 0, 360, 0, 0, 0
358, 1, 1636428169353, 1636428169709, 356, 1, 355, 0, 0, 0
361, 1, 1636428169977, 1636428170336, 359, 0, 359, 0, 0, 0
364, 1, 1636428170601, 1636428170961, 360, 0, 360, 0, 0, 0
367, 1, 1636428171225, 1636428171585, 360, 0, 360, 0, 0, 0
370, 1, 1636428171857, 1636428172221, 364, 0, 364, 0, 0, 0
373, 1, 1636428172489, 1636428172845, 356, 0, 356, 0, 0, 0
376, 1, 1636428173113, 1636428173469, 356, 0, 356, 0, 0, 0
379, 1, 1636428173740, 1636428174093, 353, 1, 352, 0, 0, 0
382, 1, 1636428174365, 1636428174717, 352, 0, 352, 0, 0, 0
385, 1, 1636428174984, 1636428175333, 349, 1, 348, 0, 0, 0
388, 1, 1636428175605, 1636428175969, 364, 0, 364, 0, 0, 0
391, 1, 1636428176237, 1636428176593, 356, 1, 355, 1, 0, 1
394, 1, 1636428176865, 1636428177229, 364, 0, 364, 0, 0, 0
397, 1, 1636428177497, 1636428177861, 364, 0, 364, 0, 0, 0
400, 1, 1636428178132, 1636428178489, 357, 1, 356, 0, 0, 0
403, 1, 1636428178757, 1636428179105, 348, 2, 346, 0, 0, 0
406, 1, 1636428179377, 1636428179737, 360, 0, 360, 0, 0, 0
409, 1, 1636428180004, 1636428180360, 356, 2, 354, 0, 1, 1
412, 1, 1636428180624, 1636428180977, 353, 2, 351, 1, 0, 1
415, 1, 1636428181249, 1636428181604, 355, 0, 355, 0, 0, 0
418, 1, 1636428181869, 1636428182225, 356, 1, 355, 0, 0, 0
421, 1, 1636428182493, 1636428182845, 352, 0, 352, 0, 0, 0
424, 1, 1636428183117, 1636428183472, 355, 1, 354, 0, 0, 0
427, 1, 1636428183741, 1636428184101, 360, 0, 360, 0, 0, 0
430, 1, 1636428184368, 1636428184725, 357, 1, 356, 0, 1, 1
433, 1, 1636428184993, 1636428185353, 360, 0, 360, 0, 0, 0
436, 1, 1636428185621, 1636428185977, 356, 1, 355, 0, 0, 0
439, 1, 1636428186240, 1636428186597, 357, 1, 356, 0, 0, 0
442, 1, 1636428186861, 1636428187225, 364, 0, 364, 0, 0, 0
445, 1, 1636428187497, 1636428187861, 364, 0, 364, 0, 0, 0
448, 1, 1636428188129, 1636428188493, 364, 0, 364, 0, 0, 0
451, 1, 1636428188761, 1636428189125, 364, 0, 364, 0, 0, 0
454, 1, 1636428189393, 1636428189757, 364, 0, 364, 0, 0, 0
457, 1, 1636428190025, 1636428190385, 360, 0, 360, 0, 0, 0
460, 1, 1636428190649, 1636428191009, 360, 0, 360, 0, 0, 0
463, 1, 1636428191277, 1636428191633, 356, 0, 356, 0, 0, 0
466, 1, 1636428191901, 1636428192256, 355, 0, 355, 0, 0, 0
469, 1, 1636428192521, 1636428192877, 356, 1, 355, 0, 0, 0
472, 1, 1636428193145, 1636428193509, 364, 1, 363, 0, 0, 0
475, 1, 1636428193777, 1636428194137, 360, 1, 359, 0, 0, 0
478, 1, 1636428194405, 1636428194757, 352, 0, 352, 0, 0, 0
481, 1, 1636428195025, 1636428195389, 364, 0, 364, 0, 0, 0
484, 1, 1636428195657, 1636428196021, 364, 0, 364, 0, 0, 0
487, 1, 1636428196289, 1636428196653, 364, 0, 364, 0, 0, 0
490, 1, 1636428196920, 1636428197277, 357, 2, 355, 0, 0, 0
493, 1, 1636428197545, 1636428197909, 364, 0, 364, 0, 0, 0
496, 1, 1636428198177, 1636428198537, 360, 0, 360, 0, 0, 0
499, 1, 1636428198801, 1636428199161, 360, 0, 360, 0, 0, 0
502, 1, 1636428199429, 1636428199785, 356, 0, 356, 0, 0, 0
505, 1, 1636428200057, 1636428200421, 364, 0, 364, 0, 0, 0
508, 1, 1636428200685, 1636428201045, 360, 0, 360, 0, 0, 0
511, 1, 1636428201313, 1636428201673, 360, 1, 359, 0, 0, 0
514, 1, 1636428201941, 1636428202301, 360, 0, 360, 0, 0, 0
517, 1, 1636428202569, 1636428202929, 360, 0, 360, 0, 0, 0
520, 1, 1636428203189, 1636428203545, 356, 0, 356, 0, 0, 0
523, 1, 1636428203813, 1636428204177, 364, 0, 364, 0, 0, 0
526, 1, 1636428204444, 1636428204801, 357, 1, 356, 0, 0, 0
529, 1, 1636428205069, 1636428205429, 360, 0, 360, 0, 0, 0
532, 1, 1636428205697, 1636428206057, 360, 0, 360, 0, 0, 0
535, 1, 1636428206321, 1636428206677, 356, 1, 355, 0, 0, 0
538, 1, 1636428206949, 1636428207313, 364, 0, 364, 0, 0, 0
541, 1, 1636428207581, 1636428207945, 364, 0, 364, 0, 0, 0
544, 1, 1636428208213, 1636428208569, 356, 0, 356, 0, 0, 0
547, 1, 1636428208837, 1636428209197, 360, 0, 360, 0, 0, 0
550, 1, 1636428209465, 1636428209829, 364, 0, 364, 0, 0, 0
553, 1, 1636428210097, 1636428210453, 356, 0, 356, 0, 0, 0
556, 1, 1636428210721, 1636428211081, 360, 0, 360, 0, 0, 0
559, 1, 1636428211349, 1636428211701, 352, 0, 352, 0, 0, 0
601, 1, 1636428331260, 1636428331729, 469, 11, 458, 0, 0, 0
602, 1, 1636428332353, 1636428332761, 408, 1, 407, 0, 0, 0
603, 1, 1636428332909, 1636428333317, 408, 0, 408, 0, 0, 0
604, 1, 1636428333156, 1636428333557, 401, 1, 400, 0, 0, 0
605, 1, 1636428333929, 1636428334332, 403, 0, 403, 0, 0, 0
606, 1, 1636428334349, 1636428334757, 408, 0, 408, 0, 0, 0
607, 1, 1636428334633, 1636428335041, 408, 1, 407, 1, 0, 1
608, 1, 1636428334909, 1636428335313, 404, 0, 404, 0, 0, 0
609, 1, 1636428335053, 1636428335456, 403, 1, 402, 0, 1, 1
610, 1, 1636428335412, 1636428335813, 401, 1, 400, 0, 1, 1
611, 1, 1636428335833, 1636428336237, 404, 0, 404, 0, 0, 0
612, 1, 1636428336233, 1636428336640, 407, 0, 407, 0, 0, 0
613, 1, 1636428336517, 1636428336921, 404, 0, 404, 0, 0, 0
614, 1, 1636428336540, 1636428336936, 396, 1, 395, 0, 0, 0
615, 1, 1636428336789, 1636428337193, 404, 0, 404, 0, 0, 0
616, 1, 1636428336953, 1636428337352, 399, 2, 397, 0, 0, 0
617, 1, 1636428337157, 1636428337432, 275, 1, 274, 1, 0, 1
618, 1, 1636428337276, 1636428337549, 273, 1, 272, 0, 0, 0
619, 1, 1636428337641, 1636428337957, 316, 0, 316, 0, 0, 0
620, 1, 1636428337717, 1636428337988, 271, 0, 271, 0, 0, 0
621, 1, 1636428338249, 1636428338520, 271, 0, 271, 0, 0, 0
622, 1, 1636428338289, 1636428338609, 320, 0, 320, 0, 0, 0
623, 1, 1636428338372, 1636428338653, 281, 1, 280, 0, 0, 0
624, 1, 1636428338420, 1636428338688, 268, 0, 268, 0, 0, 0
625, 1, 1636428338805, 1636428339081, 276, 0, 276, 0, 0, 0
626, 1, 1636428338857, 1636428339132, 275, 0, 275, 0, 0, 0
627, 1, 1636428339193, 1636428339465, 272, 0, 272, 0, 0, 0
628, 1, 1636428339273, 1636428339545, 272, 0, 272, 0, 0, 0
629, 1, 1636428339481, 1636428339753, 272, 0, 272, 0, 0, 0
630, 1, 1636428339749, 1636428340021, 272, 0, 272, 0, 0, 0
631, 1, 1636428339781, 1636428340101, 320, 0, 320, 0, 0, 0
632, 1, 1636428340177, 1636428340452, 275, 0, 275, 0, 0, 0
633, 1, 1636428340261, 1636428340533, 272, 0, 272, 0, 0, 0
634, 1, 1636428340365, 1636428340641, 276, 0, 276, 0, 0, 0
635, 1, 1636428340512, 1636428340785, 273, 1, 272, 0, 0, 0
636, 1, 1636428340680, 1636428340997, 317, 1, 316, 0, 0, 0
637, 1, 1636428340841, 1636428341112, 271, 0, 271, 0, 0, 0
638, 1, 1636428340913, 1636428341189, 276, 0, 276, 0, 0, 0
639, 1, 1636428341156, 1636428341429, 273, 1, 272, 0, 0, 0
641, 1, 1636428341217, 1636428341488, 271, 0, 271, 0, 0, 0
640, 1, 1636428341193, 1636428341504, 311, 0, 311, 0, 0, 0
642, 1, 1636428341464, 1636428341737, 273, 1, 272, 0, 1, 1
643, 1, 1636428341697, 1636428341973, 276, 0, 276, 0, 0, 0
644, 1, 1636428341748, 1636428342064, 316, 1, 315, 0, 1, 1
645, 1, 1636428341865, 1636428342141, 276, 0, 276, 0, 0, 0
646, 1, 1636428342096, 1636428342373, 277, 1, 276, 0, 1, 1
647, 1, 1636428342241, 1636428342509, 268, 0, 268, 0, 0, 0
648, 1, 1636428342356, 1636428342629, 273, 1, 272, 0, 1, 1
649, 1, 1636428342564, 1636428342837, 273, 1, 272, 0, 0, 0
650, 1, 1636428342629, 1636428342905, 276, 0, 276, 0, 0, 0
651, 1, 1636428342785, 1636428343101, 316, 0, 316, 0, 0, 0
652, 1, 1636428342832, 1636428343101, 269, 1, 268, 0, 0, 0
653, 1, 1636428342929, 1636428343205, 276, 0, 276, 0, 0, 0
654, 1, 1636428343029, 1636428343305, 276, 0, 276, 0, 0, 0
655, 1, 1636428343164, 1636428343436, 272, 1, 271, 0, 0, 0
656, 1, 1636428343252, 1636428343525, 273, 1, 272, 0, 0, 0
657, 1, 1636428343393, 1636428343749, 356, 44, 312, 44, 0, 44
658, 1, 1636428343493, 1636428343769, 276, 0, 276, 0, 0, 0
659, 1, 1636428343617, 1636428343885, 268, 0, 268, 0, 0, 0
660, 1, 1636428343628, 1636428343896, 268, 1, 267, 0, 0, 0
661, 1, 1636428343745, 1636428344021, 276, 0, 276, 0, 0, 0
662, 1, 1636428344125, 1636428344401, 276, 0, 276, 0, 0, 0
663, 1, 1636428344241, 1636428344565, 324, 0, 324, 0, 0, 0
665, 1, 1636428344477, 1636428344753, 276, 0, 276, 0, 0, 0
666, 1, 1636428344504, 1636428344777, 273, 1, 272, 0, 1, 1
667, 1, 1636428344548, 1636428344824, 276, 1, 275, 0, 0, 0
664, 1, 1636428344277, 1636428344841, 564, 289, 275, 288, 0, 288
668, 1, 1636428344665, 1636428344937, 272, 0, 272, 0, 0, 0
669, 1, 1636428344868, 1636428345145, 277, 1, 276, 1, 0, 1
671, 1, 1636428344941, 1636428345209, 268, 0, 268, 0, 0, 0
672, 1, 1636428345045, 1636428345313, 268, 0, 268, 0, 0, 0
673, 1, 1636428345128, 1636428345401, 273, 0, 273, 0, 0, 0
670, 1, 1636428344893, 1636428345465, 572, 252, 320, 252, 0, 252
674, 1, 1636428345233, 1636428345509, 276, 0, 276, 0, 0, 0
675, 1, 1636428345337, 1636428345609, 272, 0, 272, 0, 0, 0
676, 1, 1636428345520, 1636428345832, 312, 1, 311, 0, 0, 0
678, 1, 1636428345609, 1636428345880, 271, 1, 270, 0, 1, 1
677, 1, 1636428345609, 1636428345880, 271, 1, 270, 0, 0, 0
679, 1, 1636428345644, 1636428345921, 277, 0, 277, 0, 0, 0
680, 1, 1636428345864, 1636428346141, 277, 0, 277, 0, 0, 0
682, 1, 1636428346152, 1636428346425, 273, 1, 272, 0, 0, 0
681, 1, 1636428346068, 1636428346461, 393, 74, 319, 73, 0, 73
683, 1, 1636428346240, 1636428346517, 277, 1, 276, 0, 0, 0
684, 1, 1636428346324, 1636428346596, 272, 0, 272, 0, 0, 0
685, 1, 1636428346344, 1636428346621, 277, 1, 276, 0, 0, 0
686, 1, 1636428346517, 1636428346789, 272, 0, 272, 0, 0, 0
687, 1, 1636428346580, 1636428346853, 273, 1, 272, 0, 0, 0
688, 1, 1636428346588, 1636428346861, 273, 1, 272, 0, 1, 1
689, 1, 1636428346792, 1636428347069, 277, 0, 277, 0, 0, 0
690, 1, 1636428346937, 1636428347204, 267, 0, 267, 0, 0, 0
691, 1, 1636428346960, 1636428347233, 273, 1, 272, 1, 0, 1
692, 1, 1636428347033, 1636428347289, 256, 0, 256, 0, 0, 0
693, 1, 1636428347244, 1636428347520, 276, 1, 275, 0, 1, 1
694, 1, 1636428347261, 1636428347532, 271, 0, 271, 0, 0, 0
695, 1, 1636428347288, 1636428347557, 269, 1, 268, 0, 0, 0
696, 1, 1636428347372, 1636428347653, 281, 1, 280, 0, 0, 0
697, 1, 1636428347544, 1636428347817, 273, 1, 272, 0, 0, 0
698, 1, 1636428347637, 1636428347909, 272, 0, 272, 0, 0, 0
699, 1, 1636428347761, 1636428348041, 280, 0, 280, 0, 0, 0
700, 1, 1636428347929, 1636428348205, 276, 0, 276, 0, 0, 0
701, 1, 1636428347932, 1636428348205, 273, 1, 272, 0, 0, 0
702, 1, 1636428348073, 1636428348345, 272, 0, 272, 0, 0, 0
703, 1, 1636428348120, 1636428348392, 272, 1, 271, 0, 0, 0
704, 1, 1636428348345, 1636428348617, 272, 0, 272, 0, 0, 0
705, 1, 1636428348361, 1636428348633, 272, 0, 272, 0, 0, 0
707, 1, 1636428348613, 1636428348884, 271, 0, 271, 0, 0, 0
706, 1, 1636428348613, 1636428348884, 271, 0, 271, 0, 0, 0
708, 1, 1636428348692, 1636428348964, 272, 1, 271, 0, 0, 0
709, 1, 1636428348709, 1636428348985, 276, 0, 276, 0, 0, 0
710, 1, 1636428348952, 1636428349220, 268, 1, 267, 0, 1, 1
711, 1, 1636428348996, 1636428349268, 272, 1, 271, 0, 0, 0
712, 1, 1636428349065, 1636428349344, 279, 0, 279, 0, 0, 0
713, 1, 1636428349272, 1636428349544, 272, 1, 271, 0, 0, 0
714, 1, 1636428349285, 1636428349556, 271, 0, 271, 0, 0, 0
715, 1, 1636428349344, 1636428349621, 277, 1, 276, 0, 0, 0
716, 1, 1636428349388, 1636428349660, 272, 0, 272, 0, 0, 0
717, 1, 1636428349573, 1636428349848, 275, 0, 275, 0, 0, 0
718, 1, 1636428349645, 1636428349917, 272, 0, 272, 0, 0, 0
719, 1, 1636428349757, 1636428350029, 272, 0, 272, 0, 0, 0
720, 1, 1636428349821, 1636428350097, 276, 0, 276, 0, 0, 0
721, 1, 1636428349989, 1636428350260, 271, 0, 271, 0, 0, 0
722, 1, 1636428350104, 1636428350377, 273, 0, 273, 0, 0, 0
723, 1, 1636428350153, 1636428350424, 271, 0, 271, 0, 0, 0
724, 1, 1636428350397, 1636428350672, 275, 0, 275, 0, 0, 0
725, 1, 1636428350432, 1636428350709, 277, 1, 276, 0, 1, 1
727, 1, 1636428350629, 1636428350905, 276, 0, 276, 0, 0, 0
726, 1, 1636428350629, 1636428350913, 284, 0, 284, 0, 0, 0
728, 1, 1636428350729, 1636428351004, 275, 0, 275, 0, 0, 0
729, 1, 1636428350741, 1636428351013, 272, 0, 272, 0, 0, 0
730, 1, 1636428350985, 1636428351257, 272, 0, 272, 0, 0, 0
731, 1, 1636428351053, 1636428351325, 272, 0, 272, 0, 0, 0
732, 1, 1636428351093, 1636428351368, 275, 0, 275, 0, 0, 0
733, 1, 1636428351297, 1636428351569, 272, 0, 272, 0, 0, 0
734, 1, 1636428351312, 1636428351585, 273, 1, 272, 0, 0, 0
735, 1, 1636428351356, 1636428351628, 272, 1, 271, 0, 0, 0
736, 1, 1636428351400, 1636428351672, 272, 1, 271, 1, 0, 1
737, 1, 1636428351628, 1636428351897, 269, 1, 268, 0, 1, 1
738, 1, 1636428351652, 1636428351925, 273, 1, 272, 0, 0, 0
739, 1, 1636428351672, 1636428351941, 269, 1, 268, 0, 0, 0
740, 1, 1636428351848, 1636428352125, 277, 1, 276, 0, 0, 0
741, 1, 1636428352089, 1636428352364, 275, 0, 275, 0, 0, 0
742, 1, 1636428352221, 1636428352500, 279, 0, 279, 0, 0, 0
743, 1, 1636428352249, 1636428352516, 267, 0, 267, 0, 0, 0
744, 1, 1636428352356, 1636428352633, 277, 1, 276, 1, 0, 1
745, 1, 1636428352492, 1636428352765, 273, 1, 272, 1, 0, 1
746, 1, 1636428352612, 1636428352885, 273, 1, 272, 0, 0, 0
747, 1, 1636428352685, 1636428352957, 272, 0, 272, 0, 0, 0
748, 1, 1636428352701, 1636428352973, 272, 0, 272, 0, 0, 0
749, 1, 1636428352768, 1636428353040, 272, 1, 271, 0, 0, 0
750, 1, 1636428352992, 1636428353260, 268, 1, 267, 0, 0, 0
751, 1, 1636428353013, 1636428353284, 271, 0, 271, 0, 0, 0
752, 1, 1636428353108, 1636428353381, 273, 0, 273, 0, 0, 0
753, 1, 1636428353248, 1636428353520, 272, 1, 271, 0, 1, 1
754, 1, 1636428353248, 1636428353525, 277, 1, 276, 1, 0, 1
755, 1, 1636428353328, 1636428353601, 273, 1, 272, 0, 0, 0
756, 1, 1636428353460, 1636428353733, 273, 1, 272, 0, 0, 0
757, 1, 1636428353668, 1636428353941, 273, 1, 272, 0, 0, 0
758, 1, 1636428353692, 1636428353961, 269, 1, 268, 0, 0, 0
759, 1, 1636428353744, 1636428354016, 272, 1, 271, 1, 0, 1
760, 1, 1636428353961, 1636428354233, 272, 0, 272, 0, 0, 0
761, 1, 1636428354049, 1636428354321, 272, 0, 272, 0, 0, 0
762, 1, 1636428354141, 1636428354417, 276, 0, 276, 0, 0, 0
763, 1, 1636428354244, 1636428354517, 273, 1, 272, 0, 0, 0
764, 1, 1636428354345, 1636428354621, 276, 0, 276, 0, 0, 0
765, 1, 1636428354545, 1636428354829, 284, 0, 284, 0, 0, 0
766, 1, 1636428354657, 1636428354937, 280, 0, 280, 0, 0, 0
767, 1, 1636428354701, 1636428354973, 272, 0, 272, 0, 0, 0
768, 1, 1636428354728, 1636428355005, 277, 1, 276, 0, 0, 0
769, 1, 1636428354765, 1636428355033, 268, 0, 268, 0, 0, 0
770, 1, 1636428354900, 1636428355172, 272, 1, 271, 0, 0, 0
771, 1, 1636428355057, 1636428355328, 271, 0, 271, 0, 0, 0
772, 1, 1636428355172, 1636428355441, 269, 1, 268, 0, 1, 1
773, 1, 1636428355213, 1636428355484, 271, 0, 271, 0, 0, 0
774, 1, 1636428355261, 1636428355533, 272, 0, 272, 0, 0, 0
775, 1, 1636428355284, 1636428355553, 269, 1, 268, 0, 0, 0
776, 1, 1636428355416, 1636428355717, 301, 26, 275, 25, 0, 25
777, 1, 1636428355740, 1636428356013, 273, 1, 272, 0, 0, 0
778, 1, 1636428355764, 1636428356037, 273, 1, 272, 0, 0, 0
779, 1, 1636428355792, 1636428356065, 273, 1, 272, 0, 0, 0
780, 1, 1636428355900, 1636428356173, 273, 1, 272, 0, 0, 0
781, 1, 1636428355936, 1636428356209, 273, 1, 272, 0, 0, 0
782, 1, 1636428356157, 1636428356429, 272, 0, 272, 0, 0, 0
783, 1, 1636428356168, 1636428356441, 273, 1, 272, 0, 0, 0
784, 1, 1636428356445, 1636428356721, 276, 0, 276, 0, 0, 0
785, 1, 1636428356505, 1636428356776, 271, 0, 271, 0, 0, 0
786, 1, 1636428356537, 1636428356813, 276, 0, 276, 0, 0, 0
787, 1, 1636428356736, 1636428357013, 277, 1, 276, 0, 0, 0
788, 1, 1636428356800, 1636428357069, 269, 1, 268, 0, 0, 0
790, 1, 1636428356820, 1636428357089, 269, 1, 268, 0, 0, 0
789, 1, 1636428356820, 1636428357089, 269, 1, 268, 0, 0, 0
791, 1, 1636428357104, 1636428357384, 280, 1, 279, 0, 0, 0
792, 1, 1636428357177, 1636428357445, 268, 0, 268, 0, 0, 0
793, 1, 1636428357200, 1636428357472, 272, 0, 272, 0, 0, 0
795, 1, 1636428357296, 1636428357565, 269, 1, 268, 0, 1, 1
794, 1, 1636428357296, 1636428357565, 269, 1, 268, 0, 0, 0
796, 1, 1636428357372, 1636428357644, 272, 1, 271, 0, 1, 1
797, 1, 1636428357753, 1636428358033, 280, 0, 280, 0, 0, 0
798, 1, 1636428357792, 1636428358065, 273, 1, 272, 0, 0, 0
799, 1, 1636428357824, 1636428358101, 277, 1, 276, 1, 0, 1
801, 1, 1636428357917, 1636428358189, 272, 0, 272, 0, 0, 0
800, 1, 1636428357865, 1636428358320, 455, 169, 286, 169, 0, 169
802, 1, 1636428358192, 1636428358460, 268, 1, 267, 0, 0, 0
803, 1, 1636428358225, 1636428358497, 272, 0, 272, 0, 0, 0
804, 1, 1636428358392, 1636428358669, 277, 1, 276, 0, 0, 0
805, 1, 1636428358404, 1636428358677, 273, 1, 272, 0, 0, 0
806, 1, 1636428358460, 1636428358956, 496, 218, 278, 216, 0, 216
807, 1, 1636428358813, 1636428359084, 271, 0, 271, 0, 0, 0
808, 1, 1636428358813, 1636428359093, 280, 0, 280, 0, 0, 0
809, 1, 1636428358848, 1636428359121, 273, 1, 272, 0, 0, 0
810, 1, 1636428358921, 1636428359192, 271, 0, 271, 0, 0, 0
811, 1, 1636428359065, 1636428359337, 272, 0, 272, 0, 0, 0
812, 1, 1636428359080, 1636428359361, 281, 1, 280, 1, 0, 1
813, 1, 1636428359208, 1636428359480, 272, 0, 272, 0, 0, 0
814, 1, 1636428359220, 1636428359493, 273, 0, 273, 0, 0, 0
815, 1, 1636428359397, 1636428359665, 268, 0, 268, 0, 0, 0
816, 1, 1636428359401, 1636428359673, 272, 0, 272, 0, 0, 0
817, 1, 1636428359632, 1636428359908, 276, 1, 275, 1, 0, 1
818, 1, 1636428359697, 1636428359973, 276, 0, 276, 0, 0, 0
819, 1, 1636428359892, 1636428360160, 268, 1, 267, 0, 0, 0
820, 1, 1636428359921, 1636428360193, 272, 0, 272, 0, 0, 0
821, 1, 1636428359989, 1636428360265, 276, 0, 276, 0, 0, 0
822, 1, 1636428360177, 1636428360448, 271, 0, 271, 0, 0, 0
823, 1, 1636428360285, 1636428360557, 272, 0, 272, 0, 0, 0
824, 1, 1636428360292, 1636428360569, 277, 1, 276, 0, 0, 0
825, 1, 1636428360320, 1636428360592, 272, 1, 271, 0, 0, 0
826, 1, 1636428360464, 1636428360737, 273, 1, 272, 0, 0, 0
827, 1, 1636428360733, 1636428361009, 276, 0, 276, 0, 0, 0
828, 1, 1636428360868, 1636428361141, 273, 1, 272, 0, 0, 0
830, 1, 1636428360880, 1636428361144, 264, 0, 264, 0, 0, 0
829, 1, 1636428360876, 1636428361145, 269, 1, 268, 0, 0, 0
831, 1, 1636428360992, 1636428361425, 433, 153, 280, 152, 0, 152
833, 1, 1636428361188, 1636428361460, 272, 0, 272, 0, 0, 0
834, 1, 1636428361248, 1636428361520, 272, 1, 271, 1, 0, 1
835, 1, 1636428361408, 1636428361684, 276, 1, 275, 0, 0, 0
832, 1, 1636428361168, 1636428361700, 532, 258, 274, 257, 0, 257
836, 1, 1636428361448, 1636428361720, 272, 1, 271, 0, 0, 0
838, 1, 1636428361588, 1636428361857, 269, 1, 268, 0, 0, 0
839, 1, 1636428361805, 1636428362077, 272, 0, 272, 0, 0, 0
841, 1, 1636428362101, 1636428362380, 279, 0, 279, 0, 0, 0
842, 1, 1636428362197, 1636428362481, 284, 0, 284, 0, 0, 0
844, 1, 1636428362336, 1636428362609, 273, 1, 272, 0, 0, 0
845, 1, 1636428362353, 1636428362629, 276, 0, 276, 0, 0, 0
846, 1, 1636428362445, 1636428362721, 276, 0, 276, 0, 0, 0
847, 1, 1636428362772, 1636428363045, 273, 1, 272, 0, 0, 0
849, 1, 1636428362845, 1636428363117, 272, 0, 272, 0, 0, 0
850, 1, 1636428362921, 1636428363196, 275, 0, 275, 0, 0, 0
851, 1, 1636428363013, 1636428363284, 271, 0, 271, 0, 0, 0
852, 1, 1636428363117, 1636428363393, 276, 0, 276, 0, 0, 0
853, 1, 1636428363133, 1636428363413, 280, 1, 279, 0, 1, 1
854, 1, 1636428363133, 1636428363413, 280, 1, 279, 0, 1, 1
857, 1, 1636428363504, 1636428363777, 273, 1, 272, 0, 1, 1
858, 1, 1636428363829, 1636428364104, 275, 1, 274, 0, 0, 0
859, 1, 1636428364096, 1636428364368, 272, 1, 271, 0, 0, 0
860, 1, 1636428364156, 1636428364428, 272, 0, 272, 0, 0, 0
861, 1, 1636428364296, 1636428364564, 268, 1, 267, 0, 1, 1
863, 1, 1636428364468, 1636428364740, 272, 1, 271, 0, 0, 0
865, 1, 1636428364780, 1636428365053, 273, 1, 272, 1, 0, 1
867, 1, 1636428364993, 1636428365265, 272, 0, 272, 0, 0, 0
869, 1, 1636428365093, 1636428365369, 276, 0, 276, 0, 0, 0
870, 1, 1636428365240, 1636428365513, 273, 1, 272, 0, 0, 0
872, 1, 1636428365761, 1636428366037, 276, 1, 275, 0, 0, 0
873, 1, 1636428366069, 1636428366344, 275, 1, 274, 0, 0, 0
875, 1, 1636428366388, 1636428366661, 273, 1, 272, 1, 0, 1
876, 1, 1636428366396, 1636428366673, 277, 1, 276, 0, 0, 0
877, 1, 1636428366653, 1636428366925, 272, 0, 272, 0, 0, 0
878, 1, 1636428367084, 1636428367357, 273, 1, 272, 0, 0, 0
879, 1, 1636428367165, 1636428367437, 272, 0, 272, 0, 0, 0
880, 1, 1636428367169, 1636428367440, 271, 0, 271, 0, 0, 0
881, 1, 1636428367633, 1636428367905, 272, 0, 272, 0, 0, 0
882, 1, 1636428368141, 1636428368412, 271, 0, 271, 0, 0, 0
883, 1, 1636428368293, 1636428368565, 272, 0, 272, 0, 0, 0
884, 1, 1636428368320, 1636428368593, 273, 1, 272, 0, 0, 0
885, 1, 1636428368725, 1636428369001, 276, 0, 276, 0, 0, 0
886, 1, 1636428369020, 1636428369292, 272, 1, 271, 0, 0, 0
887, 1, 1636428369041, 1636428369313, 272, 0, 272, 0, 0, 0
888, 1, 1636428369228, 1636428369501, 273, 1, 272, 0, 0, 0
889, 1, 1636428369705, 1636428369981, 276, 0, 276, 0, 0, 0
890, 1, 1636428370193, 1636428370464, 271, 0, 271, 0, 0, 0
891, 1, 1636428370204, 1636428370480, 276, 0, 276, 0, 0, 0
892, 1, 1636428370364, 1636428370637, 273, 1, 272, 0, 1, 1
893, 1, 1636428370757, 1636428371028, 271, 0, 271, 0, 0, 0
894, 1, 1636428370993, 1636428371265, 272, 0, 272, 0, 0, 0
895, 1, 1636428371113, 1636428371389, 276, 0, 276, 0, 0, 0
896, 1, 1636428371169, 1636428371441, 272, 0, 272, 0, 0, 0
837, 2, 1636428361556, 1636428371798, 10242, 145, 10097, 145, 1, 146
840, 2, 1636428361865, 1636428371893, 10028, 0, 10028, 9936, 0, 9936
897, 1, 1636428371737, 1636428372121, 384, 0, 384, 0, 0, 0
843, 2, 1636428362220, 1636428372221, 10001, 0, 10001, 9580, 0, 9580
898, 1, 1636428372149, 1636428372452, 303, 0, 303, 0, 0, 0
899, 1, 1636428372269, 1636428372540, 271, 0, 271, 0, 0, 0
900, 1, 1636428372269, 1636428372541, 272, 1, 271, 0, 0, 0
901, 1, 1636428372424, 1636428372688, 264, 1, 263, 0, 0, 0
848, 2, 1636428362832, 1636428372833, 10001, 0, 10001, 8965, 0, 8965
902, 1, 1636428372672, 1636428372973, 301, 1, 300, 0, 0, 0
903, 1, 1636428373085, 1636428373356, 271, 0, 271, 0, 0, 0
904, 1, 1636428373116, 1636428373389, 273, 1, 272, 0, 0, 0
905, 1, 1636428373144, 1636428373413, 269, 1, 268, 0, 0, 0
855, 2, 1636428363413, 1636428373416, 10003, 0, 10003, 8388, 0, 8388
856, 2, 1636428363501, 1636428373501, 10000, 0, 10000, 8297, 0, 8297
906, 1, 1636428373737, 1636428374013, 276, 0, 276, 0, 0, 0
862, 2, 1636428364296, 1636428374297, 10001, 0, 10001, 7505, 0, 7505
907, 1, 1636428374125, 1636428374436, 311, 0, 311, 0, 0, 0
909, 1, 1636428374345, 1636428374620, 275, 1, 274, 0, 1, 1
910, 1, 1636428374345, 1636428374621, 276, 1, 275, 0, 1, 1
908, 1, 1636428374345, 1636428374621, 276, 1, 275, 0, 1, 1
864, 2, 1636428364692, 1636428374697, 10005, 0, 10005, 7109, 0, 7109
866, 2, 1636428364881, 1636428374881, 10000, 0, 10000, 6920, 0, 6920
911, 1, 1636428374644, 1636428374929, 285, 1, 284, 0, 0, 0
868, 2, 1636428365077, 1636428375076, 9999, 0, 9999, 6721, 0, 6721
912, 1, 1636428375060, 1636428375332, 272, 1, 271, 0, 0, 0
913, 1, 1636428375064, 1636428375341, 277, 1, 276, 0, 0, 0
914, 1, 1636428375148, 1636428375421, 273, 1, 272, 0, 1, 1
871, 2, 1636428365477, 1636428375477, 10000, 0, 10000, 6322, 0, 6322
915, 1, 1636428375705, 1636428375977, 272, 0, 272, 0, 0, 0
874, 2, 1636428366124, 1636428376125, 10001, 0, 10001, 5674, 0, 5674
916, 1, 1636428376033, 1636428376305, 272, 0, 272, 0, 0, 0
917, 1, 1636428376189, 1636428376461, 272, 0, 272, 0, 0, 0
918, 1, 1636428376309, 1636428376581, 272, 0, 272, 0, 0, 0
919, 1, 1636428376305, 1636428376737, 432, 157, 275, 157, 0, 157
920, 1, 1636428376540, 1636428376813, 273, 1, 272, 0, 1, 1
921, 1, 1636428376625, 1636428376900, 275, 0, 275, 0, 0, 0
922, 1, 1636428376961, 1636428377233, 272, 0, 272, 0, 0, 0
923, 1, 1636428376977, 1636428377253, 276, 0, 276, 0, 0, 0
924, 1, 1636428377069, 1636428377344, 275, 0, 275, 0, 0, 0
925, 1, 1636428377677, 1636428377957, 280, 0, 280, 0, 0, 0
926, 1, 1636428377929, 1636428378201, 272, 0, 272, 0, 0, 0
927, 1, 1636428378109, 1636428378381, 272, 0, 272, 0, 0, 0
928, 1, 1636428378189, 1636428378461, 272, 0, 272, 0, 0, 0
929, 1, 1636428378252, 1636428378524, 272, 1, 271, 0, 0, 0
931, 1, 1636428378561, 1636428378836, 275, 0, 275, 0, 0, 0
930, 1, 1636428378561, 1636428378836, 275, 0, 275, 0, 0, 0
932, 1, 1636428378953, 1636428379224, 271, 0, 271, 0, 0, 0
933, 1, 1636428379013, 1636428379284, 271, 0, 271, 0, 0, 0
934, 1, 1636428379060, 1636428379336, 276, 1, 275, 0, 0, 0
935, 1, 1636428379553, 1636428379825, 272, 0, 272, 0, 0, 0
936, 1, 1636428379985, 1636428380260, 275, 0, 275, 0, 0, 0
937, 1, 1636428380121, 1636428380392, 271, 0, 271, 0, 0, 0
938, 1, 1636428380145, 1636428380416, 271, 0, 271, 0, 0, 0
939, 1, 1636428380232, 1636428380504, 272, 1, 271, 0, 0, 0
940, 1, 1636428380616, 1636428380888, 272, 1, 271, 0, 0, 0
941, 1, 1636428380669, 1636428380941, 272, 0, 272, 0, 0, 0
942, 1, 1636428380841, 1636428381116, 275, 0, 275, 0, 0, 0
943, 1, 1636428381037, 1636428381313, 276, 0, 276, 0, 0, 0
944, 1, 1636428381077, 1636428381349, 272, 0, 272, 0, 0, 0
945, 1, 1636428381608, 1636428381880, 272, 1, 271, 0, 0, 0
946, 1, 1636428382021, 1636428382296, 275, 0, 275, 0, 0, 0
947, 1, 1636428382160, 1636428382428, 268, 1, 267, 0, 0, 0
949, 1, 1636428382181, 1636428382456, 275, 0, 275, 0, 0, 0
948, 1, 1636428382212, 1636428382485, 273, 1, 272, 0, 1, 1
959, 1, 1636428382212, 1636428382485, 273, 1, 272, 0, 1, 1
953, 1, 1636428382216, 1636428382485, 269, 1, 268, 0, 1, 1
960, 1, 1636428382672, 1636428382944, 272, 1, 271, 0, 0, 0
961, 1, 1636428382680, 1636428382952, 272, 1, 271, 0, 0, 0
962, 1, 1636428382896, 1636428383168, 272, 1, 271, 0, 0, 0
963, 1, 1636428382925, 1636428383200, 275, 0, 275, 0, 0, 0
964, 1, 1636428382956, 1636428383228, 272, 1, 271, 0, 0, 0
965, 1, 1636428383645, 1636428383921, 276, 0, 276, 0, 0, 0
966, 1, 1636428383949, 1636428384220, 271, 0, 271, 0, 0, 0
967, 1, 1636428384213, 1636428384484, 271, 0, 271, 0, 0, 0
968, 1, 1636428384236, 1636428384508, 272, 1, 271, 0, 0, 0
969, 1, 1636428384260, 1636428384532, 272, 1, 271, 0, 0, 0
970, 1, 1636428384280, 1636428384548, 268, 1, 267, 0, 0, 0
971, 1, 1636428384312, 1636428384581, 269, 1, 268, 0, 0, 0
972, 1, 1636428384609, 1636428384876, 267, 0, 267, 0, 0, 0
973, 1, 1636428384677, 1636428384944, 267, 0, 267, 0, 0, 0
975, 1, 1636428384961, 1636428385233, 272, 0, 272, 0, 0, 0
976, 1, 1636428384981, 1636428385249, 268, 0, 268, 0, 0, 0
977, 1, 1636428385573, 1636428385849, 276, 0, 276, 0, 0, 0
979, 1, 1636428386097, 1636428386368, 271, 0, 271, 0, 0, 0
980, 1, 1636428386252, 1636428386521, 269, 1, 268, 1, 0, 1
981, 1, 1636428386276, 1636428386548, 272, 0, 272, 0, 0, 0
982, 1, 1636428386337, 1636428386800, 463, 185, 278, 184, 0, 184
985, 1, 1636428386600, 1636428386873, 273, 1, 272, 0, 0, 0
986, 1, 1636428386885, 1636428387160, 275, 0, 275, 0, 0, 0
987, 1, 1636428387041, 1636428387317, 276, 0, 276, 0, 0, 0
990, 1, 1636428388177, 1636428388449, 272, 0, 272, 0, 0, 0
991, 1, 1636428388252, 1636428388529, 277, 0, 277, 0, 0, 0
992, 1, 1636428388296, 1636428388568, 272, 0, 272, 0, 0, 0
993, 1, 1636428388685, 1636428388961, 276, 0, 276, 0, 0, 0
995, 1, 1636428388969, 1636428389241, 272, 0, 272, 0, 0, 0
996, 1, 1636428390233, 1636428390500, 267, 0, 267, 0, 0, 0
997, 1, 1636428390265, 1636428390536, 271, 0, 271, 0, 0, 0
999, 1, 1636428390740, 1636428391013, 273, 1, 272, 0, 0, 0
951, 2, 1636428382216, 1636428392217, 10001, 0, 10001, 269, 0, 269
958, 2, 1636428382232, 1636428392265, 10033, 0, 10033, 253, 0, 253
954, 2, 1636428382224, 1636428392313, 10089, 0, 10089, 263, 0, 263
956, 2, 1636428382224, 1636428392362, 10138, 0, 10138, 261, 0, 261
950, 2, 1636428382224, 1636428392409, 10185, 0, 10185, 261, 0, 261
952, 2, 1636428382224, 1636428392457, 10233, 0, 10233, 261, 0, 261
955, 2, 1636428382224, 1636428392504, 10280, 0, 10280, 262, 0, 262
957, 2, 1636428382224, 1636428392549, 10325, 0, 10325, 262, 0, 262
1001, 1, 1636428392149, 1636428392776, 627, 0, 627, 0, 0, 0
983, 1, 1636428386337, 1636428392817, 6480, 6212, 268, 0, 6212, 6212
1002, 1, 1636428392637, 1636428392908, 271, 0, 271, 0, 0, 0
1011, 1, 1636428392840, 1636428393117, 277, 1, 276, 0, 0, 0
1003, 1, 1636428392848, 1636428393120, 272, 1, 271, 0, 0, 0
1006, 1, 1636428392856, 1636428393128, 272, 0, 272, 0, 0, 0
1004, 1, 1636428392864, 1636428393396, 532, 257, 275, 257, 0, 257
1013, 1, 1636428394193, 1636428394465, 272, 0, 272, 0, 0, 0
1014, 1, 1636428394373, 1636428394645, 272, 0, 272, 0, 0, 0
974, 2, 1636428384932, 1636428394933, 10001, 0, 10001, 1, 0, 1
1015, 1, 1636428394696, 1636428394980, 284, 1, 283, 0, 0, 0
1017, 1, 1636428394828, 1636428395101, 273, 1, 272, 0, 0, 0
1018, 1, 1636428394840, 1636428395113, 273, 1, 272, 1, 0, 1
1016, 1, 1636428394712, 1636428395256, 544, 269, 275, 268, 0, 268
1019, 1, 1636428395341, 1636428395613, 272, 0, 272, 0, 0, 0
978, 2, 1636428385925, 1636428395925, 10000, 0, 10000, 0, 0, 0
1020, 1, 1636428396113, 1636428396385, 272, 0, 272, 0, 0, 0
984, 2, 1636428386581, 1636428396581, 10000, 0, 10000, 0, 0, 0
1021, 1, 1636428396337, 1636428396629, 292, 0, 292, 0, 0, 0
1022, 1, 1636428396365, 1636428396641, 276, 0, 276, 0, 0, 0
1023, 1, 1636428396629, 1636428396900, 271, 0, 271, 0, 0, 0
1025, 1, 1636428396805, 1636428397077, 272, 0, 272, 0, 0, 0
1024, 1, 1636428396652, 1636428397173, 521, 249, 272, 249, 0, 249
1027, 1, 1636428396992, 1636428397264, 272, 1, 271, 1, 0, 1
988, 2, 1636428387544, 1636428397545, 10001, 0, 10001, 1, 0, 1
1028, 1, 1636428397284, 1636428397592, 308, 0, 308, 0, 0, 0
989, 2, 1636428388068, 1636428398069, 10001, 0, 10001, 0, 0, 0
1029, 1, 1636428397953, 1636428398224, 271, 0, 271, 0, 0, 0
1030, 1, 1636428398116, 1636428398389, 273, 1, 272, 0, 0, 0
1031, 1, 1636428398357, 1636428398629, 272, 0, 272, 0, 0, 0
1032, 1, 1636428398365, 1636428398637, 272, 0, 272, 0, 0, 0
1033, 1, 1636428398468, 1636428398741, 273, 1, 272, 0, 0, 0
994, 2, 1636428388861, 1636428398861, 10000, 0, 10000, 0, 0, 0
1034, 1, 1636428398637, 1636428398912, 275, 0, 275, 0, 0, 0
1036, 1, 1636428398760, 1636428399033, 273, 1, 272, 0, 0, 0
1035, 1, 1636428398652, 1636428399185, 533, 261, 272, 261, 0, 261
1037, 1, 1636428398996, 1636428399269, 273, 1, 272, 1, 0, 1
1038, 1, 1636428399188, 1636428399465, 277, 1, 276, 0, 0, 0
1039, 1, 1636428399268, 1636428399541, 273, 1, 272, 0, 0, 0
1040, 1, 1636428399964, 1636428400237, 273, 1, 272, 0, 0, 0
998, 2, 1636428390273, 1636428400273, 10000, 0, 10000, 0, 0, 0
1041, 1, 1636428400077, 1636428400352, 275, 0, 275, 0, 0, 0
1042, 1, 1636428400228, 1636428400504, 276, 0, 276, 0, 0, 0
1000, 1, 1636428390941, 1636428400548, 9607, 9332, 275, 0, 9332, 9332
1043, 1, 1636428400316, 1636428400588, 272, 0, 272, 0, 0, 0
1044, 1, 1636428400465, 1636428400737, 272, 0, 272, 0, 0, 0
1045, 1, 1636428400521, 1636428400796, 275, 0, 275, 0, 0, 0
1047, 1, 1636428400681, 1636428400949, 268, 0, 268, 0, 0, 0
1048, 1, 1636428400736, 1636428401005, 269, 1, 268, 0, 0, 0
1046, 1, 1636428400548, 1636428401073, 525, 249, 276, 249, 0, 249
1050, 1, 1636428400972, 1636428401240, 268, 1, 267, 0, 0, 0
1049, 1, 1636428401000, 1636428401273, 273, 1, 272, 1, 0, 1
1051, 1, 1636428401173, 1636428401445, 272, 0, 272, 0, 0, 0
1052, 1, 1636428401284, 1636428401557, 273, 1, 272, 0, 0, 0
1053, 1, 1636428401888, 1636428402161, 273, 0, 273, 0, 0, 0
1054, 1, 1636428402053, 1636428402329, 276, 0, 276, 0, 0, 0
1055, 1, 1636428402169, 1636428402441, 272, 0, 272, 0, 0, 0
1056, 1, 1636428402204, 1636428402476, 272, 0, 272, 0, 0, 0
1057, 1, 1636428402432, 1636428402704, 272, 0, 272, 0, 0, 0
1058, 1, 1636428402444, 1636428402717, 273, 1, 272, 0, 0, 0
1005, 2, 1636428392864, 1636428402861, 9997, 0, 9997, 265, 0, 265
1007, 2, 1636428392864, 1636428402909, 10045, 0, 10045, 265, 0, 265
1009, 2, 1636428392868, 1636428402957, 10089, 0, 10089, 261, 0, 261
1010, 2, 1636428392864, 1636428403005, 10141, 0, 10141, 533, 0, 533
1008, 2, 1636428392864, 1636428403053, 10189, 0, 10189, 266, 0, 266
1060, 1, 1636428402672, 1636428403100, 428, 1, 427, 1, 0, 1
1059, 1, 1636428402549, 1636428403188, 639, 168, 471, 168, 0, 168
1012, 2, 1636428393264, 1636428403265, 10001, 0, 10001, 133, 0, 133
1061, 1, 1636428402833, 1636428403312, 479, 0, 479, 0, 0, 0
1062, 1, 1636428403100, 1636428403404, 304, 1, 303, 0, 1, 1
1065, 1, 1636428403188, 1636428403500, 312, 0, 312, 0, 0, 0
1064, 1, 1636428403232, 1636428403504, 272, 1, 271, 1, 0, 1
1063, 1, 1636428403232, 1636428403508, 276, 1, 275, 0, 0, 0
1026, 1, 1636428396944, 1636428403537, 6593, 6321, 272, 0, 6321, 6321
1066, 1, 1636428403404, 1636428403677, 273, 0, 273, 0, 0, 0
1070, 1, 1636428403740, 1636428404012, 272, 0, 272, 0, 0, 0
1072, 1, 1636428403852, 1636428404128, 276, 1, 275, 0, 0, 0
1074, 1, 1636428404165, 1636428404440, 275, 0, 275, 0, 0, 0
1075, 1, 1636428404200, 1636428404473, 273, 0, 273, 0, 0, 0
1076, 1, 1636428404244, 1636428404516, 272, 0, 272, 0, 0, 0
1077, 1, 1636428404396, 1636428404673, 277, 0, 277, 0, 0, 0
1078, 1, 1636428404500, 1636428404773, 273, 1, 272, 0, 1, 1
1079, 1, 1636428404580, 1636428404857, 277, 1, 276, 1, 0, 1
1081, 1, 1636428404724, 1636428404996, 272, 1, 271, 0, 0, 0
1082, 1, 1636428405004, 1636428405269, 265, 1, 264, 0, 1, 1
1083, 1, 1636428405028, 1636428405292, 264, 0, 264, 0, 0, 0
1084, 1, 1636428405084, 1636428405348, 264, 1, 263, 0, 1, 1
1085, 1, 1636428405176, 1636428405444, 268, 1, 267, 0, 0, 0
1086, 1, 1636428405220, 1636428405488, 268, 1, 267, 0, 0, 0
1087, 1, 1636428405625, 1636428405897, 272, 0, 272, 0, 0, 0
1088, 1, 1636428405881, 1636428406152, 271, 0, 271, 0, 0, 0
1089, 1, 1636428406093, 1636428406364, 271, 0, 271, 0, 0, 0
1090, 1, 1636428406164, 1636428406437, 273, 1, 272, 0, 1, 1
1091, 1, 1636428406196, 1636428406473, 277, 1, 276, 0, 1, 1
1092, 1, 1636428406420, 1636428406689, 269, 1, 268, 0, 0, 0
1093, 1, 1636428406545, 1636428406817, 272, 0, 272, 0, 0, 0
1094, 1, 1636428406580, 1636428406852, 272, 1, 271, 0, 1, 1
1095, 1, 1636428406716, 1636428406988, 272, 1, 271, 1, 0, 1
1096, 1, 1636428406881, 1636428407152, 271, 0, 271, 0, 0, 0
1097, 1, 1636428406981, 1636428407252, 271, 0, 271, 0, 0, 0
1098, 1, 1636428407061, 1636428407333, 272, 0, 272, 0, 0, 0
1099, 1, 1636428407177, 1636428407448, 271, 0, 271, 0, 0, 0
1101, 1, 1636428407641, 1636428407917, 276, 0, 276, 0, 0, 0
1102, 1, 1636428407881, 1636428408161, 280, 0, 280, 0, 0, 0
1103, 1, 1636428408052, 1636428408324, 272, 1, 271, 0, 0, 0
1104, 1, 1636428408161, 1636428408437, 276, 0, 276, 0, 0, 0
1105, 1, 1636428408192, 1636428408464, 272, 0, 272, 0, 0, 0
1106, 1, 1636428408420, 1636428408692, 272, 1, 271, 0, 0, 0
1107, 1, 1636428408492, 1636428408756, 264, 1, 263, 0, 1, 1
1108, 1, 1636428408577, 1636428408844, 267, 0, 267, 0, 0, 0
1109, 1, 1636428408664, 1636428408936, 272, 0, 272, 0, 0, 0
1110, 1, 1636428408972, 1636428409249, 277, 0, 277, 0, 0, 0
1111, 1, 1636428408985, 1636428409257, 272, 0, 272, 0, 0, 0
1112, 1, 1636428409141, 1636428409417, 276, 0, 276, 0, 0, 0
1113, 1, 1636428409172, 1636428409444, 272, 1, 271, 0, 0, 0
1114, 1, 1636428409569, 1636428409845, 276, 0, 276, 0, 0, 0
1115, 1, 1636428409813, 1636428410085, 272, 0, 272, 0, 0, 0
1116, 1, 1636428410117, 1636428410389, 272, 0, 272, 0, 0, 0
1117, 1, 1636428410157, 1636428410424, 267, 0, 267, 0, 0, 0
1118, 1, 1636428410256, 1636428410529, 273, 1, 272, 0, 1, 1
1119, 1, 1636428410300, 1636428410569, 269, 1, 268, 0, 0, 0
1120, 1, 1636428410381, 1636428410653, 272, 0, 272, 0, 0, 0
1121, 1, 1636428410572, 1636428410845, 273, 0, 273, 0, 0, 0
1122, 1, 1636428410644, 1636428410917, 273, 1, 272, 0, 0, 0
1123, 1, 1636428410980, 1636428411253, 273, 0, 273, 0, 0, 0
1124, 1, 1636428411053, 1636428411325, 272, 0, 272, 0, 0, 0
1125, 1, 1636428411053, 1636428411325, 272, 0, 272, 0, 0, 0
1126, 1, 1636428411221, 1636428411496, 275, 0, 275, 0, 0, 0
1127, 1, 1636428411449, 1636428411721, 272, 0, 272, 0, 0, 0
1128, 1, 1636428411896, 1636428412169, 273, 1, 272, 0, 0, 0
1129, 1, 1636428412097, 1636428412365, 268, 0, 268, 0, 0, 0
1130, 1, 1636428412157, 1636428412428, 271, 0, 271, 0, 0, 0
1131, 1, 1636428412332, 1636428412608, 276, 1, 275, 0, 1, 1
1132, 1, 1636428412384, 1636428412665, 281, 1, 280, 0, 0, 0
1133, 1, 1636428412461, 1636428412729, 268, 0, 268, 0, 0, 0
1134, 1, 1636428412568, 1636428412840, 272, 0, 272, 0, 0, 0
1135, 1, 1636428412693, 1636428412965, 272, 0, 272, 0, 0, 0
1136, 1, 1636428412857, 1636428413129, 272, 0, 272, 0, 0, 0
1137, 1, 1636428413133, 1636428413405, 272, 0, 272, 0, 0, 0
1138, 1, 1636428413133, 1636428413409, 276, 0, 276, 0, 0, 0
1069, 2, 1636428403492, 1636428413492, 10000, 0, 10000, 185, 0, 185
1067, 2, 1636428403496, 1636428413537, 10041, 0, 10041, 181, 0, 181
1068, 2, 1636428403496, 1636428413584, 10088, 0, 10088, 181, 0, 181
1139, 1, 1636428413344, 1636428413721, 377, 1, 376, 0, 0, 0
1071, 2, 1636428403752, 1636428413753, 10001, 0, 10001, 261, 0, 261
1140, 1, 1636428413628, 1636428413901, 273, 0, 273, 0, 0, 0
1073, 2, 1636428403992, 1636428413993, 10001, 0, 10001, 21, 0, 21
1141, 1, 1636428413933, 1636428414216, 283, 1, 282, 1, 0, 1
1142, 1, 1636428413976, 1636428414248, 272, 1, 271, 1, 0, 1
1100, 1, 1636428407252, 1636428414260, 7008, 6741, 267, 0, 6741, 6741
1145, 1, 1636428414172, 1636428414440, 268, 1, 267, 1, 0, 1
1146, 1, 1636428414172, 1636428414448, 276, 1, 275, 1, 0, 1
1147, 1, 1636428414360, 1636428414625, 265, 1, 264, 0, 0, 0
1150, 1, 1636428414460, 1636428414728, 268, 1, 267, 0, 1, 1
1149, 1, 1636428414456, 1636428414732, 276, 0, 276, 0, 0, 0
1151, 1, 1636428414585, 1636428414857, 272, 0, 272, 0, 0, 0
1152, 1, 1636428414617, 1636428414889, 272, 0, 272, 0, 0, 0
1148, 1, 1636428414368, 1636428414900, 532, 257, 275, 257, 0, 257
1153, 1, 1636428414632, 1636428414909, 277, 1, 276, 0, 0, 0
1080, 2, 1636428404584, 1636428414953, 10369, 189, 10180, 188, 1, 189
1155, 1, 1636428414925, 1636428415280, 355, 0, 355, 0, 0, 0
1154, 1, 1636428414716, 1636428415281, 565, 185, 380, 185, 0, 185
1156, 1, 1636428415232, 1636428415500, 268, 1, 267, 0, 0, 0
1157, 1, 1636428415256, 1636428415533, 277, 0, 277, 0, 0, 0
1158, 1, 1636428415356, 1636428415624, 268, 0, 268, 0, 0, 0
1160, 1, 1636428415624, 1636428415904, 280, 1, 279, 0, 0, 0
1161, 1, 1636428415916, 1636428416193, 277, 1, 276, 0, 0, 0
1162, 1, 1636428416085, 1636428416356, 271, 0, 271, 0, 0, 0
1163, 1, 1636428416132, 1636428416408, 276, 1, 275, 0, 1, 1
1164, 1, 1636428416184, 1636428416457, 273, 1, 272, 0, 0, 0
1166, 1, 1636428416272, 1636428416544, 272, 0, 272, 0, 0, 0
1167, 1, 1636428416481, 1636428416748, 267, 0, 267, 0, 0, 0
1168, 1, 1636428416500, 1636428416768, 268, 1, 267, 1, 0, 1
1170, 1, 1636428416576, 1636428416841, 265, 1, 264, 0, 1, 1
1172, 1, 1636428416708, 1636428416977, 269, 0, 269, 0, 0, 0
1173, 1, 1636428417016, 1636428417289, 273, 1, 272, 0, 0, 0
1174, 1, 1636428417232, 1636428417505, 273, 0, 273, 0, 0, 0
1175, 1, 1636428417265, 1636428417537, 272, 0, 272, 0, 0, 0
1177, 1, 1636428417540, 1636428417816, 276, 1, 275, 0, 0, 0
1178, 1, 1636428418032, 1636428418305, 273, 1, 272, 1, 0, 1
1179, 1, 1636428418096, 1636428418369, 273, 1, 272, 0, 0, 0
1180, 1, 1636428418116, 1636428418389, 273, 1, 272, 0, 1, 1
1182, 1, 1636428418352, 1636428418624, 272, 0, 272, 0, 0, 0
1184, 1, 1636428418609, 1636428418881, 272, 0, 272, 0, 0, 0
1185, 1, 1636428418668, 1636428418941, 273, 1, 272, 0, 1, 1
1186, 1, 1636428418740, 1636428419012, 272, 0, 272, 0, 0, 0
1187, 1, 1636428419125, 1636428419397, 272, 0, 272, 0, 0, 0
1192, 1, 1636428420152, 1636428420421, 269, 0, 269, 0, 0, 0
1193, 1, 1636428420196, 1636428420472, 276, 1, 275, 0, 1, 1
1194, 1, 1636428420460, 1636428420732, 272, 0, 272, 0, 0, 0
1195, 1, 1636428420584, 1636428420853, 269, 0, 269, 0, 0, 0
1196, 1, 1636428420628, 1636428420900, 272, 0, 272, 0, 0, 0
1199, 1, 1636428422161, 1636428422433, 272, 0, 272, 0, 0, 0
1200, 1, 1636428422197, 1636428422469, 272, 0, 272, 0, 0, 0
1201, 1, 1636428422456, 1636428422729, 273, 1, 272, 0, 1, 1
1203, 1, 1636428422621, 1636428422892, 271, 0, 271, 0, 0, 0
1144, 2, 1636428414060, 1636428424065, 10005, 0, 10005, 157, 0, 157
1143, 2, 1636428414060, 1636428424109, 10049, 10005, 44, 157, 9849, 10006
1204, 1, 1636428424197, 1636428424468, 271, 0, 271, 0, 0, 0
1205, 1, 1636428424245, 1636428424509, 264, 0, 264, 0, 0, 0
1206, 1, 1636428424420, 1636428424692, 272, 1, 271, 0, 0, 0
1208, 1, 1636428424541, 1636428424813, 272, 0, 272, 0, 0, 0
1209, 1, 1636428424588, 1636428424860, 272, 1, 271, 0, 0, 0
1207, 1, 1636428424461, 1636428424965, 504, 232, 272, 232, 0, 232
1159, 2, 1636428415456, 1636428425461, 10005, 0, 10005, 0, 0, 0
1210, 1, 1636428425809, 1636428426080, 271, 0, 271, 0, 0, 0
1211, 1, 1636428426208, 1636428426480, 272, 0, 272, 0, 0, 0
1212, 1, 1636428426272, 1636428426545, 273, 0, 273, 0, 0, 0
1165, 2, 1636428416193, 1636428426549, 10356, 264, 10092, 264, 0, 264
1171, 2, 1636428416624, 1636428426640, 10016, 0, 10016, 9925, 0, 9925
1169, 2, 1636428416572, 1636428426684, 10112, 0, 10112, 0, 0, 0
1213, 1, 1636428426344, 1636428426728, 384, 0, 384, 0, 0, 0
1215, 1, 1636428426728, 1636428426996, 268, 0, 268, 0, 0, 0
1214, 1, 1636428426424, 1636428426996, 572, 305, 267, 304, 1, 305
1216, 1, 1636428426820, 1636428427088, 268, 0, 268, 0, 0, 0
1217, 1, 1636428426948, 1636428427220, 272, 0, 272, 0, 0, 0
1176, 2, 1636428417341, 1636428427341, 10000, 0, 10000, 0, 0, 0
1218, 1, 1636428426996, 1636428427389, 393, 92, 301, 92, 0, 92
1219, 1, 1636428427688, 1636428427960, 272, 0, 272, 0, 0, 0
1220, 1, 1636428427704, 1636428427976, 272, 0, 272, 0, 0, 0
1181, 2, 1636428418160, 1636428428156, 9996, 0, 9996, 0, 0, 0
1221, 1, 1636428428200, 1636428428473, 273, 0, 273, 0, 0, 0
1183, 2, 1636428418557, 1636428428560, 10003, 0, 10003, 0, 0, 0
1222, 1, 1636428428292, 1636428428608, 316, 1, 315, 0, 0, 0
1223, 1, 1636428428352, 1636428428624, 272, 1, 271, 0, 1, 1
1225, 1, 1636428428520, 1636428428792, 272, 0, 272, 0, 0, 0
1224, 1, 1636428428388, 1636428428880, 492, 220, 272, 220, 0, 220
1227, 1, 1636428428692, 1636428428964, 272, 0, 272, 0, 0, 0
1226, 1, 1636428428736, 1636428429008, 272, 0, 272, 0, 0, 0
1228, 1, 1636428428856, 1636428429133, 277, 0, 277, 0, 0, 0
1188, 2, 1636428419149, 1636428429149, 10000, 0, 10000, 7400, 0, 7400
1229, 1, 1636428428900, 1636428429197, 297, 0, 297, 0, 0, 0
1230, 1, 1636428428932, 1636428429208, 276, 0, 276, 0, 0, 0
1189, 2, 1636428419345, 1636428429340, 9995, 0, 9995, 0, 0, 0
1190, 2, 1636428419461, 1636428429456, 9995, 0, 9995, 7088, 0, 7088
1231, 1, 1636428429532, 1636428429808, 276, 0, 276, 0, 0, 0
1233, 1, 1636428429656, 1636428429925, 269, 0, 269, 0, 0, 0
1232, 1, 1636428429688, 1636428429961, 273, 0, 273, 0, 0, 0
1191, 2, 1636428420036, 1636428430037, 10001, 0, 10001, 6513, 0, 6513
1234, 1, 1636428430084, 1636428430352, 268, 0, 268, 0, 0, 0
1235, 1, 1636428430172, 1636428430444, 272, 0, 272, 0, 0, 0
1237, 1, 1636428430384, 1636428430656, 272, 0, 272, 0, 0, 0
1238, 1, 1636428430416, 1636428430688, 272, 0, 272, 0, 0, 0
1236, 1, 1636428430300, 1636428430716, 416, 144, 272, 144, 0, 144
1239, 1, 1636428430452, 1636428430724, 272, 0, 272, 0, 0, 0
1197, 2, 1636428420817, 1636428430816, 9999, 0, 9999, 0, 0, 0
1240, 1, 1636428430624, 1636428430897, 273, 0, 273, 0, 0, 0
1243, 1, 1636428430804, 1636428431080, 276, 0, 276, 0, 0, 0
1242, 1, 1636428430800, 1636428431080, 280, 0, 280, 0, 0, 0
1244, 1, 1636428430864, 1636428431136, 272, 0, 272, 0, 0, 0
1198, 2, 1636428421201, 1636428431200, 9999, 0, 9999, 0, 0, 0
1245, 1, 1636428431168, 1636428431436, 268, 0, 268, 0, 0, 0
1246, 1, 1636428431488, 1636428431761, 273, 0, 273, 0, 0, 0
1247, 1, 1636428431540, 1636428431816, 276, 0, 276, 0, 0, 0
1249, 1, 1636428431584, 1636428431856, 272, 0, 272, 0, 0, 0
1248, 1, 1636428431596, 1636428431868, 272, 0, 272, 0, 0, 0
1250, 1, 1636428432016, 1636428432288, 272, 0, 272, 0, 0, 0
1251, 1, 1636428432244, 1636428432516, 272, 0, 272, 0, 0, 0
1202, 2, 1636428422537, 1636428432536, 9999, 0, 9999, 0, 0, 0
1252, 1, 1636428432268, 1636428432584, 316, 20, 296, 20, 0, 20
1253, 1, 1636428432353, 1636428432624, 271, 0, 271, 0, 0, 0
1255, 1, 1636428432501, 1636428432772, 271, 0, 271, 0, 0, 0
1254, 1, 1636428432404, 1636428432788, 384, 113, 271, 113, 0, 113
1257, 1, 1636428432744, 1636428433016, 272, 0, 272, 0, 0, 0
1259, 1, 1636428432800, 1636428433073, 273, 0, 273, 0, 0, 0
1258, 1, 1636428432800, 1636428433073, 273, 0, 273, 0, 0, 0
1260, 1, 1636428432888, 1636428433161, 273, 0, 273, 0, 0, 0
1261, 1, 1636428433036, 1636428433308, 272, 0, 272, 0, 0, 0
1262, 1, 1636428433444, 1636428433716, 272, 0, 272, 0, 0, 0
1263, 1, 1636428433481, 1636428433753, 272, 0, 272, 0, 0, 0
1264, 1, 1636428433484, 1636428433760, 276, 0, 276, 0, 0, 0
1265, 1, 1636428433592, 1636428433865, 273, 0, 273, 0, 0, 0
1266, 1, 1636428434041, 1636428434312, 271, 0, 271, 0, 0, 0
1267, 1, 1636428434124, 1636428434396, 272, 1, 271, 0, 0, 0
1268, 1, 1636428434284, 1636428434561, 277, 1, 276, 0, 0, 0
1270, 1, 1636428434404, 1636428434672, 268, 0, 268, 0, 0, 0
1269, 1, 1636428434328, 1636428434672, 344, 69, 275, 69, 0, 69
1271, 1, 1636428434424, 1636428434696, 272, 1, 271, 0, 0, 0
1272, 1, 1636428434625, 1636428434901, 276, 0, 276, 0, 0, 0
1273, 1, 1636428434756, 1636428435028, 272, 1, 271, 0, 0, 0
1274, 1, 1636428434812, 1636428435085, 273, 1, 272, 0, 0, 0
1275, 1, 1636428434828, 1636428435109, 281, 1, 280, 1, 0, 1
1276, 1, 1636428434981, 1636428435257, 276, 0, 276, 0, 0, 0
1277, 1, 1636428435389, 1636428435660, 271, 0, 271, 0, 0, 0
1278, 1, 1636428435481, 1636428435753, 272, 0, 272, 0, 0, 0
1279, 1, 1636428435513, 1636428435789, 276, 0, 276, 0, 0, 0
1280, 1, 1636428435628, 1636428435901, 273, 1, 272, 0, 0, 0
1281, 1, 1636428435961, 1636428436228, 267, 0, 267, 0, 0, 0
1282, 1, 1636428436049, 1636428436317, 268, 0, 268, 0, 0, 0
1284, 1, 1636428436288, 1636428436560, 272, 1, 271, 0, 0, 0
1286, 1, 1636428436316, 1636428436588, 272, 1, 271, 0, 0, 0
1285, 1, 1636428436324, 1636428436592, 268, 0, 268, 0, 0, 0
1283, 1, 1636428436248, 1636428436592, 344, 69, 275, 69, 0, 69
1287, 1, 1636428436632, 1636428436908, 276, 0, 276, 0, 0, 0
1288, 1, 1636428436696, 1636428436969, 273, 0, 273, 0, 0, 0
1289, 1, 1636428436808, 1636428437081, 273, 0, 273, 0, 0, 0
1292, 1, 1636428436901, 1636428437173, 272, 0, 272, 0, 0, 0
1291, 1, 1636428436897, 1636428437173, 276, 0, 276, 0, 0, 0
1293, 1, 1636428436932, 1636428437208, 276, 0, 276, 0, 0, 0
1294, 1, 1636428436968, 1636428437240, 272, 1, 271, 0, 0, 0
1290, 1, 1636428436905, 1636428437449, 544, 269, 275, 269, 0, 269
1295, 1, 1636428437316, 1636428437588, 272, 1, 271, 0, 0, 0
1296, 1, 1636428437512, 1636428437789, 277, 1, 276, 0, 0, 0
1297, 1, 1636428437544, 1636428437821, 277, 1, 276, 0, 0, 0
1298, 1, 1636428437720, 1636428437993, 273, 1, 272, 0, 0, 0
1299, 1, 1636428437841, 1636428438112, 271, 0, 271, 0, 0, 0
1300, 1, 1636428438176, 1636428438448, 272, 1, 271, 0, 1, 1
1301, 1, 1636428438257, 1636428438528, 271, 0, 271, 0, 0, 0
1303, 1, 1636428438304, 1636428438572, 268, 0, 268, 0, 0, 0
1304, 1, 1636428438328, 1636428438601, 273, 1, 272, 0, 0, 0
1302, 1, 1636428438304, 1636428438720, 416, 145, 271, 145, 0, 145
1305, 1, 1636428438636, 1636428438908, 272, 1, 271, 0, 0, 0
1306, 1, 1636428438672, 1636428438948, 276, 1, 275, 0, 0, 0
1307, 1, 1636428438720, 1636428438992, 272, 1, 271, 0, 0, 0
1308, 1, 1636428438796, 1636428439068, 272, 0, 272, 0, 0, 0
1309, 1, 1636428438832, 1636428439108, 276, 0, 276, 0, 0, 0
1311, 1, 1636428438981, 1636428439260, 279, 12, 267, 12, 0, 12
1312, 1, 1636428438981, 1636428439261, 280, 0, 280, 0, 0, 0
1310, 1, 1636428438928, 1636428439380, 452, 181, 271, 181, 0, 181
1313, 1, 1636428439317, 1636428439589, 272, 0, 272, 0, 0, 0
1314, 1, 1636428439549, 1636428439832, 283, 0, 283, 0, 0, 0
1315, 1, 1636428439585, 1636428439853, 268, 0, 268, 0, 0, 0
1316, 1, 1636428439617, 1636428439889, 272, 0, 272, 0, 0, 0
1317, 1, 1636428439729, 1636428440129, 400, 124, 276, 124, 0, 124
1318, 1, 1636428440176, 1636428440452, 276, 1, 275, 0, 0, 0
1319, 1, 1636428440184, 1636428440460, 276, 1, 275, 1, 0, 1
1320, 1, 1636428440220, 1636428440488, 268, 1, 267, 0, 0, 0
1321, 1, 1636428440324, 1636428440729, 405, 128, 277, 128, 0, 128
1322, 1, 1636428440420, 1636428440761, 341, 69, 272, 68, 1, 69
1241, 2, 1636428430772, 1636428440772, 10000, 0, 10000, 0, 0, 0
1323, 1, 1636428440656, 1636428440929, 273, 0, 273, 0, 0, 0
1324, 1, 1636428440660, 1636428440933, 273, 1, 272, 0, 0, 0
1325, 1, 1636428440712, 1636428441001, 289, 1, 288, 0, 1, 1
1326, 1, 1636428440712, 1636428441036, 324, 49, 275, 49, 0, 49
1328, 1, 1636428440864, 1636428441124, 260, 0, 260, 0, 0, 0
1329, 1, 1636428440904, 1636428441168, 264, 1, 263, 0, 0, 0
1327, 1, 1636428440828, 1636428441273, 445, 173, 272, 173, 0, 173
1330, 1, 1636428441076, 1636428441345, 269, 1, 268, 1, 0, 1
1331, 1, 1636428441117, 1636428441392, 275, 0, 275, 0, 0, 0
1332, 1, 1636428441361, 1636428441624, 263, 0, 263, 0, 0, 0
1333, 1, 1636428441548, 1636428441825, 277, 1, 276, 0, 0, 0
1334, 1, 1636428441596, 1636428441873, 277, 0, 277, 0, 0, 0
1335, 1, 1636428441664, 1636428441937, 273, 1, 272, 1, 0, 1
1336, 1, 1636428441721, 1636428441997, 276, 0, 276, 0, 0, 0
1337, 1, 1636428442164, 1636428442436, 272, 0, 272, 0, 0, 0
1338, 1, 1636428442180, 1636428442461, 281, 0, 281, 0, 0, 0
1256, 2, 1636428432532, 1636428442533, 10001, 0, 10001, 0, 0, 0
1339, 1, 1636428442260, 1636428442576, 316, 0, 316, 0, 0, 0
1341, 1, 1636428442356, 1636428442672, 316, 0, 316, 0, 0, 0
1340, 1, 1636428442276, 1636428442765, 489, 185, 304, 185, 0, 185
1344, 1, 1636428442672, 1636428442940, 268, 0, 268, 0, 0, 0
1342, 1, 1636428442708, 1636428442980, 272, 1, 271, 1, 0, 1
1345, 1, 1636428442708, 1636428442980, 272, 1, 271, 1, 0, 1
1343, 1, 1636428442712, 1636428442988, 276, 0, 276, 0, 0, 0
1347, 1, 1636428442832, 1636428443104, 272, 0, 272, 0, 0, 0
1348, 1, 1636428442876, 1636428443148, 272, 1, 271, 0, 0, 0
1346, 1, 1636428442792, 1636428443208, 416, 148, 268, 148, 0, 148
1349, 1, 1636428442968, 1636428443245, 277, 0, 277, 0, 0, 0
1350, 1, 1636428442980, 1636428443252, 272, 0, 272, 0, 0, 0
1351, 1, 1636428443104, 1636428443377, 273, 0, 273, 0, 0, 0
1352, 1, 1636428443396, 1636428443676, 280, 1, 279, 0, 0, 0
1353, 1, 1636428443572, 1636428443845, 273, 0, 273, 0, 0, 0
1354, 1, 1636428443596, 1636428443877, 281, 0, 281, 0, 0, 0
1355, 1, 1636428443745, 1636428444017, 272, 0, 272, 0, 0, 0
1356, 1, 1636428443777, 1636428444053, 276, 0, 276, 0, 0, 0
1357, 1, 1636428444117, 1636428444389, 272, 0, 272, 0, 0, 0
1358, 1, 1636428444208, 1636428444480, 272, 1, 271, 1, 0, 1
1359, 1, 1636428444212, 1636428444488, 276, 1, 275, 0, 0, 0
1360, 1, 1636428444228, 1636428444669, 441, 161, 280, 161, 0, 161
1361, 1, 1636428444409, 1636428444677, 268, 0, 268, 0, 0, 0
1362, 1, 1636428444684, 1636428444956, 272, 1, 271, 0, 0, 0
1364, 1, 1636428444740, 1636428445013, 273, 0, 273, 0, 0, 0
1363, 1, 1636428444740, 1636428445013, 273, 0, 273, 0, 0, 0
1365, 1, 1636428444749, 1636428445028, 279, 0, 279, 0, 0, 0
1366, 1, 1636428444756, 1636428445037, 281, 0, 281, 0, 0, 0
1367, 1, 1636428444829, 1636428445100, 271, 0, 271, 0, 0, 0
1369, 1, 1636428444913, 1636428445184, 271, 0, 271, 0, 0, 0
1368, 1, 1636428444844, 1636428445228, 384, 113, 271, 113, 0, 113
1370, 1, 1636428445056, 1636428445333, 277, 0, 277, 0, 0, 0
1371, 1, 1636428445072, 1636428445345, 273, 1, 272, 0, 1, 1
1372, 1, 1636428445300, 1636428445621, 321, 46, 275, 45, 0, 45
1373, 1, 1636428445589, 1636428445860, 271, 0, 271, 0, 0, 0
1374, 1, 1636428445677, 1636428445953, 276, 0, 276, 0, 0, 0
1375, 1, 1636428445704, 1636428445976, 272, 1, 271, 0, 0, 0
1376, 1, 1636428445816, 1636428446080, 264, 0, 264, 0, 0, 0
1377, 1, 1636428446136, 1636428446405, 269, 1, 268, 0, 0, 0
1378, 1, 1636428446136, 1636428446405, 269, 1, 268, 0, 0, 0
1379, 1, 1636428446148, 1636428446416, 268, 0, 268, 0, 0, 0
1380, 1, 1636428446236, 1636428446685, 449, 170, 279, 169, 1, 170
1381, 1, 1636428446433, 1636428446700, 267, 0, 267, 0, 0, 0
1382, 1, 1636428446656, 1636428446928, 272, 0, 272, 0, 0, 0
1383, 1, 1636428446700, 1636428446976, 276, 1, 275, 0, 1, 1
1384, 1, 1636428446708, 1636428446989, 281, 1, 280, 0, 1, 1
1385, 1, 1636428446721, 1636428446989, 268, 0, 268, 0, 0, 0
1386, 1, 1636428446768, 1636428447044, 276, 1, 275, 0, 0, 0
1387, 1, 1636428446832, 1636428447104, 272, 0, 272, 0, 0, 0
1388, 1, 1636428446836, 1636428447104, 268, 0, 268, 0, 0, 0
1389, 1, 1636428446936, 1636428447321, 385, 109, 276, 109, 0, 109
1390, 1, 1636428447121, 1636428447401, 280, 0, 280, 0, 0, 0
1391, 1, 1636428447145, 1636428447421, 276, 0, 276, 0, 0, 0
1392, 1, 1636428447353, 1636428447681, 328, 48, 280, 48, 0, 48
1393, 1, 1636428447620, 1636428447892, 272, 1, 271, 0, 1, 1
1394, 1, 1636428447680, 1636428447949, 269, 1, 268, 0, 0, 0
1395, 1, 1636428447740, 1636428448013, 273, 0, 273, 0, 0, 0
1396, 1, 1636428447753, 1636428448028, 275, 0, 275, 0, 0, 0
1397, 1, 1636428448077, 1636428448352, 275, 0, 275, 0, 0, 0
1398, 1, 1636428448100, 1636428448380, 280, 1, 279, 1, 0, 1
1399, 1, 1636428448269, 1636428448541, 272, 0, 272, 0, 0, 0
1400, 1, 1636428448273, 1636428448820, 547, 268, 279, 268, 0, 268
1401, 1, 1636428448548, 1636428448821, 273, 0, 273, 0, 0, 0
1402, 1, 1636428448676, 1636428448948, 272, 1, 271, 0, 0, 0
1404, 1, 1636428448700, 1636428448969, 269, 1, 268, 0, 0, 0
1403, 1, 1636428448700, 1636428448969, 269, 1, 268, 0, 0, 0
1405, 1, 1636428448712, 1636428448976, 264, 0, 264, 0, 0, 0
1406, 1, 1636428448736, 1636428448996, 260, 0, 260, 0, 0, 0
1409, 1, 1636428448908, 1636428449176, 268, 0, 268, 0, 0, 0
1410, 1, 1636428449032, 1636428449305, 273, 0, 273, 0, 0, 0
1411, 1, 1636428449200, 1636428449473, 273, 1, 272, 1, 0, 1
1412, 1, 1636428449428, 1636428449749, 321, 45, 276, 45, 0, 45
1413, 1, 1636428449628, 1636428449900, 272, 0, 272, 0, 0, 0
1414, 1, 1636428449696, 1636428449965, 269, 1, 268, 0, 0, 0
1415, 1, 1636428449769, 1636428450037, 268, 0, 268, 0, 0, 0
1416, 1, 1636428449820, 1636428450089, 269, 1, 268, 0, 0, 0
1418, 1, 1636428450132, 1636428450409, 277, 1, 276, 0, 1, 1
1419, 1, 1636428450189, 1636428450460, 271, 0, 271, 0, 0, 0
1421, 1, 1636428450420, 1636428450696, 276, 1, 275, 0, 0, 0
1420, 1, 1636428450236, 1636428450733, 497, 225, 272, 225, 0, 225
1422, 1, 1636428450600, 1636428450872, 272, 1, 271, 0, 0, 0
1423, 1, 1636428450704, 1636428450980, 276, 0, 276, 0, 0, 0
1425, 1, 1636428450744, 1636428451017, 273, 0, 273, 0, 0, 0
1426, 1, 1636428450760, 1636428451033, 273, 0, 273, 0, 0, 0
1427, 1, 1636428450821, 1636428451097, 276, 0, 276, 0, 0, 0
1428, 1, 1636428451097, 1636428451369, 272, 0, 272, 0, 0, 0
1429, 1, 1636428451277, 1636428451548, 271, 0, 271, 0, 0, 0
1430, 1, 1636428451513, 1636428451820, 307, 36, 271, 36, 0, 36
1431, 1, 1636428451620, 1636428451892, 272, 1, 271, 0, 1, 1
1433, 1, 1636428451712, 1636428451985, 273, 1, 272, 0, 1, 1
1432, 1, 1636428451712, 1636428451985, 273, 1, 272, 0, 1, 1
1434, 1, 1636428451880, 1636428452153, 273, 1, 272, 0, 1, 1
1435, 1, 1636428452136, 1636428452413, 277, 1, 276, 0, 1, 1
1436, 1, 1636428452204, 1636428452477, 273, 1, 272, 0, 0, 0
1437, 1, 1636428452320, 1636428452752, 432, 157, 275, 157, 0, 157
1438, 1, 1636428452505, 1636428452777, 272, 0, 272, 0, 0, 0
1439, 1, 1636428452624, 1636428452896, 272, 1, 271, 0, 0, 0
1440, 1, 1636428452688, 1636428452965, 277, 0, 277, 0, 0, 0
1441, 1, 1636428452712, 1636428452985, 273, 1, 272, 0, 1, 1
1442, 1, 1636428452833, 1636428453109, 276, 0, 276, 0, 0, 0
1443, 1, 1636428452881, 1636428453153, 272, 0, 272, 0, 0, 0
1444, 1, 1636428453156, 1636428453424, 268, 0, 268, 0, 0, 0
1445, 1, 1636428453196, 1636428453468, 272, 1, 271, 0, 0, 0
1446, 1, 1636428453508, 1636428453781, 273, 0, 273, 0, 0, 0
1447, 1, 1636428453593, 1636428453865, 272, 0, 272, 0, 0, 0
1448, 1, 1636428453709, 1636428453981, 272, 0, 272, 0, 0, 0
1449, 1, 1636428453828, 1636428454100, 272, 1, 271, 0, 0, 0
1450, 1, 1636428453856, 1636428454125, 269, 1, 268, 0, 1, 1
1451, 1, 1636428454133, 1636428454401, 268, 0, 268, 0, 0, 0
1452, 1, 1636428454241, 1636428454513, 272, 0, 272, 0, 0, 0
1453, 1, 1636428454392, 1636428454792, 400, 122, 278, 120, 0, 120
1454, 1, 1636428454564, 1636428454836, 272, 1, 271, 0, 0, 0
1455, 1, 1636428454660, 1636428454936, 276, 0, 276, 0, 0, 0
1456, 1, 1636428454672, 1636428454944, 272, 0, 272, 0, 0, 0
1457, 1, 1636428454704, 1636428454984, 280, 1, 279, 0, 0, 0
1458, 1, 1636428454748, 1636428455021, 273, 0, 273, 0, 0, 0
1459, 1, 1636428454940, 1636428455216, 276, 1, 275, 1, 0, 1
1460, 1, 1636428455128, 1636428455404, 276, 0, 276, 0, 0, 0
1461, 1, 1636428455260, 1636428455533, 273, 1, 272, 0, 1, 1
1462, 1, 1636428455573, 1636428455848, 275, 0, 275, 0, 0, 0
1463, 1, 1636428455657, 1636428455932, 275, 0, 275, 0, 0, 0
1464, 1, 1636428455801, 1636428456073, 272, 0, 272, 0, 0, 0
1465, 1, 1636428455821, 1636428456093, 272, 0, 272, 0, 0, 0
1466, 1, 1636428455936, 1636428456209, 273, 0, 273, 0, 0, 0
1467, 1, 1636428456197, 1636428456469, 272, 0, 272, 0, 0, 0
1468, 1, 1636428456228, 1636428456501, 273, 1, 272, 0, 1, 1
1469, 1, 1636428456317, 1636428456784, 467, 185, 282, 184, 0, 184
1470, 1, 1636428456540, 1636428456812, 272, 1, 271, 0, 0, 0
1471, 1, 1636428456668, 1636428456940, 272, 1, 271, 0, 0, 0
1472, 1, 1636428456776, 1636428457044, 268, 1, 267, 0, 1, 1
1474, 1, 1636428456788, 1636428457060, 272, 0, 272, 0, 0, 0
1473, 1, 1636428456784, 1636428457061, 277, 1, 276, 0, 1, 1
1475, 1, 1636428456912, 1636428457185, 273, 0, 273, 0, 0, 0
1476, 1, 1636428457208, 1636428457481, 273, 1, 272, 1, 0, 1
1477, 1, 1636428457376, 1636428457649, 273, 1, 272, 0, 1, 1
1478, 1, 1636428457632, 1636428457929, 297, 17, 280, 17, 0, 17
1479, 1, 1636428457737, 1636428458009, 272, 0, 272, 0, 0, 0
1480, 1, 1636428457792, 1636428458060, 268, 1, 267, 1, 0, 1
1481, 1, 1636428457928, 1636428458196, 268, 1, 267, 1, 0, 1
1482, 1, 1636428457988, 1636428458257, 269, 1, 268, 1, 0, 1
1483, 1, 1636428458204, 1636428458476, 272, 1, 271, 0, 1, 1
1485, 1, 1636428458273, 1636428458544, 271, 0, 271, 0, 0, 0
1484, 1, 1636428458225, 1636428458749, 524, 251, 273, 251, 0, 251
1407, 2, 1636428448828, 1636428458829, 10001, 0, 10001, 149, 0, 149
1408, 2, 1636428448844, 1636428458877, 10033, 0, 10033, 133, 0, 133
1486, 1, 1636428458621, 1636428458925, 304, 0, 304, 0, 0, 0
1487, 1, 1636428458685, 1636428459016, 331, 0, 331, 0, 0, 0
1488, 1, 1636428458772, 1636428459109, 337, 1, 336, 0, 0, 0
1490, 1, 1636428458877, 1636428459148, 271, 0, 271, 0, 0, 0
1489, 1, 1636428458924, 1636428459192, 268, 1, 267, 0, 0, 0
1491, 1, 1636428459012, 1636428459284, 272, 0, 272, 0, 0, 0
1492, 1, 1636428459265, 1636428459537, 272, 0, 272, 0, 0, 0
1493, 1, 1636428459328, 1636428459597, 269, 1, 268, 0, 0, 0
1494, 1, 1636428459328, 1636428459597, 269, 1, 268, 1, 0, 1
1495, 1, 1636428459344, 1636428459617, 273, 0, 273, 0, 0, 0
1496, 1, 1636428459533, 1636428459892, 359, 84, 275, 84, 0, 84
1417, 2, 1636428450108, 1636428460109, 10001, 0, 10001, 0, 0, 0
1497, 1, 1636428459841, 1636428460156, 315, 0, 315, 0, 0, 0
1498, 1, 1636428459921, 1636428460196, 275, 0, 275, 0, 0, 0
1499, 1, 1636428459977, 1636428460248, 271, 0, 271, 0, 0, 0
1500, 1, 1636428459985, 1636428460256, 271, 0, 271, 0, 0, 0
1424, 1, 1636428450724, 1636428460376, 9652, 9385, 267, 0, 9385, 9385
1501, 1, 1636428460288, 1636428460557, 269, 0, 269, 0, 0, 0
1503, 1, 1636428460376, 1636428460649, 273, 1, 272, 0, 1, 1
1504, 1, 1636428460456, 1636428460732, 276, 1, 275, 0, 0, 0
1502, 1, 1636428460324, 1636428460833, 509, 233, 276, 233, 0, 233
1506, 1, 1636428460705, 1636428460977, 272, 0, 272, 0, 0, 0
1505, 1, 1636428460568, 1636428461004, 436, 165, 271, 164, 0, 164
1507, 1, 1636428460768, 1636428461040, 272, 1, 271, 1, 0, 1
1508, 1, 1636428460768, 1636428461044, 276, 1, 275, 0, 0, 0
1510, 1, 1636428460888, 1636428461161, 273, 1, 272, 0, 0, 0
1511, 1, 1636428460977, 1636428461253, 276, 0, 276, 0, 0, 0
1509, 1, 1636428460828, 1636428461276, 448, 177, 271, 176, 0, 176
1512, 1, 1636428461157, 1636428461429, 272, 0, 272, 0, 0, 0
1514, 1, 1636428461264, 1636428461533, 269, 1, 268, 0, 0, 0
1513, 1, 1636428461253, 1636428461533, 280, 0, 280, 0, 0, 0
1515, 1, 1636428461476, 1636428461749, 273, 1, 272, 0, 0, 0
1516, 1, 1636428461617, 1636428462029, 412, 132, 280, 132, 0, 132
1518, 1, 1636428461913, 1636428462185, 272, 0, 272, 0, 0, 0
1519, 1, 1636428461953, 1636428462224, 271, 0, 271, 0, 0, 0
1520, 1, 1636428462080, 1636428462352, 272, 1, 271, 0, 1, 1
1521, 1, 1636428462376, 1636428462653, 277, 1, 276, 0, 0, 0
1523, 1, 1636428462392, 1636428462668, 276, 1, 275, 0, 0, 0
1525, 1, 1636428462593, 1636428462865, 272, 0, 272, 0, 0, 0
1526, 1, 1636428462645, 1636428462916, 271, 0, 271, 0, 0, 0
1522, 1, 1636428462388, 1636428462928, 540, 265, 275, 265, 0, 265
1527, 1, 1636428462692, 1636428462965, 273, 1, 272, 0, 0, 0
1528, 1, 1636428462804, 1636428463077, 273, 0, 273, 0, 0, 0
1529, 1, 1636428462852, 1636428463125, 273, 1, 272, 1, 0, 1
1530, 1, 1636428462880, 1636428463157, 277, 1, 276, 0, 0, 0
1531, 1, 1636428462905, 1636428463241, 336, 61, 275, 60, 0, 60
1532, 1, 1636428463088, 1636428463357, 269, 1, 268, 0, 0, 0
1533, 1, 1636428463369, 1636428463645, 276, 0, 276, 0, 0, 0
1534, 1, 1636428463393, 1636428463660, 267, 0, 267, 0, 0, 0
1535, 1, 1636428463501, 1636428463769, 268, 0, 268, 0, 0, 0
1536, 1, 1636428463616, 1636428464044, 428, 153, 275, 152, 0, 152
1537, 1, 1636428463881, 1636428464153, 272, 0, 272, 0, 0, 0
1539, 1, 1636428464020, 1636428464292, 272, 0, 272, 0, 0, 0
1538, 1, 1636428464020, 1636428464296, 276, 1, 275, 1, 0, 1
1540, 1, 1636428464277, 1636428464552, 275, 0, 275, 0, 0, 0
1542, 1, 1636428464517, 1636428464788, 271, 0, 271, 0, 0, 0
1543, 1, 1636428464537, 1636428464809, 272, 0, 272, 0, 0, 0
1541, 1, 1636428464377, 1636428464828, 451, 176, 275, 176, 0, 176
1544, 1, 1636428464672, 1636428464944, 272, 1, 271, 0, 0, 0
1545, 1, 1636428464796, 1636428465069, 273, 1, 272, 0, 1, 1
1546, 1, 1636428464824, 1636428465093, 269, 1, 268, 0, 0, 0
1547, 1, 1636428464876, 1636428465140, 264, 1, 263, 0, 1, 1
1548, 1, 1636428464928, 1636428465201, 273, 1, 272, 1, 0, 1
1549, 1, 1636428464960, 1636428465373, 413, 133, 280, 133, 0, 133
1550, 1, 1636428465136, 1636428465409, 273, 0, 273, 0, 0, 0
1551, 1, 1636428465309, 1636428465581, 272, 0, 272, 0, 0, 0
1552, 1, 1636428465340, 1636428465613, 273, 1, 272, 1, 0, 1
1553, 1, 1636428465493, 1636428465765, 272, 0, 272, 0, 0, 0
1555, 1, 1636428465924, 1636428466197, 273, 1, 272, 0, 0, 0
1556, 1, 1636428465957, 1636428466229, 272, 0, 272, 0, 0, 0
1557, 1, 1636428465993, 1636428466265, 272, 0, 272, 0, 0, 0
1558, 1, 1636428466201, 1636428466473, 272, 0, 272, 0, 0, 0
1560, 1, 1636428466416, 1636428466689, 273, 1, 272, 0, 0, 0
1561, 1, 1636428466421, 1636428466693, 272, 0, 272, 0, 0, 0
1559, 1, 1636428466345, 1636428466749, 404, 128, 276, 128, 0, 128
1562, 1, 1636428466761, 1636428467033, 272, 0, 272, 0, 0, 0
1563, 1, 1636428466773, 1636428467048, 275, 0, 275, 0, 0, 0
1564, 1, 1636428466824, 1636428467092, 268, 1, 267, 0, 0, 0
1567, 1, 1636428466916, 1636428467189, 273, 1, 272, 0, 0, 0
1565, 1, 1636428466845, 1636428467313, 468, 189, 279, 188, 0, 188
1568, 1, 1636428467209, 1636428467477, 268, 0, 268, 0, 0, 0
1569, 1, 1636428467216, 1636428467489, 273, 1, 272, 0, 0, 0
1570, 1, 1636428467389, 1636428467665, 276, 0, 276, 0, 0, 0
1571, 1, 1636428467624, 1636428467893, 269, 1, 268, 0, 0, 0
1572, 1, 1636428467913, 1636428468184, 271, 0, 271, 0, 0, 0
1573, 1, 1636428467925, 1636428468197, 272, 0, 272, 0, 0, 0
1574, 1, 1636428467952, 1636428468225, 273, 1, 272, 0, 0, 0
1575, 1, 1636428468096, 1636428468364, 268, 1, 267, 0, 0, 0
1577, 1, 1636428468324, 1636428468596, 272, 1, 271, 1, 0, 1
1576, 1, 1636428468309, 1636428468637, 328, 56, 272, 56, 0, 56
1578, 1, 1636428468464, 1636428468732, 268, 1, 267, 1, 0, 1
1579, 1, 1636428468752, 1636428469029, 277, 1, 276, 0, 0, 0
1580, 1, 1636428468833, 1636428469108, 275, 0, 275, 0, 0, 0
1583, 1, 1636428469001, 1636428469272, 271, 0, 271, 0, 0, 0
1581, 1, 1636428468845, 1636428469300, 455, 185, 270, 184, 1, 185
1584, 1, 1636428469085, 1636428469352, 267, 0, 267, 0, 0, 0
1585, 1, 1636428469096, 1636428469364, 268, 1, 267, 0, 0, 0
1586, 1, 1636428469496, 1636428469768, 272, 0, 272, 0, 0, 0
1587, 1, 1636428469561, 1636428469837, 276, 0, 276, 0, 0, 0
1588, 1, 1636428469829, 1636428470101, 272, 0, 272, 0, 0, 0
1589, 1, 1636428469940, 1636428470217, 277, 1, 276, 0, 0, 0
1590, 1, 1636428469992, 1636428470268, 276, 1, 275, 0, 0, 0
1591, 1, 1636428470009, 1636428470281, 272, 0, 272, 0, 0, 0
1593, 1, 1636428470245, 1636428470517, 272, 0, 272, 0, 0, 0
1592, 1, 1636428470217, 1636428470541, 324, 52, 272, 52, 0, 52
1594, 1, 1636428470504, 1636428470777, 273, 1, 272, 0, 0, 0
1595, 1, 1636428470637, 1636428470908, 271, 0, 271, 0, 0, 0
1597, 1, 1636428470873, 1636428471148, 275, 0, 275, 0, 0, 0
1598, 1, 1636428470897, 1636428471169, 272, 0, 272, 0, 0, 0
1596, 1, 1636428470757, 1636428471180, 423, 152, 271, 152, 0, 152
1600, 1, 1636428471136, 1636428471409, 273, 1, 272, 0, 0, 0
1599, 1, 1636428471061, 1636428471445, 384, 108, 276, 108, 0, 108
1601, 1, 1636428471492, 1636428471764, 272, 1, 271, 0, 1, 1
1602, 1, 1636428471552, 1636428471829, 277, 1, 276, 0, 1, 1
1517, 2, 1636428461905, 1636428471905, 10000, 0, 10000, 0, 0, 0
1603, 1, 1636428471712, 1636428471985, 273, 0, 273, 0, 0, 0
1604, 1, 1636428471905, 1636428472181, 276, 0, 276, 0, 0, 0
1605, 1, 1636428471977, 1636428472249, 272, 0, 272, 0, 0, 0
1606, 1, 1636428472040, 1636428472313, 273, 1, 272, 0, 0, 0
1524, 2, 1636428462456, 1636428472457, 10001, 0, 10001, 0, 0, 0
1607, 1, 1636428472188, 1636428472505, 317, 1, 316, 0, 1, 1
1608, 1, 1636428472252, 1636428472529, 277, 1, 276, 0, 1, 1
1610, 1, 1636428472505, 1636428472781, 276, 0, 276, 0, 0, 0
1609, 1, 1636428472320, 1636428472804, 484, 209, 275, 209, 0, 209
1611, 1, 1636428472673, 1636428472949, 276, 0, 276, 0, 0, 0
1612, 1, 1636428472804, 1636428473077, 273, 1, 272, 1, 0, 1
1614, 1, 1636428472804, 1636428473077, 273, 1, 272, 1, 0, 1
1615, 1, 1636428472820, 1636428473084, 264, 0, 264, 0, 0, 0
1613, 1, 1636428472780, 1636428473216, 436, 169, 267, 168, 0, 168
1616, 1, 1636428473077, 1636428473345, 268, 0, 268, 0, 0, 0
1617, 1, 1636428473112, 1636428473385, 273, 1, 272, 0, 0, 0
1618, 1, 1636428473385, 1636428473653, 268, 0, 268, 0, 0, 0
1619, 1, 1636428473436, 1636428473700, 264, 1, 263, 0, 0, 0
1620, 1, 1636428473748, 1636428474020, 272, 0, 272, 0, 0, 0
1621, 1, 1636428473809, 1636428474080, 271, 0, 271, 0, 0, 0
1622, 1, 1636428473880, 1636428474153, 273, 1, 272, 0, 1, 1
1623, 1, 1636428473977, 1636428474244, 267, 0, 267, 0, 0, 0
1624, 1, 1636428474077, 1636428474349, 272, 4, 268, 4, 0, 4
1625, 1, 1636428474101, 1636428474377, 276, 0, 276, 0, 0, 0
1626, 1, 1636428474269, 1636428474652, 383, 108, 275, 108, 0, 108
1627, 1, 1636428474413, 1636428474685, 272, 0, 272, 0, 0, 0
1628, 1, 1636428474616, 1636428474888, 272, 1, 271, 0, 1, 1
1629, 1, 1636428474649, 1636428474917, 268, 4, 264, 4, 0, 4
1630, 1, 1636428474696, 1636428474965, 269, 1, 268, 0, 0, 0
1631, 1, 1636428474745, 1636428475017, 272, 0, 272, 0, 0, 0
1632, 1, 1636428474745, 1636428475161, 416, 144, 272, 144, 0, 144
1633, 1, 1636428475024, 1636428475297, 273, 1, 272, 0, 1, 1
1634, 1, 1636428475148, 1636428475417, 269, 1, 268, 0, 1, 1
1635, 1, 1636428475385, 1636428475657, 272, 0, 272, 0, 0, 0
1636, 1, 1636428475468, 1636428475741, 273, 1, 272, 0, 0, 0
1554, 2, 1636428465525, 1636428475857, 10332, 240, 10092, 240, 0, 240
1637, 1, 1636428475720, 1636428476045, 325, 1, 324, 1, 0, 1
1566, 1, 1636428466861, 1636428476137, 9276, 8996, 280, 8996, 0, 8996
1639, 1, 1636428475949, 1636428476221, 272, 1, 271, 0, 1, 1
1640, 1, 1636428475949, 1636428476228, 279, 1, 278, 0, 0, 0
1638, 1, 1636428475949, 1636428476237, 288, 1, 287, 0, 1, 1
1641, 1, 1636428476073, 1636428476341, 268, 0, 268, 0, 0, 0
1643, 1, 1636428476204, 1636428476481, 277, 0, 277, 0, 0, 0
1642, 1, 1636428476148, 1636428476505, 357, 89, 268, 89, 0, 89
1644, 1, 1636428476249, 1636428476612, 363, 92, 271, 92, 0, 92
1645, 1, 1636428476464, 1636428476736, 272, 1, 271, 0, 0, 0
1647, 1, 1636428476568, 1636428476840, 272, 1, 271, 0, 0, 0
1646, 1, 1636428476584, 1636428476861, 277, 1, 276, 0, 0, 0
1648, 1, 1636428476596, 1636428476881, 285, 17, 268, 17, 0, 17
1650, 1, 1636428476640, 1636428476913, 273, 1, 272, 1, 0, 1
1651, 1, 1636428476820, 1636428477093, 273, 1, 272, 1, 0, 1
1649, 1, 1636428476632, 1636428477113, 481, 209, 272, 209, 0, 209
1652, 1, 1636428477124, 1636428477397, 273, 1, 272, 1, 0, 1
1653, 1, 1636428477152, 1636428477424, 272, 1, 271, 0, 0, 0
1654, 1, 1636428477436, 1636428477712, 276, 1, 275, 0, 0, 0
1655, 1, 1636428477444, 1636428477720, 276, 1, 275, 1, 0, 1
1656, 1, 1636428477696, 1636428477969, 273, 1, 272, 1, 0, 1
1657, 1, 1636428477817, 1636428478093, 276, 0, 276, 0, 0, 0
1658, 1, 1636428477933, 1636428478201, 268, 0, 268, 0, 0, 0
1659, 1, 1636428478005, 1636428478269, 264, 0, 264, 0, 0, 0
1660, 1, 1636428478017, 1636428478293, 276, 0, 276, 0, 0, 0
1661, 1, 1636428478076, 1636428478373, 297, 17, 280, 16, 0, 16
1663, 1, 1636428478240, 1636428478512, 272, 1, 271, 0, 0, 0
1662, 1, 1636428478208, 1636428478536, 328, 62, 266, 60, 0, 60
1665, 1, 1636428478556, 1636428478821, 265, 1, 264, 1, 0, 1
1664, 1, 1636428478548, 1636428478821, 273, 1, 272, 0, 0, 0
1666, 1, 1636428478580, 1636428478849, 269, 1, 268, 1, 0, 1
1582, 2, 1636428468852, 1636428478860, 10008, 0, 10008, 0, 0, 0
1668, 1, 1636428478624, 1636428478908, 284, 0, 284, 0, 0, 0
1667, 1, 1636428478620, 1636428478908, 288, 1, 287, 0, 0, 0
1669, 1, 1636428478708, 1636428479185, 477, 201, 276, 201, 0, 201
1670, 1, 1636428478904, 1636428479185, 281, 1, 280, 0, 0, 0
1671, 1, 1636428479072, 1636428479344, 272, 1, 271, 0, 0, 0
1672, 1, 1636428479120, 1636428479388, 268, 1, 267, 0, 0, 0
1673, 1, 1636428479196, 1636428479468, 272, 1, 271, 1, 0, 1
1674, 1, 1636428479344, 1636428479621, 277, 0, 277, 0, 0, 0
1675, 1, 1636428479528, 1636428479800, 272, 0, 272, 0, 0, 0
1676, 1, 1636428479753, 1636428480024, 271, 0, 271, 0, 0, 0
1677, 1, 1636428479764, 1636428480036, 272, 0, 272, 0, 0, 0
1678, 1, 1636428479945, 1636428480212, 267, 0, 267, 0, 0, 0
1680, 1, 1636428479968, 1636428480244, 276, 0, 276, 0, 0, 0
1679, 1, 1636428479960, 1636428480305, 345, 77, 268, 77, 0, 77
1681, 1, 1636428480048, 1636428480329, 281, 0, 281, 0, 0, 0
1683, 1, 1636428480208, 1636428480493, 285, 1, 284, 0, 0, 0
1682, 1, 1636428480208, 1636428480604, 396, 121, 275, 120, 0, 120
1684, 1, 1636428480509, 1636428480781, 272, 0, 272, 0, 0, 0
1685, 1, 1636428480564, 1636428480837, 273, 1, 272, 0, 1, 1
1686, 1, 1636428480597, 1636428480872, 275, 0, 275, 0, 0, 0
1687, 1, 1636428480597, 1636428480872, 275, 8, 267, 8, 0, 8
1688, 1, 1636428480640, 1636428480913, 273, 1, 272, 0, 1, 1
1689, 1, 1636428480688, 1636428481100, 412, 149, 263, 148, 0, 148
1690, 1, 1636428480997, 1636428481269, 272, 0, 272, 0, 0, 0
1691, 1, 1636428481048, 1636428481320, 272, 0, 272, 0, 0, 0
1692, 1, 1636428481092, 1636428481360, 268, 0, 268, 0, 0, 0
1693, 1, 1636428481108, 1636428481385, 277, 1, 276, 0, 0, 0
1694, 1, 1636428481404, 1636428481676, 272, 1, 271, 0, 0, 0
1695, 1, 1636428481473, 1636428481749, 276, 0, 276, 0, 0, 0
1696, 1, 1636428481676, 1636428481944, 268, 0, 268, 0, 0, 0
1697, 1, 1636428481761, 1636428482037, 276, 0, 276, 0, 0, 0
1699, 1, 1636428481981, 1636428482252, 271, 0, 271, 0, 0, 0
1700, 1, 1636428482001, 1636428482273, 272, 0, 272, 0, 0, 0
1698, 1, 1636428481952, 1636428482309, 357, 85, 272, 85, 0, 85
1701, 1, 1636428482088, 1636428482357, 269, 1, 268, 0, 0, 0
1703, 1, 1636428482296, 1636428482557, 261, 1, 260, 0, 0, 0
1702, 1, 1636428482296, 1636428482632, 336, 62, 274, 61, 0, 61
1704, 1, 1636428482580, 1636428482856, 276, 1, 275, 0, 0, 0
1705, 1, 1636428482612, 1636428482885, 273, 1, 272, 0, 0, 0
1706, 1, 1636428482624, 1636428482897, 273, 1, 272, 0, 1, 1
1707, 1, 1636428482640, 1636428482905, 265, 0, 265, 0, 0, 0
1708, 1, 1636428482676, 1636428482952, 276, 1, 275, 0, 0, 0
1709, 1, 1636428482733, 1636428483161, 428, 152, 276, 152, 0, 152
1710, 1, 1636428482936, 1636428483205, 269, 1, 268, 1, 0, 1
1711, 1, 1636428482993, 1636428483268, 275, 0, 275, 0, 0, 0
1712, 1, 1636428483140, 1636428483416, 276, 1, 275, 0, 0, 0
1713, 1, 1636428483221, 1636428483496, 275, 0, 275, 0, 0, 0
1714, 1, 1636428483325, 1636428483597, 272, 0, 272, 0, 0, 0
1715, 1, 1636428483532, 1636428483809, 277, 1, 276, 0, 0, 0
1716, 1, 1636428483713, 1636428483988, 275, 0, 275, 0, 0, 0
1717, 1, 1636428483789, 1636428484061, 272, 0, 272, 0, 0, 0
1718, 1, 1636428483981, 1636428484257, 276, 0, 276, 0, 0, 0
1719, 1, 1636428483988, 1636428484337, 349, 73, 276, 73, 0, 73
1720, 1, 1636428484092, 1636428484364, 272, 1, 271, 0, 0, 0
1721, 1, 1636428484124, 1636428484397, 273, 1, 272, 0, 1, 1
1722, 1, 1636428484360, 1636428484636, 276, 1, 275, 0, 1, 1
1723, 1, 1636428484400, 1636428484677, 277, 1, 276, 0, 1, 1
1724, 1, 1636428484472, 1636428484748, 276, 1, 275, 0, 0, 0
1725, 1, 1636428484649, 1636428484921, 272, 0, 272, 0, 0, 0
1726, 1, 1636428484656, 1636428484929, 273, 1, 272, 0, 0, 0
1727, 1, 1636428484677, 1636428484945, 268, 0, 268, 0, 0, 0
1728, 1, 1636428484744, 1636428485012, 268, 0, 268, 0, 0, 0
1729, 1, 1636428484773, 1636428485208, 435, 156, 279, 156, 0, 156
1730, 1, 1636428484961, 1636428485232, 271, 0, 271, 0, 0, 0
1731, 1, 1636428484984, 1636428485253, 269, 1, 268, 0, 0, 0
1732, 1, 1636428485120, 1636428485393, 273, 1, 272, 0, 1, 1
1733, 1, 1636428485208, 1636428485473, 265, 1, 264, 0, 1, 1
1734, 1, 1636428485361, 1636428485633, 272, 0, 272, 0, 0, 0
1735, 1, 1636428485532, 1636428485804, 272, 1, 271, 0, 0, 0
1736, 1, 1636428485745, 1636428486024, 279, 0, 279, 0, 0, 0
1737, 1, 1636428485824, 1636428486097, 273, 1, 272, 0, 0, 0
1738, 1, 1636428485997, 1636428486269, 272, 0, 272, 0, 0, 0
1740, 1, 1636428486068, 1636428486341, 273, 1, 272, 0, 1, 1
1741, 1, 1636428486088, 1636428486361, 273, 1, 272, 0, 0, 0
1739, 1, 1636428486044, 1636428486377, 333, 54, 279, 52, 0, 52
1743, 1, 1636428486352, 1636428486624, 272, 1, 271, 0, 1, 1
1742, 1, 1636428486301, 1636428486637, 336, 60, 276, 60, 0, 60
1744, 1, 1636428486388, 1636428486656, 268, 1, 267, 0, 0, 0
1746, 1, 1636428486636, 1636428486913, 277, 1, 276, 0, 0, 0
1745, 1, 1636428486636, 1636428486913, 277, 1, 276, 0, 0, 0
1747, 1, 1636428486672, 1636428486937, 265, 0, 265, 0, 0, 0
1749, 1, 1636428486777, 1636428487048, 271, 0, 271, 0, 0, 0
1748, 1, 1636428486756, 1636428487189, 433, 157, 276, 157, 0, 157
1750, 1, 1636428486989, 1636428487257, 268, 0, 268, 0, 0, 0
1751, 1, 1636428486984, 1636428487257, 273, 1, 272, 0, 0, 0
1752, 1, 1636428487132, 1636428487405, 273, 1, 272, 1, 0, 1
1753, 1, 1636428487333, 1636428487604, 271, 0, 271, 0, 0, 0
1754, 1, 1636428487472, 1636428487745, 273, 1, 272, 0, 0, 0
1755, 1, 1636428487560, 1636428487832, 272, 1, 271, 1, 0, 1
1756, 1, 1636428487628, 1636428487908, 280, 1, 279, 0, 0, 0
1757, 1, 1636428487920, 1636428488193, 273, 0, 273, 0, 0, 0
1759, 1, 1636428488085, 1636428488357, 272, 0, 272, 0, 0, 0
1760, 1, 1636428488108, 1636428488377, 269, 1, 268, 0, 0, 0
1761, 1, 1636428488136, 1636428488412, 276, 1, 275, 1, 0, 1
1758, 1, 1636428488076, 1636428488460, 384, 117, 267, 116, 0, 116
1763, 1, 1636428488345, 1636428488616, 271, 0, 271, 0, 0, 0
1762, 1, 1636428488329, 1636428488684, 355, 84, 271, 84, 0, 84
1764, 1, 1636428488508, 1636428488781, 273, 1, 272, 0, 0, 0
1765, 1, 1636428488652, 1636428488925, 273, 1, 272, 0, 0, 0
1766, 1, 1636428488652, 1636428488948, 296, 33, 263, 32, 0, 32
1767, 1, 1636428488769, 1636428489040, 271, 0, 271, 0, 0, 0
1769, 1, 1636428488905, 1636428489176, 271, 0, 271, 0, 0, 0
1768, 1, 1636428488865, 1636428489204, 339, 60, 279, 60, 0, 60
1771, 1, 1636428489016, 1636428489285, 269, 1, 268, 0, 0, 0
1770, 1, 1636428489016, 1636428489316, 300, 25, 275, 23, 1, 24
1772, 1, 1636428489216, 1636428489489, 273, 1, 272, 0, 0, 0
1773, 1, 1636428489244, 1636428489517, 273, 1, 272, 0, 0, 0
1774, 1, 1636428489453, 1636428489725, 272, 0, 272, 0, 0, 0
1775, 1, 1636428489512, 1636428489788, 276, 1, 275, 0, 0, 0
1776, 1, 1636428489652, 1636428489924, 272, 1, 271, 0, 0, 0
1777, 1, 1636428489817, 1636428490088, 271, 0, 271, 0, 0, 0
1779, 1, 1636428490069, 1636428490340, 271, 0, 271, 0, 0, 0
1778, 1, 1636428490013, 1636428490364, 351, 76, 275, 76, 0, 76
1780, 1, 1636428490152, 1636428490424, 272, 0, 272, 0, 0, 0
1781, 1, 1636428490164, 1636428490432, 268, 0, 268, 0, 0, 0
1782, 1, 1636428490372, 1636428490644, 272, 1, 271, 0, 1, 1
1784, 1, 1636428490400, 1636428490672, 272, 0, 272, 0, 0, 0
1783, 1, 1636428490388, 1636428490704, 316, 45, 271, 45, 0, 45
1785, 1, 1636428490716, 1636428490988, 272, 0, 272, 0, 0, 0
1786, 1, 1636428490736, 1636428491009, 273, 0, 273, 0, 0, 0
1787, 1, 1636428490748, 1636428491020, 272, 0, 272, 0, 0, 0
1788, 1, 1636428490841, 1636428491116, 275, 0, 275, 0, 0, 0
1789, 1, 1636428490888, 1636428491285, 397, 121, 276, 121, 0, 121
1790, 1, 1636428490892, 1636428491297, 405, 129, 276, 128, 0, 128
1792, 1, 1636428491097, 1636428491373, 276, 0, 276, 0, 0, 0
1791, 1, 1636428491097, 1636428491373, 276, 0, 276, 0, 0, 0
1793, 1, 1636428491208, 1636428491485, 277, 0, 277, 0, 0, 0
1794, 1, 1636428491461, 1636428491733, 272, 0, 272, 0, 0, 0
1795, 1, 1636428491600, 1636428491872, 272, 1, 271, 0, 0, 0
1796, 1, 1636428491712, 1636428491985, 273, 1, 272, 0, 0, 0
1797, 1, 1636428491840, 1636428492113, 273, 1, 272, 0, 0, 0
1799, 1, 1636428492113, 1636428492384, 271, 1, 270, 0, 1, 1
1798, 1, 1636428492072, 1636428492388, 316, 42, 274, 42, 0, 42
1800, 1, 1636428492113, 1636428492388, 275, 0, 275, 0, 0, 0
1801, 1, 1636428492285, 1636428492548, 263, 0, 263, 0, 0, 0
1803, 1, 1636428492416, 1636428492685, 269, 1, 268, 0, 1, 1
1802, 1, 1636428492420, 1636428492693, 273, 1, 272, 1, 0, 1
1804, 1, 1636428492420, 1636428492828, 408, 129, 279, 129, 0, 129
1805, 1, 1636428492724, 1636428493001, 277, 1, 276, 0, 0, 0
1806, 1, 1636428492816, 1636428493093, 277, 13, 264, 13, 0, 13
1807, 1, 1636428492837, 1636428493112, 275, 0, 275, 0, 0, 0
1809, 1, 1636428492976, 1636428493248, 272, 1, 271, 0, 1, 1
1811, 1, 1636428492992, 1636428493265, 273, 1, 272, 0, 0, 0
1808, 1, 1636428492868, 1636428493277, 409, 134, 275, 133, 0, 133
1812, 1, 1636428493104, 1636428493376, 272, 1, 271, 1, 0, 1
1810, 1, 1636428492985, 1636428493384, 399, 128, 271, 128, 0, 128
1813, 1, 1636428493216, 1636428493489, 273, 1, 272, 1, 0, 1
1814, 1, 1636428493568, 1636428493845, 277, 1, 276, 0, 0, 0
1815, 1, 1636428493681, 1636428493953, 272, 0, 272, 0, 0, 0
1816, 1, 1636428493684, 1636428493957, 273, 1, 272, 0, 0, 0
1817, 1, 1636428493920, 1636428494193, 273, 1, 272, 0, 1, 1
1818, 1, 1636428494036, 1636428494305, 269, 1, 268, 1, 0, 1
1819, 1, 1636428494124, 1636428494397, 273, 1, 272, 0, 0, 0
1820, 1, 1636428494149, 1636428494469, 320, 45, 275, 44, 0, 44
1821, 1, 1636428494200, 1636428494472, 272, 1, 271, 0, 0, 0
1823, 1, 1636428494457, 1636428494729, 272, 0, 272, 0, 0, 0
1824, 1, 1636428494469, 1636428494741, 272, 0, 272, 0, 0, 0
1822, 1, 1636428494361, 1636428494748, 387, 112, 275, 112, 0, 112
1826, 1, 1636428494732, 1636428495005, 273, 1, 272, 0, 1, 1
1825, 1, 1636428494692, 1636428495024, 332, 57, 275, 57, 0, 57
1827, 1, 1636428494921, 1636428495189, 268, 0, 268, 0, 0, 0
1828, 1, 1636428494953, 1636428495277, 324, 52, 272, 52, 0, 52
1829, 1, 1636428495013, 1636428495280, 267, 0, 267, 0, 0, 0
1830, 1, 1636428495036, 1636428495305, 269, 1, 268, 0, 0, 0
1832, 1, 1636428495137, 1636428495405, 268, 0, 268, 0, 0, 0
1831, 1, 1636428495097, 1636428495461, 364, 92, 272, 92, 0, 92
1833, 1, 1636428495224, 1636428495496, 272, 1, 271, 0, 0, 0
1834, 1, 1636428495536, 1636428495804, 268, 1, 267, 0, 0, 0
1835, 1, 1636428495708, 1636428495981, 273, 1, 272, 0, 0, 0
1836, 1, 1636428495729, 1636428496005, 276, 0, 276, 0, 0, 0
1837, 1, 1636428495996, 1636428496269, 273, 1, 272, 0, 0, 0
1838, 1, 1636428496044, 1636428496316, 272, 1, 271, 0, 0, 0
1839, 1, 1636428496100, 1636428496373, 273, 1, 272, 0, 0, 0
1840, 1, 1636428496233, 1636428496545, 312, 36, 276, 36, 0, 36
1841, 1, 1636428496284, 1636428496557, 273, 1, 272, 0, 0, 0
1842, 1, 1636428496424, 1636428496693, 269, 0, 269, 0, 0, 0
1844, 1, 1636428496532, 1636428496796, 264, 1, 263, 0, 0, 0
1843, 1, 1636428496468, 1636428496837, 369, 89, 280, 89, 0, 89
1845, 1, 1636428496653, 1636428496929, 276, 0, 276, 0, 0, 0
1846, 1, 1636428496765, 1636428497108, 343, 73, 270, 72, 1, 73
1847, 1, 1636428496865, 1636428497196, 331, 64, 267, 64, 0, 64
1848, 1, 1636428496948, 1636428497224, 276, 1, 275, 0, 0, 0
1849, 1, 1636428497064, 1636428497337, 273, 0, 273, 0, 0, 0
1851, 1, 1636428497124, 1636428497397, 273, 1, 272, 0, 0, 0
1850, 1, 1636428497108, 1636428497493, 385, 117, 268, 117, 0, 117
1852, 1, 1636428497240, 1636428497509, 269, 1, 268, 0, 1, 1
1853, 1, 1636428497296, 1636428497569, 273, 1, 272, 0, 0, 0
1854, 1, 1636428497581, 1636428497849, 268, 0, 268, 0, 0, 0
1855, 1, 1636428497700, 1636428497976, 276, 1, 275, 0, 0, 0
1856, 1, 1636428497716, 1636428497993, 277, 1, 276, 1, 0, 1
1857, 1, 1636428497864, 1636428498137, 273, 1, 272, 0, 1, 1
1858, 1, 1636428498113, 1636428498384, 271, 0, 271, 0, 0, 0
1859, 1, 1636428498116, 1636428498389, 273, 1, 272, 0, 1, 1
1860, 1, 1636428498137, 1636428498409, 272, 1, 271, 0, 1, 1
1861, 1, 1636428498348, 1636428498612, 264, 0, 264, 0, 0, 0
1862, 1, 1636428498473, 1636428498753, 280, 0, 280, 0, 0, 0
1863, 1, 1636428498473, 1636428498753, 280, 1, 279, 0, 0, 0
1864, 1, 1636428498536, 1636428498889, 353, 77, 276, 77, 0, 77
1865, 1, 1636428498720, 1636428498993, 273, 0, 273, 0, 0, 0
1866, 1, 1636428498804, 1636428499165, 361, 85, 276, 85, 0, 85
1867, 1, 1636428498948, 1636428499269, 321, 45, 276, 45, 0, 45
1868, 1, 1636428499004, 1636428499280, 276, 1, 275, 0, 0, 0
1869, 1, 1636428499052, 1636428499324, 272, 1, 271, 0, 0, 0
1871, 1, 1636428499181, 1636428499452, 271, 0, 271, 0, 0, 0
1872, 1, 1636428499248, 1636428499520, 272, 0, 272, 0, 0, 0
1870, 1, 1636428499117, 1636428499556, 439, 164, 275, 164, 0, 164
1873, 1, 1636428499324, 1636428499596, 272, 1, 271, 1, 0, 1
1874, 1, 1636428499496, 1636428499769, 273, 0, 273, 0, 0, 0
1875, 1, 1636428499652, 1636428499925, 273, 0, 273, 0, 0, 0
1876, 1, 1636428499769, 1636428500045, 276, 0, 276, 0, 0, 0
1877, 1, 1636428499957, 1636428500229, 272, 0, 272, 0, 0, 0
1878, 1, 1636428499993, 1636428500264, 271, 0, 271, 0, 0, 0
1879, 1, 1636428500137, 1636428500408, 271, 0, 271, 0, 0, 0
1880, 1, 1636428500216, 1636428500500, 284, 13, 271, 13, 0, 13
1881, 1, 1636428500229, 1636428500500, 271, 0, 271, 0, 0, 0
1882, 1, 1636428500448, 1636428500716, 268, 0, 268, 0, 0, 0
1883, 1, 1636428500528, 1636428500804, 276, 0, 276, 0, 0, 0
1884, 1, 1636428500544, 1636428500812, 268, 0, 268, 0, 0, 0
1885, 1, 1636428500736, 1636428501008, 272, 1, 271, 0, 1, 1
1886, 1, 1636428500800, 1636428501076, 276, 5, 271, 5, 0, 5
1887, 1, 1636428500933, 1636428501204, 271, 0, 271, 0, 0, 0
1888, 1, 1636428500944, 1636428501220, 276, 1, 275, 0, 1, 1
1889, 1, 1636428501049, 1636428501321, 272, 0, 272, 0, 0, 0
1891, 1, 1636428501100, 1636428501368, 268, 0, 268, 0, 0, 0
1892, 1, 1636428501176, 1636428501449, 273, 0, 273, 0, 0, 0
1893, 1, 1636428501204, 1636428501477, 273, 0, 273, 0, 0, 0
1890, 1, 1636428501049, 1636428501500, 451, 172, 279, 172, 0, 172
1894, 1, 1636428501565, 1636428501836, 271, 0, 271, 0, 0, 0
1896, 1, 1636428501788, 1636428502065, 277, 1, 276, 0, 0, 0
1895, 1, 1636428501788, 1636428502065, 277, 1, 276, 1, 0, 1
1897, 1, 1636428502020, 1636428502285, 265, 0, 265, 0, 0, 0
1898, 1, 1636428502068, 1636428502341, 273, 0, 273, 0, 0, 0
1899, 1, 1636428502104, 1636428502377, 273, 1, 272, 1, 0, 1
1901, 1, 1636428502344, 1636428502613, 269, 0, 269, 0, 0, 0
1900, 1, 1636428502332, 1636428502620, 288, 9, 279, 9, 0, 9
1902, 1, 1636428502353, 1636428502620, 267, 0, 267, 0, 0, 0
1903, 1, 1636428502630, 1636428502905, 275, 0, 275, 0, 0, 0
1904, 1, 1636428502664, 1636428502936, 272, 1, 271, 0, 1, 1
1905, 1, 1636428502673, 1636428502940, 267, 0, 267, 0, 0, 0
1906, 1, 1636428502829, 1636428503108, 279, 0, 279, 0, 0, 0
1908, 1, 1636428502932, 1636428503205, 273, 1, 272, 0, 0, 0
1909, 1, 1636428503064, 1636428503340, 276, 1, 275, 1, 0, 1
1911, 1, 1636428503124, 1636428503397, 273, 1, 272, 0, 0, 0
1912, 1, 1636428503225, 1636428503493, 268, 0, 268, 0, 0, 0
1913, 1, 1636428503317, 1636428503585, 268, 0, 268, 0, 0, 0
1910, 1, 1636428503080, 1636428503613, 533, 261, 272, 261, 0, 261
1914, 1, 1636428503588, 1636428503857, 269, 1, 268, 0, 0, 0
1915, 1, 1636428503677, 1636428503949, 272, 0, 272, 0, 0, 0
1916, 1, 1636428503832, 1636428504105, 273, 1, 272, 0, 0, 0
1917, 1, 1636428504045, 1636428504317, 272, 0, 272, 0, 0, 0
1918, 1, 1636428504129, 1636428504404, 275, 0, 275, 0, 0, 0
1921, 1, 1636428504260, 1636428504533, 273, 1, 272, 0, 0, 0
1920, 1, 1636428504241, 1636428504589, 348, 76, 272, 76, 0, 76
1922, 1, 1636428504388, 1636428504669, 281, 1, 280, 0, 0, 0
1923, 1, 1636428504541, 1636428504813, 272, 0, 272, 0, 0, 0
1924, 1, 1636428504684, 1636428504953, 269, 1, 268, 0, 0, 0
1925, 1, 1636428504692, 1636428504964, 272, 0, 272, 0, 0, 0
1926, 1, 1636428504724, 1636428505000, 276, 0, 276, 0, 0, 0
1927, 1, 1636428505045, 1636428505309, 264, 0, 264, 0, 0, 0
1928, 1, 1636428505116, 1636428505388, 272, 1, 271, 0, 1, 1
1930, 1, 1636428505233, 1636428505505, 272, 0, 272, 0, 0, 0
1931, 1, 1636428505344, 1636428505613, 269, 1, 268, 0, 0, 0
1929, 1, 1636428505172, 1636428505656, 484, 217, 267, 216, 0, 216
1933, 1, 1636428505469, 1636428505741, 272, 0, 272, 0, 0, 0
1934, 1, 1636428505733, 1636428506005, 272, 0, 272, 0, 0, 0
1935, 1, 1636428505901, 1636428506173, 272, 0, 272, 0, 0, 0
1939, 1, 1636428506288, 1636428506561, 273, 1, 272, 0, 0, 0
1940, 1, 1636428506316, 1636428506589, 273, 1, 272, 0, 0, 0
1941, 1, 1636428506621, 1636428506889, 268, 0, 268, 0, 0, 0
1942, 1, 1636428506676, 1636428506945, 269, 1, 268, 0, 1, 1
1944, 1, 1636428506849, 1636428507120, 271, 0, 271, 0, 0, 0
1945, 1, 1636428507120, 1636428507393, 273, 1, 272, 0, 0, 0
1947, 1, 1636428507184, 1636428507457, 273, 1, 272, 0, 0, 0
1949, 1, 1636428507345, 1636428507617, 272, 0, 272, 0, 0, 0
1948, 1, 1636428507193, 1636428507733, 540, 265, 275, 264, 0, 264
1950, 1, 1636428507525, 1636428507801, 276, 0, 276, 0, 0, 0
1951, 1, 1636428507841, 1636428508113, 272, 0, 272, 0, 0, 0
1953, 1, 1636428508160, 1636428508433, 273, 1, 272, 0, 1, 1
1954, 1, 1636428508421, 1636428508693, 272, 0, 272, 0, 0, 0
1955, 1, 1636428508684, 1636428508957, 273, 1, 272, 0, 0, 0
1956, 1, 1636428508773, 1636428509045, 272, 0, 272, 0, 0, 0
1957, 1, 1636428508785, 1636428509057, 272, 0, 272, 0, 0, 0
1958, 1, 1636428509120, 1636428509393, 273, 1, 272, 0, 0, 0
1961, 1, 1636428509353, 1636428509625, 272, 0, 272, 0, 0, 0
1959, 1, 1636428509145, 1636428509668, 523, 249, 274, 249, 0, 249
1963, 1, 1636428509720, 1636428509993, 273, 1, 272, 0, 0, 0
1964, 1, 1636428510124, 1636428510397, 273, 1, 272, 0, 0, 0
1965, 1, 1636428510361, 1636428510633, 272, 0, 272, 0, 0, 0
1966, 1, 1636428510565, 1636428510833, 268, 0, 268, 0, 0, 0
1967, 1, 1636428510729, 1636428511001, 272, 0, 272, 0, 0, 0
1968, 1, 1636428510736, 1636428511009, 273, 1, 272, 1, 0, 1
1969, 1, 1636428511040, 1636428511309, 269, 0, 269, 0, 0, 0
1970, 1, 1636428511137, 1636428511585, 448, 173, 275, 172, 0, 172
1971, 1, 1636428511393, 1636428511664, 271, 0, 271, 0, 0, 0
1972, 1, 1636428511620, 1636428511892, 272, 1, 271, 0, 1, 1
1973, 1, 1636428512213, 1636428512484, 271, 0, 271, 0, 0, 0
1974, 1, 1636428512265, 1636428512536, 271, 0, 271, 0, 0, 0
1976, 1, 1636428512717, 1636428512988, 271, 0, 271, 0, 0, 0
1907, 2, 1636428502932, 1636428513030, 10098, 5, 10093, 4, 0, 4
1977, 1, 1636428512833, 1636428513120, 287, 0, 287, 0, 0, 0
1978, 1, 1636428512937, 1636428513304, 367, 0, 367, 0, 0, 0
1937, 1, 1636428506173, 1636428513304, 7131, 6857, 274, 6857, 0, 6857
1980, 1, 1636428513380, 1636428513653, 273, 1, 272, 0, 0, 0
1981, 1, 1636428513389, 1636428513661, 272, 0, 272, 0, 0, 0
1982, 1, 1636428513541, 1636428513813, 272, 0, 272, 0, 0, 0
1983, 1, 1636428513765, 1636428514036, 271, 0, 271, 0, 0, 0
1919, 2, 1636428504233, 1636428514237, 10004, 0, 10004, 9073, 0, 9073
1984, 1, 1636428514109, 1636428514385, 276, 0, 276, 0, 0, 0
1985, 1, 1636428514285, 1636428514556, 271, 0, 271, 0, 0, 0
1986, 1, 1636428514600, 1636428514873, 273, 1, 272, 1, 0, 1
1987, 1, 1636428514820, 1636428515093, 273, 1, 272, 0, 0, 0
1988, 1, 1636428514856, 1636428515125, 269, 1, 268, 0, 0, 0
1932, 2, 1636428505449, 1636428515449, 10000, 0, 10000, 7857, 0, 7857
1989, 1, 1636428515320, 1636428515597, 277, 1, 276, 0, 0, 0
1990, 1, 1636428515392, 1636428515681, 289, 1, 288, 1, 0, 1
1991, 1, 1636428515585, 1636428515860, 275, 0, 275, 0, 0, 0
1992, 1, 1636428515773, 1636428516045, 272, 0, 272, 0, 0, 0
1936, 2, 1636428506160, 1636428516161, 10001, 0, 10001, 7146, 0, 7146
1938, 2, 1636428506269, 1636428516269, 10000, 0, 10000, 7036, 0, 7036
1993, 1, 1636428516008, 1636428516317, 309, 1, 308, 0, 0, 0
1994, 1, 1636428516345, 1636428516621, 276, 0, 276, 0, 0, 0
1943, 2, 1636428506809, 1636428516809, 10000, 0, 10000, 6496, 0, 6496
1995, 1, 1636428516645, 1636428516949, 304, 0, 304, 0, 0, 0
1996, 1, 1636428516705, 1636428516973, 268, 0, 268, 0, 0, 0
1997, 1, 1636428516897, 1636428517169, 272, 0, 272, 0, 0, 0
1946, 2, 1636428507168, 1636428517173, 10005, 0, 10005, 6137, 0, 6137
1998, 1, 1636428517377, 1636428517645, 268, 0, 268, 0, 0, 0
1999, 1, 1636428517472, 1636428517737, 265, 1, 264, 0, 0, 0
2000, 1, 1636428517536, 1636428517809, 273, 0, 273, 0, 0, 0
1952, 2, 1636428507860, 1636428517861, 10001, 0, 10001, 5445, 0, 5445
2001, 1, 1636428517773, 1636428518093, 320, 0, 320, 0, 0, 0
2002, 1, 1636428517920, 1636428518197, 277, 1, 276, 0, 1, 1
2003, 1, 1636428518285, 1636428518557, 272, 0, 272, 0, 0, 0
2004, 1, 1636428518576, 1636428518849, 273, 0, 273, 0, 0, 0
2005, 1, 1636428518625, 1636428518896, 271, 0, 271, 0, 0, 0
2006, 1, 1636428518773, 1636428519049, 276, 0, 276, 0, 0, 0
1960, 2, 1636428509249, 1636428519249, 10000, 0, 10000, 4056, 0, 4056
1962, 2, 1636428509557, 1636428519557, 10000, 0, 10000, 3749, 0, 3749
2007, 1, 1636428519449, 1636428519725, 276, 0, 276, 0, 0, 0
2008, 1, 1636428519504, 1636428519789, 285, 1, 284, 0, 0, 0
2009, 1, 1636428519605, 1636428519881, 276, 0, 276, 0, 0, 0
2010, 1, 1636428519853, 1636428520157, 304, 28, 276, 28, 0, 28
2011, 1, 1636428520041, 1636428520313, 272, 0, 272, 0, 0, 0
2012, 1, 1636428520232, 1636428520505, 273, 1, 272, 0, 0, 0
2013, 1, 1636428520573, 1636428520845, 272, 0, 272, 0, 0, 0
2014, 1, 1636428520680, 1636428520953, 273, 1, 272, 0, 0, 0
2015, 1, 1636428520692, 1636428520969, 277, 1, 276, 0, 0, 0
2016, 1, 1636428521465, 1636428521732, 267, 0, 267, 0, 0, 0
2017, 1, 1636428521477, 1636428521749, 272, 0, 272, 0, 0, 0
2018, 1, 1636428521589, 1636428521865, 276, 0, 276, 0, 0, 0
2019, 1, 1636428521749, 1636428522025, 276, 0, 276, 0, 0, 0
2020, 1, 1636428522045, 1636428522316, 271, 0, 271, 0, 0, 0
2021, 1, 1636428522360, 1636428522637, 277, 1, 276, 0, 1, 1
1975, 2, 1636428512645, 1636428522644, 9999, 0, 9999, 661, 0, 661
2022, 1, 1636428522637, 1636428522912, 275, 1, 274, 0, 1, 1
2023, 1, 1636428522696, 1636428522969, 273, 0, 273, 0, 0, 0
2024, 1, 1636428522776, 1636428523049, 273, 1, 272, 0, 0, 0
2025, 1, 1636428522997, 1636428523269, 272, 0, 272, 0, 0, 0
1979, 2, 1636428513164, 1636428523481, 10317, 141, 10176, 141, 0, 141
2026, 1, 1636428523421, 1636428523800, 379, 0, 379, 0, 0, 0
2027, 1, 1636428523616, 1636428523889, 273, 1, 272, 0, 0, 0
2028, 1, 1636428523620, 1636428523889, 269, 1, 268, 0, 1, 1
2030, 1, 1636428523748, 1636428524016, 268, 1, 267, 0, 0, 0
2037, 1, 1636428523752, 1636428524076, 324, 48, 276, 48, 0, 48
2039, 1, 1636428523880, 1636428524153, 273, 1, 272, 0, 1, 1
2038, 1, 1636428523833, 1636428524169, 336, 57, 279, 56, 0, 56
2029, 1, 1636428523748, 1636428524357, 609, 329, 280, 329, 0, 329
2040, 1, 1636428524145, 1636428524417, 272, 0, 272, 0, 0, 0
2041, 1, 1636428524349, 1636428524621, 272, 0, 272, 0, 0, 0
2034, 1, 1636428523752, 1636428524637, 885, 606, 279, 605, 0, 605
2042, 1, 1636428524624, 1636428524897, 273, 0, 273, 0, 0, 0
2043, 1, 1636428524705, 1636428524976, 271, 0, 271, 0, 0, 0
2044, 1, 1636428524797, 1636428525065, 268, 0, 268, 0, 0, 0
2045, 1, 1636428524932, 1636428525205, 273, 1, 272, 0, 1, 1
2046, 1, 1636428525477, 1636428525749, 272, 0, 272, 0, 0, 0
2047, 1, 1636428525497, 1636428525769, 272, 0, 272, 0, 0, 0
2049, 1, 1636428525601, 1636428525869, 268, 0, 268, 0, 0, 0
2052, 1, 1636428525681, 1636428525952, 271, 0, 271, 0, 0, 0
2053, 1, 1636428525820, 1636428526093, 273, 1, 272, 0, 0, 0
2054, 1, 1636428525876, 1636428526149, 273, 1, 272, 0, 0, 0
2055, 1, 1636428526029, 1636428526301, 272, 0, 272, 0, 0, 0
2056, 1, 1636428526381, 1636428526653, 272, 0, 272, 0, 0, 0
2057, 1, 1636428526593, 1636428526865, 272, 0, 272, 0, 0, 0
2058, 1, 1636428526653, 1636428526937, 284, 1, 283, 0, 0, 0
2059, 1, 1636428526688, 1636428526957, 269, 1, 268, 0, 0, 0
2060, 1, 1636428526968, 1636428527241, 273, 1, 272, 0, 0, 0
2061, 1, 1636428527449, 1636428527725, 276, 0, 276, 0, 0, 0
2062, 1, 1636428527489, 1636428527760, 271, 0, 271, 0, 0, 0
2063, 1, 1636428527624, 1636428527901, 277, 1, 276, 0, 0, 0
2064, 1, 1636428527780, 1636428528052, 272, 1, 271, 0, 0, 0
2065, 1, 1636428527901, 1636428528177, 276, 1, 275, 0, 0, 0
2066, 1, 1636428527933, 1636428528205, 272, 0, 272, 0, 0, 0
2068, 1, 1636428528465, 1636428528737, 272, 0, 272, 0, 0, 0
2069, 1, 1636428528493, 1636428528761, 268, 0, 268, 0, 0, 0
2071, 1, 1636428528700, 1636428529037, 337, 62, 275, 61, 0, 61
2072, 1, 1636428528884, 1636428529157, 273, 1, 272, 0, 0, 0
2074, 1, 1636428529565, 1636428529836, 271, 0, 271, 0, 0, 0
2075, 1, 1636428529633, 1636428529905, 272, 0, 272, 0, 0, 0
2076, 1, 1636428529696, 1636428529968, 272, 1, 271, 0, 0, 0
2077, 1, 1636428529829, 1636428530093, 264, 0, 264, 0, 0, 0
2078, 1, 1636428529912, 1636428530181, 269, 1, 268, 0, 1, 1
2079, 1, 1636428530469, 1636428530745, 276, 0, 276, 0, 0, 0
2081, 1, 1636428530681, 1636428531017, 336, 65, 271, 64, 1, 65
2083, 1, 1636428531525, 1636428531793, 268, 0, 268, 0, 0, 0
2084, 1, 1636428531536, 1636428531813, 277, 1, 276, 0, 1, 1
2087, 1, 1636428531805, 1636428532077, 272, 0, 272, 0, 0, 0
2086, 1, 1636428531712, 1636428532089, 377, 101, 276, 101, 0, 101
2088, 1, 1636428532485, 1636428532757, 272, 0, 272, 0, 0, 0
2089, 1, 1636428532704, 1636428533033, 329, 54, 275, 54, 0, 54
2031, 2, 1636428523748, 1636428533749, 10001, 0, 10001, 269, 0, 269
2036, 2, 1636428523756, 1636428533792, 10036, 0, 10036, 261, 0, 261
2033, 2, 1636428523756, 1636428533836, 10080, 0, 10080, 261, 0, 261
2035, 2, 1636428523756, 1636428533880, 10124, 0, 10124, 262, 0, 262
2032, 2, 1636428523752, 1636428533925, 10173, 0, 10173, 265, 0, 265
2090, 1, 1636428533541, 1636428533973, 432, 0, 432, 0, 0, 0
2091, 1, 1636428533617, 1636428534064, 447, 0, 447, 0, 0, 0
2092, 1, 1636428533689, 1636428534157, 468, 0, 468, 0, 0, 0
2093, 1, 1636428533973, 1636428534249, 276, 1, 275, 0, 0, 0
2096, 1, 1636428534365, 1636428534637, 272, 0, 272, 0, 0, 0
2048, 2, 1636428525592, 1636428535593, 10001, 0, 10001, 176, 0, 176
2050, 2, 1636428525625, 1636428535641, 10016, 0, 10016, 144, 0, 144
2051, 2, 1636428525661, 1636428535690, 10029, 0, 10029, 109, 0, 109
2101, 1, 1636428535577, 1636428535917, 340, 0, 340, 0, 0, 0
2102, 1, 1636428535689, 1636428535968, 279, 1, 278, 0, 0, 0
2103, 1, 1636428535736, 1636428536004, 268, 1, 267, 0, 1, 1
2104, 1, 1636428535901, 1636428536249, 348, 68, 280, 68, 0, 68
2106, 1, 1636428536116, 1636428536389, 273, 1, 272, 0, 0, 0
2108, 1, 1636428536329, 1636428536601, 272, 0, 272, 0, 0, 0
2107, 1, 1636428536125, 1636428536664, 539, 265, 274, 265, 0, 265
2105, 1, 1636428536120, 1636428536945, 825, 546, 279, 544, 1, 545
2109, 1, 1636428537457, 1636428537729, 272, 0, 272, 0, 0, 0
2110, 1, 1636428537732, 1636428538004, 272, 1, 271, 0, 1, 1
2067, 2, 1636428528040, 1636428538041, 10001, 0, 10001, 1, 0, 1
2111, 1, 1636428537788, 1636428538089, 301, 1, 300, 0, 0, 0
2112, 1, 1636428537964, 1636428538276, 312, 1, 311, 1, 0, 1
2114, 1, 1636428537984, 1636428538277, 293, 21, 272, 21, 0, 21
2116, 1, 1636428538388, 1636428538656, 268, 1, 267, 1, 0, 1
2117, 1, 1636428538392, 1636428538664, 272, 1, 271, 0, 0, 0
2070, 2, 1636428528697, 1636428538696, 9999, 0, 9999, 0, 0, 0
2118, 1, 1636428539045, 1636428539317, 272, 0, 272, 0, 0, 0
2073, 2, 1636428529520, 1636428539521, 10001, 0, 10001, 0, 0, 0
2119, 1, 1636428539465, 1636428539757, 292, 0, 292, 0, 0, 0
2080, 1, 1636428530537, 1636428539796, 9259, 8984, 275, 0, 8984, 8984
2120, 1, 1636428539652, 1636428539925, 273, 1, 272, 0, 0, 0
2123, 1, 1636428539884, 1636428540152, 268, 1, 267, 0, 1, 1
2122, 1, 1636428539853, 1636428540197, 344, 73, 271, 73, 0, 73
2124, 1, 1636428539925, 1636428540197, 272, 0, 272, 0, 0, 0
2126, 1, 1636428540389, 1636428540661, 272, 0, 272, 0, 0, 0
2127, 1, 1636428540396, 1636428540668, 272, 1, 271, 0, 0, 0
2082, 2, 1636428530901, 1636428540901, 10000, 0, 10000, 0, 0, 0
2128, 1, 1636428541033, 1636428541309, 276, 0, 276, 0, 0, 0
2129, 1, 1636428541252, 1636428541524, 272, 1, 271, 0, 1, 1
2085, 2, 1636428531709, 1636428541709, 10000, 0, 10000, 0, 0, 0
2131, 1, 1636428541573, 1636428541853, 280, 0, 280, 0, 0, 0
2133, 1, 1636428541845, 1636428542117, 272, 0, 272, 0, 0, 0
2132, 1, 1636428541756, 1636428542129, 373, 98, 275, 97, 0, 97
2134, 1, 1636428541913, 1636428542181, 268, 0, 268, 0, 0, 0
2135, 1, 1636428542060, 1636428542333, 273, 0, 273, 0, 0, 0
2136, 1, 1636428542349, 1636428542625, 276, 0, 276, 0, 0, 0
2137, 1, 1636428542356, 1636428542629, 273, 1, 272, 0, 0, 0
2138, 1, 1636428543021, 1636428543293, 272, 0, 272, 0, 0, 0
2139, 1, 1636428543232, 1636428543505, 273, 1, 272, 0, 0, 0
2140, 1, 1636428543477, 1636428543749, 272, 0, 272, 0, 0, 0
2141, 1, 1636428543733, 1636428544028, 295, 17, 278, 16, 0, 16
2142, 1, 1636428543888, 1636428544161, 273, 1, 272, 0, 0, 0
2143, 1, 1636428543909, 1636428544181, 272, 0, 272, 0, 0, 0
2144, 1, 1636428544048, 1636428544321, 273, 0, 273, 0, 0, 0
2094, 2, 1636428534373, 1636428544373, 10000, 0, 10000, 264, 0, 264
2098, 2, 1636428534376, 1636428544421, 10045, 0, 10045, 262, 0, 262
2095, 2, 1636428534373, 1636428544469, 10096, 0, 10096, 265, 0, 265
2097, 2, 1636428534373, 1636428544517, 10144, 0, 10144, 264, 0, 264
2099, 2, 1636428534549, 1636428544565, 10016, 0, 10016, 0, 0, 0
2145, 1, 1636428544253, 1636428544704, 451, 0, 451, 0, 0, 0
2100, 1, 1636428534724, 1636428544841, 10117, 9841, 276, 0, 9841, 9841
2146, 1, 1636428544613, 1636428544880, 267, 0, 267, 0, 0, 0
2147, 1, 1636428544900, 1636428545177, 277, 1, 276, 0, 0, 0
2148, 1, 1636428544925, 1636428545197, 272, 0, 272, 0, 0, 0
2149, 1, 1636428545000, 1636428545272, 272, 1, 271, 0, 0, 0
2153, 1, 1636428545228, 1636428545497, 269, 1, 268, 0, 0, 0
2154, 1, 1636428545305, 1636428545581, 276, 0, 276, 0, 0, 0
2155, 1, 1636428545397, 1636428545853, 456, 185, 271, 184, 1, 185
2157, 1, 1636428545821, 1636428546092, 271, 0, 271, 0, 0, 0
2156, 1, 1636428545693, 1636428546129, 436, 160, 276, 160, 0, 160
2158, 1, 1636428545929, 1636428546201, 272, 0, 272, 0, 0, 0
2159, 1, 1636428546025, 1636428546297, 272, 0, 272, 0, 0, 0
2160, 1, 1636428546280, 1636428546553, 273, 1, 272, 0, 0, 0
2161, 1, 1636428546349, 1636428546613, 264, 0, 264, 0, 0, 0
2162, 1, 1636428546913, 1636428547185, 272, 0, 272, 0, 0, 0
2163, 1, 1636428546924, 1636428547197, 273, 0, 273, 0, 0, 0
2164, 1, 1636428546949, 1636428547225, 276, 0, 276, 0, 0, 0
2165, 1, 1636428547133, 1636428547405, 272, 0, 272, 0, 0, 0
2166, 1, 1636428547313, 1636428547585, 272, 0, 272, 0, 0, 0
2167, 1, 1636428547476, 1636428547861, 385, 110, 275, 109, 1, 110
2113, 2, 1636428537977, 1636428547977, 10000, 0, 10000, 300, 0, 300
2115, 2, 1636428538029, 1636428548029, 10000, 0, 10000, 249, 0, 249
2169, 1, 1636428547784, 1636428548076, 292, 1, 291, 0, 0, 0
2170, 1, 1636428547832, 1636428548116, 284, 1, 283, 0, 0, 0
2168, 1, 1636428547772, 1636428548168, 396, 89, 307, 88, 0, 88
2171, 1, 1636428548113, 1636428548380, 267, 0, 267, 0, 0, 0
2172, 1, 1636428548245, 1636428548517, 272, 0, 272, 0, 0, 0
2174, 1, 1636428548388, 1636428548657, 269, 1, 268, 0, 1, 1
2173, 1, 1636428548384, 1636428548657, 273, 1, 272, 0, 0, 0
2175, 1, 1636428548632, 1636428548933, 301, 26, 275, 26, 0, 26
2176, 1, 1636428548801, 1636428549072, 271, 0, 271, 0, 0, 0
2177, 1, 1636428548953, 1636428549224, 271, 0, 271, 0, 0, 0
2178, 1, 1636428549072, 1636428549345, 273, 0, 273, 0, 0, 0
2179, 1, 1636428549160, 1636428549433, 273, 1, 272, 0, 0, 0
2180, 1, 1636428549249, 1636428549525, 276, 0, 276, 0, 0, 0
2181, 1, 1636428549412, 1636428549805, 393, 114, 279, 112, 0, 112
2121, 2, 1636428539873, 1636428549873, 10000, 0, 10000, 0, 0, 0
2183, 1, 1636428549709, 1636428550013, 304, 0, 304, 0, 0, 0
2182, 1, 1636428549661, 1636428550104, 443, 145, 298, 144, 1, 145
2184, 1, 1636428549864, 1636428550133, 269, 1, 268, 0, 1, 1
2125, 2, 1636428540233, 1636428550233, 10000, 0, 10000, 0, 0, 0
2185, 1, 1636428550045, 1636428550316, 271, 0, 271, 0, 0, 0
2187, 1, 1636428550188, 1636428550456, 268, 1, 267, 0, 0, 0
2130, 1, 1636428541441, 1636428550496, 9055, 8792, 263, 0, 8792, 8792
2188, 1, 1636428550276, 1636428550540, 264, 1, 263, 0, 1, 1
2189, 1, 1636428550496, 1636428550764, 268, 1, 267, 0, 1, 1
2190, 1, 1636428550540, 1636428550813, 273, 0, 273, 0, 0, 0
2192, 1, 1636428550760, 1636428551029, 269, 1, 268, 0, 0, 0
2193, 1, 1636428550905, 1636428551168, 263, 0, 263, 0, 0, 0
2195, 1, 1636428551125, 1636428551397, 272, 0, 272, 0, 0, 0
2196, 1, 1636428551172, 1636428551449, 277, 1, 276, 0, 0, 0
2197, 1, 1636428551281, 1636428551557, 276, 0, 276, 0, 0, 0
2198, 1, 1636428551328, 1636428551673, 345, 69, 276, 69, 0, 69
2200, 1, 1636428551676, 1636428551948, 272, 1, 271, 0, 1, 1
2199, 1, 1636428551656, 1636428551960, 304, 17, 287, 16, 0, 16
2201, 1, 1636428551969, 1636428552241, 272, 0, 272, 0, 0, 0
2202, 1, 1636428551977, 1636428552253, 276, 0, 276, 0, 0, 0
2203, 1, 1636428552092, 1636428552365, 273, 0, 273, 0, 0, 0
2204, 1, 1636428552368, 1636428552641, 273, 1, 272, 0, 0, 0
2205, 1, 1636428552384, 1636428552653, 269, 0, 269, 0, 0, 0
2206, 1, 1636428552533, 1636428552804, 271, 0, 271, 0, 0, 0
2207, 1, 1636428552848, 1636428553117, 269, 1, 268, 0, 1, 1
2208, 1, 1636428552988, 1636428553260, 272, 0, 272, 0, 0, 0
2209, 1, 1636428553053, 1636428553324, 271, 0, 271, 0, 0, 0
2210, 1, 1636428553208, 1636428553488, 280, 0, 280, 0, 0, 0
2211, 1, 1636428553368, 1636428553641, 273, 0, 273, 0, 0, 0
2212, 1, 1636428553444, 1636428553757, 313, 45, 268, 45, 0, 45
2213, 1, 1636428553669, 1636428553941, 272, 0, 272, 0, 0, 0
2214, 1, 1636428553752, 1636428554033, 281, 6, 275, 5, 0, 5
2215, 1, 1636428553861, 1636428554132, 271, 0, 271, 0, 0, 0
2216, 1, 1636428553977, 1636428554253, 276, 0, 276, 0, 0, 0
2217, 1, 1636428554069, 1636428554349, 280, 0, 280, 0, 0, 0
2218, 1, 1636428554245, 1636428554516, 271, 0, 271, 0, 0, 0
2219, 1, 1636428554417, 1636428554688, 271, 0, 271, 0, 0, 0
2220, 1, 1636428554481, 1636428554753, 272, 0, 272, 0, 0, 0
2152, 2, 1636428545005, 1636428555005, 10000, 0, 10000, 268, 0, 268
2151, 2, 1636428545005, 1636428555053, 10048, 0, 10048, 268, 0, 268
2150, 2, 1636428545005, 1636428555097, 10092, 0, 10092, 268, 0, 268
2221, 1, 1636428554740, 1636428555144, 404, 1, 403, 0, 0, 0
2222, 1, 1636428554889, 1636428555236, 347, 0, 347, 0, 0, 0
2223, 1, 1636428555144, 1636428555412, 268, 1, 267, 0, 1, 1
2224, 1, 1636428555188, 1636428555460, 272, 0, 272, 0, 0, 0
2225, 1, 1636428555276, 1636428555545, 269, 0, 269, 0, 0, 0
2226, 1, 1636428555360, 1636428555725, 365, 101, 264, 101, 0, 101
2230, 1, 1636428555688, 1636428556001, 313, 37, 276, 37, 0, 37
2231, 1, 1636428555745, 1636428556012, 267, 0, 267, 0, 0, 0
2232, 1, 1636428555781, 1636428556048, 267, 0, 267, 0, 0, 0
2233, 1, 1636428556052, 1636428556321, 269, 0, 269, 0, 0, 0
2234, 1, 1636428556069, 1636428556345, 276, 0, 276, 0, 0, 0
2235, 1, 1636428556136, 1636428556412, 276, 1, 275, 0, 0, 0
2236, 1, 1636428556372, 1636428556649, 277, 1, 276, 0, 1, 1
2237, 1, 1636428556452, 1636428556729, 277, 1, 276, 0, 1, 1
2238, 1, 1636428556688, 1636428556965, 277, 1, 276, 0, 1, 1
2239, 1, 1636428556945, 1636428557216, 271, 0, 271, 0, 0, 0
2240, 1, 1636428556960, 1636428557236, 276, 1, 275, 0, 0, 0
2241, 1, 1636428557113, 1636428557385, 272, 0, 272, 0, 0, 0
2242, 1, 1636428557172, 1636428557445, 273, 1, 272, 0, 0, 0
2243, 1, 1636428557312, 1636428557660, 348, 73, 275, 72, 0, 72
2245, 1, 1636428557649, 1636428557921, 272, 0, 272, 0, 0, 0
2244, 1, 1636428557581, 1636428557933, 352, 80, 272, 80, 0, 80
2246, 1, 1636428557809, 1636428558080, 271, 0, 271, 0, 0, 0
2248, 1, 1636428558021, 1636428558289, 268, 0, 268, 0, 0, 0
2247, 1, 1636428558012, 1636428558289, 277, 1, 276, 0, 0, 0
2249, 1, 1636428558036, 1636428558312, 276, 0, 276, 0, 0, 0
2250, 1, 1636428558356, 1636428558629, 273, 1, 272, 0, 1, 1
2251, 1, 1636428558397, 1636428558668, 271, 0, 271, 0, 0, 0
2252, 1, 1636428558660, 1636428558933, 273, 1, 272, 0, 0, 0
2253, 1, 1636428558944, 1636428559221, 277, 1, 276, 0, 0, 0
2254, 1, 1636428558985, 1636428559257, 272, 0, 272, 0, 0, 0
2255, 1, 1636428559013, 1636428559285, 272, 0, 272, 0, 0, 0
2256, 1, 1636428559069, 1636428559341, 272, 0, 272, 0, 0, 0
2257, 1, 1636428559261, 1636428559533, 272, 0, 272, 0, 0, 0
2258, 1, 1636428559541, 1636428559813, 272, 0, 272, 0, 0, 0
2259, 1, 1636428559605, 1636428559877, 272, 0, 272, 0, 0, 0
2260, 1, 1636428559745, 1636428560016, 271, 0, 271, 0, 0, 0
2262, 1, 1636428559905, 1636428560176, 271, 0, 271, 0, 0, 0
2263, 1, 1636428559912, 1636428560185, 273, 0, 273, 0, 0, 0
2261, 1, 1636428559908, 1636428560185, 277, 1, 276, 1, 0, 1
2186, 2, 1636428550232, 1636428560237, 10005, 0, 10005, 0, 0, 0
2264, 1, 1636428560284, 1636428560565, 281, 1, 280, 0, 0, 0
2191, 2, 1636428550584, 1636428560585, 10001, 0, 10001, 0, 0, 0
2265, 1, 1636428560373, 1636428560644, 271, 0, 271, 0, 0, 0
2194, 1, 1636428550956, 1636428560861, 9905, 9629, 276, 0, 9628, 9628
2267, 1, 1636428560780, 1636428561053, 273, 1, 272, 0, 1, 1
2269, 1, 1636428560884, 1636428561156, 272, 1, 271, 0, 0, 0
2271, 1, 1636428561053, 1636428561320, 267, 0, 267, 0, 0, 0
2274, 1, 1636428561332, 1636428561604, 272, 1, 271, 0, 0, 0
2275, 1, 1636428561553, 1636428561824, 271, 0, 271, 0, 0, 0
2276, 1, 1636428561644, 1636428561917, 273, 1, 272, 0, 0, 0
2277, 1, 1636428561657, 1636428561929, 272, 0, 272, 0, 0, 0
2278, 1, 1636428561820, 1636428562093, 273, 1, 272, 0, 0, 0
2279, 1, 1636428561856, 1636428562128, 272, 0, 272, 0, 0, 0
2280, 1, 1636428562041, 1636428562317, 276, 0, 276, 0, 0, 0
2281, 1, 1636428562164, 1636428562437, 273, 0, 273, 0, 0, 0
2282, 1, 1636428562441, 1636428562713, 272, 0, 272, 0, 0, 0
2284, 1, 1636428562857, 1636428563129, 272, 0, 272, 0, 0, 0
2285, 1, 1636428562960, 1636428563237, 277, 0, 277, 0, 0, 0
2287, 1, 1636428563533, 1636428563804, 271, 0, 271, 0, 0, 0
2289, 1, 1636428563704, 1636428563976, 272, 1, 271, 0, 1, 1
2290, 1, 1636428563728, 1636428564005, 277, 0, 277, 0, 0, 0
2291, 1, 1636428563732, 1636428564013, 281, 0, 281, 0, 0, 0
2292, 1, 1636428564032, 1636428564304, 272, 1, 271, 0, 0, 0
2293, 1, 1636428564065, 1636428564336, 271, 0, 271, 0, 0, 0
2294, 1, 1636428564429, 1636428564701, 272, 0, 272, 0, 0, 0
2295, 1, 1636428564953, 1636428565225, 272, 0, 272, 0, 0, 0
2296, 1, 1636428564960, 1636428565233, 273, 0, 273, 0, 0, 0
2229, 2, 1636428555629, 1636428565629, 10000, 0, 10000, 0, 0, 0
2227, 2, 1636428555629, 1636428565676, 10047, 0, 10047, 1, 0, 1
2228, 2, 1636428555629, 1636428565721, 10092, 0, 10092, 0, 0, 0
2300, 1, 1636428565769, 1636428566044, 275, 1, 274, 1, 0, 1
2298, 1, 1636428565769, 1636428566045, 276, 1, 275, 0, 0, 0
2299, 1, 1636428565769, 1636428566044, 275, 1, 274, 1, 0, 1
2297, 1, 1636428565769, 1636428566044, 275, 1, 274, 1, 0, 1
2304, 1, 1636428566016, 1636428566321, 305, 29, 276, 29, 0, 29
2305, 1, 1636428566064, 1636428566329, 265, 1, 264, 0, 0, 0
2306, 1, 1636428566464, 1636428566737, 273, 1, 272, 0, 0, 0
2308, 1, 1636428566913, 1636428567185, 272, 0, 272, 0, 0, 0
2309, 1, 1636428567585, 1636428567852, 267, 0, 267, 0, 0, 0
2310, 1, 1636428567625, 1636428567888, 263, 0, 263, 0, 0, 0
2311, 1, 1636428567660, 1636428567928, 268, 0, 268, 0, 0, 0
2312, 1, 1636428567704, 1636428567972, 268, 0, 268, 0, 0, 0
2313, 1, 1636428568013, 1636428568281, 268, 0, 268, 0, 0, 0
2314, 1, 1636428568093, 1636428568365, 272, 0, 272, 0, 0, 0
2315, 1, 1636428568497, 1636428568769, 272, 0, 272, 0, 0, 0
2316, 1, 1636428568849, 1636428569125, 276, 0, 276, 0, 0, 0
2317, 1, 1636428569485, 1636428569756, 271, 0, 271, 0, 0, 0
2318, 1, 1636428569496, 1636428569769, 273, 1, 272, 1, 0, 1
2319, 1, 1636428569705, 1636428569977, 272, 0, 272, 0, 0, 0
2320, 1, 1636428569964, 1636428570237, 273, 1, 272, 0, 0, 0
2321, 1, 1636428570073, 1636428570345, 272, 0, 272, 0, 0, 0
2266, 2, 1636428560632, 1636428570633, 10001, 0, 10001, 0, 0, 0
2322, 1, 1636428570477, 1636428570772, 295, 0, 295, 0, 0, 0
2270, 2, 1636428560936, 1636428570932, 9996, 0, 9996, 0, 0, 0
2323, 1, 1636428570916, 1636428571193, 277, 0, 277, 0, 0, 0
2273, 2, 1636428561300, 1636428571301, 10001, 0, 10001, 0, 0, 0
2326, 1, 1636428571505, 1636428571777, 272, 0, 272, 0, 0, 0
2327, 1, 1636428571565, 1636428571841, 276, 0, 276, 0, 0, 0
2328, 1, 1636428571593, 1636428571865, 272, 0, 272, 0, 0, 0
2330, 1, 1636428571985, 1636428572253, 268, 0, 268, 0, 0, 0
2331, 1, 1636428572097, 1636428572369, 272, 0, 272, 0, 0, 0
2283, 2, 1636428562833, 1636428572833, 10000, 0, 10000, 0, 0, 0
2332, 1, 1636428572597, 1636428572880, 283, 0, 283, 0, 0, 0
2286, 2, 1636428563448, 1636428573449, 10001, 0, 10001, 1, 0, 1
2288, 1, 1636428563665, 1636428573721, 10056, 9784, 272, 0, 9784, 9784
2334, 1, 1636428573588, 1636428573861, 273, 0, 273, 0, 0, 0
2335, 1, 1636428573624, 1636428573996, 372, 98, 274, 97, 1, 98
2338, 1, 1636428574157, 1636428574429, 272, 0, 272, 0, 0, 0
2339, 1, 1636428574664, 1636428574933, 269, 1, 268, 0, 1, 1
2340, 1, 1636428575453, 1636428575729, 276, 0, 276, 0, 0, 0
2341, 1, 1636428575733, 1636428576009, 276, 0, 276, 0, 0, 0
2301, 2, 1636428566032, 1636428576029, 9997, 0, 9997, 1, 0, 1
2303, 2, 1636428566032, 1636428576076, 10044, 0, 10044, 0, 0, 0
2302, 2, 1636428566032, 1636428576120, 10088, 0, 10088, 0, 0, 0
2342, 1, 1636428576216, 1636428576488, 272, 0, 272, 0, 0, 0
2344, 1, 1636428576432, 1636428576705, 273, 1, 272, 0, 0, 0
2346, 1, 1636428576564, 1636428576840, 276, 1, 275, 0, 1, 1
2345, 1, 1636428576432, 1636428576976, 544, 273, 271, 273, 0, 273
2343, 1, 1636428576432, 1636428577248, 816, 545, 271, 545, 0, 545
2347, 1, 1636428577409, 1636428577681, 272, 0, 272, 0, 0, 0
2348, 1, 1636428577620, 1636428577893, 273, 1, 272, 0, 0, 0
2349, 1, 1636428578177, 1636428578449, 272, 0, 272, 0, 0, 0
2353, 1, 1636428578581, 1636428578853, 272, 0, 272, 0, 0, 0
2354, 1, 1636428579457, 1636428579729, 272, 0, 272, 0, 0, 0
2355, 1, 1636428579641, 1636428579917, 276, 0, 276, 0, 0, 0
2356, 1, 1636428580141, 1636428580413, 272, 0, 272, 0, 0, 0
2357, 1, 1636428580544, 1636428580817, 273, 1, 272, 1, 0, 1
2324, 2, 1636428570980, 1636428580985, 10005, 0, 10005, 0, 0, 0
2325, 2, 1636428571277, 1636428581281, 10004, 0, 10004, 0, 0, 0
2358, 1, 1636428581329, 1636428581600, 271, 0, 271, 0, 0, 0
2329, 2, 1636428571648, 1636428581645, 9997, 0, 9997, 0, 0, 0
2359, 1, 1636428581417, 1636428581692, 275, 0, 275, 0, 0, 0
2360, 1, 1636428581549, 1636428581820, 271, 0, 271, 0, 0, 0
2361, 1, 1636428581624, 1636428581897, 273, 1, 272, 0, 0, 0
2362, 1, 1636428581997, 1636428582268, 271, 0, 271, 0, 0, 0
2363, 1, 1636428582205, 1636428582481, 276, 0, 276, 0, 0, 0
2364, 1, 1636428582609, 1636428582881, 272, 0, 272, 0, 0, 0
2333, 2, 1636428573181, 1636428583181, 10000, 0, 10000, 0, 0, 0
2336, 2, 1636428573793, 1636428583793, 10000, 0, 10000, 0, 0, 0
2367, 1, 1636428583529, 1636428583840, 311, 0, 311, 0, 0, 0
2369, 1, 1636428583661, 1636428583932, 271, 0, 271, 0, 0, 0
2337, 2, 1636428574169, 1636428584169, 10000, 0, 10000, 0, 0, 0
2371, 1, 1636428584141, 1636428584408, 267, 0, 267, 0, 0, 0
2372, 1, 1636428584220, 1636428584492, 272, 1, 271, 0, 0, 0
2374, 1, 1636428584629, 1636428584901, 272, 0, 272, 0, 0, 0
2376, 1, 1636428585537, 1636428585809, 272, 0, 272, 0, 0, 0
2378, 1, 1636428586101, 1636428586376, 275, 0, 275, 0, 0, 0
2379, 1, 1636428586509, 1636428586781, 272, 0, 272, 0, 0, 0
2380, 1, 1636428587549, 1636428587821, 272, 0, 272, 0, 0, 0
2350, 2, 1636428578357, 1636428588357, 10000, 0, 10000, 0, 0, 0
2351, 2, 1636428578381, 1636428588401, 10020, 0, 10020, 0, 0, 0
2352, 2, 1636428578413, 1636428588449, 10036, 0, 10036, 0, 0, 0
2381, 1, 1636428588157, 1636428588497, 340, 0, 340, 0, 0, 0
2382, 1, 1636428588585, 1636428588856, 271, 0, 271, 0, 0, 0
2383, 1, 1636428588760, 1636428589033, 273, 0, 273, 0, 0, 0
2386, 1, 1636428589641, 1636428589916, 275, 0, 275, 0, 0, 0
2387, 1, 1636428590276, 1636428590549, 273, 1, 272, 1, 0, 1
2388, 1, 1636428590576, 1636428590849, 273, 1, 272, 0, 0, 0
2389, 1, 1636428590729, 1636428591005, 276, 0, 276, 0, 0, 0
2390, 1, 1636428591545, 1636428591821, 276, 0, 276, 0, 0, 0
2391, 1, 1636428592209, 1636428592481, 272, 0, 272, 0, 0, 0
2392, 1, 1636428592517, 1636428592789, 272, 0, 272, 0, 0, 0
2393, 1, 1636428592649, 1636428592921, 272, 0, 272, 0, 0, 0
2365, 2, 1636428583312, 1636428593317, 10005, 0, 10005, 0, 0, 0
2366, 2, 1636428583432, 1636428593429, 9997, 0, 9997, 0, 0, 0
2368, 2, 1636428583561, 1636428593561, 10000, 0, 10000, 0, 0, 0
2394, 1, 1636428593492, 1636428593792, 300, 1, 299, 0, 0, 0
2370, 2, 1636428583976, 1636428593981, 10005, 0, 10005, 0, 0, 0
2396, 1, 1636428593777, 1636428594049, 272, 0, 272, 0, 0, 0
2398, 1, 1636428594161, 1636428594437, 276, 0, 276, 0, 0, 0
2400, 1, 1636428594508, 1636428594781, 273, 1, 272, 0, 0, 0
2401, 1, 1636428594713, 1636428594988, 275, 0, 275, 0, 0, 0
2375, 2, 1636428585529, 1636428595529, 10000, 0, 10000, 0, 0, 0
2402, 1, 1636428595377, 1636428595668, 291, 0, 291, 0, 0, 0
2377, 1, 1636428586077, 1636428595804, 9727, 9452, 275, 0, 9452, 9452
2403, 1, 1636428595712, 1636428596073, 361, 93, 268, 93, 0, 93
2406, 1, 1636428596209, 1636428596481, 272, 0, 272, 0, 0, 0
2407, 1, 1636428596544, 1636428596817, 273, 1, 272, 0, 0, 0
2408, 1, 1636428596645, 1636428596917, 272, 0, 272, 0, 0, 0
2409, 1, 1636428597373, 1636428597645, 272, 0, 272, 0, 0, 0
2410, 1, 1636428597665, 1636428597944, 279, 0, 279, 0, 0, 0
2411, 1, 1636428598165, 1636428598437, 272, 0, 272, 0, 0, 0
2384, 2, 1636428588760, 1636428598761, 10001, 0, 10001, 273, 0, 273
2385, 2, 1636428588768, 1636428598809, 10041, 0, 10041, 265, 0, 265
2412, 1, 1636428598505, 1636428598857, 352, 0, 352, 0, 0, 0
2413, 1, 1636428598653, 1636428598949, 296, 0, 296, 0, 0, 0
2416, 1, 1636428599352, 1636428599624, 272, 0, 272, 0, 0, 0
2417, 1, 1636428599697, 1636428599973, 276, 0, 276, 0, 0, 0
2418, 1, 1636428600197, 1636428600468, 271, 0, 271, 0, 0, 0
2419, 1, 1636428600588, 1636428600861, 273, 1, 272, 0, 0, 0
2420, 1, 1636428600713, 1636428600989, 276, 0, 276, 0, 0, 0
2421, 1, 1636428601425, 1636428601701, 276, 0, 276, 0, 0, 0
2422, 1, 1636428601601, 1636428601877, 276, 0, 276, 0, 0, 0
2423, 1, 1636428602084, 1636428602357, 273, 1, 272, 0, 0, 0
2424, 1, 1636428602493, 1636428602764, 271, 0, 271, 0, 0, 0
2425, 1, 1636428602617, 1636428602889, 272, 0, 272, 0, 0, 0
2426, 1, 1636428603337, 1636428603613, 276, 0, 276, 0, 0, 0
2395, 2, 1636428593697, 1636428603697, 10000, 0, 10000, 0, 0, 0
2397, 2, 1636428593908, 1636428603908, 10000, 0, 10000, 0, 0, 0
2427, 1, 1636428603744, 1636428604049, 305, 0, 305, 0, 0, 0
2399, 2, 1636428594328, 1636428604332, 10004, 0, 10004, 0, 0, 0
2429, 1, 1636428604193, 1636428604477, 284, 0, 284, 0, 0, 0
2431, 1, 1636428604537, 1636428604809, 272, 0, 272, 0, 0, 0
2432, 1, 1636428604601, 1636428604877, 276, 0, 276, 0, 0, 0
2434, 1, 1636428605420, 1636428605693, 273, 1, 272, 0, 0, 0
2404, 2, 1636428595873, 1636428605873, 10000, 0, 10000, 0, 0, 0
2435, 1, 1636428605769, 1636428606045, 276, 0, 276, 0, 0, 0
2405, 1, 1636428596237, 1636428606145, 9908, 9636, 272, 0, 9636, 9636
2437, 1, 1636428606196, 1636428606469, 273, 1, 272, 0, 0, 0
2438, 1, 1636428606405, 1636428606681, 276, 0, 276, 0, 0, 0
2440, 1, 1636428606613, 1636428606885, 272, 0, 272, 0, 0, 0
2441, 1, 1636428607421, 1636428607701, 280, 0, 280, 0, 0, 0
2442, 1, 1636428607637, 1636428607913, 276, 0, 276, 0, 0, 0
2443, 1, 1636428608069, 1636428608341, 272, 0, 272, 0, 0, 0
2444, 1, 1636428608333, 1636428608604, 271, 0, 271, 0, 0, 0
2445, 1, 1636428608484, 1636428608757, 273, 1, 272, 0, 1, 1
2414, 2, 1636428599388, 1636428609389, 10001, 0, 10001, 0, 0, 0
2415, 2, 1636428599388, 1636428609432, 10044, 0, 10044, 0, 0, 0
2446, 1, 1636428609616, 1636428609889, 273, 0, 273, 0, 0, 0
2449, 1, 1636428610009, 1636428610281, 272, 0, 272, 0, 0, 0
2450, 1, 1636428610268, 1636428610541, 273, 1, 272, 0, 0, 0
2451, 1, 1636428610461, 1636428610729, 268, 0, 268, 0, 0, 0
2452, 1, 1636428611717, 1636428611993, 276, 0, 276, 0, 0, 0
2453, 1, 1636428612109, 1636428612385, 276, 0, 276, 0, 0, 0
2454, 1, 1636428612392, 1636428612665, 273, 0, 273, 0, 0, 0
2455, 1, 1636428612565, 1636428612837, 272, 0, 272, 0, 0, 0
2456, 1, 1636428613612, 1636428613884, 272, 1, 271, 0, 1, 1
2428, 2, 1636428604052, 1636428614053, 10001, 0, 10001, 0, 0, 0
2430, 2, 1636428604252, 1636428614253, 10001, 0, 10001, 0, 0, 0
2457, 1, 1636428614001, 1636428614300, 299, 0, 299, 0, 0, 0
2458, 1, 1636428614296, 1636428614569, 273, 0, 273, 0, 0, 0
2433, 2, 1636428604681, 1636428614681, 10000, 0, 10000, 0, 0, 0
2460, 1, 1636428614457, 1636428614728, 271, 0, 271, 0, 0, 0
2463, 1, 1636428615701, 1636428615973, 272, 0, 272, 0, 0, 0
2436, 2, 1636428606221, 1636428616221, 10000, 0, 10000, 0, 0, 0
2464, 1, 1636428616073, 1636428616361, 288, 0, 288, 0, 0, 0
2439, 1, 1636428606577, 1636428616497, 9920, 9644, 276, 0, 9644, 9644
2465, 1, 1636428616489, 1636428616760, 271, 0, 271, 0, 0, 0
2468, 1, 1636428617664, 1636428617937, 273, 1, 272, 0, 0, 0
2470, 1, 1636428618477, 1636428618749, 272, 0, 272, 0, 0, 0
2448, 2, 1636428609745, 1636428619745, 10000, 0, 10000, 0, 0, 0
2447, 2, 1636428609745, 1636428619788, 10043, 0, 10043, 0, 0, 0
2471, 1, 1636428619721, 1636428620020, 299, 0, 299, 0, 0, 0
2474, 1, 1636428620529, 1636428620801, 272, 0, 272, 0, 0, 0
2475, 1, 1636428621845, 1636428622121, 276, 0, 276, 0, 0, 0
2476, 1, 1636428622560, 1636428622833, 273, 1, 272, 0, 0, 0
2477, 1, 1636428623717, 1636428623984, 267, 0, 267, 0, 0, 0
2459, 2, 1636428614408, 1636428624409, 10001, 0, 10001, 0, 0, 0
2461, 2, 1636428614597, 1636428624597, 10000, 0, 10000, 0, 0, 0
2478, 1, 1636428624456, 1636428624736, 280, 1, 279, 0, 0, 0
2462, 2, 1636428615037, 1636428625033, 9996, 0, 9996, 0, 0, 0
2466, 2, 1636428616569, 1636428626569, 10000, 0, 10000, 0, 0, 0
2467, 1, 1636428616928, 1636428626841, 9913, 9641, 272, 0, 9641, 9641
2473, 2, 1636428620101, 1636428630101, 10000, 0, 10000, 0, 0, 0
2472, 2, 1636428620101, 1636428630145, 10044, 0, 10044, 0, 0, 0
2479, 2, 1636428624760, 1636428634761, 10001, 0, 10001, 0, 0, 0
2480, 2, 1636428624945, 1636428634945, 10000, 0, 10000, 0, 0, 0
2481, 2, 1636428625393, 1636428635389, 9996, 0, 9996, 0, 0, 0
2482, 2, 1636428626917, 1636428636917, 10000, 0, 10000, 0, 0, 0
2483, 1, 1636428627281, 1636428637188, 9907, 9636, 271, 0, 9636, 9636
2484, 2, 1636428630457, 1636428640457, 10000, 0, 10000, 0, 0, 0
2485, 2, 1636428630457, 1636428640500, 10043, 0, 10043, 0, 0, 0
2491, 1, 1636428640813, 1636428641085, 272, 0, 272, 0, 0, 0
2492, 1, 1636428640816, 1636428641357, 541, 270, 271, 269, 0, 269
2493, 1, 1636428642665, 1636428642937, 272, 0, 272, 0, 0, 0
2494, 1, 1636428642669, 1636428643213, 544, 269, 275, 268, 0, 268
2495, 1, 1636428644773, 1636428645053, 280, 0, 280, 0, 0, 0
2486, 2, 1636428635112, 1636428645113, 10001, 0, 10001, 0, 0, 0
2487, 2, 1636428635296, 1636428645292, 9996, 0, 9996, 0, 0, 0
2496, 1, 1636428644777, 1636428645345, 568, 276, 292, 276, 0, 276
2488, 2, 1636428635749, 1636428645749, 10000, 0, 10000, 0, 0, 0
2498, 1, 1636428645641, 1636428645917, 276, 0, 276, 0, 0, 0
2499, 1, 1636428646105, 1636428646377, 272, 0, 272, 0, 0, 0
2500, 1, 1636428646801, 1636428647073, 272, 0, 272, 0, 0, 0
2489, 2, 1636428637265, 1636428647268, 10003, 0, 10003, 0, 0, 0
2501, 1, 1636428646880, 1636428647349, 469, 193, 276, 192, 0, 192
2490, 1, 1636428637621, 1636428647537, 9916, 9648, 268, 0, 9647, 9647
2502, 1, 1636428647524, 1636428647797, 273, 1, 272, 0, 0, 0
2503, 1, 1636428647608, 1636428647881, 273, 1, 272, 0, 0, 0
2504, 1, 1636428647972, 1636428648245, 273, 1, 272, 0, 0, 0
2505, 1, 1636428647984, 1636428648261, 277, 1, 276, 1, 0, 1
2506, 1, 1636428648668, 1636428648941, 273, 1, 272, 0, 0, 0
2507, 1, 1636428648772, 1636428649217, 445, 170, 275, 169, 0, 169
2508, 1, 1636428649421, 1636428649693, 272, 0, 272, 0, 0, 0
2509, 1, 1636428649637, 1636428649909, 272, 0, 272, 0, 0, 0
2510, 1, 1636428649869, 1636428650145, 276, 0, 276, 0, 0, 0
2511, 1, 1636428650096, 1636428650368, 272, 1, 271, 0, 1, 1
2512, 1, 1636428650645, 1636428650916, 271, 0, 271, 0, 0, 0
2513, 1, 1636428650673, 1636428651193, 520, 244, 276, 244, 0, 244
2514, 1, 1636428651533, 1636428651805, 272, 0, 272, 0, 0, 0
2515, 1, 1636428651705, 1636428651981, 276, 0, 276, 0, 0, 0
2516, 1, 1636428651977, 1636428652249, 272, 0, 272, 0, 0, 0
2517, 1, 1636428652168, 1636428652441, 273, 1, 272, 0, 0, 0
2518, 1, 1636428652704, 1636428652977, 273, 0, 273, 0, 0, 0
2519, 1, 1636428652748, 1636428653253, 505, 229, 276, 229, 0, 229
2520, 1, 1636428653545, 1636428653817, 272, 0, 272, 0, 0, 0
2521, 1, 1636428653577, 1636428653849, 272, 0, 272, 0, 0, 0
2522, 1, 1636428654045, 1636428654317, 272, 0, 272, 0, 0, 0
2523, 1, 1636428654137, 1636428654409, 272, 0, 272, 0, 0, 0
2524, 1, 1636428654580, 1636428654852, 272, 1, 271, 0, 1, 1
2525, 1, 1636428654653, 1636428655125, 472, 200, 272, 200, 0, 200
2526, 1, 1636428655457, 1636428655729, 272, 0, 272, 0, 0, 0
2527, 1, 1636428655468, 1636428655741, 273, 1, 272, 0, 0, 0
2528, 1, 1636428655973, 1636428656245, 272, 0, 272, 0, 0, 0
2529, 1, 1636428656112, 1636428656385, 273, 1, 272, 0, 0, 0
2530, 1, 1636428656620, 1636428656893, 273, 0, 273, 0, 0, 0
2531, 1, 1636428656693, 1636428657169, 476, 200, 276, 200, 0, 200
2532, 1, 1636428657352, 1636428657625, 273, 0, 273, 0, 0, 0
2533, 1, 1636428657564, 1636428657833, 269, 1, 268, 0, 1, 1
2534, 1, 1636428657860, 1636428658133, 273, 1, 272, 0, 0, 0
2535, 1, 1636428658213, 1636428658489, 276, 0, 276, 0, 0, 0
2536, 1, 1636428659441, 1636428659713, 272, 0, 272, 0, 0, 0
2537, 1, 1636428659457, 1636428659729, 272, 0, 272, 0, 0, 0
2538, 1, 1636428659961, 1636428660233, 272, 0, 272, 0, 0, 0
2539, 1, 1636428660104, 1636428660369, 265, 1, 264, 0, 0, 0
2540, 1, 1636428661333, 1636428661609, 276, 0, 276, 0, 0, 0
2541, 1, 1636428661529, 1636428661801, 272, 0, 272, 0, 0, 0
2542, 1, 1636428661837, 1636428662109, 272, 0, 272, 0, 0, 0
2543, 1, 1636428662241, 1636428662513, 272, 0, 272, 0, 0, 0
2544, 1, 1636428663373, 1636428663645, 272, 0, 272, 0, 0, 0
2545, 1, 1636428663925, 1636428664196, 271, 0, 271, 0, 0, 0
