Xid, State, StartTime, EndTime, TransactionTime, ExecuteTime, CommunicationTime, ReadTime, WriteTime, DBTime
1, 1, 1636413930415, 1636413930934, 519, 93, 426, 43, 5, 48
2, 1, 1636413931299, 1636413931719, 420, 4, 416, 2, 0, 2
3, 1, 1636413932035, 1636413932455, 420, 5, 415, 2, 1, 3
4, 1, 1636413932767, 1636413933187, 420, 4, 416, 2, 1, 3
5, 1, 1636413933495, 1636413933907, 412, 2, 410, 0, 1, 1
6, 1, 1636413934223, 1636413934631, 408, 2, 406, 2, 0, 2
7, 1, 1636413934947, 1636413935367, 420, 4, 416, 3, 0, 3
8, 1, 1636413935679, 1636413936091, 412, 3, 409, 0, 1, 1
9, 1, 1636413936403, 1636413936819, 416, 3, 413, 2, 0, 2
10, 1, 1636413937131, 1636413937547, 416, 3, 413, 1, 0, 1
11, 1, 1636413937859, 1636413938271, 412, 3, 409, 2, 1, 3
12, 1, 1636413938579, 1636413938995, 416, 3, 413, 0, 1, 1
13, 1, 1636413939307, 1636413939719, 412, 2, 410, 1, 0, 1
15, 1, 1636413940031, 1636413940422, 391, 3, 388, 0, 1, 1
17, 1, 1636413940731, 1636413941143, 412, 1, 411, 0, 0, 0
19, 1, 1636413941459, 1636413941876, 417, 4, 413, 0, 0, 0
21, 1, 1636413942143, 1636413942499, 356, 3, 353, 0, 0, 0
23, 1, 1636413942767, 1636413943131, 364, 2, 362, 0, 1, 1
25, 1, 1636413943395, 1636413943747, 352, 3, 349, 0, 0, 0
27, 1, 1636413944015, 1636413944367, 352, 1, 351, 0, 0, 0
28, 1, 1636413944631, 1636413944991, 360, 2, 358, 1, 1, 2
30, 1, 1636413945259, 1636413945618, 359, 1, 358, 0, 1, 1
32, 1, 1636413945883, 1636413946243, 360, 2, 358, 0, 0, 0
34, 1, 1636413946507, 1636413946862, 355, 3, 352, 0, 0, 0
36, 1, 1636413947127, 1636413947487, 360, 3, 357, 0, 0, 0
38, 1, 1636413947755, 1636413948107, 352, 2, 350, 0, 0, 0
40, 1, 1636413948375, 1636413948722, 347, 2, 345, 0, 0, 0
42, 1, 1636413948987, 1636413949343, 356, 2, 354, 0, 0, 0
45, 1, 1636413949606, 1636413949967, 361, 2, 359, 1, 1, 2
48, 1, 1636413950231, 1636413950583, 352, 0, 352, 0, 0, 0
51, 1, 1636413950847, 1636413951202, 355, 0, 355, 0, 0, 0
54, 1, 1636413951463, 1636413951815, 352, 1, 351, 0, 0, 0
56, 1, 1636413952079, 1636413952431, 352, 0, 352, 0, 0, 0
59, 1, 1636413952695, 1636413953055, 360, 0, 360, 0, 0, 0
62, 1, 1636413953323, 1636413953678, 355, 0, 355, 0, 0, 0
65, 1, 1636413953942, 1636413954298, 356, 3, 353, 3, 0, 3
68, 1, 1636413954563, 1636413954923, 360, 1, 359, 1, 0, 1
71, 1, 1636413955186, 1636413955547, 361, 1, 360, 0, 0, 0
74, 1, 1636413955810, 1636413956167, 357, 2, 355, 0, 0, 0
77, 1, 1636413956431, 1636413956787, 356, 0, 356, 0, 0, 0
80, 1, 1636413957051, 1636413957402, 351, 1, 350, 0, 0, 0
83, 1, 1636413957666, 1636413958022, 356, 1, 355, 1, 0, 1
86, 1, 1636413958287, 1636413958643, 356, 0, 356, 0, 0, 0
89, 1, 1636413958907, 1636413959266, 359, 1, 358, 0, 0, 0
92, 1, 1636413959534, 1636413959887, 353, 1, 352, 1, 0, 1
95, 1, 1636413960150, 1636413960506, 356, 3, 353, 0, 0, 0
98, 1, 1636413960770, 1636413961126, 356, 3, 353, 2, 0, 2
101, 1, 1636413961391, 1636413961746, 355, 0, 355, 0, 0, 0
104, 1, 1636413962011, 1636413962367, 356, 1, 355, 0, 0, 0
107, 1, 1636413962639, 1636413962987, 348, 2, 346, 1, 0, 1
110, 1, 1636413963250, 1636413963607, 357, 3, 354, 0, 0, 0
113, 1, 1636413963874, 1636413964234, 360, 2, 358, 0, 0, 0
116, 1, 1636413964503, 1636413964854, 351, 2, 349, 1, 0, 1
119, 1, 1636413965118, 1636413965467, 349, 3, 346, 1, 0, 1
122, 1, 1636413965730, 1636413966083, 353, 2, 351, 0, 0, 0
125, 1, 1636413966347, 1636413966699, 352, 0, 352, 0, 0, 0
128, 1, 1636413966963, 1636413967315, 352, 2, 350, 1, 0, 1
131, 1, 1636413967578, 1636413967923, 345, 2, 343, 0, 0, 0
134, 1, 1636413968187, 1636413968543, 356, 0, 356, 0, 0, 0
137, 1, 1636413968807, 1636413969163, 356, 0, 356, 0, 0, 0
140, 1, 1636413969426, 1636413969774, 348, 2, 346, 1, 0, 1
143, 1, 1636413970039, 1636413970395, 356, 1, 355, 0, 0, 0
146, 1, 1636413970658, 1636413971019, 361, 3, 358, 0, 0, 0
149, 1, 1636413971283, 1636413971630, 347, 1, 346, 0, 0, 0
152, 1, 1636413971895, 1636413972255, 360, 2, 358, 0, 0, 0
155, 1, 1636413972519, 1636413972871, 352, 2, 350, 0, 0, 0
158, 1, 1636413973134, 1636413973487, 353, 2, 351, 0, 0, 0
161, 1, 1636413973750, 1636413974099, 349, 1, 348, 0, 0, 0
164, 1, 1636413974362, 1636413974706, 344, 2, 342, 1, 0, 1
167, 1, 1636413974970, 1636413975327, 357, 3, 354, 0, 0, 0
170, 1, 1636413975590, 1636413975934, 344, 2, 342, 0, 0, 0
173, 1, 1636413976198, 1636413976547, 349, 3, 346, 0, 0, 0
176, 1, 1636413976814, 1636413977167, 353, 2, 351, 0, 1, 1
179, 1, 1636413977431, 1636413977786, 355, 0, 355, 0, 0, 0
182, 1, 1636413978051, 1636413978398, 347, 2, 345, 2, 0, 2
185, 1, 1636413978662, 1636413979007, 345, 2, 343, 1, 0, 1
188, 1, 1636413979270, 1636413979614, 344, 2, 342, 0, 0, 0
191, 1, 1636413979878, 1636413980231, 353, 1, 352, 1, 0, 1
194, 1, 1636413980494, 1636413980847, 353, 1, 352, 0, 0, 0
197, 1, 1636413981106, 1636413981458, 352, 2, 350, 0, 0, 0
200, 1, 1636413981723, 1636413982067, 344, 0, 344, 0, 0, 0
203, 1, 1636413982331, 1636413982691, 360, 2, 358, 0, 0, 0
206, 1, 1636413982955, 1636413983315, 360, 0, 360, 0, 0, 0
209, 1, 1636413983578, 1636413983926, 348, 2, 346, 0, 0, 0
212, 1, 1636413984191, 1636413984538, 347, 2, 345, 0, 0, 0
215, 1, 1636413984803, 1636413985158, 355, 2, 353, 0, 0, 0
218, 1, 1636413985422, 1636413985779, 357, 2, 355, 1, 0, 1
221, 1, 1636413986042, 1636413986394, 352, 3, 349, 1, 0, 1
224, 1, 1636413986658, 1636413987006, 348, 3, 345, 0, 0, 0
227, 1, 1636413987270, 1636413987622, 352, 3, 349, 1, 0, 1
230, 1, 1636413987886, 1636413988238, 352, 1, 351, 1, 0, 1
233, 1, 1636413988502, 1636413988850, 348, 2, 346, 0, 0, 0
236, 1, 1636413989115, 1636413989462, 347, 1, 346, 0, 0, 0
239, 1, 1636413989726, 1636413990086, 360, 1, 359, 0, 0, 0
242, 1, 1636413990350, 1636413990703, 353, 3, 350, 0, 1, 1
245, 1, 1636413990967, 1636413991318, 351, 1, 350, 0, 0, 0
248, 1, 1636413991582, 1636413991930, 348, 3, 345, 1, 0, 1
251, 1, 1636413992194, 1636413992542, 348, 3, 345, 1, 1, 2
254, 1, 1636413992806, 1636413993154, 348, 2, 346, 1, 0, 1
257, 1, 1636413993418, 1636413993774, 356, 3, 353, 1, 0, 1
301, 1, 1636414578926, 1636414579391, 465, 12, 453, 0, 0, 0
302, 1, 1636414580259, 1636414580662, 403, 0, 403, 0, 0, 0
303, 1, 1636414580838, 1636414581247, 409, 1, 408, 0, 1, 1
304, 1, 1636414581242, 1636414581654, 412, 1, 411, 0, 0, 0
305, 1, 1636414582174, 1636414582571, 397, 2, 395, 0, 0, 0
306, 1, 1636414582206, 1636414582606, 400, 0, 400, 0, 0, 0
307, 1, 1636414582722, 1636414583131, 409, 2, 407, 0, 0, 0
308, 1, 1636414583102, 1636414583503, 401, 1, 400, 0, 0, 0
309, 1, 1636414584074, 1636414584470, 396, 1, 395, 0, 0, 0
310, 1, 1636414584102, 1636414584506, 404, 1, 403, 0, 0, 0
311, 1, 1636414584734, 1636414585134, 400, 1, 399, 0, 0, 0
312, 1, 1636414584998, 1636414585399, 401, 1, 400, 1, 0, 1
313, 1, 1636414585970, 1636414586366, 396, 0, 396, 0, 0, 0
314, 1, 1636414586118, 1636414586527, 409, 1, 408, 0, 0, 0
315, 1, 1636414586802, 1636414587207, 405, 0, 405, 0, 0, 0
316, 1, 1636414587098, 1636414587506, 408, 2, 406, 0, 0, 0
317, 1, 1636414588030, 1636414588302, 272, 1, 271, 0, 0, 0
318, 1, 1636414588122, 1636414588391, 269, 1, 268, 0, 0, 0
319, 1, 1636414588758, 1636414589034, 276, 1, 275, 0, 0, 0
320, 1, 1636414589102, 1636414589370, 268, 1, 267, 1, 0, 1
321, 1, 1636414590031, 1636414590294, 263, 0, 263, 0, 0, 0
323, 1, 1636414590874, 1636414591150, 276, 1, 275, 1, 0, 1
325, 1, 1636414592146, 1636414592414, 268, 1, 267, 0, 0, 0
326, 1, 1636414592934, 1636414593207, 273, 1, 272, 0, 0, 0
327, 1, 1636414594206, 1636414594479, 273, 1, 272, 1, 0, 1
328, 1, 1636414595006, 1636414595271, 265, 1, 264, 1, 0, 1
329, 1, 1636414596278, 1636414596542, 264, 1, 263, 0, 0, 0
330, 1, 1636414596310, 1636414596574, 264, 1, 263, 1, 0, 1
331, 1, 1636414597070, 1636414597342, 272, 1, 271, 0, 0, 0
332, 1, 1636414598307, 1636414598575, 268, 0, 268, 0, 0, 0
333, 1, 1636414598402, 1636414598666, 264, 1, 263, 0, 0, 0
334, 1, 1636414599058, 1636414599330, 272, 1, 271, 1, 0, 1
322, 2, 1636414590155, 1636414600391, 10236, 141, 10095, 141, 2, 143
335, 1, 1636414600254, 1636414600574, 320, 1, 319, 0, 1, 1
336, 1, 1636414600270, 1636414600574, 304, 0, 304, 0, 0, 0
324, 1, 1636414590970, 1636414600662, 9692, 9423, 269, 9421, 1, 9422
337, 1, 1636414600774, 1636414601046, 272, 0, 272, 0, 0, 0
338, 1, 1636414600930, 1636414601314, 384, 119, 265, 119, 0, 119
339, 1, 1636414601078, 1636414601342, 264, 0, 264, 0, 0, 0
340, 1, 1636414602250, 1636414602515, 265, 1, 264, 0, 1, 1
341, 1, 1636414602282, 1636414602546, 264, 1, 263, 0, 0, 0
342, 1, 1636414602658, 1636414602931, 273, 1, 272, 0, 0, 0
343, 1, 1636414602826, 1636414603099, 273, 1, 272, 0, 0, 0
344, 1, 1636414602930, 1636414603195, 265, 1, 264, 0, 0, 0
345, 1, 1636414604202, 1636414604474, 272, 1, 271, 1, 0, 1
346, 1, 1636414604346, 1636414604622, 276, 1, 275, 0, 1, 1
347, 1, 1636414604606, 1636414604871, 265, 1, 264, 0, 0, 0
348, 1, 1636414604870, 1636414605134, 264, 1, 263, 0, 0, 0
349, 1, 1636414604898, 1636414605162, 264, 0, 264, 0, 0, 0
350, 1, 1636414606214, 1636414606490, 276, 1, 275, 1, 0, 1
351, 1, 1636414606274, 1636414606538, 264, 1, 263, 0, 0, 0
352, 1, 1636414606570, 1636414606834, 264, 1, 263, 0, 1, 1
353, 1, 1636414606810, 1636414607082, 272, 1, 271, 1, 0, 1
354, 1, 1636414606830, 1636414607098, 268, 0, 268, 0, 0, 0
355, 1, 1636414608202, 1636414608474, 272, 1, 271, 0, 1, 1
356, 1, 1636414608334, 1636414608602, 268, 1, 267, 0, 0, 0
357, 1, 1636414608450, 1636414608718, 268, 0, 268, 0, 0, 0
358, 1, 1636414608698, 1636414608966, 268, 1, 267, 0, 0, 0
359, 1, 1636414608970, 1636414609234, 264, 0, 264, 0, 0, 0
360, 1, 1636414610338, 1636414610602, 264, 1, 263, 0, 0, 0
361, 1, 1636414610342, 1636414610606, 264, 1, 263, 0, 0, 0
363, 1, 1636414610750, 1636414611019, 269, 1, 268, 0, 0, 0
364, 1, 1636414610926, 1636414611195, 269, 0, 269, 0, 0, 0
365, 1, 1636414612250, 1636414612523, 273, 1, 272, 0, 0, 0
366, 1, 1636414612394, 1636414612663, 269, 1, 268, 0, 1, 1
367, 1, 1636414612806, 1636414613074, 268, 1, 267, 0, 0, 0
368, 1, 1636414612878, 1636414613147, 269, 1, 268, 0, 0, 0
369, 1, 1636414614202, 1636414614470, 268, 1, 267, 0, 0, 0
370, 1, 1636414614530, 1636414614798, 268, 1, 267, 0, 1, 1
371, 1, 1636414614806, 1636414615074, 268, 1, 267, 0, 0, 0
372, 1, 1636414614974, 1636414615246, 272, 0, 272, 0, 0, 0
373, 1, 1636414616302, 1636414616571, 269, 1, 268, 0, 0, 0
374, 1, 1636414616538, 1636414616806, 268, 1, 267, 1, 0, 1
375, 1, 1636414616806, 1636414617078, 272, 1, 271, 1, 0, 1
376, 1, 1636414617018, 1636414617290, 272, 0, 272, 0, 0, 0
377, 1, 1636414618346, 1636414618623, 277, 1, 276, 0, 0, 0
378, 1, 1636414618538, 1636414618802, 264, 1, 263, 0, 1, 1
379, 1, 1636414618798, 1636414619066, 268, 1, 267, 0, 1, 1
380, 1, 1636414618998, 1636414619266, 268, 0, 268, 0, 0, 0
381, 1, 1636414620306, 1636414620570, 264, 1, 263, 0, 1, 1
362, 2, 1636414610390, 1636414620783, 10393, 217, 10176, 217, 1, 218
382, 1, 1636414620522, 1636414620923, 401, 1, 400, 0, 0, 0
383, 1, 1636414620698, 1636414621102, 404, 1, 403, 0, 1, 1
384, 1, 1636414620970, 1636414621238, 268, 0, 268, 0, 0, 0
385, 1, 1636414621201, 1636414621470, 269, 1, 268, 0, 0, 0
386, 1, 1636414622282, 1636414622550, 268, 1, 267, 0, 0, 0
387, 1, 1636414622502, 1636414622770, 268, 1, 267, 0, 0, 0
388, 1, 1636414622750, 1636414623018, 268, 1, 267, 0, 0, 0
389, 1, 1636414622766, 1636414623034, 268, 1, 267, 1, 0, 1
390, 1, 1636414623046, 1636414623314, 268, 1, 267, 0, 1, 1
391, 1, 1636414624170, 1636414624446, 276, 1, 275, 0, 1, 1
392, 1, 1636414624598, 1636414624863, 265, 1, 264, 0, 1, 1
393, 1, 1636414624706, 1636414624974, 268, 0, 268, 0, 0, 0
394, 1, 1636414624758, 1636414625022, 264, 1, 263, 0, 0, 0
395, 1, 1636414624934, 1636414625202, 268, 1, 267, 0, 1, 1
396, 1, 1636414626114, 1636414626387, 273, 1, 272, 0, 0, 0
397, 1, 1636414626606, 1636414626874, 268, 1, 267, 0, 0, 0
398, 1, 1636414626710, 1636414626974, 264, 1, 263, 0, 1, 1
399, 1, 1636414626874, 1636414627138, 264, 0, 264, 0, 0, 0
400, 1, 1636414626986, 1636414627254, 268, 1, 267, 0, 0, 0
401, 1, 1636414628234, 1636414628499, 265, 0, 265, 0, 0, 0
402, 1, 1636414628622, 1636414628890, 268, 1, 267, 1, 0, 1
403, 1, 1636414628718, 1636414628982, 264, 1, 263, 0, 0, 0
404, 1, 1636414628806, 1636414629070, 264, 0, 264, 0, 0, 0
405, 1, 1636414629038, 1636414629302, 264, 0, 264, 0, 0, 0
406, 1, 1636414630243, 1636414630514, 271, 0, 271, 0, 0, 0
407, 1, 1636414630554, 1636414630831, 277, 0, 277, 0, 0, 0
408, 1, 1636414630670, 1636414630934, 264, 1, 263, 0, 1, 1
409, 1, 1636414630690, 1636414630958, 268, 1, 267, 0, 0, 0
410, 1, 1636414631162, 1636414631430, 268, 1, 267, 0, 0, 0
411, 1, 1636414632199, 1636414632475, 276, 0, 276, 0, 0, 0
412, 1, 1636414632530, 1636414632802, 272, 0, 272, 0, 0, 0
413, 1, 1636414632638, 1636414632902, 264, 1, 263, 0, 0, 0
414, 1, 1636414632670, 1636414632946, 276, 1, 275, 0, 0, 0
415, 1, 1636414633162, 1636414633435, 273, 1, 272, 1, 0, 1
416, 1, 1636414634174, 1636414634446, 272, 1, 271, 0, 0, 0
417, 1, 1636414634498, 1636414634762, 264, 1, 263, 0, 1, 1
418, 1, 1636414634610, 1636414634878, 268, 1, 267, 0, 0, 0
419, 1, 1636414634718, 1636414634983, 265, 0, 265, 0, 0, 0
420, 1, 1636414635154, 1636414635422, 268, 1, 267, 0, 0, 0
421, 1, 1636414636178, 1636414636450, 272, 1, 271, 0, 0, 0
422, 1, 1636414636470, 1636414636735, 265, 0, 265, 0, 0, 0
423, 1, 1636414636735, 1636414637002, 267, 0, 267, 0, 0, 0
424, 1, 1636414636846, 1636414637114, 268, 0, 268, 0, 0, 0
425, 1, 1636414637054, 1636414637318, 264, 0, 264, 0, 0, 0
426, 1, 1636414638290, 1636414638563, 273, 1, 272, 0, 0, 0
427, 1, 1636414638598, 1636414638862, 264, 0, 264, 0, 0, 0
428, 1, 1636414638690, 1636414638959, 269, 0, 269, 0, 0, 0
429, 1, 1636414638814, 1636414639086, 272, 1, 271, 0, 0, 0
430, 1, 1636414639138, 1636414639406, 268, 1, 267, 0, 0, 0
431, 1, 1636414640258, 1636414640530, 272, 0, 272, 0, 0, 0
432, 1, 1636414640546, 1636414640818, 272, 0, 272, 0, 0, 0
434, 1, 1636414640798, 1636414641062, 264, 1, 263, 0, 1, 1
433, 1, 1636414640594, 1636414641082, 488, 225, 263, 225, 0, 225
435, 1, 1636414641146, 1636414641411, 265, 1, 264, 0, 0, 0
436, 1, 1636414642246, 1636414642519, 273, 1, 272, 0, 0, 0
437, 1, 1636414642455, 1636414642719, 264, 0, 264, 0, 0, 0
438, 1, 1636414642518, 1636414642783, 265, 1, 264, 0, 0, 0
439, 1, 1636414642770, 1636414643043, 273, 1, 272, 0, 0, 0
440, 1, 1636414643262, 1636414643538, 276, 1, 275, 0, 0, 0
441, 1, 1636414644130, 1636414644402, 272, 1, 271, 0, 0, 0
442, 1, 1636414644331, 1636414644598, 267, 0, 267, 0, 0, 0
443, 1, 1636414644443, 1636414644715, 272, 0, 272, 0, 0, 0
444, 1, 1636414644806, 1636414645074, 268, 1, 267, 0, 0, 0
445, 1, 1636414645198, 1636414645471, 273, 1, 272, 0, 0, 0
446, 1, 1636414646170, 1636414646438, 268, 1, 267, 1, 0, 1
447, 1, 1636414646198, 1636414646462, 264, 1, 263, 0, 0, 0
448, 1, 1636414646530, 1636414646798, 268, 1, 267, 0, 0, 0
449, 1, 1636414646706, 1636414646974, 268, 1, 267, 0, 1, 1
450, 1, 1636414647166, 1636414647434, 268, 0, 268, 0, 0, 0
451, 1, 1636414648158, 1636414648426, 268, 1, 267, 0, 0, 0
452, 1, 1636414648282, 1636414648546, 264, 0, 264, 0, 0, 0
453, 1, 1636414648398, 1636414648667, 269, 0, 269, 0, 0, 0
454, 1, 1636414648822, 1636414649094, 272, 1, 271, 0, 1, 1
455, 1, 1636414649114, 1636414649387, 273, 0, 273, 0, 0, 0
456, 1, 1636414650238, 1636414650506, 268, 1, 267, 0, 1, 1
457, 1, 1636414650270, 1636414650538, 268, 1, 267, 0, 0, 0
458, 1, 1636414650278, 1636414650546, 268, 1, 267, 1, 0, 1
459, 1, 1636414650706, 1636414650975, 269, 1, 268, 0, 0, 0
460, 1, 1636414651106, 1636414651375, 269, 0, 269, 0, 0, 0
461, 1, 1636414652110, 1636414652379, 269, 1, 268, 0, 0, 0
462, 1, 1636414652162, 1636414652430, 268, 1, 267, 0, 1, 1
463, 1, 1636414652354, 1636414652623, 269, 1, 268, 0, 0, 0
464, 1, 1636414652658, 1636414652923, 265, 1, 264, 0, 0, 0
465, 1, 1636414653202, 1636414653471, 269, 1, 268, 0, 0, 0
466, 1, 1636414654114, 1636414654386, 272, 1, 271, 0, 0, 0
467, 1, 1636414654146, 1636414654415, 269, 1, 268, 0, 0, 0
468, 1, 1636414654250, 1636414654522, 272, 0, 272, 0, 0, 0
469, 1, 1636414654766, 1636414655035, 269, 1, 268, 0, 0, 0
470, 1, 1636414655154, 1636414655422, 268, 0, 268, 0, 0, 0
471, 1, 1636414656046, 1636414656310, 264, 1, 263, 1, 0, 1
472, 1, 1636414656194, 1636414656458, 264, 1, 263, 0, 0, 0
473, 1, 1636414656214, 1636414656482, 268, 1, 267, 0, 0, 0
474, 1, 1636414656771, 1636414657035, 264, 0, 264, 0, 0, 0
475, 1, 1636414657058, 1636414657323, 265, 0, 265, 0, 0, 0
476, 1, 1636414657978, 1636414658246, 268, 1, 267, 0, 0, 0
477, 1, 1636414658218, 1636414658482, 264, 1, 263, 1, 0, 1
478, 1, 1636414658234, 1636414658498, 264, 0, 264, 0, 0, 0
479, 1, 1636414658898, 1636414659166, 268, 0, 268, 0, 0, 0
480, 1, 1636414658938, 1636414659207, 269, 1, 268, 1, 0, 1
481, 1, 1636414660002, 1636414660274, 272, 1, 271, 0, 0, 0
482, 1, 1636414660298, 1636414660570, 272, 1, 271, 0, 1, 1
483, 1, 1636414660342, 1636414660614, 272, 0, 272, 0, 0, 0
484, 1, 1636414660802, 1636414661066, 264, 1, 263, 0, 1, 1
485, 1, 1636414660818, 1636414661086, 268, 0, 268, 0, 0, 0
486, 1, 1636414662066, 1636414662334, 268, 1, 267, 0, 0, 0
487, 1, 1636414662262, 1636414662534, 272, 1, 271, 0, 0, 0
488, 1, 1636414662298, 1636414662562, 264, 1, 263, 1, 0, 1
489, 1, 1636414662794, 1636414663062, 268, 1, 267, 0, 0, 0
490, 1, 1636414662918, 1636414663190, 272, 1, 271, 0, 0, 0
491, 1, 1636414664066, 1636414664331, 265, 1, 264, 1, 0, 1
492, 1, 1636414664198, 1636414664466, 268, 1, 267, 0, 0, 0
493, 1, 1636414664310, 1636414664579, 269, 1, 268, 0, 0, 0
494, 1, 1636414664790, 1636414665062, 272, 1, 271, 0, 0, 0
495, 1, 1636414664922, 1636414665194, 272, 1, 271, 0, 1, 1
496, 1, 1636414666074, 1636414666346, 272, 1, 271, 0, 0, 0
497, 1, 1636414666322, 1636414666590, 268, 1, 267, 0, 0, 0
498, 1, 1636414666430, 1636414666698, 268, 1, 267, 0, 1, 1
499, 1, 1636414666718, 1636414666986, 268, 1, 267, 0, 0, 0
500, 1, 1636414667022, 1636414667286, 264, 1, 263, 0, 1, 1
501, 1, 1636414668195, 1636414668462, 267, 0, 267, 0, 0, 0
502, 1, 1636414668375, 1636414668643, 268, 0, 268, 0, 0, 0
503, 1, 1636414668510, 1636414668778, 268, 1, 267, 0, 0, 0
504, 1, 1636414668758, 1636414669027, 269, 1, 268, 0, 1, 1
505, 1, 1636414669010, 1636414669282, 272, 1, 271, 1, 0, 1
506, 1, 1636414670274, 1636414670542, 268, 1, 267, 1, 0, 1
507, 1, 1636414670290, 1636414670558, 268, 1, 267, 0, 0, 0
508, 1, 1636414670550, 1636414670815, 265, 0, 265, 0, 0, 0
509, 1, 1636414670654, 1636414670919, 265, 1, 264, 0, 0, 0
510, 1, 1636414671122, 1636414671394, 272, 1, 271, 0, 0, 0
511, 1, 1636414672318, 1636414672582, 264, 1, 263, 0, 0, 0
512, 1, 1636414672402, 1636414672674, 272, 1, 271, 0, 0, 0
513, 1, 1636414672590, 1636414672854, 264, 0, 264, 0, 0, 0
514, 1, 1636414672658, 1636414672922, 264, 1, 263, 0, 0, 0
515, 1, 1636414673198, 1636414673470, 272, 1, 271, 0, 0, 0
516, 1, 1636414674422, 1636414674694, 272, 1, 271, 0, 0, 0
517, 1, 1636414674478, 1636414674746, 268, 1, 267, 0, 0, 0
518, 1, 1636414674630, 1636414674898, 268, 1, 267, 0, 0, 0
519, 1, 1636414674710, 1636414674974, 264, 0, 264, 0, 0, 0
520, 1, 1636414675090, 1636414675358, 268, 1, 267, 0, 0, 0
521, 1, 1636414676438, 1636414676706, 268, 1, 267, 0, 0, 0
522, 1, 1636414676470, 1636414676738, 268, 1, 267, 0, 0, 0
523, 1, 1636414676630, 1636414676898, 268, 0, 268, 0, 0, 0
524, 1, 1636414676690, 1636414676954, 264, 0, 264, 0, 0, 0
525, 1, 1636414676982, 1636414677254, 272, 0, 272, 0, 0, 0
526, 1, 1636414678362, 1636414678630, 268, 1, 267, 0, 0, 0
527, 1, 1636414678366, 1636414678630, 264, 1, 263, 0, 1, 1
528, 1, 1636414678534, 1636414678806, 272, 1, 271, 0, 0, 0
529, 1, 1636414678810, 1636414679075, 265, 0, 265, 0, 0, 0
530, 1, 1636414679046, 1636414679314, 268, 1, 267, 1, 0, 1
531, 1, 1636414680346, 1636414680619, 273, 1, 272, 0, 0, 0
532, 1, 1636414680406, 1636414680670, 264, 0, 264, 0, 0, 0
533, 1, 1636414680478, 1636414680750, 272, 0, 272, 0, 0, 0
534, 1, 1636414680822, 1636414681086, 264, 1, 263, 1, 0, 1
535, 1, 1636414681082, 1636414681350, 268, 1, 267, 0, 0, 0
536, 1, 1636414682290, 1636414682566, 276, 1, 275, 0, 1, 1
537, 1, 1636414682434, 1636414682710, 276, 1, 275, 0, 0, 0
538, 1, 1636414682574, 1636414682847, 273, 0, 273, 0, 0, 0
539, 1, 1636414682942, 1636414683219, 277, 1, 276, 0, 0, 0
540, 1, 1636414683102, 1636414683370, 268, 1, 267, 0, 0, 0
541, 1, 1636414684350, 1636414684618, 268, 1, 267, 0, 0, 0
542, 1, 1636414684454, 1636414684718, 264, 0, 264, 0, 0, 0
543, 1, 1636414684458, 1636414684730, 272, 0, 272, 0, 0, 0
544, 1, 1636414684974, 1636414685246, 272, 1, 271, 0, 0, 0
545, 1, 1636414685054, 1636414685326, 272, 1, 271, 0, 0, 0
546, 1, 1636414686254, 1636414686523, 269, 1, 268, 0, 0, 0
547, 1, 1636414686403, 1636414686670, 267, 0, 267, 0, 0, 0
548, 1, 1636414686558, 1636414686831, 273, 1, 272, 0, 0, 0
549, 1, 1636414687018, 1636414687287, 269, 0, 269, 0, 0, 0
550, 1, 1636414687147, 1636414687414, 267, 0, 267, 0, 0, 0
551, 1, 1636414688350, 1636414688618, 268, 1, 267, 0, 0, 0
552, 1, 1636414688498, 1636414688766, 268, 1, 267, 1, 0, 1
553, 1, 1636414688670, 1636414688934, 264, 1, 263, 1, 0, 1
554, 1, 1636414689114, 1636414689382, 268, 1, 267, 0, 0, 0
555, 1, 1636414689158, 1636414689426, 268, 0, 268, 0, 0, 0
556, 1, 1636414690414, 1636414690683, 269, 1, 268, 0, 0, 0
557, 1, 1636414690542, 1636414690815, 273, 0, 273, 0, 0, 0
558, 1, 1636414690594, 1636414690862, 268, 1, 267, 0, 1, 1
559, 1, 1636414691134, 1636414691406, 272, 0, 272, 0, 0, 0
560, 1, 1636414691206, 1636414691470, 264, 1, 263, 0, 1, 1
561, 1, 1636414692298, 1636414692563, 265, 1, 264, 0, 0, 0
562, 1, 1636414692594, 1636414692863, 269, 1, 268, 1, 0, 1
563, 1, 1636414692654, 1636414692922, 268, 1, 267, 1, 0, 1
564, 1, 1636414693054, 1636414693318, 264, 1, 263, 1, 0, 1
565, 1, 1636414693182, 1636414693450, 268, 0, 268, 0, 0, 0
566, 1, 1636414694386, 1636414694658, 272, 1, 271, 0, 0, 0
567, 1, 1636414694594, 1636414694866, 272, 0, 272, 0, 0, 0
568, 1, 1636414694790, 1636414695062, 272, 1, 271, 0, 0, 0
569, 1, 1636414694954, 1636414695222, 268, 1, 267, 0, 0, 0
570, 1, 1636414695246, 1636414695510, 264, 0, 264, 0, 0, 0
571, 1, 1636414696522, 1636414696786, 264, 1, 263, 0, 0, 0
572, 1, 1636414696631, 1636414696894, 263, 0, 263, 0, 0, 0
573, 1, 1636414696722, 1636414696986, 264, 1, 263, 0, 0, 0
574, 1, 1636414696898, 1636414697167, 269, 1, 268, 0, 0, 0
575, 1, 1636414697315, 1636414697587, 272, 0, 272, 0, 0, 0
576, 1, 1636414698399, 1636414698670, 271, 0, 271, 0, 0, 0
577, 1, 1636414698698, 1636414698966, 268, 1, 267, 0, 0, 0
578, 1, 1636414698814, 1636414699082, 268, 1, 267, 0, 0, 0
579, 1, 1636414698994, 1636414699258, 264, 1, 263, 1, 0, 1
580, 1, 1636414699354, 1636414699622, 268, 1, 267, 0, 1, 1
581, 1, 1636414700402, 1636414700674, 272, 1, 271, 0, 0, 0
582, 1, 1636414700718, 1636414700986, 268, 0, 268, 0, 0, 0
583, 1, 1636414700830, 1636414701102, 272, 1, 271, 0, 0, 0
584, 1, 1636414700898, 1636414701166, 268, 0, 268, 0, 0, 0
585, 1, 1636414701442, 1636414701714, 272, 0, 272, 0, 0, 0
586, 1, 1636414702306, 1636414702578, 272, 1, 271, 0, 0, 0
587, 1, 1636414702678, 1636414702950, 272, 1, 271, 1, 0, 1
588, 1, 1636414702918, 1636414703183, 265, 1, 264, 1, 0, 1
589, 1, 1636414702990, 1636414703254, 264, 0, 264, 0, 0, 0
590, 1, 1636414703354, 1636414703619, 265, 1, 264, 0, 0, 0
591, 1, 1636414704266, 1636414704538, 272, 0, 272, 0, 0, 0
592, 1, 1636414704590, 1636414704863, 273, 0, 273, 0, 0, 0
593, 1, 1636414704894, 1636414705162, 268, 1, 267, 0, 0, 0
594, 1, 1636414705102, 1636414705374, 272, 0, 272, 0, 0, 0
595, 1, 1636414705394, 1636414705663, 269, 1, 268, 0, 0, 0
596, 1, 1636414706178, 1636414706454, 276, 1, 275, 0, 0, 0
597, 1, 1636414706562, 1636414706835, 273, 0, 273, 0, 0, 0
598, 1, 1636414706930, 1636414707198, 268, 1, 267, 0, 0, 0
599, 1, 1636414706990, 1636414707258, 268, 1, 267, 0, 0, 0
600, 1, 1636414707402, 1636414707674, 272, 1, 271, 0, 0, 0
601, 1, 1636414708130, 1636414708399, 269, 1, 268, 0, 0, 0
602, 1, 1636414708490, 1636414708754, 264, 0, 264, 0, 0, 0
603, 1, 1636414708946, 1636414709214, 268, 1, 267, 0, 0, 0
604, 1, 1636414709051, 1636414709318, 267, 0, 267, 0, 0, 0
605, 1, 1636414709438, 1636414709710, 272, 0, 272, 0, 0, 0
606, 1, 1636414710114, 1636414710386, 272, 1, 271, 0, 0, 0
607, 1, 1636414710442, 1636414710710, 268, 1, 267, 1, 0, 1
608, 1, 1636414710978, 1636414711250, 272, 1, 271, 1, 0, 1
609, 1, 1636414711186, 1636414711450, 264, 1, 263, 0, 0, 0
610, 1, 1636414711338, 1636414711602, 264, 1, 263, 0, 0, 0
611, 1, 1636414712034, 1636414712302, 268, 1, 267, 0, 0, 0
612, 1, 1636414712382, 1636414712650, 268, 1, 267, 0, 0, 0
613, 1, 1636414712886, 1636414713158, 272, 1, 271, 0, 0, 0
614, 1, 1636414713067, 1636414713330, 263, 0, 263, 0, 0, 0
615, 1, 1636414713238, 1636414713502, 264, 0, 264, 0, 0, 0
616, 1, 1636414713962, 1636414714235, 273, 1, 272, 0, 0, 0
617, 1, 1636414714326, 1636414714599, 273, 0, 273, 0, 0, 0
618, 1, 1636414714766, 1636414715035, 269, 1, 268, 1, 0, 1
619, 1, 1636414715154, 1636414715419, 265, 0, 265, 0, 0, 0
620, 1, 1636414715154, 1636414715419, 265, 0, 265, 0, 0, 0
621, 1, 1636414715930, 1636414716199, 269, 1, 268, 0, 0, 0
622, 1, 1636414716222, 1636414716495, 273, 1, 272, 1, 0, 1
623, 1, 1636414716650, 1636414716918, 268, 1, 267, 1, 0, 1
624, 1, 1636414717030, 1636414717298, 268, 1, 267, 0, 0, 0
625, 1, 1636414717094, 1636414717366, 272, 1, 271, 0, 1, 1
626, 1, 1636414717826, 1636414718098, 272, 1, 271, 0, 0, 0
627, 1, 1636414718290, 1636414718562, 272, 0, 272, 0, 0, 0
628, 1, 1636414718646, 1636414718914, 268, 0, 268, 0, 0, 0
629, 1, 1636414719054, 1636414719322, 268, 0, 268, 0, 0, 0
630, 1, 1636414719142, 1636414719410, 268, 0, 268, 0, 0, 0
631, 1, 1636414719894, 1636414720158, 264, 1, 263, 0, 1, 1
632, 1, 1636414720274, 1636414720546, 272, 1, 271, 0, 0, 0
633, 1, 1636414720730, 1636414720998, 268, 1, 267, 0, 0, 0
634, 1, 1636414720986, 1636414721259, 273, 1, 272, 0, 0, 0
635, 1, 1636414721114, 1636414721390, 276, 0, 276, 0, 0, 0
636, 1, 1636414721814, 1636414722086, 272, 1, 271, 0, 0, 0
637, 1, 1636414722227, 1636414722490, 263, 0, 263, 0, 0, 0
638, 1, 1636414722702, 1636414722970, 268, 1, 267, 0, 0, 0
639, 1, 1636414722958, 1636414723223, 265, 1, 264, 0, 0, 0
640, 1, 1636414723038, 1636414723306, 268, 1, 267, 0, 0, 0
641, 1, 1636414723766, 1636414724038, 272, 1, 271, 0, 0, 0
642, 1, 1636414724158, 1636414724434, 276, 1, 275, 1, 0, 1
643, 1, 1636414724622, 1636414724890, 268, 1, 267, 0, 1, 1
644, 1, 1636414724938, 1636414725202, 264, 1, 263, 0, 0, 0
645, 1, 1636414725154, 1636414725426, 272, 1, 271, 0, 0, 0
646, 1, 1636414725759, 1636414726035, 276, 0, 276, 0, 0, 0
647, 1, 1636414726142, 1636414726415, 273, 1, 272, 0, 0, 0
648, 1, 1636414726686, 1636414726950, 264, 1, 263, 0, 0, 0
649, 1, 1636414726890, 1636414727158, 268, 0, 268, 0, 0, 0
650, 1, 1636414727086, 1636414727354, 268, 0, 268, 0, 0, 0
651, 1, 1636414727743, 1636414728019, 276, 0, 276, 0, 0, 0
652, 1, 1636414728182, 1636414728450, 268, 1, 267, 0, 0, 0
653, 1, 1636414728638, 1636414728906, 268, 1, 267, 0, 0, 0
654, 1, 1636414728814, 1636414729082, 268, 1, 267, 0, 1, 1
655, 1, 1636414728986, 1636414729258, 272, 1, 271, 0, 0, 0
656, 1, 1636414729746, 1636414730014, 268, 1, 267, 1, 0, 1
657, 1, 1636414730290, 1636414730562, 272, 1, 271, 0, 0, 0
658, 1, 1636414730538, 1636414730806, 268, 1, 267, 1, 0, 1
659, 1, 1636414730754, 1636414731022, 268, 1, 267, 0, 0, 0
660, 1, 1636414730890, 1636414731158, 268, 1, 267, 0, 0, 0
661, 1, 1636414731854, 1636414732126, 272, 0, 272, 0, 0, 0
662, 1, 1636414732158, 1636414732426, 268, 1, 267, 1, 0, 1
663, 1, 1636414732442, 1636414732706, 264, 1, 263, 1, 0, 1
664, 1, 1636414732698, 1636414732967, 269, 1, 268, 0, 0, 0
665, 1, 1636414733010, 1636414733279, 269, 0, 269, 0, 0, 0
666, 1, 1636414733722, 1636414733986, 264, 1, 263, 1, 0, 1
667, 1, 1636414734150, 1636414734419, 269, 1, 268, 0, 0, 0
668, 1, 1636414734578, 1636414734846, 268, 1, 267, 0, 0, 0
669, 1, 1636414734766, 1636414735030, 264, 1, 263, 0, 0, 0
670, 1, 1636414735078, 1636414735354, 276, 1, 275, 0, 1, 1
671, 1, 1636414735682, 1636414735954, 272, 1, 271, 0, 0, 0
672, 1, 1636414736098, 1636414736366, 268, 1, 267, 0, 0, 0
673, 1, 1636414736646, 1636414736910, 264, 0, 264, 0, 0, 0
674, 1, 1636414736682, 1636414736950, 268, 0, 268, 0, 0, 0
675, 1, 1636414737098, 1636414737375, 277, 1, 276, 0, 0, 0
676, 1, 1636414737630, 1636414737899, 269, 0, 269, 0, 0, 0
677, 1, 1636414738067, 1636414738343, 276, 0, 276, 0, 0, 0
678, 1, 1636414738638, 1636414738906, 268, 1, 267, 0, 0, 0
679, 1, 1636414738718, 1636414738982, 264, 1, 263, 0, 0, 0
680, 1, 1636414739046, 1636414739318, 272, 1, 271, 0, 1, 1
681, 1, 1636414739578, 1636414739850, 272, 1, 271, 0, 0, 0
682, 1, 1636414739970, 1636414740234, 264, 1, 263, 0, 1, 1
683, 1, 1636414740630, 1636414740898, 268, 1, 267, 0, 0, 0
684, 1, 1636414740698, 1636414740970, 272, 1, 271, 0, 0, 0
685, 1, 1636414741070, 1636414741347, 277, 0, 277, 0, 0, 0
686, 1, 1636414741482, 1636414741750, 268, 1, 267, 0, 0, 0
687, 1, 1636414742098, 1636414742374, 276, 1, 275, 0, 1, 1
688, 1, 1636414742610, 1636414742882, 272, 0, 272, 0, 0, 0
689, 1, 1636414742718, 1636414742982, 264, 1, 263, 0, 0, 0
690, 1, 1636414742938, 1636414743214, 276, 0, 276, 0, 0, 0
691, 1, 1636414743502, 1636414743766, 264, 1, 263, 0, 1, 1
692, 1, 1636414744014, 1636414744286, 272, 1, 271, 0, 0, 0
693, 1, 1636414744618, 1636414744886, 268, 0, 268, 0, 0, 0
694, 1, 1636414744650, 1636414744918, 268, 0, 268, 0, 0, 0
695, 1, 1636414745066, 1636414745330, 264, 0, 264, 0, 0, 0
696, 1, 1636414745438, 1636414745706, 268, 0, 268, 0, 0, 0
697, 1, 1636414746083, 1636414746358, 275, 0, 275, 0, 0, 0
698, 1, 1636414746742, 1636414747022, 280, 1, 279, 0, 0, 0
699, 1, 1636414746758, 1636414747026, 268, 1, 267, 0, 1, 1
700, 1, 1636414746966, 1636414747234, 268, 1, 267, 0, 0, 0
701, 1, 1636414747506, 1636414747774, 268, 0, 268, 0, 0, 0
702, 1, 1636414748190, 1636414748466, 276, 0, 276, 0, 0, 0
703, 1, 1636414748626, 1636414748894, 268, 1, 267, 0, 0, 0
704, 1, 1636414748650, 1636414748918, 268, 1, 267, 0, 0, 0
705, 1, 1636414749038, 1636414749315, 277, 1, 276, 0, 0, 0
706, 1, 1636414749614, 1636414749886, 272, 1, 271, 1, 0, 1
707, 1, 1636414750130, 1636414750402, 272, 0, 272, 0, 0, 0
708, 1, 1636414750618, 1636414750894, 276, 0, 276, 0, 0, 0
709, 1, 1636414750718, 1636414750982, 264, 1, 263, 1, 0, 1
710, 1, 1636414751142, 1636414751415, 273, 1, 272, 0, 0, 0
711, 1, 1636414751542, 1636414751810, 268, 1, 267, 0, 0, 0
712, 1, 1636414752026, 1636414752298, 272, 1, 271, 0, 0, 0
713, 1, 1636414752566, 1636414752838, 272, 1, 271, 0, 0, 0
714, 1, 1636414752798, 1636414753066, 268, 1, 267, 0, 1, 1
715, 1, 1636414753106, 1636414753379, 273, 1, 272, 1, 0, 1
716, 1, 1636414753470, 1636414753742, 272, 1, 271, 0, 0, 0
717, 1, 1636414754078, 1636414754350, 272, 1, 271, 1, 0, 1
718, 1, 1636414754514, 1636414754790, 276, 1, 275, 0, 0, 0
719, 1, 1636414754754, 1636414755022, 268, 0, 268, 0, 0, 0
720, 1, 1636414755030, 1636414755302, 272, 0, 272, 0, 0, 0
721, 1, 1636414755522, 1636414755794, 272, 0, 272, 0, 0, 0
722, 1, 1636414756026, 1636414756302, 276, 1, 275, 1, 0, 1
723, 1, 1636414756434, 1636414756706, 272, 0, 272, 0, 0, 0
724, 1, 1636414756678, 1636414756946, 268, 1, 267, 0, 0, 0
725, 1, 1636414756942, 1636414757214, 272, 1, 271, 1, 0, 1
726, 1, 1636414757470, 1636414757738, 268, 1, 267, 0, 0, 0
727, 1, 1636414757906, 1636414758182, 276, 1, 275, 0, 0, 0
728, 1, 1636414758454, 1636414758726, 272, 1, 271, 1, 0, 1
729, 1, 1636414758594, 1636414758862, 268, 0, 268, 0, 0, 0
730, 1, 1636414758914, 1636414759187, 273, 0, 273, 0, 0, 0
731, 1, 1636414759406, 1636414759678, 272, 1, 271, 0, 1, 1
732, 1, 1636414759966, 1636414760238, 272, 1, 271, 0, 0, 0
733, 1, 1636414760370, 1636414760638, 268, 1, 267, 1, 0, 1
734, 1, 1636414760570, 1636414760846, 276, 1, 275, 1, 0, 1
735, 1, 1636414760794, 1636414761066, 272, 1, 271, 0, 0, 0
736, 1, 1636414761462, 1636414761738, 276, 1, 275, 0, 1, 1
737, 1, 1636414762038, 1636414762310, 272, 1, 271, 0, 0, 0
738, 1, 1636414762442, 1636414762710, 268, 0, 268, 0, 0, 0
739, 1, 1636414762466, 1636414762734, 268, 1, 267, 1, 0, 1
740, 1, 1636414762806, 1636414763074, 268, 1, 267, 1, 0, 1
741, 1, 1636414763534, 1636414763802, 268, 1, 267, 0, 0, 0
742, 1, 1636414764078, 1636414764346, 268, 1, 267, 0, 0, 0
743, 1, 1636414764474, 1636414764738, 264, 1, 263, 0, 0, 0
744, 1, 1636414764550, 1636414764818, 268, 1, 267, 0, 0, 0
745, 1, 1636414764754, 1636414765091, 337, 65, 272, 65, 0, 65
746, 1, 1636414765574, 1636414765846, 272, 1, 271, 1, 0, 1
747, 1, 1636414765958, 1636414766235, 277, 1, 276, 0, 0, 0
748, 1, 1636414766446, 1636414766710, 264, 1, 263, 0, 1, 1
749, 1, 1636414766478, 1636414766742, 264, 1, 263, 0, 0, 0
750, 1, 1636414766862, 1636414767139, 277, 1, 276, 1, 0, 1
751, 1, 1636414767454, 1636414767730, 276, 1, 275, 0, 0, 0
752, 1, 1636414767934, 1636414768210, 276, 1, 275, 0, 0, 0
753, 1, 1636414768358, 1636414768626, 268, 1, 267, 1, 0, 1
754, 1, 1636414768446, 1636414768714, 268, 1, 267, 0, 1, 1
755, 1, 1636414768934, 1636414769210, 276, 0, 276, 0, 0, 0
756, 1, 1636414769430, 1636414769707, 277, 0, 277, 0, 0, 0
757, 1, 1636414769842, 1636414770118, 276, 0, 276, 0, 0, 0
758, 1, 1636414770414, 1636414770686, 272, 0, 272, 0, 0, 0
759, 1, 1636414770522, 1636414770790, 268, 1, 267, 0, 1, 1
760, 1, 1636414771070, 1636414771342, 272, 1, 271, 0, 1, 1
761, 1, 1636414771338, 1636414771610, 272, 1, 271, 0, 0, 0
762, 1, 1636414771734, 1636414772006, 272, 0, 272, 0, 0, 0
763, 1, 1636414772358, 1636414772630, 272, 1, 271, 0, 0, 0
764, 1, 1636414772658, 1636414772934, 276, 0, 276, 0, 0, 0
765, 1, 1636414773102, 1636414773374, 272, 1, 271, 0, 0, 0
766, 1, 1636414773230, 1636414773498, 268, 1, 267, 0, 0, 0
767, 1, 1636414773726, 1636414773998, 272, 1, 271, 0, 1, 1
768, 1, 1636414774294, 1636414774567, 273, 1, 272, 0, 0, 0
769, 1, 1636414774690, 1636414774958, 268, 1, 267, 0, 0, 0
770, 1, 1636414775222, 1636414775498, 276, 0, 276, 0, 0, 0
771, 1, 1636414775238, 1636414775502, 264, 1, 263, 0, 1, 1
772, 1, 1636414775711, 1636414775982, 271, 0, 271, 0, 0, 0
773, 1, 1636414776354, 1636414776627, 273, 0, 273, 0, 0, 0
774, 1, 1636414776822, 1636414777098, 276, 1, 275, 0, 0, 0
775, 1, 1636414777102, 1636414777370, 268, 1, 267, 0, 0, 0
776, 1, 1636414777310, 1636414777586, 276, 1, 275, 0, 1, 1
777, 1, 1636414777678, 1636414777946, 268, 1, 267, 0, 0, 0
778, 1, 1636414778422, 1636414778694, 272, 1, 271, 0, 0, 0
779, 1, 1636414778894, 1636414779170, 276, 1, 275, 0, 0, 0
780, 1, 1636414779070, 1636414779342, 272, 1, 271, 0, 0, 0
781, 1, 1636414779674, 1636414779942, 268, 0, 268, 0, 0, 0
782, 1, 1636414780466, 1636414780738, 272, 1, 271, 0, 0, 0
783, 1, 1636414781070, 1636414781342, 272, 1, 271, 1, 0, 1
784, 1, 1636414781730, 1636414782002, 272, 1, 271, 1, 0, 1
785, 1, 1636414782342, 1636414782614, 272, 1, 271, 1, 0, 1
786, 1, 1636414783123, 1636414783399, 276, 0, 276, 0, 0, 0
787, 1, 1636414783838, 1636414784110, 272, 0, 272, 0, 0, 0
788, 1, 1636414784286, 1636414784562, 276, 1, 275, 0, 0, 0
789, 1, 1636414785230, 1636414785498, 268, 0, 268, 0, 0, 0
790, 1, 1636414785754, 1636414786018, 264, 0, 264, 0, 0, 0
791, 1, 1636414786194, 1636414786462, 268, 1, 267, 0, 1, 1
792, 1, 1636414787146, 1636414787418, 272, 1, 271, 1, 0, 1
793, 1, 1636414788086, 1636414788362, 276, 1, 275, 0, 1, 1
794, 1, 1636414790078, 1636414790342, 264, 1, 263, 0, 1, 1
795, 1, 1636414792026, 1636414792298, 272, 1, 271, 1, 0, 1
796, 1, 1636414793994, 1636414794258, 264, 0, 264, 0, 0, 0
797, 1, 1636414795902, 1636414796174, 272, 0, 272, 0, 0, 0
798, 1, 1636414797958, 1636414798230, 272, 0, 272, 0, 0, 0
799, 1, 1636414800066, 1636414800334, 268, 1, 267, 0, 1, 1
800, 1, 1636414801982, 1636414802254, 272, 0, 272, 0, 0, 0
801, 1, 1636415774130, 1636415774406, 276, 1, 275, 1, 0, 1
802, 1, 1636415775026, 1636415775298, 272, 1, 271, 1, 0, 1
803, 1, 1636415775318, 1636415775594, 276, 0, 276, 0, 0, 0
804, 1, 1636415776078, 1636415776350, 272, 1, 271, 0, 0, 0
805, 1, 1636415776238, 1636415776514, 276, 1, 275, 1, 0, 1
806, 1, 1636415776562, 1636415776834, 272, 0, 272, 0, 0, 0
807, 1, 1636415776634, 1636415776910, 276, 0, 276, 0, 0, 0
808, 1, 1636415777134, 1636415777406, 272, 1, 271, 0, 0, 0
809, 1, 1636415777294, 1636415777570, 276, 1, 275, 0, 0, 0
810, 1, 1636415777482, 1636415777758, 276, 0, 276, 0, 0, 0
811, 1, 1636415777822, 1636415778094, 272, 0, 272, 0, 0, 0
812, 1, 1636415777830, 1636415778098, 268, 0, 268, 0, 0, 0
813, 1, 1636415778346, 1636415778618, 272, 0, 272, 0, 0, 0
814, 1, 1636415778538, 1636415778810, 272, 1, 271, 1, 0, 1
815, 1, 1636415778746, 1636415779022, 276, 0, 276, 0, 0, 0
816, 1, 1636415779070, 1636415779342, 272, 0, 272, 0, 0, 0
817, 1, 1636415779118, 1636415779394, 276, 0, 276, 0, 0, 0
818, 1, 1636415779590, 1636415779866, 276, 1, 275, 0, 0, 0
819, 1, 1636415779802, 1636415780078, 276, 0, 276, 0, 0, 0
820, 1, 1636415780030, 1636415780302, 272, 1, 271, 1, 0, 1
821, 1, 1636415780302, 1636415780570, 268, 1, 267, 1, 0, 1
822, 1, 1636415780330, 1636415780602, 272, 0, 272, 0, 0, 0
823, 1, 1636415780854, 1636415781130, 276, 1, 275, 1, 0, 1
824, 1, 1636415781086, 1636415781358, 272, 0, 272, 0, 0, 0
825, 1, 1636415781270, 1636415781630, 360, 89, 271, 89, 0, 89
826, 1, 1636415781570, 1636415781847, 277, 0, 277, 0, 0, 0
827, 1, 1636415781610, 1636415781902, 292, 21, 271, 21, 0, 21
828, 1, 1636415782138, 1636415782414, 276, 1, 275, 1, 0, 1
829, 1, 1636415782330, 1636415782694, 364, 85, 279, 85, 0, 85
830, 1, 1636415782558, 1636415782834, 276, 0, 276, 0, 0, 0
831, 1, 1636415782854, 1636415783130, 276, 0, 276, 0, 0, 0
832, 1, 1636415782862, 1636415783138, 276, 0, 276, 0, 0, 0
833, 1, 1636415783382, 1636415783658, 276, 1, 275, 1, 0, 1
834, 1, 1636415783614, 1636415783890, 276, 0, 276, 0, 0, 0
835, 1, 1636415783842, 1636415784118, 276, 1, 275, 1, 0, 1
836, 1, 1636415784110, 1636415784387, 277, 0, 277, 0, 0, 0
837, 1, 1636415784170, 1636415784446, 276, 0, 276, 0, 0, 0
838, 1, 1636415784638, 1636415784914, 276, 0, 276, 0, 0, 0
839, 1, 1636415784922, 1636415785198, 276, 1, 275, 0, 0, 0
840, 1, 1636415785098, 1636415785374, 276, 1, 275, 0, 1, 1
841, 1, 1636415785362, 1636415785638, 276, 1, 275, 0, 0, 0
842, 1, 1636415785458, 1636415785730, 272, 1, 271, 0, 1, 1
843, 1, 1636415785926, 1636415786202, 276, 1, 275, 1, 0, 1
844, 1, 1636415786178, 1636415786450, 272, 0, 272, 0, 0, 0
845, 1, 1636415786350, 1636415786626, 276, 0, 276, 0, 0, 0
846, 1, 1636415786554, 1636415786830, 276, 1, 275, 0, 0, 0
847, 1, 1636415786714, 1636415786990, 276, 0, 276, 0, 0, 0
848, 1, 1636415787182, 1636415787458, 276, 0, 276, 0, 0, 0
849, 1, 1636415787430, 1636415787706, 276, 1, 275, 0, 0, 0
850, 1, 1636415787542, 1636415787814, 272, 1, 271, 0, 1, 1
851, 1, 1636415787746, 1636415788018, 272, 1, 271, 0, 1, 1
852, 1, 1636415788030, 1636415788310, 280, 0, 280, 0, 0, 0
853, 1, 1636415788494, 1636415788770, 276, 1, 275, 1, 0, 1
854, 1, 1636415788622, 1636415788898, 276, 0, 276, 0, 0, 0
855, 1, 1636415788734, 1636415789006, 272, 1, 271, 0, 0, 0
856, 1, 1636415788962, 1636415789238, 276, 0, 276, 0, 0, 0
857, 1, 1636415789270, 1636415789546, 276, 0, 276, 0, 0, 0
858, 1, 1636415789686, 1636415789962, 276, 1, 275, 1, 0, 1
859, 1, 1636415789850, 1636415790118, 268, 0, 268, 0, 0, 0
860, 1, 1636415789986, 1636415790266, 280, 1, 279, 0, 0, 0
861, 1, 1636415790266, 1636415790542, 276, 1, 275, 1, 0, 1
862, 1, 1636415790462, 1636415790742, 280, 0, 280, 0, 0, 0
863, 1, 1636415790878, 1636415791154, 276, 0, 276, 0, 0, 0
864, 1, 1636415791062, 1636415791338, 276, 0, 276, 0, 0, 0
865, 1, 1636415791250, 1636415791522, 272, 1, 271, 1, 0, 1
866, 1, 1636415791490, 1636415791766, 276, 0, 276, 0, 0, 0
867, 1, 1636415791706, 1636415791983, 277, 1, 276, 1, 0, 1
868, 1, 1636415792094, 1636415792370, 276, 1, 275, 0, 0, 0
869, 1, 1636415792370, 1636415792650, 280, 1, 279, 0, 0, 0
870, 1, 1636415792474, 1636415792746, 272, 1, 271, 1, 0, 1
871, 1, 1636415792754, 1636415793030, 276, 0, 276, 0, 0, 0
872, 1, 1636415793014, 1636415793290, 276, 0, 276, 0, 0, 0
873, 1, 1636415793370, 1636415793643, 273, 0, 273, 0, 0, 0
874, 1, 1636415793602, 1636415793878, 276, 1, 275, 0, 0, 0
875, 1, 1636415793750, 1636415794026, 276, 0, 276, 0, 0, 0
876, 1, 1636415793966, 1636415794234, 268, 1, 267, 0, 1, 1
877, 1, 1636415794246, 1636415794522, 276, 0, 276, 0, 0, 0
878, 1, 1636415794590, 1636415794863, 273, 0, 273, 0, 0, 0
879, 1, 1636415794862, 1636415795134, 272, 1, 271, 0, 0, 0
880, 1, 1636415794970, 1636415795250, 280, 1, 279, 1, 0, 1
881, 1, 1636415795190, 1636415795463, 273, 0, 273, 0, 0, 0
882, 1, 1636415795510, 1636415795786, 276, 0, 276, 0, 0, 0
883, 1, 1636415795870, 1636415796146, 276, 1, 275, 1, 0, 1
884, 1, 1636415796086, 1636415796362, 276, 1, 275, 1, 0, 1
885, 1, 1636415796198, 1636415796478, 280, 0, 280, 0, 0, 0
886, 1, 1636415796486, 1636415796758, 272, 0, 272, 0, 0, 0
887, 1, 1636415796722, 1636415796994, 272, 0, 272, 0, 0, 0
888, 1, 1636415797082, 1636415797350, 268, 1, 267, 0, 0, 0
889, 1, 1636415797306, 1636415797578, 272, 0, 272, 0, 0, 0
890, 1, 1636415797490, 1636415797766, 276, 0, 276, 0, 0, 0
891, 1, 1636415797750, 1636415798026, 276, 0, 276, 0, 0, 0
892, 1, 1636415797951, 1636415798226, 275, 0, 275, 0, 0, 0
893, 1, 1636415798302, 1636415798578, 276, 0, 276, 0, 0, 0
894, 1, 1636415798606, 1636415798878, 272, 1, 271, 0, 0, 0
895, 1, 1636415798774, 1636415799051, 277, 0, 277, 0, 0, 0
896, 1, 1636415798950, 1636415799226, 276, 1, 275, 0, 0, 0
897, 1, 1636415799242, 1636415799518, 276, 1, 275, 0, 0, 0
898, 1, 1636415799602, 1636415799878, 276, 1, 275, 0, 0, 0
899, 1, 1636415799870, 1636415800146, 276, 1, 275, 0, 0, 0
900, 1, 1636415799974, 1636415800254, 280, 1, 279, 0, 0, 0
901, 1, 1636415800166, 1636415800438, 272, 0, 272, 0, 0, 0
902, 1, 1636415800526, 1636415800802, 276, 1, 275, 1, 0, 1
903, 1, 1636415800886, 1636415801162, 276, 0, 276, 0, 0, 0
904, 1, 1636415801070, 1636415801346, 276, 1, 275, 0, 0, 0
905, 1, 1636415801166, 1636415801438, 272, 1, 271, 0, 1, 1
906, 1, 1636415801386, 1636415801662, 276, 0, 276, 0, 0, 0
907, 1, 1636415801722, 1636415801998, 276, 0, 276, 0, 0, 0
908, 1, 1636415802086, 1636415802362, 276, 0, 276, 0, 0, 0
909, 1, 1636415802282, 1636415802558, 276, 0, 276, 0, 0, 0
910, 1, 1636415802390, 1636415802666, 276, 1, 275, 0, 0, 0
911, 1, 1636415802622, 1636415802898, 276, 0, 276, 0, 0, 0
912, 1, 1636415802934, 1636415803210, 276, 1, 275, 0, 0, 0
913, 1, 1636415803298, 1636415803574, 276, 1, 275, 0, 0, 0
914, 1, 1636415803506, 1636415803778, 272, 1, 271, 1, 0, 1
915, 1, 1636415803622, 1636415803898, 276, 0, 276, 0, 0, 0
916, 1, 1636415803914, 1636415804194, 280, 0, 280, 0, 0, 0
917, 1, 1636415804166, 1636415804446, 280, 0, 280, 0, 0, 0
918, 1, 1636415804522, 1636415804794, 272, 1, 271, 0, 1, 1
919, 1, 1636415804758, 1636415805038, 280, 0, 280, 0, 0, 0
920, 1, 1636415804922, 1636415805198, 276, 1, 275, 1, 0, 1
921, 1, 1636415805206, 1636415805486, 280, 0, 280, 0, 0, 0
922, 1, 1636415805398, 1636415805674, 276, 1, 275, 0, 0, 0
923, 1, 1636415805774, 1636415806050, 276, 0, 276, 0, 0, 0
924, 1, 1636415806054, 1636415806326, 272, 1, 271, 0, 1, 1
925, 1, 1636415806210, 1636415806486, 276, 1, 275, 0, 0, 0
926, 1, 1636415806398, 1636415806674, 276, 1, 275, 1, 0, 1
927, 1, 1636415806662, 1636415806938, 276, 0, 276, 0, 0, 0
928, 1, 1636415807070, 1636415807342, 272, 0, 272, 0, 0, 0
929, 1, 1636415807306, 1636415807582, 276, 0, 276, 0, 0, 0
930, 1, 1636415807398, 1636415807670, 272, 0, 272, 0, 0, 0
931, 1, 1636415807610, 1636415807886, 276, 1, 275, 1, 0, 1
932, 1, 1636415807958, 1636415808238, 280, 1, 279, 0, 1, 1
933, 1, 1636415808318, 1636415808594, 276, 1, 275, 0, 1, 1
934, 1, 1636415808502, 1636415808774, 272, 0, 272, 0, 0, 0
935, 1, 1636415808590, 1636415808858, 268, 0, 268, 0, 0, 0
936, 1, 1636415808866, 1636415809138, 272, 0, 272, 0, 0, 0
937, 1, 1636415809146, 1636415809414, 268, 0, 268, 0, 0, 0
938, 1, 1636415809522, 1636415809798, 276, 0, 276, 0, 0, 0
939, 1, 1636415809694, 1636415809962, 268, 1, 267, 0, 0, 0
940, 1, 1636415809870, 1636415810150, 280, 0, 280, 0, 0, 0
941, 1, 1636415810134, 1636415810406, 272, 0, 272, 0, 0, 0
942, 1, 1636415810334, 1636415810610, 276, 0, 276, 0, 0, 0
943, 1, 1636415810734, 1636415811010, 276, 0, 276, 0, 0, 0
944, 1, 1636415810978, 1636415811254, 276, 0, 276, 0, 0, 0
945, 1, 1636415811158, 1636415811434, 276, 0, 276, 0, 0, 0
946, 1, 1636415811370, 1636415811642, 272, 1, 271, 1, 0, 1
947, 1, 1636415811618, 1636415811890, 272, 1, 271, 0, 0, 0
948, 1, 1636415811986, 1636415812262, 276, 1, 275, 0, 0, 0
949, 1, 1636415812266, 1636415812538, 272, 0, 272, 0, 0, 0
950, 1, 1636415812398, 1636415812674, 276, 1, 275, 1, 0, 1
951, 1, 1636415812590, 1636415812858, 268, 0, 268, 0, 0, 0
952, 1, 1636415812886, 1636415813159, 273, 0, 273, 0, 0, 0
953, 1, 1636415813254, 1636415813530, 276, 1, 275, 1, 0, 1
954, 1, 1636415813502, 1636415813778, 276, 0, 276, 0, 0, 0
955, 1, 1636415813614, 1636415813886, 272, 1, 271, 0, 1, 1
956, 1, 1636415813778, 1636415814046, 268, 1, 267, 1, 0, 1
957, 1, 1636415814122, 1636415814390, 268, 1, 267, 0, 0, 0
958, 1, 1636415814490, 1636415814766, 276, 1, 275, 0, 0, 0
959, 1, 1636415814714, 1636415814982, 268, 1, 267, 0, 1, 1
960, 1, 1636415814806, 1636415815075, 269, 0, 269, 0, 0, 0
961, 1, 1636415815074, 1636415815354, 280, 1, 279, 0, 0, 0
962, 1, 1636415815374, 1636415815650, 276, 1, 275, 0, 1, 1
963, 1, 1636415815710, 1636415815986, 276, 0, 276, 0, 0, 0
964, 1, 1636415815898, 1636415816166, 268, 0, 268, 0, 0, 0
965, 1, 1636415816098, 1636415816378, 280, 0, 280, 0, 0, 0
966, 1, 1636415816286, 1636415816562, 276, 0, 276, 0, 0, 0
967, 1, 1636415816618, 1636415816894, 276, 0, 276, 0, 0, 0
968, 1, 1636415816898, 1636415817170, 272, 0, 272, 0, 0, 0
969, 1, 1636415817190, 1636415817470, 280, 0, 280, 0, 0, 0
970, 1, 1636415817314, 1636415817594, 280, 1, 279, 0, 1, 1
971, 1, 1636415817578, 1636415817854, 276, 0, 276, 0, 0, 0
972, 1, 1636415817910, 1636415818178, 268, 0, 268, 0, 0, 0
973, 1, 1636415818194, 1636415818466, 272, 0, 272, 0, 0, 0
974, 1, 1636415818410, 1636415818682, 272, 0, 272, 0, 0, 0
975, 1, 1636415818566, 1636415818842, 276, 0, 276, 0, 0, 0
976, 1, 1636415818818, 1636415819094, 276, 0, 276, 0, 0, 0
977, 1, 1636415819114, 1636415819390, 276, 0, 276, 0, 0, 0
978, 1, 1636415819394, 1636415819670, 276, 1, 275, 0, 1, 1
979, 1, 1636415819658, 1636415819935, 277, 0, 277, 0, 0, 0
980, 1, 1636415819802, 1636415820074, 272, 1, 271, 1, 0, 1
981, 1, 1636415820030, 1636415820298, 268, 0, 268, 0, 0, 0
982, 1, 1636415820406, 1636415820682, 276, 1, 275, 1, 0, 1
983, 1, 1636415820690, 1636415820966, 276, 0, 276, 0, 0, 0
984, 1, 1636415820894, 1636415821170, 276, 0, 276, 0, 0, 0
985, 1, 1636415821038, 1636415821314, 276, 0, 276, 0, 0, 0
986, 1, 1636415821314, 1636415821582, 268, 1, 267, 0, 1, 1
987, 1, 1636415821646, 1636415821922, 276, 0, 276, 0, 0, 0
988, 1, 1636415821926, 1636415822202, 276, 0, 276, 0, 0, 0
989, 1, 1636415822134, 1636415822411, 277, 1, 276, 0, 0, 0
990, 1, 1636415822322, 1636415822602, 280, 0, 280, 0, 0, 0
991, 1, 1636415822582, 1636415822854, 272, 1, 271, 0, 1, 1
992, 1, 1636415822858, 1636415823134, 276, 0, 276, 0, 0, 0
993, 1, 1636415823162, 1636415823438, 276, 1, 275, 1, 0, 1
994, 1, 1636415823414, 1636415823690, 276, 1, 275, 0, 1, 1
995, 1, 1636415823626, 1636415823902, 276, 0, 276, 0, 0, 0
996, 1, 1636415823834, 1636415824110, 276, 1, 275, 1, 0, 1
997, 1, 1636415824142, 1636415824414, 272, 0, 272, 0, 0, 0
998, 1, 1636415824446, 1636415824722, 276, 1, 275, 1, 0, 1
999, 1, 1636415824682, 1636415824954, 272, 1, 271, 0, 1, 1
1000, 1, 1636415824882, 1636415825154, 272, 0, 272, 0, 0, 0
1001, 1, 1636415825082, 1636415825362, 280, 0, 280, 0, 0, 0
1002, 1, 1636415825406, 1636415825682, 276, 0, 276, 0, 0, 0
1003, 1, 1636415825714, 1636415825986, 272, 0, 272, 0, 0, 0
1004, 1, 1636415825938, 1636415826218, 280, 1, 279, 0, 0, 0
1005, 1, 1636415826126, 1636415826402, 276, 1, 275, 1, 0, 1
1006, 1, 1636415826282, 1636415826554, 272, 0, 272, 0, 0, 0
1007, 1, 1636415826714, 1636415826990, 276, 1, 275, 0, 1, 1
1008, 1, 1636415826966, 1636415827262, 296, 25, 271, 25, 0, 25
1009, 1, 1636415827154, 1636415827426, 272, 1, 271, 0, 0, 0
1010, 1, 1636415827330, 1636415827602, 272, 0, 272, 0, 0, 0
1011, 1, 1636415827550, 1636415827822, 272, 1, 271, 0, 1, 1
1012, 1, 1636415827962, 1636415828234, 272, 0, 272, 0, 0, 0
1013, 1, 1636415828186, 1636415828506, 320, 48, 272, 48, 0, 48
1014, 1, 1636415828358, 1636415828622, 264, 0, 264, 0, 0, 0
1015, 1, 1636415828594, 1636415828862, 268, 0, 268, 0, 0, 0
1016, 1, 1636415828834, 1636415829106, 272, 0, 272, 0, 0, 0
1017, 1, 1636415829166, 1636415829438, 272, 0, 272, 0, 0, 0
1018, 1, 1636415829394, 1636415829710, 316, 45, 271, 45, 0, 45
1019, 1, 1636415829658, 1636415829930, 272, 0, 272, 0, 0, 0
1020, 1, 1636415829862, 1636415830134, 272, 1, 271, 1, 0, 1
1021, 1, 1636415830078, 1636415830354, 276, 1, 275, 1, 0, 1
1022, 1, 1636415830430, 1636415830702, 272, 1, 271, 0, 1, 1
1023, 1, 1636415830662, 1636415830978, 316, 41, 275, 41, 0, 41
1024, 1, 1636415830942, 1636415831214, 272, 1, 271, 0, 0, 0
1025, 1, 1636415831106, 1636415831382, 276, 1, 275, 0, 0, 0
1026, 1, 1636415831378, 1636415831646, 268, 0, 268, 0, 0, 0
1027, 1, 1636415831714, 1636415831990, 276, 1, 275, 0, 0, 0
1028, 1, 1636415831962, 1636415832266, 304, 29, 275, 29, 0, 29
1029, 1, 1636415832186, 1636415832458, 272, 1, 271, 1, 0, 1
1030, 1, 1636415832406, 1636415832682, 276, 1, 275, 0, 0, 0
1031, 1, 1636415832638, 1636415832914, 276, 0, 276, 0, 0, 0
1032, 1, 1636415832958, 1636415833234, 276, 0, 276, 0, 0, 0
1033, 1, 1636415833178, 1636415833514, 336, 57, 279, 57, 0, 57
1034, 1, 1636415833486, 1636415833758, 272, 0, 272, 0, 0, 0
1035, 1, 1636415833666, 1636415833942, 276, 1, 275, 1, 0, 1
1036, 1, 1636415833878, 1636415834150, 272, 1, 271, 1, 0, 1
1037, 1, 1636415834250, 1636415834526, 276, 1, 275, 0, 0, 0
1038, 1, 1636415834438, 1636415834802, 364, 89, 275, 89, 0, 89
1039, 1, 1636415834746, 1636415835014, 268, 1, 267, 0, 0, 0
1040, 1, 1636415834906, 1636415835170, 264, 0, 264, 0, 0, 0
1041, 1, 1636415835082, 1636415835358, 276, 0, 276, 0, 0, 0
1042, 1, 1636415835530, 1636415835806, 276, 0, 276, 0, 0, 0
1043, 1, 1636415835734, 1636415836078, 344, 73, 271, 73, 0, 73
1044, 1, 1636415835986, 1636415836262, 276, 1, 275, 0, 1, 1
1045, 1, 1636415836150, 1636415836422, 272, 0, 272, 0, 0, 0
1046, 1, 1636415836374, 1636415836646, 272, 1, 271, 0, 0, 0
1047, 1, 1636415836770, 1636415837046, 276, 0, 276, 0, 0, 0
1048, 1, 1636415836966, 1636415837322, 356, 81, 275, 81, 0, 81
1049, 1, 1636415837198, 1636415837470, 272, 1, 271, 0, 0, 0
1050, 1, 1636415837430, 1636415837706, 276, 0, 276, 0, 0, 0
1051, 1, 1636415837678, 1636415837978, 300, 29, 271, 29, 0, 29
1052, 1, 1636415837978, 1636415838254, 276, 0, 276, 0, 0, 0
1053, 1, 1636415838210, 1636415838534, 324, 45, 279, 45, 0, 45
1054, 1, 1636415838478, 1636415838754, 276, 1, 275, 0, 0, 0
1055, 1, 1636415838698, 1636415839026, 328, 57, 271, 57, 0, 57
1056, 1, 1636415838982, 1636415839258, 276, 0, 276, 0, 0, 0
1057, 1, 1636415839262, 1636415839538, 276, 0, 276, 0, 0, 0
1058, 1, 1636415839478, 1636415839810, 332, 61, 271, 61, 0, 61
1059, 1, 1636415839746, 1636415840082, 336, 65, 271, 65, 0, 65
1060, 1, 1636415839990, 1636415840262, 272, 0, 272, 0, 0, 0
1061, 1, 1636415840194, 1636415840470, 276, 0, 276, 0, 0, 0
1062, 1, 1636415840530, 1636415840807, 277, 1, 276, 0, 1, 1
1063, 1, 1636415840766, 1636415841082, 316, 41, 275, 41, 0, 41
1064, 1, 1636415841038, 1636415841314, 276, 0, 276, 0, 0, 0
1065, 1, 1636415841178, 1636415841454, 276, 0, 276, 0, 0, 0
1066, 1, 1636415841478, 1636415841754, 276, 0, 276, 0, 0, 0
1067, 1, 1636415841794, 1636415842070, 276, 0, 276, 0, 0, 0
1068, 1, 1636415842042, 1636415842346, 304, 29, 275, 29, 0, 29
1069, 1, 1636415842250, 1636415842526, 276, 0, 276, 0, 0, 0
1070, 1, 1636415842462, 1636415842734, 272, 0, 272, 0, 0, 0
1071, 1, 1636415842734, 1636415843006, 272, 1, 271, 0, 0, 0
1072, 1, 1636415842986, 1636415843266, 280, 1, 279, 0, 1, 1
1073, 1, 1636415843274, 1636415843550, 276, 1, 275, 0, 0, 0
1074, 1, 1636415843534, 1636415843806, 272, 1, 271, 0, 0, 0
1075, 1, 1636415843718, 1636415843986, 268, 1, 267, 1, 0, 1
1076, 1, 1636415844006, 1636415844282, 276, 0, 276, 0, 0, 0
1077, 1, 1636415844246, 1636415844522, 276, 1, 275, 0, 1, 1
1078, 1, 1636415844558, 1636415844834, 276, 1, 275, 0, 1, 1
1079, 1, 1636415844790, 1636415845062, 272, 0, 272, 0, 0, 0
1080, 1, 1636415844970, 1636415845242, 272, 0, 272, 0, 0, 0
1081, 1, 1636415845254, 1636415845534, 280, 0, 280, 0, 0, 0
1082, 1, 1636415845510, 1636415845786, 276, 1, 275, 0, 1, 1
1083, 1, 1636415845814, 1636415846090, 276, 1, 275, 0, 1, 1
1084, 1, 1636415846062, 1636415846342, 280, 0, 280, 0, 0, 0
1085, 1, 1636415846170, 1636415846614, 444, 173, 271, 173, 0, 173
1086, 1, 1636415846522, 1636415846802, 280, 0, 280, 0, 0, 0
1087, 1, 1636415846782, 1636415847050, 268, 0, 268, 0, 0, 0
1088, 1, 1636415847070, 1636415847346, 276, 0, 276, 0, 0, 0
1089, 1, 1636415847310, 1636415847618, 308, 37, 271, 37, 0, 37
1090, 1, 1636415847450, 1636415847723, 273, 1, 272, 1, 0, 1
1091, 1, 1636415847826, 1636415848094, 268, 0, 268, 0, 0, 0
1092, 1, 1636415847978, 1636415848250, 272, 0, 272, 0, 0, 0
1093, 1, 1636415848318, 1636415848594, 276, 0, 276, 0, 0, 0
1094, 1, 1636415848602, 1636415848878, 276, 0, 276, 0, 0, 0
1095, 1, 1636415848742, 1636415849154, 412, 137, 275, 137, 0, 137
1096, 1, 1636415849138, 1636415849406, 268, 0, 268, 0, 0, 0
1097, 1, 1636415849290, 1636415849566, 276, 0, 276, 0, 0, 0
1098, 1, 1636415849630, 1636415849906, 276, 0, 276, 0, 0, 0
1099, 1, 1636415849894, 1636415850174, 280, 13, 267, 13, 0, 13
1100, 1, 1636415849994, 1636415850262, 268, 0, 268, 0, 0, 0
1101, 1, 1636415850398, 1636415850670, 272, 1, 271, 0, 0, 0
1102, 1, 1636415850578, 1636415850854, 276, 1, 275, 0, 1, 1
1103, 1, 1636415850922, 1636415851194, 272, 0, 272, 0, 0, 0
1104, 1, 1636415851143, 1636415851418, 275, 0, 275, 0, 0, 0
1105, 1, 1636415851282, 1636415851554, 272, 1, 271, 0, 1, 1
1106, 1, 1636415851634, 1636415851906, 272, 1, 271, 0, 1, 1
1107, 1, 1636415851842, 1636415852118, 276, 1, 275, 1, 0, 1
1108, 1, 1636415852182, 1636415852458, 276, 1, 275, 0, 0, 0
1109, 1, 1636415852406, 1636415852682, 276, 1, 275, 0, 0, 0
1110, 1, 1636415852522, 1636415852795, 273, 0, 273, 0, 0, 0
1111, 1, 1636415852898, 1636415853174, 276, 0, 276, 0, 0, 0
1112, 1, 1636415853110, 1636415853386, 276, 1, 275, 0, 0, 0
1113, 1, 1636415853442, 1636415853718, 276, 0, 276, 0, 0, 0
1114, 1, 1636415853650, 1636415853927, 277, 0, 277, 0, 0, 0
1115, 1, 1636415853794, 1636415854070, 276, 1, 275, 0, 0, 0
1116, 1, 1636415854174, 1636415854446, 272, 1, 271, 0, 0, 0
1117, 1, 1636415854350, 1636415854622, 272, 0, 272, 0, 0, 0
1118, 1, 1636415854678, 1636415854950, 272, 0, 272, 0, 0, 0
1119, 1, 1636415854926, 1636415855202, 276, 0, 276, 0, 0, 0
1120, 1, 1636415855070, 1636415855342, 272, 1, 271, 1, 0, 1
1121, 1, 1636415855442, 1636415855719, 277, 0, 277, 0, 0, 0
1122, 1, 1636415855610, 1636415855890, 280, 1, 279, 1, 0, 1
1123, 1, 1636415855946, 1636415856222, 276, 0, 276, 0, 0, 0
1124, 1, 1636415856202, 1636415856478, 276, 1, 275, 0, 1, 1
1125, 1, 1636415856338, 1636415856610, 272, 1, 271, 0, 0, 0
1126, 1, 1636415856666, 1636415856938, 272, 0, 272, 0, 0, 0
1127, 1, 1636415856894, 1636415857170, 276, 0, 276, 0, 0, 0
1128, 1, 1636415857218, 1636415857486, 268, 0, 268, 0, 0, 0
1129, 1, 1636415857470, 1636415857747, 277, 0, 277, 0, 0, 0
1130, 1, 1636415857546, 1636415857822, 276, 1, 275, 0, 0, 0
1131, 1, 1636415857902, 1636415858178, 276, 1, 275, 0, 0, 0
1132, 1, 1636415858182, 1636415858454, 272, 0, 272, 0, 0, 0
1133, 1, 1636415858486, 1636415858762, 276, 1, 275, 1, 0, 1
1134, 1, 1636415858694, 1636415858962, 268, 1, 267, 1, 0, 1
1135, 1, 1636415858782, 1636415859058, 276, 1, 275, 0, 0, 0
1136, 1, 1636415859098, 1636415859370, 272, 0, 272, 0, 0, 0
1137, 1, 1636415859390, 1636415859666, 276, 1, 275, 1, 0, 1
1138, 1, 1636415859694, 1636415859966, 272, 1, 271, 1, 0, 1
1139, 1, 1636415859926, 1636415860198, 272, 1, 271, 0, 0, 0
1140, 1, 1636415860006, 1636415860278, 272, 1, 271, 0, 1, 1
1141, 1, 1636415860294, 1636415860571, 277, 0, 277, 0, 0, 0
1142, 1, 1636415860626, 1636415860898, 272, 0, 272, 0, 0, 0
1143, 1, 1636415860930, 1636415861202, 272, 0, 272, 0, 0, 0
1144, 1, 1636415861154, 1636415861434, 280, 0, 280, 0, 0, 0
1145, 1, 1636415861198, 1636415861470, 272, 0, 272, 0, 0, 0
1146, 1, 1636415861598, 1636415861874, 276, 0, 276, 0, 0, 0
1147, 1, 1636415861822, 1636415862098, 276, 1, 275, 0, 1, 1
1148, 1, 1636415862154, 1636415862431, 277, 0, 277, 0, 0, 0
1149, 1, 1636415862358, 1636415862634, 276, 1, 275, 0, 0, 0
1150, 1, 1636415862502, 1636415862778, 276, 1, 275, 0, 1, 1
1151, 1, 1636415862798, 1636415863074, 276, 1, 275, 0, 0, 0
1152, 1, 1636415863018, 1636415863298, 280, 0, 280, 0, 0, 0
1153, 1, 1636415863358, 1636415863634, 276, 0, 276, 0, 0, 0
1154, 1, 1636415863658, 1636415863930, 272, 0, 272, 0, 0, 0
1155, 1, 1636415863746, 1636415864018, 272, 1, 271, 1, 0, 1
1156, 1, 1636415863994, 1636415864270, 276, 0, 276, 0, 0, 0
1157, 1, 1636415864322, 1636415864594, 272, 0, 272, 0, 0, 0
1158, 1, 1636415864662, 1636415864938, 276, 0, 276, 0, 0, 0
1159, 1, 1636415864862, 1636415865138, 276, 1, 275, 1, 0, 1
1160, 1, 1636415864938, 1636415865214, 276, 0, 276, 0, 0, 0
1161, 1, 1636415865282, 1636415865554, 272, 0, 272, 0, 0, 0
1162, 1, 1636415865522, 1636415865798, 276, 0, 276, 0, 0, 0
1163, 1, 1636415865862, 1636415866134, 272, 1, 271, 0, 1, 1
1164, 1, 1636415866114, 1636415866390, 276, 0, 276, 0, 0, 0
1165, 1, 1636415866234, 1636415866506, 272, 1, 271, 0, 0, 0
1166, 1, 1636415866482, 1636415866758, 276, 1, 275, 0, 1, 1
1167, 1, 1636415866774, 1636415867046, 272, 0, 272, 0, 0, 0
1168, 1, 1636415867058, 1636415867326, 268, 0, 268, 0, 0, 0
1169, 1, 1636415867398, 1636415867670, 272, 0, 272, 0, 0, 0
1170, 1, 1636415867434, 1636415867710, 276, 1, 275, 0, 1, 1
1171, 1, 1636415867734, 1636415868010, 276, 1, 275, 0, 0, 0
1172, 1, 1636415868066, 1636415868342, 276, 0, 276, 0, 0, 0
1173, 1, 1636415868354, 1636415868630, 276, 1, 275, 0, 1, 1
1174, 1, 1636415868602, 1636415868878, 276, 1, 275, 0, 0, 0
1175, 1, 1636415868682, 1636415868954, 272, 0, 272, 0, 0, 0
1176, 1, 1636415868962, 1636415869234, 272, 0, 272, 0, 0, 0
1177, 1, 1636415869266, 1636415869542, 276, 1, 275, 0, 0, 0
1178, 1, 1636415869590, 1636415869866, 276, 0, 276, 0, 0, 0
1179, 1, 1636415869838, 1636415870115, 277, 1, 276, 0, 0, 0
1180, 1, 1636415869898, 1636415870174, 276, 1, 275, 0, 0, 0
1181, 1, 1636415870275, 1636415870546, 271, 0, 271, 0, 0, 0
1182, 1, 1636415870514, 1636415870790, 276, 1, 275, 0, 1, 1
1183, 1, 1636415870838, 1636415871114, 276, 0, 276, 0, 0, 0
1184, 1, 1636415871054, 1636415871334, 280, 0, 280, 0, 0, 0
1185, 1, 1636415871198, 1636415871610, 412, 137, 275, 137, 0, 137
1186, 1, 1636415871570, 1636415871838, 268, 1, 267, 0, 0, 0
1187, 1, 1636415871730, 1636415872006, 276, 1, 275, 0, 0, 0
1188, 1, 1636415872054, 1636415872326, 272, 0, 272, 0, 0, 0
1189, 1, 1636415872350, 1636415872626, 276, 0, 276, 0, 0, 0
1190, 1, 1636415872474, 1636415872750, 276, 1, 275, 1, 0, 1
1191, 1, 1636415872858, 1636415873134, 276, 0, 276, 0, 0, 0
1192, 1, 1636415873046, 1636415873322, 276, 0, 276, 0, 0, 0
1193, 1, 1636415873366, 1636415873642, 276, 0, 276, 0, 0, 0
1194, 1, 1636415873650, 1636415873927, 277, 0, 277, 0, 0, 0
1195, 1, 1636415873726, 1636415874002, 276, 1, 275, 0, 1, 1
1196, 1, 1636415874050, 1636415874326, 276, 0, 276, 0, 0, 0
1197, 1, 1636415874318, 1636415874595, 277, 1, 276, 0, 0, 0
1198, 1, 1636415874642, 1636415874918, 276, 0, 276, 0, 0, 0
1199, 1, 1636415874898, 1636415875166, 268, 0, 268, 0, 0, 0
1200, 1, 1636415874938, 1636415875214, 276, 1, 275, 0, 0, 0
1201, 1, 1636415875354, 1636415875631, 277, 1, 276, 0, 0, 0
1202, 1, 1636415875610, 1636415875886, 276, 0, 276, 0, 0, 0
1203, 1, 1636415875934, 1636415876210, 276, 0, 276, 0, 0, 0
1204, 1, 1636415876146, 1636415876422, 276, 1, 275, 0, 1, 1
1205, 1, 1636415876246, 1636415876522, 276, 1, 275, 0, 1, 1
1206, 1, 1636415876542, 1636415876818, 276, 0, 276, 0, 0, 0
1207, 1, 1636415876798, 1636415877074, 276, 0, 276, 0, 0, 0
1208, 1, 1636415877146, 1636415877422, 276, 0, 276, 0, 0, 0
1209, 1, 1636415877438, 1636415877714, 276, 0, 276, 0, 0, 0
1210, 1, 1636415877454, 1636415877722, 268, 1, 267, 0, 0, 0
1211, 1, 1636415877834, 1636415878106, 272, 1, 271, 0, 0, 0
1212, 1, 1636415878106, 1636415878374, 268, 1, 267, 0, 1, 1
1213, 1, 1636415878454, 1636415878730, 276, 0, 276, 0, 0, 0
1214, 1, 1636415878698, 1636415878970, 272, 0, 272, 0, 0, 0
1215, 1, 1636415878730, 1636415879002, 272, 1, 271, 0, 0, 0
1216, 1, 1636415879034, 1636415879310, 276, 0, 276, 0, 0, 0
1217, 1, 1636415879350, 1636415879622, 272, 0, 272, 0, 0, 0
1218, 1, 1636415879642, 1636415879918, 276, 0, 276, 0, 0, 0
1219, 1, 1636415879926, 1636415880194, 268, 0, 268, 0, 0, 0
1220, 1, 1636415879954, 1636415880230, 276, 1, 275, 0, 1, 1
1221, 1, 1636415880326, 1636415880602, 276, 0, 276, 0, 0, 0
1222, 1, 1636415880606, 1636415880878, 272, 0, 272, 0, 0, 0
1223, 1, 1636415880902, 1636415881178, 276, 1, 275, 0, 1, 1
1224, 1, 1636415881150, 1636415881426, 276, 0, 276, 0, 0, 0
1225, 1, 1636415881178, 1636415881454, 276, 1, 275, 0, 0, 0
1226, 1, 1636415881598, 1636415881870, 272, 1, 271, 0, 0, 0
1227, 1, 1636415881802, 1636415882078, 276, 0, 276, 0, 0, 0
1228, 1, 1636415882110, 1636415882390, 280, 1, 279, 0, 0, 0
1229, 1, 1636415882402, 1636415882678, 276, 0, 276, 0, 0, 0
1230, 1, 1636415882434, 1636415882710, 276, 0, 276, 0, 0, 0
1231, 1, 1636415882830, 1636415883106, 276, 1, 275, 0, 0, 0
1232, 1, 1636415883054, 1636415883330, 276, 0, 276, 0, 0, 0
1233, 1, 1636415883402, 1636415883678, 276, 0, 276, 0, 0, 0
1235, 1, 1636415883662, 1636415883934, 272, 0, 272, 0, 0, 0
1234, 1, 1636415883658, 1636415883934, 276, 1, 275, 0, 1, 1
1236, 1, 1636415884030, 1636415884306, 276, 1, 275, 0, 0, 0
1237, 1, 1636415884310, 1636415884586, 276, 0, 276, 0, 0, 0
1238, 1, 1636415884674, 1636415884950, 276, 1, 275, 0, 1, 1
1239, 1, 1636415884886, 1636415885162, 276, 0, 276, 0, 0, 0
1240, 1, 1636415884902, 1636415885178, 276, 0, 276, 0, 0, 0
1241, 1, 1636415885254, 1636415885531, 277, 0, 277, 0, 0, 0
1242, 1, 1636415885538, 1636415885810, 272, 0, 272, 0, 0, 0
1243, 1, 1636415885902, 1636415886178, 276, 1, 275, 0, 0, 0
1244, 1, 1636415886090, 1636415886362, 272, 1, 271, 0, 0, 0
1245, 1, 1636415886126, 1636415886398, 272, 1, 271, 1, 0, 1
1246, 1, 1636415886502, 1636415886779, 277, 1, 276, 0, 1, 1
1247, 1, 1636415886778, 1636415887054, 276, 1, 275, 0, 0, 0
1248, 1, 1636415887146, 1636415887422, 276, 0, 276, 0, 0, 0
1249, 1, 1636415887314, 1636415887590, 276, 0, 276, 0, 0, 0
1250, 1, 1636415887378, 1636415887654, 276, 0, 276, 0, 0, 0
1251, 1, 1636415887694, 1636415887966, 272, 1, 271, 0, 0, 0
1252, 1, 1636415888002, 1636415888279, 277, 0, 277, 0, 0, 0
1253, 1, 1636415888374, 1636415888650, 276, 1, 275, 0, 0, 0
1254, 1, 1636415888546, 1636415888822, 276, 1, 275, 1, 0, 1
1255, 1, 1636415888594, 1636415888870, 276, 0, 276, 0, 0, 0
1256, 1, 1636415888958, 1636415889230, 272, 1, 271, 1, 0, 1
1257, 1, 1636415889250, 1636415889526, 276, 1, 275, 0, 1, 1
1258, 1, 1636415889622, 1636415889898, 276, 1, 275, 0, 0, 0
1259, 1, 1636415889762, 1636415890034, 272, 0, 272, 0, 0, 0
1260, 1, 1636415889858, 1636415890131, 273, 0, 273, 0, 0, 0
1261, 1, 1636415890150, 1636415890426, 276, 0, 276, 0, 0, 0
1262, 1, 1636415890442, 1636415890718, 276, 1, 275, 0, 0, 0
1263, 1, 1636415890814, 1636415891090, 276, 1, 275, 0, 0, 0
1264, 1, 1636415891026, 1636415891302, 276, 0, 276, 0, 0, 0
1265, 1, 1636415891054, 1636415891330, 276, 0, 276, 0, 0, 0
1266, 1, 1636415891458, 1636415891734, 276, 1, 275, 1, 0, 1
1267, 1, 1636415891706, 1636415892010, 304, 29, 275, 29, 0, 29
1268, 1, 1636415892078, 1636415892354, 276, 1, 275, 0, 0, 0
1269, 1, 1636415892218, 1636415892494, 276, 1, 275, 0, 1, 1
1270, 1, 1636415892358, 1636415892634, 276, 0, 276, 0, 0, 0
1271, 1, 1636415892726, 1636415893002, 276, 0, 276, 0, 0, 0
1272, 1, 1636415892934, 1636415893210, 276, 1, 275, 0, 0, 0
1273, 1, 1636415893270, 1636415893550, 280, 0, 280, 0, 0, 0
1274, 1, 1636415893526, 1636415893798, 272, 1, 271, 0, 0, 0
1275, 1, 1636415893630, 1636415893906, 276, 0, 276, 0, 0, 0
1276, 1, 1636415893978, 1636415894246, 268, 1, 267, 0, 0, 0
1277, 1, 1636415894202, 1636415894478, 276, 0, 276, 0, 0, 0
1278, 1, 1636415894538, 1636415894810, 272, 0, 272, 0, 0, 0
1279, 1, 1636415894794, 1636415895070, 276, 0, 276, 0, 0, 0
1280, 1, 1636415894886, 1636415895154, 268, 0, 268, 0, 0, 0
1281, 1, 1636415895278, 1636415895550, 272, 0, 272, 0, 0, 0
1282, 1, 1636415895506, 1636415895778, 272, 0, 272, 0, 0, 0
1283, 1, 1636415895810, 1636415896082, 272, 0, 272, 0, 0, 0
1284, 1, 1636415896058, 1636415896334, 276, 0, 276, 0, 0, 0
1285, 1, 1636415896186, 1636415896462, 276, 0, 276, 0, 0, 0
1286, 1, 1636415896582, 1636415896850, 268, 0, 268, 0, 0, 0
1287, 1, 1636415896758, 1636415897034, 276, 0, 276, 0, 0, 0
1288, 1, 1636415897062, 1636415897342, 280, 1, 279, 0, 1, 1
1289, 1, 1636415897354, 1636415897626, 272, 1, 271, 0, 0, 0
1290, 1, 1636415897490, 1636415897766, 276, 0, 276, 0, 0, 0
1291, 1, 1636415897890, 1636415898162, 272, 0, 272, 0, 0, 0
1292, 1, 1636415898054, 1636415898330, 276, 0, 276, 0, 0, 0
1293, 1, 1636415898362, 1636415898638, 276, 0, 276, 0, 0, 0
1294, 1, 1636415898662, 1636415898938, 276, 0, 276, 0, 0, 0
1295, 1, 1636415898798, 1636415899074, 276, 0, 276, 0, 0, 0
1296, 1, 1636415899362, 1636415899638, 276, 1, 275, 0, 1, 1
1297, 1, 1636415899638, 1636415899922, 284, 1, 283, 1, 0, 1
1298, 1, 1636415899974, 1636415900258, 284, 0, 284, 0, 0, 0
1299, 1, 1636415900670, 1636415900946, 276, 0, 276, 0, 0, 0
1300, 1, 1636415900930, 1636415901218, 288, 17, 271, 17, 0, 17
1301, 1, 1636416134550, 1636416134826, 276, 1, 275, 0, 0, 0
1302, 1, 1636416135166, 1636416135438, 272, 1, 271, 1, 0, 1
1303, 1, 1636416135226, 1636416135498, 272, 0, 272, 0, 0, 0
1305, 1, 1636416135826, 1636416136102, 276, 0, 276, 0, 0, 0
1304, 1, 1636416135834, 1636416136106, 272, 1, 271, 0, 1, 1
1306, 1, 1636416135894, 1636416136166, 272, 0, 272, 0, 0, 0
1308, 1, 1636416136502, 1636416136778, 276, 1, 275, 0, 0, 0
1307, 1, 1636416136502, 1636416136778, 276, 1, 275, 0, 1, 1
1309, 1, 1636416136562, 1636416136830, 268, 0, 268, 0, 0, 0
1310, 1, 1636416136886, 1636416137162, 276, 0, 276, 0, 0, 0
1312, 1, 1636416137174, 1636416137446, 272, 0, 272, 0, 0, 0
1311, 1, 1636416137178, 1636416137450, 272, 0, 272, 0, 0, 0
1313, 1, 1636416137222, 1636416137494, 272, 0, 272, 0, 0, 0
1314, 1, 1636416137558, 1636416137830, 272, 1, 271, 0, 0, 0
1315, 1, 1636416137602, 1636416137878, 276, 0, 276, 0, 0, 0
1316, 1, 1636416137842, 1636416138119, 277, 0, 277, 0, 0, 0
1317, 1, 1636416137850, 1636416138119, 269, 0, 269, 0, 0, 0
1318, 1, 1636416137890, 1636416138162, 272, 0, 272, 0, 0, 0
1319, 1, 1636416138226, 1636416138494, 268, 1, 267, 0, 0, 0
1320, 1, 1636416138294, 1636416138562, 268, 0, 268, 0, 0, 0
1322, 1, 1636416138514, 1636416138790, 276, 1, 275, 0, 1, 1
1321, 1, 1636416138514, 1636416138790, 276, 1, 275, 0, 1, 1
1323, 1, 1636416138566, 1636416138834, 268, 0, 268, 0, 0, 0
1324, 1, 1636416138894, 1636416139170, 276, 0, 276, 0, 0, 0
1325, 1, 1636416138954, 1636416139230, 276, 0, 276, 0, 0, 0
1327, 1, 1636416139194, 1636416139470, 276, 0, 276, 0, 0, 0
1326, 1, 1636416139194, 1636416139470, 276, 1, 275, 0, 0, 0
1328, 1, 1636416139230, 1636416139498, 268, 1, 267, 0, 0, 0
1329, 1, 1636416139566, 1636416139838, 272, 0, 272, 0, 0, 0
1330, 1, 1636416139626, 1636416139898, 272, 0, 272, 0, 0, 0
1331, 1, 1636416139870, 1636416140142, 272, 0, 272, 0, 0, 0
1332, 1, 1636416139866, 1636416140146, 280, 0, 280, 0, 0, 0
1333, 1, 1636416139894, 1636416140166, 272, 0, 272, 0, 0, 0
1334, 1, 1636416140238, 1636416140510, 272, 1, 271, 0, 1, 1
1335, 1, 1636416140294, 1636416140570, 276, 0, 276, 0, 0, 0
1337, 1, 1636416140542, 1636416140814, 272, 0, 272, 0, 0, 0
1336, 1, 1636416140538, 1636416140814, 276, 0, 276, 0, 0, 0
1338, 1, 1636416140566, 1636416140834, 268, 0, 268, 0, 0, 0
1339, 1, 1636416140906, 1636416141186, 280, 0, 280, 0, 0, 0
1340, 1, 1636416140970, 1636416141246, 276, 0, 276, 0, 0, 0
1342, 1, 1636416141210, 1636416141486, 276, 1, 275, 0, 1, 1
1341, 1, 1636416141210, 1636416141486, 276, 1, 275, 0, 1, 1
1343, 1, 1636416141230, 1636416141498, 268, 0, 268, 0, 0, 0
1344, 1, 1636416141582, 1636416141858, 276, 0, 276, 0, 0, 0
1345, 1, 1636416141646, 1636416141922, 276, 0, 276, 0, 0, 0
1348, 1, 1636416141894, 1636416142158, 264, 0, 264, 0, 0, 0
1347, 1, 1636416141886, 1636416142159, 273, 0, 273, 0, 0, 0
1346, 1, 1636416141882, 1636416142158, 276, 0, 276, 0, 0, 0
1349, 1, 1636416142258, 1636416142534, 276, 0, 276, 0, 0, 0
1350, 1, 1636416142322, 1636416142594, 272, 0, 272, 0, 0, 0
1353, 1, 1636416142558, 1636416142830, 272, 0, 272, 0, 0, 0
1352, 1, 1636416142554, 1636416142830, 276, 1, 275, 0, 1, 1
1351, 1, 1636416142554, 1636416142830, 276, 1, 275, 0, 1, 1
1354, 1, 1636416142930, 1636416143206, 276, 1, 275, 1, 0, 1
1355, 1, 1636416142994, 1636416143266, 272, 0, 272, 0, 0, 0
1357, 1, 1636416143226, 1636416143494, 268, 0, 268, 0, 0, 0
1356, 1, 1636416143226, 1636416143498, 272, 0, 272, 0, 0, 0
1358, 1, 1636416143234, 1636416143510, 276, 0, 276, 0, 0, 0
1359, 1, 1636416143606, 1636416143882, 276, 0, 276, 0, 0, 0
1360, 1, 1636416143666, 1636416143942, 276, 0, 276, 0, 0, 0
1361, 1, 1636416143890, 1636416144170, 280, 0, 280, 0, 0, 0
1362, 1, 1636416143898, 1636416144178, 280, 0, 280, 0, 0, 0
1363, 1, 1636416143906, 1636416144178, 272, 0, 272, 0, 0, 0
1364, 1, 1636416144278, 1636416144554, 276, 0, 276, 0, 0, 0
1365, 1, 1636416144338, 1636416144614, 276, 0, 276, 0, 0, 0
1366, 1, 1636416144566, 1636416144838, 272, 0, 272, 0, 0, 0
1368, 1, 1636416144574, 1636416144850, 276, 1, 275, 0, 1, 1
1367, 1, 1636416144574, 1636416144850, 276, 1, 275, 1, 0, 1
1369, 1, 1636416144950, 1636416145222, 272, 0, 272, 0, 0, 0
1370, 1, 1636416145010, 1636416145282, 272, 0, 272, 0, 0, 0
1371, 1, 1636416145242, 1636416145518, 276, 0, 276, 0, 0, 0
1372, 1, 1636416145250, 1636416145526, 276, 1, 275, 0, 1, 1
1373, 1, 1636416145250, 1636416145526, 276, 1, 275, 0, 1, 1
1374, 1, 1636416145618, 1636416145890, 272, 1, 271, 1, 0, 1
1375, 1, 1636416145674, 1636416145950, 276, 0, 276, 0, 0, 0
1376, 1, 1636416145914, 1636416146190, 276, 0, 276, 0, 0, 0
1378, 1, 1636416145926, 1636416146198, 272, 0, 272, 0, 0, 0
1377, 1, 1636416145922, 1636416146226, 304, 29, 275, 29, 0, 29
1379, 1, 1636416146286, 1636416146562, 276, 0, 276, 0, 0, 0
1380, 1, 1636416146346, 1636416146622, 276, 0, 276, 0, 0, 0
1381, 1, 1636416146586, 1636416146858, 272, 0, 272, 0, 0, 0
1382, 1, 1636416146590, 1636416146862, 272, 0, 272, 0, 0, 0
1383, 1, 1636416146622, 1636416146898, 276, 1, 275, 0, 0, 0
1384, 1, 1636416146962, 1636416147234, 272, 1, 271, 0, 0, 0
1385, 1, 1636416147018, 1636416147294, 276, 0, 276, 0, 0, 0
1387, 1, 1636416147266, 1636416147538, 272, 0, 272, 0, 0, 0
1388, 1, 1636416147298, 1636416147570, 272, 0, 272, 0, 0, 0
1386, 1, 1636416147258, 1636416147571, 313, 37, 276, 37, 0, 37
1389, 1, 1636416147630, 1636416147902, 272, 0, 272, 0, 0, 0
1390, 1, 1636416147690, 1636416147966, 276, 0, 276, 0, 0, 0
1391, 1, 1636416147934, 1636416148210, 276, 0, 276, 0, 0, 0
1392, 1, 1636416147966, 1636416148242, 276, 1, 275, 0, 0, 0
1393, 1, 1636416147974, 1636416148246, 272, 0, 272, 0, 0, 0
1394, 1, 1636416148302, 1636416148578, 276, 0, 276, 0, 0, 0
1395, 1, 1636416148362, 1636416148638, 276, 0, 276, 0, 0, 0
1397, 1, 1636416148638, 1636416148914, 276, 1, 275, 0, 0, 0
1398, 1, 1636416148646, 1636416148914, 268, 0, 268, 0, 0, 0
1396, 1, 1636416148606, 1636416148914, 308, 33, 275, 33, 0, 33
1399, 1, 1636416148974, 1636416149250, 276, 0, 276, 0, 0, 0
1400, 1, 1636416149042, 1636416149318, 276, 0, 276, 0, 0, 0
1401, 1, 1636416149310, 1636416149586, 276, 1, 275, 0, 1, 1
1402, 1, 1636416149310, 1636416149586, 276, 1, 275, 0, 0, 0
1403, 1, 1636416149314, 1636416149586, 272, 0, 272, 0, 0, 0
1404, 1, 1636416149650, 1636416149922, 272, 1, 271, 0, 1, 1
1405, 1, 1636416149714, 1636416149990, 276, 0, 276, 0, 0, 0
1407, 1, 1636416149986, 1636416150258, 272, 0, 272, 0, 0, 0
1406, 1, 1636416149982, 1636416150258, 276, 0, 276, 0, 0, 0
1408, 1, 1636416149990, 1636416150262, 272, 1, 271, 1, 0, 1
1409, 1, 1636416150318, 1636416150594, 276, 0, 276, 0, 0, 0
1410, 1, 1636416150386, 1636416150662, 276, 0, 276, 0, 0, 0
1411, 1, 1636416150654, 1636416150930, 276, 1, 275, 0, 1, 1
1412, 1, 1636416150654, 1636416150930, 276, 1, 275, 0, 1, 1
1413, 1, 1636416150662, 1636416150930, 268, 1, 267, 0, 0, 0
1414, 1, 1636416150990, 1636416151270, 280, 0, 280, 0, 0, 0
1415, 1, 1636416151058, 1636416151334, 276, 0, 276, 0, 0, 0
1418, 1, 1636416151330, 1636416151602, 272, 5, 267, 4, 1, 5
1419, 1, 1636416151666, 1636416151946, 280, 0, 280, 0, 0, 0
1420, 1, 1636416151734, 1636416152010, 276, 0, 276, 0, 0, 0
1423, 1, 1636416152406, 1636416152682, 276, 0, 276, 0, 0, 0
1416, 2, 1636416151330, 1636416161334, 10004, 0, 10004, 1, 0, 1
1417, 2, 1636416151330, 1636416161382, 10052, 0, 10052, 0, 0, 0
1425, 1, 1636416161666, 1636416161943, 277, 0, 277, 0, 0, 0
1426, 1, 1636416161718, 1636416161994, 276, 1, 275, 0, 0, 0
1421, 2, 1636416151998, 1636416161998, 10000, 0, 10000, 0, 0, 0
1422, 2, 1636416152342, 1636416162343, 10001, 0, 10001, 0, 0, 0
1427, 1, 1636416162338, 1636416162611, 273, 1, 272, 0, 0, 0
1424, 1, 1636416153082, 1636416162611, 9529, 9261, 268, 0, 9260, 9260
1428, 1, 1636416162394, 1636416162670, 276, 0, 276, 0, 0, 0
1429, 1, 1636416162394, 1636416162883, 489, 218, 271, 218, 0, 218
1430, 1, 1636416162706, 1636416162982, 276, 1, 275, 0, 0, 0
1432, 1, 1636416163010, 1636416163286, 276, 0, 276, 0, 0, 0
1431, 1, 1636416163010, 1636416163287, 277, 0, 277, 0, 0, 0
1433, 1, 1636416163070, 1636416163346, 276, 0, 276, 0, 0, 0
1434, 1, 1636416163278, 1636416163554, 276, 0, 276, 0, 0, 0
1435, 1, 1636416163378, 1636416163646, 268, 0, 268, 0, 0, 0
1436, 1, 1636416163682, 1636416163958, 276, 0, 276, 0, 0, 0
1437, 1, 1636416163686, 1636416163958, 272, 0, 272, 0, 0, 0
1438, 1, 1636416163746, 1636416164018, 272, 0, 272, 0, 0, 0
1439, 1, 1636416163950, 1636416164218, 268, 0, 268, 0, 0, 0
1440, 1, 1636416164042, 1636416164314, 272, 1, 271, 1, 0, 1
1441, 1, 1636416164354, 1636416164626, 272, 1, 271, 0, 1, 1
1442, 1, 1636416164358, 1636416164626, 268, 0, 268, 0, 0, 0
1443, 1, 1636416164418, 1636416164686, 268, 0, 268, 0, 0, 0
1444, 1, 1636416164614, 1636416164894, 280, 0, 280, 0, 0, 0
1445, 1, 1636416164722, 1636416164994, 272, 0, 272, 0, 0, 0
1446, 1, 1636416165022, 1636416165302, 280, 1, 279, 0, 0, 0
1447, 1, 1636416165022, 1636416165302, 280, 1, 279, 1, 0, 1
1448, 1, 1636416165082, 1636416165350, 268, 0, 268, 0, 0, 0
1449, 1, 1636416165290, 1636416165562, 272, 0, 272, 0, 0, 0
1450, 1, 1636416165390, 1636416165662, 272, 0, 272, 0, 0, 0
1452, 1, 1636416165698, 1636416165974, 276, 1, 275, 0, 1, 1
1451, 1, 1636416165698, 1636416165974, 276, 1, 275, 0, 0, 0
1453, 1, 1636416165750, 1636416166022, 272, 0, 272, 0, 0, 0
1454, 1, 1636416165966, 1636416166242, 276, 0, 276, 0, 0, 0
1455, 1, 1636416166062, 1636416166330, 268, 0, 268, 0, 0, 0
1456, 1, 1636416166370, 1636416166646, 276, 1, 275, 0, 0, 0
1457, 1, 1636416166370, 1636416166646, 276, 1, 275, 1, 0, 1
1458, 1, 1636416166418, 1636416166690, 272, 0, 272, 0, 0, 0
1459, 1, 1636416166642, 1636416166918, 276, 1, 275, 0, 1, 1
1460, 1, 1636416166726, 1636416167002, 276, 1, 275, 0, 1, 1
1461, 1, 1636416167046, 1636416167322, 276, 1, 275, 0, 0, 0
1462, 1, 1636416167046, 1636416167322, 276, 1, 275, 0, 1, 1
1463, 1, 1636416167086, 1636416167358, 272, 0, 272, 0, 0, 0
1464, 1, 1636416167318, 1636416167590, 272, 0, 272, 0, 0, 0
1465, 1, 1636416167398, 1636416167674, 276, 0, 276, 0, 0, 0
1466, 1, 1636416167714, 1636416167986, 272, 0, 272, 0, 0, 0
1467, 1, 1636416167718, 1636416167990, 272, 0, 272, 0, 0, 0
1468, 1, 1636416167754, 1636416168034, 280, 0, 280, 0, 0, 0
1469, 1, 1636416167986, 1636416168258, 272, 0, 272, 0, 0, 0
1470, 1, 1636416168070, 1636416168342, 272, 0, 272, 0, 0, 0
1472, 1, 1636416168382, 1636416168658, 276, 1, 275, 1, 0, 1
1471, 1, 1636416168382, 1636416168658, 276, 1, 275, 1, 0, 1
1473, 1, 1636416168434, 1636416168702, 268, 0, 268, 0, 0, 0
1474, 1, 1636416168654, 1636416168922, 268, 1, 267, 0, 1, 1
1475, 1, 1636416168738, 1636416169010, 272, 1, 271, 0, 0, 0
1476, 1, 1636416169054, 1636416169326, 272, 0, 272, 0, 0, 0
1477, 1, 1636416169050, 1636416169326, 276, 0, 276, 0, 0, 0
1478, 1, 1636416169098, 1636416169366, 268, 0, 268, 0, 0, 0
1479, 1, 1636416169318, 1636416169586, 268, 0, 268, 0, 0, 0
1480, 1, 1636416169406, 1636416169678, 272, 0, 272, 0, 0, 0
1481, 1, 1636416169726, 1636416169998, 272, 0, 272, 0, 0, 0
1482, 1, 1636416169722, 1636416169998, 276, 0, 276, 0, 0, 0
1483, 1, 1636416169762, 1636416170034, 272, 0, 272, 0, 0, 0
1484, 1, 1636416169982, 1636416170254, 272, 0, 272, 0, 0, 0
1485, 1, 1636416170074, 1636416170346, 272, 1, 271, 0, 1, 1
1487, 1, 1636416170394, 1636416170662, 268, 0, 268, 0, 0, 0
1486, 1, 1636416170394, 1636416170666, 272, 1, 271, 0, 0, 0
1488, 1, 1636416170430, 1636416170706, 276, 0, 276, 0, 0, 0
1489, 1, 1636416170654, 1636416170930, 276, 0, 276, 0, 0, 0
1490, 1, 1636416170750, 1636416171018, 268, 0, 268, 0, 0, 0
1491, 1, 1636416171058, 1636416171326, 268, 0, 268, 0, 0, 0
1492, 1, 1636416171062, 1636416171338, 276, 0, 276, 0, 0, 0
1493, 1, 1636416171102, 1636416171374, 272, 0, 272, 0, 0, 0
1494, 1, 1636416171326, 1636416171598, 272, 0, 272, 0, 0, 0
1495, 1, 1636416171414, 1636416171686, 272, 0, 272, 0, 0, 0
1496, 1, 1636416171722, 1636416171994, 272, 0, 272, 0, 0, 0
1497, 1, 1636416171738, 1636416172018, 280, 0, 280, 0, 0, 0
1498, 1, 1636416171770, 1636416172042, 272, 0, 272, 0, 0, 0
1499, 1, 1636416171994, 1636416172270, 276, 0, 276, 0, 0, 0
1500, 1, 1636416172082, 1636416172354, 272, 0, 272, 0, 0, 0
1501, 1, 1636416172390, 1636416172662, 272, 0, 272, 0, 0, 0
1502, 1, 1636416172414, 1636416172690, 276, 0, 276, 0, 0, 0
1503, 1, 1636416172442, 1636416172714, 272, 0, 272, 0, 0, 0
1504, 1, 1636416172666, 1636416172934, 268, 0, 268, 0, 0, 0
1505, 1, 1636416172754, 1636416173022, 268, 0, 268, 0, 0, 0
1506, 1, 1636416173054, 1636416173330, 276, 0, 276, 0, 0, 0
1507, 1, 1636416173086, 1636416173358, 272, 0, 272, 0, 0, 0
1508, 1, 1636416173110, 1636416173382, 272, 0, 272, 0, 0, 0
1509, 1, 1636416173334, 1636416173602, 268, 0, 268, 0, 0, 0
1510, 1, 1636416173418, 1636416173690, 272, 0, 272, 0, 0, 0
1511, 1, 1636416173726, 1636416174002, 276, 0, 276, 0, 0, 0
1512, 1, 1636416173754, 1636416174034, 280, 0, 280, 0, 0, 0
1513, 1, 1636416173786, 1636416174062, 276, 0, 276, 0, 0, 0
1514, 1, 1636416173998, 1636416174274, 276, 0, 276, 0, 0, 0
1515, 1, 1636416174086, 1636416174362, 276, 0, 276, 0, 0, 0
1516, 1, 1636416174398, 1636416174670, 272, 0, 272, 0, 0, 0
1517, 1, 1636416174430, 1636416174702, 272, 0, 272, 0, 0, 0
1518, 1, 1636416174462, 1636416174738, 276, 0, 276, 0, 0, 0
1519, 1, 1636416174670, 1636416174938, 268, 1, 267, 0, 0, 0
1520, 1, 1636416174762, 1636416175034, 272, 0, 272, 0, 0, 0
1521, 1, 1636416175062, 1636416175334, 272, 1, 271, 0, 0, 0
1522, 1, 1636416175098, 1636416175374, 276, 0, 276, 0, 0, 0
1523, 1, 1636416175134, 1636416175410, 276, 1, 275, 0, 0, 0
1524, 1, 1636416175334, 1636416175598, 264, 0, 264, 0, 0, 0
1525, 1, 1636416175434, 1636416175714, 280, 1, 279, 0, 0, 0
1526, 1, 1636416175730, 1636416176002, 272, 0, 272, 0, 0, 0
1527, 1, 1636416175774, 1636416176046, 272, 0, 272, 0, 0, 0
1528, 1, 1636416175806, 1636416176082, 276, 0, 276, 0, 0, 0
1529, 1, 1636416175994, 1636416176266, 272, 0, 272, 0, 0, 0
1530, 1, 1636416176114, 1636416176386, 272, 1, 271, 0, 1, 1
1531, 1, 1636416176394, 1636416176666, 272, 0, 272, 0, 0, 0
1532, 1, 1636416176442, 1636416176718, 276, 0, 276, 0, 0, 0
1533, 1, 1636416176478, 1636416176754, 276, 0, 276, 0, 0, 0
1534, 1, 1636416176666, 1636416176934, 268, 0, 268, 0, 0, 0
1535, 1, 1636416176782, 1636416177054, 272, 1, 271, 0, 1, 1
1536, 1, 1636416177062, 1636416177334, 272, 0, 272, 0, 0, 0
1537, 1, 1636416177118, 1636416177386, 268, 0, 268, 0, 0, 0
1538, 1, 1636416177150, 1636416177422, 272, 0, 272, 0, 0, 0
1539, 1, 1636416177330, 1636416177602, 272, 0, 272, 0, 0, 0
1540, 1, 1636416177450, 1636416177726, 276, 0, 276, 0, 0, 0
1541, 1, 1636416177730, 1636416178002, 272, 0, 272, 0, 0, 0
1542, 1, 1636416177782, 1636416178050, 268, 0, 268, 0, 0, 0
1543, 1, 1636416177818, 1636416178090, 272, 1, 271, 0, 1, 1
1544, 1, 1636416177998, 1636416178270, 272, 0, 272, 0, 0, 0
1545, 1, 1636416178122, 1636416178398, 276, 0, 276, 0, 0, 0
1546, 1, 1636416178398, 1636416178670, 272, 1, 271, 1, 0, 1
1547, 1, 1636416178450, 1636416178714, 264, 0, 264, 0, 0, 0
1548, 1, 1636416178486, 1636416178754, 268, 0, 268, 0, 0, 0
1549, 1, 1636416178666, 1636416178938, 272, 0, 272, 0, 0, 0
1550, 1, 1636416178794, 1636416179070, 276, 1, 275, 0, 1, 1
1551, 1, 1636416179070, 1636416179338, 268, 1, 267, 1, 0, 1
1552, 1, 1636416179106, 1636416179378, 272, 1, 271, 0, 0, 0
1553, 1, 1636416179150, 1636416179426, 276, 0, 276, 0, 0, 0
1554, 1, 1636416179338, 1636416179602, 264, 0, 264, 0, 0, 0
1555, 1, 1636416179466, 1636416179742, 276, 0, 276, 0, 0, 0
1556, 1, 1636416179730, 1636416180018, 288, 13, 275, 13, 0, 13
1557, 1, 1636416179778, 1636416180046, 268, 0, 268, 0, 0, 0
1558, 1, 1636416179822, 1636416180090, 268, 0, 268, 0, 0, 0
1559, 1, 1636416179998, 1636416180270, 272, 0, 272, 0, 0, 0
1560, 1, 1636416180142, 1636416180418, 276, 0, 276, 0, 0, 0
1561, 1, 1636416180418, 1636416180690, 272, 1, 271, 1, 0, 1
1562, 1, 1636416180442, 1636416180714, 272, 0, 272, 0, 0, 0
1563, 1, 1636416180486, 1636416180758, 272, 0, 272, 0, 0, 0
1564, 1, 1636416180674, 1636416180946, 272, 0, 272, 0, 0, 0
1565, 1, 1636416180818, 1636416181090, 272, 0, 272, 0, 0, 0
1566, 1, 1636416181082, 1636416181366, 284, 9, 275, 9, 0, 9
1567, 1, 1636416181106, 1636416181382, 276, 0, 276, 0, 0, 0
1568, 1, 1636416181158, 1636416181434, 276, 0, 276, 0, 0, 0
1569, 1, 1636416181342, 1636416181618, 276, 0, 276, 0, 0, 0
1570, 1, 1636416181490, 1636416181762, 272, 0, 272, 0, 0, 0
1571, 1, 1636416181762, 1636416182034, 272, 1, 271, 1, 0, 1
1572, 1, 1636416181778, 1636416182050, 272, 0, 272, 0, 0, 0
1573, 1, 1636416181830, 1636416182102, 272, 0, 272, 0, 0, 0
1574, 1, 1636416182018, 1636416182286, 268, 0, 268, 0, 0, 0
1575, 1, 1636416182166, 1636416182442, 276, 0, 276, 0, 0, 0
1577, 1, 1636416182450, 1636416182718, 268, 0, 268, 0, 0, 0
1576, 1, 1636416182430, 1636416182718, 288, 13, 275, 13, 0, 13
1578, 1, 1636416182498, 1636416182766, 268, 0, 268, 0, 0, 0
1579, 1, 1636416182682, 1636416182958, 276, 0, 276, 0, 0, 0
1580, 1, 1636416182838, 1636416183110, 272, 0, 272, 0, 0, 0
1581, 1, 1636416183114, 1636416183386, 272, 0, 272, 0, 0, 0
1582, 1, 1636416183114, 1636416183398, 284, 0, 284, 0, 0, 0
1583, 1, 1636416183162, 1636416183434, 272, 0, 272, 0, 0, 0
1584, 1, 1636416183354, 1636416183630, 276, 0, 276, 0, 0, 0
1585, 1, 1636416183506, 1636416183782, 276, 0, 276, 0, 0, 0
1586, 1, 1636416183782, 1636416184054, 272, 0, 272, 0, 0, 0
1587, 1, 1636416183794, 1636416184066, 272, 1, 271, 0, 0, 0
1588, 1, 1636416183830, 1636416184106, 276, 0, 276, 0, 0, 0
1589, 1, 1636416184026, 1636416184306, 280, 0, 280, 0, 0, 0
1590, 1, 1636416184178, 1636416184450, 272, 0, 272, 0, 0, 0
1591, 1, 1636416184458, 1636416184726, 268, 0, 268, 0, 0, 0
1592, 1, 1636416184466, 1636416184742, 276, 0, 276, 0, 0, 0
1593, 1, 1636416184510, 1636416184775, 265, 0, 265, 0, 0, 0
1594, 1, 1636416184702, 1636416184998, 296, 25, 271, 25, 0, 25
1595, 1, 1636416184850, 1636416185130, 280, 0, 280, 0, 0, 0
1596, 1, 1636416185126, 1636416185394, 268, 1, 267, 0, 0, 0
1597, 1, 1636416185142, 1636416185422, 280, 0, 280, 0, 0, 0
1598, 1, 1636416185170, 1636416185446, 276, 0, 276, 0, 0, 0
1599, 1, 1636416185394, 1636416185670, 276, 0, 276, 0, 0, 0
1600, 1, 1636416185522, 1636416185794, 272, 0, 272, 0, 0, 0
1601, 1, 1636416185798, 1636416186066, 268, 1, 267, 0, 0, 0
1602, 1, 1636416185818, 1636416186094, 276, 0, 276, 0, 0, 0
1603, 1, 1636416185846, 1636416186118, 272, 0, 272, 0, 0, 0
1604, 1, 1636416186066, 1636416186362, 296, 29, 267, 29, 0, 29
1605, 1, 1636416186190, 1636416186466, 276, 0, 276, 0, 0, 0
1606, 1, 1636416186466, 1636416186738, 272, 1, 271, 0, 0, 0
1607, 1, 1636416186490, 1636416186758, 268, 0, 268, 0, 0, 0
1608, 1, 1636416186514, 1636416186794, 280, 0, 280, 0, 0, 0
1609, 1, 1636416186758, 1636416187034, 276, 0, 276, 0, 0, 0
1610, 1, 1636416186862, 1636416187138, 276, 1, 275, 0, 1, 1
1611, 1, 1636416187130, 1636416187406, 276, 0, 276, 0, 0, 0
1612, 1, 1636416187158, 1636416187434, 276, 0, 276, 0, 0, 0
1613, 1, 1636416187194, 1636416187470, 276, 0, 276, 0, 0, 0
1614, 1, 1636416187430, 1636416187702, 272, 0, 272, 0, 0, 0
1615, 1, 1636416187534, 1636416187814, 280, 0, 280, 0, 0, 0
1616, 1, 1636416187802, 1636416188078, 276, 0, 276, 0, 0, 0
1617, 1, 1636416187830, 1636416188102, 272, 0, 272, 0, 0, 0
1618, 1, 1636416187866, 1636416188138, 272, 0, 272, 0, 0, 0
1619, 1, 1636416188098, 1636416188370, 272, 0, 272, 0, 0, 0
1620, 1, 1636416188210, 1636416188486, 276, 1, 275, 0, 1, 1
1621, 1, 1636416188474, 1636416188746, 272, 0, 272, 0, 0, 0
1622, 1, 1636416188502, 1636416188774, 272, 0, 272, 0, 0, 0
1623, 1, 1636416188538, 1636416188810, 272, 0, 272, 0, 0, 0
1624, 1, 1636416188766, 1636416189034, 268, 0, 268, 0, 0, 0
1625, 1, 1636416188890, 1636416189170, 280, 0, 280, 0, 0, 0
1626, 1, 1636416189142, 1636416189418, 276, 0, 276, 0, 0, 0
1627, 1, 1636416189170, 1636416189442, 272, 1, 271, 1, 0, 1
1628, 1, 1636416189206, 1636416189482, 276, 0, 276, 0, 0, 0
1629, 1, 1636416189430, 1636416189702, 272, 0, 272, 0, 0, 0
1630, 1, 1636416189570, 1636416189842, 272, 1, 271, 0, 0, 0
1631, 1, 1636416189818, 1636416190094, 276, 0, 276, 0, 0, 0
1632, 1, 1636416189842, 1636416190114, 272, 1, 271, 1, 0, 1
1633, 1, 1636416189878, 1636416190154, 276, 0, 276, 0, 0, 0
1634, 1, 1636416190098, 1636416190370, 272, 0, 272, 0, 0, 0
1635, 1, 1636416190242, 1636416190510, 268, 1, 267, 0, 1, 1
1636, 1, 1636416190490, 1636416190766, 276, 0, 276, 0, 0, 0
1637, 1, 1636416190514, 1636416190786, 272, 0, 272, 0, 0, 0
1638, 1, 1636416190550, 1636416190822, 272, 0, 272, 0, 0, 0
1639, 1, 1636416190770, 1636416191046, 276, 0, 276, 0, 0, 0
1640, 1, 1636416190910, 1636416191182, 272, 1, 271, 0, 0, 0
1642, 1, 1636416191178, 1636416191458, 280, 5, 275, 4, 0, 4
1643, 1, 1636416191218, 1636416191494, 276, 0, 276, 0, 0, 0
1644, 1, 1636416191442, 1636416191714, 272, 0, 272, 0, 0, 0
1641, 1, 1636416191162, 1636416191730, 568, 296, 272, 296, 0, 296
1645, 1, 1636416191582, 1636416191854, 272, 1, 271, 0, 0, 0
1646, 1, 1636416191854, 1636416192122, 268, 1, 267, 1, 0, 1
1647, 1, 1636416191890, 1636416192166, 276, 0, 276, 0, 0, 0
1648, 1, 1636416192110, 1636416192386, 276, 0, 276, 0, 0, 0
1649, 1, 1636416192126, 1636416192402, 276, 0, 276, 0, 0, 0
1650, 1, 1636416192250, 1636416192522, 272, 1, 271, 0, 1, 1
1651, 1, 1636416192514, 1636416192790, 276, 8, 268, 8, 0, 8
1652, 1, 1636416192562, 1636416192842, 280, 0, 280, 0, 0, 0
1653, 1, 1636416192782, 1636416193054, 272, 0, 272, 0, 0, 0
1654, 1, 1636416192802, 1636416193074, 272, 0, 272, 0, 0, 0
1655, 1, 1636416192922, 1636416193198, 276, 0, 276, 0, 0, 0
1656, 1, 1636416193182, 1636416193466, 284, 17, 267, 17, 0, 17
1657, 1, 1636416193238, 1636416193506, 268, 0, 268, 0, 0, 0
1658, 1, 1636416193450, 1636416193726, 276, 0, 276, 0, 0, 0
1659, 1, 1636416193474, 1636416193746, 272, 0, 272, 0, 0, 0
1660, 1, 1636416193594, 1636416193870, 276, 1, 275, 0, 1, 1
1661, 1, 1636416193862, 1636416194146, 284, 9, 275, 9, 0, 9
1662, 1, 1636416193906, 1636416194182, 276, 0, 276, 0, 0, 0
1663, 1, 1636416194122, 1636416194394, 272, 0, 272, 0, 0, 0
1664, 1, 1636416194142, 1636416194414, 272, 0, 272, 0, 0, 0
1665, 1, 1636416194266, 1636416194542, 276, 0, 276, 0, 0, 0
1666, 1, 1636416194546, 1636416194814, 268, 0, 268, 0, 0, 0
1667, 1, 1636416194578, 1636416194854, 276, 0, 276, 0, 0, 0
1668, 1, 1636416194798, 1636416195074, 276, 0, 276, 0, 0, 0
1669, 1, 1636416194814, 1636416195082, 268, 1, 267, 0, 0, 0
1670, 1, 1636416194942, 1636416195210, 268, 1, 267, 0, 0, 0
1671, 1, 1636416195210, 1636416195478, 268, 1, 267, 1, 0, 1
1672, 1, 1636416195250, 1636416195522, 272, 0, 272, 0, 0, 0
1673, 1, 1636416195470, 1636416195746, 276, 0, 276, 0, 0, 0
1674, 1, 1636416195478, 1636416195750, 272, 0, 272, 0, 0, 0
1675, 1, 1636416195610, 1636416196022, 412, 141, 271, 141, 0, 141
1679, 1, 1636416196146, 1636416196414, 268, 1, 267, 0, 0, 0
1678, 1, 1636416196142, 1636416196414, 272, 0, 272, 0, 0, 0
1680, 1, 1636416196417, 1636416196690, 273, 1, 272, 0, 0, 0
1681, 1, 1636416196810, 1636416197087, 277, 0, 277, 0, 0, 0
1683, 1, 1636416197086, 1636416197362, 276, 1, 275, 0, 0, 0
1684, 1, 1636416197482, 1636416197759, 277, 0, 277, 0, 0, 0
1686, 1, 1636416198154, 1636416198431, 277, 1, 276, 1, 0, 1
1687, 1, 1636416198834, 1636416199110, 276, 0, 276, 0, 0, 0
1688, 1, 1636416199510, 1636416199786, 276, 1, 275, 0, 1, 1
1689, 1, 1636416200182, 1636416200459, 277, 1, 276, 0, 0, 0
1690, 1, 1636416200858, 1636416201135, 277, 1, 276, 0, 0, 0
1691, 1, 1636416201534, 1636416201810, 276, 1, 275, 1, 0, 1
1692, 1, 1636416202206, 1636416202482, 276, 1, 275, 0, 1, 1
1693, 1, 1636416202878, 1636416203154, 276, 0, 276, 0, 0, 0
1694, 1, 1636416203554, 1636416203826, 272, 0, 272, 0, 0, 0
1695, 1, 1636416204226, 1636416204503, 277, 1, 276, 1, 0, 1
1696, 1, 1636416204906, 1636416205182, 276, 1, 275, 0, 1, 1
1697, 1, 1636416205582, 1636416205858, 276, 1, 275, 0, 0, 0
1676, 2, 1636416195874, 1636416205874, 10000, 0, 10000, 148, 0, 148
1677, 2, 1636416195918, 1636416205923, 10005, 0, 10005, 105, 0, 105
1698, 1, 1636416206254, 1636416206530, 276, 0, 276, 0, 0, 0
1700, 1, 1636416206326, 1636416206598, 272, 0, 272, 0, 0, 0
1699, 1, 1636416206330, 1636416206606, 276, 0, 276, 0, 0, 0
1682, 2, 1636416196814, 1636416206814, 10000, 0, 10000, 0, 0, 0
1685, 1, 1636416197758, 1636416207086, 9328, 9057, 271, 0, 9055, 9055
1701, 1, 1636416206930, 1636416207206, 276, 1, 275, 1, 0, 1
1702, 1, 1636416206990, 1636416207262, 272, 0, 272, 0, 0, 0
1703, 1, 1636416207006, 1636416207278, 272, 0, 272, 0, 0, 0
1704, 1, 1636416207126, 1636416207398, 272, 1, 271, 0, 1, 1
1705, 1, 1636416207486, 1636416207758, 272, 1, 271, 0, 0, 0
1706, 1, 1636416207602, 1636416207882, 280, 1, 279, 1, 0, 1
1707, 1, 1636416207662, 1636416207938, 276, 0, 276, 0, 0, 0
1708, 1, 1636416207674, 1636416207954, 280, 0, 280, 0, 0, 0
1709, 1, 1636416207798, 1636416208070, 272, 0, 272, 0, 0, 0
1710, 1, 1636416208154, 1636416208426, 272, 1, 271, 0, 0, 0
1711, 1, 1636416208286, 1636416208562, 276, 1, 275, 1, 0, 1
1712, 1, 1636416208338, 1636416208614, 276, 0, 276, 0, 0, 0
1713, 1, 1636416208354, 1636416208622, 268, 0, 268, 0, 0, 0
1714, 1, 1636416208474, 1636416208746, 272, 0, 272, 0, 0, 0
1715, 1, 1636416208822, 1636416209094, 272, 0, 272, 0, 0, 0
1716, 1, 1636416208962, 1636416209238, 276, 0, 276, 0, 0, 0
1717, 1, 1636416209010, 1636416209282, 272, 0, 272, 0, 0, 0
1718, 1, 1636416209030, 1636416209310, 280, 0, 280, 0, 0, 0
1719, 1, 1636416209142, 1636416209414, 272, 0, 272, 0, 0, 0
1720, 1, 1636416209490, 1636416209762, 272, 0, 272, 0, 0, 0
1721, 1, 1636416209634, 1636416209910, 276, 0, 276, 0, 0, 0
1722, 1, 1636416209674, 1636416209946, 272, 1, 271, 0, 0, 0
1723, 1, 1636416209706, 1636416209982, 276, 0, 276, 0, 0, 0
1724, 1, 1636416209814, 1636416210090, 276, 0, 276, 0, 0, 0
1725, 1, 1636416210158, 1636416210430, 272, 1, 271, 0, 1, 1
1726, 1, 1636416210306, 1636416210586, 280, 1, 279, 0, 0, 0
1727, 1, 1636416210342, 1636416210614, 272, 0, 272, 0, 0, 0
1728, 1, 1636416210382, 1636416210650, 268, 0, 268, 0, 0, 0
1729, 1, 1636416210486, 1636416210762, 276, 0, 276, 0, 0, 0
1730, 1, 1636416210830, 1636416211106, 276, 0, 276, 0, 0, 0
1731, 1, 1636416210978, 1636416211254, 276, 0, 276, 0, 0, 0
1732, 1, 1636416211018, 1636416211294, 276, 1, 275, 0, 1, 1
1733, 1, 1636416211046, 1636416211322, 276, 1, 275, 0, 0, 0
1734, 1, 1636416211162, 1636416211438, 276, 0, 276, 0, 0, 0
1735, 1, 1636416211502, 1636416211774, 272, 0, 272, 0, 0, 0
1736, 1, 1636416211690, 1636416211962, 272, 0, 272, 0, 0, 0
1737, 1, 1636416211718, 1636416212046, 328, 57, 271, 57, 0, 57
1738, 1, 1636416211834, 1636416212110, 276, 0, 276, 0, 0, 0
1739, 1, 1636416212170, 1636416212446, 276, 0, 276, 0, 0, 0
1740, 1, 1636416212362, 1636416212638, 276, 0, 276, 0, 0, 0
1741, 1, 1636416212446, 1636416212722, 276, 1, 275, 1, 0, 1
1742, 1, 1636416212506, 1636416212910, 404, 132, 272, 132, 0, 132
1743, 1, 1636416212842, 1636416213178, 336, 69, 267, 69, 0, 69
1744, 1, 1636416213034, 1636416213310, 276, 1, 275, 1, 0, 1
1745, 1, 1636416213118, 1636416213394, 276, 1, 275, 0, 0, 0
1746, 1, 1636416213306, 1636416213578, 272, 1, 271, 0, 1, 1
1747, 1, 1636416213574, 1636416213862, 288, 5, 283, 5, 0, 5
1748, 1, 1636416213706, 1636416213978, 272, 1, 271, 1, 0, 1
1749, 1, 1636416213794, 1636416214070, 276, 0, 276, 0, 0, 0
1750, 1, 1636416213978, 1636416214254, 276, 1, 275, 0, 0, 0
1751, 1, 1636416214266, 1636416214542, 276, 0, 276, 0, 0, 0
1752, 1, 1636416214374, 1636416214646, 272, 0, 272, 0, 0, 0
1753, 1, 1636416214470, 1636416214738, 268, 0, 268, 0, 0, 0
1754, 1, 1636416214654, 1636416214926, 272, 0, 272, 0, 0, 0
1755, 1, 1636416214938, 1636416215214, 276, 0, 276, 0, 0, 0
1756, 1, 1636416215043, 1636416215318, 275, 0, 275, 0, 0, 0
1757, 1, 1636416215134, 1636416215406, 272, 1, 271, 1, 0, 1
1758, 1, 1636416215326, 1636416215602, 276, 0, 276, 0, 0, 0
1759, 1, 1636416215610, 1636416215886, 276, 0, 276, 0, 0, 0
1760, 1, 1636416215714, 1636416215986, 272, 0, 272, 0, 0, 0
1761, 1, 1636416215802, 1636416216078, 276, 1, 275, 0, 0, 0
1762, 1, 1636416215998, 1636416216270, 272, 0, 272, 0, 0, 0
1763, 1, 1636416216282, 1636416216554, 272, 1, 271, 0, 0, 0
1764, 1, 1636416216382, 1636416216662, 280, 1, 279, 1, 0, 1
1765, 1, 1636416216474, 1636416216750, 276, 1, 275, 0, 0, 0
1766, 1, 1636416216670, 1636416216946, 276, 0, 276, 0, 0, 0
1767, 1, 1636416216950, 1636416217226, 276, 1, 275, 0, 0, 0
1768, 1, 1636416217058, 1636416217338, 280, 1, 279, 1, 0, 1
1769, 1, 1636416217146, 1636416217422, 276, 1, 275, 0, 0, 0
1770, 1, 1636416217342, 1636416217618, 276, 1, 275, 0, 0, 0
1771, 1, 1636416217622, 1636416217890, 268, 0, 268, 0, 0, 0
1772, 1, 1636416217734, 1636416218002, 268, 1, 267, 0, 0, 0
1773, 1, 1636416217818, 1636416218094, 276, 0, 276, 0, 0, 0
1774, 1, 1636416218014, 1636416218294, 280, 1, 279, 0, 0, 0
1775, 1, 1636416218286, 1636416218562, 276, 9, 267, 9, 0, 9
1776, 1, 1636416218398, 1636416218674, 276, 1, 275, 0, 0, 0
1777, 1, 1636416218490, 1636416218766, 276, 1, 275, 0, 0, 0
1778, 1, 1636416218690, 1636416218966, 276, 0, 276, 0, 0, 0
1779, 1, 1636416218962, 1636416219246, 284, 5, 279, 5, 0, 5
1780, 1, 1636416219070, 1636416219342, 272, 1, 271, 0, 0, 0
1781, 1, 1636416219162, 1636416219434, 272, 1, 271, 0, 0, 0
1782, 1, 1636416219362, 1636416219630, 268, 1, 267, 0, 0, 0
1783, 1, 1636416219646, 1636416219922, 276, 0, 276, 0, 0, 0
1784, 1, 1636416219738, 1636416220014, 276, 1, 275, 1, 0, 1
1785, 1, 1636416219834, 1636416220102, 268, 1, 267, 0, 0, 0
1786, 1, 1636416220034, 1636416220310, 276, 0, 276, 0, 0, 0
1787, 1, 1636416220318, 1636416220586, 268, 0, 268, 0, 0, 0
1788, 1, 1636416220414, 1636416220686, 272, 1, 271, 1, 0, 1
1789, 1, 1636416220498, 1636416220770, 272, 0, 272, 0, 0, 0
1790, 1, 1636416220706, 1636416220978, 272, 0, 272, 0, 0, 0
1791, 1, 1636416220982, 1636416221254, 272, 0, 272, 0, 0, 0
1792, 1, 1636416221082, 1636416221350, 268, 1, 267, 1, 0, 1
1793, 1, 1636416221166, 1636416221442, 276, 1, 275, 0, 1, 1
1794, 1, 1636416221374, 1636416221650, 276, 1, 275, 0, 0, 0
1795, 1, 1636416221650, 1636416221926, 276, 1, 275, 1, 0, 1
1796, 1, 1636416221750, 1636416222018, 268, 1, 267, 0, 0, 0
1797, 1, 1636416222046, 1636416222322, 276, 1, 275, 1, 0, 1
1798, 1, 1636416222326, 1636416222598, 272, 0, 272, 0, 0, 0
1799, 1, 1636416222414, 1636416222686, 272, 1, 271, 0, 0, 0
1800, 1, 1636416223082, 1636416223358, 276, 1, 275, 0, 0, 0
1801, 1, 1636416476342, 1636416476623, 281, 1, 280, 1, 0, 1
1802, 1, 1636416476994, 1636416477270, 276, 0, 276, 0, 0, 0
1803, 1, 1636416477334, 1636416477610, 276, 0, 276, 0, 0, 0
1804, 1, 1636416477446, 1636416477723, 277, 1, 276, 1, 0, 1
1805, 1, 1636416477990, 1636416478266, 276, 1, 275, 0, 0, 0
1806, 1, 1636416478138, 1636416478414, 276, 1, 275, 1, 0, 1
1807, 1, 1636416478322, 1636416478594, 272, 0, 272, 0, 0, 0
1808, 1, 1636416478442, 1636416478718, 276, 1, 275, 1, 0, 1
1809, 1, 1636416478738, 1636416479006, 268, 1, 267, 0, 0, 0
1810, 1, 1636416478978, 1636416479250, 272, 0, 272, 0, 0, 0
1811, 1, 1636416479134, 1636416479406, 272, 0, 272, 0, 0, 0
1812, 1, 1636416479322, 1636416479598, 276, 0, 276, 0, 0, 0
1813, 1, 1636416479422, 1636416479690, 268, 1, 267, 0, 1, 1
1814, 1, 1636416479722, 1636416479994, 272, 1, 271, 0, 1, 1
1815, 1, 1636416479982, 1636416480255, 273, 0, 273, 0, 0, 0
1816, 1, 1636416480122, 1636416480398, 276, 1, 275, 0, 0, 0
1817, 1, 1636416480346, 1636416480618, 272, 1, 271, 0, 0, 0
1818, 1, 1636416480426, 1636416480698, 272, 1, 271, 0, 0, 0
1819, 1, 1636416480706, 1636416480978, 272, 0, 272, 0, 0, 0
1820, 1, 1636416481006, 1636416481282, 276, 0, 276, 0, 0, 0
1821, 1, 1636416481150, 1636416481430, 280, 1, 279, 0, 0, 0
1822, 1, 1636416481326, 1636416481598, 272, 1, 271, 0, 1, 1
1823, 1, 1636416481458, 1636416481866, 408, 141, 267, 141, 0, 141
1824, 1, 1636416481714, 1636416481986, 272, 0, 272, 0, 0, 0
1825, 1, 1636416481982, 1636416482250, 268, 0, 268, 0, 0, 0
1826, 1, 1636416482182, 1636416482526, 344, 69, 275, 69, 0, 69
1827, 1, 1636416482334, 1636416482610, 276, 0, 276, 0, 0, 0
1828, 1, 1636416482438, 1636416482794, 356, 89, 267, 89, 0, 89
1829, 1, 1636416482738, 1636416483074, 336, 57, 279, 57, 0, 57
1830, 1, 1636416482998, 1636416483278, 280, 1, 279, 1, 0, 1
1831, 1, 1636416483182, 1636416483450, 268, 1, 267, 0, 0, 0
1832, 1, 1636416483358, 1636416483626, 268, 1, 267, 0, 0, 0
1833, 1, 1636416483442, 1636416483714, 272, 0, 272, 0, 0, 0
1834, 1, 1636416483730, 1636416484002, 272, 0, 272, 0, 0, 0
1835, 1, 1636416484006, 1636416484282, 276, 0, 276, 0, 0, 0
1836, 1, 1636416484186, 1636416484458, 272, 0, 272, 0, 0, 0
1837, 1, 1636416484390, 1636416484666, 276, 0, 276, 0, 0, 0
1838, 1, 1636416484446, 1636416484714, 268, 0, 268, 0, 0, 0
1839, 1, 1636416484734, 1636416485010, 276, 0, 276, 0, 0, 0
1840, 1, 1636416485026, 1636416485306, 280, 0, 280, 0, 0, 0
1841, 1, 1636416485194, 1636416485470, 276, 0, 276, 0, 0, 0
1842, 1, 1636416485422, 1636416485698, 276, 1, 275, 0, 1, 1
1843, 1, 1636416485486, 1636416485754, 268, 0, 268, 0, 0, 0
1844, 1, 1636416485758, 1636416486034, 276, 0, 276, 0, 0, 0
1845, 1, 1636416486058, 1636416486334, 276, 0, 276, 0, 0, 0
1846, 1, 1636416486210, 1636416486478, 268, 1, 267, 0, 0, 0
1847, 1, 1636416486390, 1636416486662, 272, 0, 272, 0, 0, 0
1848, 1, 1636416486482, 1636416486758, 276, 0, 276, 0, 0, 0
1849, 1, 1636416486790, 1636416487066, 276, 1, 275, 0, 0, 0
1850, 1, 1636416487030, 1636416487306, 276, 1, 275, 0, 0, 0
1851, 1, 1636416487218, 1636416487498, 280, 1, 279, 0, 0, 0
1852, 1, 1636416487382, 1636416487662, 280, 0, 280, 0, 0, 0
1853, 1, 1636416487458, 1636416487730, 272, 1, 271, 0, 0, 0
1854, 1, 1636416487790, 1636416488066, 276, 0, 276, 0, 0, 0
1855, 1, 1636416487998, 1636416488270, 272, 0, 272, 0, 0, 0
1856, 1, 1636416488186, 1636416488462, 276, 1, 275, 1, 0, 1
1858, 1, 1636416488422, 1636416488698, 276, 0, 276, 0, 0, 0
1857, 1, 1636416488370, 1636416488738, 368, 93, 275, 93, 0, 93
1859, 1, 1636416488762, 1636416489038, 276, 1, 275, 0, 0, 0
1860, 1, 1636416488962, 1636416489318, 356, 77, 279, 77, 0, 77
1861, 1, 1636416489158, 1636416489434, 276, 1, 275, 1, 0, 1
1862, 1, 1636416489382, 1636416489654, 272, 0, 272, 0, 0, 0
1863, 1, 1636416489386, 1636416489662, 276, 0, 276, 0, 0, 0
1864, 1, 1636416489730, 1636416490006, 276, 0, 276, 0, 0, 0
1865, 1, 1636416489966, 1636416490242, 276, 0, 276, 0, 0, 0
1866, 1, 1636416490122, 1636416490398, 276, 1, 275, 1, 0, 1
1867, 1, 1636416490350, 1636416490626, 276, 0, 276, 0, 0, 0
1868, 1, 1636416490398, 1636416490670, 272, 0, 272, 0, 0, 0
1869, 1, 1636416490698, 1636416490974, 276, 0, 276, 0, 0, 0
1870, 1, 1636416490942, 1636416491210, 268, 1, 267, 0, 0, 0
1871, 1, 1636416491122, 1636416491398, 276, 1, 275, 0, 0, 0
1872, 1, 1636416491358, 1636416491634, 276, 0, 276, 0, 0, 0
1873, 1, 1636416491366, 1636416491642, 276, 1, 275, 0, 1, 1
1874, 1, 1636416491706, 1636416491978, 272, 0, 272, 0, 0, 0
1875, 1, 1636416491950, 1636416492226, 276, 0, 276, 0, 0, 0
1876, 1, 1636416492090, 1636416492366, 276, 0, 276, 0, 0, 0
1877, 1, 1636416492354, 1636416492630, 276, 0, 276, 0, 0, 0
1878, 1, 1636416492374, 1636416492650, 276, 0, 276, 0, 0, 0
1879, 1, 1636416492674, 1636416492950, 276, 0, 276, 0, 0, 0
1880, 1, 1636416492942, 1636416493214, 272, 1, 271, 0, 0, 0
1881, 1, 1636416493098, 1636416493374, 276, 1, 275, 1, 0, 1
1882, 1, 1636416493342, 1636416493618, 276, 0, 276, 0, 0, 0
1883, 1, 1636416493370, 1636416493642, 272, 0, 272, 0, 0, 0
1884, 1, 1636416493710, 1636416493986, 276, 0, 276, 0, 0, 0
1885, 1, 1636416493934, 1636416494210, 276, 1, 275, 1, 0, 1
1886, 1, 1636416494094, 1636416494370, 276, 0, 276, 0, 0, 0
1887, 1, 1636416494350, 1636416494626, 276, 0, 276, 0, 0, 0
1888, 1, 1636416494382, 1636416494662, 280, 0, 280, 0, 0, 0
1889, 1, 1636416494702, 1636416494974, 272, 0, 272, 0, 0, 0
1890, 1, 1636416494938, 1636416495206, 268, 0, 268, 0, 0, 0
1891, 1, 1636416495074, 1636416495350, 276, 1, 275, 1, 0, 1
1892, 1, 1636416495350, 1636416495622, 272, 1, 271, 0, 0, 0
1893, 1, 1636416495386, 1636416495662, 276, 0, 276, 0, 0, 0
1894, 1, 1636416495694, 1636416495966, 272, 0, 272, 0, 0, 0
1895, 1, 1636416495966, 1636416496246, 280, 0, 280, 0, 0, 0
1896, 1, 1636416496106, 1636416496382, 276, 0, 276, 0, 0, 0
1897, 1, 1636416496374, 1636416496654, 280, 1, 279, 0, 1, 1
1898, 1, 1636416496390, 1636416496658, 268, 0, 268, 0, 0, 0
1899, 1, 1636416496694, 1636416496970, 276, 0, 276, 0, 0, 0
1900, 1, 1636416496934, 1636416497206, 272, 1, 271, 0, 0, 0
1901, 1, 1636416497114, 1636416497394, 280, 0, 280, 0, 0, 0
1902, 1, 1636416497342, 1636416497618, 276, 0, 276, 0, 0, 0
1903, 1, 1636416497374, 1636416497646, 272, 0, 272, 0, 0, 0
1904, 1, 1636416497730, 1636416498006, 276, 1, 275, 0, 1, 1
1905, 1, 1636416497902, 1636416498178, 276, 1, 275, 1, 0, 1
1906, 1, 1636416498082, 1636416498354, 272, 0, 272, 0, 0, 0
1907, 1, 1636416498310, 1636416498586, 276, 0, 276, 0, 0, 0
1908, 1, 1636416498342, 1636416498614, 272, 0, 272, 0, 0, 0
1909, 1, 1636416498694, 1636416498966, 272, 1, 271, 0, 0, 0
1910, 1, 1636416498870, 1636416499142, 272, 1, 271, 0, 1, 1
1911, 1, 1636416499050, 1636416499322, 272, 1, 271, 0, 1, 1
1912, 1, 1636416499310, 1636416499586, 276, 1, 275, 1, 0, 1
1913, 1, 1636416499310, 1636416499586, 276, 1, 275, 0, 0, 0
1914, 1, 1636416499666, 1636416499942, 276, 1, 275, 0, 0, 0
1915, 1, 1636416499870, 1636416500146, 276, 1, 275, 0, 0, 0
1916, 1, 1636416500018, 1636416500290, 272, 0, 272, 0, 0, 0
1917, 1, 1636416500310, 1636416500582, 272, 0, 272, 0, 0, 0
1918, 1, 1636416500322, 1636416500594, 272, 0, 272, 0, 0, 0
1919, 1, 1636416500650, 1636416500922, 272, 0, 272, 0, 0, 0
1920, 1, 1636416500882, 1636416501158, 276, 0, 276, 0, 0, 0
1921, 1, 1636416501018, 1636416501294, 276, 0, 276, 0, 0, 0
1922, 1, 1636416501326, 1636416501598, 272, 0, 272, 0, 0, 0
1923, 1, 1636416501342, 1636416501618, 276, 0, 276, 0, 0, 0
1924, 1, 1636416501650, 1636416501926, 276, 0, 276, 0, 0, 0
1925, 1, 1636416501902, 1636416502178, 276, 0, 276, 0, 0, 0
1926, 1, 1636416502026, 1636416502302, 276, 0, 276, 0, 0, 0
1927, 1, 1636416502326, 1636416502602, 276, 0, 276, 0, 0, 0
1928, 1, 1636416502342, 1636416502610, 268, 0, 268, 0, 0, 0
1929, 1, 1636416502666, 1636416502942, 276, 0, 276, 0, 0, 0
1930, 1, 1636416502870, 1636416503142, 272, 1, 271, 1, 0, 1
1931, 1, 1636416503038, 1636416503310, 272, 1, 271, 0, 1, 1
1932, 1, 1636416503302, 1636416503574, 272, 1, 271, 0, 1, 1
1933, 1, 1636416503310, 1636416503578, 268, 0, 268, 0, 0, 0
1934, 1, 1636416503678, 1636416503954, 276, 0, 276, 0, 0, 0
1935, 1, 1636416503846, 1636416504122, 276, 1, 275, 0, 0, 0
1936, 1, 1636416504010, 1636416504286, 276, 0, 276, 0, 0, 0
1937, 1, 1636416504286, 1636416504558, 272, 0, 272, 0, 0, 0
1938, 1, 1636416504318, 1636416504586, 268, 0, 268, 0, 0, 0
1939, 1, 1636416504650, 1636416504922, 272, 1, 271, 0, 1, 1
1940, 1, 1636416504854, 1636416505130, 276, 0, 276, 0, 0, 0
1941, 1, 1636416504982, 1636416505258, 276, 0, 276, 0, 0, 0
1942, 1, 1636416505302, 1636416505574, 272, 0, 272, 0, 0, 0
1943, 1, 1636416505326, 1636416505606, 280, 0, 280, 0, 0, 0
1944, 1, 1636416505622, 1636416505902, 280, 0, 280, 0, 0, 0
1945, 1, 1636416505862, 1636416506134, 272, 0, 272, 0, 0, 0
1946, 1, 1636416505998, 1636416506274, 276, 1, 275, 1, 0, 1
1947, 1, 1636416506306, 1636416506582, 276, 1, 275, 1, 0, 1
1948, 1, 1636416506310, 1636416506582, 272, 0, 272, 0, 0, 0
1949, 1, 1636416506630, 1636416506902, 272, 0, 272, 0, 0, 0
1950, 1, 1636416506846, 1636416507118, 272, 1, 271, 0, 1, 1
1951, 1, 1636416507026, 1636416507302, 276, 1, 275, 1, 0, 1
1952, 1, 1636416507298, 1636416507574, 276, 0, 276, 0, 0, 0
1953, 1, 1636416507302, 1636416507574, 272, 0, 272, 0, 0, 0
1954, 1, 1636416507638, 1636416507910, 272, 1, 271, 0, 0, 0
1955, 1, 1636416507818, 1636416508090, 272, 0, 272, 0, 0, 0
1956, 1, 1636416508006, 1636416508278, 272, 1, 271, 1, 0, 1
1957, 1, 1636416508270, 1636416508546, 276, 0, 276, 0, 0, 0
1958, 1, 1636416508286, 1636416508562, 276, 0, 276, 0, 0, 0
1959, 1, 1636416508622, 1636416508898, 276, 0, 276, 0, 0, 0
1960, 1, 1636416508786, 1636416509062, 276, 0, 276, 0, 0, 0
1961, 1, 1636416508974, 1636416509246, 272, 0, 272, 0, 0, 0
1962, 1, 1636416509254, 1636416509530, 276, 0, 276, 0, 0, 0
1963, 1, 1636416509274, 1636416509554, 280, 1, 279, 0, 0, 0
1964, 1, 1636416509614, 1636416509886, 272, 1, 271, 0, 0, 0
1965, 1, 1636416509790, 1636416510066, 276, 1, 275, 0, 0, 0
1966, 1, 1636416509942, 1636416510218, 276, 0, 276, 0, 0, 0
1967, 1, 1636416510246, 1636416510522, 276, 0, 276, 0, 0, 0
1968, 1, 1636416510258, 1636416510526, 268, 0, 268, 0, 0, 0
1969, 1, 1636416510582, 1636416510854, 272, 0, 272, 0, 0, 0
1970, 1, 1636416510758, 1636416511034, 276, 0, 276, 0, 0, 0
1971, 1, 1636416510946, 1636416511210, 264, 1, 263, 0, 1, 1
1972, 1, 1636416511230, 1636416511510, 280, 0, 280, 0, 0, 0
1973, 1, 1636416511250, 1636416511526, 276, 0, 276, 0, 0, 0
1974, 1, 1636416511586, 1636416511862, 276, 1, 275, 0, 0, 0
1975, 1, 1636416511798, 1636416512074, 276, 1, 275, 0, 1, 1
1976, 1, 1636416511914, 1636416512190, 276, 0, 276, 0, 0, 0
1977, 1, 1636416512226, 1636416512502, 276, 0, 276, 0, 0, 0
1978, 1, 1636416512234, 1636416512518, 284, 0, 284, 0, 0, 0
1979, 1, 1636416512554, 1636416512830, 276, 0, 276, 0, 0, 0
1980, 1, 1636416512766, 1636416513047, 281, 1, 280, 0, 1, 1
1981, 1, 1636416512922, 1636416513198, 276, 1, 275, 1, 0, 1
1982, 1, 1636416513210, 1636416513486, 276, 0, 276, 0, 0, 0
1983, 1, 1636416513226, 1636416513498, 272, 0, 272, 0, 0, 0
1984, 1, 1636416513586, 1636416513862, 276, 1, 275, 0, 0, 0
1985, 1, 1636416513766, 1636416514042, 276, 1, 275, 0, 0, 0
1986, 1, 1636416513898, 1636416514166, 268, 1, 267, 0, 0, 0
1987, 1, 1636416514206, 1636416514478, 272, 0, 272, 0, 0, 0
1988, 1, 1636416514226, 1636416514510, 284, 0, 284, 0, 0, 0
1989, 1, 1636416514578, 1636416514850, 272, 1, 271, 0, 1, 1
1990, 1, 1636416514766, 1636416515038, 272, 0, 272, 0, 0, 0
1991, 1, 1636416514890, 1636416515158, 268, 0, 268, 0, 0, 0
1992, 1, 1636416515206, 1636416515486, 280, 0, 280, 0, 0, 0
1993, 1, 1636416515250, 1636416515526, 276, 0, 276, 0, 0, 0
1994, 1, 1636416515574, 1636416515846, 272, 0, 272, 0, 0, 0
1995, 1, 1636416515778, 1636416516054, 276, 1, 275, 0, 0, 0
1996, 1, 1636416515890, 1636416516166, 276, 1, 275, 0, 0, 0
1997, 1, 1636416516214, 1636416516486, 272, 0, 272, 0, 0, 0
1998, 1, 1636416516266, 1636416516538, 272, 0, 272, 0, 0, 0
1999, 1, 1636416516574, 1636416516850, 276, 0, 276, 0, 0, 0
2000, 1, 1636416516794, 1636416517070, 276, 0, 276, 0, 0, 0
2001, 1, 1636416516902, 1636416517178, 276, 0, 276, 0, 0, 0
2002, 1, 1636416517234, 1636416517506, 272, 0, 272, 0, 0, 0
2003, 1, 1636416517238, 1636416517514, 276, 0, 276, 0, 0, 0
2004, 1, 1636416517582, 1636416517854, 272, 0, 272, 0, 0, 0
2005, 1, 1636416517762, 1636416518039, 277, 0, 277, 0, 0, 0
2006, 1, 1636416517918, 1636416518190, 272, 0, 272, 0, 0, 0
2007, 1, 1636416518202, 1636416518478, 276, 0, 276, 0, 0, 0
2008, 1, 1636416518214, 1636416518486, 272, 0, 272, 0, 0, 0
2009, 1, 1636416518602, 1636416518870, 268, 1, 267, 1, 0, 1
2010, 1, 1636416518742, 1636416519014, 272, 1, 271, 0, 0, 0
2011, 1, 1636416518886, 1636416519162, 276, 0, 276, 0, 0, 0
2012, 1, 1636416519186, 1636416519462, 276, 0, 276, 0, 0, 0
2013, 1, 1636416519226, 1636416519502, 276, 1, 275, 0, 0, 0
2014, 1, 1636416519570, 1636416519842, 272, 0, 272, 0, 0, 0
2015, 1, 1636416519754, 1636416520022, 268, 1, 267, 0, 0, 0
2016, 1, 1636416519866, 1636416520134, 268, 1, 267, 0, 0, 0
2017, 1, 1636416520186, 1636416520458, 272, 0, 272, 0, 0, 0
2018, 1, 1636416520234, 1636416520510, 276, 0, 276, 0, 0, 0
2019, 1, 1636416520550, 1636416520822, 272, 1, 271, 0, 0, 0
2020, 1, 1636416520786, 1636416521062, 276, 1, 275, 0, 0, 0
2021, 1, 1636416520878, 1636416521154, 276, 0, 276, 0, 0, 0
2023, 1, 1636416521218, 1636416521486, 268, 1, 267, 0, 0, 0
2022, 1, 1636416521214, 1636416521486, 272, 0, 272, 0, 0, 0
2024, 1, 1636416521562, 1636416521834, 272, 1, 271, 0, 1, 1
2025, 1, 1636416521766, 1636416522039, 273, 0, 273, 0, 0, 0
2026, 1, 1636416521910, 1636416522182, 272, 0, 272, 0, 0, 0
2027, 1, 1636416522198, 1636416522470, 272, 0, 272, 0, 0, 0
2028, 1, 1636416522246, 1636416522522, 276, 0, 276, 0, 0, 0
2029, 1, 1636416522594, 1636416522870, 276, 0, 276, 0, 0, 0
2030, 1, 1636416522798, 1636416523074, 276, 1, 275, 1, 0, 1
2031, 1, 1636416522890, 1636416523162, 272, 1, 271, 0, 0, 0
2032, 1, 1636416523234, 1636416523514, 280, 0, 280, 0, 0, 0
2033, 1, 1636416523258, 1636416523534, 276, 1, 275, 0, 1, 1
2034, 1, 1636416523574, 1636416523854, 280, 0, 280, 0, 0, 0
2035, 1, 1636416523811, 1636416524086, 275, 0, 275, 0, 0, 0
2036, 1, 1636416523922, 1636416524198, 276, 0, 276, 0, 0, 0
2037, 1, 1636416524234, 1636416524506, 272, 0, 272, 0, 0, 0
2038, 1, 1636416524254, 1636416524530, 276, 0, 276, 0, 0, 0
2039, 1, 1636416524590, 1636416524862, 272, 0, 272, 0, 0, 0
2040, 1, 1636416524806, 1636416525082, 276, 0, 276, 0, 0, 0
2041, 1, 1636416524934, 1636416525210, 276, 1, 275, 0, 0, 0
2042, 1, 1636416525234, 1636416525510, 276, 1, 275, 1, 0, 1
2043, 1, 1636416525234, 1636416525514, 280, 1, 279, 0, 0, 0
2044, 1, 1636416525602, 1636416525878, 276, 1, 275, 0, 0, 0
2045, 1, 1636416525790, 1636416526066, 276, 0, 276, 0, 0, 0
2046, 1, 1636416525934, 1636416526210, 276, 0, 276, 0, 0, 0
2047, 1, 1636416526206, 1636416526478, 272, 0, 272, 0, 0, 0
2048, 1, 1636416526270, 1636416526542, 272, 0, 272, 0, 0, 0
2049, 1, 1636416526598, 1636416526870, 272, 0, 272, 0, 0, 0
2050, 1, 1636416526822, 1636416527098, 276, 0, 276, 0, 0, 0
2051, 1, 1636416526914, 1636416527186, 272, 0, 272, 0, 0, 0
2052, 1, 1636416527202, 1636416527474, 272, 1, 271, 0, 0, 0
2053, 1, 1636416527306, 1636416527742, 436, 169, 267, 169, 0, 169
2054, 1, 1636416527578, 1636416527854, 276, 0, 276, 0, 0, 0
2055, 1, 1636416527850, 1636416528122, 272, 0, 272, 0, 0, 0
2056, 1, 1636416527914, 1636416528390, 476, 208, 268, 208, 0, 208
2058, 1, 1636416528306, 1636416528586, 280, 1, 279, 0, 0, 0
2057, 1, 1636416528238, 1636416528666, 428, 153, 275, 153, 0, 153
2059, 1, 1636416528578, 1636416528942, 364, 89, 275, 89, 0, 89
2060, 1, 1636416528874, 1636416529150, 276, 1, 275, 0, 1, 1
2061, 1, 1636416528934, 1636416529218, 284, 9, 275, 8, 1, 9
2062, 1, 1636416529246, 1636416529522, 276, 0, 276, 0, 0, 0
2063, 1, 1636416529278, 1636416529554, 276, 0, 276, 0, 0, 0
2064, 1, 1636416529590, 1636416529866, 276, 0, 276, 0, 0, 0
2065, 1, 1636416529846, 1636416530122, 276, 0, 276, 0, 0, 0
2066, 1, 1636416529938, 1636416530210, 272, 0, 272, 0, 0, 0
2067, 1, 1636416530218, 1636416530495, 277, 0, 277, 0, 0, 0
2068, 1, 1636416530306, 1636416530586, 280, 0, 280, 0, 0, 0
2069, 1, 1636416530622, 1636416530898, 276, 1, 275, 0, 1, 1
2070, 1, 1636416530870, 1636416531146, 276, 1, 275, 0, 1, 1
2071, 1, 1636416530922, 1636416531198, 276, 0, 276, 0, 0, 0
2072, 1, 1636416531242, 1636416531518, 276, 0, 276, 0, 0, 0
2073, 1, 1636416531302, 1636416531578, 276, 0, 276, 0, 0, 0
2074, 1, 1636416531606, 1636416531882, 276, 1, 275, 0, 0, 0
2075, 1, 1636416531910, 1636416532186, 276, 0, 276, 0, 0, 0
2076, 1, 1636416531942, 1636416532210, 268, 0, 268, 0, 0, 0
2077, 1, 1636416532278, 1636416532554, 276, 1, 275, 0, 1, 1
2078, 1, 1636416532330, 1636416532606, 276, 0, 276, 0, 0, 0
2079, 1, 1636416532630, 1636416532906, 276, 1, 275, 0, 0, 0
2080, 1, 1636416532926, 1636416533202, 276, 0, 276, 0, 0, 0
2081, 1, 1636416532978, 1636416533250, 272, 0, 272, 0, 0, 0
2084, 1, 1636416533630, 1636416533906, 276, 1, 275, 0, 0, 0
2082, 2, 1636416533298, 1636416543302, 10004, 0, 10004, 0, 0, 0
2083, 2, 1636416533298, 1636416543346, 10048, 0, 10048, 0, 0, 0
2088, 1, 1636416543610, 1636416543886, 276, 0, 276, 0, 0, 0
2085, 2, 1636416533918, 1636416543918, 10000, 0, 10000, 0, 0, 0
2086, 2, 1636416533998, 1636416543998, 10000, 0, 10000, 0, 0, 0
2091, 1, 1636416544306, 1636416544586, 280, 1, 279, 1, 0, 1
2087, 2, 1636416534650, 1636416544650, 10000, 0, 10000, 0, 0, 0
2093, 1, 1636416544954, 1636416545230, 276, 1, 275, 0, 0, 0
2089, 2, 1636416543614, 1636416553614, 10000, 0, 10000, 0, 0, 0
2096, 1, 1636416553922, 1636416554194, 272, 0, 272, 0, 0, 0
2090, 2, 1636416544266, 1636416554266, 10000, 0, 10000, 0, 0, 0
2092, 2, 1636416544522, 1636416554522, 10000, 0, 10000, 0, 0, 0
2097, 1, 1636416554610, 1636416554882, 272, 0, 272, 0, 0, 0
2099, 1, 1636416554830, 1636416555106, 276, 0, 276, 0, 0, 0
2098, 1, 1636416554830, 1636416555150, 320, 53, 267, 53, 0, 53
2094, 2, 1636416545210, 1636416555210, 10000, 0, 10000, 0, 0, 0
2095, 1, 1636416545851, 1636416555486, 9635, 9359, 276, 0, 9359, 9359
2101, 1, 1636416555478, 1636416555754, 276, 0, 276, 0, 0, 0
2100, 1, 1636416555518, 1636416555794, 276, 0, 276, 0, 0, 0
2102, 1, 1636416555742, 1636416556022, 280, 13, 267, 13, 0, 13
2104, 1, 1636416555862, 1636416556134, 272, 0, 272, 0, 0, 0
2103, 1, 1636416555882, 1636416556154, 272, 1, 271, 0, 1, 1
2105, 1, 1636416556426, 1636416556702, 276, 0, 276, 0, 0, 0
2106, 1, 1636416556510, 1636416556786, 276, 1, 275, 0, 0, 0
2107, 1, 1636416556774, 1636416557058, 284, 13, 271, 13, 0, 13
2108, 1, 1636416556838, 1636416557106, 268, 0, 268, 0, 0, 0
2109, 1, 1636416556854, 1636416557122, 268, 0, 268, 0, 0, 0
2110, 1, 1636416557458, 1636416557726, 268, 0, 268, 0, 0, 0
2111, 1, 1636416557482, 1636416557750, 268, 0, 268, 0, 0, 0
2112, 1, 1636416557742, 1636416558026, 284, 9, 275, 8, 0, 8
2113, 1, 1636416557826, 1636416558090, 264, 1, 263, 0, 0, 0
2114, 1, 1636416557838, 1636416558114, 276, 0, 276, 0, 0, 0
2115, 1, 1636416558430, 1636416558706, 276, 0, 276, 0, 0, 0
2116, 1, 1636416558462, 1636416558734, 272, 0, 272, 0, 0, 0
2117, 1, 1636416558730, 1636416558998, 268, 5, 263, 4, 0, 4
2118, 1, 1636416558802, 1636416559074, 272, 0, 272, 0, 0, 0
2119, 1, 1636416558858, 1636416559134, 276, 0, 276, 0, 0, 0
2120, 1, 1636416559406, 1636416559682, 276, 0, 276, 0, 0, 0
2121, 1, 1636416559466, 1636416559742, 276, 0, 276, 0, 0, 0
2122, 1, 1636416559730, 1636416560018, 288, 13, 275, 13, 0, 13
2123, 1, 1636416559774, 1636416560046, 272, 0, 272, 0, 0, 0
2124, 1, 1636416559822, 1636416560090, 268, 0, 268, 0, 0, 0
2125, 1, 1636416560422, 1636416560698, 276, 0, 276, 0, 0, 0
2126, 1, 1636416560434, 1636416560706, 272, 0, 272, 0, 0, 0
2127, 1, 1636416560706, 1636416560982, 276, 1, 275, 0, 1, 1
2128, 1, 1636416560774, 1636416561050, 276, 0, 276, 0, 0, 0
2129, 1, 1636416560858, 1636416561134, 276, 0, 276, 0, 0, 0
2130, 1, 1636416561386, 1636416561658, 272, 1, 271, 0, 1, 1
2131, 1, 1636416561454, 1636416561731, 277, 0, 277, 0, 0, 0
2132, 1, 1636416561730, 1636416562006, 276, 1, 275, 0, 0, 0
2133, 1, 1636416561742, 1636416562022, 280, 0, 280, 0, 0, 0
2134, 1, 1636416561886, 1636416562158, 272, 1, 271, 0, 0, 0
2135, 1, 1636416562410, 1636416562686, 276, 0, 276, 0, 0, 0
2136, 1, 1636416562482, 1636416562754, 272, 0, 272, 0, 0, 0
2137, 1, 1636416562754, 1636416563030, 276, 1, 275, 1, 0, 1
2138, 1, 1636416562774, 1636416563050, 276, 1, 275, 0, 1, 1
2139, 1, 1636416562870, 1636416563146, 276, 1, 275, 0, 1, 1
2140, 1, 1636416563418, 1636416563686, 268, 0, 268, 0, 0, 0
2141, 1, 1636416563470, 1636416563742, 272, 0, 272, 0, 0, 0
2142, 1, 1636416563742, 1636416564010, 268, 1, 267, 1, 0, 1
2143, 1, 1636416563798, 1636416564074, 276, 0, 276, 0, 0, 0
2144, 1, 1636416563902, 1636416564174, 272, 0, 272, 0, 0, 0
2145, 1, 1636416564406, 1636416564682, 276, 0, 276, 0, 0, 0
2146, 1, 1636416564502, 1636416564774, 272, 0, 272, 0, 0, 0
2147, 1, 1636416564778, 1636416565054, 276, 0, 276, 0, 0, 0
2148, 1, 1636416564786, 1636416565066, 280, 0, 280, 0, 0, 0
2149, 1, 1636416564906, 1636416565186, 280, 1, 279, 0, 1, 1
2150, 1, 1636416565434, 1636416565710, 276, 1, 275, 0, 0, 0
2151, 1, 1636416565510, 1636416565786, 276, 1, 275, 0, 1, 1
2152, 1, 1636416565790, 1636416566062, 272, 0, 272, 0, 0, 0
2153, 1, 1636416565814, 1636416566090, 276, 1, 275, 0, 1, 1
2154, 1, 1636416565898, 1636416566170, 272, 0, 272, 0, 0, 0
2155, 1, 1636416566442, 1636416566718, 276, 0, 276, 0, 0, 0
2156, 1, 1636416566474, 1636416566746, 272, 1, 271, 1, 0, 1
2157, 1, 1636416566778, 1636416567046, 268, 0, 268, 0, 0, 0
2158, 1, 1636416566822, 1636416567098, 276, 1, 275, 0, 0, 0
2159, 1, 1636416566910, 1636416567186, 276, 0, 276, 0, 0, 0
2160, 1, 1636416567414, 1636416567690, 276, 0, 276, 0, 0, 0
2161, 1, 1636416567486, 1636416567762, 276, 0, 276, 0, 0, 0
2162, 1, 1636416567786, 1636416568062, 276, 0, 276, 0, 0, 0
2163, 1, 1636416567814, 1636416568090, 276, 1, 275, 0, 0, 0
2164, 1, 1636416567886, 1636416568162, 276, 1, 275, 1, 0, 1
2165, 1, 1636416568418, 1636416568690, 272, 0, 272, 0, 0, 0
2166, 1, 1636416568462, 1636416568738, 276, 0, 276, 0, 0, 0
2167, 1, 1636416568762, 1636416569034, 272, 1, 271, 0, 0, 0
2168, 1, 1636416568822, 1636416569098, 276, 0, 276, 0, 0, 0
2169, 1, 1636416568902, 1636416569178, 276, 0, 276, 0, 0, 0
2170, 1, 1636416569398, 1636416569675, 277, 0, 277, 0, 0, 0
2171, 1, 1636416569466, 1636416569742, 276, 0, 276, 0, 0, 0
2172, 1, 1636416569778, 1636416570050, 272, 0, 272, 0, 0, 0
2173, 1, 1636416569798, 1636416570074, 276, 0, 276, 0, 0, 0
2174, 1, 1636416569902, 1636416570178, 276, 1, 275, 1, 0, 1
2175, 1, 1636416570402, 1636416570678, 276, 0, 276, 0, 0, 0
2176, 1, 1636416570470, 1636416570746, 276, 0, 276, 0, 0, 0
2177, 1, 1636416570782, 1636416571058, 276, 0, 276, 0, 0, 0
2178, 1, 1636416570818, 1636416571094, 276, 0, 276, 0, 0, 0
2179, 1, 1636416570878, 1636416571374, 496, 217, 279, 217, 0, 217
2180, 1, 1636416571414, 1636416571686, 272, 0, 272, 0, 0, 0
2181, 1, 1636416571438, 1636416571714, 276, 0, 276, 0, 0, 0
2182, 1, 1636416571754, 1636416572026, 272, 1, 271, 0, 0, 0
2183, 1, 1636416571822, 1636416572098, 276, 0, 276, 0, 0, 0
2184, 1, 1636416571898, 1636416572174, 276, 0, 276, 0, 0, 0
2185, 1, 1636416572386, 1636416572662, 276, 0, 276, 0, 0, 0
2186, 1, 1636416572446, 1636416572722, 276, 0, 276, 0, 0, 0
2187, 1, 1636416572758, 1636416573030, 272, 0, 272, 0, 0, 0
2188, 1, 1636416572798, 1636416573070, 272, 1, 271, 0, 0, 0
2189, 1, 1636416572906, 1636416573182, 276, 1, 275, 0, 1, 1
2190, 1, 1636416573398, 1636416573674, 276, 1, 275, 0, 0, 0
2191, 1, 1636416573462, 1636416573738, 276, 1, 275, 0, 0, 0
2192, 1, 1636416573794, 1636416574070, 276, 1, 275, 0, 0, 0
2193, 1, 1636416573806, 1636416574082, 276, 0, 276, 0, 0, 0
2194, 1, 1636416573910, 1636416574186, 276, 1, 275, 0, 0, 0
2195, 1, 1636416574410, 1636416574682, 272, 0, 272, 0, 0, 0
2196, 1, 1636416574462, 1636416574734, 272, 0, 272, 0, 0, 0
2197, 1, 1636416574794, 1636416575066, 272, 0, 272, 0, 0, 0
2198, 1, 1636416574822, 1636416575098, 276, 1, 275, 0, 0, 0
2199, 1, 1636416574886, 1636416575158, 272, 1, 271, 0, 1, 1
2200, 1, 1636416575410, 1636416575682, 272, 1, 271, 0, 0, 0
2201, 1, 1636416575446, 1636416575718, 272, 0, 272, 0, 0, 0
2202, 1, 1636416575774, 1636416576050, 276, 0, 276, 0, 0, 0
2203, 1, 1636416575798, 1636416576074, 276, 1, 275, 1, 0, 1
2204, 1, 1636416575910, 1636416576186, 276, 1, 275, 0, 1, 1
2205, 1, 1636416576394, 1636416576671, 277, 0, 277, 0, 0, 0
2206, 1, 1636416576458, 1636416576734, 276, 0, 276, 0, 0, 0
2207, 1, 1636416576782, 1636416577054, 272, 0, 272, 0, 0, 0
2208, 1, 1636416576798, 1636416577074, 276, 0, 276, 0, 0, 0
2209, 1, 1636416576902, 1636416577178, 276, 1, 275, 0, 0, 0
2210, 1, 1636416577406, 1636416577674, 268, 0, 268, 0, 0, 0
2211, 1, 1636416577450, 1636416577718, 268, 0, 268, 0, 0, 0
2212, 1, 1636416577790, 1636416578066, 276, 0, 276, 0, 0, 0
2213, 1, 1636416577806, 1636416578074, 268, 1, 267, 0, 0, 0
2214, 1, 1636416577926, 1636416578198, 272, 1, 271, 0, 1, 1
2215, 1, 1636416578398, 1636416578675, 277, 0, 277, 0, 0, 0
2216, 1, 1636416578474, 1636416578750, 276, 0, 276, 0, 0, 0
2217, 1, 1636416578798, 1636416579070, 272, 0, 272, 0, 0, 0
2218, 1, 1636416578814, 1636416579090, 276, 1, 275, 0, 0, 0
2219, 1, 1636416578910, 1636416579187, 277, 1, 276, 1, 0, 1
2220, 1, 1636416579422, 1636416579694, 272, 1, 271, 0, 0, 0
2221, 1, 1636416579458, 1636416579734, 276, 1, 275, 0, 1, 1
2222, 1, 1636416579798, 1636416580074, 276, 0, 276, 0, 0, 0
2223, 1, 1636416579818, 1636416580094, 276, 0, 276, 0, 0, 0
2224, 1, 1636416579922, 1636416580198, 276, 0, 276, 0, 0, 0
2225, 1, 1636416580406, 1636416580682, 276, 0, 276, 0, 0, 0
2226, 1, 1636416580474, 1636416580746, 272, 0, 272, 0, 0, 0
2227, 1, 1636416580806, 1636416581082, 276, 0, 276, 0, 0, 0
2228, 1, 1636416580814, 1636416581090, 276, 0, 276, 0, 0, 0
2229, 1, 1636416580954, 1636416581230, 276, 1, 275, 0, 0, 0
2230, 1, 1636416581422, 1636416581698, 276, 1, 275, 0, 0, 0
2231, 1, 1636416581502, 1636416581778, 276, 1, 275, 0, 1, 1
2232, 1, 1636416581822, 1636416582098, 276, 0, 276, 0, 0, 0
2233, 1, 1636416581846, 1636416582122, 276, 0, 276, 0, 0, 0
2234, 1, 1636416581946, 1636416582214, 268, 0, 268, 0, 0, 0
2235, 1, 1636416582422, 1636416582698, 276, 0, 276, 0, 0, 0
2236, 1, 1636416582474, 1636416582746, 272, 0, 272, 0, 0, 0
2237, 1, 1636416582822, 1636416583098, 276, 0, 276, 0, 0, 0
2238, 1, 1636416582834, 1636416583102, 268, 0, 268, 0, 0, 0
2239, 1, 1636416582930, 1636416583202, 272, 0, 272, 0, 0, 0
2240, 1, 1636416583394, 1636416583670, 276, 0, 276, 0, 0, 0
2241, 1, 1636416583462, 1636416583734, 272, 0, 272, 0, 0, 0
2242, 1, 1636416583814, 1636416584090, 276, 0, 276, 0, 0, 0
2243, 1, 1636416583822, 1636416584094, 272, 0, 272, 0, 0, 0
2244, 1, 1636416583930, 1636416584202, 272, 1, 271, 0, 0, 0
2245, 1, 1636416584382, 1636416584654, 272, 1, 271, 0, 0, 0
2246, 1, 1636416584462, 1636416584730, 268, 0, 268, 0, 0, 0
2247, 1, 1636416584798, 1636416585079, 281, 0, 281, 0, 0, 0
2248, 1, 1636416584850, 1636416585126, 276, 0, 276, 0, 0, 0
2249, 1, 1636416584930, 1636416585350, 420, 149, 271, 149, 0, 149
2250, 1, 1636416585382, 1636416585658, 276, 0, 276, 0, 0, 0
2251, 1, 1636416585434, 1636416585706, 272, 0, 272, 0, 0, 0
2252, 1, 1636416585826, 1636416586102, 276, 0, 276, 0, 0, 0
2253, 1, 1636416585830, 1636416586106, 276, 1, 275, 0, 0, 0
2254, 1, 1636416585946, 1636416586222, 276, 1, 275, 1, 0, 1
2255, 1, 1636416586358, 1636416586634, 276, 1, 275, 1, 0, 1
2256, 1, 1636416586438, 1636416586714, 276, 0, 276, 0, 0, 0
2258, 1, 1636416586830, 1636416587102, 272, 0, 272, 0, 0, 0
2257, 1, 1636416586830, 1636416587106, 276, 0, 276, 0, 0, 0
2259, 1, 1636416586942, 1636416587218, 276, 1, 275, 0, 0, 0
2260, 1, 1636416587382, 1636416587658, 276, 1, 275, 1, 0, 1
2261, 1, 1636416587438, 1636416587714, 276, 0, 276, 0, 0, 0
2262, 1, 1636416587826, 1636416588102, 276, 1, 275, 0, 0, 0
2263, 1, 1636416587854, 1636416588126, 272, 1, 271, 0, 0, 0
2264, 1, 1636416587974, 1636416588250, 276, 1, 275, 0, 1, 1
2265, 1, 1636416588378, 1636416588654, 276, 1, 275, 1, 0, 1
2266, 1, 1636416588462, 1636416588738, 276, 0, 276, 0, 0, 0
2267, 1, 1636416588850, 1636416589126, 276, 1, 275, 0, 0, 0
2268, 1, 1636416588854, 1636416589126, 272, 1, 271, 0, 0, 0
2269, 1, 1636416589006, 1636416589282, 276, 1, 275, 0, 0, 0
2270, 1, 1636416589406, 1636416589678, 272, 0, 272, 0, 0, 0
2271, 1, 1636416589494, 1636416589770, 276, 0, 276, 0, 0, 0
2272, 1, 1636416589858, 1636416590134, 276, 0, 276, 0, 0, 0
2273, 1, 1636416589886, 1636416590158, 272, 1, 271, 0, 1, 1
2274, 1, 1636416589982, 1636416590250, 268, 1, 267, 0, 0, 0
2275, 1, 1636416590438, 1636416590714, 276, 0, 276, 0, 0, 0
2276, 1, 1636416590474, 1636416590750, 276, 0, 276, 0, 0, 0
2277, 1, 1636416590874, 1636416591150, 276, 0, 276, 0, 0, 0
2278, 1, 1636416590898, 1636416591174, 276, 0, 276, 0, 0, 0
2279, 1, 1636416590954, 1636416591234, 280, 0, 280, 0, 0, 0
2280, 1, 1636416591422, 1636416591690, 268, 0, 268, 0, 0, 0
2281, 1, 1636416591450, 1636416591722, 272, 1, 271, 0, 1, 1
2282, 1, 1636416591850, 1636416592126, 276, 0, 276, 0, 0, 0
2283, 1, 1636416591874, 1636416592154, 280, 0, 280, 0, 0, 0
2284, 1, 1636416591934, 1636416592210, 276, 0, 276, 0, 0, 0
2285, 1, 1636416592398, 1636416592670, 272, 0, 272, 0, 0, 0
2286, 1, 1636416592422, 1636416592690, 268, 1, 267, 0, 1, 1
2287, 1, 1636416592826, 1636416593098, 272, 0, 272, 0, 0, 0
2288, 1, 1636416592854, 1636416593126, 272, 0, 272, 0, 0, 0
2289, 1, 1636416592962, 1636416593234, 272, 1, 271, 0, 0, 0
2290, 1, 1636416593370, 1636416593646, 276, 1, 275, 1, 0, 1
2291, 1, 1636416593454, 1636416593730, 276, 0, 276, 0, 0, 0
2292, 1, 1636416593826, 1636416594098, 272, 0, 272, 0, 0, 0
2293, 1, 1636416593858, 1636416594126, 268, 0, 268, 0, 0, 0
2294, 1, 1636416593954, 1636416594226, 272, 0, 272, 0, 0, 0
2295, 1, 1636416594386, 1636416594658, 272, 1, 271, 0, 0, 0
2296, 1, 1636416594418, 1636416594694, 276, 1, 275, 1, 0, 1
2297, 1, 1636416594850, 1636416595130, 280, 1, 279, 0, 0, 0
2298, 1, 1636416594858, 1636416595138, 280, 0, 280, 0, 0, 0
2299, 1, 1636416595374, 1636416595655, 281, 1, 280, 0, 1, 1
2300, 1, 1636416595822, 1636416596099, 277, 1, 276, 0, 0, 0
2301, 1, 1636416740654, 1636416740930, 276, 1, 275, 1, 0, 1
2302, 1, 1636416741266, 1636416741542, 276, 1, 275, 0, 0, 0
2303, 1, 1636416741470, 1636416741746, 276, 1, 275, 0, 0, 0
2304, 1, 1636416741658, 1636416741934, 276, 0, 276, 0, 0, 0
2305, 1, 1636416742098, 1636416742366, 268, 1, 267, 0, 0, 0
2306, 1, 1636416742298, 1636416742578, 280, 1, 279, 0, 0, 0
2307, 1, 1636416742318, 1636416742586, 268, 1, 267, 0, 0, 0
2308, 1, 1636416742490, 1636416742766, 276, 0, 276, 0, 0, 0
2309, 1, 1636416742810, 1636416743078, 268, 0, 268, 0, 0, 0
2310, 1, 1636416742918, 1636416743190, 272, 0, 272, 0, 0, 0
2311, 1, 1636416743134, 1636416743406, 272, 0, 272, 0, 0, 0
2312, 1, 1636416743150, 1636416743430, 280, 0, 280, 0, 0, 0
2313, 1, 1636416743318, 1636416743594, 276, 0, 276, 0, 0, 0
2314, 1, 1636416743630, 1636416743906, 276, 1, 275, 0, 0, 0
2315, 1, 1636416743754, 1636416744026, 272, 0, 272, 0, 0, 0
2316, 1, 1636416743974, 1636416744246, 272, 0, 272, 0, 0, 0
2317, 1, 1636416743978, 1636416744250, 272, 0, 272, 0, 0, 0
2318, 1, 1636416744154, 1636416744430, 276, 0, 276, 0, 0, 0
2319, 1, 1636416744462, 1636416744738, 276, 1, 275, 0, 0, 0
2320, 1, 1636416744594, 1636416744866, 272, 1, 271, 0, 1, 1
2322, 1, 1636416744814, 1636416745086, 272, 0, 272, 0, 0, 0
2321, 1, 1636416744806, 1636416745134, 328, 61, 267, 61, 0, 61
2323, 1, 1636416744994, 1636416745402, 408, 141, 267, 141, 0, 141
2324, 1, 1636416745298, 1636416745570, 272, 0, 272, 0, 0, 0
2325, 1, 1636416745430, 1636416745702, 272, 1, 271, 0, 0, 0
2326, 1, 1636416745646, 1636416745910, 264, 0, 264, 0, 0, 0
2327, 1, 1636416745658, 1636416745966, 308, 45, 263, 45, 0, 45
2328, 1, 1636416745826, 1636416746238, 412, 141, 271, 141, 0, 141
2329, 1, 1636416746138, 1636416746514, 376, 101, 275, 101, 0, 101
2330, 1, 1636416746274, 1636416746550, 276, 1, 275, 0, 0, 0
2332, 1, 1636416746494, 1636416746778, 284, 0, 284, 0, 0, 0
2331, 1, 1636416746474, 1636416746782, 308, 41, 267, 40, 0, 40
2333, 1, 1636416746658, 1636416746926, 268, 0, 268, 0, 0, 0
2334, 1, 1636416746970, 1636416747242, 272, 0, 272, 0, 0, 0
2335, 1, 1636416747122, 1636416747398, 276, 1, 275, 0, 0, 0
2336, 1, 1636416747318, 1636416747594, 276, 0, 276, 0, 0, 0
2337, 1, 1636416747322, 1636416747594, 272, 0, 272, 0, 0, 0
2338, 1, 1636416747506, 1636416747770, 264, 1, 263, 0, 1, 1
2339, 1, 1636416747818, 1636416748086, 268, 0, 268, 0, 0, 0
2340, 1, 1636416747970, 1636416748246, 276, 1, 275, 0, 0, 0
2341, 1, 1636416748166, 1636416748438, 272, 0, 272, 0, 0, 0
2342, 1, 1636416748170, 1636416748446, 276, 0, 276, 0, 0, 0
2343, 1, 1636416748354, 1636416748622, 268, 1, 267, 1, 0, 1
2344, 1, 1636416748666, 1636416748938, 272, 0, 272, 0, 0, 0
2345, 1, 1636416748818, 1636416749090, 272, 1, 271, 1, 0, 1
2346, 1, 1636416748998, 1636416749266, 268, 0, 268, 0, 0, 0
2347, 1, 1636416749018, 1636416749290, 272, 1, 271, 0, 0, 0
2348, 1, 1636416749198, 1636416749474, 276, 0, 276, 0, 0, 0
2349, 1, 1636416749502, 1636416749774, 272, 0, 272, 0, 0, 0
2350, 1, 1636416749650, 1636416749930, 280, 0, 280, 0, 0, 0
2351, 1, 1636416749826, 1636416750102, 276, 0, 276, 0, 0, 0
2352, 1, 1636416749866, 1636416750134, 268, 1, 267, 0, 0, 0
2353, 1, 1636416750030, 1636416750302, 272, 1, 271, 0, 0, 0
2354, 1, 1636416750350, 1636416750626, 276, 0, 276, 0, 0, 0
2355, 1, 1636416750466, 1636416750734, 268, 0, 268, 0, 0, 0
2356, 1, 1636416750642, 1636416750922, 280, 0, 280, 0, 0, 0
2358, 1, 1636416750850, 1636416751126, 276, 0, 276, 0, 0, 0
2357, 1, 1636416750694, 1636416751194, 500, 229, 271, 229, 0, 229
2359, 1, 1636416751186, 1636416751466, 280, 8, 272, 8, 0, 8
2360, 1, 1636416751282, 1636416751742, 460, 185, 275, 185, 0, 185
2361, 1, 1636416751486, 1636416751762, 276, 0, 276, 0, 0, 0
2363, 1, 1636416751666, 1636416752018, 352, 77, 275, 77, 0, 77
2362, 1, 1636416751594, 1636416752034, 440, 169, 271, 169, 0, 169
2364, 1, 1636416751998, 1636416752274, 276, 0, 276, 0, 0, 0
2365, 1, 1636416752158, 1636416752430, 272, 1, 271, 1, 0, 1
2366, 1, 1636416752314, 1636416752586, 272, 0, 272, 0, 0, 0
2367, 1, 1636416752430, 1636416752702, 272, 0, 272, 0, 0, 0
2368, 1, 1636416752498, 1636416752770, 272, 0, 272, 0, 0, 0
2369, 1, 1636416752826, 1636416753106, 280, 0, 280, 0, 0, 0
2370, 1, 1636416752934, 1636416753210, 276, 1, 275, 0, 1, 1
2371, 1, 1636416753150, 1636416753414, 264, 1, 263, 1, 0, 1
2372, 1, 1636416753234, 1636416753510, 276, 0, 276, 0, 0, 0
2373, 1, 1636416753326, 1636416753598, 272, 0, 272, 0, 0, 0
2374, 1, 1636416753670, 1636416753942, 272, 0, 272, 0, 0, 0
2375, 1, 1636416753770, 1636416754046, 276, 1, 275, 1, 0, 1
2376, 1, 1636416753970, 1636416754250, 280, 1, 279, 0, 1, 1
2377, 1, 1636416754070, 1636416754338, 268, 1, 267, 0, 1, 1
2378, 1, 1636416754158, 1636416754430, 272, 0, 272, 0, 0, 0
2379, 1, 1636416754494, 1636416754770, 276, 0, 276, 0, 0, 0
2380, 1, 1636416754602, 1636416754874, 272, 0, 272, 0, 0, 0
2381, 1, 1636416754802, 1636416755074, 272, 0, 272, 0, 0, 0
2382, 1, 1636416754890, 1636416755154, 264, 0, 264, 0, 0, 0
2383, 1, 1636416754990, 1636416755258, 268, 0, 268, 0, 0, 0
2384, 1, 1636416755330, 1636416755602, 272, 0, 272, 0, 0, 0
2385, 1, 1636416755430, 1636416755706, 276, 1, 275, 1, 0, 1
2386, 1, 1636416755634, 1636416755910, 276, 0, 276, 0, 0, 0
2387, 1, 1636416755718, 1636416755990, 272, 0, 272, 0, 0, 0
2388, 1, 1636416755822, 1636416756094, 272, 0, 272, 0, 0, 0
2389, 1, 1636416756162, 1636416756434, 272, 0, 272, 0, 0, 0
2390, 1, 1636416756266, 1636416756542, 276, 1, 275, 0, 1, 1
2391, 1, 1636416756486, 1636416756758, 272, 0, 272, 0, 0, 0
2392, 1, 1636416756554, 1636416756826, 272, 0, 272, 0, 0, 0
2393, 1, 1636416756654, 1636416756926, 272, 0, 272, 0, 0, 0
2394, 1, 1636416756990, 1636416757266, 276, 1, 275, 0, 1, 1
2395, 1, 1636416757114, 1636416757390, 276, 1, 275, 1, 0, 1
2396, 1, 1636416757306, 1636416757578, 272, 0, 272, 0, 0, 0
2397, 1, 1636416757378, 1636416757650, 272, 1, 271, 0, 1, 1
2398, 1, 1636416757506, 1636416757782, 276, 0, 276, 0, 0, 0
2399, 1, 1636416757822, 1636416758098, 276, 0, 276, 0, 0, 0
2400, 1, 1636416757934, 1636416758214, 280, 0, 280, 0, 0, 0
2401, 1, 1636416758130, 1636416758410, 280, 0, 280, 0, 0, 0
2402, 1, 1636416758198, 1636416758474, 276, 0, 276, 0, 0, 0
2403, 1, 1636416758322, 1636416758590, 268, 0, 268, 0, 0, 0
2404, 1, 1636416758674, 1636416758950, 276, 0, 276, 0, 0, 0
2405, 1, 1636416758762, 1636416759038, 276, 1, 275, 1, 0, 1
2406, 1, 1636416758950, 1636416759218, 268, 1, 267, 1, 0, 1
2407, 1, 1636416759034, 1636416759302, 268, 0, 268, 0, 0, 0
2408, 1, 1636416759150, 1636416759426, 276, 1, 275, 0, 1, 1
2409, 1, 1636416759494, 1636416759774, 280, 0, 280, 0, 0, 0
2410, 1, 1636416759578, 1636416759854, 276, 0, 276, 0, 0, 0
2411, 1, 1636416759782, 1636416760058, 276, 0, 276, 0, 0, 0
2412, 1, 1636416759874, 1636416760146, 272, 1, 271, 0, 1, 1
2413, 1, 1636416759982, 1636416760266, 284, 0, 284, 0, 0, 0
2414, 1, 1636416760318, 1636416760590, 272, 0, 272, 0, 0, 0
2415, 1, 1636416760394, 1636416760670, 276, 0, 276, 0, 0, 0
2416, 1, 1636416760618, 1636416760894, 276, 1, 275, 1, 0, 1
2417, 1, 1636416760702, 1636416760974, 272, 1, 271, 0, 0, 0
2418, 1, 1636416760806, 1636416761082, 276, 0, 276, 0, 0, 0
2419, 1, 1636416761154, 1636416761430, 276, 1, 275, 1, 0, 1
2420, 1, 1636416761234, 1636416761510, 276, 0, 276, 0, 0, 0
2421, 1, 1636416761470, 1636416761738, 268, 1, 267, 0, 0, 0
2422, 1, 1636416761522, 1636416761786, 264, 0, 264, 0, 0, 0
2423, 1, 1636416761638, 1636416761914, 276, 0, 276, 0, 0, 0
2424, 1, 1636416761978, 1636416762254, 276, 0, 276, 0, 0, 0
2425, 1, 1636416762086, 1636416762362, 276, 1, 275, 1, 0, 1
2426, 1, 1636416762294, 1636416762570, 276, 0, 276, 0, 0, 0
2427, 1, 1636416762362, 1636416762634, 272, 1, 271, 0, 1, 1
2428, 1, 1636416762490, 1636416762766, 276, 1, 275, 1, 0, 1
2429, 1, 1636416762810, 1636416763082, 272, 0, 272, 0, 0, 0
2430, 1, 1636416762910, 1636416763178, 268, 1, 267, 0, 0, 0
2431, 1, 1636416763122, 1636416763398, 276, 1, 275, 1, 0, 1
2432, 1, 1636416763214, 1636416763490, 276, 0, 276, 0, 0, 0
2433, 1, 1636416763310, 1636416763578, 268, 0, 268, 0, 0, 0
2434, 1, 1636416763662, 1636416763938, 276, 0, 276, 0, 0, 0
2435, 1, 1636416763738, 1636416764006, 268, 1, 267, 0, 1, 1
2436, 1, 1636416763962, 1636416764238, 276, 1, 275, 0, 0, 0
2437, 1, 1636416764030, 1636416764298, 268, 0, 268, 0, 0, 0
2438, 1, 1636416764142, 1636416764414, 272, 0, 272, 0, 0, 0
2439, 1, 1636416764490, 1636416764762, 272, 0, 272, 0, 0, 0
2440, 1, 1636416764594, 1636416764862, 268, 1, 267, 1, 0, 1
2441, 1, 1636416764814, 1636416765090, 276, 0, 276, 0, 0, 0
2442, 1, 1636416764870, 1636416765142, 272, 0, 272, 0, 0, 0
2443, 1, 1636416764978, 1636416765254, 276, 0, 276, 0, 0, 0
2444, 1, 1636416765314, 1636416765586, 272, 0, 272, 0, 0, 0
2445, 1, 1636416765438, 1636416765710, 272, 0, 272, 0, 0, 0
2446, 1, 1636416765646, 1636416765922, 276, 0, 276, 0, 0, 0
2447, 1, 1636416765714, 1636416765986, 272, 0, 272, 0, 0, 0
2448, 1, 1636416765830, 1636416766102, 272, 0, 272, 0, 0, 0
2449, 1, 1636416766154, 1636416766430, 276, 0, 276, 0, 0, 0
2450, 1, 1636416766266, 1636416766546, 280, 0, 280, 0, 0, 0
2451, 1, 1636416766462, 1636416766738, 276, 1, 275, 1, 0, 1
2452, 1, 1636416766534, 1636416766810, 276, 0, 276, 0, 0, 0
2453, 1, 1636416766654, 1636416766926, 272, 0, 272, 0, 0, 0
2454, 1, 1636416767002, 1636416767274, 272, 0, 272, 0, 0, 0
2455, 1, 1636416767090, 1636416767366, 276, 1, 275, 0, 0, 0
2456, 1, 1636416767294, 1636416767570, 276, 0, 276, 0, 0, 0
2457, 1, 1636416767354, 1636416767622, 268, 0, 268, 0, 0, 0
2458, 1, 1636416767474, 1636416767754, 280, 0, 280, 0, 0, 0
2459, 1, 1636416767830, 1636416768106, 276, 0, 276, 0, 0, 0
2460, 1, 1636416767926, 1636416768198, 272, 0, 272, 0, 0, 0
2461, 1, 1636416768130, 1636416768406, 276, 1, 275, 0, 0, 0
2462, 1, 1636416768206, 1636416768478, 272, 0, 272, 0, 0, 0
2463, 1, 1636416768302, 1636416768578, 276, 0, 276, 0, 0, 0
2464, 1, 1636416768650, 1636416768922, 272, 1, 271, 0, 0, 0
2465, 1, 1636416768758, 1636416769038, 280, 1, 279, 1, 0, 1
2466, 1, 1636416768950, 1636416769226, 276, 0, 276, 0, 0, 0
2467, 1, 1636416769042, 1636416769318, 276, 1, 275, 0, 0, 0
2468, 1, 1636416769138, 1636416769410, 272, 0, 272, 0, 0, 0
2469, 1, 1636416769478, 1636416769754, 276, 0, 276, 0, 0, 0
2470, 1, 1636416769578, 1636416769850, 272, 1, 271, 0, 0, 0
2471, 1, 1636416769794, 1636416770070, 276, 0, 276, 0, 0, 0
2472, 1, 1636416769874, 1636416770146, 272, 0, 272, 0, 0, 0
2473, 1, 1636416769962, 1636416770238, 276, 0, 276, 0, 0, 0
2474, 1, 1636416770314, 1636416770590, 276, 1, 275, 0, 1, 1
2475, 1, 1636416770418, 1636416770694, 276, 1, 275, 0, 0, 0
2476, 1, 1636416770614, 1636416770894, 280, 1, 279, 0, 0, 0
2477, 1, 1636416770698, 1636416770974, 276, 0, 276, 0, 0, 0
2478, 1, 1636416770806, 1636416771070, 264, 0, 264, 0, 0, 0
2479, 1, 1636416771146, 1636416771422, 276, 0, 276, 0, 0, 0
2480, 1, 1636416771246, 1636416771522, 276, 1, 275, 0, 1, 1
2481, 1, 1636416771438, 1636416771710, 272, 0, 272, 0, 0, 0
2482, 1, 1636416771526, 1636416771802, 276, 0, 276, 0, 0, 0
2483, 1, 1636416771630, 1636416771906, 276, 1, 275, 0, 0, 0
2484, 1, 1636416771986, 1636416772258, 272, 0, 272, 0, 0, 0
2485, 1, 1636416772070, 1636416772346, 276, 0, 276, 0, 0, 0
2486, 1, 1636416772278, 1636416772550, 272, 0, 272, 0, 0, 0
2487, 1, 1636416772350, 1636416772618, 268, 0, 268, 0, 0, 0
2488, 1, 1636416772454, 1636416772730, 276, 1, 275, 0, 0, 0
2489, 1, 1636416772802, 1636416773078, 276, 0, 276, 0, 0, 0
2490, 1, 1636416772910, 1636416773186, 276, 1, 275, 0, 1, 1
2491, 1, 1636416773130, 1636416773402, 272, 0, 272, 0, 0, 0
2492, 1, 1636416773170, 1636416773442, 272, 1, 271, 0, 1, 1
2493, 1, 1636416773298, 1636416773566, 268, 0, 268, 0, 0, 0
2494, 1, 1636416773626, 1636416773902, 276, 0, 276, 0, 0, 0
2495, 1, 1636416773758, 1636416774034, 276, 1, 275, 0, 0, 0
2496, 1, 1636416773962, 1636416774238, 276, 0, 276, 0, 0, 0
2497, 1, 1636416773990, 1636416774266, 276, 0, 276, 0, 0, 0
2498, 1, 1636416774134, 1636416774406, 272, 0, 272, 0, 0, 0
2499, 1, 1636416774474, 1636416774746, 272, 0, 272, 0, 0, 0
2500, 1, 1636416774598, 1636416774870, 272, 1, 271, 0, 1, 1
2501, 1, 1636416774778, 1636416775050, 272, 0, 272, 0, 0, 0
2502, 1, 1636416774826, 1636416775102, 276, 0, 276, 0, 0, 0
2503, 1, 1636416774970, 1636416775238, 268, 1, 267, 0, 1, 1
2504, 1, 1636416775330, 1636416775602, 272, 0, 272, 0, 0, 0
2505, 1, 1636416775410, 1636416775682, 272, 0, 272, 0, 0, 0
2506, 1, 1636416775606, 1636416775870, 264, 0, 264, 0, 0, 0
2507, 1, 1636416775642, 1636416775910, 268, 0, 268, 0, 0, 0
2508, 1, 1636416775790, 1636416776070, 280, 0, 280, 0, 0, 0
2509, 1, 1636416776162, 1636416776438, 276, 1, 275, 0, 1, 1
2510, 1, 1636416776238, 1636416776514, 276, 0, 276, 0, 0, 0
2511, 1, 1636416776450, 1636416776726, 276, 0, 276, 0, 0, 0
2512, 1, 1636416776474, 1636416776746, 272, 0, 272, 0, 0, 0
2513, 1, 1636416776614, 1636416776894, 280, 1, 279, 0, 0, 0
2514, 1, 1636416776978, 1636416777254, 276, 0, 276, 0, 0, 0
2515, 1, 1636416777082, 1636416777354, 272, 1, 271, 0, 0, 0
2516, 1, 1636416777286, 1636416777558, 272, 0, 272, 0, 0, 0
2517, 1, 1636416777290, 1636416777562, 272, 0, 272, 0, 0, 0
2518, 1, 1636416777458, 1636416777734, 276, 1, 275, 0, 0, 0
2519, 1, 1636416777806, 1636416778082, 276, 1, 275, 0, 0, 0
2520, 1, 1636416777918, 1636416778186, 268, 1, 267, 1, 0, 1
2521, 1, 1636416778102, 1636416778370, 268, 0, 268, 0, 0, 0
2522, 1, 1636416778130, 1636416778410, 280, 0, 280, 0, 0, 0
2523, 1, 1636416778294, 1636416778566, 272, 0, 272, 0, 0, 0
2524, 1, 1636416778646, 1636416778922, 276, 0, 276, 0, 0, 0
2525, 1, 1636416778738, 1636416779010, 272, 0, 272, 0, 0, 0
2526, 1, 1636416778938, 1636416779202, 264, 0, 264, 0, 0, 0
2527, 1, 1636416778970, 1636416779242, 272, 0, 272, 0, 0, 0
2528, 1, 1636416779110, 1636416779382, 272, 1, 271, 0, 0, 0
2529, 1, 1636416779482, 1636416779758, 276, 0, 276, 0, 0, 0
2530, 1, 1636416779586, 1636416779858, 272, 0, 272, 0, 0, 0
2531, 1, 1636416779786, 1636416780058, 272, 0, 272, 0, 0, 0
2532, 1, 1636416779818, 1636416780090, 272, 0, 272, 0, 0, 0
2533, 1, 1636416779962, 1636416780226, 264, 1, 263, 0, 0, 0
2534, 1, 1636416780302, 1636416780574, 272, 1, 271, 1, 0, 1
2535, 1, 1636416780430, 1636416780706, 276, 1, 275, 0, 1, 1
2536, 1, 1636416780614, 1636416780890, 276, 0, 276, 0, 0, 0
2537, 1, 1636416780638, 1636416780910, 272, 0, 272, 0, 0, 0
2538, 1, 1636416780810, 1636416781086, 276, 0, 276, 0, 0, 0
2539, 1, 1636416781150, 1636416781430, 280, 0, 280, 0, 0, 0
2540, 1, 1636416781258, 1636416781530, 272, 1, 271, 0, 0, 0
2541, 1, 1636416781442, 1636416781714, 272, 0, 272, 0, 0, 0
2542, 1, 1636416781478, 1636416781750, 272, 0, 272, 0, 0, 0
2543, 1, 1636416781638, 1636416781914, 276, 1, 275, 0, 1, 1
2544, 1, 1636416782002, 1636416782274, 272, 0, 272, 0, 0, 0
2545, 1, 1636416782086, 1636416782363, 277, 0, 277, 0, 0, 0
2546, 1, 1636416782290, 1636416782566, 276, 0, 276, 0, 0, 0
2547, 1, 1636416782318, 1636416782590, 272, 0, 272, 0, 0, 0
2548, 1, 1636416782466, 1636416782746, 280, 1, 279, 0, 0, 0
2549, 1, 1636416782826, 1636416783102, 276, 0, 276, 0, 0, 0
2550, 1, 1636416782934, 1636416783206, 272, 1, 271, 0, 0, 0
2552, 1, 1636416783166, 1636416783434, 268, 0, 268, 0, 0, 0
2551, 1, 1636416783134, 1636416783474, 340, 73, 267, 73, 0, 73
2553, 1, 1636416783298, 1636416783742, 444, 177, 267, 177, 0, 177
2554, 1, 1636416783654, 1636416783930, 276, 0, 276, 0, 0, 0
2555, 1, 1636416783778, 1636416784054, 276, 1, 275, 0, 1, 1
2557, 1, 1636416783990, 1636416784254, 264, 0, 264, 0, 0, 0
2556, 1, 1636416783982, 1636416784254, 272, 0, 272, 0, 0, 0
2558, 1, 1636416784178, 1636416784446, 268, 0, 268, 0, 0, 0
2559, 1, 1636416784502, 1636416784774, 272, 0, 272, 0, 0, 0
2560, 1, 1636416784614, 1636416784886, 272, 0, 272, 0, 0, 0
2561, 1, 1636416784810, 1636416785082, 272, 0, 272, 0, 0, 0
2562, 1, 1636416784834, 1636416785106, 272, 0, 272, 0, 0, 0
2563, 1, 1636416784974, 1636416785250, 276, 1, 275, 0, 0, 0
2564, 1, 1636416785346, 1636416785618, 272, 0, 272, 0, 0, 0
2565, 1, 1636416785442, 1636416785714, 272, 1, 271, 0, 0, 0
2566, 1, 1636416785654, 1636416785926, 272, 0, 272, 0, 0, 0
2567, 1, 1636416785678, 1636416785954, 276, 0, 276, 0, 0, 0
2568, 1, 1636416785802, 1636416786078, 276, 0, 276, 0, 0, 0
2569, 1, 1636416786182, 1636416786454, 272, 1, 271, 0, 0, 0
2570, 1, 1636416786282, 1636416786550, 268, 1, 267, 1, 0, 1
2571, 1, 1636416786494, 1636416786762, 268, 0, 268, 0, 0, 0
2572, 1, 1636416786506, 1636416786770, 264, 0, 264, 0, 0, 0
2573, 1, 1636416786642, 1636416786918, 276, 0, 276, 0, 0, 0
2574, 1, 1636416787010, 1636416787286, 276, 0, 276, 0, 0, 0
2575, 1, 1636416787134, 1636416787406, 272, 1, 271, 0, 1, 1
2576, 1, 1636416787326, 1636416787598, 272, 0, 272, 0, 0, 0
2577, 1, 1636416787349, 1636416787622, 273, 1, 272, 1, 0, 1
2578, 1, 1636416787482, 1636416787758, 276, 0, 276, 0, 0, 0
2579, 1, 1636416787854, 1636416788130, 276, 1, 275, 0, 1, 1
2580, 1, 1636416787982, 1636416788254, 272, 0, 272, 0, 0, 0
2582, 1, 1636416788198, 1636416788471, 273, 0, 273, 0, 0, 0
2581, 1, 1636416788146, 1636416788530, 384, 109, 275, 109, 0, 109
2583, 1, 1636416788330, 1636416788798, 468, 201, 267, 201, 0, 201
2584, 1, 1636416788694, 1636416788966, 272, 1, 271, 0, 1, 1
2585, 1, 1636416788798, 1636416789070, 272, 1, 271, 1, 0, 1
2586, 1, 1636416788982, 1636416789258, 276, 0, 276, 0, 0, 0
2587, 1, 1636416789014, 1636416789290, 276, 0, 276, 0, 0, 0
2588, 1, 1636416789206, 1636416789478, 272, 0, 272, 0, 0, 0
2589, 1, 1636416789542, 1636416789818, 276, 0, 276, 0, 0, 0
2590, 1, 1636416789634, 1636416789910, 276, 0, 276, 0, 0, 0
2592, 1, 1636416789854, 1636416790130, 276, 1, 275, 0, 0, 0
2591, 1, 1636416789826, 1636416790194, 368, 85, 283, 85, 0, 85
2593, 1, 1636416789982, 1636416790258, 276, 1, 275, 0, 0, 0
2594, 1, 1636416790358, 1636416790630, 272, 0, 272, 0, 0, 0
2595, 1, 1636416790478, 1636416790750, 272, 1, 271, 0, 0, 0
2596, 1, 1636416790658, 1636416790934, 276, 0, 276, 0, 0, 0
2597, 1, 1636416790690, 1636416790962, 272, 0, 272, 0, 0, 0
2598, 1, 1636416790818, 1636416791090, 272, 0, 272, 0, 0, 0
2599, 1, 1636416791194, 1636416791466, 272, 0, 272, 0, 0, 0
2600, 1, 1636416791322, 1636416791594, 272, 1, 271, 1, 0, 1
2601, 1, 1636416791506, 1636416791774, 268, 1, 267, 1, 0, 1
2602, 1, 1636416791526, 1636416791802, 276, 0, 276, 0, 0, 0
2603, 1, 1636416791650, 1636416791922, 272, 0, 272, 0, 0, 0
2604, 1, 1636416792038, 1636416792314, 276, 0, 276, 0, 0, 0
2605, 1, 1636416792166, 1636416792446, 280, 0, 280, 0, 0, 0
2606, 1, 1636416792322, 1636416792603, 281, 0, 281, 0, 0, 0
2607, 1, 1636416792342, 1636416792618, 276, 0, 276, 0, 0, 0
2608, 1, 1636416792470, 1636416792738, 268, 0, 268, 0, 0, 0
2609, 1, 1636416792882, 1636416793158, 276, 0, 276, 0, 0, 0
2610, 1, 1636416792986, 1636416793258, 272, 1, 271, 1, 0, 1
2611, 1, 1636416793170, 1636416793438, 268, 0, 268, 0, 0, 0
2612, 1, 1636416793186, 1636416793462, 276, 1, 275, 0, 0, 0
2613, 1, 1636416793298, 1636416793570, 272, 0, 272, 0, 0, 0
2614, 1, 1636416793722, 1636416793998, 276, 1, 275, 0, 0, 0
2615, 1, 1636416793830, 1636416794102, 272, 1, 271, 1, 0, 1
2616, 1, 1636416794006, 1636416794274, 268, 0, 268, 0, 0, 0
2617, 1, 1636416794022, 1636416794294, 272, 0, 272, 0, 0, 0
2618, 1, 1636416794122, 1636416794394, 272, 0, 272, 0, 0, 0
2619, 1, 1636416794558, 1636416794834, 276, 1, 275, 0, 1, 1
2620, 1, 1636416794666, 1636416794942, 276, 1, 275, 1, 0, 1
2621, 1, 1636416794838, 1636416795114, 276, 0, 276, 0, 0, 0
2622, 1, 1636416794858, 1636416795130, 272, 1, 271, 0, 0, 0
2623, 1, 1636416794954, 1636416795222, 268, 0, 268, 0, 0, 0
2624, 1, 1636416795402, 1636416795674, 272, 0, 272, 0, 0, 0
2625, 1, 1636416795502, 1636416795770, 268, 0, 268, 0, 0, 0
2627, 1, 1636416795686, 1636416795962, 276, 1, 275, 0, 0, 0
2626, 1, 1636416795678, 1636416795962, 284, 0, 284, 0, 0, 0
2628, 1, 1636416795806, 1636416796078, 272, 0, 272, 0, 0, 0
2629, 1, 1636416796238, 1636416796510, 272, 1, 271, 0, 0, 0
2630, 1, 1636416796334, 1636416796602, 268, 0, 268, 0, 0, 0
2631, 1, 1636416796510, 1636416796782, 272, 0, 272, 0, 0, 0
2632, 1, 1636416796510, 1636416796786, 276, 0, 276, 0, 0, 0
2633, 1, 1636416796622, 1636416796898, 276, 0, 276, 0, 0, 0
2634, 1, 1636416797074, 1636416797350, 276, 0, 276, 0, 0, 0
2635, 1, 1636416797158, 1636416797438, 280, 0, 280, 0, 0, 0
2636, 1, 1636416797326, 1636416797602, 276, 0, 276, 0, 0, 0
2637, 1, 1636416797362, 1636416797642, 280, 0, 280, 0, 0, 0
2638, 1, 1636416797446, 1636416797726, 280, 0, 280, 0, 0, 0
2639, 1, 1636416797906, 1636416798178, 272, 1, 271, 0, 0, 0
2640, 1, 1636416797982, 1636416798254, 272, 1, 271, 0, 1, 1
2641, 1, 1636416798150, 1636416798422, 272, 0, 272, 0, 0, 0
2642, 1, 1636416798206, 1636416798482, 276, 0, 276, 0, 0, 0
2643, 1, 1636416798266, 1636416798530, 264, 0, 264, 0, 0, 0
2644, 1, 1636416798726, 1636416798994, 268, 0, 268, 0, 0, 0
2645, 1, 1636416798806, 1636416799078, 272, 0, 272, 0, 0, 0
2646, 1, 1636416798986, 1636416799254, 268, 0, 268, 0, 0, 0
2647, 1, 1636416799030, 1636416799298, 268, 0, 268, 0, 0, 0
2648, 1, 1636416799086, 1636416799358, 272, 0, 272, 0, 0, 0
2649, 1, 1636416799542, 1636416799814, 272, 0, 272, 0, 0, 0
2650, 1, 1636416799638, 1636416799906, 268, 1, 267, 1, 0, 1
2651, 1, 1636416799822, 1636416800098, 276, 0, 276, 0, 0, 0
2652, 1, 1636416799874, 1636416800146, 272, 0, 272, 0, 0, 0
2653, 1, 1636416799938, 1636416800210, 272, 1, 271, 0, 0, 0
2654, 1, 1636416800362, 1636416800638, 276, 0, 276, 0, 0, 0
2655, 1, 1636416800470, 1636416800746, 276, 1, 275, 0, 0, 0
2656, 1, 1636416800654, 1636416800930, 276, 0, 276, 0, 0, 0
2657, 1, 1636416800718, 1636416800994, 276, 0, 276, 0, 0, 0
2658, 1, 1636416800782, 1636416801058, 276, 1, 275, 0, 0, 0
2659, 1, 1636416801198, 1636416801474, 276, 1, 275, 0, 0, 0
2660, 1, 1636416801306, 1636416801582, 276, 1, 275, 1, 0, 1
2661, 1, 1636416801498, 1636416801774, 276, 1, 275, 0, 0, 0
2662, 1, 1636416801546, 1636416801818, 272, 0, 272, 0, 0, 0
2663, 1, 1636416801602, 1636416801878, 276, 0, 276, 0, 0, 0
2664, 1, 1636416802018, 1636416802294, 276, 1, 275, 0, 1, 1
2665, 1, 1636416802150, 1636416802426, 276, 1, 275, 1, 0, 1
2666, 1, 1636416802314, 1636416802590, 276, 0, 276, 0, 0, 0
2667, 1, 1636416802398, 1636416802674, 276, 0, 276, 0, 0, 0
2668, 1, 1636416802414, 1636416802690, 276, 1, 275, 0, 0, 0
2669, 1, 1636416802850, 1636416803126, 276, 0, 276, 0, 0, 0
2670, 1, 1636416802970, 1636416803242, 272, 1, 271, 0, 1, 1
2671, 1, 1636416803134, 1636416803402, 268, 0, 268, 0, 0, 0
2672, 1, 1636416803214, 1636416803482, 268, 0, 268, 0, 0, 0
2673, 1, 1636416803234, 1636416803506, 272, 0, 272, 0, 0, 0
2674, 1, 1636416803694, 1636416803966, 272, 1, 271, 0, 0, 0
2675, 1, 1636416803802, 1636416804078, 276, 1, 275, 0, 0, 0
2676, 1, 1636416803966, 1636416804238, 272, 0, 272, 0, 0, 0
2677, 1, 1636416804054, 1636416804322, 268, 0, 268, 0, 0, 0
2678, 1, 1636416804062, 1636416804326, 264, 0, 264, 0, 0, 0
2679, 1, 1636416804510, 1636416804786, 276, 1, 275, 0, 0, 0
2680, 1, 1636416804626, 1636416804894, 268, 1, 267, 0, 0, 0
2682, 1, 1636416804874, 1636416805146, 272, 0, 272, 0, 0, 0
2683, 1, 1636416804890, 1636416805166, 276, 0, 276, 0, 0, 0
2684, 1, 1636416805334, 1636416805610, 276, 1, 275, 0, 0, 0
2686, 1, 1636416805714, 1636416805990, 276, 0, 276, 0, 0, 0
2687, 1, 1636416805718, 1636416805998, 280, 0, 280, 0, 0, 0
2689, 1, 1636416806542, 1636416806814, 272, 1, 271, 0, 0, 0
2690, 1, 1636416806566, 1636416806842, 276, 1, 275, 0, 0, 0
2691, 1, 1636416807374, 1636416807646, 272, 1, 271, 0, 0, 0
2692, 1, 1636416807410, 1636416807686, 276, 0, 276, 0, 0, 0
2693, 1, 1636416808214, 1636416808482, 268, 1, 267, 0, 0, 0
2694, 1, 1636416808238, 1636416808506, 268, 1, 267, 0, 0, 0
2695, 1, 1636416809046, 1636416809322, 276, 1, 275, 1, 0, 1
2696, 1, 1636416809054, 1636416809326, 272, 0, 272, 0, 0, 0
2697, 1, 1636416809870, 1636416810146, 276, 1, 275, 0, 0, 0
2698, 1, 1636416809906, 1636416810182, 276, 0, 276, 0, 0, 0
2699, 1, 1636416810718, 1636416810994, 276, 0, 276, 0, 0, 0
2700, 1, 1636416810734, 1636416811006, 272, 0, 272, 0, 0, 0
2701, 1, 1636416811546, 1636416811822, 276, 0, 276, 0, 0, 0
2702, 1, 1636416811586, 1636416811862, 276, 0, 276, 0, 0, 0
2703, 1, 1636416812362, 1636416812638, 276, 1, 275, 1, 0, 1
2704, 1, 1636416812418, 1636416812686, 268, 0, 268, 0, 0, 0
2705, 1, 1636416813214, 1636416813486, 272, 1, 271, 0, 0, 0
2706, 1, 1636416813266, 1636416813538, 272, 0, 272, 0, 0, 0
2707, 1, 1636416814058, 1636416814338, 280, 1, 279, 0, 0, 0
2708, 1, 1636416814114, 1636416814390, 276, 0, 276, 0, 0, 0
2681, 2, 1636416804802, 1636416814987, 10185, 93, 10092, 93, 1, 94
2709, 1, 1636416814898, 1636416815262, 364, 0, 364, 0, 0, 0
2710, 1, 1636416814938, 1636416815266, 328, 1, 327, 0, 1, 1
2685, 2, 1636416805466, 1636416815466, 10000, 0, 10000, 9521, 0, 9521
2711, 1, 1636416815302, 1636416815602, 300, 0, 300, 0, 0, 0
2688, 1, 1636416806158, 1636416815742, 9584, 9308, 276, 8829, 479, 9308
2712, 1, 1636416815726, 1636416815994, 268, 0, 268, 0, 0, 0
2713, 1, 1636416815758, 1636416816034, 276, 0, 276, 0, 0, 0
2715, 1, 1636416816050, 1636416816318, 268, 0, 268, 0, 0, 0
2714, 1, 1636416816058, 1636416816330, 272, 0, 272, 0, 0, 0
2716, 1, 1636416816138, 1636416816414, 276, 0, 276, 0, 0, 0
2717, 1, 1636416816554, 1636416816830, 276, 1, 275, 1, 0, 1
2718, 1, 1636416816602, 1636416816878, 276, 0, 276, 0, 0, 0
2719, 1, 1636416816806, 1636416817078, 272, 0, 272, 0, 0, 0
2720, 1, 1636416816886, 1636416817154, 268, 0, 268, 0, 0, 0
2721, 1, 1636416816918, 1636416817186, 268, 0, 268, 0, 0, 0
2722, 1, 1636416817378, 1636416817658, 280, 0, 280, 0, 0, 0
2723, 1, 1636416817438, 1636416817706, 268, 0, 268, 0, 0, 0
2724, 1, 1636416817646, 1636416817922, 276, 0, 276, 0, 0, 0
2725, 1, 1636416817714, 1636416817986, 272, 0, 272, 0, 0, 0
2726, 1, 1636416817754, 1636416818022, 268, 0, 268, 0, 0, 0
2727, 1, 1636416818210, 1636416818482, 272, 0, 272, 0, 0, 0
2728, 1, 1636416818278, 1636416818554, 276, 0, 276, 0, 0, 0
2729, 1, 1636416818466, 1636416818742, 276, 0, 276, 0, 0, 0
2730, 1, 1636416818538, 1636416818810, 272, 0, 272, 0, 0, 0
2731, 1, 1636416818590, 1636416818862, 272, 0, 272, 0, 0, 0
2732, 1, 1636416819026, 1636416819302, 276, 1, 275, 0, 0, 0
2733, 1, 1636416819110, 1636416819382, 272, 0, 272, 0, 0, 0
2734, 1, 1636416819294, 1636416819566, 272, 1, 271, 0, 0, 0
2735, 1, 1636416819386, 1636416819658, 272, 0, 272, 0, 0, 0
2736, 1, 1636416819406, 1636416819678, 272, 0, 272, 0, 0, 0
2737, 1, 1636416819854, 1636416820126, 272, 1, 271, 0, 0, 0
2738, 1, 1636416819962, 1636416820234, 272, 1, 271, 1, 0, 1
2739, 1, 1636416820138, 1636416820406, 268, 0, 268, 0, 0, 0
2740, 1, 1636416820214, 1636416820486, 272, 0, 272, 0, 0, 0
2741, 1, 1636416820234, 1636416820758, 524, 253, 271, 253, 0, 253
2742, 1, 1636416820674, 1636416820946, 272, 0, 272, 0, 0, 0
2743, 1, 1636416820798, 1636416821074, 276, 0, 276, 0, 0, 0
2744, 1, 1636416820966, 1636416821246, 280, 1, 279, 0, 0, 0
2745, 1, 1636416821030, 1636416821306, 276, 0, 276, 0, 0, 0
2746, 1, 1636416821158, 1636416821434, 276, 0, 276, 0, 0, 0
2747, 1, 1636416821486, 1636416821754, 268, 0, 268, 0, 0, 0
2748, 1, 1636416821622, 1636416821890, 268, 0, 268, 0, 0, 0
2749, 1, 1636416821782, 1636416822058, 276, 1, 275, 0, 0, 0
2750, 1, 1636416821878, 1636416822146, 268, 0, 268, 0, 0, 0
2751, 1, 1636416821946, 1636416822218, 272, 0, 272, 0, 0, 0
2752, 1, 1636416822334, 1636416822614, 280, 0, 280, 0, 0, 0
2753, 1, 1636416822450, 1636416822726, 276, 1, 275, 0, 0, 0
2754, 1, 1636416822634, 1636416822902, 268, 1, 267, 0, 0, 0
2755, 1, 1636416822718, 1636416822990, 272, 0, 272, 0, 0, 0
2756, 1, 1636416822786, 1636416823062, 276, 0, 276, 0, 0, 0
2757, 1, 1636416823186, 1636416823454, 268, 1, 267, 1, 0, 1
2758, 1, 1636416823270, 1636416823534, 264, 0, 264, 0, 0, 0
2759, 1, 1636416823478, 1636416823746, 268, 1, 267, 0, 1, 1
2760, 1, 1636416823566, 1636416823846, 280, 0, 280, 0, 0, 0
2761, 1, 1636416823642, 1636416823918, 276, 0, 276, 0, 0, 0
2762, 1, 1636416824014, 1636416824290, 276, 0, 276, 0, 0, 0
2763, 1, 1636416824114, 1636416824386, 272, 1, 271, 0, 1, 1
2764, 1, 1636416824326, 1636416824598, 272, 0, 272, 0, 0, 0
2765, 1, 1636416824394, 1636416824674, 280, 0, 280, 0, 0, 0
2766, 1, 1636416824450, 1636416824722, 272, 0, 272, 0, 0, 0
2767, 1, 1636416824930, 1636416825206, 276, 0, 276, 0, 0, 0
2768, 1, 1636416825150, 1636416825422, 272, 0, 272, 0, 0, 0
2769, 1, 1636416825210, 1636416825482, 272, 0, 272, 0, 0, 0
2770, 1, 1636416825278, 1636416825550, 272, 0, 272, 0, 0, 0
2771, 1, 1636416825970, 1636416826242, 272, 0, 272, 0, 0, 0
2772, 1, 1636416826030, 1636416826302, 272, 0, 272, 0, 0, 0
2773, 1, 1636416826122, 1636416826394, 272, 0, 272, 0, 0, 0
2774, 1, 1636416826794, 1636416827066, 272, 1, 271, 1, 0, 1
2775, 1, 1636416826858, 1636416827138, 280, 0, 280, 0, 0, 0
2776, 1, 1636416826954, 1636416827226, 272, 0, 272, 0, 0, 0
2777, 1, 1636416827622, 1636416827894, 272, 0, 272, 0, 0, 0
2778, 1, 1636416827678, 1636416827950, 272, 0, 272, 0, 0, 0
2779, 1, 1636416827798, 1636416828070, 272, 0, 272, 0, 0, 0
2780, 1, 1636416828442, 1636416828714, 272, 1, 271, 0, 1, 1
2781, 1, 1636416828506, 1636416828778, 272, 1, 271, 0, 0, 0
2782, 1, 1636416828630, 1636416828902, 272, 0, 272, 0, 0, 0
2783, 1, 1636416829266, 1636416829538, 272, 1, 271, 0, 0, 0
2784, 1, 1636416829326, 1636416829598, 272, 0, 272, 0, 0, 0
2785, 1, 1636416829478, 1636416829754, 276, 0, 276, 0, 0, 0
2786, 1, 1636416830086, 1636416830362, 276, 1, 275, 0, 1, 1
2787, 1, 1636416830142, 1636416830418, 276, 0, 276, 0, 0, 0
2788, 1, 1636416830314, 1636416830590, 276, 1, 275, 0, 0, 0
2789, 1, 1636416830906, 1636416831182, 276, 1, 275, 0, 1, 1
2790, 1, 1636416830974, 1636416831246, 272, 1, 271, 0, 0, 0
2791, 1, 1636416831138, 1636416831402, 264, 0, 264, 0, 0, 0
2792, 1, 1636416831738, 1636416832010, 272, 0, 272, 0, 0, 0
2793, 1, 1636416831826, 1636416832098, 272, 1, 271, 0, 0, 0
2794, 1, 1636416831954, 1636416832230, 276, 1, 275, 0, 0, 0
2795, 1, 1636416832594, 1636416832862, 268, 1, 267, 0, 1, 1
2796, 1, 1636416832658, 1636416832934, 276, 0, 276, 0, 0, 0
2797, 1, 1636416832774, 1636416833050, 276, 1, 275, 0, 0, 0
2798, 1, 1636416833418, 1636416833690, 272, 0, 272, 0, 0, 0
2799, 1, 1636416833618, 1636416833890, 272, 0, 272, 0, 0, 0
2800, 1, 1636416834434, 1636416834710, 276, 0, 276, 0, 0, 0
2801, 1, 1636417030130, 1636417030410, 280, 1, 279, 0, 0, 0
2802, 1, 1636417030718, 1636417030994, 276, 0, 276, 0, 0, 0
2803, 1, 1636417030838, 1636417031114, 276, 1, 275, 0, 0, 0
2804, 1, 1636417031142, 1636417031410, 268, 0, 268, 0, 0, 0
2805, 1, 1636417031426, 1636417031694, 268, 1, 267, 0, 0, 0
2806, 1, 1636417031550, 1636417031822, 272, 1, 271, 0, 1, 1
2807, 1, 1636417031762, 1636417032034, 272, 1, 271, 0, 0, 0
2808, 1, 1636417031854, 1636417032122, 268, 0, 268, 0, 0, 0
2809, 1, 1636417032138, 1636417032414, 276, 0, 276, 0, 0, 0
2810, 1, 1636417032262, 1636417032538, 276, 0, 276, 0, 0, 0
2811, 1, 1636417032426, 1636417032702, 276, 0, 276, 0, 0, 0
2812, 1, 1636417032466, 1636417032746, 280, 0, 280, 0, 0, 0
2813, 1, 1636417032562, 1636417032834, 272, 0, 272, 0, 0, 0
2814, 1, 1636417032854, 1636417033130, 276, 0, 276, 0, 0, 0
2815, 1, 1636417032982, 1636417033258, 276, 1, 275, 0, 0, 0
2816, 1, 1636417033138, 1636417033418, 280, 0, 280, 0, 0, 0
2817, 1, 1636417033178, 1636417033446, 268, 0, 268, 0, 0, 0
2818, 1, 1636417033282, 1636417033558, 276, 0, 276, 0, 0, 0
2819, 1, 1636417033566, 1636417033842, 276, 0, 276, 0, 0, 0
2820, 1, 1636417033694, 1636417034118, 424, 149, 275, 149, 0, 149
2821, 1, 1636417033846, 1636417034130, 284, 0, 284, 0, 0, 0
2822, 1, 1636417033898, 1636417034170, 272, 0, 272, 0, 0, 0
2823, 1, 1636417034002, 1636417034390, 388, 117, 271, 117, 0, 117
2824, 1, 1636417034274, 1636417034670, 396, 117, 279, 117, 0, 117
2825, 1, 1636417034514, 1636417034790, 276, 0, 276, 0, 0, 0
2826, 1, 1636417034562, 1636417034834, 272, 0, 272, 0, 0, 0
2827, 1, 1636417034614, 1636417034942, 328, 57, 271, 57, 0, 57
2828, 1, 1636417034790, 1636417035058, 268, 1, 267, 0, 1, 1
2829, 1, 1636417035070, 1636417035338, 268, 0, 268, 0, 0, 0
2830, 1, 1636417035226, 1636417035498, 272, 1, 271, 0, 1, 1
2831, 1, 1636417035278, 1636417035550, 272, 0, 272, 0, 0, 0
2833, 1, 1636417035462, 1636417035734, 272, 0, 272, 0, 0, 0
2832, 1, 1636417035369, 1636417035822, 453, 181, 272, 180, 0, 180
2834, 1, 1636417035738, 1636417036014, 276, 0, 276, 0, 0, 0
2835, 1, 1636417035938, 1636417036210, 272, 1, 271, 0, 0, 0
2836, 1, 1636417035990, 1636417036258, 268, 0, 268, 0, 0, 0
2837, 1, 1636417036166, 1636417036442, 276, 0, 276, 0, 0, 0
2838, 1, 1636417036222, 1636417036490, 268, 0, 268, 0, 0, 0
2839, 1, 1636417036446, 1636417036714, 268, 0, 268, 0, 0, 0
2840, 1, 1636417036606, 1636417036870, 264, 0, 264, 0, 0, 0
2841, 1, 1636417036710, 1636417036982, 272, 0, 272, 0, 0, 0
2842, 1, 1636417036878, 1636417037142, 264, 0, 264, 0, 0, 0
2843, 1, 1636417036886, 1636417037158, 272, 0, 272, 0, 0, 0
2844, 1, 1636417037162, 1636417037438, 276, 0, 276, 0, 0, 0
2845, 1, 1636417037314, 1636417037590, 276, 0, 276, 0, 0, 0
2847, 1, 1636417037586, 1636417037858, 272, 0, 272, 0, 0, 0
2848, 1, 1636417037606, 1636417037882, 276, 0, 276, 0, 0, 0
2850, 1, 1636417038030, 1636417038306, 276, 1, 275, 0, 1, 1
2852, 1, 1636417038310, 1636417038582, 272, 0, 272, 0, 0, 0
2853, 1, 1636417038750, 1636417039018, 268, 0, 268, 0, 0, 0
2855, 1, 1636417039466, 1636417039738, 272, 1, 271, 1, 0, 1
2856, 1, 1636417040182, 1636417040458, 276, 1, 275, 0, 0, 0
2857, 1, 1636417040890, 1636417041167, 277, 1, 276, 0, 0, 0
2858, 1, 1636417041602, 1636417041874, 272, 0, 272, 0, 0, 0
2859, 1, 1636417042322, 1636417042598, 276, 1, 275, 1, 0, 1
2860, 1, 1636417043042, 1636417043318, 276, 0, 276, 0, 0, 0
2861, 1, 1636417043754, 1636417044030, 276, 1, 275, 0, 0, 0
2862, 1, 1636417044470, 1636417044746, 276, 0, 276, 0, 0, 0
2863, 1, 1636417045178, 1636417045450, 272, 1, 271, 0, 0, 0
2864, 1, 1636417045890, 1636417046166, 276, 1, 275, 1, 0, 1
2865, 1, 1636417046594, 1636417046870, 276, 1, 275, 0, 0, 0
2866, 1, 1636417047306, 1636417047583, 277, 1, 276, 1, 0, 1
2846, 2, 1636417037422, 1636417047683, 10261, 169, 10092, 169, 1, 170
2849, 2, 1636417037874, 1636417047875, 10001, 0, 10001, 0, 0, 0
2854, 1, 1636417039026, 1636417047958, 8932, 8657, 275, 8657, 0, 8657
2851, 1, 1636417038298, 1636417048226, 9928, 9660, 268, 9659, 0, 9659
2867, 1, 1636417047990, 1636417048258, 268, 0, 268, 0, 0, 0
2868, 1, 1636417048018, 1636417048286, 268, 0, 268, 0, 0, 0
2869, 1, 1636417048182, 1636417048454, 272, 1, 271, 1, 0, 1
2870, 1, 1636417048354, 1636417048726, 372, 101, 271, 101, 0, 101
2872, 1, 1636417048666, 1636417048942, 276, 0, 276, 0, 0, 0
2871, 1, 1636417048622, 1636417048994, 372, 105, 267, 105, 0, 105
2873, 1, 1636417048730, 1636417048998, 268, 0, 268, 0, 0, 0
2874, 1, 1636417048850, 1636417049122, 272, 1, 271, 1, 0, 1
2875, 1, 1636417049122, 1636417049398, 276, 1, 275, 0, 0, 0
2876, 1, 1636417049338, 1636417049610, 272, 1, 271, 1, 0, 1
2877, 1, 1636417049390, 1636417049678, 288, 8, 280, 8, 0, 8
2878, 1, 1636417049442, 1636417049718, 276, 1, 275, 0, 1, 1
2879, 1, 1636417049566, 1636417049842, 276, 0, 276, 0, 0, 0
2880, 1, 1636417049838, 1636417050114, 276, 5, 271, 5, 0, 5
2881, 1, 1636417050058, 1636417050330, 272, 1, 271, 1, 0, 1
2882, 1, 1636417050110, 1636417050390, 280, 5, 275, 4, 0, 4
2883, 1, 1636417050154, 1636417050426, 272, 1, 271, 1, 0, 1
2884, 1, 1636417050278, 1636417050554, 276, 0, 276, 0, 0, 0
2885, 1, 1636417050550, 1636417050830, 280, 5, 275, 5, 0, 5
2886, 1, 1636417050770, 1636417051042, 272, 0, 272, 0, 0, 0
2887, 1, 1636417050818, 1636417051106, 288, 13, 275, 13, 0, 13
2888, 1, 1636417050870, 1636417051142, 272, 0, 272, 0, 0, 0
2889, 1, 1636417050994, 1636417051262, 268, 0, 268, 0, 0, 0
2890, 1, 1636417051262, 1636417051534, 272, 1, 271, 1, 0, 1
2891, 1, 1636417051486, 1636417051758, 272, 1, 271, 0, 1, 1
2892, 1, 1636417051530, 1636417051802, 272, 5, 267, 5, 0, 5
2893, 1, 1636417051590, 1636417051862, 272, 0, 272, 0, 0, 0
2894, 1, 1636417051662, 1636417051938, 276, 0, 276, 0, 0, 0
2895, 1, 1636417051930, 1636417052207, 277, 9, 268, 9, 0, 9
2897, 1, 1636417052206, 1636417052474, 268, 1, 267, 0, 0, 0
2898, 1, 1636417052294, 1636417052566, 272, 1, 271, 0, 1, 1
2899, 1, 1636417052382, 1636417052654, 272, 0, 272, 0, 0, 0
2900, 1, 1636417052650, 1636417052926, 276, 4, 272, 4, 0, 4
2901, 1, 1636417052918, 1636417053190, 272, 0, 272, 0, 0, 0
2902, 1, 1636417053010, 1636417053278, 268, 1, 267, 0, 0, 0
2903, 1, 1636417053094, 1636417053366, 272, 0, 272, 0, 0, 0
2904, 1, 1636417053362, 1636417053638, 276, 4, 272, 4, 0, 4
2905, 1, 1636417053626, 1636417053898, 272, 0, 272, 0, 0, 0
2906, 1, 1636417053718, 1636417053986, 268, 0, 268, 0, 0, 0
2907, 1, 1636417053806, 1636417054078, 272, 0, 272, 0, 0, 0
2908, 1, 1636417054074, 1636417054342, 268, 5, 263, 4, 0, 4
2909, 1, 1636417054342, 1636417054614, 272, 0, 272, 0, 0, 0
2910, 1, 1636417054430, 1636417054706, 276, 0, 276, 0, 0, 0
2911, 1, 1636417054522, 1636417054794, 272, 1, 271, 0, 0, 0
2912, 1, 1636417054790, 1636417055062, 272, 4, 268, 4, 0, 4
2913, 1, 1636417055062, 1636417055330, 268, 1, 267, 0, 0, 0
2914, 1, 1636417055150, 1636417055414, 264, 0, 264, 0, 0, 0
2915, 1, 1636417055242, 1636417055518, 276, 0, 276, 0, 0, 0
2916, 1, 1636417055510, 1636417055786, 276, 9, 267, 9, 0, 9
2917, 1, 1636417055782, 1636417056058, 276, 0, 276, 0, 0, 0
2918, 1, 1636417055874, 1636417056150, 276, 0, 276, 0, 0, 0
2919, 1, 1636417055954, 1636417056230, 276, 0, 276, 0, 0, 0
2920, 1, 1636417056222, 1636417056502, 280, 9, 271, 9, 0, 9
2921, 1, 1636417056498, 1636417056778, 280, 5, 275, 5, 0, 5
2922, 1, 1636417056594, 1636417056862, 268, 0, 268, 0, 0, 0
2923, 1, 1636417056662, 1636417056938, 276, 0, 276, 0, 0, 0
2896, 1, 1636417052206, 1636417057134, 4928, 4657, 271, 4657, 0, 4657
2924, 1, 1636417056934, 1636417057210, 276, 5, 271, 5, 0, 5
2925, 1, 1636417057206, 1636417057478, 272, 1, 271, 0, 0, 0
2926, 1, 1636417057310, 1636417057582, 272, 0, 272, 0, 0, 0
2927, 1, 1636417057370, 1636417057646, 276, 0, 276, 0, 0, 0
2928, 1, 1636417057538, 1636417057806, 268, 0, 268, 0, 0, 0
2929, 1, 1636417057642, 1636417057914, 272, 5, 267, 5, 0, 5
2930, 1, 1636417057914, 1636417058194, 280, 1, 279, 1, 0, 1
2931, 1, 1636417058026, 1636417058302, 276, 1, 275, 0, 0, 0
2932, 1, 1636417058086, 1636417058466, 380, 109, 271, 109, 0, 109
2933, 1, 1636417058210, 1636417058490, 280, 0, 280, 0, 0, 0
2934, 1, 1636417058354, 1636417058742, 388, 113, 275, 113, 0, 113
2935, 1, 1636417058626, 1636417058894, 268, 0, 268, 0, 0, 0
2936, 1, 1636417058746, 1636417059014, 268, 0, 268, 0, 0, 0
2937, 1, 1636417058866, 1636417059142, 276, 0, 276, 0, 0, 0
2938, 1, 1636417058918, 1636417059190, 272, 0, 272, 0, 0, 0
2939, 1, 1636417059138, 1636417059414, 276, 5, 271, 5, 0, 5
2940, 1, 1636417059338, 1636417059686, 348, 77, 271, 77, 0, 77
2941, 1, 1636417059466, 1636417059746, 280, 0, 280, 0, 0, 0
2942, 1, 1636417059578, 1636417059850, 272, 0, 272, 0, 0, 0
2943, 1, 1636417059642, 1636417059910, 268, 0, 268, 0, 0, 0
2944, 1, 1636417059850, 1636417060126, 276, 1, 275, 1, 0, 1
2945, 1, 1636417060090, 1636417060394, 304, 37, 267, 37, 0, 37
2946, 1, 1636417060182, 1636417060454, 272, 0, 272, 0, 0, 0
2948, 1, 1636417060366, 1636417060638, 272, 0, 272, 0, 0, 0
2947, 1, 1636417060246, 1636417060662, 416, 148, 268, 148, 0, 148
2949, 1, 1636417060566, 1636417060930, 364, 96, 268, 96, 0, 96
2951, 1, 1636417060898, 1636417061170, 272, 0, 272, 0, 0, 0
2950, 1, 1636417060810, 1636417061202, 392, 121, 271, 121, 0, 121
2952, 1, 1636417061058, 1636417061330, 272, 0, 272, 0, 0, 0
2953, 1, 1636417061074, 1636417061342, 268, 0, 268, 0, 0, 0
2954, 1, 1636417061330, 1636417061598, 268, 1, 267, 1, 0, 1
2955, 1, 1636417061598, 1636417061866, 268, 1, 267, 1, 0, 1
2956, 1, 1636417061614, 1636417061878, 264, 0, 264, 0, 0, 0
2957, 1, 1636417061734, 1636417062002, 268, 0, 268, 0, 0, 0
2958, 1, 1636417061786, 1636417062058, 272, 0, 272, 0, 0, 0
2959, 1, 1636417062006, 1636417062282, 276, 0, 276, 0, 0, 0
2960, 1, 1636417062274, 1636417062558, 284, 9, 275, 9, 0, 9
2961, 1, 1636417062322, 1636417062590, 268, 0, 268, 0, 0, 0
2962, 1, 1636417062446, 1636417062718, 272, 1, 271, 0, 0, 0
2963, 1, 1636417062494, 1636417062766, 272, 0, 272, 0, 0, 0
2964, 1, 1636417062714, 1636417062994, 280, 5, 275, 4, 1, 5
2965, 1, 1636417062982, 1636417063262, 280, 13, 267, 12, 1, 13
2966, 1, 1636417063030, 1636417063298, 268, 0, 268, 0, 0, 0
2967, 1, 1636417063154, 1636417063430, 276, 0, 276, 0, 0, 0
2968, 1, 1636417063206, 1636417063478, 272, 0, 272, 0, 0, 0
2969, 1, 1636417063430, 1636417063694, 264, 0, 264, 0, 0, 0
2970, 1, 1636417063690, 1636417063966, 276, 5, 271, 5, 0, 5
2971, 1, 1636417063754, 1636417064018, 264, 0, 264, 0, 0, 0
2973, 1, 1636417063922, 1636417064186, 264, 0, 264, 0, 0, 0
2972, 1, 1636417063874, 1636417064294, 420, 145, 275, 145, 0, 145
2974, 1, 1636417064142, 1636417064570, 428, 153, 275, 153, 0, 153
2976, 1, 1636417064458, 1636417064730, 272, 0, 272, 0, 0, 0
2975, 1, 1636417064410, 1636417064850, 440, 161, 279, 161, 0, 161
2977, 1, 1636417064630, 1636417064906, 276, 0, 276, 0, 0, 0
2978, 1, 1636417064690, 1636417064958, 268, 0, 268, 0, 0, 0
2979, 1, 1636417064970, 1636417065246, 276, 0, 276, 0, 0, 0
2980, 1, 1636417065182, 1636417065454, 272, 1, 271, 0, 1, 1
2981, 1, 1636417065246, 1636417065522, 276, 1, 275, 1, 0, 1
2982, 1, 1636417065342, 1636417065618, 276, 0, 276, 0, 0, 0
2983, 1, 1636417065358, 1636417065634, 276, 1, 275, 0, 0, 0
2984, 1, 1636417065686, 1636417065958, 272, 0, 272, 0, 0, 0
2985, 1, 1636417065898, 1636417066174, 276, 0, 276, 0, 0, 0
2986, 1, 1636417065918, 1636417066226, 308, 41, 267, 41, 0, 41
2987, 1, 1636417066054, 1636417066326, 272, 0, 272, 0, 0, 0
2988, 1, 1636417066066, 1636417066338, 272, 0, 272, 0, 0, 0
2989, 1, 1636417066398, 1636417066678, 280, 0, 280, 0, 0, 0
2990, 1, 1636417066610, 1636417066882, 272, 0, 272, 0, 0, 0
2991, 1, 1636417066630, 1636417066946, 316, 48, 268, 48, 0, 48
2992, 1, 1636417066766, 1636417067038, 272, 0, 272, 0, 0, 0
2993, 1, 1636417066786, 1636417067058, 272, 0, 272, 0, 0, 0
2994, 1, 1636417067114, 1636417067386, 272, 0, 272, 0, 0, 0
2995, 1, 1636417067326, 1636417067598, 272, 1, 271, 0, 1, 1
2996, 1, 1636417067386, 1636417067658, 272, 1, 271, 1, 0, 1
2997, 1, 1636417067482, 1636417067750, 268, 0, 268, 0, 0, 0
2998, 1, 1636417067498, 1636417067774, 276, 0, 276, 0, 0, 0
2999, 1, 1636417067782, 1636417068054, 272, 0, 272, 0, 0, 0
3000, 1, 1636417068038, 1636417068310, 272, 0, 272, 0, 0, 0
3001, 1, 1636417068058, 1636417068326, 268, 0, 268, 0, 0, 0
3002, 1, 1636417068194, 1636417068462, 268, 0, 268, 0, 0, 0
3003, 1, 1636417068218, 1636417068486, 268, 0, 268, 0, 0, 0
3004, 1, 1636417068498, 1636417068766, 268, 1, 267, 0, 0, 0
3005, 1, 1636417068754, 1636417069026, 272, 0, 272, 0, 0, 0
3006, 1, 1636417068774, 1636417069050, 276, 0, 276, 0, 0, 0
3007, 1, 1636417068906, 1636417069178, 272, 0, 272, 0, 0, 0
3008, 1, 1636417068926, 1636417069202, 276, 0, 276, 0, 0, 0
3009, 1, 1636417069214, 1636417069490, 276, 0, 276, 0, 0, 0
3010, 1, 1636417069474, 1636417069750, 276, 1, 275, 0, 0, 0
3011, 1, 1636417069486, 1636417069758, 272, 5, 267, 5, 0, 5
3012, 1, 1636417069622, 1636417069902, 280, 0, 280, 0, 0, 0
3013, 1, 1636417069638, 1636417069910, 272, 0, 272, 0, 0, 0
3014, 1, 1636417069926, 1636417070202, 276, 0, 276, 0, 0, 0
3015, 1, 1636417070186, 1636417070458, 272, 0, 272, 0, 0, 0
3016, 1, 1636417070198, 1636417070470, 272, 5, 267, 5, 0, 5
3017, 1, 1636417070334, 1636417070602, 268, 0, 268, 0, 0, 0
3018, 1, 1636417070354, 1636417070630, 276, 1, 275, 0, 0, 0
3019, 1, 1636417070634, 1636417070910, 276, 0, 276, 0, 0, 0
3020, 1, 1636417070898, 1636417071178, 280, 0, 280, 0, 0, 0
3021, 1, 1636417070914, 1636417071186, 272, 0, 272, 0, 0, 0
3022, 1, 1636417071046, 1636417071314, 268, 0, 268, 0, 0, 0
3023, 1, 1636417071070, 1636417071346, 276, 0, 276, 0, 0, 0
3024, 1, 1636417071354, 1636417071626, 272, 0, 272, 0, 0, 0
3025, 1, 1636417071606, 1636417071878, 272, 0, 272, 0, 0, 0
3026, 1, 1636417071630, 1636417071906, 276, 0, 276, 0, 0, 0
3027, 1, 1636417071766, 1636417072042, 276, 0, 276, 0, 0, 0
3028, 1, 1636417071786, 1636417072058, 272, 1, 271, 0, 0, 0
3029, 1, 1636417072070, 1636417072342, 272, 0, 272, 0, 0, 0
3030, 1, 1636417072318, 1636417072590, 272, 0, 272, 0, 0, 0
3031, 1, 1636417072342, 1636417072618, 276, 1, 275, 1, 0, 1
3032, 1, 1636417072486, 1636417072758, 272, 0, 272, 0, 0, 0
3033, 1, 1636417072498, 1636417072766, 268, 0, 268, 0, 0, 0
3034, 1, 1636417072782, 1636417073054, 272, 0, 272, 0, 0, 0
3035, 1, 1636417073034, 1636417073302, 268, 1, 267, 0, 0, 0
3036, 1, 1636417073058, 1636417073326, 268, 0, 268, 0, 0, 0
3037, 1, 1636417073206, 1636417073478, 272, 1, 271, 0, 0, 0
3038, 1, 1636417073214, 1636417073490, 276, 0, 276, 0, 0, 0
3039, 1, 1636417073494, 1636417073774, 280, 0, 280, 0, 0, 0
3040, 1, 1636417073742, 1636417074010, 268, 0, 268, 0, 0, 0
3041, 1, 1636417073770, 1636417074042, 272, 5, 267, 5, 0, 5
3042, 1, 1636417073926, 1636417074202, 276, 0, 276, 0, 0, 0
3043, 1, 1636417073930, 1636417074202, 272, 0, 272, 0, 0, 0
3044, 1, 1636417074214, 1636417074490, 276, 0, 276, 0, 0, 0
3045, 1, 1636417074446, 1636417074714, 268, 0, 268, 0, 0, 0
3046, 1, 1636417074494, 1636417074766, 272, 0, 272, 0, 0, 0
3047, 1, 1636417074642, 1636417074914, 272, 0, 272, 0, 0, 0
3048, 1, 1636417074650, 1636417074918, 268, 0, 268, 0, 0, 0
3049, 1, 1636417074934, 1636417075210, 276, 0, 276, 0, 0, 0
3050, 1, 1636417075158, 1636417075430, 272, 0, 272, 0, 0, 0
3051, 1, 1636417075210, 1636417075482, 272, 1, 271, 1, 0, 1
3053, 1, 1636417075366, 1636417075634, 268, 0, 268, 0, 0, 0
3052, 1, 1636417075358, 1636417075634, 276, 0, 276, 0, 0, 0
3054, 1, 1636417075642, 1636417075918, 276, 0, 276, 0, 0, 0
3055, 1, 1636417075866, 1636417076134, 268, 1, 267, 0, 1, 1
3056, 1, 1636417075922, 1636417076194, 272, 0, 272, 0, 0, 0
3057, 1, 1636417076074, 1636417076350, 276, 0, 276, 0, 0, 0
3058, 1, 1636417076082, 1636417076350, 268, 1, 267, 0, 0, 0
3059, 1, 1636417076358, 1636417076638, 280, 0, 280, 0, 0, 0
3060, 1, 1636417076582, 1636417076854, 272, 0, 272, 0, 0, 0
3061, 1, 1636417076634, 1636417076922, 288, 5, 283, 4, 0, 4
3062, 1, 1636417076794, 1636417077070, 276, 0, 276, 0, 0, 0
3063, 1, 1636417076802, 1636417077126, 324, 53, 271, 53, 0, 53
3064, 1, 1636417077078, 1636417077346, 268, 0, 268, 0, 0, 0
3065, 1, 1636417077290, 1636417077566, 276, 0, 276, 0, 0, 0
3066, 1, 1636417077354, 1636417077630, 276, 0, 276, 0, 0, 0
3067, 1, 1636417077506, 1636417077782, 276, 1, 275, 0, 0, 0
3068, 1, 1636417077562, 1636417077838, 276, 0, 276, 0, 0, 0
3069, 1, 1636417077790, 1636417078062, 272, 0, 272, 0, 0, 0
3070, 1, 1636417077998, 1636417078270, 272, 0, 272, 0, 0, 0
3071, 1, 1636417078062, 1636417078330, 268, 0, 268, 0, 0, 0
3072, 1, 1636417078218, 1636417078490, 272, 1, 271, 0, 0, 0
3073, 1, 1636417078274, 1636417078550, 276, 0, 276, 0, 0, 0
3074, 1, 1636417078506, 1636417078778, 272, 0, 272, 0, 0, 0
3075, 1, 1636417078710, 1636417078990, 280, 1, 279, 0, 1, 1
3076, 1, 1636417078774, 1636417079054, 280, 5, 275, 5, 0, 5
3077, 1, 1636417078938, 1636417079210, 272, 1, 271, 0, 0, 0
3078, 1, 1636417078986, 1636417079262, 276, 0, 276, 0, 0, 0
3079, 1, 1636417079222, 1636417079490, 268, 0, 268, 0, 0, 0
3080, 1, 1636417079422, 1636417079698, 276, 0, 276, 0, 0, 0
3081, 1, 1636417079486, 1636417079770, 284, 5, 279, 5, 0, 5
3083, 1, 1636417079698, 1636417079974, 276, 1, 275, 0, 0, 0
3082, 1, 1636417079658, 1636417080046, 388, 113, 275, 113, 0, 113
3084, 1, 1636417079942, 1636417080318, 376, 104, 272, 104, 0, 104
3085, 1, 1636417080142, 1636417080414, 272, 0, 272, 0, 0, 0
3086, 1, 1636417080206, 1636417080586, 380, 113, 267, 113, 0, 113
3087, 1, 1636417080414, 1636417080678, 264, 0, 264, 0, 0, 0
3088, 1, 1636417080446, 1636417080726, 280, 0, 280, 0, 0, 0
3089, 1, 1636417080714, 1636417080998, 284, 13, 271, 12, 1, 13
3090, 1, 1636417080862, 1636417081134, 272, 0, 272, 0, 0, 0
3091, 1, 1636417080982, 1636417081270, 288, 17, 271, 17, 0, 17
3092, 1, 1636417081082, 1636417081354, 272, 1, 271, 0, 0, 0
3093, 1, 1636417081162, 1636417081438, 276, 0, 276, 0, 0, 0
3094, 1, 1636417081430, 1636417081706, 276, 8, 268, 8, 0, 8
3095, 1, 1636417081566, 1636417081838, 272, 0, 272, 0, 0, 0
3096, 1, 1636417081694, 1636417081974, 280, 13, 267, 13, 0, 13
3097, 1, 1636417081802, 1636417082074, 272, 0, 272, 0, 0, 0
3098, 1, 1636417081874, 1636417082142, 268, 0, 268, 0, 0, 0
3099, 1, 1636417082142, 1636417082426, 284, 1, 283, 1, 0, 1
3100, 1, 1636417082278, 1636417082554, 276, 0, 276, 0, 0, 0
3101, 1, 1636417082406, 1636417082702, 296, 21, 275, 20, 1, 21
3102, 1, 1636417082526, 1636417082802, 276, 0, 276, 0, 0, 0
3103, 1, 1636417082550, 1636417082822, 272, 0, 272, 0, 0, 0
3104, 1, 1636417082862, 1636417083134, 272, 0, 272, 0, 0, 0
3105, 1, 1636417082990, 1636417083258, 268, 0, 268, 0, 0, 0
3106, 1, 1636417083122, 1636417083410, 288, 13, 275, 13, 0, 13
3107, 1, 1636417083238, 1636417083510, 272, 0, 272, 0, 0, 0
3108, 1, 1636417083266, 1636417083542, 276, 0, 276, 0, 0, 0
3109, 1, 1636417083574, 1636417083838, 264, 0, 264, 0, 0, 0
3110, 1, 1636417083702, 1636417083982, 280, 0, 280, 0, 0, 0
3111, 1, 1636417083838, 1636417084114, 276, 1, 275, 0, 0, 0
3112, 1, 1636417083954, 1636417084226, 272, 0, 272, 0, 0, 0
3113, 1, 1636417083970, 1636417084242, 272, 0, 272, 0, 0, 0
3114, 1, 1636417084238, 1636417084514, 276, 5, 271, 5, 0, 5
3115, 1, 1636417084414, 1636417084686, 272, 0, 272, 0, 0, 0
3116, 1, 1636417084546, 1636417084818, 272, 1, 271, 0, 0, 0
3117, 1, 1636417084670, 1636417084942, 272, 1, 271, 0, 0, 0
3118, 1, 1636417084678, 1636417084946, 268, 0, 268, 0, 0, 0
3119, 1, 1636417084946, 1636417085218, 272, 1, 271, 1, 0, 1
3120, 1, 1636417085130, 1636417085402, 272, 0, 272, 0, 0, 0
3121, 1, 1636417085218, 1636417085494, 276, 1, 275, 1, 0, 1
3122, 1, 1636417085382, 1636417085658, 276, 1, 275, 1, 0, 1
3123, 1, 1636417085382, 1636417085658, 276, 1, 275, 1, 0, 1
3124, 1, 1636417085654, 1636417085926, 272, 5, 267, 5, 0, 5
3125, 1, 1636417085838, 1636417086110, 272, 0, 272, 0, 0, 0
3126, 1, 1636417085926, 1636417086194, 268, 1, 267, 1, 0, 1
3128, 1, 1636417086102, 1636417086374, 272, 0, 272, 0, 0, 0
3127, 1, 1636417086098, 1636417086374, 276, 0, 276, 0, 0, 0
3129, 1, 1636417086366, 1636417086642, 276, 9, 267, 9, 0, 9
3130, 1, 1636417086562, 1636417086830, 268, 0, 268, 0, 0, 0
3131, 1, 1636417086638, 1636417086914, 276, 5, 271, 5, 0, 5
3132, 1, 1636417086810, 1636417087078, 268, 0, 268, 0, 0, 0
3135, 1, 1636417087274, 1636417087550, 276, 0, 276, 0, 0, 0
3137, 1, 1636417087518, 1636417087798, 280, 0, 280, 0, 0, 0
3138, 1, 1636417087982, 1636417088258, 276, 1, 275, 0, 0, 0
3139, 1, 1636417088226, 1636417088502, 276, 1, 275, 0, 0, 0
3140, 1, 1636417088698, 1636417088974, 276, 1, 275, 0, 0, 0
3141, 1, 1636417088934, 1636417089210, 276, 0, 276, 0, 0, 0
3142, 1, 1636417089414, 1636417089691, 277, 1, 276, 0, 1, 1
3143, 1, 1636417089650, 1636417089926, 276, 0, 276, 0, 0, 0
3144, 1, 1636417090126, 1636417090402, 276, 1, 275, 0, 1, 1
3145, 1, 1636417090362, 1636417090634, 272, 0, 272, 0, 0, 0
3146, 1, 1636417090842, 1636417091118, 276, 0, 276, 0, 0, 0
3147, 1, 1636417091070, 1636417091346, 276, 0, 276, 0, 0, 0
3148, 1, 1636417091562, 1636417091838, 276, 1, 275, 0, 1, 1
3149, 1, 1636417091778, 1636417092054, 276, 1, 275, 1, 0, 1
3150, 1, 1636417092278, 1636417092554, 276, 1, 275, 0, 1, 1
3151, 1, 1636417092490, 1636417092771, 281, 0, 281, 0, 0, 0
3152, 1, 1636417092994, 1636417093270, 276, 0, 276, 0, 0, 0
3153, 1, 1636417093210, 1636417093486, 276, 0, 276, 0, 0, 0
3154, 1, 1636417093702, 1636417093978, 276, 0, 276, 0, 0, 0
3155, 1, 1636417093926, 1636417094202, 276, 1, 275, 0, 0, 0
3156, 1, 1636417094418, 1636417094690, 272, 1, 271, 0, 0, 0
3157, 1, 1636417094634, 1636417094906, 272, 1, 271, 0, 0, 0
3158, 1, 1636417095126, 1636417095398, 272, 1, 271, 0, 0, 0
3159, 1, 1636417095346, 1636417095670, 324, 53, 271, 53, 0, 53
3160, 1, 1636417095834, 1636417096110, 276, 0, 276, 0, 0, 0
3161, 1, 1636417096106, 1636417096378, 272, 0, 272, 0, 0, 0
3133, 2, 1636417086818, 1636417096819, 10001, 0, 10001, 261, 0, 261
3162, 1, 1636417096546, 1636417096866, 320, 1, 319, 0, 0, 0
3134, 2, 1636417087078, 1636417097078, 10000, 0, 10000, 1, 0, 1
3163, 1, 1636417096818, 1636417097126, 308, 1, 307, 1, 0, 1
3136, 1, 1636417087350, 1636417097346, 9996, 9728, 268, 0, 9728, 9728
3164, 1, 1636417097302, 1636417097570, 268, 0, 268, 0, 0, 0
3165, 1, 1636417097386, 1636417097658, 272, 1, 271, 0, 0, 0
3166, 1, 1636417097386, 1636417097658, 272, 1, 271, 0, 1, 1
3167, 1, 1636417097530, 1636417097802, 272, 0, 272, 0, 0, 0
3168, 1, 1636417097742, 1636417098014, 272, 0, 272, 0, 0, 0
3169, 1, 1636417098014, 1636417098278, 264, 1, 263, 0, 1, 1
3171, 1, 1636417098058, 1636417098326, 268, 0, 268, 0, 0, 0
3170, 1, 1636417098058, 1636417098326, 268, 0, 268, 0, 0, 0
3172, 1, 1636417098202, 1636417098478, 276, 0, 276, 0, 0, 0
3173, 1, 1636417098414, 1636417098686, 272, 0, 272, 0, 0, 0
3174, 1, 1636417098686, 1636417098958, 272, 0, 272, 0, 0, 0
3175, 1, 1636417098726, 1636417099002, 276, 0, 276, 0, 0, 0
3176, 1, 1636417098726, 1636417099002, 276, 0, 276, 0, 0, 0
3177, 1, 1636417098922, 1636417099194, 272, 0, 272, 0, 0, 0
3178, 1, 1636417099126, 1636417099398, 272, 1, 271, 0, 1, 1
3179, 1, 1636417099394, 1636417099670, 276, 1, 275, 0, 0, 0
3180, 1, 1636417099442, 1636417099710, 268, 0, 268, 0, 0, 0
3181, 1, 1636417099442, 1636417099714, 272, 1, 271, 0, 1, 1
3182, 1, 1636417099634, 1636417099910, 276, 0, 276, 0, 0, 0
3183, 1, 1636417099838, 1636417100114, 276, 1, 275, 0, 1, 1
3184, 1, 1636417100118, 1636417100394, 276, 0, 276, 0, 0, 0
3185, 1, 1636417100158, 1636417100430, 272, 0, 272, 0, 0, 0
3186, 1, 1636417100162, 1636417100430, 268, 0, 268, 0, 0, 0
3187, 1, 1636417100346, 1636417100618, 272, 1, 271, 0, 1, 1
3188, 1, 1636417100554, 1636417100830, 276, 1, 275, 0, 1, 1
3189, 1, 1636417100826, 1636417101102, 276, 0, 276, 0, 0, 0
3191, 1, 1636417100882, 1636417101150, 268, 0, 268, 0, 0, 0
3190, 1, 1636417100878, 1636417101150, 272, 0, 272, 0, 0, 0
3192, 1, 1636417101066, 1636417101338, 272, 0, 272, 0, 0, 0
3193, 1, 1636417101274, 1636417101546, 272, 1, 271, 0, 1, 1
3194, 1, 1636417101594, 1636417101871, 277, 0, 277, 0, 0, 0
3195, 1, 1636417101598, 1636417101871, 273, 0, 273, 0, 0, 0
3196, 1, 1636417101778, 1636417102050, 272, 1, 271, 0, 1, 1
3197, 1, 1636417101986, 1636417102258, 272, 0, 272, 0, 0, 0
3198, 1, 1636417102302, 1636417102570, 268, 0, 268, 0, 0, 0
3199, 1, 1636417102310, 1636417102582, 272, 0, 272, 0, 0, 0
3200, 1, 1636417102498, 1636417102774, 276, 1, 275, 0, 0, 0
3201, 1, 1636417102706, 1636417102978, 272, 0, 272, 0, 0, 0
3202, 1, 1636417103018, 1636417103290, 272, 0, 272, 0, 0, 0
3203, 1, 1636417103026, 1636417103294, 268, 0, 268, 0, 0, 0
3204, 1, 1636417103210, 1636417103486, 276, 0, 276, 0, 0, 0
3205, 1, 1636417103426, 1636417103702, 276, 0, 276, 0, 0, 0
3206, 1, 1636417103726, 1636417103998, 272, 0, 272, 0, 0, 0
3207, 1, 1636417103746, 1636417104022, 276, 0, 276, 0, 0, 0
3208, 1, 1636417103930, 1636417104206, 276, 0, 276, 0, 0, 0
3209, 1, 1636417104138, 1636417104410, 272, 0, 272, 0, 0, 0
3210, 1, 1636417104442, 1636417104714, 272, 0, 272, 0, 0, 0
3211, 1, 1636417104470, 1636417104746, 276, 0, 276, 0, 0, 0
3212, 1, 1636417104650, 1636417104922, 272, 1, 271, 0, 1, 1
3213, 1, 1636417104858, 1636417105138, 280, 0, 280, 0, 0, 0
3214, 1, 1636417105154, 1636417105426, 272, 0, 272, 0, 0, 0
3215, 1, 1636417105178, 1636417105450, 272, 0, 272, 0, 0, 0
3216, 1, 1636417105358, 1636417105630, 272, 1, 271, 0, 0, 0
3217, 1, 1636417105566, 1636417105842, 276, 0, 276, 0, 0, 0
3218, 1, 1636417105862, 1636417106138, 276, 0, 276, 0, 0, 0
3219, 1, 1636417105886, 1636417106162, 276, 0, 276, 0, 0, 0
3220, 1, 1636417106066, 1636417106338, 272, 0, 272, 0, 0, 0
3221, 1, 1636417106286, 1636417106554, 268, 1, 267, 0, 0, 0
3222, 1, 1636417106586, 1636417106862, 276, 0, 276, 0, 0, 0
3223, 1, 1636417106598, 1636417106874, 276, 0, 276, 0, 0, 0
3224, 1, 1636417106782, 1636417107050, 268, 1, 267, 0, 1, 1
3225, 1, 1636417107002, 1636417107278, 276, 0, 276, 0, 0, 0
3226, 1, 1636417107294, 1636417107566, 272, 0, 272, 0, 0, 0
3227, 1, 1636417107306, 1636417107582, 276, 0, 276, 0, 0, 0
3228, 1, 1636417107498, 1636417107774, 276, 0, 276, 0, 0, 0
3229, 1, 1636417107710, 1636417107986, 276, 0, 276, 0, 0, 0
3230, 1, 1636417108002, 1636417108278, 276, 0, 276, 0, 0, 0
3231, 1, 1636417108026, 1636417108298, 272, 1, 271, 0, 0, 0
3232, 1, 1636417108218, 1636417108490, 272, 0, 272, 0, 0, 0
3233, 1, 1636417108430, 1636417108706, 276, 0, 276, 0, 0, 0
3234, 1, 1636417108718, 1636417108986, 268, 0, 268, 0, 0, 0
3235, 1, 1636417108730, 1636417109002, 272, 0, 272, 0, 0, 0
3236, 1, 1636417108922, 1636417109190, 268, 0, 268, 0, 0, 0
3237, 1, 1636417109150, 1636417109422, 272, 0, 272, 0, 0, 0
3238, 1, 1636417109434, 1636417109714, 280, 0, 280, 0, 0, 0
3239, 1, 1636417109438, 1636417109715, 277, 0, 277, 0, 0, 0
3240, 1, 1636417109638, 1636417109910, 272, 0, 272, 0, 0, 0
3241, 1, 1636417109866, 1636417110142, 276, 0, 276, 0, 0, 0
3242, 1, 1636417110150, 1636417110418, 268, 0, 268, 0, 0, 0
3243, 1, 1636417110162, 1636417110438, 276, 1, 275, 0, 0, 0
3244, 1, 1636417110358, 1636417110634, 276, 1, 275, 0, 0, 0
3245, 1, 1636417110574, 1636417110850, 276, 0, 276, 0, 0, 0
3246, 1, 1636417110862, 1636417111138, 276, 0, 276, 0, 0, 0
3247, 1, 1636417110866, 1636417111146, 280, 0, 280, 0, 0, 0
3248, 1, 1636417111070, 1636417111346, 276, 0, 276, 0, 0, 0
3249, 1, 1636417111298, 1636417111570, 272, 1, 271, 0, 1, 1
3251, 1, 1636417111574, 1636417111850, 276, 0, 276, 0, 0, 0
3250, 1, 1636417111574, 1636417111851, 277, 0, 277, 0, 0, 0
3252, 1, 1636417112006, 1636417112282, 276, 1, 275, 0, 0, 0
3254, 1, 1636417112294, 1636417112566, 272, 0, 272, 0, 0, 0
3253, 1, 1636417112290, 1636417112566, 276, 0, 276, 0, 0, 0
3255, 1, 1636417112726, 1636417113002, 276, 0, 276, 0, 0, 0
3256, 1, 1636417113006, 1636417113282, 276, 0, 276, 0, 0, 0
3257, 1, 1636417113010, 1636417113282, 272, 0, 272, 0, 0, 0
3258, 1, 1636417113438, 1636417113714, 276, 0, 276, 0, 0, 0
3260, 1, 1636417113730, 1636417113994, 264, 0, 264, 0, 0, 0
3259, 1, 1636417113722, 1636417113998, 276, 0, 276, 0, 0, 0
3261, 1, 1636417114158, 1636417114434, 276, 1, 275, 0, 0, 0
3262, 1, 1636417114438, 1636417114710, 272, 1, 271, 0, 1, 1
3263, 1, 1636417114438, 1636417114710, 272, 1, 271, 1, 0, 1
3264, 1, 1636417114874, 1636417115146, 272, 1, 271, 0, 1, 1
3265, 1, 1636417115146, 1636417115410, 264, 0, 264, 0, 0, 0
3266, 1, 1636417115154, 1636417115426, 272, 1, 271, 0, 0, 0
3267, 1, 1636417115586, 1636417115862, 276, 1, 275, 0, 0, 0
3269, 1, 1636417115870, 1636417116142, 272, 0, 272, 0, 0, 0
3268, 1, 1636417115866, 1636417116142, 276, 0, 276, 0, 0, 0
3270, 1, 1636417116302, 1636417116574, 272, 1, 271, 0, 1, 1
3271, 1, 1636417116578, 1636417116851, 273, 0, 273, 0, 0, 0
3272, 1, 1636417116586, 1636417117126, 540, 265, 275, 265, 0, 265
3273, 1, 1636417117014, 1636417117290, 276, 0, 276, 0, 0, 0
3274, 1, 1636417117298, 1636417117570, 272, 0, 272, 0, 0, 0
3275, 1, 1636417117522, 1636417117794, 272, 0, 272, 0, 0, 0
3276, 1, 1636417117722, 1636417117998, 276, 1, 275, 0, 1, 1
3277, 1, 1636417118006, 1636417118278, 272, 1, 271, 0, 0, 0
3278, 1, 1636417118190, 1636417118470, 280, 0, 280, 0, 0, 0
3279, 1, 1636417118446, 1636417118722, 276, 0, 276, 0, 0, 0
3280, 1, 1636417118722, 1636417118998, 276, 1, 275, 0, 0, 0
3281, 1, 1636417118902, 1636417119178, 276, 0, 276, 0, 0, 0
3282, 1, 1636417119150, 1636417119422, 272, 0, 272, 0, 0, 0
3283, 1, 1636417119438, 1636417119714, 276, 0, 276, 0, 0, 0
3284, 1, 1636417119610, 1636417119882, 272, 1, 271, 0, 1, 1
3285, 1, 1636417119870, 1636417120146, 276, 0, 276, 0, 0, 0
3286, 1, 1636417120150, 1636417120431, 281, 0, 281, 0, 0, 0
3287, 1, 1636417120322, 1636417120598, 276, 1, 275, 0, 1, 1
3288, 1, 1636417120590, 1636417120866, 276, 1, 275, 0, 0, 0
3289, 1, 1636417120858, 1636417121130, 272, 0, 272, 0, 0, 0
3290, 1, 1636417121034, 1636417121306, 272, 0, 272, 0, 0, 0
3291, 1, 1636417121298, 1636417121570, 272, 1, 271, 0, 1, 1
3292, 1, 1636417121566, 1636417121843, 277, 0, 277, 0, 0, 0
3293, 1, 1636417122014, 1636417122290, 276, 0, 276, 0, 0, 0
3294, 1, 1636417122274, 1636417122550, 276, 0, 276, 0, 0, 0
3295, 1, 1636417122726, 1636417123002, 276, 0, 276, 0, 0, 0
3296, 1, 1636417122986, 1636417123262, 276, 0, 276, 0, 0, 0
3297, 1, 1636417123706, 1636417123983, 277, 1, 276, 0, 1, 1
3298, 1, 1636417124414, 1636417124686, 272, 1, 271, 0, 0, 0
3299, 1, 1636417125134, 1636417125406, 272, 0, 272, 0, 0, 0
3300, 1, 1636417125854, 1636417126130, 276, 1, 275, 0, 0, 0
