Xid, State, StartTime, EndTime, TransactionTime, ExecuteTime, CommunicationTime, ReadTime, WriteTime, DBTime
1, 1, 1636429417772, 1636429418271, 499, 69, 430, 28, 5, 33
2, 1, 1636429418637, 1636429419041, 404, 2, 402, 0, 0, 0
3, 1, 1636429419357, 1636429419770, 413, 4, 409, 2, 1, 3
4, 1, 1636429420085, 1636429420493, 408, 3, 405, 0, 1, 1
5, 1, 1636429420809, 1636429421217, 408, 4, 404, 0, 0, 0
6, 1, 1636429421529, 1636429421938, 409, 5, 404, 1, 1, 2
7, 1, 1636429422249, 1636429422658, 409, 5, 404, 0, 0, 0
8, 1, 1636429422969, 1636429423378, 409, 4, 405, 0, 0, 0
9, 1, 1636429423689, 1636429424109, 420, 4, 416, 3, 0, 3
10, 1, 1636429424421, 1636429424829, 408, 2, 406, 1, 0, 1
11, 1, 1636429425141, 1636429425549, 408, 3, 405, 0, 0, 0
12, 1, 1636429425861, 1636429426269, 408, 4, 404, 1, 0, 1
13, 1, 1636429426581, 1636429426989, 408, 3, 405, 0, 0, 0
14, 1, 1636429427301, 1636429427709, 408, 3, 405, 0, 0, 0
15, 1, 1636429428021, 1636429428429, 408, 3, 405, 1, 0, 1
17, 1, 1636429428741, 1636429429150, 409, 7, 402, 1, 0, 1
19, 1, 1636429429461, 1636429429825, 364, 4, 360, 2, 0, 2
21, 1, 1636429430093, 1636429430457, 364, 3, 361, 0, 0, 0
23, 1, 1636429430729, 1636429431097, 368, 2, 366, 2, 0, 2
25, 1, 1636429431365, 1636429431725, 360, 2, 358, 1, 1, 2
26, 1, 1636429431993, 1636429432353, 360, 2, 358, 1, 0, 1
28, 1, 1636429432621, 1636429432985, 364, 2, 362, 0, 0, 0
30, 1, 1636429433253, 1636429433617, 364, 3, 361, 2, 0, 2
32, 1, 1636429433889, 1636429434253, 364, 2, 362, 0, 0, 0
34, 1, 1636429434521, 1636429434885, 364, 3, 361, 0, 0, 0
36, 1, 1636429435152, 1636429435505, 353, 2, 351, 1, 0, 1
38, 1, 1636429435777, 1636429436141, 364, 2, 362, 0, 0, 0
40, 1, 1636429436405, 1636429436765, 360, 2, 358, 1, 0, 1
42, 1, 1636429437037, 1636429437401, 364, 2, 362, 1, 0, 1
44, 1, 1636429437669, 1636429438029, 360, 1, 359, 1, 0, 1
46, 1, 1636429438297, 1636429438657, 360, 1, 359, 0, 1, 1
48, 1, 1636429438925, 1636429439290, 365, 2, 363, 0, 1, 1
50, 1, 1636429439557, 1636429439921, 364, 2, 362, 0, 1, 1
52, 1, 1636429440193, 1636429440553, 360, 2, 358, 2, 0, 2
54, 1, 1636429440825, 1636429441181, 356, 3, 353, 0, 0, 0
56, 1, 1636429441449, 1636429441813, 364, 2, 362, 0, 1, 1
58, 1, 1636429442081, 1636429442445, 364, 3, 361, 0, 1, 1
60, 1, 1636429442709, 1636429443069, 360, 1, 359, 0, 0, 0
62, 1, 1636429443341, 1636429443705, 364, 3, 361, 0, 1, 1
65, 1, 1636429443973, 1636429444337, 364, 0, 364, 0, 0, 0
68, 1, 1636429444605, 1636429444969, 364, 0, 364, 0, 0, 0
71, 1, 1636429445237, 1636429445601, 364, 2, 362, 0, 1, 1
74, 1, 1636429445869, 1636429446233, 364, 2, 362, 1, 0, 1
77, 1, 1636429446501, 1636429446861, 360, 0, 360, 0, 0, 0
80, 1, 1636429447129, 1636429447493, 364, 1, 363, 0, 1, 1
83, 1, 1636429447765, 1636429448129, 364, 1, 363, 0, 1, 1
86, 1, 1636429448397, 1636429448761, 364, 2, 362, 0, 0, 0
88, 1, 1636429449033, 1636429449397, 364, 2, 362, 0, 0, 0
91, 1, 1636429449665, 1636429450029, 364, 1, 363, 0, 1, 1
94, 1, 1636429450297, 1636429450661, 364, 2, 362, 0, 0, 0
97, 1, 1636429450929, 1636429451289, 360, 1, 359, 0, 0, 0
100, 1, 1636429451556, 1636429451913, 357, 2, 355, 1, 0, 1
103, 1, 1636429452181, 1636429452545, 364, 1, 363, 0, 1, 1
106, 1, 1636429452813, 1636429453177, 364, 1, 363, 0, 0, 0
109, 1, 1636429453449, 1636429453805, 356, 3, 353, 1, 0, 1
112, 1, 1636429454077, 1636429454437, 360, 0, 360, 0, 0, 0
115, 1, 1636429454708, 1636429455061, 353, 1, 352, 0, 0, 0
118, 1, 1636429455329, 1636429455693, 364, 1, 363, 0, 0, 0
121, 1, 1636429455961, 1636429456325, 364, 2, 362, 0, 0, 0
124, 1, 1636429456593, 1636429456949, 356, 1, 355, 0, 0, 0
127, 1, 1636429457217, 1636429457577, 360, 0, 360, 0, 0, 0
130, 1, 1636429457845, 1636429458209, 364, 2, 362, 0, 1, 1
133, 1, 1636429458476, 1636429458841, 365, 0, 365, 0, 0, 0
136, 1, 1636429459109, 1636429459465, 356, 1, 355, 0, 0, 0
139, 1, 1636429459733, 1636429460093, 360, 5, 355, 3, 1, 4
142, 1, 1636429460361, 1636429460725, 364, 0, 364, 0, 0, 0
145, 1, 1636429460989, 1636429461353, 364, 1, 363, 0, 0, 0
148, 1, 1636429461621, 1636429461977, 356, 2, 354, 1, 0, 1
151, 1, 1636429462245, 1636429462609, 364, 2, 362, 0, 1, 1
154, 1, 1636429462877, 1636429463241, 364, 0, 364, 0, 0, 0
157, 1, 1636429463513, 1636429463873, 360, 1, 359, 0, 0, 0
160, 1, 1636429464141, 1636429464504, 363, 0, 363, 0, 0, 0
163, 1, 1636429464769, 1636429465133, 364, 0, 364, 0, 0, 0
166, 1, 1636429465401, 1636429465765, 364, 1, 363, 0, 0, 0
169, 1, 1636429466033, 1636429466393, 360, 0, 360, 0, 0, 0
172, 1, 1636429466661, 1636429467021, 360, 0, 360, 0, 0, 0
175, 1, 1636429467289, 1636429467653, 364, 1, 363, 0, 0, 0
178, 1, 1636429467921, 1636429468272, 351, 1, 350, 0, 0, 0
181, 1, 1636429468536, 1636429468897, 361, 1, 360, 0, 0, 0
184, 1, 1636429469168, 1636429469529, 361, 1, 360, 0, 0, 0
187, 1, 1636429469801, 1636429470164, 363, 1, 362, 0, 0, 0
190, 1, 1636429470429, 1636429470789, 360, 2, 358, 0, 0, 0
193, 1, 1636429471057, 1636429471425, 368, 0, 368, 0, 0, 0
196, 1, 1636429471693, 1636429472053, 360, 0, 360, 0, 0, 0
199, 1, 1636429472321, 1636429472681, 360, 1, 359, 0, 0, 0
202, 1, 1636429472953, 1636429473313, 360, 2, 358, 1, 0, 1
205, 1, 1636429473581, 1636429473941, 360, 1, 359, 0, 0, 0
208, 1, 1636429474209, 1636429474564, 355, 2, 353, 1, 1, 2
211, 1, 1636429474829, 1636429475193, 364, 0, 364, 0, 0, 0
214, 1, 1636429475465, 1636429475829, 364, 1, 363, 0, 0, 0
217, 1, 1636429476101, 1636429476461, 360, 1, 359, 0, 0, 0
220, 1, 1636429476729, 1636429477093, 364, 0, 364, 0, 0, 0
223, 1, 1636429477356, 1636429477713, 357, 2, 355, 0, 1, 1
226, 1, 1636429477980, 1636429478337, 357, 1, 356, 0, 0, 0
229, 1, 1636429478608, 1636429478969, 361, 1, 360, 0, 0, 0
232, 1, 1636429479237, 1636429479593, 356, 1, 355, 0, 0, 0
235, 1, 1636429479861, 1636429480225, 364, 1, 363, 0, 1, 1
238, 1, 1636429480493, 1636429480853, 360, 0, 360, 0, 0, 0
241, 1, 1636429481121, 1636429481485, 364, 0, 364, 0, 0, 0
244, 1, 1636429481753, 1636429482117, 364, 0, 364, 0, 0, 0
247, 1, 1636429482385, 1636429482745, 360, 0, 360, 0, 0, 0
250, 1, 1636429483013, 1636429483377, 364, 0, 364, 0, 0, 0
253, 1, 1636429483645, 1636429484009, 364, 0, 364, 0, 0, 0
256, 1, 1636429484277, 1636429484641, 364, 0, 364, 0, 0, 0
259, 1, 1636429484909, 1636429485273, 364, 0, 364, 0, 0, 0
262, 1, 1636429485541, 1636429485905, 364, 1, 363, 0, 0, 0
265, 1, 1636429486173, 1636429486537, 364, 0, 364, 0, 0, 0
268, 1, 1636429486805, 1636429487169, 364, 0, 364, 0, 0, 0
271, 1, 1636429487437, 1636429487801, 364, 1, 363, 0, 0, 0
274, 1, 1636429488069, 1636429488429, 360, 0, 360, 0, 0, 0
277, 1, 1636429488697, 1636429489061, 364, 0, 364, 0, 0, 0
280, 1, 1636429489329, 1636429489692, 363, 0, 363, 0, 0, 0
283, 1, 1636429489957, 1636429490317, 360, 0, 360, 0, 0, 0
286, 1, 1636429490585, 1636429490941, 356, 1, 355, 0, 0, 0
289, 1, 1636429491209, 1636429491573, 364, 0, 364, 0, 0, 0
292, 1, 1636429491841, 1636429492205, 364, 0, 364, 0, 0, 0
295, 1, 1636429492473, 1636429492833, 360, 1, 359, 0, 0, 0
298, 1, 1636429493101, 1636429493465, 364, 1, 363, 0, 0, 0
301, 1, 1636429493733, 1636429494093, 360, 2, 358, 0, 0, 0
304, 1, 1636429494365, 1636429494729, 364, 0, 364, 0, 0, 0
307, 1, 1636429494997, 1636429495361, 364, 0, 364, 0, 0, 0
310, 1, 1636429495629, 1636429495993, 364, 1, 363, 0, 0, 0
313, 1, 1636429496261, 1636429496620, 359, 0, 359, 0, 0, 0
316, 1, 1636429496885, 1636429497245, 360, 2, 358, 1, 0, 1
319, 1, 1636429497513, 1636429497877, 364, 0, 364, 0, 0, 0
322, 1, 1636429498144, 1636429498501, 357, 0, 357, 0, 0, 0
325, 1, 1636429498769, 1636429499129, 360, 0, 360, 0, 0, 0
328, 1, 1636429499397, 1636429499761, 364, 1, 363, 0, 0, 0
331, 1, 1636429500029, 1636429500393, 364, 1, 363, 1, 0, 1
334, 1, 1636429500661, 1636429501025, 364, 1, 363, 0, 1, 1
337, 1, 1636429501297, 1636429501657, 360, 2, 358, 1, 1, 2
340, 1, 1636429501925, 1636429502285, 360, 1, 359, 0, 0, 0
343, 1, 1636429502553, 1636429502917, 364, 0, 364, 0, 0, 0
346, 1, 1636429503185, 1636429503541, 356, 1, 355, 0, 0, 0
349, 1, 1636429503813, 1636429504169, 356, 1, 355, 1, 0, 1
352, 1, 1636429504437, 1636429504792, 355, 1, 354, 0, 0, 0
355, 1, 1636429505057, 1636429505421, 364, 0, 364, 0, 0, 0
358, 1, 1636429505693, 1636429506057, 364, 0, 364, 0, 0, 0
361, 1, 1636429506325, 1636429506685, 360, 0, 360, 0, 0, 0
364, 1, 1636429506952, 1636429507313, 361, 1, 360, 0, 0, 0
367, 1, 1636429507585, 1636429507949, 364, 0, 364, 0, 0, 0
370, 1, 1636429508217, 1636429508581, 364, 0, 364, 0, 0, 0
373, 1, 1636429508849, 1636429509209, 360, 0, 360, 0, 0, 0
376, 1, 1636429509481, 1636429509845, 364, 0, 364, 0, 0, 0
379, 1, 1636429510113, 1636429510473, 360, 0, 360, 0, 0, 0
382, 1, 1636429510745, 1636429511105, 360, 1, 359, 0, 0, 0
385, 1, 1636429511373, 1636429511725, 352, 2, 350, 1, 0, 1
388, 1, 1636429511993, 1636429512353, 360, 1, 359, 0, 0, 0
391, 1, 1636429512621, 1636429512985, 364, 0, 364, 0, 0, 0
394, 1, 1636429513253, 1636429513613, 360, 0, 360, 0, 0, 0
397, 1, 1636429513881, 1636429514241, 360, 0, 360, 0, 0, 0
400, 1, 1636429514509, 1636429514873, 364, 0, 364, 0, 0, 0
403, 1, 1636429515141, 1636429515501, 360, 1, 359, 0, 0, 0
406, 1, 1636429515769, 1636429516129, 360, 0, 360, 0, 0, 0
409, 1, 1636429516397, 1636429516760, 363, 0, 363, 0, 0, 0
412, 1, 1636429517025, 1636429517389, 364, 1, 363, 0, 0, 0
415, 1, 1636429517657, 1636429518021, 364, 0, 364, 0, 0, 0
418, 1, 1636429518289, 1636429518653, 364, 0, 364, 0, 0, 0
421, 1, 1636429518921, 1636429519285, 364, 0, 364, 0, 0, 0
424, 1, 1636429519553, 1636429519909, 356, 1, 355, 0, 0, 0
427, 1, 1636429520177, 1636429520541, 364, 0, 364, 0, 0, 0
430, 1, 1636429520809, 1636429521169, 360, 0, 360, 0, 0, 0
433, 1, 1636429521441, 1636429521801, 360, 0, 360, 0, 0, 0
436, 1, 1636429522069, 1636429522433, 364, 0, 364, 0, 0, 0
439, 1, 1636429522705, 1636429523057, 352, 0, 352, 0, 0, 0
442, 1, 1636429523325, 1636429523689, 364, 0, 364, 0, 0, 0
445, 1, 1636429523953, 1636429524309, 356, 1, 355, 0, 0, 0
448, 1, 1636429524577, 1636429524937, 360, 0, 360, 0, 0, 0
451, 1, 1636429525205, 1636429525569, 364, 0, 364, 0, 0, 0
454, 1, 1636429525837, 1636429526201, 364, 0, 364, 0, 0, 0
457, 1, 1636429526473, 1636429526828, 355, 0, 355, 0, 0, 0
460, 1, 1636429527093, 1636429527453, 360, 1, 359, 0, 0, 0
463, 1, 1636429527721, 1636429528085, 364, 0, 364, 0, 0, 0
466, 1, 1636429528369, 1636429528729, 360, 0, 360, 0, 0, 0
469, 1, 1636429528996, 1636429529357, 361, 1, 360, 0, 0, 0
472, 1, 1636429529625, 1636429529989, 364, 0, 364, 0, 0, 0
475, 1, 1636429530256, 1636429530617, 361, 0, 361, 0, 0, 0
478, 1, 1636429530885, 1636429531241, 356, 1, 355, 0, 0, 0
481, 1, 1636429531509, 1636429531873, 364, 0, 364, 0, 0, 0
484, 1, 1636429532145, 1636429532509, 364, 0, 364, 0, 0, 0
487, 1, 1636429532777, 1636429533137, 360, 1, 359, 0, 0, 0
490, 1, 1636429533405, 1636429533769, 364, 0, 364, 0, 0, 0
493, 1, 1636429534037, 1636429534393, 356, 1, 355, 0, 0, 0
496, 1, 1636429534661, 1636429535021, 360, 1, 359, 0, 0, 0
499, 1, 1636429535289, 1636429535649, 360, 0, 360, 0, 0, 0
502, 1, 1636429535917, 1636429536281, 364, 0, 364, 0, 0, 0
505, 1, 1636429536549, 1636429536912, 363, 0, 363, 0, 0, 0
508, 1, 1636429537181, 1636429537540, 359, 0, 359, 0, 0, 0
511, 1, 1636429537805, 1636429538169, 364, 0, 364, 0, 0, 0
514, 1, 1636429538437, 1636429538801, 364, 0, 364, 0, 0, 0
517, 1, 1636429539069, 1636429539425, 356, 0, 356, 0, 0, 0
520, 1, 1636429539693, 1636429540053, 360, 2, 358, 1, 0, 1
523, 1, 1636429540321, 1636429540685, 364, 1, 363, 0, 0, 0
526, 1, 1636429540953, 1636429541313, 360, 0, 360, 0, 0, 0
529, 1, 1636429541581, 1636429541945, 364, 0, 364, 0, 0, 0
532, 1, 1636429542213, 1636429542577, 364, 0, 364, 0, 0, 0
535, 1, 1636429542845, 1636429543205, 360, 1, 359, 0, 0, 0
538, 1, 1636429543473, 1636429543825, 352, 1, 351, 0, 0, 0
541, 1, 1636429544093, 1636429544457, 364, 0, 364, 0, 0, 0
544, 1, 1636429544717, 1636429545081, 364, 0, 364, 0, 0, 0
601, 1, 1636429578453, 1636429579097, 644, 10, 634, 0, 0, 0
602, 1, 1636429578809, 1636429579680, 871, 289, 582, 289, 0, 289
603, 1, 1636429579365, 1636429579949, 584, 2, 582, 2, 0, 2
604, 1, 1636429579365, 1636429580265, 900, 316, 584, 316, 0, 316
605, 1, 1636429579952, 1636429580536, 584, 1, 583, 0, 0, 0
607, 1, 1636429580217, 1636429580797, 580, 1, 579, 0, 0, 0
606, 1, 1636429580013, 1636429580849, 836, 253, 583, 252, 0, 252
608, 1, 1636429580532, 1636429581121, 589, 5, 584, 4, 0, 4
610, 1, 1636429580800, 1636429581381, 581, 1, 580, 0, 0, 0
609, 1, 1636429580548, 1636429581425, 877, 302, 575, 302, 0, 302
612, 1, 1636429581064, 1636429581649, 585, 1, 584, 0, 0, 0
613, 1, 1636429581181, 1636429581769, 588, 0, 588, 0, 0, 0
614, 1, 1636429581392, 1636429581973, 581, 1, 580, 0, 0, 0
611, 1, 1636429581025, 1636429582013, 988, 402, 586, 401, 1, 402
616, 1, 1636429581649, 1636429582229, 580, 2, 578, 0, 0, 0
617, 1, 1636429581713, 1636429582305, 592, 57, 535, 57, 0, 57
618, 1, 1636429581873, 1636429582325, 452, 0, 452, 0, 0, 0
619, 1, 1636429581993, 1636429582449, 456, 0, 456, 0, 0, 0
615, 1, 1636429581557, 1636429582556, 999, 457, 542, 456, 1, 457
621, 1, 1636429582201, 1636429582685, 484, 29, 455, 29, 0, 29
622, 1, 1636429582297, 1636429582761, 464, 9, 455, 9, 0, 9
623, 1, 1636429582453, 1636429582909, 456, 0, 456, 0, 0, 0
624, 1, 1636429582532, 1636429582981, 449, 1, 448, 1, 0, 1
626, 1, 1636429582544, 1636429582992, 448, 1, 447, 1, 0, 1
625, 1, 1636429582544, 1636429583012, 468, 14, 454, 13, 0, 13
627, 1, 1636429582673, 1636429583141, 468, 13, 455, 13, 0, 13
628, 1, 1636429582796, 1636429583240, 444, 0, 444, 0, 0, 0
629, 1, 1636429582916, 1636429583368, 452, 1, 451, 1, 0, 1
631, 1, 1636429582984, 1636429583428, 444, 1, 443, 1, 0, 1
632, 1, 1636429583128, 1636429583581, 453, 1, 452, 0, 0, 0
633, 1, 1636429583205, 1636429583660, 455, 0, 455, 0, 0, 0
634, 1, 1636429583216, 1636429583668, 452, 1, 451, 0, 1, 1
635, 1, 1636429583248, 1636429583701, 453, 1, 452, 0, 0, 0
636, 1, 1636429583361, 1636429583821, 460, 8, 452, 7, 0, 7
637, 1, 1636429583460, 1636429583912, 452, 1, 451, 0, 0, 0
638, 1, 1636429583589, 1636429584041, 452, 0, 452, 0, 0, 0
639, 1, 1636429583653, 1636429584117, 464, 9, 455, 9, 0, 9
640, 1, 1636429583805, 1636429584249, 444, 0, 444, 0, 0, 0
641, 1, 1636429583880, 1636429584325, 445, 1, 444, 0, 0, 0
642, 1, 1636429583889, 1636429584341, 452, 0, 452, 0, 0, 0
643, 1, 1636429583924, 1636429584372, 448, 1, 447, 0, 1, 1
644, 1, 1636429584044, 1636429584500, 456, 1, 455, 0, 0, 0
645, 1, 1636429584133, 1636429584592, 459, 0, 459, 0, 0, 0
646, 1, 1636429584265, 1636429584717, 452, 1, 451, 1, 0, 1
647, 1, 1636429584341, 1636429584797, 456, 0, 456, 0, 0, 0
648, 1, 1636429584473, 1636429584929, 456, 0, 456, 0, 0, 0
649, 1, 1636429584545, 1636429584997, 452, 0, 452, 0, 0, 0
652, 1, 1636429584592, 1636429585044, 452, 1, 451, 1, 0, 1
653, 1, 1636429584725, 1636429585185, 460, 0, 460, 0, 0, 0
654, 1, 1636429584813, 1636429585264, 451, 0, 451, 0, 0, 0
655, 1, 1636429584941, 1636429585389, 448, 0, 448, 0, 0, 0
656, 1, 1636429585024, 1636429585477, 453, 1, 452, 0, 0, 0
659, 1, 1636429585225, 1636429585676, 451, 0, 451, 0, 0, 0
660, 1, 1636429585260, 1636429585716, 456, 5, 451, 5, 0, 5
661, 1, 1636429585413, 1636429585873, 460, 0, 460, 0, 0, 0
662, 1, 1636429585489, 1636429585940, 451, 0, 451, 0, 0, 0
664, 1, 1636429585704, 1636429586153, 449, 1, 448, 0, 0, 0
666, 1, 1636429585900, 1636429586345, 445, 1, 444, 0, 0, 0
667, 1, 1636429585937, 1636429586401, 464, 4, 460, 4, 0, 4
669, 1, 1636429586165, 1636429586625, 460, 0, 460, 0, 0, 0
671, 1, 1636429586381, 1636429586833, 452, 0, 452, 0, 0, 0
673, 1, 1636429586625, 1636429587081, 456, 1, 455, 1, 0, 1
675, 1, 1636429586848, 1636429587301, 453, 1, 452, 0, 0, 0
678, 1, 1636429587304, 1636429587757, 453, 1, 452, 0, 0, 0
620, 2, 1636429582033, 1636429592036, 10003, 0, 10003, 980, 0, 980
630, 2, 1636429582984, 1636429592985, 10001, 0, 10001, 29, 0, 29
685, 1, 1636429593409, 1636429593865, 456, 1, 455, 0, 0, 0
686, 1, 1636429593413, 1636429594317, 904, 453, 451, 453, 0, 453
687, 1, 1636429594105, 1636429594561, 456, 0, 456, 0, 0, 0
650, 2, 1636429584564, 1636429594568, 10004, 0, 10004, 1, 0, 1
651, 2, 1636429584580, 1636429594617, 10037, 0, 10037, 0, 0, 0
688, 1, 1636429594557, 1636429595024, 467, 5, 462, 4, 0, 4
657, 2, 1636429585156, 1636429595157, 10001, 0, 10001, 0, 0, 0
658, 2, 1636429585201, 1636429595204, 10003, 0, 10003, 0, 0, 0
689, 1, 1636429594797, 1636429595249, 452, 0, 452, 0, 0, 0
691, 1, 1636429594948, 1636429595433, 485, 1, 484, 0, 0, 0
690, 1, 1636429594937, 1636429595433, 496, 0, 496, 0, 0, 0
663, 2, 1636429585613, 1636429595612, 9999, 0, 9999, 0, 0, 0
692, 1, 1636429595252, 1636429595704, 452, 1, 451, 0, 0, 0
665, 2, 1636429585729, 1636429595732, 10003, 0, 10003, 0, 0, 0
693, 1, 1636429595472, 1636429595953, 481, 0, 481, 0, 0, 0
694, 1, 1636429595525, 1636429596045, 520, 0, 520, 0, 0, 0
695, 1, 1636429595561, 1636429596056, 495, 0, 495, 0, 0, 0
668, 2, 1636429586097, 1636429596093, 9996, 0, 9996, 0, 0, 0
696, 1, 1636429595660, 1636429596132, 472, 1, 471, 0, 1, 1
697, 1, 1636429595700, 1636429596156, 456, 1, 455, 0, 0, 0
670, 2, 1636429586225, 1636429596224, 9999, 0, 9999, 0, 0, 0
698, 1, 1636429595916, 1636429596448, 532, 38, 494, 37, 0, 37
700, 1, 1636429596081, 1636429596536, 455, 0, 455, 0, 0, 0
699, 1, 1636429596000, 1636429596540, 540, 46, 494, 46, 0, 46
672, 2, 1636429586569, 1636429596568, 9999, 0, 9999, 0, 0, 0
701, 1, 1636429596180, 1636429596628, 448, 1, 447, 0, 1, 1
702, 1, 1636429596268, 1636429596717, 449, 1, 448, 0, 0, 0
674, 2, 1636429586737, 1636429596737, 10000, 0, 10000, 0, 0, 0
704, 1, 1636429596348, 1636429596788, 440, 1, 439, 0, 0, 0
703, 1, 1636429596312, 1636429596788, 476, 0, 476, 0, 0, 0
705, 1, 1636429596400, 1636429596885, 485, 1, 484, 0, 0, 0
706, 1, 1636429596452, 1636429596996, 544, 89, 455, 89, 0, 89
676, 2, 1636429587057, 1636429597057, 10000, 0, 10000, 0, 0, 0
707, 1, 1636429596612, 1636429597068, 456, 1, 455, 0, 0, 0
708, 1, 1636429596664, 1636429597140, 476, 1, 475, 0, 0, 0
677, 2, 1636429587213, 1636429597209, 9996, 0, 9996, 0, 0, 0
710, 1, 1636429596784, 1636429597285, 501, 5, 496, 5, 0, 5
709, 1, 1636429596784, 1636429597285, 501, 1, 500, 0, 0, 0
711, 1, 1636429596848, 1636429597297, 449, 1, 448, 0, 0, 0
713, 1, 1636429596936, 1636429597377, 441, 1, 440, 0, 1, 1
712, 1, 1636429596929, 1636429597465, 536, 68, 468, 68, 0, 68
714, 1, 1636429597008, 1636429597465, 457, 1, 456, 0, 0, 0
715, 1, 1636429597008, 1636429597468, 460, 1, 459, 1, 0, 1
679, 2, 1636429587525, 1636429597524, 9999, 0, 9999, 0, 0, 0
716, 1, 1636429597108, 1636429597556, 448, 0, 448, 0, 0, 0
717, 1, 1636429597144, 1636429597620, 476, 0, 476, 0, 0, 0
680, 2, 1636429587712, 1636429597712, 10000, 0, 10000, 0, 0, 0
718, 1, 1636429597256, 1636429597752, 496, 30, 466, 30, 0, 30
719, 1, 1636429597305, 1636429597752, 447, 0, 447, 0, 0, 0
720, 1, 1636429597389, 1636429597841, 452, 0, 452, 0, 0, 0
721, 1, 1636429597428, 1636429597936, 508, 38, 470, 37, 1, 38
722, 1, 1636429597508, 1636429597961, 453, 1, 452, 0, 1, 1
723, 1, 1636429597512, 1636429597964, 452, 1, 451, 0, 1, 1
724, 1, 1636429597516, 1636429597972, 456, 1, 455, 0, 0, 0
681, 2, 1636429587981, 1636429597980, 9999, 0, 9999, 0, 0, 0
725, 1, 1636429597572, 1636429598028, 456, 0, 456, 0, 0, 0
726, 1, 1636429597616, 1636429598064, 448, 0, 448, 0, 0, 0
728, 1, 1636429597704, 1636429598200, 496, 0, 496, 0, 0, 0
729, 1, 1636429597704, 1636429598209, 505, 0, 505, 0, 0, 0
727, 1, 1636429597704, 1636429598209, 505, 48, 457, 48, 0, 48
682, 2, 1636429588261, 1636429598260, 9999, 0, 9999, 0, 0, 0
731, 1, 1636429597841, 1636429598301, 460, 0, 460, 0, 0, 0
730, 1, 1636429597800, 1636429598301, 501, 0, 501, 0, 0, 0
732, 1, 1636429597896, 1636429598392, 496, 41, 455, 41, 0, 41
733, 1, 1636429597968, 1636429598417, 449, 1, 448, 0, 0, 0
734, 1, 1636429597972, 1636429598421, 449, 1, 448, 1, 0, 1
736, 1, 1636429598077, 1636429598580, 503, 0, 503, 0, 0, 0
735, 1, 1636429598077, 1636429598580, 503, 1, 502, 0, 0, 0
739, 1, 1636429598185, 1636429598676, 491, 0, 491, 0, 0, 0
737, 1, 1636429598160, 1636429598677, 517, 50, 467, 49, 0, 49
738, 1, 1636429598176, 1636429598677, 501, 34, 467, 33, 1, 34
683, 2, 1636429588677, 1636429598678, 10001, 0, 10001, 0, 0, 0
742, 1, 1636429598308, 1636429598760, 452, 1, 451, 0, 1, 1
741, 1, 1636429598316, 1636429598764, 448, 1, 447, 0, 1, 1
743, 1, 1636429598352, 1636429598848, 496, 41, 455, 41, 0, 41
746, 1, 1636429598436, 1636429598901, 465, 2, 463, 0, 0, 0
745, 1, 1636429598444, 1636429598904, 460, 1, 459, 0, 0, 0
744, 1, 1636429598436, 1636429598908, 472, 1, 471, 0, 0, 0
748, 1, 1636429598520, 1636429598996, 476, 1, 475, 1, 0, 1
747, 1, 1636429598520, 1636429598996, 476, 1, 475, 0, 0, 0
750, 1, 1636429598632, 1636429599096, 464, 1, 463, 0, 1, 1
751, 1, 1636429598645, 1636429599128, 483, 34, 449, 34, 0, 34
749, 1, 1636429598612, 1636429599136, 524, 66, 458, 66, 0, 66
752, 1, 1636429598645, 1636429599136, 491, 34, 457, 33, 1, 34
684, 2, 1636429589141, 1636429599140, 9999, 0, 9999, 0, 0, 0
754, 1, 1636429598816, 1636429599268, 452, 0, 452, 0, 0, 0
757, 1, 1636429598901, 1636429599364, 463, 8, 455, 8, 0, 8
756, 1, 1636429598901, 1636429599368, 467, 1, 466, 0, 0, 0
755, 1, 1636429598901, 1636429599372, 471, 1, 470, 1, 0, 1
759, 1, 1636429598984, 1636429599460, 476, 12, 464, 12, 0, 12
758, 1, 1636429598980, 1636429599461, 481, 1, 480, 0, 1, 1
760, 1, 1636429599044, 1636429599556, 512, 53, 459, 53, 0, 53
762, 1, 1636429599124, 1636429599576, 452, 0, 452, 0, 0, 0
764, 1, 1636429599128, 1636429599588, 460, 9, 451, 9, 0, 9
761, 1, 1636429599068, 1636429599596, 528, 69, 459, 69, 0, 69
766, 1, 1636429599236, 1636429599696, 460, 1, 459, 0, 0, 0
765, 1, 1636429599236, 1636429599696, 460, 1, 459, 0, 0, 0
767, 1, 1636429599332, 1636429599768, 436, 1, 435, 0, 0, 0
770, 1, 1636429599360, 1636429599808, 448, 5, 443, 5, 0, 5
769, 1, 1636429599360, 1636429599824, 464, 9, 455, 9, 0, 9
768, 1, 1636429599344, 1636429599832, 488, 29, 459, 29, 0, 29
771, 1, 1636429599492, 1636429599944, 452, 1, 451, 0, 0, 0
775, 1, 1636429599588, 1636429600032, 444, 1, 443, 1, 0, 1
774, 1, 1636429599588, 1636429600032, 444, 1, 443, 1, 0, 1
773, 1, 1636429599584, 1636429600040, 456, 5, 451, 5, 0, 5
776, 1, 1636429599680, 1636429600149, 469, 17, 452, 16, 0, 16
778, 1, 1636429599788, 1636429600240, 452, 1, 451, 0, 1, 1
779, 1, 1636429599796, 1636429600241, 445, 1, 444, 1, 0, 1
781, 1, 1636429599808, 1636429600264, 456, 2, 454, 1, 0, 1
780, 1, 1636429599804, 1636429600272, 468, 21, 447, 21, 0, 21
782, 1, 1636429599925, 1636429600369, 444, 0, 444, 0, 0, 0
784, 1, 1636429599984, 1636429600424, 440, 1, 439, 0, 1, 1
785, 1, 1636429600028, 1636429600484, 456, 13, 443, 13, 0, 13
787, 1, 1636429600053, 1636429600500, 447, 0, 447, 0, 0, 0
786, 1, 1636429600044, 1636429600500, 456, 0, 456, 0, 0, 0
788, 1, 1636429600160, 1636429600609, 449, 1, 448, 0, 0, 0
789, 1, 1636429600256, 1636429600696, 440, 1, 439, 0, 0, 0
791, 1, 1636429600264, 1636429600721, 457, 8, 449, 8, 0, 8
792, 1, 1636429600369, 1636429600821, 452, 0, 452, 0, 0, 0
794, 1, 1636429600456, 1636429600913, 457, 1, 456, 0, 0, 0
795, 1, 1636429600484, 1636429600940, 456, 1, 455, 1, 0, 1
796, 1, 1636429600492, 1636429600960, 468, 10, 458, 9, 0, 9
797, 1, 1636429600588, 1636429601044, 456, 1, 455, 0, 0, 0
798, 1, 1636429600644, 1636429601096, 452, 1, 451, 0, 0, 0
800, 1, 1636429600713, 1636429601168, 455, 0, 455, 0, 0, 0
799, 1, 1636429600700, 1636429601176, 476, 22, 454, 21, 0, 21
802, 1, 1636429600832, 1636429601280, 448, 1, 447, 0, 0, 0
804, 1, 1636429600940, 1636429601417, 477, 22, 455, 20, 1, 21
805, 1, 1636429601048, 1636429601489, 441, 1, 440, 0, 0, 0
806, 1, 1636429601133, 1636429601581, 448, 0, 448, 0, 0, 0
807, 1, 1636429601157, 1636429601620, 463, 20, 443, 20, 0, 20
809, 1, 1636429601272, 1636429601717, 445, 1, 444, 1, 0, 1
810, 1, 1636429601316, 1636429601756, 440, 1, 439, 0, 0, 0
812, 1, 1636429601396, 1636429601869, 473, 22, 451, 21, 1, 22
813, 1, 1636429601496, 1636429601949, 453, 1, 452, 0, 0, 0
815, 1, 1636429601713, 1636429602164, 451, 5, 446, 5, 0, 5
816, 1, 1636429601800, 1636429602253, 453, 1, 452, 0, 0, 0
817, 1, 1636429601844, 1636429602321, 477, 26, 451, 26, 0, 26
819, 1, 1636429601977, 1636429602428, 451, 0, 451, 0, 0, 0
821, 1, 1636429602176, 1636429602628, 452, 1, 451, 0, 0, 0
823, 1, 1636429602472, 1636429602925, 453, 1, 452, 1, 0, 1
825, 1, 1636429602649, 1636429603105, 456, 0, 456, 0, 0, 0
827, 1, 1636429603145, 1636429603601, 456, 0, 456, 0, 0, 0
740, 2, 1636429598193, 1636429608192, 9999, 0, 9999, 0, 0, 0
753, 2, 1636429598808, 1636429608812, 10004, 0, 10004, 1, 0, 1
830, 1, 1636429608505, 1636429608961, 456, 0, 456, 0, 0, 0
763, 2, 1636429599128, 1636429609129, 10001, 0, 10001, 429, 0, 429
772, 2, 1636429599504, 1636429609509, 10005, 0, 10005, 52, 0, 52
831, 1, 1636429609125, 1636429609580, 455, 0, 455, 0, 0, 0
832, 1, 1636429609221, 1636429609677, 456, 0, 456, 0, 0, 0
777, 2, 1636429599680, 1636429609688, 10008, 0, 10008, 0, 0, 0
783, 2, 1636429599925, 1636429609924, 9999, 0, 9999, 0, 0, 0
833, 1, 1636429609801, 1636429610257, 456, 0, 456, 0, 0, 0
790, 2, 1636429600256, 1636429610257, 10001, 0, 10001, 0, 0, 0
834, 1, 1636429609869, 1636429610332, 463, 1, 462, 0, 0, 0
835, 1, 1636429609869, 1636429610332, 463, 1, 462, 0, 0, 0
836, 1, 1636429609900, 1636429610348, 448, 1, 447, 0, 0, 0
793, 2, 1636429600460, 1636429610464, 10004, 0, 10004, 0, 0, 0
838, 1, 1636429610236, 1636429610684, 448, 1, 447, 0, 0, 0
801, 2, 1636429600724, 1636429610724, 10000, 0, 10000, 0, 0, 0
837, 1, 1636429610012, 1636429610785, 773, 321, 452, 321, 0, 321
803, 2, 1636429600916, 1636429610920, 10004, 0, 10004, 0, 0, 0
839, 1, 1636429610508, 1636429610956, 448, 1, 447, 0, 1, 1
842, 1, 1636429610569, 1636429611041, 472, 1, 471, 1, 0, 1
840, 1, 1636429610552, 1636429611041, 489, 1, 488, 0, 0, 0
843, 1, 1636429610569, 1636429611041, 472, 1, 471, 0, 0, 0
808, 2, 1636429601176, 1636429611180, 10004, 0, 10004, 0, 0, 0
841, 1, 1636429610569, 1636429611237, 668, 217, 451, 217, 0, 217
844, 1, 1636429610772, 1636429611237, 465, 0, 465, 0, 0, 0
811, 2, 1636429601381, 1636429611384, 10003, 0, 10003, 0, 0, 0
845, 1, 1636429610905, 1636429611404, 499, 0, 499, 0, 0, 0
846, 1, 1636429611012, 1636429611496, 484, 29, 455, 29, 0, 29
848, 1, 1636429611172, 1636429611629, 457, 1, 456, 1, 0, 1
814, 2, 1636429601644, 1636429611640, 9996, 0, 9996, 0, 0, 0
849, 1, 1636429611228, 1636429611701, 473, 9, 464, 9, 0, 9
847, 1, 1636429611028, 1636429611704, 676, 209, 467, 209, 0, 209
850, 1, 1636429611272, 1636429611729, 457, 1, 456, 1, 0, 1
852, 1, 1636429611272, 1636429611729, 457, 2, 455, 1, 0, 1
818, 2, 1636429601940, 1636429611940, 10000, 0, 10000, 0, 0, 0
854, 1, 1636429611477, 1636429611960, 483, 0, 483, 0, 0, 0
853, 1, 1636429611476, 1636429611960, 484, 21, 463, 20, 0, 20
856, 1, 1636429611629, 1636429612084, 455, 0, 455, 0, 0, 0
820, 2, 1636429602093, 1636429612092, 9999, 0, 9999, 0, 0, 0
857, 1, 1636429611688, 1636429612164, 476, 14, 462, 13, 0, 13
855, 1, 1636429611484, 1636429612165, 681, 221, 460, 220, 1, 221
859, 1, 1636429611852, 1636429612348, 496, 1, 495, 0, 0, 0
822, 2, 1636429602388, 1636429612388, 10000, 0, 10000, 0, 0, 0
860, 1, 1636429611924, 1636429612412, 488, 37, 451, 37, 0, 37
861, 1, 1636429611924, 1636429612416, 492, 37, 455, 37, 0, 37
862, 1, 1636429611988, 1636429612437, 449, 1, 448, 1, 0, 1
863, 1, 1636429611988, 1636429612436, 448, 1, 447, 0, 0, 0
824, 1, 1636429602545, 1636429612544, 9999, 9548, 451, 0, 9548, 9548
864, 1, 1636429611988, 1636429612612, 624, 178, 446, 178, 0, 178
865, 1, 1636429612184, 1636429612641, 457, 1, 456, 0, 0, 0
867, 1, 1636429612269, 1636429612720, 451, 0, 451, 0, 0, 0
868, 1, 1636429612308, 1636429612797, 489, 1, 488, 1, 0, 1
826, 2, 1636429602853, 1636429612853, 10000, 0, 10000, 0, 0, 0
870, 1, 1636429612385, 1636429612864, 479, 28, 451, 28, 0, 28
869, 1, 1636429612385, 1636429612864, 479, 32, 447, 32, 0, 32
872, 1, 1636429612564, 1636429613013, 449, 1, 448, 0, 0, 0
871, 1, 1636429612436, 1636429613077, 641, 178, 463, 177, 0, 177
874, 1, 1636429612633, 1636429613093, 460, 9, 451, 8, 1, 9
875, 1, 1636429612656, 1636429613109, 453, 1, 452, 0, 0, 0
877, 1, 1636429612688, 1636429613169, 481, 33, 448, 33, 0, 33
876, 1, 1636429612664, 1636429613169, 505, 1, 504, 0, 0, 0
879, 1, 1636429612836, 1636429613316, 480, 29, 451, 29, 0, 29
828, 2, 1636429603329, 1636429613324, 9995, 0, 9995, 0, 0, 0
880, 1, 1636429612900, 1636429613356, 456, 1, 455, 0, 0, 0
881, 1, 1636429612945, 1636429613396, 451, 0, 451, 0, 0, 0
882, 1, 1636429613040, 1636429613501, 461, 0, 461, 0, 0, 0
884, 1, 1636429613084, 1636429613548, 464, 10, 454, 9, 1, 10
878, 1, 1636429612760, 1636429613548, 788, 318, 470, 317, 0, 317
885, 1, 1636429613168, 1636429613644, 476, 2, 474, 1, 0, 1
886, 1, 1636429613241, 1636429613737, 496, 0, 496, 0, 0, 0
887, 1, 1636429613296, 1636429613764, 468, 21, 447, 21, 0, 21
888, 1, 1636429613312, 1636429613805, 493, 46, 447, 45, 1, 46
829, 2, 1636429603829, 1636429613825, 9996, 0, 9996, 0, 0, 0
890, 1, 1636429613420, 1636429613881, 461, 1, 460, 0, 0, 0
891, 1, 1636429613420, 1636429613881, 461, 1, 460, 0, 0, 0
889, 1, 1636429613372, 1636429614049, 677, 178, 499, 177, 1, 178
893, 1, 1636429613576, 1636429614052, 476, 1, 475, 0, 0, 0
894, 1, 1636429613616, 1636429614072, 456, 1, 455, 0, 0, 0
895, 1, 1636429613640, 1636429614149, 509, 5, 504, 5, 0, 5
896, 1, 1636429613728, 1636429614177, 449, 0, 449, 0, 0, 0
897, 1, 1636429613768, 1636429614233, 465, 0, 465, 0, 0, 0
898, 1, 1636429613764, 1636429614248, 484, 42, 442, 42, 0, 42
899, 1, 1636429613873, 1636429614325, 452, 9, 443, 9, 0, 9
902, 1, 1636429614028, 1636429614496, 468, 25, 443, 25, 0, 25
901, 1, 1636429614004, 1636429614500, 496, 46, 450, 45, 1, 46
903, 1, 1636429614108, 1636429614556, 448, 1, 447, 1, 0, 1
905, 1, 1636429614132, 1636429614604, 472, 18, 454, 18, 0, 18
906, 1, 1636429614269, 1636429614724, 455, 0, 455, 0, 0, 0
907, 1, 1636429614269, 1636429614724, 455, 0, 455, 0, 0, 0
908, 1, 1636429614293, 1636429614744, 451, 0, 451, 0, 0, 0
909, 1, 1636429614368, 1636429614812, 444, 1, 443, 0, 0, 0
910, 1, 1636429614401, 1636429614849, 448, 0, 448, 0, 0, 0
912, 1, 1636429614464, 1636429614949, 485, 33, 452, 33, 0, 33
913, 1, 1636429614553, 1636429615012, 459, 4, 455, 4, 0, 4
914, 1, 1636429614716, 1636429615185, 469, 9, 460, 9, 0, 9
915, 1, 1636429614720, 1636429615185, 465, 6, 459, 5, 0, 5
916, 1, 1636429614780, 1636429615232, 452, 1, 451, 0, 0, 0
917, 1, 1636429614820, 1636429615269, 449, 1, 448, 0, 1, 1
918, 1, 1636429614949, 1636429615405, 456, 0, 456, 0, 0, 0
920, 1, 1636429614964, 1636429615408, 444, 1, 443, 0, 1, 1
921, 1, 1636429615028, 1636429615480, 452, 0, 452, 0, 0, 0
922, 1, 1636429615072, 1636429615520, 448, 1, 447, 0, 1, 1
923, 1, 1636429615168, 1636429615633, 465, 18, 447, 17, 0, 17
924, 1, 1636429615232, 1636429615684, 452, 0, 452, 0, 0, 0
925, 1, 1636429615408, 1636429615865, 457, 1, 456, 1, 0, 1
927, 1, 1636429615448, 1636429615892, 444, 0, 444, 0, 0, 0
928, 1, 1636429615488, 1636429615936, 448, 1, 447, 0, 0, 0
929, 1, 1636429615624, 1636429616068, 444, 1, 443, 0, 0, 0
930, 1, 1636429615632, 1636429616085, 453, 2, 451, 0, 1, 1
931, 1, 1636429615700, 1636429616145, 445, 1, 444, 0, 1, 1
932, 1, 1636429615741, 1636429616200, 459, 0, 459, 0, 0, 0
933, 1, 1636429615856, 1636429616316, 460, 10, 450, 9, 0, 9
934, 1, 1636429615912, 1636429616369, 457, 1, 456, 1, 0, 1
935, 1, 1636429616085, 1636429616548, 463, 0, 463, 0, 0, 0
936, 1, 1636429616112, 1636429616560, 448, 0, 448, 0, 0, 0
937, 1, 1636429616153, 1636429616596, 443, 0, 443, 0, 0, 0
938, 1, 1636429616288, 1636429616737, 449, 1, 448, 0, 0, 0
939, 1, 1636429616308, 1636429616768, 460, 9, 451, 8, 0, 8
940, 1, 1636429616360, 1636429616816, 456, 9, 447, 9, 0, 9
942, 1, 1636429616532, 1636429616996, 464, 17, 447, 17, 0, 17
943, 1, 1636429616592, 1636429617037, 445, 1, 444, 1, 0, 1
944, 1, 1636429616768, 1636429617217, 449, 1, 448, 1, 0, 1
945, 1, 1636429616788, 1636429617244, 456, 1, 455, 0, 0, 0
946, 1, 1636429616812, 1636429617272, 460, 5, 455, 5, 0, 5
948, 1, 1636429616988, 1636429617441, 453, 9, 444, 8, 0, 8
949, 1, 1636429617033, 1636429617488, 455, 4, 451, 4, 0, 4
950, 1, 1636429617212, 1636429617672, 460, 5, 455, 5, 0, 5
951, 1, 1636429617257, 1636429617704, 447, 0, 447, 0, 0, 0
953, 1, 1636429617465, 1636429617921, 456, 0, 456, 0, 0, 0
954, 1, 1636429617492, 1636429617940, 448, 1, 447, 1, 0, 1
955, 1, 1636429617660, 1636429618120, 460, 13, 447, 13, 0, 13
956, 1, 1636429617708, 1636429618161, 453, 1, 452, 0, 0, 0
958, 1, 1636429617925, 1636429618376, 451, 0, 451, 0, 0, 0
959, 1, 1636429618144, 1636429618597, 453, 1, 452, 0, 0, 0
960, 1, 1636429618164, 1636429618612, 448, 0, 448, 0, 0, 0
962, 1, 1636429618381, 1636429618828, 447, 0, 447, 0, 0, 0
963, 1, 1636429618597, 1636429619053, 456, 1, 455, 0, 1, 1
965, 1, 1636429618836, 1636429619284, 448, 1, 447, 1, 0, 1
966, 1, 1636429619048, 1636429619508, 460, 5, 455, 4, 0, 4
968, 1, 1636429619508, 1636429619960, 452, 1, 451, 1, 0, 1
851, 2, 1636429611272, 1636429621273, 10001, 0, 10001, 1, 0, 1
858, 2, 1636429611732, 1636429621733, 10001, 0, 10001, 0, 0, 0
971, 1, 1636429621589, 1636429622053, 464, 0, 464, 0, 0, 0
866, 2, 1636429612184, 1636429622185, 10001, 0, 10001, 0, 0, 0
972, 1, 1636429622040, 1636429622501, 461, 13, 448, 12, 0, 12
873, 2, 1636429612633, 1636429622633, 10000, 0, 10000, 0, 0, 0
973, 1, 1636429622273, 1636429622725, 452, 0, 452, 0, 0, 0
974, 1, 1636429622497, 1636429622961, 464, 4, 460, 4, 0, 4
883, 2, 1636429613084, 1636429623081, 9997, 0, 9997, 0, 0, 0
975, 1, 1636429622725, 1636429623176, 451, 1, 450, 1, 0, 1
977, 1, 1636429622948, 1636429623397, 449, 1, 448, 0, 0, 0
976, 1, 1636429622945, 1636429623412, 467, 16, 451, 16, 0, 16
892, 2, 1636429613540, 1636429623541, 10001, 0, 10001, 1, 0, 1
978, 1, 1636429623184, 1636429623640, 456, 1, 455, 0, 0, 0
979, 1, 1636429623401, 1636429623861, 460, 0, 460, 0, 0, 0
980, 1, 1636429623401, 1636429623864, 463, 12, 451, 12, 0, 12
900, 2, 1636429614001, 1636429624004, 10003, 0, 10003, 0, 0, 0
981, 1, 1636429623633, 1636429624088, 455, 0, 455, 0, 0, 0
982, 1, 1636429623633, 1636429624100, 467, 8, 459, 8, 0, 8
904, 2, 1636429614108, 1636429624108, 10000, 0, 10000, 1, 0, 1
983, 1, 1636429623853, 1636429624328, 475, 12, 463, 12, 0, 12
984, 1, 1636429623860, 1636429624332, 472, 1, 471, 0, 0, 0
911, 2, 1636429614452, 1636429624452, 10000, 0, 10000, 0, 0, 0
985, 1, 1636429624092, 1636429624536, 444, 1, 443, 0, 0, 0
986, 1, 1636429624092, 1636429624536, 444, 9, 435, 9, 0, 9
987, 1, 1636429624305, 1636429624764, 459, 0, 459, 0, 0, 0
989, 1, 1636429624324, 1636429624780, 456, 9, 447, 9, 0, 9
988, 1, 1636429624312, 1636429624784, 472, 17, 455, 17, 0, 17
990, 1, 1636429624420, 1636429624873, 453, 0, 453, 0, 0, 0
919, 2, 1636429614948, 1636429624949, 10001, 0, 10001, 0, 0, 0
991, 1, 1636429624544, 1636429624993, 449, 0, 449, 0, 0, 0
992, 1, 1636429624552, 1636429625004, 452, 1, 451, 0, 0, 0
993, 1, 1636429624756, 1636429625213, 457, 9, 448, 8, 0, 8
995, 1, 1636429624764, 1636429625268, 504, 21, 483, 21, 0, 21
994, 1, 1636429624756, 1636429625272, 516, 25, 491, 25, 0, 25
926, 2, 1636429615408, 1636429625405, 9997, 0, 9997, 1, 0, 1
996, 1, 1636429624996, 1636429625452, 456, 1, 455, 0, 0, 0
997, 1, 1636429624996, 1636429625460, 464, 9, 455, 9, 0, 9
998, 1, 1636429625036, 1636429625489, 453, 1, 452, 1, 0, 1
999, 1, 1636429625129, 1636429625576, 447, 0, 447, 0, 0, 0
1002, 1, 1636429625256, 1636429625712, 456, 13, 443, 13, 0, 13
1001, 1, 1636429625236, 1636429625716, 480, 1, 479, 0, 1, 1
1000, 1, 1636429625213, 1636429625720, 507, 60, 447, 60, 0, 60
1003, 1, 1636429625452, 1636429625897, 445, 1, 444, 1, 0, 1
1005, 1, 1636429625496, 1636429625944, 448, 1, 447, 0, 0, 0
1004, 1, 1636429625496, 1636429625944, 448, 1, 447, 1, 0, 1
1006, 1, 1636429625668, 1636429626113, 445, 0, 445, 0, 0, 0
1009, 1, 1636429625716, 1636429626165, 449, 1, 448, 0, 1, 1
1008, 1, 1636429625708, 1636429626165, 457, 13, 444, 12, 0, 12
1007, 1, 1636429625676, 1636429626168, 492, 41, 451, 41, 0, 41
1010, 1, 1636429625797, 1636429626245, 448, 0, 448, 0, 0, 0
1012, 1, 1636429625936, 1636429626380, 444, 1, 443, 0, 0, 0
1011, 1, 1636429625932, 1636429626384, 452, 13, 439, 13, 0, 13
1013, 1, 1636429625936, 1636429626388, 452, 9, 443, 8, 0, 8
941, 2, 1636429616416, 1636429626420, 10004, 0, 10004, 0, 0, 0
1014, 1, 1636429626124, 1636429626572, 448, 1, 447, 0, 0, 0
1016, 1, 1636429626165, 1636429626648, 483, 4, 479, 4, 0, 4
1017, 1, 1636429626332, 1636429626833, 501, 1, 500, 0, 0, 0
1019, 1, 1636429626392, 1636429626836, 444, 1, 443, 0, 1, 1
1018, 1, 1636429626388, 1636429626840, 452, 1, 451, 0, 0, 0
1020, 1, 1636429626392, 1636429626849, 457, 1, 456, 0, 0, 0
1021, 1, 1636429626468, 1636429626916, 448, 0, 448, 0, 0, 0
947, 2, 1636429616960, 1636429626960, 10000, 0, 10000, 0, 0, 0
1023, 1, 1636429626597, 1636429627044, 447, 0, 447, 0, 0, 0
1022, 1, 1636429626597, 1636429627044, 447, 0, 447, 0, 0, 0
1024, 1, 1636429626608, 1636429627092, 484, 41, 443, 41, 0, 41
1025, 1, 1636429626724, 1636429627188, 464, 1, 463, 0, 0, 0
1026, 1, 1636429626792, 1636429627284, 492, 41, 451, 41, 0, 41
1027, 1, 1636429626869, 1636429627312, 443, 0, 443, 0, 0, 0
952, 2, 1636429617441, 1636429627441, 10000, 0, 10000, 0, 0, 0
1015, 1, 1636429626165, 1636429627492, 1327, 879, 448, 879, 0, 879
1028, 1, 1636429627052, 1636429627505, 453, 0, 453, 0, 0, 0
1030, 1, 1636429627060, 1636429627513, 453, 0, 453, 0, 0, 0
1029, 1, 1636429627052, 1636429627533, 481, 40, 441, 40, 0, 40
1032, 1, 1636429627136, 1636429627584, 448, 0, 448, 0, 0, 0
1033, 1, 1636429627268, 1636429627752, 484, 17, 467, 17, 0, 17
1035, 1, 1636429627268, 1636429627760, 492, 0, 492, 0, 0, 0
1036, 1, 1636429627312, 1636429627760, 448, 1, 447, 1, 0, 1
1034, 1, 1636429627268, 1636429627764, 496, 0, 496, 0, 0, 0
1037, 1, 1636429627409, 1636429627860, 451, 0, 451, 0, 0, 0
957, 2, 1636429617889, 1636429627888, 9999, 0, 9999, 0, 0, 0
1031, 1, 1636429627068, 1636429627940, 872, 425, 447, 425, 0, 425
1038, 1, 1636429627532, 1636429627988, 456, 1, 455, 0, 0, 0
1039, 1, 1636429627532, 1636429627988, 456, 1, 455, 0, 0, 0
1042, 1, 1636429627736, 1636429628205, 469, 17, 452, 16, 0, 16
1044, 1, 1636429627756, 1636429628208, 452, 5, 447, 5, 0, 5
1040, 1, 1636429627709, 1636429628216, 507, 56, 451, 56, 0, 56
1043, 1, 1636429627749, 1636429628216, 467, 12, 455, 12, 0, 12
1045, 1, 1636429627804, 1636429628296, 492, 1, 491, 0, 0, 0
961, 2, 1636429618340, 1636429628337, 9997, 0, 9997, 0, 0, 0
1041, 1, 1636429627728, 1636429628388, 660, 213, 447, 213, 0, 213
1048, 1, 1636429627980, 1636429628432, 452, 1, 451, 0, 0, 0
1047, 1, 1636429627980, 1636429628432, 452, 1, 451, 1, 0, 1
1046, 1, 1636429627980, 1636429628437, 457, 9, 448, 8, 0, 8
1049, 1, 1636429627980, 1636429628437, 457, 9, 448, 9, 0, 9
1054, 1, 1636429628208, 1636429628656, 448, 1, 447, 0, 0, 0
1051, 1, 1636429628161, 1636429628660, 499, 56, 443, 56, 0, 56
1052, 1, 1636429628201, 1636429628668, 467, 16, 451, 16, 0, 16
964, 2, 1636429618820, 1636429628821, 10001, 0, 10001, 1, 0, 1
1053, 1, 1636429628204, 1636429628832, 628, 185, 443, 184, 0, 184
1058, 1, 1636429628436, 1636429628889, 453, 2, 451, 1, 0, 1
1057, 1, 1636429628436, 1636429628889, 453, 1, 452, 0, 1, 1
1055, 1, 1636429628429, 1636429628892, 463, 9, 454, 8, 1, 9
1056, 1, 1636429628429, 1636429628892, 463, 9, 454, 9, 0, 9
1059, 1, 1636429628516, 1636429628968, 452, 1, 451, 0, 0, 0
1060, 1, 1636429628608, 1636429629056, 448, 0, 448, 0, 0, 0
1061, 1, 1636429628648, 1636429629140, 492, 21, 471, 21, 0, 21
1062, 1, 1636429628652, 1636429629144, 492, 1, 491, 0, 0, 0
1064, 1, 1636429628660, 1636429629144, 484, 1, 483, 0, 0, 0
967, 2, 1636429619277, 1636429629273, 9996, 0, 9996, 0, 0, 0
1066, 1, 1636429628876, 1636429629348, 472, 17, 455, 17, 0, 17
1068, 1, 1636429628913, 1636429629364, 451, 0, 451, 0, 0, 0
1067, 1, 1636429628913, 1636429629372, 459, 0, 459, 0, 0, 0
1069, 1, 1636429629052, 1636429629508, 456, 4, 452, 4, 0, 4
1074, 1, 1636429629128, 1636429629584, 456, 13, 443, 13, 0, 13
1070, 1, 1636429629104, 1636429629592, 488, 41, 447, 41, 0, 41
1073, 1, 1636429629120, 1636429629609, 489, 25, 464, 25, 0, 25
1075, 1, 1636429629188, 1636429629681, 493, 1, 492, 0, 0, 0
969, 2, 1636429619728, 1636429629729, 10001, 0, 10001, 0, 0, 0
1076, 1, 1636429629320, 1636429629769, 449, 0, 449, 0, 0, 0
1078, 1, 1636429629364, 1636429629812, 448, 1, 447, 1, 0, 1
1077, 1, 1636429629360, 1636429629813, 453, 5, 448, 5, 0, 5
1079, 1, 1636429629364, 1636429629836, 472, 1, 471, 0, 1, 1
1083, 1, 1636429629600, 1636429630044, 444, 1, 443, 0, 0, 0
1082, 1, 1636429629584, 1636429630044, 460, 1, 459, 1, 0, 1
970, 1, 1636429620181, 1636429630177, 9996, 9548, 448, 0, 9548, 9548
1084, 1, 1636429629776, 1636429630221, 445, 0, 445, 0, 0, 0
1085, 1, 1636429629820, 1636429630269, 449, 1, 448, 1, 0, 1
1087, 1, 1636429629824, 1636429630269, 445, 0, 445, 0, 0, 0
1086, 1, 1636429629820, 1636429630293, 473, 17, 456, 17, 0, 17
1088, 1, 1636429629904, 1636429630349, 445, 1, 444, 0, 0, 0
1089, 1, 1636429629988, 1636429630437, 449, 1, 448, 0, 0, 0
1091, 1, 1636429630036, 1636429630493, 457, 9, 448, 9, 0, 9
1093, 1, 1636429630052, 1636429630504, 452, 1, 451, 0, 0, 0
1094, 1, 1636429630264, 1636429630720, 456, 6, 450, 5, 0, 5
1095, 1, 1636429630268, 1636429630744, 476, 25, 451, 24, 0, 24
1097, 1, 1636429630440, 1636429630889, 449, 1, 448, 0, 0, 0
1096, 1, 1636429630396, 1636429630937, 541, 98, 443, 97, 1, 98
1100, 1, 1636429630516, 1636429630964, 448, 1, 447, 0, 1, 1
1101, 1, 1636429630573, 1636429631016, 443, 0, 443, 0, 0, 0
1102, 1, 1636429630660, 1636429631108, 448, 1, 447, 0, 0, 0
1104, 1, 1636429630720, 1636429631169, 449, 1, 448, 0, 1, 1
1103, 1, 1636429630716, 1636429631169, 453, 5, 448, 5, 0, 5
1106, 1, 1636429630960, 1636429631413, 453, 4, 449, 4, 0, 4
1107, 1, 1636429631112, 1636429631561, 449, 0, 449, 0, 0, 0
1109, 1, 1636429631181, 1636429631633, 452, 0, 452, 0, 0, 0
1108, 1, 1636429631152, 1636429631633, 481, 18, 463, 18, 0, 18
1110, 1, 1636429631237, 1636429631689, 452, 0, 452, 0, 0, 0
1111, 1, 1636429631324, 1636429631777, 453, 1, 452, 1, 0, 1
1114, 1, 1636429631636, 1636429632084, 448, 1, 447, 0, 0, 0
1115, 1, 1636429631784, 1636429632232, 448, 1, 447, 0, 0, 0
1118, 1, 1636429631913, 1636429632373, 460, 0, 460, 0, 0, 0
1119, 1, 1636429631996, 1636429632445, 449, 1, 448, 0, 1, 1
1121, 1, 1636429632453, 1636429632917, 464, 0, 464, 0, 0, 0
1123, 1, 1636429632668, 1636429633121, 453, 1, 452, 0, 0, 0
1124, 1, 1636429633140, 1636429633593, 453, 1, 452, 0, 0, 0
1125, 1, 1636429633345, 1636429633797, 452, 0, 452, 0, 0, 0
1126, 1, 1636429633817, 1636429634273, 456, 0, 456, 0, 0, 0
1127, 1, 1636429634017, 1636429634473, 456, 0, 456, 0, 0, 0
1128, 1, 1636429634497, 1636429634953, 456, 0, 456, 0, 0, 0
1129, 1, 1636429634697, 1636429635153, 456, 0, 456, 0, 0, 0
1130, 1, 1636429635176, 1636429635629, 453, 0, 453, 0, 0, 0
1131, 1, 1636429635377, 1636429635829, 452, 0, 452, 0, 0, 0
1132, 1, 1636429635853, 1636429636309, 456, 0, 456, 0, 0, 0
1133, 1, 1636429636053, 1636429636509, 456, 0, 456, 0, 0, 0
1134, 1, 1636429636533, 1636429636981, 448, 0, 448, 0, 0, 0
1135, 1, 1636429636733, 1636429637184, 451, 0, 451, 0, 0, 0
1136, 1, 1636429637205, 1636429637665, 460, 0, 460, 0, 0, 0
1137, 1, 1636429637401, 1636429637853, 452, 0, 452, 0, 0, 0
1050, 2, 1636429628080, 1636429638085, 10005, 0, 10005, 752, 0, 752
1138, 1, 1636429637889, 1636429638345, 456, 0, 456, 0, 0, 0
1139, 1, 1636429638077, 1636429638533, 456, 0, 456, 0, 0, 0
1063, 2, 1636429628656, 1636429638657, 10001, 0, 10001, 177, 0, 177
1065, 2, 1636429628660, 1636429638705, 10045, 0, 10045, 173, 0, 173
1140, 1, 1636429638569, 1636429639113, 544, 0, 544, 0, 0, 0
1071, 2, 1636429629112, 1636429639113, 10001, 0, 10001, 1, 0, 1
1072, 2, 1636429629112, 1636429639160, 10048, 0, 10048, 0, 0, 0
1141, 1, 1636429638753, 1636429639201, 448, 0, 448, 0, 0, 0
1080, 2, 1636429629560, 1636429639564, 10004, 0, 10004, 0, 0, 0
1081, 2, 1636429629584, 1636429639609, 10025, 0, 10025, 1, 0, 1
1142, 1, 1636429639204, 1636429639657, 453, 1, 452, 0, 0, 0
1143, 1, 1636429639204, 1636429639660, 456, 1, 455, 0, 0, 0
1145, 1, 1636429639341, 1636429639833, 492, 0, 492, 0, 0, 0
1146, 1, 1636429639420, 1636429639924, 504, 1, 503, 0, 0, 0
1090, 2, 1636429630032, 1636429640033, 10001, 0, 10001, 0, 0, 0
1092, 2, 1636429630036, 1636429640080, 10044, 0, 10044, 0, 0, 0
1147, 1, 1636429639428, 1636429640121, 693, 233, 460, 233, 0, 233
1151, 1, 1636429639877, 1636429640392, 515, 0, 515, 0, 0, 0
1150, 1, 1636429639877, 1636429640396, 519, 0, 519, 0, 0, 0
1099, 2, 1636429630496, 1636429640497, 10001, 0, 10001, 1, 0, 1
1098, 2, 1636429630496, 1636429640544, 10048, 0, 10048, 0, 0, 0
1153, 1, 1636429640128, 1636429640572, 444, 0, 444, 0, 0, 0
1149, 1, 1636429639872, 1636429640576, 704, 249, 455, 249, 0, 249
1154, 1, 1636429640176, 1636429640616, 440, 1, 439, 0, 1, 1
1155, 1, 1636429640345, 1636429640864, 519, 48, 471, 48, 0, 48
1105, 2, 1636429630936, 1636429640940, 10004, 0, 10004, 1, 0, 1
1156, 1, 1636429640345, 1636429641028, 683, 232, 451, 232, 0, 232
1158, 1, 1636429640637, 1636429641089, 452, 0, 452, 0, 0, 0
1159, 1, 1636429640637, 1636429641093, 456, 0, 456, 0, 0, 0
1160, 1, 1636429640792, 1636429641253, 461, 1, 460, 0, 0, 0
1161, 1, 1636429640792, 1636429641348, 556, 73, 483, 73, 0, 73
1113, 2, 1636429631392, 1636429641392, 10000, 0, 10000, 0, 0, 0
1112, 2, 1636429631392, 1636429641436, 10044, 0, 10044, 0, 0, 0
1164, 1, 1636429640836, 1636429641481, 645, 193, 452, 193, 0, 193
1165, 1, 1636429641120, 1636429641665, 545, 1, 544, 1, 0, 1
1167, 1, 1636429641248, 1636429641844, 596, 101, 495, 100, 0, 100
1169, 1, 1636429641316, 1636429641848, 532, 1, 531, 0, 0, 0
1116, 2, 1636429631849, 1636429641848, 9999, 0, 9999, 0, 0, 0
1168, 1, 1636429641316, 1636429641848, 532, 1, 531, 0, 0, 0
1117, 2, 1636429631856, 1636429641893, 10037, 0, 10037, 0, 0, 0
1162, 1, 1636429640812, 1636429641933, 1121, 669, 452, 669, 0, 669
1171, 1, 1636429641573, 1636429642116, 543, 93, 450, 93, 0, 93
1173, 1, 1636429641708, 1636429642204, 496, 2, 494, 0, 1, 1
1120, 2, 1636429632305, 1636429642305, 10000, 0, 10000, 0, 0, 0
1175, 1, 1636429641940, 1636429642389, 449, 0, 449, 0, 0, 0
1177, 1, 1636429642073, 1636429642529, 456, 0, 456, 0, 0, 0
1176, 1, 1636429642073, 1636429642537, 464, 0, 464, 0, 0, 0
1178, 1, 1636429642073, 1636429642565, 492, 44, 448, 44, 0, 44
1179, 1, 1636429642156, 1636429642616, 460, 1, 459, 0, 0, 0
1122, 1, 1636429632592, 1636429642756, 10164, 9713, 451, 0, 9712, 9712
1182, 1, 1636429642352, 1636429642840, 488, 38, 450, 37, 1, 38
1183, 1, 1636429642425, 1636429642876, 451, 0, 451, 0, 0, 0
1184, 1, 1636429642608, 1636429643065, 457, 1, 456, 1, 0, 1
1186, 1, 1636429642748, 1636429643189, 441, 0, 441, 0, 0, 0
1187, 1, 1636429642756, 1636429643213, 457, 1, 456, 0, 0, 0
1189, 1, 1636429642832, 1636429643277, 445, 1, 444, 0, 0, 0
1188, 1, 1636429642784, 1636429643293, 509, 57, 452, 57, 0, 57
1191, 1, 1636429643056, 1636429643520, 464, 9, 455, 8, 0, 8
1192, 1, 1636429643097, 1636429643549, 452, 0, 452, 0, 0, 0
1193, 1, 1636429643292, 1636429643741, 449, 1, 448, 1, 0, 1
1194, 1, 1636429643412, 1636429643865, 453, 0, 453, 0, 0, 0
1195, 1, 1636429643432, 1636429643885, 453, 1, 452, 0, 1, 1
1196, 1, 1636429643496, 1636429643949, 453, 1, 452, 0, 0, 0
1197, 1, 1636429643517, 1636429643977, 460, 4, 456, 4, 0, 4
1198, 1, 1636429643740, 1636429644192, 452, 1, 451, 0, 0, 0
1199, 1, 1636429643776, 1636429644225, 449, 0, 449, 0, 0, 0
1200, 1, 1636429643969, 1636429644421, 452, 0, 452, 0, 0, 0
1202, 1, 1636429644112, 1636429644553, 441, 1, 440, 0, 0, 0
1203, 1, 1636429644172, 1636429644625, 453, 1, 452, 1, 0, 1
1204, 1, 1636429644196, 1636429644649, 453, 0, 453, 0, 0, 0
1205, 1, 1636429644416, 1636429644873, 457, 5, 452, 4, 0, 4
1206, 1, 1636429644444, 1636429644892, 448, 1, 447, 0, 0, 0
1207, 1, 1636429644641, 1636429645088, 447, 0, 447, 0, 0, 0
1208, 1, 1636429644776, 1636429645229, 453, 1, 452, 0, 0, 0
1209, 1, 1636429644849, 1636429645297, 448, 0, 448, 0, 0, 0
1210, 1, 1636429644873, 1636429645325, 452, 0, 452, 0, 0, 0
1211, 1, 1636429645092, 1636429645540, 448, 0, 448, 0, 0, 0
1212, 1, 1636429645113, 1636429645565, 452, 0, 452, 0, 0, 0
1213, 1, 1636429645312, 1636429645765, 453, 1, 452, 0, 0, 0
1214, 1, 1636429645456, 1636429645905, 449, 1, 448, 0, 0, 0
1215, 1, 1636429645524, 1636429645977, 453, 1, 452, 0, 0, 0
1216, 1, 1636429645544, 1636429645993, 449, 1, 448, 1, 0, 1
1217, 1, 1636429645757, 1636429646216, 459, 8, 451, 8, 0, 8
1218, 1, 1636429645788, 1636429646236, 448, 1, 447, 0, 0, 0
1219, 1, 1636429645988, 1636429646437, 449, 1, 448, 1, 0, 1
1220, 1, 1636429646133, 1636429646581, 448, 0, 448, 0, 0, 0
1221, 1, 1636429646201, 1636429646645, 444, 0, 444, 0, 0, 0
1222, 1, 1636429646213, 1636429646660, 447, 4, 443, 4, 0, 4
1223, 1, 1636429646433, 1636429646888, 455, 4, 451, 4, 0, 4
1224, 1, 1636429646461, 1636429647100, 639, 185, 454, 184, 0, 184
1225, 1, 1636429646660, 1636429647116, 456, 1, 455, 1, 0, 1
1226, 1, 1636429646804, 1636429647249, 445, 1, 444, 0, 0, 0
1227, 1, 1636429646868, 1636429647317, 449, 0, 449, 0, 0, 0
1228, 1, 1636429646884, 1636429647340, 456, 5, 451, 5, 0, 5
1229, 1, 1636429647104, 1636429647568, 464, 13, 451, 13, 0, 13
1230, 1, 1636429647317, 1636429647777, 460, 0, 460, 0, 0, 0
1231, 1, 1636429647333, 1636429647793, 460, 0, 460, 0, 0, 0
1232, 1, 1636429647469, 1636429647921, 452, 0, 452, 0, 0, 0
1233, 1, 1636429647541, 1636429647989, 448, 0, 448, 0, 0, 0
1234, 1, 1636429647556, 1636429648017, 461, 13, 448, 12, 0, 12
1235, 1, 1636429647785, 1636429648245, 460, 8, 452, 8, 0, 8
1236, 1, 1636429648001, 1636429648449, 448, 0, 448, 0, 0, 0
1237, 1, 1636429648021, 1636429648468, 447, 0, 447, 0, 0, 0
1238, 1, 1636429648144, 1636429648592, 448, 1, 447, 0, 0, 0
1239, 1, 1636429648212, 1636429648664, 452, 1, 451, 0, 0, 0
1240, 1, 1636429648241, 1636429648705, 464, 4, 460, 4, 0, 4
1241, 1, 1636429648468, 1636429648917, 449, 1, 448, 1, 0, 1
1242, 1, 1636429648668, 1636429649125, 457, 1, 456, 0, 0, 0
1243, 1, 1636429648689, 1636429649145, 456, 0, 456, 0, 0, 0
1144, 2, 1636429639208, 1636429649160, 9952, 0, 9952, 449, 0, 449
1244, 1, 1636429648813, 1636429649269, 456, 0, 456, 0, 0, 0
1246, 1, 1636429648929, 1636429649381, 452, 0, 452, 0, 0, 0
1245, 1, 1636429648884, 1636429649381, 497, 1, 496, 0, 0, 0
1148, 2, 1636429639428, 1636429649424, 9996, 0, 9996, 229, 0, 229
1247, 1, 1636429649133, 1636429649601, 468, 12, 456, 12, 0, 12
1248, 1, 1636429649348, 1636429649832, 484, 1, 483, 0, 0, 0
1249, 1, 1636429649369, 1636429649836, 467, 0, 467, 0, 0, 0
1152, 2, 1636429639888, 1636429649889, 10001, 0, 10001, 0, 0, 0
1250, 1, 1636429649516, 1636429649973, 457, 1, 456, 0, 0, 0
1252, 1, 1636429649604, 1636429650052, 448, 1, 447, 0, 0, 0
1251, 1, 1636429649604, 1636429650060, 456, 1, 455, 1, 0, 1
1253, 1, 1636429649825, 1636429650296, 471, 12, 459, 12, 0, 12
1157, 2, 1636429640345, 1636429650344, 9999, 0, 9999, 0, 0, 0
1257, 1, 1636429650068, 1636429650516, 448, 1, 447, 0, 0, 0
1256, 1, 1636429650068, 1636429650516, 448, 1, 447, 1, 0, 1
1258, 1, 1636429650192, 1636429650661, 469, 0, 469, 0, 0, 0
1261, 1, 1636429650277, 1636429650748, 471, 20, 451, 20, 0, 20
1260, 1, 1636429650272, 1636429650748, 476, 1, 475, 0, 0, 0
1163, 2, 1636429640812, 1636429650809, 9997, 0, 9997, 0, 0, 0
1264, 1, 1636429650736, 1636429651217, 481, 1, 480, 0, 0, 0
1265, 1, 1636429650732, 1636429651221, 489, 1, 488, 1, 0, 1
1166, 2, 1636429641248, 1636429651249, 10001, 0, 10001, 0, 0, 0
1266, 1, 1636429650900, 1636429651353, 453, 0, 453, 0, 0, 0
1268, 1, 1636429650988, 1636429651473, 485, 0, 485, 0, 0, 0
1267, 1, 1636429650989, 1636429651473, 484, 0, 484, 0, 0, 0
1170, 2, 1636429641484, 1636429651484, 10000, 0, 10000, 450, 0, 450
1174, 2, 1636429641708, 1636429651708, 10000, 0, 10000, 224, 0, 224
1172, 2, 1636429641709, 1636429651753, 10044, 0, 10044, 0, 0, 0
1262, 1, 1636429650516, 1636429651976, 1460, 958, 502, 957, 1, 958
1270, 1, 1636429651440, 1636429651980, 540, 0, 540, 0, 0, 0
1271, 1, 1636429651445, 1636429651980, 535, 0, 535, 0, 0, 0
1180, 2, 1636429642156, 1636429652157, 10001, 0, 10001, 0, 0, 0
1275, 1, 1636429651697, 1636429652164, 467, 0, 467, 0, 0, 0
1181, 2, 1636429642160, 1636429652204, 10044, 0, 10044, 0, 0, 0
1274, 1, 1636429651697, 1636429652428, 731, 280, 451, 280, 0, 280
1190, 1, 1636429642977, 1636429652612, 9635, 9180, 455, 0, 9180, 9180
1185, 2, 1636429642616, 1636429652612, 9996, 0, 9996, 0, 0, 0
1278, 1, 1636429652253, 1636429652705, 452, 1, 451, 0, 0, 0
1281, 1, 1636429652253, 1636429652705, 452, 0, 452, 0, 0, 0
1280, 1, 1636429652253, 1636429652708, 455, 1, 454, 1, 0, 1
1277, 1, 1636429652253, 1636429652708, 455, 1, 454, 0, 1, 1
1282, 1, 1636429652384, 1636429652836, 452, 1, 451, 0, 0, 0
1285, 1, 1636429652656, 1636429653156, 500, 53, 447, 53, 0, 53
1284, 1, 1636429652472, 1636429653160, 688, 234, 454, 234, 0, 234
1288, 1, 1636429652933, 1636429653381, 448, 1, 447, 0, 0, 0
1291, 1, 1636429652933, 1636429653385, 452, 1, 451, 1, 0, 1
1290, 1, 1636429652933, 1636429653385, 452, 1, 451, 1, 0, 1
1289, 1, 1636429652933, 1636429653388, 455, 0, 455, 0, 0, 0
1287, 1, 1636429652920, 1636429653620, 700, 241, 459, 241, 0, 241
1293, 1, 1636429653377, 1636429653844, 467, 12, 455, 11, 1, 12
1294, 1, 1636429653384, 1636429653845, 461, 2, 459, 2, 0, 2
1295, 1, 1636429653600, 1636429654053, 453, 1, 452, 0, 0, 0
1296, 1, 1636429653605, 1636429654061, 456, 0, 456, 0, 0, 0
1298, 1, 1636429653608, 1636429654064, 456, 1, 455, 1, 0, 1
1201, 2, 1636429644089, 1636429654088, 9999, 0, 9999, 0, 0, 0
1299, 1, 1636429653836, 1636429654312, 476, 10, 466, 8, 0, 8
1301, 1, 1636429654068, 1636429654517, 449, 1, 448, 1, 0, 1
1303, 1, 1636429654280, 1636429654733, 453, 1, 452, 0, 1, 1
1302, 1, 1636429654276, 1636429654733, 457, 1, 456, 1, 0, 1
1304, 1, 1636429654284, 1636429654733, 449, 0, 449, 0, 0, 0
1305, 1, 1636429654400, 1636429654853, 453, 1, 452, 0, 0, 0
1306, 1, 1636429654533, 1636429654984, 451, 0, 451, 0, 0, 0
1307, 1, 1636429654733, 1636429655188, 455, 1, 454, 1, 0, 1
1308, 1, 1636429654957, 1636429655408, 451, 0, 451, 0, 0, 0
1309, 1, 1636429654960, 1636429655412, 452, 1, 451, 0, 0, 0
1310, 1, 1636429654957, 1636429655412, 455, 0, 455, 0, 0, 0
1311, 1, 1636429655076, 1636429655525, 449, 1, 448, 0, 1, 1
1312, 1, 1636429655208, 1636429655660, 452, 1, 451, 0, 0, 0
1313, 1, 1636429655408, 1636429655865, 457, 5, 452, 5, 0, 5
1316, 1, 1636429655637, 1636429656077, 440, 0, 440, 0, 0, 0
1315, 1, 1636429655633, 1636429656080, 447, 0, 447, 0, 0, 0
1314, 1, 1636429655628, 1636429656081, 453, 1, 452, 0, 0, 0
1317, 1, 1636429655749, 1636429656204, 455, 0, 455, 0, 0, 0
1318, 1, 1636429655881, 1636429656332, 451, 0, 451, 0, 0, 0
1319, 1, 1636429656088, 1636429656549, 461, 1, 460, 0, 0, 0
1320, 1, 1636429656296, 1636429656753, 457, 1, 456, 0, 0, 0
1322, 1, 1636429656304, 1636429656757, 453, 1, 452, 0, 0, 0
1321, 1, 1636429656304, 1636429656757, 453, 1, 452, 0, 0, 0
1323, 1, 1636429656433, 1636429656881, 448, 0, 448, 0, 0, 0
1324, 1, 1636429656552, 1636429657004, 452, 1, 451, 0, 0, 0
1325, 1, 1636429656768, 1636429657224, 456, 1, 455, 1, 0, 1
1327, 1, 1636429656981, 1636429657432, 451, 0, 451, 0, 0, 0
1328, 1, 1636429656981, 1636429657433, 452, 1, 451, 0, 0, 0
1329, 1, 1636429657105, 1636429657561, 456, 0, 456, 0, 0, 0
1330, 1, 1636429657224, 1636429657676, 452, 1, 451, 1, 0, 1
1331, 1, 1636429657444, 1636429657900, 456, 1, 455, 0, 1, 1
1333, 1, 1636429657657, 1636429658108, 451, 0, 451, 0, 0, 0
1332, 1, 1636429657652, 1636429658108, 456, 1, 455, 0, 0, 0
1326, 1, 1636429656972, 1636429658140, 1168, 705, 463, 705, 0, 705
1334, 1, 1636429657785, 1636429658232, 447, 0, 447, 0, 0, 0
1335, 1, 1636429657897, 1636429658356, 459, 4, 455, 4, 0, 4
1336, 1, 1636429658124, 1636429658573, 449, 1, 448, 0, 0, 0
1338, 1, 1636429658329, 1636429658777, 448, 0, 448, 0, 0, 0
1337, 1, 1636429658329, 1636429658777, 448, 0, 448, 0, 0, 0
1339, 1, 1636429658360, 1636429658812, 452, 1, 451, 0, 1, 1
1340, 1, 1636429658452, 1636429658897, 445, 0, 445, 0, 0, 0
1341, 1, 1636429658577, 1636429659028, 451, 0, 451, 0, 0, 0
1342, 1, 1636429658792, 1636429659245, 453, 1, 452, 0, 0, 0
1343, 1, 1636429659001, 1636429659452, 451, 0, 451, 0, 0, 0
1344, 1, 1636429659005, 1636429659461, 456, 0, 456, 0, 0, 0
1345, 1, 1636429659032, 1636429659484, 452, 0, 452, 0, 0, 0
1346, 1, 1636429659117, 1636429659569, 452, 0, 452, 0, 0, 0
1347, 1, 1636429659248, 1636429659697, 449, 1, 448, 0, 0, 0
1348, 1, 1636429659469, 1636429659917, 448, 0, 448, 0, 0, 0
1255, 2, 1636429649981, 1636429659977, 9996, 0, 9996, 0, 0, 0
1254, 2, 1636429649981, 1636429660021, 10040, 0, 10040, 0, 0, 0
1349, 1, 1636429659673, 1636429660116, 443, 0, 443, 0, 0, 0
1350, 1, 1636429659685, 1636429660145, 460, 0, 460, 0, 0, 0
1259, 2, 1636429650192, 1636429660200, 10008, 0, 10008, 0, 0, 0
1352, 1, 1636429659792, 1636429660241, 449, 1, 448, 1, 0, 1
1351, 1, 1636429659705, 1636429660241, 536, 0, 536, 0, 0, 0
1353, 1, 1636429659917, 1636429660428, 511, 1, 510, 0, 0, 0
1354, 1, 1636429660156, 1636429660612, 456, 1, 455, 0, 1, 1
1263, 2, 1636429650656, 1636429660652, 9996, 0, 9996, 0, 0, 0
1356, 1, 1636429660288, 1636429660732, 444, 1, 443, 0, 0, 0
1358, 1, 1636429660381, 1636429660825, 444, 0, 444, 0, 0, 0
1357, 1, 1636429660381, 1636429660836, 455, 0, 455, 0, 0, 0
1359, 1, 1636429660460, 1636429660913, 453, 1, 452, 0, 0, 0
1360, 1, 1636429660460, 1636429660916, 456, 1, 455, 0, 0, 0
1362, 1, 1636429660644, 1636429661096, 452, 0, 452, 0, 0, 0
1269, 2, 1636429651117, 1636429661117, 10000, 0, 10000, 0, 0, 0
1363, 1, 1636429660828, 1636429661336, 508, 9, 499, 9, 0, 9
1364, 1, 1636429660949, 1636429661428, 479, 0, 479, 0, 0, 0
1367, 1, 1636429661060, 1636429661517, 457, 1, 456, 1, 0, 1
1366, 1, 1636429661048, 1636429661517, 469, 1, 468, 0, 0, 0
1273, 2, 1636429651572, 1636429661576, 10004, 0, 10004, 1, 0, 1
1369, 1, 1636429661161, 1636429661613, 452, 0, 452, 0, 0, 0
1368, 1, 1636429661161, 1636429661616, 455, 0, 455, 0, 0, 0
1272, 2, 1636429651576, 1636429661624, 10048, 0, 10048, 1, 0, 1
1370, 1, 1636429661321, 1636429661844, 523, 16, 507, 16, 0, 16
1276, 2, 1636429652016, 1636429662017, 10001, 0, 10001, 1, 0, 1
1372, 1, 1636429661552, 1636429662036, 484, 0, 484, 0, 0, 0
1373, 1, 1636429661672, 1636429662116, 444, 1, 443, 1, 0, 1
1279, 2, 1636429652249, 1636429662208, 9959, 0, 9959, 0, 0, 0
1375, 1, 1636429661760, 1636429662240, 480, 1, 479, 0, 0, 0
1374, 1, 1636429661760, 1636429662240, 480, 1, 479, 1, 0, 1
1376, 1, 1636429661828, 1636429662280, 452, 0, 452, 0, 0, 0
1377, 1, 1636429661836, 1636429662332, 496, 0, 496, 0, 0, 0
1378, 1, 1636429661888, 1636429662333, 445, 1, 444, 0, 0, 0
1283, 2, 1636429652472, 1636429662473, 10001, 0, 10001, 0, 0, 0
1380, 1, 1636429662064, 1636429662528, 464, 0, 464, 0, 0, 0
1381, 1, 1636429662256, 1636429662708, 452, 1, 451, 0, 0, 0
1383, 1, 1636429662336, 1636429662788, 452, 0, 452, 0, 0, 0
1384, 1, 1636429662460, 1636429662904, 444, 1, 443, 0, 0, 0
1385, 1, 1636429662464, 1636429662905, 441, 1, 440, 0, 1, 1
1286, 1, 1636429652832, 1636429662916, 10084, 9641, 443, 0, 9641, 9641
1386, 1, 1636429662520, 1636429662964, 444, 0, 444, 0, 0, 0
1389, 1, 1636429662564, 1636429662992, 428, 1, 427, 1, 0, 1
1388, 1, 1636429662564, 1636429662996, 432, 1, 431, 1, 0, 1
1387, 1, 1636429662568, 1636429663000, 432, 0, 432, 0, 0, 0
1292, 2, 1636429653052, 1636429663056, 10004, 0, 10004, 0, 0, 0
1390, 1, 1636429662744, 1636429663196, 452, 0, 452, 0, 0, 0
1392, 1, 1636429662929, 1636429663388, 459, 0, 459, 0, 0, 0
1393, 1, 1636429663004, 1636429663465, 461, 1, 460, 0, 1, 1
1395, 1, 1636429663152, 1636429663600, 448, 1, 447, 0, 1, 1
1394, 1, 1636429663152, 1636429663604, 452, 1, 451, 1, 0, 1
1297, 2, 1636429653608, 1636429663608, 10000, 0, 10000, 1, 0, 1
1397, 1, 1636429663192, 1636429663640, 448, 0, 448, 0, 0, 0
1399, 1, 1636429663236, 1636429663688, 452, 1, 451, 1, 0, 1
1400, 1, 1636429663236, 1636429663688, 452, 2, 450, 0, 0, 0
1401, 1, 1636429663356, 1636429663833, 477, 1, 476, 0, 1, 1
1402, 1, 1636429663408, 1636429663857, 449, 1, 448, 0, 0, 0
1300, 1, 1636429654068, 1636429664060, 9992, 9541, 451, 1, 9540, 9541
1398, 1, 1636429663236, 1636429664088, 852, 405, 447, 405, 0, 405
1403, 1, 1636429663656, 1636429664113, 457, 1, 456, 0, 0, 0
1406, 1, 1636429663824, 1636429664264, 440, 1, 439, 0, 1, 1
1407, 1, 1636429663864, 1636429664304, 440, 1, 439, 0, 0, 0
1408, 1, 1636429663908, 1636429664357, 449, 1, 448, 0, 1, 1
1409, 1, 1636429663908, 1636429664360, 452, 1, 451, 0, 1, 1
1410, 1, 1636429663916, 1636429664364, 448, 0, 448, 0, 0, 0
1411, 1, 1636429664052, 1636429664513, 461, 1, 460, 0, 0, 0
1405, 1, 1636429663816, 1636429664513, 697, 245, 452, 245, 0, 245
1412, 1, 1636429664076, 1636429664560, 484, 37, 447, 37, 0, 37
1414, 1, 1636429664304, 1636429664756, 452, 0, 452, 0, 0, 0
1413, 1, 1636429664284, 1636429664821, 537, 81, 456, 81, 0, 81
1416, 1, 1636429664488, 1636429664944, 456, 1, 455, 0, 0, 0
1415, 1, 1636429664324, 1636429664964, 640, 190, 450, 189, 0, 189
1417, 1, 1636429664525, 1636429664984, 459, 0, 459, 0, 0, 0
1419, 1, 1636429664580, 1636429665024, 444, 1, 443, 0, 1, 1
1418, 1, 1636429664572, 1636429665024, 452, 0, 452, 0, 0, 0
1420, 1, 1636429664576, 1636429665028, 452, 1, 451, 0, 0, 0
1421, 1, 1636429664733, 1636429665188, 455, 0, 455, 0, 0, 0
1422, 1, 1636429664733, 1636429665272, 539, 88, 451, 88, 0, 88
1423, 1, 1636429664776, 1636429665416, 640, 189, 451, 189, 0, 189
1424, 1, 1636429664976, 1636429665424, 448, 0, 448, 0, 0, 0
1425, 1, 1636429665041, 1636429665484, 443, 0, 443, 0, 0, 0
1426, 1, 1636429665160, 1636429665609, 449, 0, 449, 0, 0, 0
1428, 1, 1636429665208, 1636429665660, 452, 0, 452, 0, 0, 0
1430, 1, 1636429665241, 1636429665689, 448, 0, 448, 0, 0, 0
1429, 1, 1636429665248, 1636429665696, 448, 1, 447, 0, 0, 0
1431, 1, 1636429665248, 1636429665700, 452, 1, 451, 0, 0, 0
1427, 1, 1636429665176, 1636429665724, 548, 97, 451, 97, 0, 97
1404, 1, 1636429663700, 1636429665857, 2157, 1716, 441, 1716, 0, 1716
1432, 1, 1636429665408, 1636429665857, 449, 0, 449, 0, 0, 0
1433, 1, 1636429665484, 1636429665933, 449, 0, 449, 0, 0, 0
1435, 1, 1636429665648, 1636429666096, 448, 1, 447, 0, 1, 1
1436, 1, 1636429665704, 1636429666148, 444, 1, 443, 0, 0, 0
1434, 1, 1636429665636, 1636429666180, 544, 89, 455, 88, 0, 88
1437, 1, 1636429665833, 1636429666277, 444, 0, 444, 0, 0, 0
1438, 1, 1636429665880, 1636429666324, 444, 1, 443, 0, 0, 0
1439, 1, 1636429665917, 1636429666368, 451, 1, 450, 0, 1, 1
1440, 1, 1636429665917, 1636429666369, 452, 1, 451, 0, 1, 1
1441, 1, 1636429665917, 1636429666369, 452, 1, 451, 0, 1, 1
1442, 1, 1636429665944, 1636429666397, 453, 1, 452, 0, 0, 0
1443, 1, 1636429666076, 1636429666521, 445, 1, 444, 0, 0, 0
1444, 1, 1636429666084, 1636429666532, 448, 1, 447, 0, 0, 0
1445, 1, 1636429666148, 1636429666596, 448, 1, 447, 1, 0, 1
1446, 1, 1636429666317, 1636429666764, 447, 0, 447, 0, 0, 0
1447, 1, 1636429666368, 1636429666824, 456, 1, 455, 1, 0, 1
1448, 1, 1636429666397, 1636429666848, 451, 1, 450, 0, 1, 1
1449, 1, 1636429666497, 1636429666949, 452, 0, 452, 0, 0, 0
1450, 1, 1636429666548, 1636429666997, 449, 0, 449, 0, 0, 0
1451, 1, 1636429666588, 1636429667041, 453, 1, 452, 0, 0, 0
1452, 1, 1636429666588, 1636429667041, 453, 1, 452, 0, 0, 0
1453, 1, 1636429666588, 1636429667041, 453, 2, 451, 1, 0, 1
1454, 1, 1636429666620, 1636429667068, 448, 0, 448, 0, 0, 0
1455, 1, 1636429666745, 1636429667192, 447, 0, 447, 0, 0, 0
1456, 1, 1636429666753, 1636429667204, 451, 0, 451, 0, 0, 0
1457, 1, 1636429666808, 1636429667276, 468, 17, 451, 17, 0, 17
1458, 1, 1636429666984, 1636429667425, 441, 1, 440, 0, 1, 1
1459, 1, 1636429667048, 1636429667500, 452, 1, 451, 0, 1, 1
1460, 1, 1636429667065, 1636429667520, 455, 4, 451, 4, 0, 4
1461, 1, 1636429667176, 1636429667620, 444, 0, 444, 0, 0, 0
1462, 1, 1636429667220, 1636429667668, 448, 0, 448, 0, 0, 0
1463, 1, 1636429667264, 1636429667713, 449, 1, 448, 0, 0, 0
1465, 1, 1636429667260, 1636429667713, 453, 1, 452, 0, 0, 0
1464, 1, 1636429667264, 1636429667716, 452, 1, 451, 0, 0, 0
1466, 1, 1636429667280, 1636429667732, 452, 0, 452, 0, 0, 0
1467, 1, 1636429667416, 1636429667865, 449, 1, 448, 0, 0, 0
1468, 1, 1636429667424, 1636429667872, 448, 1, 447, 0, 0, 0
1469, 1, 1636429667492, 1636429667956, 464, 8, 456, 8, 0, 8
1470, 1, 1636429667640, 1636429668089, 449, 0, 449, 0, 0, 0
1471, 1, 1636429667716, 1636429668168, 452, 0, 452, 0, 0, 0
1472, 1, 1636429667732, 1636429668185, 453, 1, 452, 1, 0, 1
1473, 1, 1636429667836, 1636429668289, 453, 1, 452, 0, 0, 0
1474, 1, 1636429667892, 1636429668340, 448, 0, 448, 0, 0, 0
1475, 1, 1636429667936, 1636429668384, 448, 0, 448, 0, 0, 0
1477, 1, 1636429667936, 1636429668388, 452, 1, 451, 0, 0, 0
1476, 1, 1636429667933, 1636429668392, 459, 0, 459, 0, 0, 0
1478, 1, 1636429667952, 1636429668408, 456, 5, 451, 5, 0, 5
1479, 1, 1636429668084, 1636429668536, 452, 1, 451, 0, 0, 0
1480, 1, 1636429668088, 1636429668540, 452, 1, 451, 0, 0, 0
1481, 1, 1636429668176, 1636429668624, 448, 1, 447, 0, 1, 1
1482, 1, 1636429668312, 1636429668760, 448, 1, 447, 0, 0, 0
1483, 1, 1636429668384, 1636429668844, 460, 9, 451, 9, 0, 9
1484, 1, 1636429668400, 1636429668860, 460, 9, 451, 9, 0, 9
1485, 1, 1636429668516, 1636429668961, 445, 1, 444, 0, 0, 0
1486, 1, 1636429668564, 1636429669012, 448, 0, 448, 0, 0, 0
1489, 1, 1636429668605, 1636429669053, 448, 0, 448, 0, 0, 0
1487, 1, 1636429668605, 1636429669056, 451, 0, 451, 0, 0, 0
1488, 1, 1636429668608, 1636429669056, 448, 0, 448, 0, 0, 0
1490, 1, 1636429668624, 1636429669072, 448, 0, 448, 0, 0, 0
1492, 1, 1636429668760, 1636429669200, 440, 0, 440, 0, 0, 0
1491, 1, 1636429668756, 1636429669208, 452, 0, 452, 0, 0, 0
1493, 1, 1636429668840, 1636429669292, 452, 5, 447, 5, 0, 5
1494, 1, 1636429668980, 1636429669433, 453, 1, 452, 0, 0, 0
1495, 1, 1636429669064, 1636429669516, 452, 1, 451, 0, 0, 0
1496, 1, 1636429669080, 1636429669524, 444, 1, 443, 0, 0, 0
1497, 1, 1636429669185, 1636429669637, 452, 0, 452, 0, 0, 0
1498, 1, 1636429669236, 1636429669680, 444, 0, 444, 0, 0, 0
1500, 1, 1636429669276, 1636429669724, 448, 1, 447, 0, 1, 1
1499, 1, 1636429669272, 1636429669725, 453, 1, 452, 0, 0, 0
1501, 1, 1636429669276, 1636429669725, 449, 1, 448, 0, 1, 1
1502, 1, 1636429669288, 1636429669740, 452, 5, 447, 5, 0, 5
1503, 1, 1636429669416, 1636429669864, 448, 0, 448, 0, 0, 0
1504, 1, 1636429669424, 1636429669873, 449, 1, 448, 0, 1, 1
1505, 1, 1636429669504, 1636429669964, 460, 13, 447, 13, 0, 13
1506, 1, 1636429669652, 1636429670096, 444, 0, 444, 0, 0, 0
1507, 1, 1636429669732, 1636429670188, 456, 0, 456, 0, 0, 0
1508, 1, 1636429669736, 1636429670188, 452, 5, 447, 5, 0, 5
1355, 2, 1636429660292, 1636429670297, 10005, 0, 10005, 441, 0, 441
1509, 1, 1636429669856, 1636429670300, 444, 0, 444, 0, 0, 0
1510, 1, 1636429669900, 1636429670344, 444, 0, 444, 0, 0, 0
1512, 1, 1636429669948, 1636429670388, 440, 1, 439, 0, 1, 1
1511, 1, 1636429669944, 1636429670392, 448, 1, 447, 0, 1, 1
1513, 1, 1636429669948, 1636429670392, 444, 1, 443, 1, 0, 1
1514, 1, 1636429669960, 1636429670412, 452, 5, 447, 5, 0, 5
1361, 2, 1636429660492, 1636429670492, 10000, 0, 10000, 241, 0, 241
1515, 1, 1636429670084, 1636429670524, 440, 0, 440, 0, 0, 0
1517, 1, 1636429670184, 1636429670636, 452, 5, 447, 4, 0, 4
1518, 1, 1636429670344, 1636429670808, 464, 1, 463, 1, 0, 1
1520, 1, 1636429670409, 1636429670901, 492, 4, 488, 4, 0, 4
1519, 1, 1636429670409, 1636429670904, 495, 0, 495, 0, 0, 0
1365, 2, 1636429660968, 1636429670969, 10001, 0, 10001, 0, 0, 0
1521, 1, 1636429670544, 1636429670992, 448, 0, 448, 0, 0, 0
1522, 1, 1636429670580, 1636429671024, 444, 1, 443, 0, 0, 0
1524, 1, 1636429670612, 1636429671064, 452, 2, 450, 0, 0, 0
1523, 1, 1636429670612, 1636429671068, 456, 2, 454, 0, 0, 0
1525, 1, 1636429670612, 1636429671072, 460, 1, 459, 0, 0, 0
1526, 1, 1636429670668, 1636429671104, 436, 1, 435, 0, 0, 0
1527, 1, 1636429670740, 1636429671197, 457, 0, 457, 0, 0, 0
1528, 1, 1636429670852, 1636429671376, 524, 53, 471, 53, 0, 53
1516, 1, 1636429670100, 1636429671376, 1276, 801, 475, 801, 0, 801
1371, 2, 1636429661424, 1636429671428, 10004, 0, 10004, 0, 0, 0
1529, 1, 1636429671064, 1636429671512, 448, 1, 447, 0, 0, 0
1533, 1, 1636429671148, 1636429671596, 448, 0, 448, 0, 0, 0
1532, 1, 1636429671148, 1636429671600, 452, 0, 452, 0, 0, 0
1534, 1, 1636429671217, 1636429671664, 447, 0, 447, 0, 0, 0
1539, 1, 1636429671288, 1636429671744, 456, 1, 455, 0, 0, 0
1538, 1, 1636429671288, 1636429671744, 456, 1, 455, 0, 1, 1
1537, 1, 1636429671288, 1636429671748, 460, 1, 459, 1, 0, 1
1540, 1, 1636429671324, 1636429671836, 512, 53, 459, 53, 0, 53
1535, 1, 1636429671244, 1636429671844, 600, 133, 467, 133, 0, 133
1541, 1, 1636429671420, 1636429671869, 449, 1, 448, 1, 0, 1
1379, 2, 1636429661892, 1636429671893, 10001, 0, 10001, 0, 0, 0
1543, 1, 1636429671608, 1636429672056, 448, 1, 447, 1, 0, 1
1542, 1, 1636429671608, 1636429672056, 448, 1, 447, 1, 0, 1
1544, 1, 1636429671728, 1636429672208, 480, 1, 479, 0, 0, 0
1547, 1, 1636429671820, 1636429672300, 480, 17, 463, 16, 0, 16
1546, 1, 1636429671812, 1636429672300, 488, 1, 487, 0, 0, 0
1382, 2, 1636429662324, 1636429672324, 10000, 0, 10000, 0, 0, 0
1550, 1, 1636429671988, 1636429672436, 448, 1, 447, 0, 0, 0
1551, 1, 1636429671988, 1636429672436, 448, 1, 447, 1, 0, 1
1552, 1, 1636429672072, 1636429672549, 477, 1, 476, 0, 1, 1
1554, 1, 1636429672100, 1636429672549, 449, 0, 449, 0, 0, 0
1553, 1, 1636429672072, 1636429672552, 480, 0, 480, 0, 0, 0
1549, 1, 1636429671980, 1636429672656, 676, 229, 447, 229, 0, 229
1557, 1, 1636429672280, 1636429672729, 449, 0, 449, 0, 0, 0
1391, 2, 1636429662772, 1636429672776, 10004, 0, 10004, 0, 0, 0
1558, 1, 1636429672432, 1636429672876, 444, 1, 443, 0, 0, 0
1559, 1, 1636429672520, 1636429672996, 476, 1, 475, 0, 1, 1
1560, 1, 1636429672520, 1636429673004, 484, 33, 451, 33, 0, 33
1562, 1, 1636429672653, 1636429673109, 456, 0, 456, 0, 0, 0
1563, 1, 1636429672656, 1636429673112, 456, 1, 455, 1, 0, 1
1566, 1, 1636429672772, 1636429673225, 453, 1, 452, 0, 1, 1
1396, 1, 1636429663152, 1636429673229, 10077, 9625, 452, 1, 9624, 9625
1565, 1, 1636429672772, 1636429673229, 457, 1, 456, 0, 0, 0
1567, 1, 1636429672876, 1636429673321, 445, 1, 444, 0, 0, 0
1568, 1, 1636429672956, 1636429673408, 452, 1, 451, 0, 0, 0
1570, 1, 1636429673093, 1636429673544, 451, 0, 451, 0, 0, 0
1571, 1, 1636429673216, 1636429673673, 457, 0, 457, 0, 0, 0
1574, 1, 1636429673328, 1636429673781, 453, 0, 453, 0, 0, 0
1573, 1, 1636429673321, 1636429673781, 460, 0, 460, 0, 0, 0
1576, 1, 1636429673456, 1636429673900, 444, 1, 443, 1, 0, 1
1575, 1, 1636429673452, 1636429673901, 449, 1, 448, 0, 1, 1
1578, 1, 1636429673540, 1636429673988, 448, 0, 448, 0, 0, 0
1579, 1, 1636429673624, 1636429674072, 448, 1, 447, 0, 0, 0
1580, 1, 1636429673760, 1636429674213, 453, 1, 452, 0, 0, 0
1581, 1, 1636429673893, 1636429674349, 456, 0, 456, 0, 0, 0
1582, 1, 1636429674005, 1636429674461, 456, 0, 456, 0, 0, 0
1583, 1, 1636429674005, 1636429674461, 456, 0, 456, 0, 0, 0
1584, 1, 1636429674124, 1636429674581, 457, 0, 457, 0, 0, 0
1586, 1, 1636429674208, 1636429674648, 440, 1, 439, 0, 0, 0
1587, 1, 1636429674293, 1636429674745, 452, 0, 452, 0, 0, 0
1588, 1, 1636429674432, 1636429674877, 445, 1, 444, 0, 1, 1
1589, 1, 1636429674576, 1636429675029, 453, 1, 452, 0, 0, 0
1591, 1, 1636429674685, 1636429675137, 452, 0, 452, 0, 0, 0
1590, 1, 1636429674692, 1636429675140, 448, 0, 448, 0, 0, 0
1592, 1, 1636429674804, 1636429675253, 449, 1, 448, 0, 0, 0
1593, 1, 1636429674869, 1636429675316, 447, 0, 447, 0, 0, 0
1594, 1, 1636429674964, 1636429675408, 444, 1, 443, 0, 0, 0
1595, 1, 1636429675096, 1636429675544, 448, 1, 447, 0, 1, 1
1596, 1, 1636429675253, 1636429675705, 452, 0, 452, 0, 0, 0
1597, 1, 1636429675360, 1636429675808, 448, 1, 447, 0, 0, 0
1598, 1, 1636429675360, 1636429675808, 448, 1, 447, 0, 1, 1
1599, 1, 1636429675472, 1636429675921, 449, 0, 449, 0, 0, 0
1600, 1, 1636429675532, 1636429675981, 449, 0, 449, 0, 0, 0
1601, 1, 1636429675628, 1636429676080, 452, 1, 451, 1, 0, 1
1602, 1, 1636429675764, 1636429676208, 444, 1, 443, 0, 1, 1
1603, 1, 1636429675925, 1636429676373, 448, 0, 448, 0, 0, 0
1604, 1, 1636429676028, 1636429676477, 449, 1, 448, 0, 1, 1
1605, 1, 1636429676032, 1636429676477, 445, 1, 444, 0, 1, 1
1606, 1, 1636429676141, 1636429676592, 451, 0, 451, 0, 0, 0
1607, 1, 1636429676204, 1636429676657, 453, 1, 452, 0, 0, 0
1608, 1, 1636429676296, 1636429676748, 452, 0, 452, 0, 0, 0
1609, 1, 1636429676428, 1636429676884, 456, 1, 455, 0, 0, 0
1610, 1, 1636429676597, 1636429677049, 452, 0, 452, 0, 0, 0
1611, 1, 1636429676701, 1636429677145, 444, 0, 444, 0, 0, 0
1612, 1, 1636429676708, 1636429677161, 453, 0, 453, 0, 0, 0
1613, 1, 1636429676812, 1636429677257, 445, 1, 444, 0, 0, 0
1614, 1, 1636429676876, 1636429677324, 448, 1, 447, 0, 0, 0
1615, 1, 1636429676965, 1636429677408, 443, 0, 443, 0, 0, 0
1616, 1, 1636429677108, 1636429677561, 453, 1, 452, 0, 0, 0
1617, 1, 1636429677273, 1636429677721, 448, 0, 448, 0, 0, 0
1618, 1, 1636429677360, 1636429677805, 445, 1, 444, 0, 1, 1
1619, 1, 1636429677385, 1636429677837, 452, 0, 452, 0, 0, 0
1620, 1, 1636429677476, 1636429677925, 449, 1, 448, 0, 1, 1
1621, 1, 1636429677540, 1636429677977, 437, 0, 437, 0, 0, 0
1622, 1, 1636429677624, 1636429678068, 444, 1, 443, 0, 0, 0
1623, 1, 1636429677780, 1636429678232, 452, 1, 451, 0, 0, 0
1624, 1, 1636429677945, 1636429678393, 448, 0, 448, 0, 0, 0
1625, 1, 1636429678033, 1636429678493, 460, 0, 460, 0, 0, 0
1626, 1, 1636429678060, 1636429678517, 457, 1, 456, 0, 0, 0
1627, 1, 1636429678149, 1636429678605, 456, 0, 456, 0, 0, 0
1628, 1, 1636429678200, 1636429678641, 441, 1, 440, 0, 0, 0
1629, 1, 1636429678300, 1636429678745, 445, 1, 444, 1, 0, 1
1630, 1, 1636429678452, 1636429678900, 448, 1, 447, 0, 1, 1
1631, 1, 1636429678621, 1636429679069, 448, 0, 448, 0, 0, 0
1632, 1, 1636429678709, 1636429679152, 443, 0, 443, 0, 0, 0
1633, 1, 1636429678741, 1636429679196, 455, 0, 455, 0, 0, 0
1634, 1, 1636429678825, 1636429679277, 452, 0, 452, 0, 0, 0
1635, 1, 1636429678860, 1636429679309, 449, 0, 449, 0, 0, 0
1636, 1, 1636429678976, 1636429679429, 453, 1, 452, 0, 1, 1
1637, 1, 1636429679124, 1636429679572, 448, 1, 447, 0, 0, 0
1638, 1, 1636429679293, 1636429679745, 452, 0, 452, 0, 0, 0
1639, 1, 1636429679373, 1636429679829, 456, 0, 456, 0, 0, 0
1640, 1, 1636429679409, 1636429679857, 448, 0, 448, 0, 0, 0
1641, 1, 1636429679500, 1636429679953, 453, 1, 452, 0, 0, 0
1642, 1, 1636429679537, 1636429679993, 456, 0, 456, 0, 0, 0
1643, 1, 1636429679652, 1636429680109, 457, 1, 456, 0, 1, 1
1644, 1, 1636429679796, 1636429680244, 448, 1, 447, 0, 0, 0
1645, 1, 1636429679969, 1636429680429, 460, 0, 460, 0, 0, 0
1646, 1, 1636429680048, 1636429680496, 448, 0, 448, 0, 0, 0
1647, 1, 1636429680073, 1636429680521, 448, 0, 448, 0, 0, 0
1648, 1, 1636429680172, 1636429680621, 449, 1, 448, 0, 0, 0
1649, 1, 1636429680221, 1636429680664, 443, 0, 443, 0, 0, 0
1650, 1, 1636429680333, 1636429680876, 543, 97, 446, 96, 0, 96
1651, 1, 1636429680464, 1636429680920, 456, 1, 455, 0, 1, 1
1531, 2, 1636429671064, 1636429681065, 10001, 0, 10001, 1, 0, 1
1652, 1, 1636429680656, 1636429681101, 445, 1, 444, 0, 1, 1
1530, 2, 1636429671064, 1636429681117, 10053, 0, 10053, 1, 0, 1
1653, 1, 1636429680712, 1636429681161, 449, 1, 448, 0, 0, 0
1654, 1, 1636429680741, 1636429681188, 447, 0, 447, 0, 0, 0
1536, 2, 1636429671280, 1636429681281, 10001, 0, 10001, 0, 0, 0
1655, 1, 1636429680845, 1636429681340, 495, 0, 495, 0, 0, 0
1657, 1, 1636429681161, 1636429681616, 455, 0, 455, 0, 0, 0
1658, 1, 1636429681164, 1636429681620, 456, 0, 456, 0, 0, 0
1656, 1, 1636429680884, 1636429681693, 809, 305, 504, 305, 0, 305
1545, 2, 1636429671736, 1636429681737, 10001, 0, 10001, 0, 0, 0
1661, 1, 1636429681376, 1636429681828, 452, 1, 451, 0, 1, 1
1663, 1, 1636429681408, 1636429681856, 448, 0, 448, 0, 0, 0
1548, 2, 1636429671880, 1636429681880, 10000, 0, 10000, 421, 0, 421
1664, 1, 1636429681565, 1636429682053, 488, 0, 488, 0, 0, 0
1662, 1, 1636429681380, 1636429682152, 772, 314, 458, 313, 0, 313
1555, 2, 1636429672201, 1636429682204, 10003, 0, 10003, 0, 0, 0
1556, 2, 1636429672273, 1636429682272, 9999, 0, 9999, 28, 0, 28
1665, 1, 1636429681588, 1636429682293, 705, 241, 464, 241, 0, 241
1666, 1, 1636429681836, 1636429682293, 457, 1, 456, 0, 1, 1
1667, 1, 1636429681836, 1636429682293, 457, 1, 456, 0, 0, 0
1668, 1, 1636429681928, 1636429682373, 445, 0, 445, 0, 0, 0
1671, 1, 1636429682076, 1636429682532, 456, 1, 455, 0, 0, 0
1670, 1, 1636429682060, 1636429682532, 472, 1, 471, 1, 0, 1
1659, 1, 1636429681328, 1636429682616, 1288, 825, 463, 825, 0, 825
1561, 2, 1636429672632, 1636429682632, 10000, 0, 10000, 0, 0, 0
1564, 2, 1636429672776, 1636429682777, 10001, 0, 10001, 0, 0, 0
1673, 1, 1636429682380, 1636429682856, 476, 1, 475, 1, 0, 1
1676, 1, 1636429682516, 1636429683001, 485, 17, 468, 17, 0, 17
1674, 1, 1636429682516, 1636429683001, 485, 1, 484, 1, 0, 1
1675, 1, 1636429682516, 1636429683004, 488, 1, 487, 1, 0, 1
1569, 2, 1636429673081, 1636429683085, 10004, 0, 10004, 0, 0, 0
1680, 1, 1636429682620, 1636429683088, 468, 1, 467, 1, 0, 1
1672, 1, 1636429682316, 1636429683092, 776, 301, 475, 301, 0, 301
1679, 1, 1636429682620, 1636429683092, 472, 1, 471, 1, 0, 1
1678, 1, 1636429682596, 1636429683096, 500, 1, 499, 1, 0, 1
1681, 1, 1636429682756, 1636429683209, 453, 1, 452, 0, 1, 1
1572, 2, 1636429673228, 1636429683232, 10004, 0, 10004, 1, 0, 1
1683, 1, 1636429682872, 1636429683308, 436, 0, 436, 0, 0, 0
1686, 1, 1636429683084, 1636429683548, 464, 5, 459, 5, 0, 5
1682, 1, 1636429682753, 1636429683548, 795, 340, 455, 340, 0, 340
1577, 1, 1636429673456, 1636429683548, 10092, 9629, 463, 0, 9628, 9628
1685, 1, 1636429683080, 1636429683549, 469, 17, 452, 16, 1, 17
1585, 1, 1636429674124, 1636429683680, 9556, 9109, 447, 0, 9109, 9109
1687, 1, 1636429683280, 1636429683724, 444, 1, 443, 1, 0, 1
1688, 1, 1636429683280, 1636429683728, 448, 1, 447, 1, 0, 1
1693, 1, 1636429683324, 1636429683768, 444, 0, 444, 0, 0, 0
1692, 1, 1636429683332, 1636429683772, 440, 1, 439, 0, 1, 1
1691, 1, 1636429683332, 1636429683793, 461, 1, 460, 0, 1, 1
1690, 1, 1636429683332, 1636429683793, 461, 1, 460, 1, 0, 1
1695, 1, 1636429683432, 1636429683884, 452, 0, 452, 0, 0, 0
1696, 1, 1636429683528, 1636429683976, 448, 0, 448, 0, 0, 0
1697, 1, 1636429683536, 1636429683988, 452, 13, 439, 13, 0, 13
1689, 1, 1636429683280, 1636429684128, 848, 401, 447, 401, 0, 401
1698, 1, 1636429683760, 1636429684216, 456, 13, 443, 12, 1, 13
1700, 1, 1636429683768, 1636429684220, 452, 1, 451, 1, 0, 1
1699, 1, 1636429683760, 1636429684240, 480, 34, 446, 33, 1, 34
1703, 1, 1636429683940, 1636429684392, 452, 1, 451, 1, 0, 1
1704, 1, 1636429683940, 1636429684392, 452, 1, 451, 0, 0, 0
1705, 1, 1636429683984, 1636429684429, 445, 0, 445, 0, 0, 0
1702, 1, 1636429683896, 1636429684432, 536, 93, 443, 93, 0, 93
1706, 1, 1636429683992, 1636429684440, 448, 0, 448, 0, 0, 0
1708, 1, 1636429684020, 1636429684480, 460, 1, 459, 0, 1, 1
1707, 1, 1636429684020, 1636429684480, 460, 1, 459, 0, 1, 1
1710, 1, 1636429684205, 1636429684656, 451, 0, 451, 0, 0, 0
1711, 1, 1636429684205, 1636429684688, 483, 36, 447, 36, 0, 36
1712, 1, 1636429684356, 1636429684816, 460, 0, 460, 0, 0, 0
1709, 1, 1636429684100, 1636429684844, 744, 293, 451, 293, 0, 293
1714, 1, 1636429684436, 1636429684877, 441, 0, 441, 0, 0, 0
1713, 1, 1636429684432, 1636429684880, 448, 9, 439, 8, 1, 9
1715, 1, 1636429684452, 1636429684928, 476, 29, 447, 29, 0, 29
1716, 1, 1636429684616, 1636429685060, 444, 1, 443, 0, 1, 1
1718, 1, 1636429684644, 1636429685097, 453, 0, 453, 0, 0, 0
1720, 1, 1636429684660, 1636429685112, 452, 0, 452, 0, 0, 0
1719, 1, 1636429684656, 1636429685144, 488, 33, 455, 33, 0, 33
1722, 1, 1636429684700, 1636429685152, 452, 1, 451, 1, 0, 1
1721, 1, 1636429684700, 1636429685153, 453, 1, 452, 1, 0, 1
1717, 1, 1636429684616, 1636429685296, 680, 229, 451, 229, 0, 229
1723, 1, 1636429684872, 1636429685328, 456, 1, 455, 0, 1, 1
1724, 1, 1636429684904, 1636429685392, 488, 30, 458, 30, 0, 30
1725, 1, 1636429685037, 1636429685489, 452, 0, 452, 0, 0, 0
1726, 1, 1636429685068, 1636429685549, 481, 29, 452, 29, 0, 29
1728, 1, 1636429685096, 1636429685572, 476, 17, 459, 16, 0, 16
1729, 1, 1636429685164, 1636429685624, 460, 1, 459, 1, 0, 1
1730, 1, 1636429685280, 1636429685728, 448, 1, 447, 0, 0, 0
1731, 1, 1636429685317, 1636429685765, 448, 0, 448, 0, 0, 0
1732, 1, 1636429685336, 1636429685788, 452, 1, 451, 0, 0, 0
1734, 1, 1636429685372, 1636429685825, 453, 1, 452, 1, 0, 1
1735, 1, 1636429685372, 1636429685828, 456, 1, 455, 1, 0, 1
1733, 1, 1636429685364, 1636429685844, 480, 29, 451, 29, 0, 29
1737, 1, 1636429685548, 1636429686000, 452, 1, 451, 0, 0, 0
1738, 1, 1636429685620, 1636429686073, 453, 5, 448, 5, 0, 5
1740, 1, 1636429685773, 1636429686220, 447, 0, 447, 0, 0, 0
1741, 1, 1636429685800, 1636429686252, 452, 0, 452, 0, 0, 0
1742, 1, 1636429685844, 1636429686293, 449, 1, 448, 0, 1, 1
1743, 1, 1636429685952, 1636429686404, 452, 1, 451, 0, 0, 0
1744, 1, 1636429685989, 1636429686441, 452, 0, 452, 0, 0, 0
1747, 1, 1636429686048, 1636429686492, 444, 1, 443, 0, 1, 1
1746, 1, 1636429686044, 1636429686492, 448, 1, 447, 1, 0, 1
1748, 1, 1636429686072, 1636429686529, 457, 1, 456, 0, 0, 0
1750, 1, 1636429686293, 1636429686744, 451, 0, 451, 0, 0, 0
1751, 1, 1636429686441, 1636429686889, 448, 0, 448, 0, 0, 0
1749, 1, 1636429686224, 1636429686956, 732, 269, 463, 268, 0, 268
1753, 1, 1636429686509, 1636429686960, 451, 0, 451, 0, 0, 0
1754, 1, 1636429686624, 1636429687084, 460, 0, 460, 0, 0, 0
1755, 1, 1636429686668, 1636429687116, 448, 0, 448, 0, 0, 0
1757, 1, 1636429686721, 1636429687172, 451, 1, 450, 0, 0, 0
1756, 1, 1636429686721, 1636429687172, 451, 1, 450, 0, 0, 0
1758, 1, 1636429686752, 1636429687209, 457, 0, 457, 0, 0, 0
1759, 1, 1636429686968, 1636429687421, 453, 0, 453, 0, 0, 0
1760, 1, 1636429687108, 1636429687561, 453, 0, 453, 0, 0, 0
1762, 1, 1636429687176, 1636429687620, 444, 0, 444, 0, 0, 0
1761, 1, 1636429687172, 1636429687629, 457, 1, 456, 0, 0, 0
1763, 1, 1636429687305, 1636429687761, 456, 0, 456, 0, 0, 0
1764, 1, 1636429687337, 1636429687789, 452, 0, 452, 0, 0, 0
1765, 1, 1636429687392, 1636429687845, 453, 1, 452, 0, 0, 0
1766, 1, 1636429687428, 1636429687876, 448, 1, 447, 0, 1, 1
1767, 1, 1636429687645, 1636429688097, 452, 0, 452, 0, 0, 0
1768, 1, 1636429687784, 1636429688232, 448, 1, 447, 0, 0, 0
1769, 1, 1636429687845, 1636429688297, 452, 1, 451, 0, 0, 0
1771, 1, 1636429687976, 1636429688428, 452, 0, 452, 0, 0, 0
1772, 1, 1636429688008, 1636429688456, 448, 1, 447, 0, 0, 0
1773, 1, 1636429688073, 1636429688529, 456, 0, 456, 0, 0, 0
1774, 1, 1636429688097, 1636429688549, 452, 1, 451, 0, 0, 0
1775, 1, 1636429688320, 1636429688769, 449, 1, 448, 0, 0, 0
1776, 1, 1636429688452, 1636429688889, 437, 1, 436, 0, 0, 0
1777, 1, 1636429688512, 1636429688981, 469, 17, 452, 16, 0, 16
1778, 1, 1636429688648, 1636429689097, 449, 1, 448, 0, 0, 0
1779, 1, 1636429688681, 1636429689129, 448, 0, 448, 0, 0, 0
1780, 1, 1636429688744, 1636429689193, 449, 1, 448, 0, 0, 0
1781, 1, 1636429688769, 1636429689221, 452, 1, 451, 0, 1, 1
1782, 1, 1636429688997, 1636429689444, 447, 0, 447, 0, 0, 0
1783, 1, 1636429689112, 1636429689569, 457, 1, 456, 0, 0, 0
1784, 1, 1636429689201, 1636429689653, 452, 0, 452, 0, 0, 0
1785, 1, 1636429689325, 1636429689776, 451, 0, 451, 0, 0, 0
1786, 1, 1636429689349, 1636429689809, 460, 0, 460, 0, 0, 0
1787, 1, 1636429689417, 1636429689869, 452, 0, 452, 0, 0, 0
1788, 1, 1636429689441, 1636429689904, 463, 4, 459, 4, 0, 4
1789, 1, 1636429689664, 1636429690117, 453, 1, 452, 0, 0, 0
1790, 1, 1636429689792, 1636429690245, 453, 1, 452, 0, 0, 0
1791, 1, 1636429689869, 1636429690321, 452, 1, 451, 0, 0, 0
1793, 1, 1636429690029, 1636429690481, 452, 0, 452, 0, 0, 0
1794, 1, 1636429690097, 1636429690541, 444, 0, 444, 0, 0, 0
1792, 1, 1636429689992, 1636429690569, 577, 125, 452, 124, 0, 124
1796, 1, 1636429690332, 1636429690780, 448, 0, 448, 0, 0, 0
1798, 1, 1636429690545, 1636429691000, 455, 0, 455, 0, 0, 0
1795, 1, 1636429690124, 1636429691021, 897, 446, 451, 445, 0, 445
1799, 1, 1636429690700, 1636429691153, 453, 0, 453, 0, 0, 0
1800, 1, 1636429690764, 1636429691221, 457, 1, 456, 0, 1, 1
1801, 1, 1636429690788, 1636429691236, 448, 0, 448, 0, 0, 0
1660, 2, 1636429681380, 1636429691381, 10001, 0, 10001, 913, 0, 913
1802, 1, 1636429690996, 1636429691457, 461, 5, 456, 4, 0, 4
1804, 1, 1636429691240, 1636429691696, 456, 0, 456, 0, 0, 0
1803, 1, 1636429691221, 1636429691696, 475, 1, 474, 0, 0, 0
1805, 1, 1636429691377, 1636429691832, 455, 0, 455, 0, 0, 0
1806, 1, 1636429691473, 1636429691932, 459, 0, 459, 0, 0, 0
1807, 1, 1636429691473, 1636429691932, 459, 0, 459, 0, 0, 0
1669, 2, 1636429682068, 1636429692065, 9997, 0, 9997, 224, 0, 224
1808, 1, 1636429691676, 1636429692149, 473, 21, 452, 21, 0, 21
1809, 1, 1636429691916, 1636429692381, 465, 17, 448, 17, 0, 17
1810, 1, 1636429691916, 1636429692381, 465, 1, 464, 0, 1, 1
1811, 1, 1636429692052, 1636429692500, 448, 1, 447, 0, 0, 0
1677, 2, 1636429682536, 1636429692541, 10005, 0, 10005, 0, 0, 0
1812, 1, 1636429692153, 1636429692609, 456, 0, 456, 0, 0, 0
1813, 1, 1636429692153, 1636429692609, 456, 0, 456, 0, 0, 0
1814, 1, 1636429692373, 1636429692856, 483, 8, 475, 8, 0, 8
1684, 2, 1636429682956, 1636429692961, 10005, 0, 10005, 0, 0, 0
1815, 1, 1636429692633, 1636429693085, 452, 1, 451, 0, 1, 1
1818, 1, 1636429692633, 1636429693088, 455, 1, 454, 1, 0, 1
1817, 1, 1636429692633, 1636429693088, 455, 1, 454, 0, 0, 0
1819, 1, 1636429692720, 1636429693193, 473, 0, 473, 0, 0, 0
1821, 1, 1636429692832, 1636429693285, 453, 1, 452, 0, 0, 0
1820, 1, 1636429692832, 1636429693288, 456, 1, 455, 0, 0, 0
1694, 2, 1636429683408, 1636429693412, 10004, 0, 10004, 0, 0, 0
1822, 1, 1636429692840, 1636429693544, 704, 245, 459, 245, 0, 245
1823, 1, 1636429693080, 1636429693544, 464, 9, 455, 9, 0, 9
1825, 1, 1636429693305, 1636429693761, 456, 0, 456, 0, 0, 0
1826, 1, 1636429693312, 1636429693768, 456, 1, 455, 0, 0, 0
1701, 2, 1636429683768, 1636429693769, 10001, 0, 10001, 1, 0, 1
1827, 1, 1636429693312, 1636429693772, 460, 1, 459, 1, 0, 1
1828, 1, 1636429693456, 1636429693900, 444, 0, 444, 0, 0, 0
1830, 1, 1636429693508, 1636429693989, 481, 0, 481, 0, 0, 0
1832, 1, 1636429693764, 1636429694212, 448, 1, 447, 0, 0, 0
1797, 1, 1636429690468, 1636429694221, 3753, 3301, 452, 0, 3300, 3300
1829, 1, 1636429693500, 1636429694221, 721, 269, 452, 269, 0, 269
1833, 1, 1636429693761, 1636429694228, 467, 12, 455, 12, 0, 12
1834, 1, 1636429693981, 1636429694436, 455, 0, 455, 0, 0, 0
1835, 1, 1636429693989, 1636429694444, 455, 0, 455, 0, 0, 0
1839, 1, 1636429694208, 1636429694656, 448, 1, 447, 0, 0, 0
1836, 1, 1636429693989, 1636429694680, 691, 233, 458, 232, 1, 233
1840, 1, 1636429694432, 1636429694893, 461, 5, 456, 4, 0, 4
1841, 1, 1636429694444, 1636429694896, 452, 1, 451, 1, 0, 1
1842, 1, 1636429694444, 1636429694900, 456, 1, 455, 0, 1, 1
1844, 1, 1636429694652, 1636429695101, 449, 1, 448, 0, 1, 1
1727, 2, 1636429685100, 1636429695101, 10001, 0, 10001, 449, 0, 449
1845, 1, 1636429694664, 1636429695108, 444, 1, 443, 0, 0, 0
1843, 1, 1636429694444, 1636429695141, 697, 237, 460, 236, 0, 236
1846, 1, 1636429694876, 1636429695328, 452, 1, 451, 0, 0, 0
1847, 1, 1636429694896, 1636429695356, 460, 5, 455, 5, 0, 5
1736, 2, 1636429685520, 1636429695525, 10005, 0, 10005, 29, 0, 29
1849, 1, 1636429695148, 1636429695596, 448, 1, 447, 1, 0, 1
1848, 1, 1636429695148, 1636429695600, 452, 1, 451, 1, 0, 1
1850, 1, 1636429695148, 1636429695600, 452, 1, 451, 1, 0, 1
1739, 2, 1636429685712, 1636429695712, 10000, 0, 10000, 0, 0, 0
1852, 1, 1636429695324, 1636429695772, 448, 1, 447, 0, 0, 0
1853, 1, 1636429695352, 1636429695840, 488, 5, 483, 5, 0, 5
1745, 2, 1636429686008, 1636429696009, 10001, 0, 10001, 0, 0, 0
1854, 1, 1636429695572, 1636429696025, 453, 1, 452, 0, 1, 1
1855, 1, 1636429695572, 1636429696052, 480, 29, 451, 29, 0, 29
1856, 1, 1636429695816, 1636429696269, 453, 1, 452, 0, 0, 0
1859, 1, 1636429695896, 1636429696349, 453, 1, 452, 0, 0, 0
1860, 1, 1636429695896, 1636429696352, 456, 1, 455, 0, 0, 0
1861, 1, 1636429695988, 1636429696436, 448, 1, 447, 0, 1, 1
1752, 2, 1636429686472, 1636429696473, 10001, 0, 10001, 0, 0, 0
1863, 1, 1636429696056, 1636429696508, 452, 1, 451, 0, 1, 1
1862, 1, 1636429696056, 1636429696508, 452, 1, 451, 1, 0, 1
1864, 1, 1636429696249, 1636429696700, 451, 0, 451, 0, 0, 0
1866, 1, 1636429696312, 1636429696800, 488, 37, 451, 37, 0, 37
1867, 1, 1636429696520, 1636429696972, 452, 0, 452, 0, 0, 0
1868, 1, 1636429696572, 1636429697016, 444, 1, 443, 0, 0, 0
1869, 1, 1636429696580, 1636429697020, 440, 1, 439, 1, 0, 1
1870, 1, 1636429696652, 1636429697101, 449, 1, 448, 0, 1, 1
1872, 1, 1636429696729, 1636429697185, 456, 0, 456, 0, 0, 0
1873, 1, 1636429696772, 1636429697249, 477, 28, 449, 28, 0, 28
1874, 1, 1636429696921, 1636429697373, 452, 0, 452, 0, 0, 0
1875, 1, 1636429697016, 1636429697461, 445, 5, 440, 5, 0, 5
1876, 1, 1636429697192, 1636429697640, 448, 0, 448, 0, 0, 0
1877, 1, 1636429697236, 1636429697684, 448, 1, 447, 0, 0, 0
1878, 1, 1636429697240, 1636429697684, 444, 1, 443, 0, 1, 1
1770, 2, 1636429687848, 1636429697849, 10001, 0, 10001, 0, 0, 0
1881, 1, 1636429697468, 1636429697916, 448, 1, 447, 0, 1, 1
1882, 1, 1636429697593, 1636429698076, 483, 0, 483, 0, 0, 0
1883, 1, 1636429697681, 1636429698168, 487, 4, 483, 4, 0, 4
1884, 1, 1636429697896, 1636429698340, 444, 1, 443, 0, 1, 1
1885, 1, 1636429697940, 1636429698384, 444, 1, 443, 0, 0, 0
1886, 1, 1636429697937, 1636429698385, 448, 0, 448, 0, 0, 0
1888, 1, 1636429698156, 1636429698605, 449, 1, 448, 1, 0, 1
1887, 1, 1636429698140, 1636429698620, 480, 29, 451, 28, 0, 28
1889, 1, 1636429698297, 1636429698748, 451, 0, 451, 0, 0, 0
1890, 1, 1636429698384, 1636429698840, 456, 1, 455, 0, 0, 0
1891, 1, 1636429698560, 1636429699016, 456, 0, 456, 0, 0, 0
1893, 1, 1636429698604, 1636429699057, 453, 1, 452, 1, 0, 1
1892, 1, 1636429698604, 1636429699057, 453, 2, 451, 0, 0, 0
1894, 1, 1636429698828, 1636429699277, 449, 1, 448, 0, 1, 1
1895, 1, 1636429698836, 1636429699288, 452, 5, 447, 4, 0, 4
1896, 1, 1636429698969, 1636429699412, 443, 0, 443, 0, 0, 0
1897, 1, 1636429699060, 1636429699501, 441, 0, 441, 0, 0, 0
1898, 1, 1636429699236, 1636429699680, 444, 0, 444, 0, 0, 0
1900, 1, 1636429699280, 1636429699728, 448, 1, 447, 0, 1, 1
1899, 1, 1636429699280, 1636429699728, 448, 1, 447, 0, 0, 0
1901, 1, 1636429699500, 1636429699945, 445, 1, 444, 0, 1, 1
1902, 1, 1636429699500, 1636429699956, 456, 1, 455, 1, 0, 1
1903, 1, 1636429699632, 1636429700077, 445, 0, 445, 0, 0, 0
1904, 1, 1636429699716, 1636429700177, 461, 13, 448, 13, 0, 13
1905, 1, 1636429699896, 1636429700344, 448, 1, 447, 0, 0, 0
1906, 1, 1636429699948, 1636429700401, 453, 1, 452, 0, 0, 0
1907, 1, 1636429699952, 1636429700409, 457, 1, 456, 0, 1, 1
1908, 1, 1636429700168, 1636429700617, 449, 0, 449, 0, 0, 0
1909, 1, 1636429700177, 1636429700620, 443, 0, 443, 0, 0, 0
1911, 1, 1636429700401, 1636429700848, 447, 1, 446, 0, 1, 1
1912, 1, 1636429700565, 1636429701016, 451, 0, 451, 0, 0, 0
1914, 1, 1636429700624, 1636429701072, 448, 1, 447, 0, 0, 0
1913, 1, 1636429700624, 1636429701076, 452, 1, 451, 1, 0, 1
1915, 1, 1636429700836, 1636429701285, 449, 1, 448, 1, 0, 1
1916, 1, 1636429700836, 1636429701305, 469, 13, 456, 13, 0, 13
1917, 1, 1636429701068, 1636429701525, 457, 9, 448, 9, 0, 9
1918, 1, 1636429701237, 1636429701680, 443, 0, 443, 0, 0, 0
1919, 1, 1636429701293, 1636429701732, 439, 0, 439, 0, 0, 0
1920, 1, 1636429701297, 1636429701736, 439, 0, 439, 0, 0, 0
1921, 1, 1636429701505, 1636429701953, 448, 0, 448, 0, 0, 0
1922, 1, 1636429701525, 1636429701977, 452, 1, 451, 0, 0, 0
1923, 1, 1636429701752, 1636429702201, 449, 1, 448, 0, 0, 0
1924, 1, 1636429701901, 1636429702349, 448, 0, 448, 0, 0, 0
1925, 1, 1636429701952, 1636429702409, 457, 1, 456, 0, 0, 0
1926, 1, 1636429701961, 1636429702421, 460, 0, 460, 0, 0, 0
1927, 1, 1636429702173, 1636429702625, 452, 0, 452, 0, 0, 0
1816, 2, 1636429692633, 1636429702633, 10000, 0, 10000, 912, 0, 912
1928, 1, 1636429702200, 1636429702653, 453, 1, 452, 0, 0, 0
1929, 1, 1636429702429, 1636429702884, 455, 0, 455, 0, 0, 0
1930, 1, 1636429702573, 1636429703033, 460, 0, 460, 0, 0, 0
1931, 1, 1636429702628, 1636429703080, 452, 1, 451, 0, 0, 0
1932, 1, 1636429702680, 1636429703129, 449, 1, 448, 0, 0, 0
1824, 2, 1636429693260, 1636429703261, 10001, 0, 10001, 285, 0, 285
1933, 1, 1636429702848, 1636429703300, 452, 1, 451, 0, 0, 0
1934, 1, 1636429702881, 1636429703337, 456, 4, 452, 4, 0, 4
1935, 1, 1636429703109, 1636429703584, 475, 20, 455, 20, 0, 20
1936, 1, 1636429703253, 1636429703705, 452, 0, 452, 0, 0, 0
1831, 2, 1636429693709, 1636429703708, 9999, 0, 9999, 0, 0, 0
1937, 1, 1636429703308, 1636429703756, 448, 1, 447, 0, 0, 0
1938, 1, 1636429703352, 1636429703796, 444, 1, 443, 0, 1, 1
1939, 1, 1636429703520, 1636429703972, 452, 1, 451, 0, 0, 0
1940, 1, 1636429703560, 1636429704033, 473, 25, 448, 25, 0, 25
1837, 2, 1636429694080, 1636429704085, 10005, 0, 10005, 0, 0, 0
1838, 2, 1636429694117, 1636429704133, 10016, 0, 10016, 0, 0, 0
1941, 1, 1636429703808, 1636429704256, 448, 0, 448, 0, 0, 0
1945, 1, 1636429703976, 1636429704452, 476, 0, 476, 0, 0, 0
1944, 1, 1636429703921, 1636429704456, 535, 0, 535, 0, 0, 0
1947, 1, 1636429704012, 1636429704541, 529, 1, 528, 0, 0, 0
1948, 1, 1636429704224, 1636429704681, 457, 0, 457, 0, 0, 0
1949, 1, 1636429704268, 1636429704716, 448, 1, 447, 0, 0, 0
1951, 1, 1636429704428, 1636429704880, 452, 1, 451, 0, 0, 0
1952, 1, 1636429704480, 1636429704993, 513, 61, 452, 60, 0, 60
1953, 1, 1636429704673, 1636429705125, 452, 0, 452, 0, 0, 0
1954, 1, 1636429704681, 1636429705128, 447, 0, 447, 0, 0, 0
1851, 2, 1636429695316, 1636429705320, 10004, 0, 10004, 0, 0, 0
1956, 1, 1636429704904, 1636429705356, 452, 0, 452, 0, 0, 0
1957, 1, 1636429704933, 1636429705444, 511, 61, 450, 60, 0, 60
1958, 1, 1636429705101, 1636429705552, 451, 0, 451, 0, 0, 0
1960, 1, 1636429705368, 1636429705817, 449, 1, 448, 1, 0, 1
1961, 1, 1636429705368, 1636429705821, 453, 1, 452, 0, 0, 0
1857, 2, 1636429695820, 1636429705821, 10001, 0, 10001, 1, 0, 1
1858, 2, 1636429695820, 1636429705864, 10044, 0, 10044, 0, 0, 0
1962, 1, 1636429705580, 1636429706084, 504, 0, 504, 0, 0, 0
1963, 1, 1636429705620, 1636429706088, 468, 1, 467, 0, 0, 0
1865, 2, 1636429696281, 1636429706277, 9996, 0, 9996, 0, 0, 0
1966, 1, 1636429706040, 1636429706500, 460, 1, 459, 0, 0, 0
1967, 1, 1636429706040, 1636429706500, 460, 1, 459, 0, 1, 1
1969, 1, 1636429706132, 1636429706589, 457, 1, 456, 1, 0, 1
1968, 1, 1636429706128, 1636429706592, 464, 1, 463, 0, 1, 1
1871, 2, 1636429696729, 1636429706728, 9999, 0, 9999, 0, 0, 0
1970, 1, 1636429706324, 1636429706773, 449, 1, 448, 1, 0, 1
1971, 1, 1636429706324, 1636429706780, 456, 1, 455, 0, 0, 0
1972, 1, 1636429706589, 1636429707044, 455, 0, 455, 0, 0, 0
1973, 1, 1636429706720, 1636429707169, 449, 1, 448, 0, 0, 0
1974, 1, 1636429706724, 1636429707173, 449, 0, 449, 0, 0, 0
1975, 1, 1636429706821, 1636429707276, 455, 0, 455, 0, 0, 0
1879, 2, 1636429697325, 1636429707321, 9996, 0, 9996, 0, 0, 0
1880, 2, 1636429697409, 1636429707409, 10000, 0, 10000, 0, 0, 0
1978, 1, 1636429706996, 1636429707452, 456, 1, 455, 0, 0, 0
1979, 1, 1636429707040, 1636429707496, 456, 5, 451, 5, 0, 5
1982, 1, 1636429707456, 1636429707901, 445, 1, 444, 0, 1, 1
1981, 1, 1636429707456, 1636429707908, 452, 1, 451, 0, 0, 0
1983, 1, 1636429707496, 1636429707944, 448, 1, 447, 0, 1, 1
1984, 1, 1636429707664, 1636429708116, 452, 0, 452, 0, 0, 0
1985, 1, 1636429707672, 1636429708129, 457, 0, 457, 0, 0, 0
1987, 1, 1636429707716, 1636429708160, 444, 0, 444, 0, 0, 0
1988, 1, 1636429708129, 1636429708581, 452, 0, 452, 0, 0, 0
1989, 1, 1636429708129, 1636429708584, 455, 0, 455, 0, 0, 0
1990, 1, 1636429708168, 1636429708625, 457, 1, 456, 0, 1, 1
1991, 1, 1636429708332, 1636429708784, 452, 1, 451, 1, 0, 1
1993, 1, 1636429708804, 1636429709253, 449, 1, 448, 0, 1, 1
1994, 1, 1636429708808, 1636429709265, 457, 0, 457, 0, 0, 0
1995, 1, 1636429708848, 1636429709296, 448, 1, 447, 0, 0, 0
1996, 1, 1636429708996, 1636429709449, 453, 1, 452, 0, 1, 1
1997, 1, 1636429709476, 1636429709925, 449, 1, 448, 0, 0, 0
1998, 1, 1636429709489, 1636429709945, 456, 0, 456, 0, 0, 0
1999, 1, 1636429709517, 1636429709969, 452, 0, 452, 0, 0, 0
2000, 1, 1636429709673, 1636429710121, 448, 0, 448, 0, 0, 0
1910, 2, 1636429700296, 1636429710301, 10005, 0, 10005, 0, 0, 0
2002, 1, 1636429710168, 1636429710616, 448, 1, 447, 0, 1, 1
2001, 1, 1636429710148, 1636429710616, 468, 0, 468, 0, 0, 0
2003, 1, 1636429710192, 1636429710640, 448, 1, 447, 0, 1, 1
1965, 1, 1636429705773, 1636429710752, 4979, 4528, 451, 0, 4528, 4528
2004, 1, 1636429710348, 1636429710801, 453, 1, 452, 0, 1, 1
2005, 1, 1636429710604, 1636429711052, 448, 0, 448, 0, 0, 0
2007, 1, 1636429710836, 1636429711288, 452, 1, 451, 0, 0, 0
2006, 1, 1636429710836, 1636429711292, 456, 1, 455, 0, 0, 0
2008, 1, 1636429710860, 1636429711317, 457, 0, 457, 0, 0, 0
2009, 1, 1636429710972, 1636429711421, 449, 0, 449, 0, 0, 0
2010, 1, 1636429711012, 1636429711461, 449, 0, 449, 0, 0, 0
2012, 1, 1636429711504, 1636429711957, 453, 1, 452, 0, 0, 0
2013, 1, 1636429711508, 1636429711969, 461, 1, 460, 0, 1, 1
2014, 1, 1636429711545, 1636429712001, 456, 0, 456, 0, 0, 0
2015, 1, 1636429711681, 1636429712133, 452, 0, 452, 0, 0, 0
2016, 1, 1636429712180, 1636429712637, 457, 0, 457, 0, 0, 0
2017, 1, 1636429712196, 1636429712648, 452, 1, 451, 0, 0, 0
2018, 1, 1636429712221, 1636429712684, 463, 0, 463, 0, 0, 0
2019, 1, 1636429712356, 1636429712801, 445, 0, 445, 0, 0, 0
2020, 1, 1636429712860, 1636429713305, 445, 1, 444, 0, 0, 0
2021, 1, 1636429712873, 1636429713325, 452, 0, 452, 0, 0, 0
2022, 1, 1636429712904, 1636429713349, 445, 1, 444, 0, 1, 1
2023, 1, 1636429713024, 1636429713473, 449, 0, 449, 0, 0, 0
1943, 2, 1636429703884, 1636429713885, 10001, 0, 10001, 0, 0, 0
1942, 2, 1636429703884, 1636429713928, 10044, 0, 10044, 0, 0, 0
2024, 1, 1636429713528, 1636429713976, 448, 0, 448, 0, 0, 0
2025, 1, 1636429713549, 1636429714000, 451, 0, 451, 0, 0, 0
1946, 2, 1636429704016, 1636429714016, 10000, 0, 10000, 0, 0, 0
2026, 1, 1636429713572, 1636429714032, 460, 1, 459, 0, 1, 1
2027, 1, 1636429713692, 1636429714160, 468, 0, 468, 0, 0, 0
1950, 1, 1636429704401, 1636429714465, 10064, 9616, 448, 0, 9616, 9616
2028, 1, 1636429714188, 1636429714633, 445, 1, 444, 1, 0, 1
2030, 1, 1636429714196, 1636429714636, 440, 1, 439, 0, 1, 1
2031, 1, 1636429714221, 1636429714673, 452, 0, 452, 0, 0, 0
2032, 1, 1636429714248, 1636429714697, 449, 1, 448, 0, 0, 0
1955, 2, 1636429704760, 1636429714765, 10005, 0, 10005, 0, 0, 0
2034, 1, 1636429714377, 1636429714821, 444, 0, 444, 0, 0, 0
1959, 2, 1636429705213, 1636429715217, 10004, 0, 10004, 0, 0, 0
2037, 1, 1636429714856, 1636429715309, 453, 1, 452, 0, 1, 1
2036, 1, 1636429714856, 1636429715309, 453, 1, 452, 0, 0, 0
2038, 1, 1636429714888, 1636429715336, 448, 1, 447, 0, 0, 0
2039, 1, 1636429714944, 1636429715389, 445, 0, 445, 0, 0, 0
2040, 1, 1636429715041, 1636429715533, 492, 0, 492, 0, 0, 0
2041, 1, 1636429715073, 1636429715536, 463, 0, 463, 0, 0, 0
1964, 2, 1636429705661, 1636429715657, 9996, 0, 9996, 0, 0, 0
2044, 1, 1636429715532, 1636429715989, 457, 1, 456, 0, 0, 0
2042, 1, 1636429715524, 1636429715989, 465, 13, 452, 13, 0, 13
2045, 1, 1636429715552, 1636429716000, 448, 0, 448, 0, 0, 0
2046, 1, 1636429715612, 1636429716061, 449, 0, 449, 0, 0, 0
2048, 1, 1636429715756, 1636429716209, 453, 0, 453, 0, 0, 0
2049, 1, 1636429715972, 1636429716449, 477, 18, 459, 16, 0, 16
2050, 1, 1636429716212, 1636429716660, 448, 1, 447, 0, 1, 1
2051, 1, 1636429716212, 1636429716661, 449, 0, 449, 0, 0, 0
2052, 1, 1636429716228, 1636429716676, 448, 1, 447, 0, 0, 0
1976, 2, 1636429706821, 1636429716821, 10000, 0, 10000, 0, 0, 0
2054, 1, 1636429716429, 1636429716881, 452, 0, 452, 0, 0, 0
1977, 2, 1636429706988, 1636429716993, 10005, 0, 10005, 0, 0, 0
2055, 1, 1636429716668, 1636429717137, 469, 1, 468, 0, 0, 0
1980, 2, 1636429707260, 1636429717264, 10004, 0, 10004, 0, 0, 0
2058, 1, 1636429716912, 1636429717405, 493, 1, 492, 0, 0, 0
2056, 1, 1636429716912, 1636429717405, 493, 1, 492, 0, 0, 0
2057, 1, 1636429716912, 1636429717405, 493, 1, 492, 1, 0, 1
2060, 1, 1636429717128, 1636429717585, 457, 1, 456, 0, 1, 1
2059, 1, 1636429717100, 1636429717585, 485, 1, 484, 0, 1, 1
1986, 2, 1636429707712, 1636429717716, 10004, 0, 10004, 0, 0, 0
2061, 1, 1636429717308, 1636429717760, 452, 1, 451, 1, 0, 1
2062, 1, 1636429717360, 1636429717853, 493, 46, 447, 46, 0, 46
2063, 1, 1636429717573, 1636429718049, 476, 13, 463, 12, 1, 13
2064, 1, 1636429717628, 1636429718072, 444, 0, 444, 0, 0, 0
2066, 1, 1636429717628, 1636429718116, 488, 0, 488, 0, 0, 0
2065, 1, 1636429717632, 1636429718117, 485, 0, 485, 0, 0, 0
2067, 1, 1636429717804, 1636429718257, 453, 0, 453, 0, 0, 0
1992, 2, 1636429708353, 1636429718353, 10000, 0, 10000, 0, 0, 0
2068, 1, 1636429717980, 1636429718432, 452, 0, 452, 0, 0, 0
2069, 1, 1636429718024, 1636429718501, 477, 25, 452, 25, 0, 25
2070, 1, 1636429718069, 1636429718577, 508, 48, 460, 48, 0, 48
2072, 1, 1636429718293, 1636429718761, 468, 0, 468, 0, 0, 0
2071, 1, 1636429718273, 1636429718761, 488, 0, 488, 0, 0, 0
2073, 1, 1636429718340, 1636429718793, 453, 1, 452, 0, 0, 0
2074, 1, 1636429718472, 1636429718921, 449, 1, 448, 1, 0, 1
2075, 1, 1636429718653, 1636429719104, 451, 0, 451, 0, 0, 0
2076, 1, 1636429718664, 1636429719112, 448, 1, 447, 0, 0, 0
2077, 1, 1636429718724, 1636429719216, 492, 38, 454, 37, 0, 37
2078, 1, 1636429718984, 1636429719432, 448, 0, 448, 0, 0, 0
2079, 1, 1636429718984, 1636429719440, 456, 0, 456, 0, 0, 0
2080, 1, 1636429719016, 1636429719468, 452, 0, 452, 0, 0, 0
2081, 1, 1636429719141, 1636429719593, 452, 0, 452, 0, 0, 0
2083, 1, 1636429719332, 1636429719785, 453, 1, 452, 0, 1, 1
2082, 1, 1636429719332, 1636429719788, 456, 1, 455, 1, 0, 1
2084, 1, 1636429719436, 1636429719893, 457, 5, 452, 5, 0, 5
2085, 1, 1636429719653, 1636429720100, 447, 0, 447, 0, 0, 0
2086, 1, 1636429719661, 1636429720104, 443, 0, 443, 0, 0, 0
2087, 1, 1636429719689, 1636429720141, 452, 0, 452, 0, 0, 0
2088, 1, 1636429719817, 1636429720273, 456, 0, 456, 0, 0, 0
2089, 1, 1636429720005, 1636429720456, 451, 0, 451, 0, 0, 0
2090, 1, 1636429720113, 1636429720569, 456, 0, 456, 0, 0, 0
2092, 1, 1636429720320, 1636429720764, 444, 1, 443, 1, 0, 1
2091, 1, 1636429720320, 1636429720765, 445, 1, 444, 0, 0, 0
2093, 1, 1636429720364, 1636429720805, 441, 1, 440, 0, 0, 0
2094, 1, 1636429720497, 1636429720953, 456, 0, 456, 0, 0, 0
2095, 1, 1636429720677, 1636429721128, 451, 0, 451, 0, 0, 0
2096, 1, 1636429720789, 1636429721236, 447, 0, 447, 0, 0, 0
2011, 2, 1636429711269, 1636429721269, 10000, 0, 10000, 0, 0, 0
2097, 1, 1636429720984, 1636429721429, 445, 0, 445, 0, 0, 0
2098, 1, 1636429720988, 1636429721432, 444, 1, 443, 0, 1, 1
2099, 1, 1636429721028, 1636429721492, 464, 1, 463, 1, 0, 1
2100, 1, 1636429721172, 1636429721613, 441, 1, 440, 1, 0, 1
2043, 1, 1636429715532, 1636429721720, 6188, 5737, 451, 0, 5736, 5736
2101, 1, 1636429721360, 1636429721804, 444, 1, 443, 0, 0, 0
2102, 1, 1636429721457, 1636429721896, 439, 0, 439, 0, 0, 0
2103, 1, 1636429721577, 1636429722025, 448, 0, 448, 0, 0, 0
2105, 1, 1636429721644, 1636429722092, 448, 1, 447, 0, 0, 0
2104, 1, 1636429721648, 1636429722092, 444, 1, 443, 0, 0, 0
2106, 1, 1636429721712, 1636429722160, 448, 0, 448, 0, 0, 0
2107, 1, 1636429721832, 1636429722284, 452, 1, 451, 0, 1, 1
2108, 1, 1636429721936, 1636429722384, 448, 1, 447, 1, 0, 1
2109, 1, 1636429722025, 1636429722472, 447, 0, 447, 0, 0, 0
2110, 1, 1636429722116, 1636429722568, 452, 0, 452, 0, 0, 0
2111, 1, 1636429722244, 1636429722692, 448, 0, 448, 0, 0, 0
2113, 1, 1636429722312, 1636429722757, 445, 1, 444, 1, 0, 1
2112, 1, 1636429722312, 1636429722757, 445, 1, 444, 0, 0, 0
2114, 1, 1636429722376, 1636429722821, 445, 0, 445, 0, 0, 0
2115, 1, 1636429722500, 1636429722945, 445, 0, 445, 0, 0, 0
2116, 1, 1636429722600, 1636429723048, 448, 0, 448, 0, 0, 0
2117, 1, 1636429722692, 1636429723140, 448, 0, 448, 0, 0, 0
2118, 1, 1636429722789, 1636429723253, 464, 0, 464, 0, 0, 0
2119, 1, 1636429722913, 1636429723361, 448, 0, 448, 0, 0, 0
2121, 1, 1636429722981, 1636429723432, 451, 0, 451, 0, 0, 0
2120, 1, 1636429722981, 1636429723436, 455, 0, 455, 0, 0, 0
2122, 1, 1636429723045, 1636429723489, 444, 0, 444, 0, 0, 0
2123, 1, 1636429723165, 1636429723621, 456, 0, 456, 0, 0, 0
2124, 1, 1636429723273, 1636429723728, 455, 0, 455, 0, 0, 0
2125, 1, 1636429723360, 1636429723816, 456, 1, 455, 0, 0, 0
2126, 1, 1636429723476, 1636429723928, 452, 1, 451, 0, 0, 0
2127, 1, 1636429723585, 1636429724041, 456, 0, 456, 0, 0, 0
2128, 1, 1636429723656, 1636429724096, 440, 1, 439, 0, 0, 0
2129, 1, 1636429723656, 1636429724105, 449, 1, 448, 0, 0, 0
2130, 1, 1636429723708, 1636429724149, 441, 1, 440, 0, 0, 0
2029, 2, 1636429714196, 1636429724193, 9997, 0, 9997, 437, 0, 437
2131, 1, 1636429723840, 1636429724289, 449, 0, 449, 0, 0, 0
2033, 2, 1636429714329, 1636429724329, 10000, 0, 10000, 304, 0, 304
2132, 1, 1636429723948, 1636429724420, 472, 1, 471, 0, 0, 0
2133, 1, 1636429724037, 1636429724552, 515, 0, 515, 0, 0, 0
2134, 1, 1636429724140, 1636429724644, 504, 1, 503, 0, 1, 1
2035, 2, 1636429714684, 1636429724688, 10004, 0, 10004, 0, 0, 0
2135, 1, 1636429724280, 1636429724732, 452, 1, 451, 0, 0, 0
2136, 1, 1636429724317, 1636429724772, 455, 0, 455, 0, 0, 0
2137, 1, 1636429724376, 1636429724816, 440, 1, 439, 1, 0, 1
2138, 1, 1636429724376, 1636429724817, 441, 1, 440, 1, 0, 1
2139, 1, 1636429724504, 1636429725008, 504, 1, 503, 0, 0, 0
2140, 1, 1636429724636, 1636429725109, 473, 0, 473, 0, 0, 0
2141, 1, 1636429724776, 1636429725224, 448, 0, 448, 0, 0, 0
2142, 1, 1636429724860, 1636429725313, 453, 1, 452, 0, 0, 0
2144, 1, 1636429724952, 1636429725405, 453, 0, 453, 0, 0, 0
2146, 1, 1636429724992, 1636429725440, 448, 0, 448, 0, 0, 0
2148, 1, 1636429725032, 1636429725484, 452, 0, 452, 0, 0, 0
2149, 1, 1636429725040, 1636429725485, 445, 1, 444, 0, 1, 1
2150, 1, 1636429725232, 1636429725688, 456, 0, 456, 0, 0, 0
2047, 2, 1636429715756, 1636429725757, 10001, 0, 10001, 0, 0, 0
2151, 1, 1636429725324, 1636429725777, 453, 1, 452, 0, 0, 0
2152, 1, 1636429725444, 1636429725888, 444, 0, 444, 0, 0, 0
2153, 1, 1636429725532, 1636429725984, 452, 0, 452, 0, 0, 0
2154, 1, 1636429725625, 1636429726073, 448, 0, 448, 0, 0, 0
2155, 1, 1636429725660, 1636429726108, 448, 0, 448, 0, 0, 0
2157, 1, 1636429725708, 1636429726169, 461, 1, 460, 0, 0, 0
2156, 1, 1636429725704, 1636429726169, 465, 1, 464, 0, 1, 1
2053, 1, 1636429716285, 1636429726205, 9920, 9472, 448, 0, 9472, 9472
2158, 1, 1636429725936, 1636429726388, 452, 1, 451, 0, 1, 1
2159, 1, 1636429725993, 1636429726441, 448, 0, 448, 0, 0, 0
2160, 1, 1636429726061, 1636429726513, 452, 0, 452, 0, 0, 0
2161, 1, 1636429726125, 1636429726589, 464, 0, 464, 0, 0, 0
2162, 1, 1636429726205, 1636429726656, 451, 0, 451, 0, 0, 0
2163, 1, 1636429726292, 1636429726740, 448, 1, 447, 0, 0, 0
2164, 1, 1636429726332, 1636429726777, 445, 1, 444, 0, 0, 0
2165, 1, 1636429726384, 1636429726841, 457, 4, 453, 4, 0, 4
2166, 1, 1636429726392, 1636429726844, 452, 0, 452, 0, 0, 0
2167, 1, 1636429726428, 1636429726964, 536, 86, 450, 85, 1, 86
2168, 1, 1636429726604, 1636429727048, 444, 1, 443, 0, 1, 1
2169, 1, 1636429726664, 1636429727104, 440, 1, 439, 0, 1, 1
2170, 1, 1636429726736, 1636429727177, 441, 1, 440, 0, 0, 0
2171, 1, 1636429726816, 1636429727269, 453, 1, 452, 0, 0, 0
2172, 1, 1636429726877, 1636429727316, 439, 0, 439, 0, 0, 0
2173, 1, 1636429726956, 1636429727400, 444, 1, 443, 0, 0, 0
2174, 1, 1636429727000, 1636429727444, 444, 1, 443, 0, 1, 1
2176, 1, 1636429727056, 1636429727500, 444, 1, 443, 0, 1, 1
2175, 1, 1636429727052, 1636429727504, 452, 1, 451, 0, 0, 0
2177, 1, 1636429727180, 1636429727624, 444, 1, 443, 1, 0, 1
2178, 1, 1636429727269, 1636429727721, 452, 0, 452, 0, 0, 0
2179, 1, 1636429727324, 1636429727772, 448, 1, 447, 0, 0, 0
2180, 1, 1636429727397, 1636429727841, 444, 0, 444, 0, 0, 0
2181, 1, 1636429727488, 1636429727933, 445, 1, 444, 1, 0, 1
2182, 1, 1636429727532, 1636429727980, 448, 1, 447, 0, 1, 1
2183, 1, 1636429727620, 1636429728072, 452, 0, 452, 0, 0, 0
2184, 1, 1636429727664, 1636429728112, 448, 1, 447, 0, 1, 1
2185, 1, 1636429727720, 1636429728173, 453, 1, 452, 0, 0, 0
2186, 1, 1636429727720, 1636429728173, 453, 1, 452, 0, 0, 0
2187, 1, 1636429727840, 1636429728292, 452, 1, 451, 0, 0, 0
2189, 1, 1636429727992, 1636429728441, 449, 1, 448, 0, 0, 0
2190, 1, 1636429728065, 1636429728509, 444, 0, 444, 0, 0, 0
2188, 1, 1636429727944, 1636429728564, 620, 169, 451, 169, 0, 169
2191, 1, 1636429728152, 1636429728608, 456, 1, 455, 0, 0, 0
2192, 1, 1636429728204, 1636429728645, 441, 1, 440, 0, 0, 0
2193, 1, 1636429728292, 1636429728732, 440, 1, 439, 0, 0, 0
2194, 1, 1636429728333, 1636429728793, 460, 0, 460, 0, 0, 0
2195, 1, 1636429728388, 1636429728836, 448, 1, 447, 0, 0, 0
2197, 1, 1636429728524, 1636429728977, 453, 1, 452, 0, 0, 0
2196, 1, 1636429728392, 1636429729020, 628, 173, 455, 173, 0, 173
2198, 1, 1636429728660, 1636429729112, 452, 1, 451, 0, 0, 0
2199, 1, 1636429728728, 1636429729176, 448, 1, 447, 0, 0, 0
2201, 1, 1636429728832, 1636429729285, 453, 1, 452, 1, 0, 1
2203, 1, 1636429728953, 1636429729408, 455, 0, 455, 0, 0, 0
2204, 1, 1636429729012, 1636429729460, 448, 1, 447, 0, 1, 1
2202, 1, 1636429728864, 1636429729472, 608, 157, 451, 157, 0, 157
2205, 1, 1636429729053, 1636429729508, 455, 0, 455, 0, 0, 0
2206, 1, 1636429729196, 1636429729637, 441, 0, 441, 0, 0, 0
2208, 1, 1636429729332, 1636429729780, 448, 1, 447, 0, 1, 1
2209, 1, 1636429729397, 1636429729844, 447, 0, 447, 0, 0, 0
2210, 1, 1636429729504, 1636429729956, 452, 0, 452, 0, 0, 0
2211, 1, 1636429729629, 1636429730084, 455, 0, 455, 0, 0, 0
2212, 1, 1636429729684, 1636429730136, 452, 0, 452, 0, 0, 0
2214, 1, 1636429729724, 1636429730176, 452, 1, 451, 1, 0, 1
2215, 1, 1636429729857, 1636429730304, 447, 0, 447, 0, 0, 0
2216, 1, 1636429730004, 1636429730449, 445, 1, 444, 1, 0, 1
2217, 1, 1636429730061, 1636429730505, 444, 0, 444, 0, 0, 0
2219, 1, 1636429730304, 1636429730753, 449, 0, 449, 0, 0, 0
2220, 1, 1636429730356, 1636429730805, 449, 0, 449, 0, 0, 0
2221, 1, 1636429730392, 1636429730837, 445, 0, 445, 0, 0, 0
2222, 1, 1636429730524, 1636429730968, 444, 1, 443, 1, 0, 1
2223, 1, 1636429730669, 1636429731112, 443, 0, 443, 0, 0, 0
2225, 1, 1636429730972, 1636429731417, 445, 0, 445, 0, 0, 0
2226, 1, 1636429731028, 1636429731473, 445, 1, 444, 1, 0, 1
2227, 1, 1636429731057, 1636429731505, 448, 0, 448, 0, 0, 0
2229, 1, 1636429731328, 1636429731776, 448, 1, 447, 0, 0, 0
2230, 1, 1636429731641, 1636429732089, 448, 0, 448, 0, 0, 0
2231, 1, 1636429731692, 1636429732140, 448, 1, 447, 0, 0, 0
2232, 1, 1636429731733, 1636429732181, 448, 0, 448, 0, 0, 0
2233, 1, 1636429731997, 1636429732448, 451, 0, 451, 0, 0, 0
2234, 1, 1636429732313, 1636429732765, 452, 0, 452, 0, 0, 0
2235, 1, 1636429732360, 1636429732805, 445, 0, 445, 0, 0, 0
2236, 1, 1636429732404, 1636429732849, 445, 0, 445, 0, 0, 0
2237, 1, 1636429732669, 1636429733120, 451, 0, 451, 0, 0, 0
2239, 1, 1636429733028, 1636429733481, 453, 1, 452, 0, 0, 0
2240, 1, 1636429733072, 1636429733520, 448, 0, 448, 0, 0, 0
2241, 1, 1636429733340, 1636429733793, 453, 1, 452, 0, 0, 0
2242, 1, 1636429733701, 1636429734145, 444, 0, 444, 0, 0, 0
2243, 1, 1636429733741, 1636429734192, 451, 0, 451, 0, 0, 0
2244, 1, 1636429734013, 1636429734469, 456, 0, 456, 0, 0, 0
2245, 1, 1636429734368, 1636429734817, 449, 0, 449, 0, 0, 0
2143, 2, 1636429724948, 1636429734949, 10001, 0, 10001, 161, 0, 161
2145, 2, 1636429724952, 1636429734997, 10045, 0, 10045, 157, 0, 157
2147, 2, 1636429725000, 1636429735045, 10045, 0, 10045, 109, 0, 109
2247, 1, 1636429734693, 1636429735264, 571, 0, 571, 0, 0, 0
2248, 1, 1636429735093, 1636429735544, 451, 0, 451, 0, 0, 0
2249, 1, 1636429735416, 1636429735868, 452, 0, 452, 0, 0, 0
2252, 1, 1636429735485, 1636429735929, 444, 0, 444, 0, 0, 0
2253, 1, 1636429735765, 1636429736221, 456, 0, 456, 0, 0, 0
2254, 1, 1636429736089, 1636429736541, 452, 0, 452, 0, 0, 0
2255, 1, 1636429736153, 1636429736605, 452, 0, 452, 0, 0, 0
2256, 1, 1636429736445, 1636429736901, 456, 0, 456, 0, 0, 0
2257, 1, 1636429736757, 1636429737209, 452, 0, 452, 0, 0, 0
2258, 1, 1636429736829, 1636429737285, 456, 0, 456, 0, 0, 0
2259, 1, 1636429737124, 1636429737573, 449, 1, 448, 0, 0, 0
2260, 1, 1636429737429, 1636429737881, 452, 0, 452, 0, 0, 0
2262, 1, 1636429737797, 1636429738253, 456, 0, 456, 0, 0, 0
2263, 1, 1636429738101, 1636429738557, 456, 0, 456, 0, 0, 0
2200, 2, 1636429728784, 1636429738785, 10001, 0, 10001, 0, 0, 0
2207, 2, 1636429729237, 1636429739237, 10000, 0, 10000, 0, 0, 0
2213, 2, 1636429729688, 1636429739689, 10001, 0, 10001, 0, 0, 0
2218, 2, 1636429730176, 1636429740181, 10005, 0, 10005, 1, 0, 1
2224, 2, 1636429730720, 1636429740721, 10001, 0, 10001, 0, 0, 0
2228, 2, 1636429731189, 1636429741189, 10000, 0, 10000, 0, 0, 0
2266, 1, 1636429741029, 1636429741509, 480, 0, 480, 0, 0, 0
2267, 1, 1636429741501, 1636429741965, 464, 9, 455, 8, 1, 9
2268, 1, 1636429741729, 1636429742185, 456, 0, 456, 0, 0, 0
2269, 1, 1636429742189, 1636429742641, 452, 0, 452, 0, 0, 0
2270, 1, 1636429742404, 1636429742857, 453, 1, 452, 0, 0, 0
2238, 2, 1636429732984, 1636429742985, 10001, 0, 10001, 0, 0, 0
2271, 1, 1636429742865, 1636429743317, 452, 0, 452, 0, 0, 0
2272, 1, 1636429743076, 1636429743525, 449, 0, 449, 0, 0, 0
2273, 1, 1636429743536, 1636429743985, 449, 1, 448, 0, 0, 0
2274, 1, 1636429743748, 1636429744201, 453, 1, 452, 0, 0, 0
2246, 2, 1636429734412, 1636429744413, 10001, 0, 10001, 1, 0, 1
2275, 1, 1636429744205, 1636429744661, 456, 0, 456, 0, 0, 0
2276, 1, 1636429744460, 1636429744913, 453, 1, 452, 0, 0, 0
2277, 1, 1636429744885, 1636429745369, 484, 29, 455, 28, 0, 28
2251, 2, 1636429735421, 1636429745421, 10000, 0, 10000, 448, 0, 448
2250, 2, 1636429735421, 1636429745469, 10048, 0, 10048, 448, 0, 448
2278, 1, 1636429745133, 1636429745589, 456, 0, 456, 0, 0, 0
2264, 1, 1636429738477, 1636429745920, 7443, 6992, 451, 0, 6992, 6992
2279, 1, 1636429745605, 1636429746061, 456, 0, 456, 0, 0, 0
2280, 1, 1636429745813, 1636429746268, 455, 0, 455, 0, 0, 0
2281, 1, 1636429746140, 1636429746581, 441, 0, 441, 0, 0, 0
2284, 1, 1636429746284, 1636429746733, 449, 1, 448, 0, 0, 0
2285, 1, 1636429746485, 1636429746937, 452, 0, 452, 0, 0, 0
2286, 1, 1636429746805, 1636429747252, 447, 0, 447, 0, 0, 0
2287, 1, 1636429746957, 1636429747413, 456, 0, 456, 0, 0, 0
2261, 2, 1636429737505, 1636429747501, 9996, 0, 9996, 0, 0, 0
2288, 1, 1636429747165, 1636429747625, 460, 0, 460, 0, 0, 0
2289, 1, 1636429747472, 1636429747925, 453, 1, 452, 0, 0, 0
2265, 1, 1636429738780, 1636429747949, 9169, 8721, 448, 0, 8720, 8720
2290, 1, 1636429747680, 1636429748133, 453, 1, 452, 0, 0, 0
2291, 1, 1636429747813, 1636429748260, 447, 0, 447, 0, 0, 0
2292, 1, 1636429747844, 1636429748293, 449, 1, 448, 0, 0, 0
2293, 1, 1636429748145, 1636429748593, 448, 0, 448, 0, 0, 0
2294, 1, 1636429748169, 1636429748625, 456, 0, 456, 0, 0, 0
2295, 1, 1636429748353, 1636429748800, 447, 0, 447, 0, 0, 0
2296, 1, 1636429748481, 1636429748933, 452, 0, 452, 0, 0, 0
2297, 1, 1636429748516, 1636429748973, 457, 1, 456, 1, 0, 1
2298, 1, 1636429748844, 1636429749296, 452, 1, 451, 1, 0, 1
2299, 1, 1636429749017, 1636429749465, 448, 0, 448, 0, 0, 0
2300, 1, 1636429749156, 1636429749600, 444, 1, 443, 0, 0, 0
2301, 1, 1636429749192, 1636429749641, 449, 0, 449, 0, 0, 0
2302, 1, 1636429749509, 1636429749961, 452, 0, 452, 0, 0, 0
2303, 1, 1636429749685, 1636429750128, 443, 0, 443, 0, 0, 0
2304, 1, 1636429749820, 1636429750268, 448, 1, 447, 0, 1, 1
2305, 1, 1636429749860, 1636429750308, 448, 1, 447, 0, 0, 0
2306, 1, 1636429750176, 1636429750616, 440, 0, 440, 0, 0, 0
2307, 1, 1636429750348, 1636429750805, 457, 1, 456, 0, 1, 1
2308, 1, 1636429750480, 1636429750933, 453, 0, 453, 0, 0, 0
2309, 1, 1636429750520, 1636429750977, 457, 1, 456, 0, 1, 1
2310, 1, 1636429750837, 1636429751289, 452, 0, 452, 0, 0, 0
2311, 1, 1636429751024, 1636429751473, 449, 1, 448, 0, 0, 0
2312, 1, 1636429751157, 1636429751609, 452, 0, 452, 0, 0, 0
2313, 1, 1636429751193, 1636429751645, 452, 0, 452, 0, 0, 0
2314, 1, 1636429751512, 1636429751961, 449, 1, 448, 0, 0, 0
2315, 1, 1636429751692, 1636429752145, 453, 1, 452, 0, 0, 0
2316, 1, 1636429751837, 1636429752285, 448, 0, 448, 0, 0, 0
2317, 1, 1636429751865, 1636429752317, 452, 0, 452, 0, 0, 0
2318, 1, 1636429752181, 1636429752629, 448, 0, 448, 0, 0, 0
2319, 1, 1636429752364, 1636429752813, 449, 1, 448, 0, 0, 0
2321, 1, 1636429752541, 1636429753001, 460, 0, 460, 0, 0, 0
2320, 1, 1636429752509, 1636429753077, 568, 121, 447, 120, 1, 121
2322, 1, 1636429752853, 1636429753309, 456, 0, 456, 0, 0, 0
2323, 1, 1636429753037, 1636429753484, 447, 0, 447, 0, 0, 0
2324, 1, 1636429753221, 1636429753677, 456, 0, 456, 0, 0, 0
2325, 1, 1636429753301, 1636429753752, 451, 0, 451, 0, 0, 0
2326, 1, 1636429753528, 1636429753977, 449, 1, 448, 0, 0, 0
2327, 1, 1636429753705, 1636429754153, 448, 0, 448, 0, 0, 0
2328, 1, 1636429753904, 1636429754349, 445, 0, 445, 0, 0, 0
2329, 1, 1636429753968, 1636429754417, 449, 1, 448, 0, 0, 0
2330, 1, 1636429754200, 1636429754649, 449, 1, 448, 1, 0, 1
2331, 1, 1636429754373, 1636429754833, 460, 0, 460, 0, 0, 0
2332, 1, 1636429754565, 1636429755017, 452, 0, 452, 0, 0, 0
2333, 1, 1636429754641, 1636429755089, 448, 0, 448, 0, 0, 0
2334, 1, 1636429754873, 1636429755325, 452, 0, 452, 0, 0, 0
2335, 1, 1636429755057, 1636429755517, 460, 0, 460, 0, 0, 0
2336, 1, 1636429755237, 1636429755689, 452, 0, 452, 0, 0, 0
2337, 1, 1636429755312, 1636429755765, 453, 0, 453, 0, 0, 0
2338, 1, 1636429755545, 1636429755996, 451, 0, 451, 0, 0, 0
2339, 1, 1636429755736, 1636429756181, 445, 1, 444, 0, 1, 1
2283, 2, 1636429746181, 1636429756181, 10000, 0, 10000, 0, 0, 0
2282, 2, 1636429746181, 1636429756229, 10048, 0, 10048, 0, 0, 0
2340, 1, 1636429755908, 1636429756353, 445, 1, 444, 0, 1, 1
2341, 1, 1636429755984, 1636429756452, 468, 1, 467, 0, 0, 0
2342, 1, 1636429756272, 1636429756725, 453, 1, 452, 0, 0, 0
2343, 1, 1636429756408, 1636429756857, 449, 1, 448, 0, 1, 1
2346, 1, 1636429756573, 1636429757025, 452, 0, 452, 0, 0, 0
2347, 1, 1636429756673, 1636429757120, 447, 0, 447, 0, 0, 0
2348, 1, 1636429756945, 1636429757397, 452, 0, 452, 0, 0, 0
2349, 1, 1636429757076, 1636429757533, 457, 1, 456, 0, 0, 0
2350, 1, 1636429757245, 1636429757697, 452, 0, 452, 0, 0, 0
2351, 1, 1636429757341, 1636429757793, 452, 0, 452, 0, 0, 0
2352, 1, 1636429757621, 1636429758081, 460, 0, 460, 0, 0, 0
2353, 1, 1636429757757, 1636429758209, 452, 0, 452, 0, 0, 0
2354, 1, 1636429757913, 1636429758369, 456, 0, 456, 0, 0, 0
2355, 1, 1636429758009, 1636429758461, 452, 0, 452, 0, 0, 0
2356, 1, 1636429758305, 1636429758761, 456, 0, 456, 0, 0, 0
2357, 1, 1636429758433, 1636429758885, 452, 0, 452, 0, 0, 0
2358, 1, 1636429758589, 1636429759041, 452, 0, 452, 0, 0, 0
2359, 1, 1636429758681, 1636429759137, 456, 0, 456, 0, 0, 0
2360, 1, 1636429758984, 1636429759441, 457, 1, 456, 0, 0, 0
2361, 1, 1636429759113, 1636429759561, 448, 0, 448, 0, 0, 0
2362, 1, 1636429759261, 1636429759717, 456, 0, 456, 0, 0, 0
2363, 1, 1636429759365, 1636429759821, 456, 0, 456, 0, 0, 0
2364, 1, 1636429759665, 1636429760113, 448, 0, 448, 0, 0, 0
2365, 1, 1636429759788, 1636429760245, 457, 1, 456, 0, 0, 0
2366, 1, 1636429759932, 1636429760385, 453, 0, 453, 0, 0, 0
2367, 1, 1636429760045, 1636429760493, 448, 0, 448, 0, 0, 0
2368, 1, 1636429760333, 1636429760793, 460, 0, 460, 0, 0, 0
2369, 1, 1636429760469, 1636429760921, 452, 0, 452, 0, 0, 0
2370, 1, 1636429760605, 1636429761056, 451, 0, 451, 0, 0, 0
2371, 1, 1636429760716, 1636429761172, 456, 1, 455, 0, 0, 0
2372, 1, 1636429761005, 1636429761457, 452, 0, 452, 0, 0, 0
2373, 1, 1636429761145, 1636429761601, 456, 0, 456, 0, 0, 0
2374, 1, 1636429761273, 1636429761728, 455, 0, 455, 0, 0, 0
2375, 1, 1636429761393, 1636429761849, 456, 0, 456, 0, 0, 0
2376, 1, 1636429761681, 1636429762136, 455, 0, 455, 0, 0, 0
2377, 1, 1636429761824, 1636429762276, 452, 1, 451, 0, 0, 0
2378, 1, 1636429761949, 1636429762396, 447, 0, 447, 0, 0, 0
2379, 1, 1636429762072, 1636429762525, 453, 0, 453, 0, 0, 0
2380, 1, 1636429762352, 1636429762800, 448, 1, 447, 0, 0, 0
2381, 1, 1636429762497, 1636429762949, 452, 0, 452, 0, 0, 0
2382, 1, 1636429762613, 1636429763065, 452, 0, 452, 0, 0, 0
2383, 1, 1636429762749, 1636429763205, 456, 0, 456, 0, 0, 0
2384, 1, 1636429763021, 1636429763473, 452, 0, 452, 0, 0, 0
2385, 1, 1636429763173, 1636429763629, 456, 0, 456, 0, 0, 0
2386, 1, 1636429763284, 1636429763733, 449, 1, 448, 1, 0, 1
2387, 1, 1636429763429, 1636429763881, 452, 0, 452, 0, 0, 0
2388, 1, 1636429763697, 1636429764148, 451, 0, 451, 0, 0, 0
2389, 1, 1636429763853, 1636429764309, 456, 0, 456, 0, 0, 0
2390, 1, 1636429763952, 1636429764397, 445, 0, 445, 0, 0, 0
2391, 1, 1636429764104, 1636429764565, 461, 0, 461, 0, 0, 0
2392, 1, 1636429764365, 1636429764816, 451, 0, 451, 0, 0, 0
2393, 1, 1636429764533, 1636429764989, 456, 0, 456, 0, 0, 0
2394, 1, 1636429764616, 1636429765073, 457, 1, 456, 1, 0, 1
2395, 1, 1636429764793, 1636429765245, 452, 0, 452, 0, 0, 0
2396, 1, 1636429765036, 1636429765485, 449, 0, 449, 0, 0, 0
2397, 1, 1636429765212, 1636429765672, 460, 1, 459, 0, 0, 0
2398, 1, 1636429765292, 1636429765745, 453, 1, 452, 0, 0, 0
2399, 1, 1636429765469, 1636429765917, 448, 0, 448, 0, 0, 0
2400, 1, 1636429765713, 1636429766165, 452, 0, 452, 0, 0, 0
2401, 1, 1636429765893, 1636429766353, 460, 0, 460, 0, 0, 0
2402, 1, 1636429765960, 1636429766405, 445, 0, 445, 0, 0, 0
2344, 2, 1636429756493, 1636429766493, 10000, 0, 10000, 0, 0, 0
2345, 2, 1636429756493, 1636429766540, 10047, 0, 10047, 0, 0, 0
2403, 1, 1636429766140, 1636429766585, 445, 1, 444, 0, 0, 0
2404, 1, 1636429766389, 1636429766856, 467, 0, 467, 0, 0, 0
2405, 1, 1636429766588, 1636429767037, 449, 1, 448, 0, 1, 1
2406, 1, 1636429766676, 1636429767121, 445, 1, 444, 0, 0, 0
2407, 1, 1636429766804, 1636429767252, 448, 1, 447, 0, 0, 0
2410, 1, 1636429767072, 1636429767520, 448, 1, 447, 1, 0, 1
2411, 1, 1636429767257, 1636429767713, 456, 0, 456, 0, 0, 0
2412, 1, 1636429767336, 1636429767789, 453, 1, 452, 0, 0, 0
2413, 1, 1636429767473, 1636429767925, 452, 0, 452, 0, 0, 0
2414, 1, 1636429767741, 1636429768193, 452, 0, 452, 0, 0, 0
2415, 1, 1636429767936, 1636429768389, 453, 1, 452, 0, 0, 0
2416, 1, 1636429768005, 1636429768456, 451, 0, 451, 0, 0, 0
2417, 1, 1636429768144, 1636429768601, 457, 1, 456, 0, 0, 0
2418, 1, 1636429768412, 1636429768860, 448, 0, 448, 0, 0, 0
2419, 1, 1636429768612, 1636429769057, 445, 1, 444, 0, 0, 0
2420, 1, 1636429768677, 1636429769124, 447, 0, 447, 0, 0, 0
2421, 1, 1636429768820, 1636429769261, 441, 1, 440, 0, 0, 0
2422, 1, 1636429769077, 1636429769529, 452, 0, 452, 0, 0, 0
2423, 1, 1636429769284, 1636429769733, 449, 1, 448, 1, 0, 1
2424, 1, 1636429769340, 1636429769780, 440, 1, 439, 0, 1, 1
2425, 1, 1636429769485, 1636429769929, 444, 0, 444, 0, 0, 0
2426, 1, 1636429769744, 1636429770197, 453, 1, 452, 0, 0, 0
2427, 1, 1636429769956, 1636429770409, 453, 0, 453, 0, 0, 0
2428, 1, 1636429770004, 1636429770452, 448, 0, 448, 0, 0, 0
2429, 1, 1636429770157, 1636429770605, 448, 0, 448, 0, 0, 0
2430, 1, 1636429770420, 1636429770868, 448, 1, 447, 0, 0, 0
2431, 1, 1636429770633, 1636429771093, 460, 0, 460, 0, 0, 0
2432, 1, 1636429770828, 1636429771281, 453, 1, 452, 0, 0, 0
2433, 1, 1636429771085, 1636429771537, 452, 0, 452, 0, 0, 0
2434, 1, 1636429771509, 1636429771965, 456, 0, 456, 0, 0, 0
2435, 1, 1636429771757, 1636429772201, 444, 0, 444, 0, 0, 0
2436, 1, 1636429772189, 1636429772645, 456, 0, 456, 0, 0, 0
2437, 1, 1636429772425, 1636429772881, 456, 0, 456, 0, 0, 0
2438, 1, 1636429772869, 1636429773321, 452, 0, 452, 0, 0, 0
2439, 1, 1636429773109, 1636429773565, 456, 0, 456, 0, 0, 0
2440, 1, 1636429773541, 1636429774005, 464, 0, 464, 0, 0, 0
2441, 1, 1636429773785, 1636429774245, 460, 0, 460, 0, 0, 0
2442, 1, 1636429774225, 1636429774677, 452, 0, 452, 0, 0, 0
2443, 1, 1636429774465, 1636429774921, 456, 0, 456, 0, 0, 0
2444, 1, 1636429774904, 1636429775353, 449, 1, 448, 0, 0, 0
2445, 1, 1636429775145, 1636429775597, 452, 0, 452, 0, 0, 0
2446, 1, 1636429775577, 1636429776028, 451, 0, 451, 0, 0, 0
2447, 1, 1636429775817, 1636429776273, 456, 0, 456, 0, 0, 0
2448, 1, 1636429776249, 1636429776701, 452, 0, 452, 0, 0, 0
2409, 2, 1636429766809, 1636429776809, 10000, 0, 10000, 0, 0, 0
2408, 2, 1636429766809, 1636429776853, 10044, 0, 10044, 0, 0, 0
2449, 1, 1636429776493, 1636429777168, 675, 209, 466, 208, 1, 209
2450, 1, 1636429776945, 1636429777397, 452, 0, 452, 0, 0, 0
2453, 1, 1636429777385, 1636429777841, 456, 0, 456, 0, 0, 0
2454, 1, 1636429778061, 1636429778513, 452, 0, 452, 0, 0, 0
2455, 1, 1636429778737, 1636429779193, 456, 0, 456, 0, 0, 0
2456, 1, 1636429779417, 1636429779869, 452, 0, 452, 0, 0, 0
2457, 1, 1636429780097, 1636429780549, 452, 0, 452, 0, 0, 0
2458, 1, 1636429780777, 1636429781233, 456, 0, 456, 0, 0, 0
2459, 1, 1636429781457, 1636429781909, 452, 0, 452, 0, 0, 0
2460, 1, 1636429782133, 1636429782589, 456, 0, 456, 0, 0, 0
2461, 1, 1636429782817, 1636429783273, 456, 0, 456, 0, 0, 0
2462, 1, 1636429783501, 1636429783948, 447, 0, 447, 0, 0, 0
2463, 1, 1636429784161, 1636429784621, 460, 0, 460, 0, 0, 0
2464, 1, 1636429784849, 1636429785309, 460, 0, 460, 0, 0, 0
2465, 1, 1636429785533, 1636429785985, 452, 0, 452, 0, 0, 0
2466, 1, 1636429786209, 1636429786665, 456, 0, 456, 0, 0, 0
2451, 2, 1636429777121, 1636429787121, 10000, 0, 10000, 0, 0, 0
2452, 2, 1636429777121, 1636429787168, 10047, 0, 10047, 0, 0, 0
2467, 1, 1636429786889, 1636429787392, 503, 0, 503, 0, 0, 0
2470, 1, 1636429787608, 1636429788061, 453, 1, 452, 0, 0, 0
2471, 1, 1636429788281, 1636429788741, 460, 0, 460, 0, 0, 0
2472, 1, 1636429788961, 1636429789413, 452, 0, 452, 0, 0, 0
2473, 1, 1636429789637, 1636429790085, 448, 0, 448, 0, 0, 0
2468, 2, 1636429787436, 1636429797437, 10001, 0, 10001, 1, 0, 1
2469, 2, 1636429787436, 1636429797480, 10044, 0, 10044, 0, 0, 0
2474, 1, 1636429790305, 1636429797929, 7624, 7176, 448, 0, 7176, 7176
2475, 2, 1636429797752, 1636429807753, 10001, 0, 10001, 0, 0, 0
2476, 2, 1636429797752, 1636429807800, 10048, 0, 10048, 0, 0, 0
2477, 1, 1636429808060, 1636429808513, 453, 1, 452, 0, 0, 0
2478, 1, 1636429808068, 1636429808969, 901, 446, 455, 446, 0, 446
2479, 1, 1636429808737, 1636429809188, 451, 0, 451, 0, 0, 0
2480, 1, 1636429809192, 1636429809645, 453, 1, 452, 0, 0, 0
2481, 1, 1636429809409, 1636429809861, 452, 0, 452, 0, 0, 0
2482, 1, 1636429809869, 1636429810325, 456, 0, 456, 0, 0, 0
2483, 1, 1636429810085, 1636429810541, 456, 0, 456, 0, 0, 0
2484, 1, 1636429810549, 1636429811005, 456, 0, 456, 0, 0, 0
2485, 1, 1636429810765, 1636429811217, 452, 0, 452, 0, 0, 0
2486, 1, 1636429811233, 1636429811688, 455, 0, 455, 0, 0, 0
2487, 1, 1636429811441, 1636429811897, 456, 0, 456, 0, 0, 0
2488, 1, 1636429811909, 1636429812361, 452, 0, 452, 0, 0, 0
2489, 1, 1636429812121, 1636429812577, 456, 0, 456, 0, 0, 0
2490, 1, 1636429812585, 1636429813041, 456, 0, 456, 0, 0, 0
2491, 1, 1636429812801, 1636429813257, 456, 0, 456, 0, 0, 0
2492, 1, 1636429813265, 1636429813721, 456, 0, 456, 0, 0, 0
2493, 1, 1636429813476, 1636429813929, 453, 1, 452, 0, 1, 1
2494, 1, 1636429813945, 1636429814389, 444, 0, 444, 0, 0, 0
2495, 1, 1636429814153, 1636429814609, 456, 0, 456, 0, 0, 0
2496, 1, 1636429814613, 1636429815073, 460, 0, 460, 0, 0, 0
2497, 1, 1636429814832, 1636429815289, 457, 1, 456, 0, 0, 0
2498, 1, 1636429815297, 1636429815749, 452, 0, 452, 0, 0, 0
2499, 1, 1636429815513, 1636429815965, 452, 0, 452, 0, 0, 0
2500, 1, 1636429815973, 1636429816429, 456, 0, 456, 0, 0, 0
2501, 1, 1636429816189, 1636429816645, 456, 0, 456, 0, 0, 0
2502, 1, 1636429816652, 1636429817105, 453, 1, 452, 0, 0, 0
2503, 1, 1636429816869, 1636429817321, 452, 0, 452, 0, 0, 0
2504, 1, 1636429817328, 1636429817773, 445, 1, 444, 0, 0, 0
2505, 1, 1636429817545, 1636429818001, 456, 0, 456, 0, 0, 0
2506, 1, 1636429817997, 1636429818453, 456, 4, 452, 4, 0, 4
2507, 1, 1636429818224, 1636429818673, 449, 1, 448, 0, 1, 1
2508, 1, 1636429818677, 1636429819133, 456, 0, 456, 0, 0, 0
2509, 1, 1636429818896, 1636429819349, 453, 1, 452, 0, 0, 0
2510, 1, 1636429819357, 1636429819813, 456, 0, 456, 0, 0, 0
2511, 1, 1636429819573, 1636429820033, 460, 0, 460, 0, 0, 0
2512, 1, 1636429820037, 1636429820489, 452, 0, 452, 0, 0, 0
2513, 1, 1636429820256, 1636429820709, 453, 1, 452, 0, 0, 0
2514, 1, 1636429820713, 1636429821169, 456, 0, 456, 0, 0, 0
2515, 1, 1636429820933, 1636429821389, 456, 0, 456, 0, 0, 0
2516, 1, 1636429821396, 1636429821845, 449, 1, 448, 0, 0, 0
2517, 1, 1636429821613, 1636429822073, 460, 0, 460, 0, 0, 0
2518, 1, 1636429822065, 1636429822529, 464, 9, 455, 8, 1, 9
2519, 1, 1636429822297, 1636429822745, 448, 0, 448, 0, 0, 0
2520, 1, 1636429822752, 1636429823200, 448, 1, 447, 1, 0, 1
2521, 1, 1636429822969, 1636429823421, 452, 0, 452, 0, 0, 0
2522, 1, 1636429823420, 1636429823872, 452, 1, 451, 0, 0, 0
2523, 1, 1636429823645, 1636429824101, 456, 0, 456, 0, 0, 0
2524, 1, 1636429824093, 1636429824557, 464, 9, 455, 8, 1, 9
2525, 1, 1636429824325, 1636429824777, 452, 0, 452, 0, 0, 0
2526, 1, 1636429824781, 1636429825237, 456, 0, 456, 0, 0, 0
2527, 1, 1636429825000, 1636429825457, 457, 1, 456, 0, 0, 0
2528, 1, 1636429825461, 1636429825917, 456, 0, 456, 0, 0, 0
2529, 1, 1636429825681, 1636429826137, 456, 0, 456, 0, 0, 0
2530, 1, 1636429826140, 1636429826593, 453, 1, 452, 0, 0, 0
2531, 1, 1636429826360, 1636429826813, 453, 1, 452, 0, 0, 0
2532, 1, 1636429826817, 1636429827269, 452, 0, 452, 0, 0, 0
2533, 1, 1636429827037, 1636429827481, 444, 0, 444, 0, 0, 0
2534, 1, 1636429827493, 1636429827940, 447, 0, 447, 0, 0, 0
2535, 1, 1636429827701, 1636429828153, 452, 0, 452, 0, 0, 0
2536, 1, 1636429828161, 1636429828621, 460, 0, 460, 0, 0, 0
2537, 1, 1636429828373, 1636429828829, 456, 0, 456, 0, 0, 0
2538, 1, 1636429828844, 1636429829297, 453, 1, 452, 0, 1, 1
2539, 1, 1636429829053, 1636429829509, 456, 0, 456, 0, 0, 0
2540, 1, 1636429829525, 1636429829981, 456, 0, 456, 0, 0, 0
2541, 1, 1636429829737, 1636429830197, 460, 0, 460, 0, 0, 0
2542, 1, 1636429830205, 1636429830657, 452, 0, 452, 0, 0, 0
2543, 1, 1636429830420, 1636429830873, 453, 1, 452, 0, 0, 0
2544, 1, 1636429830880, 1636429831329, 449, 0, 449, 0, 0, 0
2545, 1, 1636429831097, 1636429831552, 455, 0, 455, 0, 0, 0
2546, 1, 1636429831552, 1636429832005, 453, 1, 452, 1, 0, 1
2547, 1, 1636429831768, 1636429832221, 453, 1, 452, 0, 0, 0
2548, 1, 1636429832228, 1636429832681, 453, 1, 452, 0, 1, 1
2549, 1, 1636429832444, 1636429832893, 449, 1, 448, 0, 0, 0
2550, 1, 1636429832908, 1636429833357, 449, 1, 448, 0, 1, 1
2551, 1, 1636429833117, 1636429833573, 456, 0, 456, 0, 0, 0
2552, 1, 1636429833581, 1636429834032, 451, 0, 451, 0, 0, 0
2553, 1, 1636429833797, 1636429834249, 452, 0, 452, 0, 0, 0
2554, 1, 1636429834253, 1636429834708, 455, 0, 455, 0, 0, 0
2555, 1, 1636429834472, 1636429834917, 445, 1, 444, 0, 0, 0
2556, 1, 1636429834928, 1636429835380, 452, 1, 451, 0, 1, 1
2557, 1, 1636429835137, 1636429835589, 452, 0, 452, 0, 0, 0
2558, 1, 1636429835600, 1636429836049, 449, 1, 448, 0, 0, 0
2559, 1, 1636429835812, 1636429836265, 453, 1, 452, 0, 0, 0
2560, 1, 1636429836273, 1636429836725, 452, 0, 452, 0, 0, 0
2561, 1, 1636429836488, 1636429836937, 449, 1, 448, 0, 0, 0
2562, 1, 1636429836949, 1636429837405, 456, 0, 456, 0, 0, 0
2563, 1, 1636429837161, 1636429837617, 456, 0, 456, 0, 0, 0
2564, 1, 1636429837625, 1636429838073, 448, 0, 448, 0, 0, 0
2565, 1, 1636429837841, 1636429838292, 451, 0, 451, 0, 0, 0
2566, 1, 1636429838296, 1636429838749, 453, 1, 452, 0, 0, 0
2567, 1, 1636429838509, 1636429838965, 456, 0, 456, 0, 0, 0
2568, 1, 1636429838973, 1636429839429, 456, 0, 456, 0, 0, 0
2569, 1, 1636429839189, 1636429839649, 460, 0, 460, 0, 0, 0
2570, 1, 1636429839653, 1636429840104, 451, 0, 451, 0, 0, 0
2571, 1, 1636429839873, 1636429840328, 455, 0, 455, 0, 0, 0
2572, 1, 1636429840325, 1636429840781, 456, 4, 452, 4, 0, 4
2573, 1, 1636429840548, 1636429841001, 453, 1, 452, 0, 0, 0
2574, 1, 1636429841005, 1636429841453, 448, 0, 448, 0, 0, 0
2575, 1, 1636429841220, 1636429841669, 449, 1, 448, 0, 0, 0
2576, 1, 1636429841676, 1636429842129, 453, 0, 453, 0, 0, 0
2577, 1, 1636429841892, 1636429842349, 457, 1, 456, 0, 0, 0
2578, 1, 1636429842357, 1636429842805, 448, 0, 448, 0, 0, 0
2579, 1, 1636429842569, 1636429843025, 456, 0, 456, 0, 0, 0
2580, 1, 1636429843029, 1636429843481, 452, 0, 452, 0, 0, 0
2581, 1, 1636429843249, 1636429843697, 448, 0, 448, 0, 0, 0
2582, 1, 1636429843704, 1636429844157, 453, 1, 452, 0, 1, 1
2583, 1, 1636429843921, 1636429844380, 459, 0, 459, 0, 0, 0
2584, 1, 1636429844380, 1636429844833, 453, 1, 452, 1, 0, 1
2585, 1, 1636429844601, 1636429845057, 456, 0, 456, 0, 0, 0
2586, 1, 1636429845057, 1636429845509, 452, 1, 451, 1, 0, 1
2587, 1, 1636429845281, 1636429845737, 456, 0, 456, 0, 0, 0
2588, 1, 1636429845733, 1636429846193, 460, 4, 456, 4, 0, 4
2589, 1, 1636429845961, 1636429846409, 448, 0, 448, 0, 0, 0
2590, 1, 1636429846412, 1636429846860, 448, 0, 448, 0, 0, 0
2591, 1, 1636429846629, 1636429847085, 456, 0, 456, 0, 0, 0
2592, 1, 1636429847080, 1636429847540, 460, 5, 455, 5, 0, 5
2593, 1, 1636429847309, 1636429847765, 456, 0, 456, 0, 0, 0
2594, 1, 1636429847761, 1636429848220, 459, 5, 454, 4, 0, 4
2595, 1, 1636429847989, 1636429848441, 452, 0, 452, 0, 0, 0
2596, 1, 1636429848437, 1636429848897, 460, 5, 455, 4, 1, 5
2597, 1, 1636429848665, 1636429849120, 455, 0, 455, 0, 0, 0
2598, 1, 1636429849120, 1636429849573, 453, 1, 452, 1, 0, 1
2599, 1, 1636429849340, 1636429849793, 453, 1, 452, 0, 0, 0
2600, 1, 1636429849797, 1636429850253, 456, 0, 456, 0, 0, 0
2601, 1, 1636429869413, 1636429869869, 456, 0, 456, 0, 0, 0
2602, 1, 1636429870280, 1636429870725, 445, 0, 445, 0, 0, 0
2603, 1, 1636429870409, 1636429870861, 452, 0, 452, 0, 0, 0
2604, 1, 1636429871273, 1636429871724, 451, 0, 451, 0, 0, 0
2605, 1, 1636429871401, 1636429871861, 460, 0, 460, 0, 0, 0
2606, 1, 1636429871621, 1636429872073, 452, 0, 452, 0, 0, 0
2607, 1, 1636429872084, 1636429872529, 445, 1, 444, 0, 0, 0
2608, 1, 1636429872253, 1636429872705, 452, 0, 452, 0, 0, 0
2609, 1, 1636429872405, 1636429872861, 456, 0, 456, 0, 0, 0
2610, 1, 1636429872613, 1636429873069, 456, 0, 456, 0, 0, 0
2611, 1, 1636429872705, 1636429873157, 452, 0, 452, 0, 0, 0
2612, 1, 1636429873069, 1636429873517, 448, 1, 447, 0, 1, 1
2613, 1, 1636429873261, 1636429873721, 460, 0, 460, 0, 0, 0
2614, 1, 1636429873308, 1636429873757, 449, 1, 448, 0, 0, 0
2615, 1, 1636429873437, 1636429873889, 452, 0, 452, 0, 0, 0
2616, 1, 1636429873597, 1636429874056, 459, 0, 459, 0, 0, 0
2617, 1, 1636429873693, 1636429874145, 452, 0, 452, 0, 0, 0
2618, 1, 1636429873885, 1636429874336, 451, 0, 451, 0, 0, 0
2619, 1, 1636429874053, 1636429874512, 459, 4, 455, 4, 0, 4
2620, 1, 1636429874289, 1636429874744, 455, 0, 455, 0, 0, 0
2621, 1, 1636429874292, 1636429874745, 453, 1, 452, 0, 1, 1
2622, 1, 1636429874437, 1636429874889, 452, 0, 452, 0, 0, 0
2623, 1, 1636429874601, 1636429875053, 452, 0, 452, 0, 0, 0
2624, 1, 1636429874672, 1636429875125, 453, 1, 452, 0, 1, 1
2625, 1, 1636429874692, 1636429875144, 452, 0, 452, 0, 0, 0
2626, 1, 1636429874868, 1636429875320, 452, 1, 451, 0, 0, 0
2628, 1, 1636429875085, 1636429875537, 452, 0, 452, 0, 0, 0
2627, 1, 1636429875061, 1636429875596, 535, 84, 451, 84, 0, 84
2629, 1, 1636429875265, 1636429875717, 452, 0, 452, 0, 0, 0
2630, 1, 1636429875292, 1636429875744, 452, 1, 451, 0, 0, 0
2631, 1, 1636429875445, 1636429876056, 611, 152, 459, 152, 0, 152
2632, 1, 1636429875624, 1636429876081, 457, 1, 456, 0, 0, 0
2633, 1, 1636429875632, 1636429876081, 449, 1, 448, 1, 0, 1
2635, 1, 1636429875700, 1636429876148, 448, 0, 448, 0, 0, 0
2636, 1, 1636429875856, 1636429876305, 449, 1, 448, 0, 1, 1
2634, 1, 1636429875652, 1636429876508, 856, 405, 451, 405, 0, 405
2637, 1, 1636429876001, 1636429876529, 528, 81, 447, 80, 0, 80
2638, 1, 1636429876117, 1636429876565, 448, 0, 448, 0, 0, 0
2639, 1, 1636429876269, 1636429876720, 451, 0, 451, 0, 0, 0
2641, 1, 1636429876457, 1636429876905, 448, 0, 448, 0, 0, 0
2640, 1, 1636429876297, 1636429876961, 664, 212, 452, 212, 0, 212
2642, 1, 1636429876608, 1636429877049, 441, 0, 441, 0, 0, 0
2643, 1, 1636429876616, 1636429877056, 440, 0, 440, 0, 0, 0
2645, 1, 1636429876724, 1636429877177, 453, 1, 452, 0, 0, 0
2646, 1, 1636429876864, 1636429877313, 449, 1, 448, 0, 0, 0
2647, 1, 1636429876941, 1636429877409, 468, 20, 448, 20, 0, 20
2648, 1, 1636429876977, 1636429877501, 524, 80, 444, 80, 0, 80
2644, 1, 1636429876733, 1636429877501, 768, 317, 451, 316, 0, 316
2650, 1, 1636429877301, 1636429877748, 447, 0, 447, 0, 0, 0
2651, 1, 1636429877313, 1636429877769, 456, 0, 456, 0, 0, 0
2652, 1, 1636429877484, 1636429877929, 445, 1, 444, 0, 0, 0
2649, 1, 1636429877093, 1636429877961, 868, 409, 459, 409, 0, 409
2653, 1, 1636429877629, 1636429878077, 448, 0, 448, 0, 0, 0
2654, 1, 1636429877653, 1636429878100, 447, 0, 447, 0, 0, 0
2655, 1, 1636429877736, 1636429878188, 452, 1, 451, 0, 0, 0
2657, 1, 1636429877892, 1636429878349, 457, 1, 456, 0, 0, 0
2658, 1, 1636429877892, 1636429878349, 457, 1, 456, 0, 0, 0
2656, 1, 1636429877705, 1636429878408, 703, 256, 447, 256, 0, 256
2659, 1, 1636429877997, 1636429878556, 559, 104, 455, 104, 0, 104
2660, 1, 1636429878180, 1636429878632, 452, 1, 451, 0, 0, 0
2661, 1, 1636429878180, 1636429878636, 456, 1, 455, 0, 0, 0
2663, 1, 1636429878328, 1636429878769, 441, 1, 440, 0, 0, 0
2662, 1, 1636429878277, 1636429878856, 579, 132, 447, 132, 0, 132
2664, 1, 1636429878493, 1636429878941, 448, 0, 448, 0, 0, 0
2665, 1, 1636429878649, 1636429879097, 448, 0, 448, 0, 0, 0
2666, 1, 1636429878664, 1636429879116, 452, 1, 451, 1, 0, 1
2667, 1, 1636429878673, 1636429879133, 460, 0, 460, 0, 0, 0
2668, 1, 1636429878692, 1636429879149, 457, 1, 456, 0, 0, 0
2670, 1, 1636429878877, 1636429879324, 447, 0, 447, 0, 0, 0
2671, 1, 1636429878892, 1636429879344, 452, 1, 451, 0, 1, 1
2673, 1, 1636429879108, 1636429879548, 440, 0, 440, 0, 0, 0
2674, 1, 1636429879112, 1636429879561, 449, 1, 448, 0, 0, 0
2672, 1, 1636429879020, 1636429879584, 564, 114, 450, 113, 0, 113
2669, 1, 1636429878700, 1636429879597, 897, 449, 448, 448, 0, 448
2677, 1, 1636429879324, 1636429879768, 444, 1, 443, 0, 1, 1
2678, 1, 1636429879460, 1636429879904, 444, 0, 444, 0, 0, 0
2676, 1, 1636429879284, 1636429880052, 768, 313, 455, 313, 0, 313
2679, 1, 1636429879628, 1636429880084, 456, 1, 455, 0, 0, 0
2681, 1, 1636429879672, 1636429880121, 449, 1, 448, 0, 1, 1
2682, 1, 1636429879680, 1636429880124, 444, 1, 443, 0, 0, 0
2684, 1, 1636429879812, 1636429880261, 449, 1, 448, 1, 0, 1
2685, 1, 1636429879876, 1636429880328, 452, 1, 451, 1, 0, 1
2688, 1, 1636429880080, 1636429880544, 464, 0, 464, 0, 0, 0
2689, 1, 1636429880088, 1636429880544, 456, 0, 456, 0, 0, 0
2687, 1, 1636429880009, 1636429880577, 568, 112, 456, 112, 0, 112
2692, 1, 1636429880292, 1636429880748, 456, 0, 456, 0, 0, 0
2691, 1, 1636429880289, 1636429880752, 463, 0, 463, 0, 0, 0
2693, 1, 1636429880445, 1636429880901, 456, 0, 456, 0, 0, 0
2694, 1, 1636429880617, 1636429881072, 455, 0, 455, 0, 0, 0
2696, 1, 1636429880680, 1636429881128, 448, 1, 447, 0, 0, 0
2697, 1, 1636429880772, 1636429881220, 448, 1, 447, 0, 0, 0
2699, 1, 1636429880904, 1636429881357, 453, 1, 452, 0, 1, 1
2701, 1, 1636429881072, 1636429881520, 448, 1, 447, 0, 0, 0
2702, 1, 1636429881120, 1636429881569, 449, 1, 448, 0, 0, 0
2703, 1, 1636429881264, 1636429881713, 449, 1, 448, 0, 1, 1
2704, 1, 1636429881312, 1636429881765, 453, 1, 452, 0, 0, 0
2705, 1, 1636429881436, 1636429881889, 453, 1, 452, 0, 0, 0
2707, 1, 1636429881612, 1636429882061, 449, 1, 448, 0, 1, 1
2709, 1, 1636429881773, 1636429882217, 444, 0, 444, 0, 0, 0
2708, 1, 1636429881652, 1636429882349, 697, 237, 460, 236, 0, 236
2710, 1, 1636429881900, 1636429882349, 449, 0, 449, 0, 0, 0
2712, 1, 1636429882032, 1636429882480, 448, 1, 447, 0, 1, 1
2713, 1, 1636429882140, 1636429882592, 452, 1, 451, 1, 0, 1
2715, 1, 1636429882345, 1636429882792, 447, 0, 447, 0, 0, 0
2714, 1, 1636429882224, 1636429882805, 581, 125, 456, 125, 0, 125
2716, 1, 1636429882444, 1636429882901, 457, 1, 456, 0, 0, 0
2718, 1, 1636429882632, 1636429883084, 452, 1, 451, 0, 0, 0
2719, 1, 1636429882641, 1636429883093, 452, 0, 452, 0, 0, 0
2720, 1, 1636429882732, 1636429883180, 448, 1, 447, 0, 0, 0
2722, 1, 1636429883040, 1636429883492, 452, 0, 452, 0, 0, 0
2723, 1, 1636429883120, 1636429883565, 445, 1, 444, 0, 0, 0
2724, 1, 1636429883229, 1636429883677, 448, 0, 448, 0, 0, 0
2725, 1, 1636429883313, 1636429883765, 452, 0, 452, 0, 0, 0
2726, 1, 1636429883417, 1636429883861, 444, 0, 444, 0, 0, 0
2727, 1, 1636429883616, 1636429884069, 453, 1, 452, 0, 0, 0
2729, 1, 1636429883764, 1636429884213, 449, 1, 448, 0, 0, 0
2728, 1, 1636429883632, 1636429884217, 585, 133, 452, 133, 0, 133
2730, 1, 1636429884040, 1636429884485, 445, 1, 444, 0, 1, 1
2732, 1, 1636429884200, 1636429884645, 445, 1, 444, 0, 0, 0
2733, 1, 1636429884285, 1636429884737, 452, 0, 452, 0, 0, 0
2734, 1, 1636429884424, 1636429884865, 441, 1, 440, 0, 1, 1
2736, 1, 1636429884652, 1636429885105, 453, 1, 452, 0, 0, 0
2737, 1, 1636429884801, 1636429885252, 451, 0, 451, 0, 0, 0
2738, 1, 1636429885073, 1636429885521, 448, 0, 448, 0, 0, 0
2739, 1, 1636429885212, 1636429885665, 453, 1, 452, 0, 1, 1
2740, 1, 1636429885249, 1636429885693, 444, 0, 444, 0, 0, 0
2741, 1, 1636429885409, 1636429885869, 460, 0, 460, 0, 0, 0
2742, 1, 1636429885625, 1636429886081, 456, 0, 456, 0, 0, 0
2743, 1, 1636429885805, 1636429886257, 452, 0, 452, 0, 0, 0
2744, 1, 1636429886101, 1636429886553, 452, 0, 452, 0, 0, 0
2745, 1, 1636429886204, 1636429886644, 440, 0, 440, 0, 0, 0
2746, 1, 1636429886248, 1636429886700, 452, 0, 452, 0, 0, 0
2747, 1, 1636429886377, 1636429886825, 448, 0, 448, 0, 0, 0
2748, 1, 1636429886649, 1636429887096, 447, 0, 447, 0, 0, 0
2749, 1, 1636429886840, 1636429887293, 453, 1, 452, 0, 0, 0
2750, 1, 1636429887068, 1636429887513, 445, 1, 444, 0, 1, 1
2751, 1, 1636429887197, 1636429887645, 448, 0, 448, 0, 0, 0
2752, 1, 1636429887217, 1636429887677, 460, 0, 460, 0, 0, 0
2753, 1, 1636429887385, 1636429887821, 436, 0, 436, 0, 0, 0
2754, 1, 1636429887645, 1636429888093, 448, 0, 448, 0, 0, 0
2755, 1, 1636429887825, 1636429888272, 447, 0, 447, 0, 0, 0
2756, 1, 1636429888069, 1636429888525, 456, 0, 456, 0, 0, 0
2757, 1, 1636429888225, 1636429888677, 452, 0, 452, 0, 0, 0
2758, 1, 1636429888241, 1636429888685, 444, 0, 444, 0, 0, 0
2759, 1, 1636429888409, 1636429888861, 452, 0, 452, 0, 0, 0
2760, 1, 1636429888644, 1636429889089, 445, 0, 445, 0, 0, 0
2675, 2, 1636429879229, 1636429889233, 10004, 0, 10004, 824, 0, 824
2761, 1, 1636429888825, 1636429889277, 452, 0, 452, 0, 0, 0
2762, 1, 1636429889097, 1636429889548, 451, 0, 451, 0, 0, 0
2680, 2, 1636429879652, 1636429889649, 9997, 0, 9997, 401, 0, 401
2764, 1, 1636429889281, 1636429889728, 447, 0, 447, 0, 0, 0
2763, 1, 1636429889281, 1636429889734, 453, 0, 453, 0, 0, 0
2683, 2, 1636429879761, 1636429889765, 10004, 0, 10004, 292, 0, 292
2765, 1, 1636429889377, 1636429889821, 444, 0, 444, 0, 0, 0
2686, 2, 1636429879904, 1636429889905, 10001, 0, 10001, 149, 0, 149
2766, 1, 1636429889641, 1636429890128, 487, 0, 487, 0, 0, 0
2690, 2, 1636429880289, 1636429890288, 9999, 0, 9999, 0, 0, 0
2767, 1, 1636429889857, 1636429890316, 459, 0, 459, 0, 0, 0
2768, 1, 1636429890108, 1636429890556, 448, 0, 448, 0, 0, 0
2695, 2, 1636429880680, 1636429890677, 9997, 0, 9997, 0, 0, 0
2770, 1, 1636429890228, 1636429890705, 477, 0, 477, 0, 0, 0
2769, 1, 1636429890208, 1636429890705, 497, 1, 496, 0, 1, 1
2773, 1, 1636429890380, 1636429890837, 457, 2, 455, 1, 0, 1
2772, 1, 1636429890380, 1636429890837, 457, 1, 456, 0, 0, 0
2775, 1, 1636429890380, 1636429890837, 457, 1, 456, 0, 0, 0
2698, 2, 1636429880861, 1636429890865, 10004, 0, 10004, 0, 0, 0
2700, 2, 1636429881009, 1636429891008, 9999, 0, 9999, 0, 0, 0
2777, 1, 1636429890641, 1636429891088, 447, 0, 447, 0, 0, 0
2778, 1, 1636429890908, 1636429891352, 444, 0, 444, 0, 0, 0
2779, 1, 1636429890984, 1636429891432, 448, 0, 448, 0, 0, 0
2706, 2, 1636429881444, 1636429891453, 10009, 0, 10009, 1, 0, 1
2781, 1, 1636429891144, 1636429891589, 445, 0, 445, 0, 0, 0
2782, 1, 1636429891188, 1636429891676, 488, 1, 487, 0, 1, 1
2783, 1, 1636429891244, 1636429891705, 461, 0, 461, 0, 0, 0
2784, 1, 1636429891256, 1636429891705, 449, 1, 448, 0, 0, 0
2786, 1, 1636429891300, 1636429891769, 469, 1, 468, 0, 0, 0
2787, 1, 1636429891368, 1636429891861, 493, 1, 492, 1, 0, 1
2785, 1, 1636429891316, 1636429891888, 572, 117, 455, 117, 0, 117
2711, 2, 1636429881969, 1636429891969, 10000, 0, 10000, 0, 0, 0
2788, 1, 1636429891628, 1636429892081, 453, 1, 452, 0, 0, 0
2791, 1, 1636429891901, 1636429892376, 475, 0, 475, 0, 0, 0
2790, 1, 1636429891881, 1636429892376, 495, 0, 495, 0, 0, 0
2717, 2, 1636429882452, 1636429892453, 10001, 0, 10001, 0, 0, 0
2792, 1, 1636429892104, 1636429892557, 453, 1, 452, 0, 0, 0
2793, 1, 1636429892168, 1636429892621, 453, 1, 452, 0, 0, 0
2797, 1, 1636429892256, 1636429892705, 449, 1, 448, 0, 0, 0
2796, 1, 1636429892252, 1636429892705, 453, 0, 453, 0, 0, 0
2799, 1, 1636429892360, 1636429892809, 449, 0, 449, 0, 0, 0
2795, 1, 1636429892236, 1636429892861, 625, 141, 484, 141, 0, 141
2721, 2, 1636429882916, 1636429892917, 10001, 0, 10001, 1, 0, 1
2800, 1, 1636429892596, 1636429893049, 453, 0, 453, 0, 0, 0
2802, 1, 1636429892852, 1636429893325, 473, 1, 472, 0, 1, 1
2803, 1, 1636429892885, 1636429893336, 451, 0, 451, 0, 0, 0
2804, 1, 1636429893073, 1636429893533, 460, 0, 460, 0, 0, 0
2805, 1, 1636429893169, 1636429893621, 452, 0, 452, 0, 0, 0
2807, 1, 1636429893220, 1636429893664, 444, 1, 443, 0, 1, 1
2806, 1, 1636429893232, 1636429893673, 441, 1, 440, 0, 0, 0
2808, 1, 1636429893225, 1636429893677, 452, 0, 452, 0, 0, 0
2809, 1, 1636429893225, 1636429893796, 571, 112, 459, 112, 0, 112
2810, 1, 1636429893376, 1636429893829, 453, 1, 452, 0, 1, 1
2811, 1, 1636429893561, 1636429894004, 443, 0, 443, 0, 0, 0
2731, 2, 1636429884125, 1636429894125, 10000, 0, 10000, 0, 0, 0
2812, 1, 1636429893829, 1636429894276, 447, 0, 447, 0, 0, 0
2813, 1, 1636429893852, 1636429894296, 444, 1, 443, 0, 0, 0
2814, 1, 1636429894052, 1636429894528, 476, 1, 475, 0, 0, 0
2735, 1, 1636429884625, 1636429894568, 9943, 9500, 443, 0, 9500, 9500
2815, 1, 1636429894172, 1636429894616, 444, 0, 444, 0, 0, 0
2816, 1, 1636429894216, 1636429894660, 444, 1, 443, 1, 0, 1
2817, 1, 1636429894216, 1636429894664, 448, 1, 447, 0, 1, 1
2819, 1, 1636429894260, 1636429894701, 441, 0, 441, 0, 0, 0
2818, 1, 1636429894216, 1636429894745, 529, 81, 448, 81, 0, 81
2820, 1, 1636429894428, 1636429894885, 457, 1, 456, 0, 0, 0
2822, 1, 1636429894528, 1636429894972, 444, 1, 443, 1, 0, 1
2821, 1, 1636429894388, 1636429895120, 732, 277, 455, 277, 0, 277
2823, 1, 1636429894785, 1636429895337, 552, 100, 452, 100, 0, 100
2825, 1, 1636429894888, 1636429895337, 449, 1, 448, 0, 1, 1
2824, 1, 1636429894821, 1636429895428, 607, 152, 455, 152, 0, 152
2826, 1, 1636429895024, 1636429895469, 445, 1, 444, 0, 0, 0
2827, 1, 1636429895124, 1636429895565, 441, 0, 441, 0, 0, 0
2828, 1, 1636429895172, 1636429895617, 445, 0, 445, 0, 0, 0
2829, 1, 1636429895208, 1636429895644, 436, 0, 436, 0, 0, 0
2831, 1, 1636429895252, 1636429895688, 436, 0, 436, 0, 0, 0
2832, 1, 1636429895340, 1636429895777, 437, 0, 437, 0, 0, 0
2830, 1, 1636429895212, 1636429895777, 565, 126, 439, 126, 0, 126
2833, 1, 1636429895380, 1636429895820, 440, 1, 439, 0, 0, 0
2834, 1, 1636429895557, 1636429896013, 456, 0, 456, 0, 0, 0
2835, 1, 1636429895732, 1636429896228, 496, 46, 450, 45, 0, 45
2836, 1, 1636429895817, 1636429896264, 447, 0, 447, 0, 0, 0
2837, 1, 1636429895889, 1636429896345, 456, 0, 456, 0, 0, 0
2838, 1, 1636429896049, 1636429896497, 448, 0, 448, 0, 0, 0
2839, 1, 1636429896081, 1636429896528, 447, 0, 447, 0, 0, 0
2840, 1, 1636429896149, 1636429896604, 455, 0, 455, 0, 0, 0
2841, 1, 1636429896200, 1636429896652, 452, 1, 451, 0, 0, 0
2843, 1, 1636429896260, 1636429896705, 445, 1, 444, 1, 0, 1
2844, 1, 1636429896321, 1636429896761, 440, 0, 440, 0, 0, 0
2842, 1, 1636429896220, 1636429896796, 576, 125, 451, 125, 0, 125
2845, 1, 1636429896356, 1636429896804, 448, 0, 448, 0, 0, 0
2846, 1, 1636429896573, 1636429897021, 448, 0, 448, 0, 0, 0
2847, 1, 1636429896704, 1636429897217, 513, 57, 456, 56, 0, 56
2848, 1, 1636429896837, 1636429897288, 451, 0, 451, 0, 0, 0
2849, 1, 1636429896900, 1636429897352, 452, 1, 451, 0, 1, 1
2850, 1, 1636429897053, 1636429897504, 451, 0, 451, 0, 0, 0
2851, 1, 1636429897120, 1636429897572, 452, 1, 451, 0, 1, 1
2852, 1, 1636429897164, 1636429897616, 452, 1, 451, 0, 1, 1
2855, 1, 1636429897288, 1636429897729, 441, 1, 440, 0, 0, 0
2856, 1, 1636429897320, 1636429897773, 453, 1, 452, 0, 1, 1
2854, 1, 1636429897252, 1636429897801, 549, 101, 448, 101, 0, 101
2857, 1, 1636429897376, 1636429897817, 441, 1, 440, 0, 1, 1
2858, 1, 1636429897541, 1636429897984, 443, 0, 443, 0, 0, 0
2853, 1, 1636429897176, 1636429898024, 848, 397, 451, 397, 0, 397
2859, 1, 1636429897685, 1636429898232, 547, 88, 459, 88, 0, 88
2860, 1, 1636429897836, 1636429898281, 445, 1, 444, 1, 0, 1
2861, 1, 1636429897932, 1636429898380, 448, 1, 447, 0, 0, 0
2863, 1, 1636429898117, 1636429898569, 452, 0, 452, 0, 0, 0
2864, 1, 1636429898180, 1636429898629, 449, 1, 448, 1, 0, 1
2865, 1, 1636429898244, 1636429898688, 444, 1, 443, 0, 0, 0
2862, 1, 1636429898040, 1636429898732, 692, 241, 451, 241, 0, 241
2868, 1, 1636429898332, 1636429898772, 440, 1, 439, 1, 0, 1
2869, 1, 1636429898380, 1636429898824, 444, 1, 443, 1, 0, 1
2866, 1, 1636429898244, 1636429898828, 584, 137, 447, 137, 0, 137
2867, 1, 1636429898272, 1636429899077, 805, 357, 448, 357, 0, 357
2872, 1, 1636429898816, 1636429899268, 452, 0, 452, 0, 0, 0
2874, 1, 1636429899036, 1636429899493, 457, 0, 457, 0, 0, 0
2873, 1, 1636429898900, 1636429899533, 633, 177, 456, 177, 0, 177
2875, 1, 1636429899156, 1636429899601, 445, 1, 444, 0, 0, 0
2876, 1, 1636429899180, 1636429899625, 445, 1, 444, 1, 0, 1
2877, 1, 1636429899208, 1636429899661, 453, 1, 452, 0, 1, 1
2879, 1, 1636429899316, 1636429899752, 436, 0, 436, 0, 0, 0
2880, 1, 1636429899356, 1636429899805, 449, 1, 448, 0, 0, 0
2881, 1, 1636429899360, 1636429899805, 445, 1, 444, 0, 0, 0
2878, 1, 1636429899232, 1636429899984, 752, 301, 451, 301, 0, 301
2882, 1, 1636429899796, 1636429900244, 448, 1, 447, 0, 1, 1
2883, 1, 1636429899896, 1636429900340, 444, 1, 443, 1, 0, 1
2771, 2, 1636429890380, 1636429900376, 9996, 0, 9996, 0, 0, 0
2774, 2, 1636429890380, 1636429900420, 10040, 0, 10040, 1, 0, 1
2884, 1, 1636429900028, 1636429900476, 448, 1, 447, 1, 0, 1
2776, 2, 1636429890596, 1636429900592, 9996, 0, 9996, 0, 0, 0
2886, 1, 1636429900185, 1636429900644, 459, 0, 459, 0, 0, 0
2887, 1, 1636429900185, 1636429900648, 463, 0, 463, 0, 0, 0
2889, 1, 1636429900296, 1636429900824, 528, 1, 527, 0, 1, 1
2890, 1, 1636429900328, 1636429900824, 496, 0, 496, 0, 0, 0
2888, 1, 1636429900236, 1636429900824, 588, 104, 484, 104, 0, 104
2891, 1, 1636429900464, 1636429900908, 444, 0, 444, 0, 0, 0
2780, 2, 1636429891188, 1636429901184, 9996, 0, 9996, 0, 0, 0
2894, 1, 1636429900788, 1636429901240, 452, 0, 452, 0, 0, 0
2896, 1, 1636429900920, 1636429901409, 489, 1, 488, 0, 0, 0
2897, 1, 1636429901037, 1636429901501, 464, 0, 464, 0, 0, 0
2898, 1, 1636429901152, 1636429901604, 452, 0, 452, 0, 0, 0
2899, 1, 1636429901156, 1636429901609, 453, 0, 453, 0, 0, 0
2789, 2, 1636429891752, 1636429901753, 10001, 0, 10001, 1, 0, 1
2901, 1, 1636429901321, 1636429901760, 439, 0, 439, 0, 0, 0
2902, 1, 1636429901328, 1636429901768, 440, 1, 439, 1, 0, 1
2900, 1, 1636429901232, 1636429901852, 620, 177, 443, 177, 0, 177
2903, 1, 1636429901420, 1636429901856, 436, 0, 436, 0, 0, 0
2905, 1, 1636429901800, 1636429902248, 448, 0, 448, 0, 0, 0
2794, 2, 1636429892272, 1636429902276, 10004, 0, 10004, 1, 0, 1
2798, 2, 1636429892293, 1636429902320, 10027, 0, 10027, 0, 0, 0
2906, 1, 1636429901940, 1636429902392, 452, 0, 452, 0, 0, 0
2908, 1, 1636429902028, 1636429902544, 516, 1, 515, 0, 1, 1
2910, 1, 1636429902152, 1636429902636, 484, 1, 483, 0, 0, 0
2909, 1, 1636429902152, 1636429902636, 484, 1, 483, 0, 0, 0
2801, 1, 1636429892756, 1636429902773, 10017, 9564, 453, 0, 9564, 9564
2912, 1, 1636429902372, 1636429902816, 444, 0, 444, 0, 0, 0
2911, 1, 1636429902240, 1636429902844, 604, 153, 451, 153, 0, 153
2913, 1, 1636429902408, 1636429902857, 449, 0, 449, 0, 0, 0
2916, 1, 1636429902600, 1636429903049, 449, 0, 449, 0, 0, 0
2917, 1, 1636429902788, 1636429903236, 448, 1, 447, 0, 0, 0
2914, 1, 1636429902408, 1636429903260, 852, 409, 443, 409, 0, 409
2920, 1, 1636429903017, 1636429903465, 448, 0, 448, 0, 0, 0
2921, 1, 1636429903129, 1636429903576, 447, 0, 447, 0, 0, 0
2922, 1, 1636429903180, 1636429903624, 444, 1, 443, 1, 0, 1
2919, 1, 1636429902961, 1636429903709, 748, 300, 448, 300, 0, 300
2924, 1, 1636429903316, 1636429903760, 444, 0, 444, 0, 0, 0
2925, 1, 1636429903352, 1636429903796, 444, 1, 443, 0, 0, 0
2926, 1, 1636429903476, 1636429903925, 449, 1, 448, 1, 0, 1
2927, 1, 1636429903501, 1636429904069, 568, 124, 444, 124, 0, 124
2923, 1, 1636429903244, 1636429904165, 921, 465, 456, 465, 0, 465
2928, 1, 1636429903773, 1636429904224, 451, 0, 451, 0, 0, 0
2929, 1, 1636429903964, 1636429904412, 448, 1, 447, 1, 0, 1
2930, 1, 1636429904020, 1636429904472, 452, 1, 451, 0, 0, 0
2931, 1, 1636429904108, 1636429904556, 448, 1, 447, 1, 0, 1
2932, 1, 1636429904177, 1636429904625, 448, 0, 448, 0, 0, 0
2933, 1, 1636429904288, 1636429904744, 456, 1, 455, 0, 1, 1
2934, 1, 1636429904381, 1636429904832, 451, 0, 451, 0, 0, 0
2935, 1, 1636429904392, 1636429904841, 449, 1, 448, 1, 0, 1
2936, 1, 1636429904456, 1636429904905, 449, 0, 449, 0, 0, 0
2937, 1, 1636429904476, 1636429904925, 449, 0, 449, 0, 0, 0
2938, 1, 1636429904780, 1636429905229, 449, 1, 448, 1, 0, 1
2939, 1, 1636429904937, 1636429905388, 451, 0, 451, 0, 0, 0
2940, 1, 1636429905008, 1636429905457, 449, 1, 448, 1, 0, 1
2941, 1, 1636429905109, 1636429905548, 439, 0, 439, 0, 0, 0
2942, 1, 1636429905188, 1636429905632, 444, 1, 443, 0, 0, 0
2943, 1, 1636429905285, 1636429905721, 436, 0, 436, 0, 0, 0
2944, 1, 1636429905360, 1636429905801, 441, 1, 440, 0, 0, 0
2945, 1, 1636429905400, 1636429905849, 449, 1, 448, 0, 0, 0
2946, 1, 1636429905456, 1636429905896, 440, 1, 439, 0, 0, 0
2948, 1, 1636429905760, 1636429906208, 448, 1, 447, 0, 0, 0
2949, 1, 1636429905933, 1636429906380, 447, 0, 447, 0, 0, 0
2950, 1, 1636429905993, 1636429906436, 443, 0, 443, 0, 0, 0
2951, 1, 1636429906113, 1636429906565, 452, 0, 452, 0, 0, 0
2952, 1, 1636429906172, 1636429906625, 453, 1, 452, 0, 0, 0
2953, 1, 1636429906276, 1636429906712, 436, 0, 436, 0, 0, 0
2954, 1, 1636429906352, 1636429906800, 448, 1, 447, 0, 0, 0
2955, 1, 1636429906428, 1636429906872, 444, 0, 444, 0, 0, 0
2956, 1, 1636429906472, 1636429906920, 448, 0, 448, 0, 0, 0
2957, 1, 1636429906741, 1636429907188, 447, 0, 447, 0, 0, 0
2958, 1, 1636429906912, 1636429907360, 448, 0, 448, 0, 0, 0
2959, 1, 1636429906993, 1636429907441, 448, 0, 448, 0, 0, 0
2960, 1, 1636429907137, 1636429907584, 447, 0, 447, 0, 0, 0
2961, 1, 1636429907148, 1636429907584, 436, 0, 436, 0, 0, 0
2963, 1, 1636429907316, 1636429907757, 441, 0, 441, 0, 0, 0
2962, 1, 1636429907312, 1636429907757, 445, 1, 444, 0, 0, 0
2964, 1, 1636429907416, 1636429907853, 437, 0, 437, 0, 0, 0
2965, 1, 1636429907485, 1636429907936, 451, 0, 451, 0, 0, 0
2966, 1, 1636429907744, 1636429908196, 452, 1, 451, 0, 0, 0
2967, 1, 1636429907932, 1636429908380, 448, 1, 447, 0, 0, 0
2968, 1, 1636429908004, 1636429908453, 449, 1, 448, 0, 0, 0
2870, 2, 1636429898512, 1636429908517, 10005, 0, 10005, 261, 0, 261
2969, 1, 1636429908120, 1636429908564, 444, 1, 443, 1, 0, 1
2970, 1, 1636429908156, 1636429908605, 449, 1, 448, 0, 1, 1
2871, 2, 1636429898696, 1636429908700, 10004, 0, 10004, 77, 0, 77
2971, 1, 1636429908308, 1636429908756, 448, 1, 447, 0, 1, 1
2972, 1, 1636429908340, 1636429908836, 496, 1, 495, 0, 0, 0
2973, 1, 1636429908388, 1636429908836, 448, 1, 447, 1, 0, 1
2974, 1, 1636429908564, 1636429909013, 449, 0, 449, 0, 0, 0
2885, 1, 1636429900157, 1636429909152, 8995, 8544, 451, 0, 8544, 8544
2975, 1, 1636429908748, 1636429909200, 452, 1, 451, 1, 0, 1
2976, 1, 1636429908925, 1636429909377, 452, 0, 452, 0, 0, 0
2977, 1, 1636429909024, 1636429909469, 445, 1, 444, 0, 0, 0
2978, 1, 1636429909081, 1636429909525, 444, 0, 444, 0, 0, 0
2979, 1, 1636429909088, 1636429909537, 449, 1, 448, 0, 0, 0
2980, 1, 1636429909116, 1636429909560, 444, 0, 444, 0, 0, 0
2985, 1, 1636429909369, 1636429909809, 440, 0, 440, 0, 0, 0
2982, 1, 1636429909296, 1636429909825, 529, 81, 448, 80, 0, 80
2984, 1, 1636429909369, 1636429909825, 456, 0, 456, 0, 0, 0
2981, 1, 1636429909180, 1636429909908, 728, 289, 439, 289, 0, 289
2986, 1, 1636429909540, 1636429909989, 449, 0, 449, 0, 0, 0
2983, 1, 1636429909376, 1636429909989, 613, 161, 452, 160, 0, 160
2987, 1, 1636429909764, 1636429910360, 596, 145, 451, 144, 0, 144
2988, 1, 1636429909916, 1636429910368, 452, 1, 451, 0, 1, 1
2989, 1, 1636429909996, 1636429910445, 449, 0, 449, 0, 0, 0
2990, 1, 1636429910012, 1636429910460, 448, 1, 447, 0, 0, 0
2991, 1, 1636429910040, 1636429910488, 448, 0, 448, 0, 0, 0
2992, 1, 1636429910140, 1636429910596, 456, 1, 455, 0, 0, 0
2993, 1, 1636429910188, 1636429910633, 445, 1, 444, 0, 1, 1
2893, 2, 1636429900688, 1636429910689, 10001, 0, 10001, 1, 0, 1
2994, 1, 1636429910268, 1636429910716, 448, 0, 448, 0, 0, 0
2892, 2, 1636429900688, 1636429910732, 10044, 0, 10044, 1, 0, 1
2996, 1, 1636429910345, 1636429910792, 447, 0, 447, 0, 0, 0
2997, 1, 1636429910368, 1636429910808, 440, 1, 439, 0, 0, 0
2895, 2, 1636429900900, 1636429910900, 10000, 0, 10000, 0, 0, 0
2995, 1, 1636429910337, 1636429910952, 615, 108, 507, 108, 0, 108
2998, 1, 1636429910540, 1636429911044, 504, 1, 503, 0, 0, 0
2999, 1, 1636429910820, 1636429911312, 492, 1, 491, 0, 0, 0
3000, 1, 1636429910892, 1636429911340, 448, 1, 447, 1, 0, 1
3001, 1, 1636429910992, 1636429911441, 449, 1, 448, 0, 0, 0
3003, 1, 1636429910992, 1636429911444, 452, 1, 451, 0, 1, 1
3004, 1, 1636429911036, 1636429911492, 456, 0, 456, 0, 0, 0
2904, 2, 1636429901500, 1636429911505, 10005, 0, 10005, 0, 0, 0
3005, 1, 1636429911068, 1636429911516, 448, 0, 448, 0, 0, 0
3006, 1, 1636429911132, 1636429911572, 440, 1, 439, 0, 0, 0
3008, 1, 1636429911213, 1636429911665, 452, 0, 452, 0, 0, 0
3009, 1, 1636429911260, 1636429911728, 468, 1, 467, 0, 0, 0
3011, 1, 1636429911344, 1636429911820, 476, 0, 476, 0, 0, 0
3012, 1, 1636429911384, 1636429911837, 453, 1, 452, 0, 1, 1
3007, 1, 1636429911205, 1636429911908, 703, 236, 467, 236, 0, 236
3010, 1, 1636429911320, 1636429911912, 592, 125, 467, 124, 0, 124
3013, 1, 1636429911552, 1636429912001, 449, 1, 448, 0, 0, 0
2907, 2, 1636429902061, 1636429912061, 10000, 0, 10000, 0, 0, 0
3015, 1, 1636429911788, 1636429912228, 440, 1, 439, 0, 0, 0
3016, 1, 1636429911884, 1636429912377, 493, 1, 492, 0, 0, 0
3014, 1, 1636429911812, 1636429912380, 568, 97, 471, 97, 0, 97
3018, 1, 1636429911952, 1636429912400, 448, 1, 447, 0, 0, 0
3019, 1, 1636429912020, 1636429912468, 448, 1, 447, 1, 0, 1
3020, 1, 1636429912108, 1636429912557, 449, 1, 448, 0, 0, 0
2915, 2, 1636429902580, 1636429912584, 10004, 0, 10004, 0, 0, 0
3022, 1, 1636429912156, 1636429912600, 444, 1, 443, 1, 0, 1
3023, 1, 1636429912236, 1636429912696, 460, 0, 460, 0, 0, 0
3024, 1, 1636429912276, 1636429912717, 441, 1, 440, 1, 0, 1
3027, 1, 1636429912360, 1636429912805, 445, 0, 445, 0, 0, 0
3025, 1, 1636429912296, 1636429912849, 553, 105, 448, 105, 0, 105
2918, 2, 1636429902992, 1636429912992, 10000, 0, 10000, 0, 0, 0
3029, 1, 1636429912560, 1636429913008, 448, 0, 448, 0, 0, 0
3028, 1, 1636429912376, 1636429913049, 673, 225, 448, 224, 0, 224
3031, 1, 1636429912788, 1636429913240, 452, 0, 452, 0, 0, 0
3034, 1, 1636429912952, 1636429913404, 452, 0, 452, 0, 0, 0
3033, 1, 1636429912908, 1636429913404, 496, 1, 495, 1, 0, 1
2947, 1, 1636429905476, 1636429913448, 7972, 7517, 455, 0, 7517, 7517
3035, 1, 1636429913036, 1636429913485, 449, 0, 449, 0, 0, 0
3036, 1, 1636429913133, 1636429913589, 456, 0, 456, 0, 0, 0
3037, 1, 1636429913133, 1636429913589, 456, 0, 456, 0, 0, 0
3039, 1, 1636429913248, 1636429913704, 456, 1, 455, 0, 1, 1
3038, 1, 1636429913248, 1636429913705, 457, 0, 457, 0, 0, 0
3042, 1, 1636429913340, 1636429913788, 448, 0, 448, 0, 0, 0
3043, 1, 1636429913384, 1636429913829, 445, 1, 444, 0, 0, 0
3041, 1, 1636429913324, 1636429913848, 524, 81, 443, 81, 0, 81
3044, 1, 1636429913556, 1636429914000, 444, 0, 444, 0, 0, 0
3045, 1, 1636429913660, 1636429914117, 457, 1, 456, 0, 0, 0
3046, 1, 1636429913792, 1636429914237, 445, 0, 445, 0, 0, 0
3047, 1, 1636429913904, 1636429914348, 444, 0, 444, 0, 0, 0
3048, 1, 1636429913948, 1636429914397, 449, 0, 449, 0, 0, 0
3049, 1, 1636429914033, 1636429914472, 439, 0, 439, 0, 0, 0
3051, 1, 1636429914121, 1636429914564, 443, 0, 443, 0, 0, 0
3052, 1, 1636429914220, 1636429914672, 452, 1, 451, 1, 0, 1
3053, 1, 1636429914240, 1636429914689, 449, 1, 448, 0, 1, 1
3055, 1, 1636429914340, 1636429914785, 445, 1, 444, 0, 0, 0
3056, 1, 1636429914356, 1636429914804, 448, 0, 448, 0, 0, 0
3054, 1, 1636429914300, 1636429914844, 544, 97, 447, 96, 0, 96
3057, 1, 1636429914532, 1636429914976, 444, 1, 443, 0, 0, 0
3058, 1, 1636429914664, 1636429915121, 457, 1, 456, 0, 0, 0
3059, 1, 1636429914821, 1636429915272, 451, 0, 451, 0, 0, 0
3060, 1, 1636429914888, 1636429915336, 448, 0, 448, 0, 0, 0
3061, 1, 1636429914932, 1636429915376, 444, 1, 443, 0, 1, 1
3062, 1, 1636429915020, 1636429915477, 457, 0, 457, 0, 0, 0
3063, 1, 1636429915153, 1636429915600, 447, 0, 447, 0, 0, 0
3065, 1, 1636429915221, 1636429915673, 452, 0, 452, 0, 0, 0
3064, 1, 1636429915221, 1636429915676, 455, 0, 455, 0, 0, 0
3066, 1, 1636429915288, 1636429915824, 536, 89, 447, 88, 1, 89
3068, 1, 1636429915368, 1636429915824, 456, 0, 456, 0, 0, 0
3069, 1, 1636429915500, 1636429915952, 452, 1, 451, 1, 0, 1
3070, 1, 1636429915657, 1636429916105, 448, 0, 448, 0, 0, 0
3071, 1, 1636429915852, 1636429916296, 444, 1, 443, 1, 0, 1
3072, 1, 1636429915888, 1636429916336, 448, 1, 447, 0, 0, 0
3073, 1, 1636429915932, 1636429916380, 448, 0, 448, 0, 0, 0
3074, 1, 1636429916021, 1636429916464, 443, 0, 443, 0, 0, 0
3075, 1, 1636429916133, 1636429916572, 439, 0, 439, 0, 0, 0
3077, 1, 1636429916209, 1636429916661, 452, 0, 452, 0, 0, 0
3076, 1, 1636429916209, 1636429916661, 452, 0, 452, 0, 0, 0
3078, 1, 1636429916300, 1636429916832, 532, 81, 451, 81, 0, 81
3079, 1, 1636429916384, 1636429916832, 448, 0, 448, 0, 0, 0
3080, 1, 1636429916508, 1636429916960, 452, 1, 451, 0, 0, 0
3081, 1, 1636429916677, 1636429917129, 452, 0, 452, 0, 0, 0
3082, 1, 1636429916832, 1636429917284, 452, 1, 451, 0, 1, 1
3083, 1, 1636429916876, 1636429917325, 449, 0, 449, 0, 0, 0
3084, 1, 1636429916948, 1636429917404, 456, 1, 455, 0, 0, 0
3086, 1, 1636429917112, 1636429917564, 452, 1, 451, 0, 0, 0
3087, 1, 1636429917188, 1636429917624, 436, 1, 435, 0, 0, 0
3088, 1, 1636429917212, 1636429917668, 456, 1, 455, 0, 1, 1
3090, 1, 1636429917377, 1636429917829, 452, 0, 452, 0, 0, 0
3089, 1, 1636429917316, 1636429917860, 544, 89, 455, 88, 0, 88
3091, 1, 1636429917485, 1636429917937, 452, 0, 452, 0, 0, 0
3092, 1, 1636429917676, 1636429918120, 444, 1, 443, 1, 0, 1
3093, 1, 1636429917812, 1636429918256, 444, 1, 443, 0, 0, 0
3094, 1, 1636429917856, 1636429918308, 452, 1, 451, 0, 0, 0
3095, 1, 1636429917973, 1636429918420, 447, 0, 447, 0, 0, 0
3096, 1, 1636429918093, 1636429918548, 455, 0, 455, 0, 0, 0
3098, 1, 1636429918192, 1636429918632, 440, 1, 439, 0, 1, 1
3097, 1, 1636429918185, 1636429918636, 451, 0, 451, 0, 0, 0
3100, 1, 1636429918360, 1636429918808, 448, 0, 448, 0, 0, 0
3099, 1, 1636429918320, 1636429918873, 553, 101, 452, 101, 0, 101
3101, 1, 1636429918496, 1636429918949, 453, 1, 452, 0, 0, 0
3102, 1, 1636429918673, 1636429919128, 455, 0, 455, 0, 0, 0
3103, 1, 1636429918789, 1636429919240, 451, 0, 451, 0, 0, 0
3104, 1, 1636429918864, 1636429919313, 449, 1, 448, 1, 0, 1
3105, 1, 1636429918973, 1636429919420, 447, 0, 447, 0, 0, 0
3106, 1, 1636429919100, 1636429919544, 444, 1, 443, 1, 0, 1
3107, 1, 1636429919197, 1636429919645, 448, 0, 448, 0, 0, 0
3108, 1, 1636429919197, 1636429919653, 456, 0, 456, 0, 0, 0
3110, 1, 1636429919369, 1636429919824, 455, 0, 455, 0, 0, 0
3109, 1, 1636429919328, 1636429919868, 540, 92, 448, 92, 0, 92
3111, 1, 1636429919504, 1636429919948, 444, 1, 443, 0, 0, 0
3112, 1, 1636429919668, 1636429920116, 448, 1, 447, 0, 0, 0
3113, 1, 1636429919797, 1636429920229, 432, 0, 432, 0, 0, 0
3114, 1, 1636429919885, 1636429920325, 440, 0, 440, 0, 0, 0
3115, 1, 1636429919996, 1636429920445, 449, 1, 448, 1, 0, 1
3116, 1, 1636429920073, 1636429920517, 444, 0, 444, 0, 0, 0
3117, 1, 1636429920212, 1636429920665, 453, 1, 452, 0, 0, 0
3120, 1, 1636429920344, 1636429920801, 457, 1, 456, 1, 0, 1
3121, 1, 1636429920488, 1636429920937, 449, 0, 449, 0, 0, 0
3002, 2, 1636429911000, 1636429921005, 10005, 0, 10005, 1381, 0, 1381
3122, 1, 1636429920700, 1636429921157, 457, 1, 456, 0, 0, 0
3123, 1, 1636429920781, 1636429921233, 452, 0, 452, 0, 0, 0
3125, 1, 1636429921001, 1636429921449, 448, 0, 448, 0, 0, 0
3126, 1, 1636429921097, 1636429921549, 452, 0, 452, 0, 0, 0
3127, 1, 1636429921193, 1636429921645, 452, 0, 452, 0, 0, 0
3128, 1, 1636429921336, 1636429921785, 449, 1, 448, 0, 1, 1
3017, 2, 1636429911904, 1636429921909, 10005, 0, 10005, 473, 0, 473
3129, 1, 1636429921516, 1636429921961, 445, 1, 444, 0, 0, 0
3130, 1, 1636429921700, 1636429922149, 449, 1, 448, 0, 0, 0
3021, 2, 1636429912156, 1636429922157, 10001, 0, 10001, 221, 0, 221
3131, 1, 1636429921788, 1636429922241, 453, 1, 452, 0, 0, 0
3026, 2, 1636429912368, 1636429922373, 10005, 0, 10005, 13, 0, 13
3132, 1, 1636429922045, 1636429922501, 456, 0, 456, 0, 0, 0
3133, 1, 1636429922112, 1636429922601, 489, 0, 489, 0, 0, 0
3134, 1, 1636429922200, 1636429922700, 500, 0, 500, 0, 0, 0
3030, 2, 1636429912724, 1636429922725, 10001, 0, 10001, 0, 0, 0
3135, 1, 1636429922309, 1636429922780, 471, 0, 471, 0, 0, 0
3032, 2, 1636429912881, 1636429922885, 10004, 0, 10004, 0, 0, 0
3136, 1, 1636429922525, 1636429922976, 451, 0, 451, 0, 0, 0
3141, 1, 1636429922692, 1636429923145, 453, 1, 452, 0, 0, 0
3142, 1, 1636429922817, 1636429923293, 476, 0, 476, 0, 0, 0
3040, 2, 1636429913304, 1636429923312, 10008, 0, 10008, 1, 0, 1
3145, 1, 1636429923109, 1636429923560, 451, 0, 451, 0, 0, 0
3147, 1, 1636429923209, 1636429923660, 451, 0, 451, 0, 0, 0
3144, 1, 1636429923037, 1636429923745, 708, 256, 452, 256, 0, 256
3085, 1, 1636429917037, 1636429923752, 6715, 6276, 439, 0, 6275, 6275
3149, 1, 1636429923528, 1636429923973, 445, 1, 444, 0, 0, 0
3050, 2, 1636429914101, 1636429924101, 10000, 0, 10000, 0, 0, 0
3151, 1, 1636429923700, 1636429924204, 504, 53, 451, 53, 0, 53
3152, 1, 1636429923796, 1636429924245, 449, 0, 449, 0, 0, 0
3153, 1, 1636429923969, 1636429924420, 451, 0, 451, 0, 0, 0
3154, 1, 1636429924041, 1636429924501, 460, 0, 460, 0, 0, 0
3067, 1, 1636429915344, 1636429924544, 9200, 8757, 443, 0, 8757, 8757
3155, 1, 1636429924144, 1636429924588, 444, 1, 443, 0, 0, 0
3156, 1, 1636429924188, 1636429924637, 449, 0, 449, 0, 0, 0
3157, 1, 1636429924413, 1636429924869, 456, 0, 456, 0, 0, 0
3158, 1, 1636429924537, 1636429924985, 448, 0, 448, 0, 0, 0
3159, 1, 1636429924716, 1636429925165, 449, 1, 448, 0, 0, 0
3161, 1, 1636429924805, 1636429925256, 451, 0, 451, 0, 0, 0
3160, 1, 1636429924768, 1636429925320, 552, 101, 451, 101, 0, 101
3162, 1, 1636429924901, 1636429925348, 447, 0, 447, 0, 0, 0
3163, 1, 1636429925036, 1636429925477, 441, 1, 440, 0, 1, 1
3164, 1, 1636429925144, 1636429925593, 449, 0, 449, 0, 0, 0
3165, 1, 1636429925196, 1636429925644, 448, 1, 447, 0, 0, 0
3166, 1, 1636429925300, 1636429925736, 436, 1, 435, 0, 0, 0
3167, 1, 1636429925504, 1636429925957, 453, 1, 452, 1, 0, 1
3168, 1, 1636429925717, 1636429926169, 452, 0, 452, 0, 0, 0
3169, 1, 1636429925720, 1636429926193, 473, 17, 456, 17, 0, 17
3170, 1, 1636429925816, 1636429926265, 449, 1, 448, 0, 0, 0
3171, 1, 1636429925872, 1636429926329, 457, 1, 456, 0, 0, 0
3172, 1, 1636429926012, 1636429926465, 453, 1, 452, 0, 0, 0
3173, 1, 1636429926128, 1636429926572, 444, 0, 444, 0, 0, 0
3174, 1, 1636429926172, 1636429926616, 444, 1, 443, 0, 1, 1
3176, 1, 1636429926496, 1636429926945, 449, 0, 449, 0, 0, 0
3177, 1, 1636429926705, 1636429927160, 455, 0, 455, 0, 0, 0
3179, 1, 1636429926820, 1636429927273, 453, 0, 453, 0, 0, 0
3180, 1, 1636429926864, 1636429927313, 449, 1, 448, 0, 0, 0
3181, 1, 1636429926988, 1636429927441, 453, 1, 452, 0, 0, 0
3182, 1, 1636429927140, 1636429927589, 449, 1, 448, 0, 0, 0
3183, 1, 1636429927156, 1636429927609, 453, 0, 453, 0, 0, 0
3184, 1, 1636429927496, 1636429927937, 441, 1, 440, 0, 0, 0
3185, 1, 1636429927737, 1636429928188, 451, 0, 451, 0, 0, 0
3186, 1, 1636429927837, 1636429928288, 451, 0, 451, 0, 0, 0
3187, 1, 1636429927848, 1636429928301, 453, 1, 452, 0, 0, 0
3189, 1, 1636429928133, 1636429928577, 444, 0, 444, 0, 0, 0
3190, 1, 1636429928148, 1636429928596, 448, 1, 447, 0, 0, 0
3191, 1, 1636429928464, 1636429928908, 444, 1, 443, 0, 0, 0
3192, 1, 1636429928756, 1636429929204, 448, 1, 447, 0, 1, 1
3193, 1, 1636429928832, 1636429929285, 453, 1, 452, 0, 0, 0
3194, 1, 1636429928861, 1636429929316, 455, 0, 455, 0, 0, 0
3195, 1, 1636429929120, 1636429929568, 448, 1, 447, 0, 0, 0
3196, 1, 1636429929125, 1636429929568, 443, 0, 443, 0, 0, 0
3197, 1, 1636429929441, 1636429929900, 459, 0, 459, 0, 0, 0
3198, 1, 1636429929741, 1636429930189, 448, 0, 448, 0, 0, 0
3118, 2, 1636429920224, 1636429930225, 10001, 0, 10001, 221, 0, 221
3199, 1, 1636429929801, 1636429930248, 447, 0, 447, 0, 0, 0
3200, 1, 1636429929877, 1636429930324, 447, 0, 447, 0, 0, 0
3119, 2, 1636429920325, 1636429930325, 10000, 0, 10000, 120, 0, 120
3201, 1, 1636429930097, 1636429930544, 447, 0, 447, 0, 0, 0
3202, 1, 1636429930120, 1636429930569, 449, 1, 448, 0, 0, 0
3124, 1, 1636429920897, 1636429930768, 9871, 9428, 443, 0, 9428, 9428
3203, 1, 1636429930464, 1636429930917, 453, 0, 453, 0, 0, 0
3206, 1, 1636429930745, 1636429931201, 456, 0, 456, 0, 0, 0
3205, 1, 1636429930752, 1636429931204, 452, 1, 451, 0, 0, 0
3204, 1, 1636429930752, 1636429931225, 473, 1, 472, 0, 0, 0
3207, 1, 1636429930784, 1636429931236, 452, 1, 451, 0, 0, 0
3208, 1, 1636429930845, 1636429931289, 444, 0, 444, 0, 0, 0
3210, 1, 1636429931076, 1636429931525, 449, 1, 448, 0, 0, 0
3211, 1, 1636429931093, 1636429931540, 447, 0, 447, 0, 0, 0
3209, 1, 1636429930988, 1636429931653, 665, 217, 448, 217, 0, 217
3212, 1, 1636429931441, 1636429931888, 447, 0, 447, 0, 0, 0
3213, 1, 1636429931664, 1636429932113, 449, 1, 448, 0, 0, 0
3215, 1, 1636429931749, 1636429932201, 452, 0, 452, 0, 0, 0
3216, 1, 1636429931769, 1636429932216, 447, 0, 447, 0, 0, 0
3217, 1, 1636429931816, 1636429932269, 453, 1, 452, 1, 0, 1
3219, 1, 1636429932049, 1636429932501, 452, 0, 452, 0, 0, 0
3220, 1, 1636429932077, 1636429932529, 452, 0, 452, 0, 0, 0
3138, 2, 1636429922685, 1636429932685, 10000, 0, 10000, 0, 0, 0
3140, 2, 1636429922692, 1636429932732, 10040, 0, 10040, 1, 0, 1
3139, 2, 1636429922692, 1636429932776, 10084, 0, 10084, 0, 0, 0
3137, 2, 1636429922685, 1636429932820, 10135, 0, 10135, 0, 0, 0
3221, 1, 1636429932404, 1636429932853, 449, 1, 448, 0, 0, 0
3146, 2, 1636429923188, 1636429933192, 10004, 0, 10004, 0, 0, 0
3222, 1, 1636429932645, 1636429933225, 580, 0, 580, 0, 0, 0
3143, 1, 1636429923064, 1636429933265, 10201, 9756, 445, 0, 9755, 9755
3223, 1, 1636429932872, 1636429933316, 444, 1, 443, 0, 0, 0
3224, 1, 1636429932872, 1636429933316, 444, 1, 443, 0, 0, 0
3225, 1, 1636429932908, 1636429933356, 448, 0, 448, 0, 0, 0
3148, 2, 1636429923356, 1636429933360, 10004, 0, 10004, 0, 0, 0
3231, 1, 1636429933052, 1636429933504, 452, 0, 452, 0, 0, 0
3226, 1, 1636429933036, 1636429933508, 472, 0, 472, 0, 0, 0
3227, 1, 1636429933089, 1636429933584, 495, 0, 495, 0, 0, 0
3230, 1, 1636429933089, 1636429933584, 495, 1, 494, 0, 0, 0
3150, 2, 1636429923616, 1636429933621, 10005, 0, 10005, 0, 0, 0
3232, 1, 1636429933404, 1636429933852, 448, 0, 448, 0, 0, 0
3236, 1, 1636429933668, 1636429934117, 449, 1, 448, 0, 0, 0
3235, 1, 1636429933668, 1636429934117, 449, 1, 448, 0, 0, 0
3238, 1, 1636429933752, 1636429934201, 449, 1, 448, 0, 0, 0
3237, 1, 1636429933756, 1636429934205, 449, 0, 449, 0, 0, 0
3239, 1, 1636429933844, 1636429934292, 448, 0, 448, 0, 0, 0
3242, 1, 1636429934000, 1636429934449, 449, 1, 448, 0, 0, 0
3244, 1, 1636429934025, 1636429934473, 448, 0, 448, 0, 0, 0
3243, 1, 1636429934016, 1636429934473, 457, 1, 456, 0, 0, 0
3245, 1, 1636429934436, 1636429934889, 453, 0, 453, 0, 0, 0
3246, 1, 1636429934597, 1636429935048, 451, 0, 451, 0, 0, 0
3247, 1, 1636429934696, 1636429935140, 444, 1, 443, 0, 0, 0
3248, 1, 1636429934720, 1636429935176, 456, 0, 456, 0, 0, 0
3250, 1, 1636429934828, 1636429935277, 449, 0, 449, 0, 0, 0
3251, 1, 1636429934992, 1636429935441, 449, 1, 448, 1, 0, 1
3252, 1, 1636429935008, 1636429935457, 449, 0, 449, 0, 0, 0
3253, 1, 1636429935040, 1636429935484, 444, 1, 443, 0, 0, 0
3254, 1, 1636429935400, 1636429935848, 448, 1, 447, 0, 0, 0
3255, 1, 1636429935617, 1636429936056, 439, 0, 439, 0, 0, 0
3256, 1, 1636429935700, 1636429936141, 441, 1, 440, 0, 0, 0
3257, 1, 1636429935704, 1636429936149, 445, 0, 445, 0, 0, 0
3258, 1, 1636429935797, 1636429936241, 444, 0, 444, 0, 0, 0
3175, 2, 1636429926320, 1636429936321, 10001, 0, 10001, 0, 0, 0
3259, 1, 1636429935957, 1636429936409, 452, 0, 452, 0, 0, 0
3261, 1, 1636429936016, 1636429936453, 437, 0, 437, 0, 0, 0
3260, 1, 1636429936008, 1636429936456, 448, 1, 447, 0, 1, 1
3178, 2, 1636429926721, 1636429936721, 10000, 0, 10000, 0, 0, 0
3262, 1, 1636429936368, 1636429936816, 448, 1, 447, 0, 1, 1
3263, 1, 1636429936580, 1636429937036, 456, 1, 455, 0, 0, 0
3264, 1, 1636429936632, 1636429937128, 496, 0, 496, 0, 0, 0
3265, 1, 1636429936676, 1636429937132, 456, 0, 456, 0, 0, 0
3266, 1, 1636429936705, 1636429937157, 452, 0, 452, 0, 0, 0
3267, 1, 1636429936764, 1636429937212, 448, 1, 447, 0, 0, 0
3268, 1, 1636429936960, 1636429937413, 453, 1, 452, 0, 0, 0
3269, 1, 1636429936981, 1636429937432, 451, 0, 451, 0, 0, 0
3271, 1, 1636429937004, 1636429937453, 449, 0, 449, 0, 0, 0
3270, 1, 1636429937028, 1636429937576, 548, 101, 447, 101, 0, 101
3272, 1, 1636429937337, 1636429937792, 455, 0, 455, 0, 0, 0
3273, 1, 1636429937532, 1636429937976, 444, 0, 444, 0, 0, 0
3188, 2, 1636429928000, 1636429938001, 10001, 0, 10001, 0, 0, 0
3274, 1, 1636429937568, 1636429938016, 448, 0, 448, 0, 0, 0
3275, 1, 1636429937684, 1636429938133, 449, 1, 448, 0, 1, 1
3276, 1, 1636429937708, 1636429938157, 449, 1, 448, 1, 0, 1
3277, 1, 1636429937769, 1636429938225, 456, 0, 456, 0, 0, 0
3280, 1, 1636429937948, 1636429938409, 461, 1, 460, 0, 0, 0
3278, 1, 1636429937924, 1636429938409, 485, 1, 484, 0, 0, 0
3281, 1, 1636429937980, 1636429938429, 449, 0, 449, 0, 0, 0
3279, 1, 1636429937936, 1636429938429, 493, 41, 452, 41, 0, 41
3283, 1, 1636429938300, 1636429938745, 445, 1, 444, 0, 0, 0
3282, 1, 1636429938308, 1636429938752, 444, 1, 443, 0, 0, 0
3284, 1, 1636429938500, 1636429938952, 452, 1, 451, 0, 0, 0
3285, 1, 1636429938580, 1636429939037, 457, 1, 456, 0, 0, 0
3286, 1, 1636429938669, 1636429939120, 451, 0, 451, 0, 0, 0
3287, 1, 1636429938696, 1636429939196, 500, 57, 443, 57, 0, 57
3288, 1, 1636429938764, 1636429939208, 444, 1, 443, 0, 0, 0
3289, 1, 1636429938900, 1636429939348, 448, 0, 448, 0, 0, 0
3291, 1, 1636429938929, 1636429939372, 443, 0, 443, 0, 0, 0
3290, 1, 1636429938920, 1636429939404, 484, 33, 451, 32, 0, 32
3292, 1, 1636429938976, 1636429939416, 440, 1, 439, 1, 0, 1
3293, 1, 1636429939228, 1636429939677, 449, 1, 448, 0, 0, 0
3294, 1, 1636429939324, 1636429939772, 448, 0, 448, 0, 0, 0
3295, 1, 1636429939501, 1636429939956, 455, 0, 455, 0, 0, 0
3296, 1, 1636429939588, 1636429940033, 445, 1, 444, 1, 0, 1
3297, 1, 1636429939636, 1636429940089, 453, 0, 453, 0, 0, 0
3298, 1, 1636429939717, 1636429940165, 448, 0, 448, 0, 0, 0
3299, 1, 1636429939797, 1636429940241, 444, 0, 444, 0, 0, 0
3300, 1, 1636429939860, 1636429940309, 449, 1, 448, 0, 0, 0
3301, 1, 1636429939944, 1636429940393, 449, 1, 448, 0, 0, 0
3302, 1, 1636429939952, 1636429940401, 449, 5, 444, 4, 0, 4
3303, 1, 1636429939976, 1636429940425, 449, 1, 448, 0, 1, 1
3304, 1, 1636429940220, 1636429940677, 457, 1, 456, 0, 0, 0
3305, 1, 1636429940368, 1636429940820, 452, 1, 451, 0, 0, 0
3306, 1, 1636429940468, 1636429940916, 448, 1, 447, 0, 0, 0
3307, 1, 1636429940568, 1636429941008, 440, 1, 439, 0, 0, 0
3308, 1, 1636429940636, 1636429941088, 452, 1, 451, 0, 0, 0
3309, 1, 1636429940709, 1636429941165, 456, 0, 456, 0, 0, 0
3310, 1, 1636429940788, 1636429941241, 453, 1, 452, 0, 0, 0
3311, 1, 1636429940856, 1636429941300, 444, 0, 444, 0, 0, 0
3312, 1, 1636429940944, 1636429941384, 440, 1, 439, 0, 0, 0
3313, 1, 1636429940980, 1636429941429, 449, 1, 448, 0, 0, 0
3314, 1, 1636429940984, 1636429941432, 448, 1, 447, 0, 0, 0
3214, 2, 1636429931680, 1636429941680, 10000, 0, 10000, 1, 0, 1
3315, 1, 1636429941248, 1636429941696, 448, 1, 447, 0, 0, 0
3316, 1, 1636429941329, 1636429941776, 447, 0, 447, 0, 0, 0
3218, 2, 1636429931949, 1636429941952, 10003, 0, 10003, 0, 0, 0
3317, 1, 1636429941505, 1636429941996, 491, 0, 491, 0, 0, 0
3318, 1, 1636429941576, 1636429942024, 448, 0, 448, 0, 0, 0
3319, 1, 1636429941597, 1636429942088, 491, 0, 491, 0, 0, 0
3320, 1, 1636429941724, 1636429942176, 452, 1, 451, 0, 0, 0
3321, 1, 1636429941820, 1636429942269, 449, 1, 448, 0, 0, 0
3322, 1, 1636429941876, 1636429942356, 480, 1, 479, 0, 0, 0
3324, 1, 1636429941948, 1636429942392, 444, 1, 443, 0, 0, 0
3249, 1, 1636429934729, 1636429942396, 7667, 7224, 443, 0, 7223, 7223
3326, 1, 1636429942000, 1636429942445, 445, 1, 444, 1, 0, 1
3325, 1, 1636429942000, 1636429942445, 445, 1, 444, 0, 1, 1
3323, 1, 1636429942000, 1636429942448, 448, 1, 447, 1, 0, 1
3328, 1, 1636429942257, 1636429942704, 447, 0, 447, 0, 0, 0
3329, 1, 1636429942328, 1636429942777, 449, 1, 448, 0, 0, 0
3327, 1, 1636429942257, 1636429942900, 643, 192, 451, 192, 0, 192
3330, 1, 1636429942484, 1636429942932, 448, 0, 448, 0, 0, 0
3332, 1, 1636429942588, 1636429943028, 440, 1, 439, 1, 0, 1
3331, 1, 1636429942616, 1636429943068, 452, 1, 451, 0, 0, 0
3333, 1, 1636429942629, 1636429943084, 455, 0, 455, 0, 0, 0
3229, 2, 1636429933089, 1636429943089, 10000, 0, 10000, 496, 0, 496
3228, 2, 1636429933089, 1636429943137, 10048, 0, 10048, 496, 0, 496
3334, 1, 1636429942740, 1636429943193, 453, 0, 453, 0, 0, 0
3335, 1, 1636429942788, 1636429943360, 572, 112, 460, 112, 0, 112
3337, 1, 1636429942908, 1636429943452, 544, 0, 544, 0, 0, 0
3339, 1, 1636429942948, 1636429943456, 508, 1, 507, 0, 0, 0
3338, 1, 1636429942941, 1636429943456, 515, 0, 515, 0, 0, 0
3336, 1, 1636429942900, 1636429943456, 556, 0, 556, 0, 0, 0
3233, 2, 1636429933484, 1636429943489, 10005, 0, 10005, 101, 0, 101
3234, 2, 1636429933492, 1636429943537, 10045, 0, 10045, 93, 0, 93
3340, 1, 1636429943000, 1636429943548, 548, 1, 547, 1, 0, 1
3342, 1, 1636429943277, 1636429943761, 484, 0, 484, 0, 0, 0
3343, 1, 1636429943308, 1636429943761, 453, 1, 452, 0, 1, 1
3341, 1, 1636429943228, 1636429943944, 716, 225, 491, 224, 0, 224
3241, 1, 1636429933980, 1636429943944, 9964, 9509, 455, 0, 9509, 9509
3344, 1, 1636429943480, 1636429943952, 472, 0, 472, 0, 0, 0
3240, 1, 1636429933925, 1636429943980, 10055, 9612, 443, 0, 9612, 9612
3345, 1, 1636429943584, 1636429944028, 444, 1, 443, 0, 1, 1
3346, 1, 1636429943592, 1636429944032, 440, 0, 440, 0, 0, 0
3347, 1, 1636429943668, 1636429944112, 444, 0, 444, 0, 0, 0
3348, 1, 1636429943708, 1636429944209, 501, 53, 448, 53, 0, 53
3350, 1, 1636429943892, 1636429944332, 440, 0, 440, 0, 0, 0
3354, 1, 1636429943896, 1636429944349, 453, 0, 453, 0, 0, 0
3353, 1, 1636429943896, 1636429944349, 453, 0, 453, 0, 0, 0
3355, 1, 1636429943916, 1636429944360, 444, 0, 444, 0, 0, 0
3357, 1, 1636429943924, 1636429944376, 452, 1, 451, 0, 0, 0
3356, 1, 1636429943916, 1636429944392, 476, 37, 439, 36, 1, 37
3349, 1, 1636429943816, 1636429944396, 580, 129, 451, 129, 0, 129
3358, 1, 1636429943996, 1636429944436, 440, 0, 440, 0, 0, 0
3362, 1, 1636429944252, 1636429944696, 444, 1, 443, 0, 0, 0
3363, 1, 1636429944285, 1636429944740, 455, 0, 455, 0, 0, 0
3360, 1, 1636429944196, 1636429944796, 600, 154, 446, 153, 1, 154
3361, 1, 1636429944180, 1636429944809, 629, 181, 448, 181, 0, 181
3364, 1, 1636429944484, 1636429944936, 452, 1, 451, 0, 1, 1
3365, 1, 1636429944540, 1636429944988, 448, 1, 447, 1, 0, 1
3366, 1, 1636429944568, 1636429945009, 441, 0, 441, 0, 0, 0
3367, 1, 1636429944608, 1636429945044, 436, 1, 435, 0, 1, 1
3368, 1, 1636429944732, 1636429945180, 448, 1, 447, 1, 0, 1
3352, 1, 1636429943904, 1636429945252, 1348, 893, 455, 893, 0, 893
3370, 1, 1636429944820, 1636429945269, 449, 1, 448, 0, 1, 1
3369, 1, 1636429944820, 1636429945276, 456, 1, 455, 0, 0, 0
3374, 1, 1636429944900, 1636429945337, 437, 0, 437, 0, 0, 0
3373, 1, 1636429944888, 1636429945337, 449, 0, 449, 0, 0, 0
3372, 1, 1636429944888, 1636429945337, 449, 0, 449, 0, 0, 0
3375, 1, 1636429944924, 1636429945380, 456, 13, 443, 13, 0, 13
3376, 1, 1636429944976, 1636429945416, 440, 1, 439, 1, 0, 1
3379, 1, 1636429945264, 1636429945724, 460, 1, 459, 0, 1, 1
3380, 1, 1636429945293, 1636429945740, 447, 0, 447, 0, 0, 0
3377, 1, 1636429945168, 1636429945784, 616, 170, 446, 169, 0, 169
3381, 1, 1636429945469, 1636429945916, 447, 0, 447, 0, 0, 0
3382, 1, 1636429945496, 1636429945941, 445, 1, 444, 0, 1, 1
3383, 1, 1636429945544, 1636429945988, 444, 1, 443, 1, 0, 1
3385, 1, 1636429945576, 1636429946024, 448, 1, 447, 0, 1, 1
3384, 1, 1636429945568, 1636429946024, 456, 1, 455, 0, 0, 0
3386, 1, 1636429945760, 1636429946212, 452, 1, 451, 0, 0, 0
3387, 1, 1636429945793, 1636429946236, 443, 0, 443, 0, 0, 0
3388, 1, 1636429945812, 1636429946260, 448, 1, 447, 0, 1, 1
3389, 1, 1636429945864, 1636429946308, 444, 1, 443, 1, 0, 1
3390, 1, 1636429945868, 1636429946316, 448, 1, 447, 0, 0, 0
3391, 1, 1636429945896, 1636429946344, 448, 0, 448, 0, 0, 0
3392, 1, 1636429945936, 1636429946385, 449, 5, 444, 4, 0, 4
3393, 1, 1636429946000, 1636429946437, 437, 1, 436, 1, 0, 1
3395, 1, 1636429946268, 1636429946709, 441, 0, 441, 0, 0, 0
3394, 1, 1636429946165, 1636429946753, 588, 144, 444, 144, 0, 144
3396, 1, 1636429946297, 1636429946753, 456, 0, 456, 0, 0, 0
3397, 1, 1636429946444, 1636429946896, 452, 1, 451, 0, 0, 0
3398, 1, 1636429946512, 1636429946961, 449, 0, 449, 0, 0, 0
3399, 1, 1636429946520, 1636429946968, 448, 0, 448, 0, 0, 0
3400, 1, 1636429946556, 1636429947008, 452, 0, 452, 0, 0, 0
3401, 1, 1636429946580, 1636429947025, 445, 0, 445, 0, 0, 0
3402, 1, 1636429946740, 1636429947193, 453, 1, 452, 0, 0, 0
3403, 1, 1636429946764, 1636429947213, 449, 0, 449, 0, 0, 0
3404, 1, 1636429946836, 1636429947280, 444, 0, 444, 0, 0, 0
3405, 1, 1636429946848, 1636429947304, 456, 0, 456, 0, 0, 0
3407, 1, 1636429946888, 1636429947324, 436, 0, 436, 0, 0, 0
3406, 1, 1636429946876, 1636429947325, 449, 0, 449, 0, 0, 0
3408, 1, 1636429946957, 1636429947409, 452, 4, 448, 4, 0, 4
3409, 1, 1636429946992, 1636429947445, 453, 0, 453, 0, 0, 0
3411, 1, 1636429947288, 1636429947740, 452, 0, 452, 0, 0, 0
3412, 1, 1636429947296, 1636429947748, 452, 0, 452, 0, 0, 0
3410, 1, 1636429947181, 1636429947780, 599, 145, 454, 144, 0, 144
3413, 1, 1636429947420, 1636429947880, 460, 1, 459, 0, 0, 0
3414, 1, 1636429947484, 1636429947924, 440, 1, 439, 1, 0, 1
3415, 1, 1636429947536, 1636429947988, 452, 0, 452, 0, 0, 0
3416, 1, 1636429947552, 1636429947996, 444, 0, 444, 0, 0, 0
3417, 1, 1636429947600, 1636429948049, 449, 0, 449, 0, 0, 0
3418, 1, 1636429947760, 1636429948212, 452, 1, 451, 0, 0, 0
3419, 1, 1636429947776, 1636429948232, 456, 5, 451, 5, 0, 5
3420, 1, 1636429947828, 1636429948268, 440, 1, 439, 0, 1, 1
3421, 1, 1636429947836, 1636429948289, 453, 0, 453, 0, 0, 0
3422, 1, 1636429947860, 1636429948305, 445, 0, 445, 0, 0, 0
3423, 1, 1636429947904, 1636429948348, 444, 0, 444, 0, 0, 0
3424, 1, 1636429947924, 1636429948380, 456, 1, 455, 1, 0, 1
3425, 1, 1636429947980, 1636429948424, 444, 1, 443, 0, 0, 0
3427, 1, 1636429948285, 1636429948732, 447, 0, 447, 0, 0, 0
3428, 1, 1636429948305, 1636429948745, 440, 0, 440, 0, 0, 0
3426, 1, 1636429948196, 1636429948788, 592, 153, 439, 153, 0, 153
3429, 1, 1636429948396, 1636429948852, 456, 1, 455, 1, 0, 1
3430, 1, 1636429948460, 1636429948904, 444, 1, 443, 0, 0, 0
3431, 1, 1636429948516, 1636429948965, 449, 1, 448, 1, 0, 1
3432, 1, 1636429948537, 1636429948980, 443, 0, 443, 0, 0, 0
3433, 1, 1636429948580, 1636429949032, 452, 1, 451, 0, 1, 1
3434, 1, 1636429948748, 1636429949197, 449, 0, 449, 0, 0, 0
3435, 1, 1636429948776, 1636429949244, 468, 13, 455, 13, 0, 13
3436, 1, 1636429948836, 1636429949288, 452, 0, 452, 0, 0, 0
3437, 1, 1636429948872, 1636429949320, 448, 0, 448, 0, 0, 0
3438, 1, 1636429948876, 1636429949328, 452, 0, 452, 0, 0, 0
3439, 1, 1636429948892, 1636429949345, 453, 0, 453, 0, 0, 0
3440, 1, 1636429948912, 1636429949369, 457, 1, 456, 0, 1, 1
3441, 1, 1636429948996, 1636429949449, 453, 1, 452, 0, 0, 0
3443, 1, 1636429949269, 1636429949716, 447, 0, 447, 0, 0, 0
3444, 1, 1636429949336, 1636429949785, 449, 0, 449, 0, 0, 0
3442, 1, 1636429949184, 1636429949796, 612, 161, 451, 160, 0, 160
3445, 1, 1636429949377, 1636429949828, 451, 0, 451, 0, 0, 0
3446, 1, 1636429949469, 1636429949924, 455, 0, 455, 0, 0, 0
3448, 1, 1636429949516, 1636429949968, 452, 1, 451, 0, 0, 0
3447, 1, 1636429949516, 1636429949972, 456, 1, 455, 0, 0, 0
3449, 1, 1636429949612, 1636429950057, 445, 0, 445, 0, 0, 0
3450, 1, 1636429949748, 1636429950201, 453, 0, 453, 0, 0, 0
3451, 1, 1636429949756, 1636429950245, 489, 41, 448, 41, 0, 41
3452, 1, 1636429949808, 1636429950256, 448, 1, 447, 1, 0, 1
3453, 1, 1636429949869, 1636429950308, 439, 0, 439, 0, 0, 0
3454, 1, 1636429949888, 1636429950333, 445, 0, 445, 0, 0, 0
3455, 1, 1636429949932, 1636429950376, 444, 1, 443, 0, 0, 0
3456, 1, 1636429949932, 1636429950376, 444, 1, 443, 0, 1, 1
3457, 1, 1636429950020, 1636429950469, 449, 1, 448, 0, 0, 0
3459, 1, 1636429950232, 1636429950680, 448, 1, 447, 0, 0, 0
3460, 1, 1636429950317, 1636429950768, 451, 0, 451, 0, 0, 0
3461, 1, 1636429950368, 1636429950820, 452, 1, 451, 0, 1, 1
3458, 1, 1636429950188, 1636429950832, 644, 189, 455, 189, 0, 189
3463, 1, 1636429950488, 1636429950924, 436, 1, 435, 0, 0, 0
3462, 1, 1636429950476, 1636429950925, 449, 1, 448, 0, 1, 1
3464, 1, 1636429950548, 1636429950992, 444, 1, 443, 0, 0, 0
3465, 1, 1636429950645, 1636429951092, 447, 0, 447, 0, 0, 0
3466, 1, 1636429950721, 1636429951168, 447, 0, 447, 0, 0, 0
3469, 1, 1636429950836, 1636429951284, 448, 0, 448, 0, 0, 0
3467, 1, 1636429950776, 1636429951288, 512, 57, 455, 57, 0, 57
3468, 1, 1636429950832, 1636429951292, 460, 1, 459, 0, 0, 0
3470, 1, 1636429950876, 1636429951321, 445, 0, 445, 0, 0, 0
3472, 1, 1636429950952, 1636429951389, 437, 0, 437, 0, 0, 0
3471, 1, 1636429950941, 1636429951389, 448, 0, 448, 0, 0, 0
3473, 1, 1636429950992, 1636429951440, 448, 0, 448, 0, 0, 0
3475, 1, 1636429951237, 1636429951688, 451, 0, 451, 0, 0, 0
3476, 1, 1636429951304, 1636429951753, 449, 1, 448, 0, 0, 0
3477, 1, 1636429951364, 1636429951840, 476, 25, 451, 24, 0, 24
3474, 1, 1636429951201, 1636429951840, 639, 189, 450, 188, 0, 188
3478, 1, 1636429951456, 1636429951913, 457, 1, 456, 0, 1, 1
3479, 1, 1636429951524, 1636429951960, 436, 1, 435, 0, 0, 0
3480, 1, 1636429951564, 1636429952004, 440, 1, 439, 1, 0, 1
3481, 1, 1636429951673, 1636429952113, 440, 0, 440, 0, 0, 0
3482, 1, 1636429951720, 1636429952165, 445, 1, 444, 0, 0, 0
3484, 1, 1636429951828, 1636429952276, 448, 1, 447, 0, 0, 0
3485, 1, 1636429951832, 1636429952276, 444, 0, 444, 0, 0, 0
3483, 1, 1636429951792, 1636429952284, 492, 49, 443, 49, 0, 49
3486, 1, 1636429951864, 1636429952308, 444, 0, 444, 0, 0, 0
3487, 1, 1636429951924, 1636429952364, 440, 1, 439, 1, 0, 1
3488, 1, 1636429951941, 1636429952385, 444, 0, 444, 0, 0, 0
3489, 1, 1636429951984, 1636429952428, 444, 1, 443, 0, 0, 0
3491, 1, 1636429952232, 1636429952676, 444, 1, 443, 0, 0, 0
3492, 1, 1636429952337, 1636429952785, 448, 0, 448, 0, 0, 0
3493, 1, 1636429952348, 1636429952800, 452, 1, 451, 0, 0, 0
3490, 1, 1636429952192, 1636429952836, 644, 193, 451, 193, 0, 193
3494, 1, 1636429952472, 1636429952924, 452, 1, 451, 0, 0, 0
3495, 1, 1636429952549, 1636429953000, 451, 0, 451, 0, 0, 0
3496, 1, 1636429952568, 1636429953032, 464, 0, 464, 0, 0, 0
3497, 1, 1636429952656, 1636429953109, 453, 0, 453, 0, 0, 0
3498, 1, 1636429952712, 1636429953157, 445, 1, 444, 1, 0, 1
3500, 1, 1636429952784, 1636429953232, 448, 1, 447, 0, 0, 0
3499, 1, 1636429952756, 1636429953289, 533, 81, 452, 81, 0, 81
3501, 1, 1636429952836, 1636429953293, 457, 1, 456, 0, 0, 0
3502, 1, 1636429952892, 1636429953336, 444, 0, 444, 0, 0, 0
3503, 1, 1636429952916, 1636429953361, 445, 0, 445, 0, 0, 0
3504, 1, 1636429952928, 1636429953381, 453, 0, 453, 0, 0, 0
3505, 1, 1636429953000, 1636429953445, 445, 1, 444, 0, 0, 0
3507, 1, 1636429953217, 1636429953660, 443, 0, 443, 0, 0, 0
3506, 1, 1636429953188, 1636429953809, 621, 173, 448, 172, 0, 172
3509, 1, 1636429953380, 1636429953833, 453, 1, 452, 0, 1, 1
3351, 2, 1636429943900, 1636429953904, 10004, 0, 10004, 433, 0, 433
3510, 1, 1636429953488, 1636429953933, 445, 1, 444, 0, 0, 0
3512, 1, 1636429953544, 1636429953988, 444, 1, 443, 0, 0, 0
3511, 1, 1636429953541, 1636429953992, 451, 0, 451, 0, 0, 0
3513, 1, 1636429953688, 1636429954145, 457, 1, 456, 0, 0, 0
3514, 1, 1636429953700, 1636429954153, 453, 1, 452, 0, 0, 0
3359, 2, 1636429944160, 1636429954165, 10005, 0, 10005, 173, 0, 173
3515, 1, 1636429953748, 1636429954257, 509, 61, 448, 61, 0, 61
3516, 1, 1636429953816, 1636429954309, 493, 0, 493, 0, 0, 0
3517, 1, 1636429953824, 1636429954312, 488, 0, 488, 0, 0, 0
3520, 1, 1636429953952, 1636429954396, 444, 1, 443, 0, 1, 1
3519, 1, 1636429953952, 1636429954400, 448, 1, 447, 0, 1, 1
3521, 1, 1636429954036, 1636429954477, 441, 1, 440, 0, 1, 1
3523, 1, 1636429954257, 1636429954708, 451, 0, 451, 0, 0, 0
3371, 2, 1636429944824, 1636429954828, 10004, 0, 10004, 0, 0, 0
3522, 1, 1636429954212, 1636429954852, 640, 189, 451, 189, 0, 189
3524, 1, 1636429954408, 1636429954852, 444, 1, 443, 0, 1, 1
3525, 1, 1636429954484, 1636429954928, 444, 0, 444, 0, 0, 0
3526, 1, 1636429954528, 1636429954972, 444, 1, 443, 1, 0, 1
3527, 1, 1636429954528, 1636429954984, 456, 1, 455, 1, 0, 1
3529, 1, 1636429954648, 1636429955141, 493, 1, 492, 0, 1, 1
3530, 1, 1636429954704, 1636429955165, 461, 5, 456, 5, 0, 5
3531, 1, 1636429954716, 1636429955168, 452, 1, 451, 0, 0, 0
3378, 2, 1636429945168, 1636429955168, 10000, 0, 10000, 0, 0, 0
3533, 1, 1636429954804, 1636429955249, 445, 1, 444, 0, 0, 0
3532, 1, 1636429954748, 1636429955297, 549, 105, 444, 105, 0, 105
3534, 1, 1636429954876, 1636429955329, 453, 1, 452, 0, 0, 0
3536, 1, 1636429954965, 1636429955416, 451, 0, 451, 0, 0, 0
3535, 1, 1636429954960, 1636429955416, 456, 0, 456, 0, 0, 0
3537, 1, 1636429955016, 1636429955480, 464, 1, 463, 1, 0, 1
3540, 1, 1636429955261, 1636429955704, 443, 0, 443, 0, 0, 0
3539, 1, 1636429955216, 1636429955864, 648, 201, 447, 201, 0, 201
3541, 1, 1636429955436, 1636429955888, 452, 0, 452, 0, 0, 0
3543, 1, 1636429955460, 1636429955905, 445, 1, 444, 0, 0, 0
3544, 1, 1636429955541, 1636429955988, 447, 0, 447, 0, 0, 0
3545, 1, 1636429955552, 1636429956000, 448, 1, 447, 0, 0, 0
3546, 1, 1636429955564, 1636429956012, 448, 0, 448, 0, 0, 0
3547, 1, 1636429955696, 1636429956152, 456, 9, 447, 9, 0, 9
3548, 1, 1636429955724, 1636429956176, 452, 0, 452, 0, 0, 0
3550, 1, 1636429955804, 1636429956248, 444, 0, 444, 0, 0, 0
3549, 1, 1636429955764, 1636429956309, 545, 101, 444, 100, 0, 100
3552, 1, 1636429955936, 1636429956385, 449, 1, 448, 0, 0, 0
3553, 1, 1636429955960, 1636429956409, 449, 0, 449, 0, 0, 0
3554, 1, 1636429956021, 1636429956469, 448, 0, 448, 0, 0, 0
3556, 1, 1636429956244, 1636429956692, 448, 1, 447, 1, 0, 1
3555, 1, 1636429956196, 1636429956864, 668, 213, 455, 213, 0, 213
3557, 1, 1636429956464, 1636429956912, 448, 1, 447, 0, 1, 1
3559, 1, 1636429956545, 1636429957004, 459, 0, 459, 0, 0, 0
3561, 1, 1636429956568, 1636429957033, 465, 0, 465, 0, 0, 0
3562, 1, 1636429956728, 1636429957176, 448, 1, 447, 1, 0, 1
3563, 1, 1636429956764, 1636429957216, 452, 1, 451, 1, 0, 1
3565, 1, 1636429956788, 1636429957232, 444, 1, 443, 0, 0, 0
3566, 1, 1636429956940, 1636429957388, 448, 1, 447, 0, 0, 0
3567, 1, 1636429956944, 1636429957392, 448, 1, 447, 0, 0, 0
3568, 1, 1636429957033, 1636429957477, 444, 0, 444, 0, 0, 0
3570, 1, 1636429957264, 1636429957713, 449, 0, 449, 0, 0, 0
3569, 1, 1636429957197, 1636429957845, 648, 196, 452, 196, 0, 196
3571, 1, 1636429957505, 1636429957952, 447, 0, 447, 0, 0, 0
3572, 1, 1636429957532, 1636429957980, 448, 1, 447, 0, 0, 0
3573, 1, 1636429957556, 1636429958000, 444, 1, 443, 1, 0, 1
3575, 1, 1636429957757, 1636429958205, 448, 0, 448, 0, 0, 0
3574, 1, 1636429957752, 1636429958205, 453, 1, 452, 0, 0, 0
3576, 1, 1636429957776, 1636429958221, 445, 1, 444, 0, 0, 0
3577, 1, 1636429957968, 1636429958421, 453, 1, 452, 0, 0, 0
3578, 1, 1636429957968, 1636429958421, 453, 0, 453, 0, 0, 0
3579, 1, 1636429958008, 1636429958448, 440, 0, 440, 0, 0, 0
3581, 1, 1636429958257, 1636429958709, 452, 0, 452, 0, 0, 0
3580, 1, 1636429958204, 1636429958885, 681, 218, 463, 216, 0, 216
3582, 1, 1636429958520, 1636429958976, 456, 1, 455, 0, 0, 0
3584, 1, 1636429958584, 1636429959040, 456, 0, 456, 0, 0, 0
3585, 1, 1636429958748, 1636429959200, 452, 1, 451, 1, 0, 1
3586, 1, 1636429958772, 1636429959216, 444, 0, 444, 0, 0, 0
3587, 1, 1636429958813, 1636429959260, 447, 0, 447, 0, 0, 0
3588, 1, 1636429958972, 1636429959412, 440, 0, 440, 0, 0, 0
3589, 1, 1636429958996, 1636429959433, 437, 1, 436, 1, 0, 1
3592, 1, 1636429959280, 1636429959716, 436, 1, 435, 0, 0, 0
3591, 1, 1636429959204, 1636429959857, 653, 209, 444, 209, 0, 209
3593, 1, 1636429959521, 1636429959968, 447, 0, 447, 0, 0, 0
3594, 1, 1636429959608, 1636429960056, 448, 1, 447, 1, 0, 1
3595, 1, 1636429959769, 1636429960213, 444, 0, 444, 0, 0, 0
3596, 1, 1636429959785, 1636429960236, 451, 0, 451, 0, 0, 0
3598, 1, 1636429960008, 1636429960457, 449, 1, 448, 0, 0, 0
3599, 1, 1636429960016, 1636429960469, 453, 1, 452, 0, 0, 0
3597, 1, 1636429959849, 1636429960688, 839, 388, 451, 388, 0, 388
3601, 1, 1636429960292, 1636429960744, 452, 1, 451, 0, 0, 0
3600, 1, 1636429960216, 1636429960908, 692, 241, 451, 240, 0, 240
3602, 1, 1636429960485, 1636429960936, 451, 0, 451, 0, 0, 0
3603, 1, 1636429960608, 1636429961057, 449, 1, 448, 0, 1, 1
3604, 1, 1636429960780, 1636429961233, 453, 1, 452, 0, 0, 0
3605, 1, 1636429960788, 1636429961233, 445, 0, 445, 0, 0, 0
3606, 1, 1636429960904, 1636429961352, 448, 0, 448, 0, 0, 0
3607, 1, 1636429960968, 1636429961420, 452, 0, 452, 0, 0, 0
3608, 1, 1636429961020, 1636429961468, 448, 1, 447, 0, 0, 0
3610, 1, 1636429961260, 1636429961708, 448, 0, 448, 0, 0, 0
3609, 1, 1636429961208, 1636429961868, 660, 213, 447, 213, 0, 213
3611, 1, 1636429961520, 1636429961964, 444, 1, 443, 0, 0, 0
3612, 1, 1636429961588, 1636429962040, 452, 1, 451, 0, 0, 0
3613, 1, 1636429961772, 1636429962221, 449, 1, 448, 1, 0, 1
3614, 1, 1636429961788, 1636429962241, 453, 0, 453, 0, 0, 0
3615, 1, 1636429961852, 1636429962305, 453, 1, 452, 0, 0, 0
3617, 1, 1636429962008, 1636429962460, 452, 0, 452, 0, 0, 0
3616, 1, 1636429962004, 1636429962460, 456, 1, 455, 0, 0, 0
3619, 1, 1636429962268, 1636429962717, 449, 1, 448, 0, 0, 0
3618, 1, 1636429962220, 1636429962912, 692, 241, 451, 240, 0, 240
3620, 1, 1636429962549, 1636429962992, 443, 0, 443, 0, 0, 0
3621, 1, 1636429962588, 1636429963032, 444, 1, 443, 1, 0, 1
3622, 1, 1636429962757, 1636429963204, 447, 0, 447, 0, 0, 0
3623, 1, 1636429962780, 1636429963228, 448, 1, 447, 1, 0, 1
3624, 1, 1636429962848, 1636429963292, 444, 0, 444, 0, 0, 0
3508, 2, 1636429953316, 1636429963320, 10004, 0, 10004, 1, 0, 1
3625, 1, 1636429962996, 1636429963444, 448, 0, 448, 0, 0, 0
3626, 1, 1636429963028, 1636429963481, 453, 0, 453, 0, 0, 0
3628, 1, 1636429963244, 1636429963729, 485, 1, 484, 0, 0, 0
3518, 2, 1636429953864, 1636429963865, 10001, 0, 10001, 0, 0, 0
3627, 1, 1636429963224, 1636429963932, 708, 258, 450, 257, 0, 257
3629, 1, 1636429963557, 1636429964009, 452, 0, 452, 0, 0, 0
3631, 1, 1636429963624, 1636429964088, 464, 1, 463, 0, 0, 0
3632, 1, 1636429963745, 1636429964189, 444, 0, 444, 0, 0, 0
3633, 1, 1636429963760, 1636429964205, 445, 1, 444, 0, 0, 0
3634, 1, 1636429963845, 1636429964288, 443, 0, 443, 0, 0, 0
3635, 1, 1636429963996, 1636429964449, 453, 0, 453, 0, 0, 0
3636, 1, 1636429964040, 1636429964496, 456, 0, 456, 0, 0, 0
3528, 2, 1636429954648, 1636429964649, 10001, 0, 10001, 493, 0, 493
3639, 1, 1636429964260, 1636429964709, 449, 1, 448, 1, 0, 1
3638, 1, 1636429964240, 1636429964964, 724, 257, 467, 256, 0, 256
3538, 2, 1636429955132, 1636429965133, 10001, 0, 10001, 9, 0, 9
3643, 1, 1636429964744, 1636429965192, 448, 1, 447, 0, 0, 0
3642, 1, 1636429964784, 1636429965236, 452, 1, 451, 1, 0, 1
3644, 1, 1636429964864, 1636429965356, 492, 1, 491, 0, 0, 0
3645, 1, 1636429964964, 1636429965452, 488, 0, 488, 0, 0, 0
3542, 2, 1636429955493, 1636429965493, 10000, 0, 10000, 0, 0, 0
3646, 1, 1636429965060, 1636429965541, 481, 1, 480, 0, 0, 0
3647, 1, 1636429965268, 1636429965725, 457, 1, 456, 0, 0, 0
3551, 2, 1636429955832, 1636429965837, 10005, 0, 10005, 0, 0, 0
3649, 1, 1636429965444, 1636429965901, 457, 0, 457, 0, 0, 0
3648, 1, 1636429965268, 1636429965997, 729, 273, 456, 272, 0, 272
3652, 1, 1636429965776, 1636429966240, 464, 1, 463, 1, 0, 1
3653, 1, 1636429965792, 1636429966244, 452, 0, 452, 0, 0, 0
3560, 1, 1636429956545, 1636429966284, 9739, 9292, 447, 0, 9292, 9292
3654, 1, 1636429965884, 1636429966329, 445, 1, 444, 0, 0, 0
3655, 1, 1636429965973, 1636429966417, 444, 0, 444, 0, 0, 0
3558, 2, 1636429956468, 1636429966469, 10001, 0, 10001, 396, 0, 396
3656, 1, 1636429966044, 1636429966493, 449, 1, 448, 0, 0, 0
3659, 1, 1636429966257, 1636429966709, 452, 0, 452, 0, 0, 0
3564, 2, 1636429956788, 1636429966789, 10001, 0, 10001, 76, 0, 76
3660, 1, 1636429966344, 1636429966792, 448, 1, 447, 1, 0, 1
3658, 1, 1636429966228, 1636429966944, 716, 265, 451, 264, 0, 264
3663, 1, 1636429966752, 1636429967200, 448, 0, 448, 0, 0, 0
3662, 1, 1636429966748, 1636429967201, 453, 1, 452, 1, 0, 1
3665, 1, 1636429966936, 1636429967389, 453, 0, 453, 0, 0, 0
3666, 1, 1636429967068, 1636429967528, 460, 1, 459, 0, 0, 0
3668, 1, 1636429967184, 1636429967633, 449, 1, 448, 0, 0, 0
3664, 1, 1636429966833, 1636429967657, 824, 369, 455, 368, 0, 368
3670, 1, 1636429967277, 1636429967725, 448, 0, 448, 0, 0, 0
3671, 1, 1636429967356, 1636429967812, 456, 1, 455, 0, 0, 0
3669, 1, 1636429967244, 1636429967980, 736, 285, 451, 285, 0, 285
3672, 1, 1636429967716, 1636429968160, 444, 1, 443, 0, 1, 1
3673, 1, 1636429967757, 1636429968204, 447, 0, 447, 0, 0, 0
3674, 1, 1636429967876, 1636429968324, 448, 1, 447, 0, 0, 0
3675, 1, 1636429967952, 1636429968393, 441, 1, 440, 0, 0, 0
3676, 1, 1636429968065, 1636429968505, 440, 0, 440, 0, 0, 0
3583, 2, 1636429958529, 1636429968533, 10004, 0, 10004, 0, 0, 0
3677, 1, 1636429968097, 1636429968541, 444, 0, 444, 0, 0, 0
3679, 1, 1636429968317, 1636429968769, 452, 0, 452, 0, 0, 0
3680, 1, 1636429968341, 1636429968789, 448, 0, 448, 0, 0, 0
3678, 1, 1636429968248, 1636429968996, 748, 293, 455, 293, 0, 293
3590, 2, 1636429959000, 1636429969000, 10000, 0, 10000, 0, 0, 0
3681, 1, 1636429968724, 1636429969172, 448, 0, 448, 0, 0, 0
3683, 1, 1636429968796, 1636429969253, 457, 0, 457, 0, 0, 0
3684, 1, 1636429968840, 1636429969320, 480, 1, 479, 0, 1, 1
3685, 1, 1636429968940, 1636429969408, 468, 1, 467, 0, 0, 0
3686, 1, 1636429969092, 1636429969553, 461, 0, 461, 0, 0, 0
3687, 1, 1636429969136, 1636429969584, 448, 0, 448, 0, 0, 0
3690, 1, 1636429969312, 1636429969765, 453, 1, 452, 1, 0, 1
3691, 1, 1636429969312, 1636429969765, 453, 1, 452, 1, 0, 1
3688, 1, 1636429969253, 1636429970033, 780, 332, 448, 332, 0, 332
3692, 1, 1636429969713, 1636429970164, 451, 0, 451, 0, 0, 0
3693, 1, 1636429969777, 1636429970220, 443, 0, 443, 0, 0, 0
3694, 1, 1636429969833, 1636429970276, 443, 0, 443, 0, 0, 0
3695, 1, 1636429969937, 1636429970385, 448, 0, 448, 0, 0, 0
3696, 1, 1636429970073, 1636429970520, 447, 0, 447, 0, 0, 0
3697, 1, 1636429970133, 1636429970581, 448, 0, 448, 0, 0, 0
3700, 1, 1636429970300, 1636429970736, 436, 1, 435, 0, 1, 1
3699, 1, 1636429970289, 1636429970736, 447, 0, 447, 0, 0, 0
3698, 1, 1636429970293, 1636429971037, 744, 288, 456, 288, 0, 288
3701, 1, 1636429970700, 1636429971144, 444, 0, 444, 0, 0, 0
3702, 1, 1636429970753, 1636429971196, 443, 0, 443, 0, 0, 0
3703, 1, 1636429970825, 1636429971273, 448, 0, 448, 0, 0, 0
3704, 1, 1636429970916, 1636429971368, 452, 1, 451, 0, 0, 0
3705, 1, 1636429971060, 1636429971500, 440, 1, 439, 1, 0, 1
3706, 1, 1636429971097, 1636429971544, 447, 0, 447, 0, 0, 0
3708, 1, 1636429971301, 1636429971745, 444, 0, 444, 0, 0, 0
3709, 1, 1636429971324, 1636429971772, 448, 1, 447, 0, 1, 1
3707, 1, 1636429971288, 1636429971996, 708, 257, 451, 257, 0, 257
3710, 1, 1636429971668, 1636429972124, 456, 1, 455, 0, 0, 0
3711, 1, 1636429971748, 1636429972200, 452, 1, 451, 0, 0, 0
3712, 1, 1636429971857, 1636429972300, 443, 0, 443, 0, 0, 0
3713, 1, 1636429971933, 1636429972385, 452, 0, 452, 0, 0, 0
3714, 1, 1636429972072, 1636429972520, 448, 1, 447, 0, 0, 0
3715, 1, 1636429972089, 1636429972533, 444, 0, 444, 0, 0, 0
3718, 1, 1636429972325, 1636429972777, 452, 0, 452, 0, 0, 0
3716, 1, 1636429972252, 1636429972989, 737, 281, 456, 281, 0, 281
3719, 1, 1636429972697, 1636429973153, 456, 0, 456, 0, 0, 0
3721, 1, 1636429972873, 1636429973333, 460, 0, 460, 0, 0, 0
3722, 1, 1636429972949, 1636429973405, 456, 0, 456, 0, 0, 0
3723, 1, 1636429973080, 1636429973533, 453, 1, 452, 0, 0, 0
3630, 2, 1636429963628, 1636429973629, 10001, 0, 10001, 1, 0, 1
3724, 1, 1636429973100, 1636429973785, 685, 233, 452, 233, 0, 233
3726, 1, 1636429973349, 1636429973797, 448, 0, 448, 0, 0, 0
3725, 1, 1636429973241, 1636429974033, 792, 293, 499, 292, 0, 292
3727, 1, 1636429973716, 1636429974165, 449, 1, 448, 0, 0, 0
3637, 2, 1636429964173, 1636429974176, 10003, 0, 10003, 0, 0, 0
3728, 1, 1636429973868, 1636429974317, 449, 1, 448, 0, 0, 0
3729, 1, 1636429973937, 1636429974404, 467, 0, 467, 0, 0, 0
3730, 1, 1636429973976, 1636429974425, 449, 1, 448, 0, 0, 0
3732, 1, 1636429974117, 1636429974584, 467, 0, 467, 0, 0, 0
3640, 2, 1636429964584, 1636429974584, 10000, 0, 10000, 0, 0, 0
3731, 1, 1636429974093, 1636429974588, 495, 0, 495, 0, 0, 0
3641, 2, 1636429964628, 1636429974628, 10000, 0, 10000, 0, 0, 0
3734, 1, 1636429974353, 1636429974852, 499, 0, 499, 0, 0, 0
3735, 1, 1636429974480, 1636429974944, 464, 1, 463, 0, 0, 0
3733, 1, 1636429974281, 1636429975041, 760, 304, 456, 304, 0, 304
3736, 1, 1636429974720, 1636429975169, 449, 1, 448, 0, 0, 0
3738, 1, 1636429974852, 1636429975300, 448, 1, 447, 0, 1, 1
3739, 1, 1636429974852, 1636429975301, 449, 1, 448, 0, 0, 0
3737, 1, 1636429974896, 1636429975344, 448, 0, 448, 0, 0, 0
3741, 1, 1636429974976, 1636429975425, 449, 1, 448, 0, 0, 0
3650, 2, 1636429965452, 1636429975457, 10005, 0, 10005, 449, 0, 449
3742, 1, 1636429975060, 1636429975517, 457, 1, 456, 1, 0, 1
3743, 1, 1636429975084, 1636429975537, 453, 0, 453, 0, 0, 0
3745, 1, 1636429975328, 1636429975801, 473, 17, 456, 16, 0, 16
3651, 2, 1636429965804, 1636429975801, 9997, 0, 9997, 97, 0, 97
3746, 1, 1636429975416, 1636429975865, 449, 1, 448, 1, 0, 1
3744, 1, 1636429975288, 1636429976021, 733, 249, 484, 249, 0, 249
3747, 1, 1636429975705, 1636429976144, 439, 0, 439, 0, 0, 0
3657, 2, 1636429966145, 1636429976144, 9999, 0, 9999, 0, 0, 0
3748, 1, 1636429975781, 1636429976224, 443, 0, 443, 0, 0, 0
3749, 1, 1636429975848, 1636429976288, 440, 0, 440, 0, 0, 0
3750, 1, 1636429975888, 1636429976364, 476, 1, 475, 1, 0, 1
3751, 1, 1636429976004, 1636429976456, 452, 0, 452, 0, 0, 0
3752, 1, 1636429976052, 1636429976496, 444, 0, 444, 0, 0, 0
3753, 1, 1636429976093, 1636429976544, 451, 0, 451, 0, 0, 0
3661, 1, 1636429966517, 1636429976592, 10075, 9628, 447, 0, 9628, 9628
3755, 1, 1636429976236, 1636429976680, 444, 1, 443, 0, 0, 0
3757, 1, 1636429976308, 1636429976760, 452, 0, 452, 0, 0, 0
3759, 1, 1636429976440, 1636429976888, 448, 0, 448, 0, 0, 0
3758, 1, 1636429976456, 1636429976896, 440, 0, 440, 0, 0, 0
3756, 1, 1636429976236, 1636429976940, 704, 261, 443, 261, 0, 261
3754, 1, 1636429976236, 1636429977128, 892, 445, 447, 444, 1, 445
3760, 1, 1636429976712, 1636429977164, 452, 1, 451, 0, 0, 0
3667, 2, 1636429967172, 1636429977172, 10000, 0, 10000, 0, 0, 0
3762, 1, 1636429976812, 1636429977252, 440, 0, 440, 0, 0, 0
3763, 1, 1636429976816, 1636429977253, 437, 0, 437, 0, 0, 0
3764, 1, 1636429976852, 1636429977300, 448, 0, 448, 0, 0, 0
3761, 1, 1636429976812, 1636429977340, 528, 85, 443, 85, 0, 85
3766, 1, 1636429977069, 1636429977512, 443, 0, 443, 0, 0, 0
3767, 1, 1636429977100, 1636429977576, 476, 1, 475, 0, 1, 1
3768, 1, 1636429977120, 1636429977580, 460, 1, 459, 1, 0, 1
3765, 1, 1636429977008, 1636429977580, 572, 121, 451, 121, 0, 121
3771, 1, 1636429977344, 1636429977792, 448, 1, 447, 0, 0, 0
3770, 1, 1636429977356, 1636429977796, 440, 1, 439, 0, 0, 0
3772, 1, 1636429977392, 1636429977840, 448, 0, 448, 0, 0, 0
3773, 1, 1636429977436, 1636429977884, 448, 0, 448, 0, 0, 0
3774, 1, 1636429977476, 1636429977924, 448, 0, 448, 0, 0, 0
3769, 1, 1636429977260, 1636429977964, 704, 253, 451, 253, 0, 253
3775, 1, 1636429977704, 1636429978148, 444, 0, 444, 0, 0, 0
3778, 1, 1636429977809, 1636429978265, 456, 0, 456, 0, 0, 0
3779, 1, 1636429977816, 1636429978268, 452, 1, 451, 0, 0, 0
3780, 1, 1636429978016, 1636429978468, 452, 0, 452, 0, 0, 0
3781, 1, 1636429978060, 1636429978504, 444, 1, 443, 0, 0, 0
3782, 1, 1636429978097, 1636429978537, 440, 0, 440, 0, 0, 0
3783, 1, 1636429978133, 1636429978581, 448, 0, 448, 0, 0, 0
3785, 1, 1636429978304, 1636429978752, 448, 0, 448, 0, 0, 0
3786, 1, 1636429978308, 1636429978765, 457, 0, 457, 0, 0, 0
3682, 2, 1636429968840, 1636429978836, 9996, 0, 9996, 1, 0, 1
3788, 1, 1636429978404, 1636429978852, 448, 1, 447, 0, 0, 0
3787, 1, 1636429978404, 1636429978852, 448, 1, 447, 0, 0, 0
3789, 1, 1636429978428, 1636429978876, 448, 0, 448, 0, 0, 0
3784, 1, 1636429978236, 1636429978960, 724, 269, 455, 269, 0, 269
3790, 1, 1636429978709, 1636429979152, 443, 0, 443, 0, 0, 0
3791, 1, 1636429978776, 1636429979245, 469, 1, 468, 0, 0, 0
3792, 1, 1636429978796, 1636429979245, 449, 0, 449, 0, 0, 0
3689, 2, 1636429969300, 1636429979304, 10004, 0, 10004, 0, 0, 0
3793, 1, 1636429979017, 1636429979464, 447, 0, 447, 0, 0, 0
3794, 1, 1636429979060, 1636429979529, 469, 0, 469, 0, 0, 0
3797, 1, 1636429979132, 1636429979613, 481, 0, 481, 0, 0, 0
3795, 1, 1636429979148, 1636429979616, 468, 0, 468, 0, 0, 0
3796, 1, 1636429979129, 1636429979616, 487, 0, 487, 0, 0, 0
3799, 1, 1636429979296, 1636429979748, 452, 1, 451, 0, 1, 1
3740, 1, 1636429974940, 1636429979756, 4816, 4365, 451, 0, 4364, 4364
3800, 1, 1636429979348, 1636429979796, 448, 0, 448, 0, 0, 0
3801, 1, 1636429979396, 1636429979848, 452, 1, 451, 0, 0, 0
3803, 1, 1636429979396, 1636429979848, 452, 1, 451, 1, 0, 1
3802, 1, 1636429979396, 1636429979856, 460, 1, 459, 1, 0, 1
3798, 1, 1636429979236, 1636429979976, 740, 293, 447, 292, 0, 292
3804, 1, 1636429979605, 1636429980068, 463, 12, 451, 12, 0, 12
3805, 1, 1636429979689, 1636429980140, 451, 0, 451, 0, 0, 0
3807, 1, 1636429979785, 1636429980232, 447, 0, 447, 0, 0, 0
3806, 1, 1636429979788, 1636429980237, 449, 1, 448, 0, 0, 0
3809, 1, 1636429980044, 1636429980485, 441, 0, 441, 0, 0, 0
3810, 1, 1636429980052, 1636429980501, 449, 1, 448, 0, 1, 1
3808, 1, 1636429979968, 1636429980508, 540, 101, 439, 101, 0, 101
3811, 1, 1636429980084, 1636429980532, 448, 0, 448, 0, 0, 0
3813, 1, 1636429980152, 1636429980605, 453, 1, 452, 0, 0, 0
3812, 1, 1636429980152, 1636429980605, 453, 1, 452, 0, 0, 0
3815, 1, 1636429980260, 1636429980712, 452, 0, 452, 0, 0, 0
3816, 1, 1636429980312, 1636429980752, 440, 1, 439, 1, 0, 1
3817, 1, 1636429980348, 1636429980796, 448, 0, 448, 0, 0, 0
3818, 1, 1636429980392, 1636429980837, 445, 1, 444, 0, 1, 1
3819, 1, 1636429980396, 1636429980837, 441, 1, 440, 0, 0, 0
3814, 1, 1636429980236, 1636429980953, 717, 265, 452, 265, 0, 265
3820, 1, 1636429980544, 1636429980988, 444, 1, 443, 0, 1, 1
3822, 1, 1636429980784, 1636429981228, 444, 1, 443, 1, 0, 1
3823, 1, 1636429980820, 1636429981285, 465, 1, 464, 0, 1, 1
3824, 1, 1636429980953, 1636429981448, 495, 36, 459, 36, 0, 36
3825, 1, 1636429981049, 1636429981500, 451, 0, 451, 0, 0, 0
3826, 1, 1636429981060, 1636429981508, 448, 0, 448, 0, 0, 0
3827, 1, 1636429981076, 1636429981529, 453, 1, 452, 0, 0, 0
3828, 1, 1636429981144, 1636429981580, 436, 0, 436, 0, 0, 0
3829, 1, 1636429981184, 1636429981648, 464, 1, 463, 0, 1, 1
3831, 1, 1636429981265, 1636429981720, 455, 0, 455, 0, 0, 0
3833, 1, 1636429981312, 1636429981761, 449, 1, 448, 0, 0, 0
3834, 1, 1636429981364, 1636429981820, 456, 1, 455, 1, 0, 1
3835, 1, 1636429981380, 1636429981828, 448, 1, 447, 0, 0, 0
3830, 1, 1636429981236, 1636429981965, 729, 273, 456, 273, 0, 273
3836, 1, 1636429981520, 1636429981973, 453, 9, 444, 9, 0, 9
3832, 1, 1636429981320, 1636429982208, 888, 442, 446, 441, 1, 442
3837, 1, 1636429981793, 1636429982237, 444, 0, 444, 0, 0, 0
3838, 1, 1636429981812, 1636429982256, 444, 0, 444, 0, 0, 0
3717, 2, 1636429972289, 1636429982292, 10003, 0, 10003, 0, 0, 0
3839, 1, 1636429981944, 1636429982424, 480, 28, 452, 28, 0, 28
3840, 1, 1636429982048, 1636429982516, 468, 1, 467, 0, 0, 0
3841, 1, 1636429982069, 1636429982532, 463, 0, 463, 0, 0, 0
3842, 1, 1636429982092, 1636429982540, 448, 0, 448, 0, 0, 0
3843, 1, 1636429982132, 1636429982608, 476, 0, 476, 0, 0, 0
3844, 1, 1636429982156, 1636429982608, 452, 0, 452, 0, 0, 0
3846, 1, 1636429982252, 1636429982700, 448, 0, 448, 0, 0, 0
3720, 1, 1636429972744, 1636429982740, 9996, 9549, 447, 0, 9548, 9548
3847, 1, 1636429982340, 1636429982784, 444, 0, 444, 0, 0, 0
3848, 1, 1636429982384, 1636429982836, 452, 0, 452, 0, 0, 0
3849, 1, 1636429982424, 1636429982872, 448, 1, 447, 0, 0, 0
3850, 1, 1636429982468, 1636429982924, 456, 0, 456, 0, 0, 0
3851, 1, 1636429982536, 1636429982981, 445, 5, 440, 5, 0, 5
3845, 1, 1636429982236, 1636429982984, 748, 297, 451, 296, 0, 296
3852, 1, 1636429982600, 1636429983056, 456, 1, 455, 0, 0, 0
3853, 1, 1636429982776, 1636429983220, 444, 1, 443, 0, 1, 1
3854, 1, 1636429982784, 1636429983228, 444, 1, 443, 0, 1, 1
3856, 1, 1636429982956, 1636429983432, 476, 25, 451, 24, 0, 24
3857, 1, 1636429983056, 1636429983496, 440, 0, 440, 0, 0, 0
3855, 1, 1636429982956, 1636429983500, 544, 101, 443, 101, 0, 101
3858, 1, 1636429983084, 1636429983533, 449, 1, 448, 0, 1, 1
3859, 1, 1636429983084, 1636429983533, 449, 1, 448, 0, 1, 1
3860, 1, 1636429983128, 1636429983572, 444, 0, 444, 0, 0, 0
3861, 1, 1636429983148, 1636429983588, 440, 0, 440, 0, 0, 0
3863, 1, 1636429983276, 1636429983716, 440, 1, 439, 0, 0, 0
3864, 1, 1636429983284, 1636429983740, 456, 1, 455, 1, 0, 1
3866, 1, 1636429983368, 1636429983820, 452, 1, 451, 0, 0, 0
3865, 1, 1636429983368, 1636429983824, 456, 0, 456, 0, 0, 0
3868, 1, 1636429983512, 1636429983956, 444, 0, 444, 0, 0, 0
3869, 1, 1636429983520, 1636429983988, 468, 14, 454, 12, 1, 13
3862, 1, 1636429983240, 1636429983992, 752, 294, 458, 293, 1, 294
3867, 1, 1636429983412, 1636429984176, 764, 305, 459, 305, 0, 305
3870, 1, 1636429983793, 1636429984240, 447, 0, 447, 0, 0, 0
3871, 1, 1636429983804, 1636429984252, 448, 1, 447, 1, 0, 1
3872, 1, 1636429983905, 1636429984409, 504, 52, 452, 52, 0, 52
3873, 1, 1636429983936, 1636429984444, 508, 53, 455, 53, 0, 53
3874, 1, 1636429984068, 1636429984517, 449, 1, 448, 0, 0, 0
3876, 1, 1636429984084, 1636429984528, 444, 0, 444, 0, 0, 0
3875, 1, 1636429984076, 1636429984528, 452, 1, 451, 0, 0, 0
3877, 1, 1636429984132, 1636429984576, 444, 1, 443, 0, 1, 1
3878, 1, 1636429984132, 1636429984576, 444, 0, 444, 0, 0, 0
3880, 1, 1636429984308, 1636429984752, 444, 1, 443, 1, 0, 1
3881, 1, 1636429984308, 1636429984752, 444, 1, 443, 1, 0, 1
3882, 1, 1636429984376, 1636429984833, 457, 0, 457, 0, 0, 0
3883, 1, 1636429984388, 1636429984833, 445, 0, 445, 0, 0, 0
3884, 1, 1636429984408, 1636429984844, 436, 1, 435, 1, 0, 1
3879, 1, 1636429984236, 1636429984968, 732, 281, 451, 281, 0, 281
3886, 1, 1636429984520, 1636429984977, 457, 0, 457, 0, 0, 0
3885, 1, 1636429984501, 1636429984977, 476, 28, 448, 28, 0, 28
3887, 1, 1636429984812, 1636429985265, 453, 1, 452, 0, 0, 0
3888, 1, 1636429984821, 1636429985273, 452, 0, 452, 0, 0, 0
3890, 1, 1636429984929, 1636429985428, 499, 49, 450, 49, 0, 49
3889, 1, 1636429984925, 1636429985428, 503, 53, 450, 52, 0, 52
3891, 1, 1636429985044, 1636429985497, 453, 0, 453, 0, 0, 0
3892, 1, 1636429985077, 1636429985520, 443, 0, 443, 0, 0, 0
3893, 1, 1636429985088, 1636429985544, 456, 0, 456, 0, 0, 0
3894, 1, 1636429985112, 1636429985561, 449, 1, 448, 1, 0, 1
3895, 1, 1636429985128, 1636429985580, 452, 0, 452, 0, 0, 0
3897, 1, 1636429985320, 1636429985776, 456, 1, 455, 0, 0, 0
3899, 1, 1636429985344, 1636429985792, 448, 1, 447, 0, 0, 0
3898, 1, 1636429985344, 1636429985800, 456, 1, 455, 0, 0, 0
3900, 1, 1636429985408, 1636429985860, 452, 1, 451, 1, 0, 1
3901, 1, 1636429985408, 1636429985860, 452, 1, 451, 0, 0, 0
3902, 1, 1636429985472, 1636429985944, 472, 25, 447, 25, 0, 25
3903, 1, 1636429985496, 1636429985948, 452, 1, 451, 0, 0, 0
3896, 1, 1636429985244, 1636429985988, 744, 301, 443, 300, 0, 300
3904, 1, 1636429985804, 1636429986248, 444, 1, 443, 0, 1, 1
3905, 1, 1636429985813, 1636429986268, 455, 0, 455, 0, 0, 0
3907, 1, 1636429985924, 1636429986397, 473, 21, 452, 21, 0, 21
3906, 1, 1636429985900, 1636429986397, 497, 49, 448, 49, 0, 49
3909, 1, 1636429986056, 1636429986516, 460, 1, 459, 0, 0, 0
3908, 1, 1636429986056, 1636429986520, 464, 0, 464, 0, 0, 0
3912, 1, 1636429986100, 1636429986545, 445, 1, 444, 1, 0, 1
3910, 1, 1636429986096, 1636429986545, 449, 0, 449, 0, 0, 0
3911, 1, 1636429986100, 1636429986556, 456, 1, 455, 0, 0, 0
3914, 1, 1636429986316, 1636429986765, 449, 0, 449, 0, 0, 0
3915, 1, 1636429986320, 1636429986765, 445, 0, 445, 0, 0, 0
3916, 1, 1636429986344, 1636429986789, 445, 0, 445, 0, 0, 0
3917, 1, 1636429986376, 1636429986825, 449, 1, 448, 1, 0, 1
3918, 1, 1636429986440, 1636429986877, 437, 0, 437, 0, 0, 0
3919, 1, 1636429986496, 1636429986968, 472, 21, 451, 21, 0, 21
3913, 1, 1636429986240, 1636429986972, 732, 281, 451, 281, 0, 281
3922, 1, 1636429986821, 1636429987272, 451, 0, 451, 0, 0, 0
3924, 1, 1636429986949, 1636429987420, 471, 20, 451, 20, 0, 20
3925, 1, 1636429987032, 1636429987480, 448, 0, 448, 0, 0, 0
3927, 1, 1636429987064, 1636429987512, 448, 0, 448, 0, 0, 0
3926, 1, 1636429987060, 1636429987513, 453, 0, 453, 0, 0, 0
3928, 1, 1636429987096, 1636429987545, 449, 1, 448, 1, 0, 1
3929, 1, 1636429987133, 1636429987585, 452, 0, 452, 0, 0, 0
3931, 1, 1636429987316, 1636429987756, 440, 1, 439, 1, 0, 1
3932, 1, 1636429987316, 1636429987768, 452, 1, 451, 0, 0, 0
3776, 2, 1636429977772, 1636429987777, 10005, 0, 10005, 69, 0, 69
3934, 1, 1636429987364, 1636429987812, 448, 0, 448, 0, 0, 0
3777, 2, 1636429977809, 1636429987825, 10016, 0, 10016, 32, 0, 32
3933, 1, 1636429987320, 1636429987868, 548, 101, 447, 101, 0, 101
3935, 1, 1636429987468, 1636429987920, 452, 1, 451, 0, 0, 0
3936, 1, 1636429987476, 1636429987932, 456, 5, 451, 5, 0, 5
3930, 1, 1636429987248, 1636429988056, 808, 265, 543, 265, 0, 265
3921, 1, 1636429986805, 1636429988320, 1515, 1064, 451, 1064, 0, 1064
3937, 1, 1636429987960, 1636429988408, 448, 0, 448, 0, 0, 0
3938, 1, 1636429988000, 1636429988449, 449, 1, 448, 1, 0, 1
3939, 1, 1636429988032, 1636429988485, 453, 1, 452, 1, 0, 1
3940, 1, 1636429988064, 1636429988508, 444, 1, 443, 0, 0, 0
3941, 1, 1636429988100, 1636429988540, 440, 1, 439, 0, 0, 0
3944, 1, 1636429988129, 1636429988580, 451, 0, 451, 0, 0, 0
3942, 1, 1636429988152, 1636429988601, 449, 1, 448, 0, 0, 0
3943, 1, 1636429988164, 1636429988604, 440, 1, 439, 0, 0, 0
3946, 1, 1636429988280, 1636429988724, 444, 0, 444, 0, 0, 0
3947, 1, 1636429988288, 1636429988733, 445, 1, 444, 1, 0, 1
3948, 1, 1636429988344, 1636429988784, 440, 1, 439, 0, 0, 0
3949, 1, 1636429988364, 1636429988813, 449, 1, 448, 0, 0, 0
3950, 1, 1636429988460, 1636429988896, 436, 1, 435, 1, 0, 1
3945, 1, 1636429988288, 1636429988936, 648, 197, 451, 197, 0, 197
3951, 1, 1636429988540, 1636429988992, 452, 1, 451, 0, 0, 0
3952, 1, 1636429988893, 1636429989344, 451, 4, 447, 4, 0, 4
3953, 1, 1636429989004, 1636429989452, 448, 1, 447, 0, 0, 0
3954, 1, 1636429989036, 1636429989484, 448, 1, 447, 0, 0, 0
3957, 1, 1636429989068, 1636429989509, 441, 0, 441, 0, 0, 0
3956, 1, 1636429989068, 1636429989512, 444, 1, 443, 0, 1, 1
3959, 1, 1636429989105, 1636429989541, 436, 0, 436, 0, 0, 0
3961, 1, 1636429989316, 1636429989768, 452, 1, 451, 0, 1, 1
3962, 1, 1636429989328, 1636429989768, 440, 0, 440, 0, 0, 0
3963, 1, 1636429989336, 1636429989792, 456, 0, 456, 0, 0, 0
3964, 1, 1636429989368, 1636429989816, 448, 0, 448, 0, 0, 0
3965, 1, 1636429989472, 1636429989916, 444, 0, 444, 0, 0, 0
3966, 1, 1636429989493, 1636429989941, 448, 0, 448, 0, 0, 0
3967, 1, 1636429989900, 1636429990396, 496, 41, 455, 41, 0, 41
3968, 1, 1636429989973, 1636429990424, 451, 0, 451, 0, 0, 0
3969, 1, 1636429990045, 1636429990493, 448, 0, 448, 0, 0, 0
3970, 1, 1636429990064, 1636429990509, 445, 0, 445, 0, 0, 0
3972, 1, 1636429990132, 1636429990581, 449, 1, 448, 0, 0, 0
3821, 2, 1636429980725, 1636429990729, 10004, 0, 10004, 0, 0, 0
3973, 1, 1636429990312, 1636429990757, 445, 1, 444, 0, 0, 0
3974, 1, 1636429990324, 1636429990773, 449, 1, 448, 0, 0, 0
3975, 1, 1636429990340, 1636429990776, 436, 0, 436, 0, 0, 0
3971, 1, 1636429990081, 1636429990949, 868, 412, 456, 412, 0, 412
3976, 1, 1636429990456, 1636429990949, 493, 0, 493, 0, 0, 0
3978, 1, 1636429990885, 1636429991396, 511, 65, 446, 64, 0, 64
3980, 1, 1636429990996, 1636429991440, 444, 0, 444, 0, 0, 0
3979, 1, 1636429991033, 1636429991472, 439, 0, 439, 0, 0, 0
3981, 1, 1636429991036, 1636429991476, 440, 1, 439, 0, 0, 0
3982, 1, 1636429991080, 1636429991520, 440, 0, 440, 0, 0, 0
3984, 1, 1636429991164, 1636429991609, 445, 1, 444, 1, 0, 1
3983, 1, 1636429991160, 1636429991612, 452, 1, 451, 0, 0, 0
3985, 1, 1636429991320, 1636429991777, 457, 1, 456, 0, 1, 1
3986, 1, 1636429991340, 1636429991780, 440, 0, 440, 0, 0, 0
3987, 1, 1636429991348, 1636429991793, 445, 0, 445, 0, 0, 0
3988, 1, 1636429991460, 1636429991913, 453, 1, 452, 0, 1, 1
3989, 1, 1636429991888, 1636429992372, 484, 25, 459, 25, 0, 25
3990, 1, 1636429991976, 1636429992428, 452, 0, 452, 0, 0, 0
3992, 1, 1636429992020, 1636429992460, 440, 0, 440, 0, 0, 0
3991, 1, 1636429992012, 1636429992464, 452, 1, 451, 0, 0, 0
3993, 1, 1636429992085, 1636429992532, 447, 0, 447, 0, 0, 0
3994, 1, 1636429992116, 1636429992565, 449, 0, 449, 0, 0, 0
3995, 1, 1636429992160, 1636429992609, 449, 1, 448, 0, 0, 0
3996, 1, 1636429992324, 1636429992773, 449, 1, 448, 0, 0, 0
3997, 1, 1636429992345, 1636429992785, 440, 0, 440, 0, 0, 0
3998, 1, 1636429992352, 1636429992793, 441, 1, 440, 0, 1, 1
3999, 1, 1636429992464, 1636429992909, 445, 1, 444, 1, 0, 1
4000, 1, 1636429992893, 1636429993361, 468, 16, 452, 16, 0, 16
4001, 1, 1636429992996, 1636429993452, 456, 0, 456, 0, 0, 0
4002, 1, 1636429992996, 1636429993452, 456, 0, 456, 0, 0, 0
4003, 1, 1636429993056, 1636429993496, 440, 1, 439, 0, 0, 0
4004, 1, 1636429993056, 1636429993521, 465, 1, 464, 0, 1, 1
4005, 1, 1636429993116, 1636429993564, 448, 0, 448, 0, 0, 0
4006, 1, 1636429993124, 1636429993577, 453, 1, 452, 0, 0, 0
4007, 1, 1636429993296, 1636429993745, 449, 1, 448, 0, 0, 0
4008, 1, 1636429993332, 1636429993776, 444, 0, 444, 0, 0, 0
4009, 1, 1636429993360, 1636429993813, 453, 1, 452, 0, 0, 0
4010, 1, 1636429993448, 1636429993901, 453, 5, 448, 5, 0, 5
4011, 1, 1636429993877, 1636429994352, 475, 24, 451, 24, 0, 24
4012, 1, 1636429993980, 1636429994432, 452, 1, 451, 0, 0, 0
4014, 1, 1636429994020, 1636429994468, 448, 0, 448, 0, 0, 0
4013, 1, 1636429994016, 1636429994468, 452, 1, 451, 1, 0, 1
4015, 1, 1636429994036, 1636429994485, 449, 0, 449, 0, 0, 0
4016, 1, 1636429994096, 1636429994549, 453, 0, 453, 0, 0, 0
4017, 1, 1636429994120, 1636429994569, 449, 0, 449, 0, 0, 0
4019, 1, 1636429994300, 1636429994752, 452, 0, 452, 0, 0, 0
4018, 1, 1636429994300, 1636429994752, 452, 0, 452, 0, 0, 0
4020, 1, 1636429994348, 1636429994792, 444, 0, 444, 0, 0, 0
4021, 1, 1636429994472, 1636429994929, 457, 13, 444, 13, 0, 13
4022, 1, 1636429994884, 1636429995380, 496, 45, 451, 44, 0, 44
4023, 1, 1636429994956, 1636429995404, 448, 1, 447, 0, 0, 0
4024, 1, 1636429995032, 1636429995477, 445, 0, 445, 0, 0, 0
4026, 1, 1636429995040, 1636429995496, 456, 1, 455, 0, 0, 0
4025, 1, 1636429995040, 1636429995496, 456, 0, 456, 0, 0, 0
4027, 1, 1636429995080, 1636429995524, 444, 0, 444, 0, 0, 0
4028, 1, 1636429995149, 1636429995597, 448, 0, 448, 0, 0, 0
4030, 1, 1636429995276, 1636429995717, 441, 1, 440, 0, 0, 0
4029, 1, 1636429995276, 1636429995717, 441, 1, 440, 0, 1, 1
4031, 1, 1636429995352, 1636429995805, 453, 0, 453, 0, 0, 0
4032, 1, 1636429995489, 1636429995952, 463, 8, 455, 8, 0, 8
4033, 1, 1636429995916, 1636429996401, 485, 37, 448, 37, 0, 37
4034, 1, 1636429995948, 1636429996401, 453, 1, 452, 0, 0, 0
4035, 1, 1636429996012, 1636429996464, 452, 1, 451, 0, 0, 0
4036, 1, 1636429996048, 1636429996497, 449, 1, 448, 0, 0, 0
4037, 1, 1636429996064, 1636429996512, 448, 0, 448, 0, 0, 0
3920, 2, 1636429986528, 1636429996528, 10000, 0, 10000, 0, 0, 0
4038, 1, 1636429996100, 1636429996557, 457, 0, 457, 0, 0, 0
4039, 1, 1636429996172, 1636429996616, 444, 0, 444, 0, 0, 0
4040, 1, 1636429996240, 1636429996689, 449, 0, 449, 0, 0, 0
4041, 1, 1636429996296, 1636429996753, 457, 0, 457, 0, 0, 0
4042, 1, 1636429996332, 1636429996780, 448, 0, 448, 0, 0, 0
3923, 2, 1636429986904, 1636429996905, 10001, 0, 10001, 0, 0, 0
4043, 1, 1636429996484, 1636429996940, 456, 1, 455, 0, 0, 0
4044, 1, 1636429996836, 1636429997321, 485, 1, 484, 0, 0, 0
4045, 1, 1636429996889, 1636429997396, 507, 52, 455, 52, 0, 52
4046, 1, 1636429996952, 1636429997409, 457, 0, 457, 0, 0, 0
4049, 1, 1636429997041, 1636429997493, 452, 0, 452, 0, 0, 0
4048, 1, 1636429997041, 1636429997493, 452, 1, 451, 0, 0, 0
4047, 1, 1636429997041, 1636429997500, 459, 0, 459, 0, 0, 0
4050, 1, 1636429997120, 1636429997568, 448, 0, 448, 0, 0, 0
4051, 1, 1636429997144, 1636429997592, 448, 0, 448, 0, 0, 0
4054, 1, 1636429997289, 1636429997733, 444, 0, 444, 0, 0, 0
4052, 1, 1636429997208, 1636429997772, 564, 113, 451, 113, 0, 113
4055, 1, 1636429997352, 1636429997801, 449, 1, 448, 0, 1, 1
4056, 1, 1636429997492, 1636429997941, 449, 1, 448, 0, 0, 0
4057, 1, 1636429997760, 1636429998208, 448, 0, 448, 0, 0, 0
4058, 1, 1636429997904, 1636429998392, 488, 38, 450, 37, 0, 37
4059, 1, 1636429997941, 1636429998396, 455, 0, 455, 0, 0, 0
4060, 1, 1636429998008, 1636429998452, 444, 1, 443, 0, 0, 0
4061, 1, 1636429998064, 1636429998513, 449, 1, 448, 1, 0, 1
4062, 1, 1636429998076, 1636429998521, 445, 0, 445, 0, 0, 0
4063, 1, 1636429998088, 1636429998537, 449, 0, 449, 0, 0, 0
4064, 1, 1636429998116, 1636429998565, 449, 1, 448, 0, 0, 0
4065, 1, 1636429998136, 1636429998653, 517, 73, 444, 73, 0, 73
4066, 1, 1636429998284, 1636429998729, 445, 1, 444, 0, 0, 0
4067, 1, 1636429998356, 1636429998805, 449, 1, 448, 0, 0, 0
4068, 1, 1636429998456, 1636429998905, 449, 1, 448, 0, 0, 0
3955, 2, 1636429989068, 1636429999068, 10000, 0, 10000, 0, 0, 0
3958, 2, 1636429989088, 1636429999116, 10028, 0, 10028, 0, 0, 0
4069, 1, 1636429998789, 1636429999236, 447, 0, 447, 0, 0, 0
3960, 2, 1636429989248, 1636429999249, 10001, 0, 10001, 0, 0, 0
4070, 1, 1636429998897, 1636429999472, 575, 8, 567, 8, 0, 8
4071, 1, 1636429998920, 1636429999476, 556, 0, 556, 0, 0, 0
4073, 1, 1636429999061, 1636429999573, 512, 0, 512, 0, 0, 0
4072, 1, 1636429999020, 1636429999573, 553, 0, 553, 0, 0, 0
4076, 1, 1636429999165, 1636429999652, 487, 0, 487, 0, 0, 0
4074, 1, 1636429999165, 1636429999657, 492, 1, 491, 0, 1, 1
4075, 1, 1636429999165, 1636429999657, 492, 1, 491, 0, 1, 1
4077, 1, 1636429999208, 1636429999680, 472, 29, 443, 29, 0, 29
4078, 1, 1636429999296, 1636429999740, 444, 1, 443, 1, 0, 1
4079, 1, 1636429999340, 1636429999784, 444, 0, 444, 0, 0, 0
4081, 1, 1636429999384, 1636429999837, 453, 0, 453, 0, 0, 0
4080, 1, 1636429999424, 1636429999880, 456, 0, 456, 0, 0, 0
4082, 1, 1636429999472, 1636430000021, 549, 102, 447, 102, 0, 102
4084, 1, 1636429999761, 1636430000212, 451, 0, 451, 0, 0, 0
4083, 1, 1636429999553, 1636430000292, 739, 285, 454, 284, 0, 284
4085, 1, 1636429999921, 1636430000372, 451, 0, 451, 0, 0, 0
4087, 1, 1636430000024, 1636430000476, 452, 0, 452, 0, 0, 0
4086, 1, 1636429999921, 1636430000476, 555, 101, 454, 100, 0, 100
3977, 2, 1636429990488, 1636430000492, 10004, 0, 10004, 1, 0, 1
4089, 1, 1636430000068, 1636430000512, 444, 0, 444, 0, 0, 0
4090, 1, 1636430000088, 1636430000536, 448, 1, 447, 0, 0, 0
4091, 1, 1636430000156, 1636430000656, 500, 57, 443, 57, 0, 57
4092, 1, 1636430000244, 1636430000720, 476, 0, 476, 0, 0, 0
4093, 1, 1636430000300, 1636430000744, 444, 1, 443, 0, 0, 0
4094, 1, 1636430000300, 1636430000753, 453, 1, 452, 0, 1, 1
4095, 1, 1636430000325, 1636430000809, 484, 0, 484, 0, 0, 0
4097, 1, 1636430000536, 1636430000988, 452, 1, 451, 0, 1, 1
4096, 1, 1636430000536, 1636430000988, 452, 1, 451, 0, 1, 1
4098, 1, 1636430000740, 1636430001192, 452, 1, 451, 0, 0, 0
4099, 1, 1636430000800, 1636430001244, 444, 1, 443, 0, 0, 0
4100, 1, 1636430000897, 1636430001336, 439, 0, 439, 0, 0, 0
4102, 1, 1636430000996, 1636430001445, 449, 0, 449, 0, 0, 0
4101, 1, 1636430000920, 1636430001448, 528, 69, 459, 69, 0, 69
4103, 1, 1636430001069, 1636430001508, 439, 0, 439, 0, 0, 0
4104, 1, 1636430001092, 1636430001537, 445, 0, 445, 0, 0, 0
4105, 1, 1636430001144, 1636430001645, 501, 49, 452, 49, 0, 49
4106, 1, 1636430001252, 1636430001692, 440, 1, 439, 1, 0, 1
4107, 1, 1636430001305, 1636430001756, 451, 0, 451, 0, 0, 0
4108, 1, 1636430001308, 1636430001756, 448, 1, 447, 0, 0, 0
4109, 1, 1636430001352, 1636430001797, 445, 0, 445, 0, 0, 0
4111, 1, 1636430001472, 1636430001913, 441, 1, 440, 0, 0, 0
4110, 1, 1636430001464, 1636430001916, 452, 1, 451, 0, 0, 0
4112, 1, 1636430001692, 1636430002137, 445, 0, 445, 0, 0, 0
4113, 1, 1636430001736, 1636430002184, 448, 0, 448, 0, 0, 0
4114, 1, 1636430001900, 1636430002344, 444, 0, 444, 0, 0, 0
4115, 1, 1636430001916, 1636430002365, 449, 1, 448, 1, 0, 1
4116, 1, 1636430002004, 1636430002448, 444, 1, 443, 0, 0, 0
4118, 1, 1636430002073, 1636430002528, 455, 0, 455, 0, 0, 0
4117, 1, 1636430002073, 1636430002532, 459, 0, 459, 0, 0, 0
4119, 1, 1636430002128, 1636430002636, 508, 57, 451, 57, 0, 57
4120, 1, 1636430002216, 1636430002665, 449, 1, 448, 0, 0, 0
4121, 1, 1636430002277, 1636430002724, 447, 0, 447, 0, 0, 0
4122, 1, 1636430002312, 1636430002756, 444, 1, 443, 0, 0, 0
4123, 1, 1636430002324, 1636430002760, 436, 0, 436, 0, 0, 0
4124, 1, 1636430002472, 1636430002912, 440, 1, 439, 0, 0, 0
4125, 1, 1636430002504, 1636430002953, 449, 0, 449, 0, 0, 0
4126, 1, 1636430002672, 1636430003124, 452, 1, 451, 0, 0, 0
4127, 1, 1636430002732, 1636430003185, 453, 1, 452, 1, 0, 1
4128, 1, 1636430002924, 1636430003372, 448, 1, 447, 0, 0, 0
4129, 1, 1636430003041, 1636430003492, 451, 0, 451, 0, 0, 0
4130, 1, 1636430003077, 1636430003521, 444, 0, 444, 0, 0, 0
4131, 1, 1636430003096, 1636430003544, 448, 1, 447, 0, 0, 0
4132, 1, 1636430003112, 1636430003632, 520, 73, 447, 73, 0, 73
4133, 1, 1636430003201, 1636430003636, 435, 0, 435, 0, 0, 0
4134, 1, 1636430003264, 1636430003705, 441, 0, 441, 0, 0, 0
4135, 1, 1636430003292, 1636430003724, 432, 1, 431, 0, 1, 1
4136, 1, 1636430003324, 1636430003768, 444, 0, 444, 0, 0, 0
4137, 1, 1636430003484, 1636430003936, 452, 9, 443, 9, 0, 9
4138, 1, 1636430003496, 1636430003944, 448, 0, 448, 0, 0, 0
4140, 1, 1636430003705, 1636430004157, 452, 0, 452, 0, 0, 0
4139, 1, 1636430003676, 1636430004380, 704, 261, 443, 261, 0, 261
4142, 1, 1636430004017, 1636430004460, 443, 0, 443, 0, 0, 0
4143, 1, 1636430004080, 1636430004540, 460, 0, 460, 0, 0, 0
4145, 1, 1636430004120, 1636430004556, 436, 1, 435, 1, 0, 1
4144, 1, 1636430004088, 1636430004605, 517, 69, 448, 69, 0, 69
4147, 1, 1636430004252, 1636430004693, 441, 0, 441, 0, 0, 0
4148, 1, 1636430004292, 1636430004736, 444, 1, 443, 1, 0, 1
4149, 1, 1636430004316, 1636430004760, 444, 1, 443, 1, 0, 1
4150, 1, 1636430004484, 1636430004937, 453, 1, 452, 0, 0, 0
4151, 1, 1636430004504, 1636430004949, 445, 0, 445, 0, 0, 0
4152, 1, 1636430004669, 1636430005117, 448, 0, 448, 0, 0, 0
4153, 1, 1636430004681, 1636430005136, 455, 0, 455, 0, 0, 0
4154, 1, 1636430004996, 1636430005444, 448, 1, 447, 1, 0, 1
4155, 1, 1636430005049, 1636430005493, 444, 0, 444, 0, 0, 0
4157, 1, 1636430005116, 1636430005564, 448, 1, 447, 0, 0, 0
4156, 1, 1636430005072, 1636430005585, 513, 65, 448, 64, 0, 64
4158, 1, 1636430005236, 1636430005676, 440, 1, 439, 0, 0, 0
4159, 1, 1636430005272, 1636430005712, 440, 1, 439, 0, 0, 0
4160, 1, 1636430005296, 1636430005732, 436, 0, 436, 0, 0, 0
4161, 1, 1636430005464, 1636430005920, 456, 1, 455, 0, 1, 1
4162, 1, 1636430005496, 1636430005944, 448, 1, 447, 0, 0, 0
4164, 1, 1636430005672, 1636430006121, 449, 0, 449, 0, 0, 0
4163, 1, 1636430005653, 1636430006164, 511, 60, 451, 60, 0, 60
4165, 1, 1636430006020, 1636430006469, 449, 1, 448, 0, 0, 0
4167, 1, 1636430006057, 1636430006509, 452, 0, 452, 0, 0, 0
4166, 1, 1636430006049, 1636430006569, 520, 72, 448, 72, 0, 72
4168, 1, 1636430006140, 1636430006581, 441, 0, 441, 0, 0, 0
4169, 1, 1636430006212, 1636430006661, 449, 1, 448, 0, 0, 0
4170, 1, 1636430006276, 1636430006725, 449, 1, 448, 0, 0, 0
4171, 1, 1636430006328, 1636430006772, 444, 1, 443, 0, 0, 0
4172, 1, 1636430006484, 1636430006925, 441, 1, 440, 0, 0, 0
4173, 1, 1636430006509, 1636430006957, 448, 0, 448, 0, 0, 0
4174, 1, 1636430006657, 1636430007104, 447, 0, 447, 0, 0, 0
4175, 1, 1636430006688, 1636430007145, 457, 1, 456, 0, 0, 0
4053, 2, 1636429997237, 1636430007240, 10003, 0, 10003, 0, 0, 0
4176, 1, 1636430007012, 1636430007465, 453, 1, 452, 0, 0, 0
4177, 1, 1636430007041, 1636430007560, 519, 64, 455, 64, 0, 64
4180, 1, 1636430007176, 1636430007648, 472, 0, 472, 0, 0, 0
4179, 1, 1636430007152, 1636430007652, 500, 0, 500, 0, 0, 0
4088, 1, 1636430000064, 1636430007693, 7629, 7177, 452, 0, 7176, 7176
4182, 1, 1636430007336, 1636430007788, 452, 1, 451, 0, 1, 1
4181, 1, 1636430007336, 1636430007788, 452, 1, 451, 0, 0, 0
4183, 1, 1636430007472, 1636430007921, 449, 1, 448, 0, 0, 0
4185, 1, 1636430007537, 1636430007989, 452, 0, 452, 0, 0, 0
4184, 1, 1636430007545, 1636430007992, 447, 0, 447, 0, 0, 0
4186, 1, 1636430007656, 1636430008105, 449, 1, 448, 0, 1, 1
4187, 1, 1636430007692, 1636430008144, 452, 1, 451, 0, 0, 0
4188, 1, 1636430007921, 1636430008372, 451, 0, 451, 0, 0, 0
4189, 1, 1636430008032, 1636430008488, 456, 1, 455, 0, 0, 0
4190, 1, 1636430008048, 1636430008552, 504, 57, 447, 56, 0, 56
4191, 1, 1636430008172, 1636430008617, 445, 1, 444, 0, 0, 0
4192, 1, 1636430008172, 1636430008625, 453, 1, 452, 1, 0, 1
4193, 1, 1636430008272, 1636430008717, 445, 0, 445, 0, 0, 0
4194, 1, 1636430008316, 1636430008760, 444, 0, 444, 0, 0, 0
4195, 1, 1636430008456, 1636430008917, 461, 1, 460, 0, 0, 0
4196, 1, 1636430008492, 1636430008941, 449, 1, 448, 0, 0, 0
4197, 1, 1636430008520, 1636430008965, 445, 1, 444, 0, 0, 0
4198, 1, 1636430008700, 1636430009144, 444, 1, 443, 0, 0, 0
4199, 1, 1636430008872, 1636430009328, 456, 1, 455, 0, 0, 0
4200, 1, 1636430009020, 1636430009465, 445, 1, 444, 1, 0, 1
4201, 1, 1636430009144, 1636430009592, 448, 1, 447, 0, 0, 0
4202, 1, 1636430009160, 1636430009609, 449, 0, 449, 0, 0, 0
4203, 1, 1636430009281, 1636430009729, 448, 0, 448, 0, 0, 0
4204, 1, 1636430009348, 1636430009800, 452, 1, 451, 0, 0, 0
4205, 1, 1636430009481, 1636430009929, 448, 0, 448, 0, 0, 0
4206, 1, 1636430009492, 1636430009941, 449, 1, 448, 0, 1, 1
4207, 1, 1636430009496, 1636430009941, 445, 0, 445, 0, 0, 0
4208, 1, 1636430009704, 1636430010149, 445, 1, 444, 1, 0, 1
4209, 1, 1636430009844, 1636430010288, 444, 1, 443, 0, 1, 1
4210, 1, 1636430010057, 1636430010509, 452, 0, 452, 0, 0, 0
4211, 1, 1636430010152, 1636430010597, 445, 0, 445, 0, 0, 0
4212, 1, 1636430010192, 1636430010637, 445, 1, 444, 0, 0, 0
4213, 1, 1636430010304, 1636430010752, 448, 1, 447, 0, 0, 0
4214, 1, 1636430010325, 1636430010780, 455, 0, 455, 0, 0, 0
4215, 1, 1636430010472, 1636430010917, 445, 1, 444, 0, 0, 0
4216, 1, 1636430010492, 1636430010961, 469, 17, 452, 16, 0, 16
4218, 1, 1636430010736, 1636430011184, 448, 0, 448, 0, 0, 0
4217, 1, 1636430010501, 1636430011233, 732, 280, 452, 280, 0, 280
4220, 1, 1636430011057, 1636430011508, 451, 0, 451, 0, 0, 0
4221, 1, 1636430011204, 1636430011648, 444, 0, 444, 0, 0, 0
4222, 1, 1636430011292, 1636430011737, 445, 1, 444, 1, 0, 1
4223, 1, 1636430011308, 1636430011757, 449, 0, 449, 0, 0, 0
4225, 1, 1636430011504, 1636430011960, 456, 5, 451, 4, 0, 4
4224, 1, 1636430011504, 1636430011964, 460, 1, 459, 0, 0, 0
4226, 1, 1636430011736, 1636430012185, 449, 1, 448, 0, 0, 0
4227, 1, 1636430012029, 1636430012485, 456, 0, 456, 0, 0, 0
4228, 1, 1636430012232, 1636430012689, 457, 1, 456, 1, 0, 1
4229, 1, 1636430012257, 1636430012705, 448, 0, 448, 0, 0, 0
4230, 1, 1636430012309, 1636430012761, 452, 0, 452, 0, 0, 0
4231, 1, 1636430012484, 1636430012929, 445, 1, 444, 0, 0, 0
4232, 1, 1636430012496, 1636430012945, 449, 0, 449, 0, 0, 0
4233, 1, 1636430012740, 1636430013193, 453, 1, 452, 0, 0, 0
4234, 1, 1636430013017, 1636430013469, 452, 0, 452, 0, 0, 0
4235, 1, 1636430013265, 1636430013717, 452, 0, 452, 0, 0, 0
4236, 1, 1636430013273, 1636430013729, 456, 0, 456, 0, 0, 0
4238, 1, 1636430013465, 1636430013916, 451, 0, 451, 0, 0, 0
4237, 1, 1636430013289, 1636430013925, 636, 180, 456, 180, 0, 180
4141, 2, 1636430003961, 1636430013961, 10000, 0, 10000, 419, 0, 419
4146, 2, 1636430004208, 1636430014213, 10005, 0, 10005, 173, 0, 173
4240, 1, 1636430013768, 1636430014220, 452, 1, 451, 0, 0, 0
4239, 1, 1636430013484, 1636430014377, 893, 441, 452, 441, 0, 441
4241, 1, 1636430014053, 1636430014529, 476, 0, 476, 0, 0, 0
4242, 1, 1636430014265, 1636430014713, 448, 0, 448, 0, 0, 0
4244, 1, 1636430014305, 1636430014749, 444, 0, 444, 0, 0, 0
4243, 1, 1636430014300, 1636430014760, 460, 1, 459, 0, 0, 0
4245, 1, 1636430014464, 1636430014920, 456, 1, 455, 1, 0, 1
4246, 1, 1636430014601, 1636430015053, 452, 0, 452, 0, 0, 0
4247, 1, 1636430014688, 1636430015149, 461, 1, 460, 0, 0, 0
4249, 1, 1636430014776, 1636430015220, 444, 1, 443, 0, 0, 0
4248, 1, 1636430014688, 1636430015368, 680, 233, 447, 232, 0, 232
4250, 1, 1636430015037, 1636430015484, 447, 0, 447, 0, 0, 0
4251, 1, 1636430015281, 1636430015733, 452, 0, 452, 0, 0, 0
4252, 1, 1636430015288, 1636430015737, 449, 1, 448, 0, 0, 0
4253, 1, 1636430015297, 1636430015740, 443, 0, 443, 0, 0, 0
4254, 1, 1636430015505, 1636430015961, 456, 0, 456, 0, 0, 0
4255, 1, 1636430015528, 1636430015977, 449, 1, 448, 0, 0, 0
4256, 1, 1636430015584, 1636430016041, 457, 0, 457, 0, 0, 0
4257, 1, 1636430015605, 1636430016057, 452, 0, 452, 0, 0, 0
4258, 1, 1636430015756, 1636430016209, 453, 1, 452, 0, 0, 0
4259, 1, 1636430016041, 1636430016492, 451, 0, 451, 0, 0, 0
4260, 1, 1636430016272, 1636430016716, 444, 1, 443, 1, 0, 1
4261, 1, 1636430016293, 1636430016740, 447, 0, 447, 0, 0, 0
4262, 1, 1636430016312, 1636430016752, 440, 1, 439, 0, 0, 0
4264, 1, 1636430016492, 1636430016928, 436, 1, 435, 0, 0, 0
4263, 1, 1636430016481, 1636430016932, 451, 0, 451, 0, 0, 0
4265, 1, 1636430016552, 1636430017005, 453, 0, 453, 0, 0, 0
4266, 1, 1636430016616, 1636430017065, 449, 0, 449, 0, 0, 0
4178, 2, 1636430007072, 1636430017073, 10001, 0, 10001, 0, 0, 0
4267, 1, 1636430016748, 1636430017200, 452, 0, 452, 0, 0, 0
4268, 1, 1636430017037, 1636430017484, 447, 0, 447, 0, 0, 0
4219, 1, 1636430010853, 1636430017516, 6663, 6220, 443, 0, 6220, 6220
4269, 1, 1636430017296, 1636430017736, 440, 0, 440, 0, 0, 0
4270, 1, 1636430017316, 1636430017768, 452, 0, 452, 0, 0, 0
4271, 1, 1636430017336, 1636430017780, 444, 0, 444, 0, 0, 0
4272, 1, 1636430017380, 1636430017832, 452, 0, 452, 0, 0, 0
4273, 1, 1636430017464, 1636430017905, 441, 0, 441, 0, 0, 0
4274, 1, 1636430017512, 1636430017957, 445, 0, 445, 0, 0, 0
4275, 1, 1636430017540, 1636430017981, 441, 1, 440, 0, 0, 0
4276, 1, 1636430017592, 1636430018045, 453, 0, 453, 0, 0, 0
4277, 1, 1636430017736, 1636430018184, 448, 1, 447, 0, 1, 1
4278, 1, 1636430017732, 1636430018184, 452, 1, 451, 1, 0, 1
4279, 1, 1636430018044, 1636430018492, 448, 1, 447, 0, 0, 0
4280, 1, 1636430018308, 1636430018749, 441, 0, 441, 0, 0, 0
4281, 1, 1636430018312, 1636430018752, 440, 1, 439, 0, 0, 0
4282, 1, 1636430018321, 1636430018764, 443, 0, 443, 0, 0, 0
4283, 1, 1636430018321, 1636430018772, 451, 0, 451, 0, 0, 0
4284, 1, 1636430018452, 1636430018905, 453, 0, 453, 0, 0, 0
4285, 1, 1636430018524, 1636430018972, 448, 0, 448, 0, 0, 0
4286, 1, 1636430018532, 1636430018989, 457, 1, 456, 0, 0, 0
4287, 1, 1636430018596, 1636430019053, 457, 1, 456, 0, 0, 0
4288, 1, 1636430018680, 1636430019133, 453, 1, 452, 0, 0, 0
4289, 1, 1636430018741, 1636430019188, 447, 0, 447, 0, 0, 0
4290, 1, 1636430019080, 1636430019528, 448, 1, 447, 0, 0, 0
4292, 1, 1636430019300, 1636430019741, 441, 1, 440, 0, 1, 1
4291, 1, 1636430019293, 1636430019741, 448, 0, 448, 0, 0, 0
4293, 1, 1636430019341, 1636430019785, 444, 0, 444, 0, 0, 0
4294, 1, 1636430019341, 1636430019785, 444, 0, 444, 0, 0, 0
4295, 1, 1636430019488, 1636430019928, 440, 0, 440, 0, 0, 0
4296, 1, 1636430019508, 1636430019957, 449, 1, 448, 0, 0, 0
4297, 1, 1636430019520, 1636430019965, 445, 0, 445, 0, 0, 0
4299, 1, 1636430019656, 1636430020109, 453, 1, 452, 1, 0, 1
4300, 1, 1636430019716, 1636430020172, 456, 1, 455, 1, 0, 1
4298, 1, 1636430019564, 1636430020197, 633, 178, 455, 177, 1, 178
4301, 1, 1636430020056, 1636430020508, 452, 1, 451, 0, 0, 0
4302, 1, 1636430020268, 1636430020717, 449, 0, 449, 0, 0, 0
4303, 1, 1636430020284, 1636430020721, 437, 0, 437, 0, 0, 0
4304, 1, 1636430020312, 1636430020764, 452, 0, 452, 0, 0, 0
4305, 1, 1636430020344, 1636430020781, 437, 1, 436, 0, 0, 0
4306, 1, 1636430020460, 1636430020913, 453, 0, 453, 0, 0, 0
4308, 1, 1636430020516, 1636430020957, 441, 1, 440, 1, 0, 1
4309, 1, 1636430020560, 1636430021005, 445, 1, 444, 0, 1, 1
4310, 1, 1636430020633, 1636430021168, 535, 84, 451, 84, 0, 84
4311, 1, 1636430020733, 1636430021176, 443, 0, 443, 0, 0, 0
4307, 1, 1636430020500, 1636430021361, 861, 413, 448, 413, 0, 413
4312, 1, 1636430021032, 1636430021481, 449, 1, 448, 0, 0, 0
4313, 1, 1636430021264, 1636430021712, 448, 1, 447, 0, 0, 0
4314, 1, 1636430021308, 1636430021756, 448, 1, 447, 0, 0, 0
4315, 1, 1636430021369, 1636430021821, 452, 0, 452, 0, 0, 0
4317, 1, 1636430021496, 1636430021941, 445, 1, 444, 0, 1, 1
4316, 1, 1636430021489, 1636430021941, 452, 0, 452, 0, 0, 0
4318, 1, 1636430021528, 1636430021977, 449, 1, 448, 0, 0, 0
4319, 1, 1636430021580, 1636430022029, 449, 1, 448, 1, 0, 1
4320, 1, 1636430021636, 1636430022089, 453, 1, 452, 0, 0, 0
4322, 1, 1636430022009, 1636430022456, 447, 0, 447, 0, 0, 0
4321, 1, 1636430021745, 1636430022484, 739, 284, 455, 284, 0, 284
4324, 1, 1636430022293, 1636430022744, 451, 0, 451, 0, 0, 0
4323, 1, 1636430022293, 1636430022744, 451, 0, 451, 0, 0, 0
4325, 1, 1636430022388, 1636430022837, 449, 0, 449, 0, 0, 0
4326, 1, 1636430022460, 1636430022905, 445, 0, 445, 0, 0, 0
4327, 1, 1636430022516, 1636430022969, 453, 0, 453, 0, 0, 0
4328, 1, 1636430022544, 1636430022993, 449, 1, 448, 0, 1, 1
4329, 1, 1636430022556, 1636430023005, 449, 0, 449, 0, 0, 0
4330, 1, 1636430022612, 1636430023057, 445, 1, 444, 0, 0, 0
4331, 1, 1636430022748, 1636430023444, 696, 245, 451, 245, 0, 245
4332, 1, 1636430023260, 1636430023705, 445, 0, 445, 0, 0, 0
4333, 1, 1636430023300, 1636430023753, 453, 1, 452, 0, 0, 0
4334, 1, 1636430023420, 1636430023865, 445, 1, 444, 0, 0, 0
4335, 1, 1636430023448, 1636430023901, 453, 0, 453, 0, 0, 0
4336, 1, 1636430023544, 1636430023992, 448, 0, 448, 0, 0, 0
4337, 1, 1636430023588, 1636430024033, 445, 1, 444, 0, 0, 0
4338, 1, 1636430023620, 1636430024065, 445, 0, 445, 0, 0, 0
4339, 1, 1636430023753, 1636430024441, 688, 240, 448, 240, 0, 240
4340, 1, 1636430024241, 1636430024688, 447, 0, 447, 0, 0, 0
4341, 1, 1636430024288, 1636430024744, 456, 1, 455, 1, 0, 1
4342, 1, 1636430024452, 1636430024905, 453, 1, 452, 0, 0, 0
4343, 1, 1636430024472, 1636430024921, 449, 1, 448, 0, 0, 0
4344, 1, 1636430024560, 1636430025017, 457, 1, 456, 0, 0, 0
4345, 1, 1636430024577, 1636430025024, 447, 0, 447, 0, 0, 0
4346, 1, 1636430024608, 1636430025061, 453, 0, 453, 0, 0, 0
4347, 1, 1636430024752, 1636430025472, 720, 266, 454, 265, 0, 265
4348, 1, 1636430025244, 1636430025693, 449, 0, 449, 0, 0, 0
4349, 1, 1636430025308, 1636430025764, 456, 1, 455, 0, 0, 0
4350, 1, 1636430025448, 1636430025897, 449, 1, 448, 0, 0, 0
4351, 1, 1636430025508, 1636430025953, 445, 1, 444, 0, 0, 0
4352, 1, 1636430025540, 1636430025984, 444, 1, 443, 0, 0, 0
4353, 1, 1636430025569, 1636430026017, 448, 0, 448, 0, 0, 0
4354, 1, 1636430025577, 1636430026021, 444, 0, 444, 0, 0, 0
4355, 1, 1636430025753, 1636430026433, 680, 232, 448, 232, 0, 232
4356, 1, 1636430026241, 1636430026688, 447, 0, 447, 0, 0, 0
4357, 1, 1636430026325, 1636430026772, 447, 0, 447, 0, 0, 0
4358, 1, 1636430026468, 1636430026908, 440, 1, 439, 0, 0, 0
4359, 1, 1636430026512, 1636430026952, 440, 0, 440, 0, 0, 0
4360, 1, 1636430026541, 1636430026993, 452, 0, 452, 0, 0, 0
4361, 1, 1636430026552, 1636430026996, 444, 0, 444, 0, 0, 0
4362, 1, 1636430026572, 1636430027017, 445, 0, 445, 0, 0, 0
4363, 1, 1636430026764, 1636430027473, 709, 253, 456, 253, 0, 253
4364, 1, 1636430027224, 1636430027673, 449, 0, 449, 0, 0, 0
4365, 1, 1636430027312, 1636430027761, 449, 1, 448, 0, 1, 1
4366, 1, 1636430027476, 1636430027924, 448, 0, 448, 0, 0, 0
4367, 1, 1636430027484, 1636430027933, 449, 0, 449, 0, 0, 0
4368, 1, 1636430027516, 1636430027968, 452, 0, 452, 0, 0, 0
4369, 1, 1636430027544, 1636430027992, 448, 0, 448, 0, 0, 0
4370, 1, 1636430027552, 1636430027996, 444, 0, 444, 0, 0, 0
4371, 1, 1636430027761, 1636430028440, 679, 232, 447, 232, 0, 232
4372, 1, 1636430028201, 1636430028644, 443, 0, 443, 0, 0, 0
4373, 1, 1636430028300, 1636430028744, 444, 1, 443, 1, 0, 1
4374, 1, 1636430028484, 1636430028936, 452, 1, 451, 0, 0, 0
4375, 1, 1636430028513, 1636430028964, 451, 0, 451, 0, 0, 0
4376, 1, 1636430028513, 1636430028964, 451, 0, 451, 0, 0, 0
4377, 1, 1636430028528, 1636430028968, 440, 0, 440, 0, 0, 0
4378, 1, 1636430028556, 1636430029008, 452, 0, 452, 0, 0, 0
4379, 1, 1636430028752, 1636430029417, 665, 217, 448, 217, 0, 217
4380, 1, 1636430029205, 1636430029661, 456, 0, 456, 0, 0, 0
4381, 1, 1636430029272, 1636430029721, 449, 1, 448, 1, 0, 1
4382, 1, 1636430029488, 1636430029933, 445, 1, 444, 0, 0, 0
4383, 1, 1636430029500, 1636430029948, 448, 1, 447, 1, 0, 1
4384, 1, 1636430029508, 1636430029961, 453, 1, 452, 1, 0, 1
4385, 1, 1636430029520, 1636430029973, 453, 1, 452, 0, 1, 1
4386, 1, 1636430029568, 1636430030009, 441, 1, 440, 0, 0, 0
4387, 1, 1636430029748, 1636430030401, 653, 201, 452, 201, 0, 201
4388, 1, 1636430030221, 1636430030664, 443, 0, 443, 0, 0, 0
4389, 1, 1636430030244, 1636430030693, 449, 1, 448, 0, 0, 0
4390, 1, 1636430030457, 1636430030900, 443, 0, 443, 0, 0, 0
4391, 1, 1636430030489, 1636430030937, 448, 0, 448, 0, 0, 0
4392, 1, 1636430030509, 1636430030957, 448, 0, 448, 0, 0, 0
4393, 1, 1636430030528, 1636430030981, 453, 1, 452, 0, 0, 0
4394, 1, 1636430030540, 1636430030988, 448, 0, 448, 0, 0, 0
4395, 1, 1636430030736, 1636430031413, 677, 221, 456, 221, 0, 221
4397, 1, 1636430031224, 1636430031673, 449, 1, 448, 1, 0, 1
4396, 1, 1636430031224, 1636430031673, 449, 1, 448, 0, 1, 1
4398, 1, 1636430031444, 1636430031892, 448, 1, 447, 1, 0, 1
4399, 1, 1636430031509, 1636430031949, 440, 0, 440, 0, 0, 0
4400, 1, 1636430031520, 1636430031969, 449, 0, 449, 0, 0, 0
4401, 1, 1636430031564, 1636430032017, 453, 0, 453, 0, 0, 0
4402, 1, 1636430031736, 1636430032400, 664, 213, 451, 213, 0, 213
4403, 1, 1636430032212, 1636430032660, 448, 0, 448, 0, 0, 0
4404, 1, 1636430032256, 1636430032701, 445, 1, 444, 0, 0, 0
4405, 1, 1636430032436, 1636430032885, 449, 0, 449, 0, 0, 0
4406, 1, 1636430032484, 1636430032925, 441, 1, 440, 0, 1, 1
4407, 1, 1636430032549, 1636430032997, 448, 0, 448, 0, 0, 0
4408, 1, 1636430032572, 1636430033021, 449, 1, 448, 1, 0, 1
4409, 1, 1636430032725, 1636430033380, 655, 201, 454, 201, 0, 201
4410, 1, 1636430033229, 1636430033676, 447, 0, 447, 0, 0, 0
4411, 1, 1636430033237, 1636430033688, 451, 0, 451, 0, 0, 0
4412, 1, 1636430033449, 1636430033888, 439, 0, 439, 0, 0, 0
4413, 1, 1636430033477, 1636430033928, 451, 0, 451, 0, 0, 0
4414, 1, 1636430033552, 1636430033997, 445, 0, 445, 0, 0, 0
4415, 1, 1636430033584, 1636430034037, 453, 0, 453, 0, 0, 0
4416, 1, 1636430033712, 1636430034376, 664, 217, 447, 217, 0, 217
4417, 1, 1636430034209, 1636430034660, 451, 0, 451, 0, 0, 0
4418, 1, 1636430034269, 1636430034716, 447, 0, 447, 0, 0, 0
4419, 1, 1636430034420, 1636430034873, 453, 1, 452, 0, 1, 1
4420, 1, 1636430034448, 1636430034893, 445, 1, 444, 0, 0, 0
4421, 1, 1636430034544, 1636430034997, 453, 0, 453, 0, 0, 0
4422, 1, 1636430034572, 1636430035020, 448, 0, 448, 0, 0, 0
4423, 1, 1636430034697, 1636430035344, 647, 196, 451, 196, 0, 196
4424, 1, 1636430035221, 1636430035665, 444, 0, 444, 0, 0, 0
4425, 1, 1636430035288, 1636430035737, 449, 0, 449, 0, 0, 0
4426, 1, 1636430035388, 1636430035837, 449, 1, 448, 0, 0, 0
4427, 1, 1636430035409, 1636430035860, 451, 0, 451, 0, 0, 0
4428, 1, 1636430035565, 1636430036017, 452, 0, 452, 0, 0, 0
4429, 1, 1636430035601, 1636430036057, 456, 0, 456, 0, 0, 0
4430, 1, 1636430035685, 1636430036313, 628, 176, 452, 176, 0, 176
4431, 1, 1636430036200, 1636430036653, 453, 1, 452, 0, 0, 0
4432, 1, 1636430036389, 1636430036837, 448, 0, 448, 0, 0, 0
4433, 1, 1636430036444, 1636430036893, 449, 1, 448, 1, 0, 1
4434, 1, 1636430036568, 1636430037021, 453, 1, 452, 0, 0, 0
4435, 1, 1636430036616, 1636430037069, 453, 0, 453, 0, 0, 0
4436, 1, 1636430036704, 1636430037344, 640, 189, 451, 189, 0, 189
4437, 1, 1636430037221, 1636430037672, 451, 0, 451, 0, 0, 0
4438, 1, 1636430037388, 1636430037837, 449, 1, 448, 0, 0, 0
4439, 1, 1636430037417, 1636430037868, 451, 0, 451, 0, 0, 0
4440, 1, 1636430037537, 1636430037993, 456, 0, 456, 0, 0, 0
4441, 1, 1636430037616, 1636430038072, 456, 1, 455, 1, 0, 1
4442, 1, 1636430037689, 1636430038321, 632, 180, 452, 180, 0, 180
4443, 1, 1636430038249, 1636430038701, 452, 0, 452, 0, 0, 0
4444, 1, 1636430038372, 1636430038829, 457, 1, 456, 0, 0, 0
4445, 1, 1636430038393, 1636430038849, 456, 0, 456, 0, 0, 0
4446, 1, 1636430038541, 1636430038993, 452, 0, 452, 0, 0, 0
4447, 1, 1636430038637, 1636430039081, 444, 0, 444, 0, 0, 0
4448, 1, 1636430038676, 1636430039301, 625, 174, 451, 173, 1, 174
4449, 1, 1636430039213, 1636430039669, 456, 0, 456, 0, 0, 0
4450, 1, 1636430039361, 1636430039813, 452, 0, 452, 0, 0, 0
4451, 1, 1636430039376, 1636430039825, 449, 1, 448, 0, 0, 0
4452, 1, 1636430039533, 1636430040120, 587, 136, 451, 136, 0, 136
4453, 1, 1636430039668, 1636430040120, 452, 1, 451, 0, 0, 0
4454, 1, 1636430039672, 1636430040273, 601, 154, 447, 153, 1, 154
4455, 1, 1636430040180, 1636430040725, 545, 93, 452, 92, 0, 92
4457, 1, 1636430040365, 1636430040813, 448, 0, 448, 0, 0, 0
4456, 1, 1636430040365, 1636430040813, 448, 0, 448, 0, 0, 0
4458, 1, 1636430040521, 1636430040977, 456, 0, 456, 0, 0, 0
4459, 1, 1636430040633, 1636430041089, 456, 0, 456, 0, 0, 0
4460, 1, 1636430040665, 1636430041273, 608, 149, 459, 148, 0, 148
4461, 1, 1636430041157, 1636430041613, 456, 0, 456, 0, 0, 0
4462, 1, 1636430041376, 1636430041829, 453, 1, 452, 0, 0, 0
4463, 1, 1636430041392, 1636430041845, 453, 1, 452, 0, 0, 0
4464, 1, 1636430041512, 1636430041969, 457, 1, 456, 0, 0, 0
4465, 1, 1636430041641, 1636430042097, 456, 0, 456, 0, 0, 0
4466, 1, 1636430041680, 1636430042301, 621, 165, 456, 164, 0, 164
4467, 1, 1636430042133, 1636430042576, 443, 0, 443, 0, 0, 0
4468, 1, 1636430042389, 1636430042844, 455, 0, 455, 0, 0, 0
4469, 1, 1636430042413, 1636430042869, 456, 0, 456, 0, 0, 0
4470, 1, 1636430042544, 1636430042993, 449, 0, 449, 0, 0, 0
4471, 1, 1636430042612, 1636430043069, 457, 1, 456, 0, 0, 0
4472, 1, 1636430042697, 1636430043320, 623, 172, 451, 172, 0, 172
4473, 1, 1636430043109, 1636430043552, 443, 0, 443, 0, 0, 0
4474, 1, 1636430043376, 1636430043828, 452, 1, 451, 0, 0, 0
4475, 1, 1636430043376, 1636430043828, 452, 1, 451, 0, 0, 0
4476, 1, 1636430043536, 1636430043985, 449, 0, 449, 0, 0, 0
4477, 1, 1636430043596, 1636430044045, 449, 0, 449, 0, 0, 0
4478, 1, 1636430043685, 1636430044276, 591, 144, 447, 144, 0, 144
4479, 1, 1636430044137, 1636430044588, 451, 0, 451, 0, 0, 0
4480, 1, 1636430044372, 1636430044821, 449, 1, 448, 1, 0, 1
4481, 1, 1636430044392, 1636430044840, 448, 1, 447, 0, 0, 0
4482, 1, 1636430044508, 1636430044957, 449, 1, 448, 0, 0, 0
4483, 1, 1636430044564, 1636430045017, 453, 1, 452, 1, 0, 1
4484, 1, 1636430044673, 1636430045277, 604, 148, 456, 148, 0, 148
4485, 1, 1636430045121, 1636430045573, 452, 0, 452, 0, 0, 0
4486, 1, 1636430045352, 1636430045801, 449, 0, 449, 0, 0, 0
4487, 1, 1636430045372, 1636430045824, 452, 1, 451, 0, 0, 0
4488, 1, 1636430045512, 1636430045965, 453, 1, 452, 0, 0, 0
4489, 1, 1636430045573, 1636430046029, 456, 0, 456, 0, 0, 0
4490, 1, 1636430045665, 1636430046257, 592, 136, 456, 136, 0, 136
4491, 1, 1636430046333, 1636430046789, 456, 0, 456, 0, 0, 0
4492, 1, 1636430046380, 1636430046828, 448, 1, 447, 0, 1, 1
4493, 1, 1636430046501, 1636430046953, 452, 0, 452, 0, 0, 0
4494, 1, 1636430046533, 1636430046989, 456, 0, 456, 0, 0, 0
4495, 1, 1636430046649, 1636430047248, 599, 140, 459, 140, 0, 140
4496, 1, 1636430047316, 1636430047765, 449, 1, 448, 1, 0, 1
4497, 1, 1636430047368, 1636430047812, 444, 1, 443, 0, 1, 1
4499, 1, 1636430047533, 1636430047976, 443, 0, 443, 0, 0, 0
4498, 1, 1636430047525, 1636430047976, 451, 0, 451, 0, 0, 0
4500, 1, 1636430047629, 1636430048221, 592, 137, 455, 136, 1, 137
4501, 1, 1636430048313, 1636430048761, 448, 0, 448, 0, 0, 0
4502, 1, 1636430048397, 1636430048849, 452, 0, 452, 0, 0, 0
4503, 1, 1636430048545, 1636430048993, 448, 0, 448, 0, 0, 0
4504, 1, 1636430048556, 1636430049005, 449, 1, 448, 0, 0, 0
4505, 1, 1636430048641, 1636430049217, 576, 121, 455, 120, 1, 121
4506, 1, 1636430049288, 1636430049736, 448, 1, 447, 0, 1, 1
4507, 1, 1636430049408, 1636430049857, 449, 0, 449, 0, 0, 0
4508, 1, 1636430049508, 1636430049957, 449, 0, 449, 0, 0, 0
4509, 1, 1636430049544, 1636430049988, 444, 1, 443, 0, 0, 0
4510, 1, 1636430049641, 1636430050185, 544, 96, 448, 96, 0, 96
4511, 1, 1636430050308, 1636430050761, 453, 1, 452, 0, 0, 0
4512, 1, 1636430050380, 1636430050829, 449, 1, 448, 0, 1, 1
4513, 1, 1636430050532, 1636430050977, 445, 0, 445, 0, 0, 0
4514, 1, 1636430050576, 1636430051029, 453, 0, 453, 0, 0, 0
4515, 1, 1636430050645, 1636430051213, 568, 116, 452, 116, 0, 116
4516, 1, 1636430051321, 1636430051777, 456, 0, 456, 0, 0, 0
4517, 1, 1636430051372, 1636430051817, 445, 0, 445, 0, 0, 0
4518, 1, 1636430051557, 1636430052005, 448, 0, 448, 0, 0, 0
4519, 1, 1636430051589, 1636430052041, 452, 0, 452, 0, 0, 0
4520, 1, 1636430051652, 1636430052233, 581, 125, 456, 125, 0, 125
4521, 1, 1636430052305, 1636430052757, 452, 0, 452, 0, 0, 0
4522, 1, 1636430052337, 1636430052793, 456, 0, 456, 0, 0, 0
4523, 1, 1636430052545, 1636430052993, 448, 0, 448, 0, 0, 0
4524, 1, 1636430052577, 1636430053025, 448, 0, 448, 0, 0, 0
4525, 1, 1636430052636, 1636430053209, 573, 121, 452, 121, 0, 121
4526, 1, 1636430053285, 1636430053736, 451, 0, 451, 0, 0, 0
4527, 1, 1636430053309, 1636430053756, 447, 0, 447, 0, 0, 0
4529, 1, 1636430053580, 1636430054033, 453, 1, 452, 0, 1, 1
4528, 1, 1636430053580, 1636430054033, 453, 1, 452, 1, 0, 1
4530, 1, 1636430053640, 1636430054185, 545, 97, 448, 97, 0, 97
4531, 1, 1636430054288, 1636430054737, 449, 1, 448, 0, 1, 1
4532, 1, 1636430054321, 1636430054769, 448, 0, 448, 0, 0, 0
4533, 1, 1636430054565, 1636430055012, 447, 0, 447, 0, 0, 0
4534, 1, 1636430054589, 1636430055041, 452, 0, 452, 0, 0, 0
4535, 1, 1636430054645, 1636430055225, 580, 124, 456, 124, 0, 124
4536, 1, 1636430055293, 1636430055741, 448, 0, 448, 0, 0, 0
4537, 1, 1636430055325, 1636430055781, 456, 0, 456, 0, 0, 0
4538, 1, 1636430055580, 1636430056029, 449, 1, 448, 0, 1, 1
4539, 1, 1636430055580, 1636430056032, 452, 1, 451, 0, 0, 0
4540, 1, 1636430055624, 1636430056193, 569, 117, 452, 117, 0, 117
4541, 1, 1636430056281, 1636430056732, 451, 0, 451, 0, 0, 0
4542, 1, 1636430056297, 1636430056745, 448, 0, 448, 0, 0, 0
4544, 1, 1636430056589, 1636430057049, 460, 0, 460, 0, 0, 0
4543, 1, 1636430056589, 1636430057049, 460, 0, 460, 0, 0, 0
4545, 1, 1636430056620, 1636430057185, 565, 113, 452, 113, 0, 113
4546, 1, 1636430057301, 1636430057752, 451, 0, 451, 0, 0, 0
4548, 1, 1636430057585, 1636430058036, 451, 0, 451, 0, 0, 0
4547, 1, 1636430057585, 1636430058036, 451, 0, 451, 0, 0, 0
4549, 1, 1636430057620, 1636430058205, 585, 133, 452, 133, 0, 133
4550, 1, 1636430058317, 1636430058773, 456, 0, 456, 0, 0, 0
4551, 1, 1636430058589, 1636430059041, 452, 0, 452, 0, 0, 0
4552, 1, 1636430058600, 1636430059053, 453, 1, 452, 0, 1, 1
4553, 1, 1636430058625, 1636430059229, 604, 149, 455, 148, 0, 148
4554, 1, 1636430059337, 1636430059793, 456, 0, 456, 0, 0, 0
4555, 1, 1636430059600, 1636430060053, 453, 1, 452, 0, 0, 0
4556, 1, 1636430059609, 1636430060061, 452, 0, 452, 0, 0, 0
4557, 1, 1636430059641, 1636430060245, 604, 153, 451, 152, 0, 152
4558, 1, 1636430060321, 1636430060773, 452, 0, 452, 0, 0, 0
4559, 1, 1636430060573, 1636430061021, 448, 0, 448, 0, 0, 0
4560, 1, 1636430060589, 1636430061045, 456, 0, 456, 0, 0, 0
4561, 1, 1636430060624, 1636430061225, 601, 150, 451, 150, 0, 150
4562, 1, 1636430061300, 1636430061757, 457, 1, 456, 0, 0, 0
4563, 1, 1636430061561, 1636430062009, 448, 0, 448, 0, 0, 0
4564, 1, 1636430061585, 1636430062037, 452, 0, 452, 0, 0, 0
4565, 1, 1636430061620, 1636430062213, 593, 137, 456, 137, 0, 137
4566, 1, 1636430062284, 1636430062732, 448, 1, 447, 0, 0, 0
4567, 1, 1636430062585, 1636430063037, 452, 0, 452, 0, 0, 0
4568, 1, 1636430062596, 1636430063041, 445, 0, 445, 0, 0, 0
4569, 1, 1636430062600, 1636430063181, 581, 133, 448, 133, 0, 133
4570, 1, 1636430063281, 1636430063741, 460, 0, 460, 0, 0, 0
4571, 1, 1636430063552, 1636430064001, 449, 0, 449, 0, 0, 0
4573, 1, 1636430063596, 1636430064041, 445, 1, 444, 0, 0, 0
4572, 1, 1636430063584, 1636430064189, 605, 158, 447, 157, 1, 158
4574, 1, 1636430064277, 1636430064728, 451, 0, 451, 0, 0, 0
4577, 1, 1636430064585, 1636430065036, 451, 0, 451, 0, 0, 0
4576, 1, 1636430064581, 1636430065036, 455, 0, 455, 0, 0, 0
4575, 1, 1636430064569, 1636430065176, 607, 160, 447, 160, 0, 160
4578, 1, 1636430065561, 1636430066013, 452, 0, 452, 0, 0, 0
4579, 1, 1636430065593, 1636430066049, 456, 0, 456, 0, 0, 0
4580, 1, 1636430066561, 1636430067013, 452, 0, 452, 0, 0, 0
4581, 1, 1636430066580, 1636430067033, 453, 1, 452, 0, 0, 0
4582, 1, 1636430067577, 1636430068033, 456, 0, 456, 0, 0, 0
4583, 1, 1636430067584, 1636430068041, 457, 1, 456, 0, 0, 0
4584, 1, 1636430068573, 1636430069029, 456, 0, 456, 0, 0, 0
4585, 1, 1636430068573, 1636430069029, 456, 0, 456, 0, 0, 0
4586, 1, 1636430069557, 1636430070013, 456, 0, 456, 0, 0, 0
4587, 1, 1636430069585, 1636430070037, 452, 0, 452, 0, 0, 0
4589, 1, 1636430070588, 1636430071037, 449, 1, 448, 0, 1, 1
4588, 1, 1636430070588, 1636430071037, 449, 1, 448, 0, 1, 1
4590, 1, 1636430071581, 1636430072033, 452, 0, 452, 0, 0, 0
4591, 1, 1636430071589, 1636430072041, 452, 0, 452, 0, 0, 0
4592, 1, 1636430072565, 1636430073020, 455, 0, 455, 0, 0, 0
4593, 1, 1636430072617, 1636430073065, 448, 0, 448, 0, 0, 0
4594, 1, 1636430073597, 1636430074049, 452, 0, 452, 0, 0, 0
4595, 1, 1636430073608, 1636430074053, 445, 1, 444, 0, 1, 1
4596, 1, 1636430074597, 1636430075049, 452, 0, 452, 0, 0, 0
4597, 1, 1636430074621, 1636430075077, 456, 0, 456, 0, 0, 0
4598, 1, 1636430075621, 1636430076077, 456, 0, 456, 0, 0, 0
4599, 1, 1636430076617, 1636430077073, 456, 0, 456, 0, 0, 0
4600, 1, 1636430077645, 1636430078101, 456, 0, 456, 0, 0, 0
4601, 1, 1636430167629, 1636430168089, 460, 0, 460, 0, 0, 0
4602, 1, 1636430168109, 1636430168557, 448, 0, 448, 0, 0, 0
4603, 1, 1636430168604, 1636430169053, 449, 1, 448, 0, 1, 1
4604, 1, 1636430169313, 1636430169765, 452, 0, 452, 0, 0, 0
4605, 1, 1636430169536, 1636430169985, 449, 1, 448, 0, 1, 1
4606, 1, 1636430169681, 1636430170213, 532, 85, 447, 84, 0, 84
4607, 1, 1636430170105, 1636430170557, 452, 0, 452, 0, 0, 0
4608, 1, 1636430170365, 1636430170813, 448, 0, 448, 0, 0, 0
4609, 1, 1636430170465, 1636430171009, 544, 92, 452, 92, 0, 92
4610, 1, 1636430170893, 1636430171349, 456, 0, 456, 0, 0, 0
4611, 1, 1636430171177, 1636430171625, 448, 0, 448, 0, 0, 0
4612, 1, 1636430171484, 1636430171937, 453, 1, 452, 0, 1, 1
4613, 1, 1636430171484, 1636430171937, 453, 1, 452, 0, 0, 0
4614, 1, 1636430171564, 1636430172076, 512, 61, 451, 61, 0, 61
4615, 1, 1636430171881, 1636430172393, 512, 57, 455, 56, 1, 57
4616, 1, 1636430172056, 1636430172509, 453, 1, 452, 0, 0, 0
4618, 1, 1636430172364, 1636430172817, 453, 1, 452, 0, 0, 0
4617, 1, 1636430172345, 1636430172965, 620, 164, 456, 164, 0, 164
4620, 1, 1636430172765, 1636430173217, 452, 0, 452, 0, 0, 0
4619, 1, 1636430172757, 1636430173277, 520, 60, 460, 60, 0, 60
4621, 1, 1636430173129, 1636430173581, 452, 0, 452, 0, 0, 0
4622, 1, 1636430173352, 1636430173805, 453, 1, 452, 0, 0, 0
4624, 1, 1636430173497, 1636430173945, 448, 0, 448, 0, 0, 0
4623, 1, 1636430173461, 1636430174033, 572, 120, 452, 120, 0, 120
4625, 1, 1636430173869, 1636430174316, 447, 0, 447, 0, 0, 0
4626, 1, 1636430174072, 1636430174525, 453, 1, 452, 1, 0, 1
4627, 1, 1636430174125, 1636430174581, 456, 0, 456, 0, 0, 0
4628, 1, 1636430174312, 1636430174765, 453, 1, 452, 0, 0, 0
4629, 1, 1636430174352, 1636430174973, 621, 173, 448, 173, 0, 173
4630, 1, 1636430174540, 1636430175028, 488, 41, 447, 41, 0, 41
4632, 1, 1636430174765, 1636430175209, 444, 0, 444, 0, 0, 0
4631, 1, 1636430174728, 1636430175213, 485, 38, 447, 37, 0, 37
4633, 1, 1636430174912, 1636430175477, 565, 117, 448, 117, 0, 117
4634, 1, 1636430175137, 1636430175593, 456, 0, 456, 0, 0, 0
4635, 1, 1636430175296, 1636430175745, 449, 1, 448, 0, 0, 0
4636, 1, 1636430175393, 1636430175929, 536, 85, 451, 84, 0, 84
4637, 1, 1636430175553, 1636430176041, 488, 40, 448, 40, 0, 40
4638, 1, 1636430175621, 1636430176073, 452, 0, 452, 0, 0, 0
4639, 1, 1636430175817, 1636430176277, 460, 0, 460, 0, 0, 0
4640, 1, 1636430175916, 1636430176385, 469, 13, 456, 12, 0, 12
4641, 1, 1636430175988, 1636430176428, 440, 1, 439, 0, 0, 0
4642, 1, 1636430176152, 1636430176597, 445, 1, 444, 0, 0, 0
4643, 1, 1636430176324, 1636430176772, 448, 1, 447, 1, 0, 1
4645, 1, 1636430176428, 1636430176877, 449, 1, 448, 1, 0, 1
4646, 1, 1636430176501, 1636430176953, 452, 0, 452, 0, 0, 0
4644, 1, 1636430176420, 1636430177048, 628, 178, 450, 178, 0, 178
4647, 1, 1636430176717, 1636430177168, 451, 0, 451, 0, 0, 0
4648, 1, 1636430176820, 1636430177269, 449, 0, 449, 0, 0, 0
4649, 1, 1636430176864, 1636430177332, 468, 13, 455, 13, 0, 13
4650, 1, 1636430176988, 1636430177429, 441, 1, 440, 0, 0, 0
4651, 1, 1636430177228, 1636430177681, 453, 0, 453, 0, 0, 0
4652, 1, 1636430177273, 1636430177784, 511, 60, 451, 60, 0, 60
4653, 1, 1636430177344, 1636430177801, 457, 1, 456, 0, 0, 0
4654, 1, 1636430177517, 1636430177968, 451, 0, 451, 0, 0, 0
4655, 1, 1636430177532, 1636430177985, 453, 1, 452, 0, 1, 1
4656, 1, 1636430177665, 1636430178133, 468, 16, 452, 16, 0, 16
4657, 1, 1636430177889, 1636430178341, 452, 0, 452, 0, 0, 0
4658, 1, 1636430177920, 1636430178368, 448, 0, 448, 0, 0, 0
4659, 1, 1636430177964, 1636430178409, 445, 0, 445, 0, 0, 0
4660, 1, 1636430178060, 1636430178497, 437, 1, 436, 0, 1, 1
4661, 1, 1636430178097, 1636430178552, 455, 0, 455, 0, 0, 0
4663, 1, 1636430178364, 1636430178808, 444, 0, 444, 0, 0, 0
4664, 1, 1636430178409, 1636430178856, 447, 1, 446, 0, 1, 1
4665, 1, 1636430178456, 1636430178896, 440, 0, 440, 0, 0, 0
4662, 1, 1636430178341, 1636430178949, 608, 156, 452, 156, 0, 156
4666, 1, 1636430178673, 1636430179129, 456, 0, 456, 0, 0, 0
4667, 1, 1636430178720, 1636430179173, 453, 1, 452, 0, 1, 1
4668, 1, 1636430178833, 1636430179309, 476, 24, 452, 24, 0, 24
4669, 1, 1636430178948, 1636430179401, 453, 1, 452, 1, 0, 1
4670, 1, 1636430178985, 1636430179436, 451, 0, 451, 0, 0, 0
4671, 1, 1636430179097, 1636430179548, 451, 0, 451, 0, 0, 0
4672, 1, 1636430179168, 1636430179757, 589, 141, 448, 141, 0, 141
4673, 1, 1636430179364, 1636430179844, 480, 37, 443, 37, 0, 37
4674, 1, 1636430179517, 1636430179964, 447, 0, 447, 0, 0, 0
4675, 1, 1636430179581, 1636430180028, 447, 0, 447, 0, 0, 0
4676, 1, 1636430179652, 1636430180104, 452, 1, 451, 0, 0, 0
4677, 1, 1636430179832, 1636430180293, 461, 1, 460, 1, 0, 1
4678, 1, 1636430179956, 1636430180408, 452, 9, 443, 8, 0, 8
4679, 1, 1636430180008, 1636430180456, 448, 0, 448, 0, 0, 0
4680, 1, 1636430180040, 1636430180492, 452, 0, 452, 0, 0, 0
4681, 1, 1636430180128, 1636430180580, 452, 1, 451, 0, 0, 0
4682, 1, 1636430180316, 1636430180768, 452, 1, 451, 0, 0, 0
4683, 1, 1636430180340, 1636430180793, 453, 1, 452, 1, 0, 1
4685, 1, 1636430180444, 1636430180905, 461, 13, 448, 12, 0, 12
4686, 1, 1636430180536, 1636430180985, 449, 0, 449, 0, 0, 0
4684, 1, 1636430180408, 1636430181028, 620, 173, 447, 173, 0, 173
4687, 1, 1636430180816, 1636430181273, 457, 1, 456, 0, 0, 0
4688, 1, 1636430180848, 1636430181300, 452, 1, 451, 1, 0, 1
4689, 1, 1636430180864, 1636430181352, 488, 41, 447, 41, 0, 41
4690, 1, 1636430180933, 1636430181385, 452, 0, 452, 0, 0, 0
4692, 1, 1636430181212, 1636430181660, 448, 1, 447, 1, 0, 1
4693, 1, 1636430181280, 1636430181728, 448, 1, 447, 0, 0, 0
4691, 1, 1636430181185, 1636430181808, 623, 168, 455, 168, 0, 168
4694, 1, 1636430181469, 1636430181916, 447, 0, 447, 0, 0, 0
4695, 1, 1636430181700, 1636430182148, 448, 1, 447, 0, 0, 0
4696, 1, 1636430181708, 1636430182165, 457, 0, 457, 0, 0, 0
4697, 1, 1636430181852, 1636430182300, 448, 1, 447, 0, 0, 0
4698, 1, 1636430181908, 1636430182364, 456, 9, 447, 9, 0, 9
4699, 1, 1636430181948, 1636430182396, 448, 1, 447, 0, 1, 1
4700, 1, 1636430182133, 1636430182588, 455, 0, 455, 0, 0, 0
4701, 1, 1636430182184, 1636430182636, 452, 1, 451, 1, 0, 1
4702, 1, 1636430182380, 1636430182829, 449, 0, 449, 0, 0, 0
4703, 1, 1636430182436, 1636430182889, 453, 1, 452, 0, 0, 0
4705, 1, 1636430182488, 1636430182945, 457, 0, 457, 0, 0, 0
4706, 1, 1636430182528, 1636430183032, 504, 61, 443, 61, 0, 61
4704, 1, 1636430182436, 1636430183080, 644, 201, 443, 200, 0, 200
4707, 1, 1636430182761, 1636430183213, 452, 0, 452, 0, 0, 0
4709, 1, 1636430182945, 1636430183393, 448, 0, 448, 0, 0, 0
4710, 1, 1636430182972, 1636430183425, 453, 1, 452, 0, 0, 0
4708, 1, 1636430182908, 1636430183497, 589, 125, 464, 125, 0, 125
4712, 1, 1636430183272, 1636430183729, 457, 1, 456, 1, 0, 1
4713, 1, 1636430183405, 1636430183852, 447, 0, 447, 0, 0, 0
4711, 1, 1636430183232, 1636430183945, 713, 265, 448, 264, 0, 264
4714, 1, 1636430183508, 1636430183952, 444, 1, 443, 0, 0, 0
4715, 1, 1636430183756, 1636430184200, 444, 1, 443, 0, 0, 0
4716, 1, 1636430183797, 1636430184244, 447, 0, 447, 0, 0, 0
4717, 1, 1636430183920, 1636430184393, 473, 33, 440, 32, 0, 32
4718, 1, 1636430183980, 1636430184420, 440, 1, 439, 0, 0, 0
4719, 1, 1636430183996, 1636430184448, 452, 0, 452, 0, 0, 0
4720, 1, 1636430184064, 1636430184512, 448, 1, 447, 0, 0, 0
4721, 1, 1636430184252, 1636430184700, 448, 1, 447, 0, 0, 0
4722, 1, 1636430184412, 1636430184900, 488, 37, 451, 37, 0, 37
4723, 1, 1636430184496, 1636430184944, 448, 1, 447, 0, 1, 1
4725, 1, 1636430184504, 1636430184945, 441, 0, 441, 0, 0, 0
4724, 1, 1636430184496, 1636430184944, 448, 1, 447, 1, 0, 1
4726, 1, 1636430184556, 1636430185157, 601, 145, 456, 145, 0, 145
4728, 1, 1636430184892, 1636430185345, 453, 1, 452, 0, 0, 0
4727, 1, 1636430184872, 1636430185352, 480, 29, 451, 28, 0, 28
4729, 1, 1636430184992, 1636430185440, 448, 0, 448, 0, 0, 0
4730, 1, 1636430185052, 1636430185488, 436, 0, 436, 0, 0, 0
4732, 1, 1636430185345, 1636430185793, 448, 0, 448, 0, 0, 0
4731, 1, 1636430185168, 1636430185793, 625, 185, 440, 183, 0, 183
4733, 1, 1636430185456, 1636430185904, 448, 0, 448, 0, 0, 0
4734, 1, 1636430185633, 1636430186088, 455, 0, 455, 0, 0, 0
4735, 1, 1636430185824, 1636430186272, 448, 1, 447, 0, 0, 0
4736, 1, 1636430185845, 1636430186300, 455, 0, 455, 0, 0, 0
4737, 1, 1636430185860, 1636430186304, 444, 1, 443, 0, 0, 0
4738, 1, 1636430185940, 1636430186528, 588, 149, 439, 149, 0, 149
4739, 1, 1636430186112, 1636430186544, 432, 0, 432, 0, 0, 0
4740, 1, 1636430186116, 1636430186569, 453, 0, 453, 0, 0, 0
4741, 1, 1636430186316, 1636430186757, 441, 0, 441, 0, 0, 0
4742, 1, 1636430186376, 1636430186816, 440, 1, 439, 0, 1, 1
4743, 1, 1636430186441, 1636430187013, 572, 129, 443, 128, 1, 129
4744, 1, 1636430186568, 1636430187013, 445, 1, 444, 0, 0, 0
4745, 1, 1636430186624, 1636430187064, 440, 0, 440, 0, 0, 0
4746, 1, 1636430186668, 1636430187217, 549, 89, 460, 89, 0, 89
4748, 1, 1636430186948, 1636430187401, 453, 1, 452, 0, 0, 0
4749, 1, 1636430186957, 1636430187413, 456, 0, 456, 0, 0, 0
4747, 1, 1636430186924, 1636430187472, 548, 89, 459, 89, 0, 89
4750, 1, 1636430187060, 1636430187513, 453, 1, 452, 0, 1, 1
4752, 1, 1636430187413, 1636430187868, 455, 0, 455, 0, 0, 0
4751, 1, 1636430187213, 1636430187916, 703, 260, 443, 260, 0, 260
4753, 1, 1636430187504, 1636430187949, 445, 0, 445, 0, 0, 0
4754, 1, 1636430187529, 1636430187977, 448, 0, 448, 0, 0, 0
4755, 1, 1636430187848, 1636430188297, 449, 1, 448, 0, 0, 0
4757, 1, 1636430187889, 1636430188332, 443, 0, 443, 0, 0, 0
4756, 1, 1636430187881, 1636430188408, 527, 68, 459, 68, 0, 68
4758, 1, 1636430187977, 1636430188428, 451, 0, 451, 0, 0, 0
4759, 1, 1636430188152, 1636430188605, 453, 0, 453, 0, 0, 0
4760, 1, 1636430188177, 1636430188628, 451, 0, 451, 0, 0, 0
4761, 1, 1636430188192, 1636430188748, 556, 105, 451, 105, 0, 105
4762, 1, 1636430188440, 1636430188892, 452, 0, 452, 0, 0, 0
4763, 1, 1636430188500, 1636430188956, 456, 1, 455, 0, 0, 0
4766, 1, 1636430188632, 1636430189080, 448, 1, 447, 0, 1, 1
4764, 1, 1636430188516, 1636430189080, 564, 113, 451, 112, 0, 112
4765, 1, 1636430188592, 1636430189201, 609, 157, 452, 157, 0, 157
4768, 1, 1636430189025, 1636430189469, 444, 0, 444, 0, 0, 0
4769, 1, 1636430189072, 1636430189521, 449, 1, 448, 0, 0, 0
4767, 1, 1636430189000, 1636430189537, 537, 81, 456, 81, 0, 81
4770, 1, 1636430189124, 1636430189572, 448, 0, 448, 0, 0, 0
4772, 1, 1636430189369, 1636430189829, 460, 0, 460, 0, 0, 0
4771, 1, 1636430189252, 1636430189989, 737, 285, 452, 284, 0, 284
4773, 1, 1636430189592, 1636430190032, 440, 0, 440, 0, 0, 0
4774, 1, 1636430189620, 1636430190064, 444, 1, 443, 0, 0, 0
4775, 1, 1636430189717, 1636430190169, 452, 0, 452, 0, 0, 0
4776, 1, 1636430189880, 1636430190333, 453, 0, 453, 0, 0, 0
4778, 1, 1636430190036, 1636430190493, 457, 0, 457, 0, 0, 0
4777, 1, 1636430189928, 1636430190516, 588, 137, 451, 137, 0, 137
4779, 1, 1636430190145, 1636430190628, 483, 24, 459, 24, 0, 24
4780, 1, 1636430190200, 1636430190652, 452, 0, 452, 0, 0, 0
4781, 1, 1636430190244, 1636430190701, 457, 1, 456, 0, 0, 0
4782, 1, 1636430190500, 1636430190945, 445, 1, 444, 0, 1, 1
4786, 1, 1636430190628, 1636430191072, 444, 1, 443, 0, 1, 1
4783, 1, 1636430190540, 1636430191076, 536, 89, 447, 89, 0, 89
4785, 1, 1636430190625, 1636430191084, 459, 0, 459, 0, 0, 0
4784, 1, 1636430190557, 1636430191153, 596, 144, 452, 144, 0, 144
4788, 1, 1636430191092, 1636430191541, 449, 0, 449, 0, 0, 0
4789, 1, 1636430191112, 1636430191556, 444, 0, 444, 0, 0, 0
4790, 1, 1636430191136, 1636430191584, 448, 1, 447, 0, 0, 0
4787, 1, 1636430191072, 1636430191604, 532, 81, 451, 81, 0, 81
4792, 1, 1636430191281, 1636430191740, 459, 0, 459, 0, 0, 0
4793, 1, 1636430191464, 1636430192008, 544, 93, 451, 93, 0, 93
4791, 1, 1636430191265, 1636430192048, 783, 339, 444, 339, 0, 339
4795, 1, 1636430191676, 1636430192121, 445, 0, 445, 0, 0, 0
4796, 1, 1636430191828, 1636430192277, 449, 0, 449, 0, 0, 0
4794, 1, 1636430191644, 1636430192465, 821, 365, 456, 365, 0, 365
4799, 1, 1636430192116, 1636430192569, 453, 1, 452, 1, 0, 1
4797, 1, 1636430191936, 1636430192577, 641, 185, 456, 185, 0, 185
4801, 1, 1636430192312, 1636430192760, 448, 1, 447, 1, 0, 1
4803, 1, 1636430192577, 1636430193028, 451, 1, 450, 0, 1, 1
4804, 1, 1636430192577, 1636430193028, 451, 0, 451, 0, 0, 0
4806, 1, 1636430192688, 1636430193141, 453, 1, 452, 0, 1, 1
4805, 1, 1636430192672, 1636430193209, 537, 89, 448, 89, 0, 89
4808, 1, 1636430193084, 1636430193533, 449, 0, 449, 0, 0, 0
4810, 1, 1636430193204, 1636430193645, 441, 1, 440, 0, 0, 0
4809, 1, 1636430193189, 1636430193652, 463, 20, 443, 20, 0, 20
4813, 1, 1636430193384, 1636430193989, 605, 149, 456, 149, 0, 149
4812, 1, 1636430193301, 1636430194100, 799, 352, 447, 352, 0, 352
4814, 1, 1636430193696, 1636430194153, 457, 1, 456, 0, 1, 1
4815, 1, 1636430193740, 1636430194189, 449, 0, 449, 0, 0, 0
4818, 1, 1636430194160, 1636430194608, 448, 0, 448, 0, 0, 0
4817, 1, 1636430194009, 1636430194640, 631, 180, 451, 180, 0, 180
4821, 1, 1636430194608, 1636430195057, 449, 1, 448, 1, 0, 1
4823, 1, 1636430194769, 1636430195225, 456, 0, 456, 0, 0, 0
4827, 1, 1636430195324, 1636430195777, 453, 1, 452, 0, 1, 1
4829, 1, 1636430195681, 1636430196136, 455, 0, 455, 0, 0, 0
4830, 1, 1636430195865, 1636430196317, 452, 0, 452, 0, 0, 0
4831, 1, 1636430196069, 1636430196773, 704, 249, 455, 248, 1, 249
4834, 1, 1636430196813, 1636430197264, 451, 0, 451, 0, 0, 0
4836, 1, 1636430197781, 1636430198237, 456, 0, 456, 0, 0, 0
4840, 1, 1636430199692, 1636430200141, 449, 1, 448, 0, 0, 0
4798, 2, 1636430192060, 1636430202065, 10005, 0, 10005, 405, 0, 405
4841, 1, 1636430201645, 1636430202097, 452, 0, 452, 0, 0, 0
4800, 2, 1636430192156, 1636430202157, 10001, 0, 10001, 308, 0, 308
4802, 2, 1636430192513, 1636430202517, 10004, 0, 10004, 0, 0, 0
4807, 2, 1636430193040, 1636430203044, 10004, 0, 10004, 0, 0, 0
4811, 2, 1636430193209, 1636430203212, 10003, 0, 10003, 0, 0, 0
4843, 1, 1636430202780, 1636430203264, 484, 0, 484, 0, 0, 0
4842, 1, 1636430202772, 1636430203268, 496, 0, 496, 0, 0, 0
4844, 1, 1636430202820, 1636430203712, 892, 445, 447, 445, 0, 445
4816, 2, 1636430193744, 1636430203748, 10004, 0, 10004, 0, 0, 0
4845, 1, 1636430203341, 1636430203793, 452, 0, 452, 0, 0, 0
4847, 1, 1636430203653, 1636430204112, 459, 0, 459, 0, 0, 0
4846, 1, 1636430203520, 1636430204169, 649, 193, 456, 193, 0, 193
4819, 2, 1636430194309, 1636430204309, 10000, 0, 10000, 0, 0, 0
4820, 2, 1636430194501, 1636430204501, 10000, 0, 10000, 0, 0, 0
4848, 1, 1636430204049, 1636430204624, 575, 120, 455, 120, 0, 120
4822, 2, 1636430194660, 1636430204665, 10005, 0, 10005, 0, 0, 0
4824, 2, 1636430195005, 1636430205005, 10000, 0, 10000, 0, 0, 0
4849, 1, 1636430204624, 1636430205073, 449, 1, 448, 0, 0, 0
4825, 2, 1636430195149, 1636430205149, 10000, 0, 10000, 0, 0, 0
4853, 1, 1636430204804, 1636430205253, 449, 0, 449, 0, 0, 0
4826, 2, 1636430195257, 1636430205253, 9996, 0, 9996, 0, 0, 0
4851, 1, 1636430204848, 1636430205321, 473, 0, 473, 0, 0, 0
4828, 2, 1636430195340, 1636430205345, 10005, 0, 10005, 0, 0, 0
4854, 1, 1636430204969, 1636430205564, 595, 104, 491, 104, 0, 104
4855, 1, 1636430205344, 1636430205797, 453, 1, 452, 0, 0, 0
4856, 1, 1636430205388, 1636430205844, 456, 1, 455, 0, 0, 0
4857, 1, 1636430205453, 1636430206017, 564, 112, 452, 112, 0, 112
4832, 2, 1636430196153, 1636430206149, 9996, 0, 9996, 0, 0, 0
4861, 1, 1636430205781, 1636430206228, 447, 0, 447, 0, 0, 0
4860, 1, 1636430205648, 1636430206249, 601, 149, 452, 148, 0, 148
4859, 1, 1636430205608, 1636430206469, 861, 409, 452, 409, 0, 409
4833, 2, 1636430196601, 1636430206601, 10000, 0, 10000, 0, 0, 0
4863, 1, 1636430206465, 1636430206912, 447, 4, 443, 4, 0, 4
4864, 1, 1636430206648, 1636430207088, 440, 1, 439, 0, 0, 0
4835, 2, 1636430197320, 1636430207317, 9997, 0, 9997, 0, 0, 0
4866, 1, 1636430206904, 1636430207352, 448, 9, 439, 9, 0, 9
4867, 1, 1636430206909, 1636430207360, 451, 0, 451, 0, 0, 0
4868, 1, 1636430206952, 1636430207541, 589, 137, 452, 137, 0, 137
4837, 2, 1636430197857, 1636430207853, 9996, 0, 9996, 0, 0, 0
4870, 1, 1636430207449, 1636430207897, 448, 0, 448, 0, 0, 0
4838, 2, 1636430197965, 1636430207965, 10000, 0, 10000, 0, 0, 0
4871, 1, 1636430207457, 1636430207984, 527, 84, 443, 84, 0, 84
4872, 1, 1636430207629, 1636430208072, 443, 0, 443, 0, 0, 0
4875, 1, 1636430207761, 1636430208212, 451, 0, 451, 0, 0, 0
4839, 1, 1636430198769, 1636430208421, 9652, 9196, 456, 0, 9196, 9196
4874, 1, 1636430207608, 1636430208437, 829, 377, 452, 376, 0, 376
4876, 1, 1636430208160, 1636430208612, 452, 0, 452, 0, 0, 0
4878, 1, 1636430208428, 1636430208888, 460, 9, 451, 8, 0, 8
4877, 1, 1636430208273, 1636430209061, 788, 340, 448, 340, 0, 340
4880, 1, 1636430208645, 1636430209100, 455, 0, 455, 0, 0, 0
4881, 1, 1636430208892, 1636430209337, 445, 0, 445, 0, 0, 0
4879, 1, 1636430208645, 1636430209516, 871, 416, 455, 416, 0, 416
4883, 1, 1636430209024, 1636430209549, 525, 76, 449, 76, 0, 76
4885, 1, 1636430209576, 1636430210029, 453, 1, 452, 0, 0, 0
4886, 1, 1636430209613, 1636430210068, 455, 0, 455, 0, 0, 0
4888, 1, 1636430209705, 1636430210152, 447, 0, 447, 0, 0, 0
4887, 1, 1636430209681, 1636430210481, 800, 348, 452, 348, 0, 348
4889, 1, 1636430210152, 1636430210601, 449, 1, 448, 0, 0, 0
4891, 1, 1636430210509, 1636430210960, 451, 0, 451, 0, 0, 0
4890, 1, 1636430210265, 1636430211056, 791, 337, 454, 336, 0, 336
4894, 1, 1636430210896, 1636430211413, 517, 65, 452, 65, 0, 65
4892, 1, 1636430210620, 1636430211513, 893, 437, 456, 437, 0, 437
4896, 1, 1636430211593, 1636430212049, 456, 0, 456, 0, 0, 0
4898, 1, 1636430211689, 1636430212136, 447, 0, 447, 0, 0, 0
4900, 1, 1636430212157, 1636430212605, 448, 0, 448, 0, 0, 0
4901, 1, 1636430212348, 1636430213061, 713, 258, 455, 256, 0, 256
4903, 1, 1636430212696, 1636430213517, 821, 365, 456, 364, 0, 364
4905, 1, 1636430213517, 1636430213972, 455, 0, 455, 0, 0, 0
4850, 2, 1636430204757, 1636430214757, 10000, 0, 10000, 0, 0, 0
4852, 2, 1636430204757, 1636430214800, 10043, 0, 10043, 0, 0, 0
4858, 2, 1636430205524, 1636430215529, 10005, 0, 10005, 0, 0, 0
4862, 2, 1636430206024, 1636430216025, 10001, 0, 10001, 0, 0, 0
4912, 1, 1636430215660, 1636430216108, 448, 1, 447, 0, 0, 0
4865, 2, 1636430206776, 1636430216776, 10000, 0, 10000, 0, 0, 0
4869, 2, 1636430207289, 1636430217289, 10000, 0, 10000, 0, 0, 0
4873, 2, 1636430207592, 1636430217593, 10001, 0, 10001, 1, 0, 1
4917, 1, 1636430217752, 1636430218205, 453, 0, 453, 0, 0, 0
4882, 2, 1636430208908, 1636430218909, 10001, 0, 10001, 0, 0, 0
4884, 2, 1636430209549, 1636430219544, 9995, 0, 9995, 0, 0, 0
4920, 1, 1636430219728, 1636430220180, 452, 1, 451, 0, 0, 0
4893, 2, 1636430210712, 1636430220717, 10005, 0, 10005, 0, 0, 0
4895, 2, 1636430211076, 1636430221077, 10001, 0, 10001, 0, 0, 0
4897, 2, 1636430211649, 1636430221648, 9999, 0, 9999, 0, 0, 0
4899, 2, 1636430211757, 1636430221752, 9995, 0, 9995, 0, 0, 0
4924, 1, 1636430221736, 1636430222188, 452, 0, 452, 0, 0, 0
4902, 2, 1636430212580, 1636430222581, 10001, 0, 10001, 0, 0, 0
4904, 2, 1636430212957, 1636430222957, 10000, 0, 10000, 0, 0, 0
4906, 2, 1636430213688, 1636430223689, 10001, 0, 10001, 0, 0, 0
4907, 2, 1636430214156, 1636430224157, 10001, 0, 10001, 1, 0, 1
4929, 1, 1636430223776, 1636430224228, 452, 1, 451, 1, 0, 1
4908, 2, 1636430214381, 1636430224381, 10000, 0, 10000, 0, 0, 0
4909, 1, 1636430214733, 1636430224841, 10108, 9648, 460, 0, 9648, 9648
4910, 2, 1636430215069, 1636430225069, 10000, 0, 10000, 0, 0, 0
4911, 2, 1636430215069, 1636430225113, 10044, 0, 10044, 0, 0, 0
4913, 2, 1636430215833, 1636430225833, 10000, 0, 10000, 0, 0, 0
4914, 2, 1636430216332, 1636430226333, 10001, 0, 10001, 0, 0, 0
4936, 1, 1636430225921, 1636430226368, 447, 0, 447, 0, 0, 0
4915, 2, 1636430217085, 1636430227085, 10000, 0, 10000, 0, 0, 0
4916, 2, 1636430217636, 1636430227641, 10005, 0, 10005, 0, 0, 0
4918, 2, 1636430217901, 1636430227901, 10000, 0, 10000, 0, 0, 0
4940, 1, 1636430227869, 1636430228329, 460, 0, 460, 0, 0, 0
4919, 2, 1636430219212, 1636430229216, 10004, 0, 10004, 0, 0, 0
4921, 2, 1636430219853, 1636430229853, 10000, 0, 10000, 0, 0, 0
4944, 1, 1636430229805, 1636430230261, 456, 0, 456, 0, 0, 0
4922, 2, 1636430221025, 1636430231025, 10000, 0, 10000, 0, 0, 0
4923, 2, 1636430221376, 1636430231380, 10004, 0, 10004, 0, 0, 0
4925, 2, 1636430221961, 1636430231961, 10000, 0, 10000, 0, 0, 0
4926, 2, 1636430222065, 1636430232065, 10000, 0, 10000, 0, 0, 0
4948, 1, 1636430231736, 1636430232189, 453, 0, 453, 0, 0, 0
4927, 2, 1636430222893, 1636430232893, 10000, 0, 10000, 0, 0, 0
4928, 2, 1636430223265, 1636430233265, 10000, 0, 10000, 0, 0, 0
4930, 2, 1636430224000, 1636430234001, 10001, 0, 10001, 0, 0, 0
4953, 1, 1636430233873, 1636430234333, 460, 0, 460, 0, 0, 0
4931, 2, 1636430224469, 1636430234473, 10004, 0, 10004, 0, 0, 0
4932, 2, 1636430224688, 1636430234689, 10001, 0, 10001, 0, 0, 0
4933, 1, 1636430225064, 1636430235137, 10073, 9625, 448, 1, 9624, 9625
4934, 2, 1636430225380, 1636430235381, 10001, 0, 10001, 0, 0, 0
4935, 2, 1636430225380, 1636430235429, 10049, 0, 10049, 0, 0, 0
4937, 2, 1636430226145, 1636430236145, 10000, 0, 10000, 0, 0, 0
4960, 1, 1636430235849, 1636430236301, 452, 0, 452, 0, 0, 0
4938, 2, 1636430226637, 1636430236637, 10000, 0, 10000, 0, 0, 0
4939, 2, 1636430227397, 1636430237397, 10000, 0, 10000, 0, 0, 0
4941, 2, 1636430227948, 1636430237949, 10001, 0, 10001, 0, 0, 0
4942, 2, 1636430228212, 1636430238212, 10000, 0, 10000, 1, 0, 1
4964, 1, 1636430237997, 1636430238449, 452, 0, 452, 0, 0, 0
4943, 2, 1636430229517, 1636430239517, 10000, 0, 10000, 0, 0, 0
4945, 2, 1636430230161, 1636430240164, 10003, 0, 10003, 0, 0, 0
4968, 1, 1636430239849, 1636430240305, 456, 0, 456, 0, 0, 0
4946, 2, 1636430231336, 1636430241337, 10001, 0, 10001, 0, 0, 0
4947, 2, 1636430231680, 1636430241685, 10005, 0, 10005, 0, 0, 0
4971, 1, 1636430241777, 1636430242233, 456, 0, 456, 0, 0, 0
4949, 2, 1636430232265, 1636430242269, 10004, 0, 10004, 0, 0, 0
4950, 2, 1636430232373, 1636430242369, 9996, 0, 9996, 0, 0, 0
4951, 2, 1636430233205, 1636430243205, 10000, 0, 10000, 0, 0, 0
4952, 2, 1636430233568, 1636430243573, 10005, 0, 10005, 0, 0, 0
4976, 1, 1636430243785, 1636430244241, 456, 0, 456, 0, 0, 0
4954, 2, 1636430234308, 1636430244308, 10000, 0, 10000, 0, 0, 0
4955, 2, 1636430234777, 1636430244781, 10004, 0, 10004, 0, 0, 0
4956, 2, 1636430234997, 1636430244997, 10000, 0, 10000, 0, 0, 0
4957, 1, 1636430235360, 1636430245449, 10089, 9637, 452, 0, 9636, 9636
4959, 2, 1636430235696, 1636430245697, 10001, 0, 10001, 0, 0, 0
4958, 2, 1636430235696, 1636430245740, 10044, 0, 10044, 0, 0, 0
4982, 1, 1636430245900, 1636430246349, 449, 0, 449, 0, 0, 0
4983, 1, 1636430246004, 1636430246452, 448, 0, 448, 0, 0, 0
4961, 2, 1636430236457, 1636430246456, 9999, 0, 9999, 0, 0, 0
4984, 1, 1636430246008, 1636430246904, 896, 445, 451, 445, 0, 445
4962, 2, 1636430236949, 1636430246948, 9999, 0, 9999, 0, 0, 0
4985, 1, 1636430246769, 1636430247365, 596, 136, 460, 136, 0, 136
4963, 2, 1636430237709, 1636430247709, 10000, 0, 10000, 0, 0, 0
4986, 1, 1636430247252, 1636430247816, 564, 113, 451, 113, 0, 113
4965, 2, 1636430238261, 1636430248261, 10000, 0, 10000, 0, 0, 0
4987, 1, 1636430247928, 1636430248377, 449, 1, 448, 0, 0, 0
4988, 1, 1636430247948, 1636430248397, 449, 0, 449, 0, 0, 0
4989, 1, 1636430248021, 1636430248485, 464, 0, 464, 0, 0, 0
4966, 2, 1636430238521, 1636430248521, 10000, 0, 10000, 0, 0, 0
4990, 1, 1636430247992, 1636430248861, 869, 405, 464, 405, 0, 405
4991, 1, 1636430248568, 1636430249017, 449, 0, 449, 0, 0, 0
4992, 1, 1636430248732, 1636430249317, 585, 130, 455, 129, 0, 129
4993, 1, 1636430248829, 1636430249473, 644, 189, 455, 188, 1, 189
4994, 1, 1636430249241, 1636430249769, 528, 76, 452, 76, 0, 76
4967, 2, 1636430239829, 1636430249829, 10000, 0, 10000, 0, 0, 0
4995, 1, 1636430249876, 1636430250325, 449, 1, 448, 0, 0, 0
4997, 1, 1636430249964, 1636430250412, 448, 1, 447, 1, 0, 1
4969, 2, 1636430240472, 1636430250473, 10001, 0, 10001, 1, 0, 1
4999, 1, 1636430250140, 1636430250593, 453, 0, 453, 0, 0, 0
5000, 1, 1636430250608, 1636430251061, 453, 1, 452, 0, 0, 0
5002, 1, 1636430250781, 1636430251233, 452, 0, 452, 0, 0, 0
5003, 1, 1636430250844, 1636430251517, 673, 218, 455, 217, 1, 218
4970, 2, 1636430241644, 1636430251645, 10001, 0, 10001, 0, 0, 0
4972, 2, 1636430241985, 1636430251985, 10000, 0, 10000, 0, 0, 0
5005, 1, 1636430251780, 1636430252229, 449, 1, 448, 0, 1, 1
5007, 1, 1636430251960, 1636430252412, 452, 1, 451, 0, 0, 0
4973, 2, 1636430242573, 1636430252573, 10000, 0, 10000, 0, 0, 0
5008, 1, 1636430252169, 1636430252620, 451, 0, 451, 0, 0, 0
4974, 2, 1636430242685, 1636430252681, 9996, 0, 9996, 0, 0, 0
5009, 1, 1636430252292, 1636430252905, 613, 121, 492, 120, 0, 120
5011, 1, 1636430252817, 1636430253269, 452, 0, 452, 0, 0, 0
5013, 1, 1636430252881, 1636430253357, 476, 24, 452, 24, 0, 24
4975, 2, 1636430243517, 1636430253517, 10000, 0, 10000, 0, 0, 0
5014, 1, 1636430252993, 1636430253837, 844, 364, 480, 364, 0, 364
4977, 2, 1636430243877, 1636430253876, 9999, 0, 9999, 0, 0, 0
5015, 1, 1636430253829, 1636430254288, 459, 8, 451, 8, 0, 8
5017, 1, 1636430253921, 1636430254368, 447, 0, 447, 0, 0, 0
5016, 1, 1636430253921, 1636430254376, 455, 0, 455, 0, 0, 0
4978, 2, 1636430244616, 1636430254616, 10000, 0, 10000, 0, 0, 0
5019, 1, 1636430254185, 1636430254744, 559, 104, 455, 104, 0, 104
5020, 1, 1636430254213, 1636430254837, 624, 163, 461, 163, 0, 163
4979, 2, 1636430245089, 1636430255089, 10000, 0, 10000, 0, 0, 0
4980, 2, 1636430245309, 1636430255309, 10000, 0, 10000, 0, 0, 0
5021, 1, 1636430254805, 1636430255316, 511, 33, 478, 32, 1, 33
5023, 1, 1636430254929, 1636430255405, 476, 0, 476, 0, 0, 0
4981, 1, 1636430245673, 1636430255760, 10087, 9636, 451, 0, 9636, 9636
5024, 1, 1636430254989, 1636430255769, 780, 328, 452, 328, 0, 328
5025, 1, 1636430255396, 1636430255857, 461, 10, 451, 9, 1, 10
5027, 1, 1636430255769, 1636430256213, 444, 0, 444, 0, 0, 0
5026, 1, 1636430255617, 1636430256305, 688, 240, 448, 240, 0, 240
5030, 1, 1636430255980, 1636430256425, 445, 1, 444, 0, 1, 1
5031, 1, 1636430256196, 1636430256669, 473, 17, 456, 17, 0, 17
5029, 1, 1636430255980, 1636430256761, 781, 325, 456, 325, 0, 325
5034, 1, 1636430256896, 1636430257344, 448, 0, 448, 0, 0, 0
5036, 1, 1636430257429, 1636430257881, 452, 0, 452, 0, 0, 0
5037, 1, 1636430257561, 1636430258337, 776, 320, 456, 320, 0, 320
5039, 1, 1636430257896, 1636430258348, 452, 1, 451, 0, 0, 0
5040, 1, 1636430258017, 1636430258797, 780, 320, 460, 320, 0, 320
4996, 2, 1636430249964, 1636430259965, 10001, 0, 10001, 0, 0, 0
4998, 2, 1636430249964, 1636430260008, 10044, 0, 10044, 0, 0, 0
5046, 1, 1636430260057, 1636430260513, 456, 0, 456, 0, 0, 0
5001, 2, 1636430250721, 1636430260721, 10000, 0, 10000, 0, 0, 0
5048, 1, 1636430260277, 1636430260733, 456, 0, 456, 0, 0, 0
5047, 1, 1636430260277, 1636430261189, 912, 456, 456, 456, 0, 456
5004, 2, 1636430251240, 1636430261237, 9997, 0, 9997, 0, 0, 0
5049, 1, 1636430261033, 1636430261649, 616, 157, 459, 157, 0, 157
5006, 2, 1636430251817, 1636430261817, 10000, 0, 10000, 0, 0, 0
5050, 1, 1636430261549, 1636430262133, 584, 101, 483, 100, 0, 100
5051, 1, 1636430262041, 1636430262488, 447, 0, 447, 0, 0, 0
5010, 2, 1636430252533, 1636430262533, 10000, 0, 10000, 0, 0, 0
5052, 1, 1636430262129, 1636430262577, 448, 4, 444, 4, 0, 4
5053, 1, 1636430262213, 1636430262665, 452, 0, 452, 0, 0, 0
5012, 2, 1636430252832, 1636430262833, 10001, 0, 10001, 0, 0, 0
5054, 1, 1636430262217, 1636430263148, 931, 449, 482, 448, 1, 449
5055, 1, 1636430262880, 1636430263328, 448, 0, 448, 0, 0, 0
5056, 1, 1636430263012, 1636430263601, 589, 137, 452, 137, 0, 137
5057, 1, 1636430263140, 1636430263781, 641, 189, 452, 189, 0, 189
5058, 1, 1636430263577, 1636430264057, 480, 25, 455, 24, 0, 24
5018, 2, 1636430254108, 1636430264109, 10001, 0, 10001, 0, 0, 0
5059, 1, 1636430263933, 1636430264428, 495, 0, 495, 0, 0, 0
5060, 1, 1636430264057, 1636430264520, 463, 1, 462, 0, 1, 1
5061, 1, 1636430264245, 1636430264697, 452, 0, 452, 0, 0, 0
5022, 2, 1636430254809, 1636430264809, 10000, 0, 10000, 0, 0, 0
5063, 1, 1636430264412, 1636430264860, 448, 1, 447, 0, 1, 1
5062, 1, 1636430264261, 1636430265149, 888, 437, 451, 436, 0, 436
5064, 1, 1636430264852, 1636430265305, 453, 1, 452, 0, 0, 0
5065, 1, 1636430265112, 1636430265565, 453, 1, 452, 0, 0, 0
5067, 1, 1636430265125, 1636430265605, 480, 24, 456, 24, 0, 24
5066, 1, 1636430265084, 1636430265757, 673, 221, 452, 221, 0, 221
5028, 2, 1636430255836, 1636430265841, 10005, 0, 10005, 0, 0, 0
5068, 1, 1636430265637, 1636430266093, 456, 0, 456, 0, 0, 0
5032, 2, 1636430256204, 1636430266209, 10005, 0, 10005, 0, 0, 0
5069, 1, 1636430265888, 1636430266336, 448, 1, 447, 1, 0, 1
5071, 1, 1636430266129, 1636430266609, 480, 0, 480, 0, 0, 0
5072, 1, 1636430266153, 1636430266609, 456, 0, 456, 0, 0, 0
5070, 1, 1636430266149, 1636430266612, 463, 0, 463, 0, 0, 0
5074, 1, 1636430266340, 1636430266781, 441, 0, 441, 0, 0, 0
5033, 2, 1636430256785, 1636430266785, 10000, 0, 10000, 0, 0, 0
5035, 2, 1636430256940, 1636430266941, 10001, 0, 10001, 0, 0, 0
5073, 1, 1636430266252, 1636430267101, 849, 358, 491, 358, 0, 358
5075, 1, 1636430266509, 1636430267101, 592, 104, 488, 103, 1, 104
5076, 1, 1636430266920, 1636430267373, 453, 1, 452, 0, 0, 0
5078, 1, 1636430267072, 1636430267521, 449, 0, 449, 0, 0, 0
5079, 1, 1636430267032, 1636430267553, 521, 69, 452, 69, 0, 69
5077, 1, 1636430267120, 1636430267573, 453, 1, 452, 0, 0, 0
5038, 2, 1636430257741, 1636430267741, 10000, 0, 10000, 0, 0, 0
5080, 1, 1636430267156, 1636430267824, 668, 218, 450, 218, 0, 218
5082, 1, 1636430267600, 1636430268060, 460, 1, 459, 0, 1, 1
5081, 1, 1636430267245, 1636430268061, 816, 328, 488, 328, 0, 328
5041, 2, 1636430258145, 1636430268144, 9999, 0, 9999, 0, 0, 0
5083, 1, 1636430267993, 1636430268468, 475, 0, 475, 0, 0, 0
5087, 1, 1636430268100, 1636430268549, 449, 0, 449, 0, 0, 0
5085, 1, 1636430268044, 1636430268552, 508, 17, 491, 16, 0, 16
5086, 1, 1636430268088, 1636430268552, 464, 0, 464, 0, 0, 0
5084, 1, 1636430268056, 1636430268556, 500, 6, 494, 5, 0, 5
5089, 1, 1636430268376, 1636430268821, 445, 1, 444, 0, 1, 1
5042, 2, 1636430258869, 1636430268868, 9999, 0, 9999, 0, 0, 0
5088, 1, 1636430268232, 1636430269000, 768, 317, 451, 317, 0, 317
5090, 1, 1636430268449, 1636430269013, 564, 108, 456, 108, 0, 108
5091, 1, 1636430268528, 1636430269013, 485, 25, 460, 25, 0, 25
5092, 1, 1636430268833, 1636430269276, 443, 0, 443, 0, 0, 0
5043, 2, 1636430259425, 1636430269426, 10001, 0, 10001, 0, 0, 0
5093, 1, 1636430268957, 1636430269449, 492, 44, 448, 44, 0, 44
5044, 2, 1636430259521, 1636430269517, 9996, 0, 9996, 0, 0, 0
5094, 1, 1636430269077, 1636430269520, 443, 0, 443, 0, 0, 0
5096, 1, 1636430269184, 1636430269652, 468, 0, 468, 0, 0, 0
5097, 1, 1636430269156, 1636430269652, 496, 0, 496, 0, 0, 0
5095, 1, 1636430269100, 1636430269744, 644, 177, 467, 176, 0, 176
5045, 1, 1636430260053, 1636430269965, 9912, 9464, 448, 0, 9464, 9464
5098, 1, 1636430269200, 1636430269968, 768, 321, 447, 321, 0, 321
5099, 1, 1636430269612, 1636430270073, 461, 0, 461, 0, 0, 0
5100, 1, 1636430269729, 1636430270177, 448, 0, 448, 0, 0, 0
5102, 1, 1636430269975, 1636430270424, 449, 0, 449, 0, 0, 0
5104, 1, 1636430270016, 1636430270464, 448, 1, 447, 0, 0, 0
5105, 1, 1636430270076, 1636430270525, 449, 0, 449, 0, 0, 0
5103, 1, 1636430270008, 1636430270525, 517, 65, 452, 65, 0, 65
5108, 1, 1636430270168, 1636430270624, 456, 1, 455, 0, 0, 0
5101, 1, 1636430269829, 1636430270624, 795, 348, 447, 348, 0, 348
5109, 1, 1636430270356, 1636430270809, 453, 1, 452, 0, 0, 0
5110, 1, 1636430270440, 1636430270885, 445, 0, 445, 0, 0, 0
5106, 1, 1636430270117, 1636430270973, 856, 408, 448, 408, 0, 408
5107, 1, 1636430270180, 1636430271060, 880, 445, 435, 445, 0, 445
5111, 1, 1636430270592, 1636430271064, 472, 33, 439, 33, 0, 33
5112, 1, 1636430270704, 1636430271152, 448, 1, 447, 0, 0, 0
5113, 1, 1636430270825, 1636430271421, 596, 148, 448, 148, 0, 148
5115, 1, 1636430271093, 1636430271544, 451, 0, 451, 0, 0, 0
5116, 1, 1636430271104, 1636430271556, 452, 1, 451, 0, 0, 0
5114, 1, 1636430271028, 1636430271588, 560, 125, 435, 124, 0, 124
5117, 1, 1636430271160, 1636430271597, 437, 0, 437, 0, 0, 0
5118, 1, 1636430271212, 1636430271992, 780, 333, 447, 333, 0, 333
5119, 1, 1636430271560, 1636430272012, 452, 1, 451, 1, 0, 1
5120, 1, 1636430271653, 1636430272105, 452, 0, 452, 0, 0, 0
5123, 1, 1636430272016, 1636430272469, 453, 0, 453, 0, 0, 0
5122, 1, 1636430271988, 1636430272469, 481, 25, 456, 25, 0, 25
5124, 1, 1636430272036, 1636430272485, 449, 0, 449, 0, 0, 0
5126, 1, 1636430272096, 1636430272540, 444, 0, 444, 0, 0, 0
5121, 1, 1636430271789, 1636430272552, 763, 316, 447, 316, 0, 316
5127, 1, 1636430272128, 1636430272581, 453, 1, 452, 1, 0, 1
5129, 1, 1636430272225, 1636430272673, 448, 0, 448, 0, 0, 0
5125, 1, 1636430272084, 1636430272933, 849, 385, 464, 385, 0, 385
5130, 1, 1636430272485, 1636430272984, 499, 56, 443, 56, 0, 56
5128, 1, 1636430272136, 1636430273009, 873, 417, 456, 416, 0, 416
5131, 1, 1636430272512, 1636430273041, 529, 69, 460, 69, 0, 69
5132, 1, 1636430272588, 1636430273045, 457, 0, 457, 0, 0, 0
5133, 1, 1636430272753, 1636430273388, 635, 180, 455, 180, 0, 180
5135, 1, 1636430273045, 1636430273496, 451, 0, 451, 0, 0, 0
5134, 1, 1636430272925, 1636430273500, 575, 120, 455, 120, 0, 120
5136, 1, 1636430273072, 1636430273516, 444, 1, 443, 0, 1, 1
5138, 1, 1636430273233, 1636430273685, 452, 0, 452, 0, 0, 0
5139, 1, 1636430273476, 1636430273928, 452, 0, 452, 0, 0, 0
5137, 1, 1636430273200, 1636430273968, 768, 317, 451, 316, 1, 317
5140, 1, 1636430273776, 1636430274225, 449, 0, 449, 0, 0, 0
5143, 1, 1636430273916, 1636430274364, 448, 1, 447, 1, 0, 1
5142, 1, 1636430273912, 1636430274381, 469, 17, 452, 17, 0, 17
5144, 1, 1636430274016, 1636430274472, 456, 1, 455, 0, 0, 0
5145, 1, 1636430274076, 1636430274513, 437, 1, 436, 0, 0, 0
5146, 1, 1636430274080, 1636430274532, 452, 0, 452, 0, 0, 0
5147, 1, 1636430274116, 1636430274557, 441, 0, 441, 0, 0, 0
5148, 1, 1636430274156, 1636430274916, 760, 316, 444, 315, 0, 315
5152, 1, 1636430274516, 1636430274961, 445, 0, 445, 0, 0, 0
5150, 1, 1636430274424, 1636430274961, 537, 89, 448, 88, 0, 88
5151, 1, 1636430274480, 1636430274981, 501, 53, 448, 53, 0, 53
5153, 1, 1636430274861, 1636430275364, 503, 56, 447, 56, 0, 56
5155, 1, 1636430274936, 1636430275385, 449, 1, 448, 0, 0, 0
5154, 1, 1636430274929, 1636430275417, 488, 32, 456, 32, 0, 32
5156, 1, 1636430274940, 1636430275437, 497, 41, 456, 41, 0, 41
5158, 1, 1636430275200, 1636430275652, 452, 0, 452, 0, 0, 0
5157, 1, 1636430275200, 1636430275889, 689, 237, 452, 237, 0, 237
5159, 1, 1636430275480, 1636430275925, 445, 0, 445, 0, 0, 0
5160, 1, 1636430275756, 1636430276209, 453, 0, 453, 0, 0, 0
5161, 1, 1636430275945, 1636430276393, 448, 0, 448, 0, 0, 0
5162, 1, 1636430276005, 1636430276448, 443, 0, 443, 0, 0, 0
5163, 1, 1636430276008, 1636430276456, 448, 0, 448, 0, 0, 0
5164, 1, 1636430276052, 1636430276492, 440, 0, 440, 0, 0, 0
5165, 1, 1636430276064, 1636430276505, 441, 1, 440, 1, 0, 1
5169, 1, 1636430276464, 1636430276940, 476, 29, 447, 28, 1, 29
5170, 1, 1636430276516, 1636430276964, 448, 1, 447, 0, 0, 0
5171, 1, 1636430276857, 1636430277321, 464, 0, 464, 0, 0, 0
5172, 1, 1636430276921, 1636430277385, 464, 20, 444, 20, 0, 20
5173, 1, 1636430276981, 1636430277429, 448, 0, 448, 0, 0, 0
5175, 1, 1636430277133, 1636430277841, 708, 253, 455, 252, 0, 252
5179, 1, 1636430277837, 1636430278300, 463, 4, 459, 4, 0, 4
5180, 1, 1636430278000, 1636430278452, 452, 1, 451, 0, 0, 0
5182, 1, 1636430278057, 1636430278509, 452, 0, 452, 0, 0, 0
5183, 1, 1636430278069, 1636430278517, 448, 0, 448, 0, 0, 0
5184, 1, 1636430278385, 1636430278901, 516, 68, 448, 68, 0, 68
5186, 1, 1636430278813, 1636430279353, 540, 89, 451, 88, 1, 89
5187, 1, 1636430278901, 1636430279353, 452, 0, 452, 0, 0, 0
5189, 1, 1636430279133, 1636430279809, 676, 221, 455, 221, 0, 221
5190, 1, 1636430279725, 1636430280257, 532, 85, 447, 85, 0, 85
5192, 1, 1636430280109, 1636430280565, 456, 0, 456, 0, 0, 0
5193, 1, 1636430280120, 1636430280573, 453, 1, 452, 0, 0, 0
5194, 1, 1636430280489, 1636430281029, 540, 84, 456, 84, 0, 84
5195, 1, 1636430280913, 1636430281485, 572, 117, 455, 116, 1, 117
5197, 1, 1636430281233, 1636430281937, 704, 253, 451, 253, 0, 253
5198, 1, 1636430281789, 1636430282388, 599, 149, 450, 148, 1, 149
5199, 1, 1636430282017, 1636430282468, 451, 0, 451, 0, 0, 0
5141, 2, 1636430273820, 1636430283821, 10001, 0, 10001, 405, 0, 405
5149, 2, 1636430274225, 1636430284225, 10000, 0, 10000, 0, 0, 0
5205, 1, 1636430284053, 1636430284537, 484, 0, 484, 0, 0, 0
5166, 2, 1636430276088, 1636430286089, 10001, 0, 10001, 304, 0, 304
5167, 2, 1636430276248, 1636430286249, 10001, 0, 10001, 144, 0, 144
5168, 2, 1636430276352, 1636430286357, 10005, 0, 10005, 40, 0, 40
5208, 1, 1636430286133, 1636430286589, 456, 0, 456, 0, 0, 0
5174, 2, 1636430276988, 1636430286985, 9997, 0, 9997, 0, 0, 0
5176, 2, 1636430277145, 1636430287145, 10000, 0, 10000, 0, 0, 0
5209, 1, 1636430286705, 1636430287156, 451, 0, 451, 0, 0, 0
5177, 2, 1636430277493, 1636430287493, 10000, 0, 10000, 0, 0, 0
5178, 2, 1636430277705, 1636430287705, 10000, 0, 10000, 0, 0, 0
5213, 1, 1636430287457, 1636430287929, 472, 0, 472, 0, 0, 0
5181, 2, 1636430278017, 1636430288016, 9999, 0, 9999, 0, 0, 0
5215, 1, 1636430288064, 1636430288508, 444, 0, 444, 0, 0, 0
5185, 2, 1636430278588, 1636430288589, 10001, 0, 10001, 0, 0, 0
5216, 1, 1636430288152, 1636430288600, 448, 1, 447, 0, 1, 1
5188, 2, 1636430279057, 1636430289052, 9995, 0, 9995, 0, 0, 0
5218, 1, 1636430288632, 1636430289077, 445, 0, 445, 0, 0, 0
5220, 1, 1636430289249, 1636430289701, 452, 0, 452, 0, 0, 0
5191, 2, 1636430280088, 1636430290089, 10001, 0, 10001, 0, 0, 0
5222, 1, 1636430289817, 1636430290312, 495, 0, 495, 0, 0, 0
5223, 1, 1636430290236, 1636430290692, 456, 0, 456, 0, 0, 0
5196, 2, 1636430280925, 1636430290925, 10000, 0, 10000, 0, 0, 0
5225, 1, 1636430290685, 1636430291148, 463, 0, 463, 0, 0, 0
5227, 1, 1636430291272, 1636430291725, 453, 0, 453, 0, 0, 0
5200, 2, 1636430282144, 1636430292145, 10001, 0, 10001, 0, 0, 0
5228, 1, 1636430291893, 1636430292368, 475, 0, 475, 0, 0, 0
5201, 2, 1636430282608, 1636430292610, 10002, 0, 10002, 0, 0, 0
5229, 1, 1636430292192, 1636430292640, 448, 0, 448, 0, 0, 0
5202, 2, 1636430282977, 1636430292977, 10000, 0, 10000, 0, 0, 0
5203, 2, 1636430283249, 1636430293248, 9999, 0, 9999, 0, 0, 0
5204, 1, 1636430283869, 1636430293696, 9827, 9379, 448, 0, 9379, 9379
5207, 2, 1636430284537, 1636430294536, 9999, 0, 9999, 0, 0, 0
5206, 2, 1636430284537, 1636430294581, 10044, 9999, 45, 0, 10000, 10000
5238, 1, 1636430294173, 1636430294621, 448, 0, 448, 0, 0, 0
5239, 1, 1636430294844, 1636430295297, 453, 1, 452, 0, 0, 0
5240, 1, 1636430294849, 1636430295753, 904, 449, 455, 448, 0, 448
5210, 2, 1636430286709, 1636430296709, 10000, 0, 10000, 0, 0, 0
5211, 2, 1636430286709, 1636430296752, 10043, 0, 10043, 0, 0, 0
5241, 1, 1636430296305, 1636430296760, 455, 0, 455, 0, 0, 0
5242, 1, 1636430296653, 1636430297156, 503, 0, 503, 0, 0, 0
5212, 2, 1636430287324, 1636430297325, 10001, 0, 10001, 0, 0, 0
5243, 1, 1636430296796, 1636430297641, 845, 361, 484, 360, 1, 361
5214, 2, 1636430287809, 1636430297809, 10000, 0, 10000, 0, 0, 0
5217, 2, 1636430288324, 1636430298328, 10004, 0, 10004, 0, 0, 0
5219, 2, 1636430288900, 1636430298904, 10004, 0, 10004, 0, 0, 0
5250, 1, 1636430298596, 1636430299044, 448, 0, 448, 0, 0, 0
5221, 2, 1636430289369, 1636430299369, 10000, 0, 10000, 0, 0, 0
5251, 1, 1636430298744, 1636430299497, 753, 301, 452, 300, 0, 300
5224, 2, 1636430290384, 1636430300389, 10005, 0, 10005, 0, 0, 0
5254, 1, 1636430300636, 1636430301093, 457, 1, 456, 0, 0, 0
5226, 2, 1636430291228, 1636430301229, 10001, 0, 10001, 1, 0, 1
5256, 1, 1636430300753, 1636430301545, 792, 341, 451, 340, 0, 340
5230, 2, 1636430292453, 1636430302453, 10000, 0, 10000, 0, 0, 0
5231, 2, 1636430292656, 1636430302657, 10001, 0, 10001, 0, 0, 0
5232, 2, 1636430292913, 1636430302912, 9999, 0, 9999, 0, 0, 0
5258, 1, 1636430302744, 1636430303225, 481, 0, 481, 0, 0, 0
5233, 2, 1636430293233, 1636430303228, 9995, 0, 9995, 0, 0, 0
5234, 2, 1636430293292, 1636430303296, 10004, 0, 10004, 0, 0, 0
5261, 1, 1636430302957, 1636430303448, 491, 0, 491, 0, 0, 0
5235, 2, 1636430293557, 1636430303556, 9999, 0, 9999, 0, 0, 0
5260, 1, 1636430302828, 1636430303704, 876, 397, 479, 397, 0, 397
5236, 2, 1636430293785, 1636430303785, 10000, 0, 10000, 0, 0, 0
5237, 2, 1636430293917, 1636430303917, 10000, 0, 10000, 0, 0, 0
5263, 1, 1636430303600, 1636430304141, 541, 0, 541, 0, 0, 0
5248, 1, 1636430298416, 1636430304365, 5949, 5501, 448, 0, 5501, 5501
5266, 1, 1636430304097, 1636430304597, 500, 44, 456, 44, 0, 44
5268, 1, 1636430304584, 1636430305037, 453, 1, 452, 0, 0, 0
5269, 1, 1636430304657, 1636430305105, 448, 0, 448, 0, 0, 0
5270, 1, 1636430304797, 1636430305561, 764, 308, 456, 308, 0, 308
5274, 1, 1636430306416, 1636430306873, 457, 1, 456, 1, 0, 1
5244, 2, 1636430297024, 1636430307021, 9997, 0, 9997, 1, 0, 1
5245, 2, 1636430297024, 1636430307064, 10040, 0, 10040, 0, 0, 0
5246, 2, 1636430297633, 1636430307633, 10000, 0, 10000, 0, 0, 0
5247, 2, 1636430298117, 1636430308117, 10000, 0, 10000, 0, 0, 0
5249, 2, 1636430298632, 1636430308632, 10000, 0, 10000, 0, 0, 0
5280, 1, 1636430308352, 1636430308805, 453, 0, 453, 0, 0, 0
5252, 2, 1636430299205, 1636430309209, 10004, 0, 10004, 0, 0, 0
5253, 2, 1636430299681, 1636430309681, 10000, 0, 10000, 0, 0, 0
5255, 2, 1636430300697, 1636430310697, 10000, 0, 10000, 0, 0, 0
5285, 1, 1636430310289, 1636430310740, 451, 0, 451, 0, 0, 0
5257, 2, 1636430301525, 1636430311529, 10004, 0, 10004, 0, 0, 0
5288, 1, 1636430312293, 1636430312749, 456, 0, 456, 0, 0, 0
5259, 2, 1636430302760, 1636430312769, 10009, 0, 10009, 0, 0, 0
5262, 2, 1636430303221, 1636430313221, 10000, 0, 10000, 0, 0, 0
5264, 2, 1636430303600, 1636430313605, 10005, 0, 10005, 0, 0, 0
5265, 2, 1636430303876, 1636430313877, 10001, 0, 10001, 0, 0, 0
5267, 2, 1636430304228, 1636430314229, 10001, 0, 10001, 1, 0, 1
5293, 1, 1636430314364, 1636430314817, 453, 0, 453, 0, 0, 0
5271, 2, 1636430304877, 1636430314877, 10000, 0, 10000, 0, 0, 0
5272, 2, 1636430305489, 1636430315489, 10000, 0, 10000, 0, 0, 0
5273, 2, 1636430306049, 1636430316049, 10000, 0, 10000, 0, 0, 0
5275, 2, 1636430306673, 1636430316680, 10007, 0, 10007, 0, 0, 0
5298, 1, 1636430316353, 1636430316813, 460, 0, 460, 0, 0, 0
5276, 1, 1636430306869, 1636430317133, 10264, 9811, 453, 0, 9811, 9811
5278, 2, 1636430307333, 1636430317333, 10000, 0, 10000, 0, 0, 0
5277, 2, 1636430307333, 1636430317380, 10047, 0, 10047, 0, 0, 0
5279, 2, 1636430307945, 1636430317944, 9999, 0, 9999, 0, 0, 0
5281, 2, 1636430308429, 1636430318429, 10000, 0, 10000, 0, 0, 0
5304, 1, 1636430318289, 1636430318745, 456, 0, 456, 0, 0, 0
5282, 2, 1636430308941, 1636430318941, 10000, 0, 10000, 0, 0, 0
5283, 2, 1636430309517, 1636430319517, 10000, 0, 10000, 0, 0, 0
5284, 2, 1636430309989, 1636430319989, 10000, 0, 10000, 0, 0, 0
5308, 1, 1636430320241, 1636430320701, 460, 0, 460, 0, 0, 0
5286, 2, 1636430311009, 1636430321009, 10000, 0, 10000, 0, 0, 0
5287, 2, 1636430311837, 1636430321837, 10000, 0, 10000, 0, 0, 0
5312, 1, 1636430322185, 1636430322641, 456, 0, 456, 0, 0, 0
5289, 2, 1636430313073, 1636430323073, 10000, 0, 10000, 0, 0, 0
5290, 2, 1636430313529, 1636430323529, 10000, 0, 10000, 0, 0, 0
5291, 2, 1636430313924, 1636430323924, 10000, 0, 10000, 0, 0, 0
5292, 2, 1636430314176, 1636430324180, 10004, 0, 10004, 0, 0, 0
5294, 2, 1636430314541, 1636430324541, 10000, 0, 10000, 0, 0, 0
5315, 1, 1636430324105, 1636430324593, 488, 0, 488, 0, 0, 0
5295, 2, 1636430315185, 1636430325185, 10000, 0, 10000, 0, 0, 0
5296, 2, 1636430315797, 1636430325800, 10003, 0, 10003, 0, 0, 0
5297, 2, 1636430316361, 1636430326361, 10000, 0, 10000, 0, 0, 0
5321, 1, 1636430326152, 1636430326605, 453, 0, 453, 0, 0, 0
5299, 2, 1636430316985, 1636430326985, 10000, 0, 10000, 0, 0, 0
5300, 1, 1636430317424, 1636430327441, 10017, 9561, 456, 0, 9561, 9561
5302, 2, 1636430317648, 1636430327649, 10001, 0, 10001, 1, 0, 1
5301, 2, 1636430317648, 1636430327696, 10048, 0, 10048, 1, 0, 1
5303, 2, 1636430318257, 1636430328257, 10000, 0, 10000, 0, 0, 0
5327, 1, 1636430328017, 1636430328477, 460, 0, 460, 0, 0, 0
5305, 2, 1636430318736, 1636430328736, 10000, 0, 10000, 0, 0, 0
5306, 2, 1636430319253, 1636430329253, 10000, 0, 10000, 0, 0, 0
5307, 2, 1636430319833, 1636430329833, 10000, 0, 10000, 0, 0, 0
5309, 2, 1636430320297, 1636430330297, 10000, 0, 10000, 0, 0, 0
5332, 1, 1636430330125, 1636430330617, 492, 0, 492, 0, 0, 0
5310, 2, 1636430321317, 1636430331317, 10000, 0, 10000, 0, 0, 0
5311, 2, 1636430322149, 1636430332149, 10000, 0, 10000, 0, 0, 0
5335, 1, 1636430332125, 1636430332569, 444, 0, 444, 0, 0, 0
5313, 2, 1636430323385, 1636430333385, 10000, 0, 10000, 0, 0, 0
5314, 2, 1636430323832, 1636430333836, 10004, 0, 10004, 0, 0, 0
5316, 2, 1636430324228, 1636430334229, 10001, 0, 10001, 0, 0, 0
5317, 2, 1636430324481, 1636430334476, 9995, 0, 9995, 0, 0, 0
5338, 1, 1636430334057, 1636430334544, 487, 0, 487, 0, 0, 0
5318, 2, 1636430324853, 1636430334853, 10000, 0, 10000, 0, 0, 0
5319, 2, 1636430325493, 1636430335493, 10000, 0, 10000, 0, 0, 0
5320, 2, 1636430326108, 1636430336109, 10001, 0, 10001, 0, 0, 0
5344, 1, 1636430335965, 1636430336429, 464, 0, 464, 0, 0, 0
5322, 2, 1636430326673, 1636430336673, 10000, 0, 10000, 0, 0, 0
5323, 2, 1636430327297, 1636430337297, 10000, 0, 10000, 0, 0, 0
5324, 1, 1636430327740, 1636430337749, 10009, 9557, 452, 0, 9557, 9557
5326, 2, 1636430327964, 1636430337965, 10001, 0, 10001, 0, 0, 0
5325, 2, 1636430327964, 1636430338012, 10048, 0, 10048, 0, 0, 0
5349, 1, 1636430338060, 1636430338520, 460, 0, 460, 0, 0, 0
5328, 2, 1636430328569, 1636430338569, 10000, 0, 10000, 0, 0, 0
5329, 2, 1636430329041, 1636430339041, 10000, 0, 10000, 0, 0, 0
5330, 2, 1636430329564, 1636430339565, 10001, 0, 10001, 1, 0, 1
5331, 2, 1636430330149, 1636430340149, 10000, 0, 10000, 0, 0, 0
5355, 1, 1636430339973, 1636430340464, 491, 0, 491, 0, 0, 0
5333, 2, 1636430330609, 1636430340600, 9991, 0, 9991, 0, 0, 0
5334, 2, 1636430331625, 1636430341625, 10000, 0, 10000, 0, 0, 0
5358, 1, 1636430341877, 1636430342333, 456, 0, 456, 0, 0, 0
5336, 2, 1636430332452, 1636430342457, 10005, 0, 10005, 0, 0, 0
5337, 2, 1636430333697, 1636430343697, 10000, 0, 10000, 0, 0, 0
5339, 2, 1636430334141, 1636430344141, 10000, 0, 10000, 0, 0, 0
5361, 1, 1636430343933, 1636430344389, 456, 0, 456, 0, 0, 0
5340, 2, 1636430334565, 1636430344569, 10004, 0, 10004, 0, 0, 0
5341, 2, 1636430334792, 1636430344792, 10000, 0, 10000, 1, 0, 1
5342, 2, 1636430335165, 1636430345165, 10000, 0, 10000, 0, 0, 0
5343, 2, 1636430335805, 1636430345805, 10000, 0, 10000, 0, 0, 0
5345, 2, 1636430336417, 1636430346417, 10000, 0, 10000, 0, 0, 0
5367, 1, 1636430345977, 1636430346432, 455, 0, 455, 0, 0, 0
5346, 2, 1636430336984, 1636430346985, 10001, 0, 10001, 0, 0, 0
5347, 2, 1636430337605, 1636430347605, 10000, 0, 10000, 0, 0, 0
5348, 1, 1636430338056, 1636430348060, 10004, 9549, 455, 0, 9549, 9549
5351, 2, 1636430338280, 1636430348281, 10001, 0, 10001, 0, 0, 0
5350, 2, 1636430338280, 1636430348324, 10044, 0, 10044, 0, 0, 0
5372, 1, 1636430348060, 1636430348552, 492, 0, 492, 0, 0, 0
5352, 2, 1636430338881, 1636430348881, 10000, 0, 10000, 0, 0, 0
5353, 2, 1636430339345, 1636430349341, 9996, 0, 9996, 0, 0, 0
5354, 2, 1636430339873, 1636430349873, 10000, 0, 10000, 0, 0, 0
5378, 1, 1636430349965, 1636430350421, 456, 0, 456, 0, 0, 0
5356, 2, 1636430340456, 1636430350461, 10005, 0, 10005, 0, 0, 0
5357, 2, 1636430340921, 1636430350921, 10000, 0, 10000, 0, 0, 0
5359, 2, 1636430341936, 1636430351936, 10000, 0, 10000, 1, 0, 1
5382, 1, 1636430351916, 1636430352372, 456, 0, 456, 0, 0, 0
5360, 2, 1636430342765, 1636430352765, 10000, 0, 10000, 0, 0, 0
5362, 2, 1636430344009, 1636430354009, 10000, 0, 10000, 0, 0, 0
5363, 2, 1636430344448, 1636430354449, 10001, 0, 10001, 0, 0, 0
5364, 2, 1636430344881, 1636430354885, 10004, 0, 10004, 0, 0, 0
5365, 2, 1636430345096, 1636430355097, 10001, 0, 10001, 0, 0, 0
5366, 2, 1636430345477, 1636430355477, 10000, 0, 10000, 0, 0, 0
5368, 2, 1636430346113, 1636430356113, 10000, 0, 10000, 0, 0, 0
5369, 2, 1636430346729, 1636430356729, 10000, 0, 10000, 0, 0, 0
5370, 2, 1636430347289, 1636430357289, 10000, 0, 10000, 0, 0, 0
5371, 2, 1636430347912, 1636430357916, 10004, 0, 10004, 0, 0, 0
5373, 2, 1636430348277, 1636430358281, 10004, 0, 10004, 0, 0, 0
5375, 2, 1636430348592, 1636430358588, 9996, 0, 9996, 1, 0, 1
5374, 2, 1636430348592, 1636430358632, 10040, 0, 10040, 1, 0, 1
5385, 1, 1636430353829, 1636430358728, 4899, 4452, 447, 0, 4452, 4452
5376, 2, 1636430349193, 1636430359193, 10000, 0, 10000, 0, 0, 0
5398, 1, 1636430358944, 1636430359421, 477, 0, 477, 0, 0, 0
5377, 2, 1636430349652, 1636430359653, 10001, 0, 10001, 0, 0, 0
5379, 2, 1636430350185, 1636430360184, 9999, 0, 9999, 0, 0, 0
5380, 2, 1636430350765, 1636430360765, 10000, 0, 10000, 0, 0, 0
5381, 2, 1636430351229, 1636430361229, 10000, 0, 10000, 0, 0, 0
5402, 1, 1636430360949, 1636430361400, 451, 0, 451, 0, 0, 0
5383, 2, 1636430352253, 1636430362253, 10000, 0, 10000, 0, 0, 0
5384, 2, 1636430353077, 1636430363077, 10000, 0, 10000, 0, 0, 0
5406, 1, 1636430363013, 1636430363489, 476, 0, 476, 0, 0, 0
5386, 2, 1636430354321, 1636430364321, 10000, 0, 10000, 0, 0, 0
5387, 2, 1636430354753, 1636430364753, 10000, 0, 10000, 0, 0, 0
5388, 2, 1636430355185, 1636430365188, 10003, 0, 10003, 0, 0, 0
5409, 1, 1636430364904, 1636430365356, 452, 1, 451, 0, 0, 0
5389, 2, 1636430355405, 1636430365404, 9999, 0, 9999, 0, 0, 0
5390, 2, 1636430355789, 1636430365788, 9999, 0, 9999, 0, 0, 0
5391, 2, 1636430356421, 1636430366421, 10000, 0, 10000, 0, 0, 0
5392, 2, 1636430357041, 1636430367041, 10000, 0, 10000, 0, 0, 0
5415, 1, 1636430366772, 1636430367269, 497, 0, 497, 0, 0, 0
5393, 2, 1636430357601, 1636430367601, 10000, 0, 10000, 0, 0, 0
5394, 2, 1636430358221, 1636430368221, 10000, 0, 10000, 0, 0, 0
5395, 1, 1636430358584, 1636430368677, 10093, 9637, 456, 1, 9636, 9637
5397, 2, 1636430358900, 1636430368901, 10001, 0, 10001, 0, 0, 0
5396, 2, 1636430358900, 1636430368944, 10044, 0, 10044, 0, 0, 0
5419, 1, 1636430368681, 1636430369168, 487, 0, 487, 0, 0, 0
5399, 2, 1636430359505, 1636430369505, 10000, 0, 10000, 0, 0, 0
5400, 2, 1636430359960, 1636430369961, 10001, 0, 10001, 0, 0, 0
5401, 2, 1636430360492, 1636430370497, 10005, 0, 10005, 0, 0, 0
5403, 2, 1636430361077, 1636430371077, 10000, 0, 10000, 0, 0, 0
5426, 1, 1636430370777, 1636430371229, 452, 0, 452, 0, 0, 0
5404, 2, 1636430361536, 1636430371537, 10001, 0, 10001, 0, 0, 0
5405, 2, 1636430362561, 1636430372565, 10004, 0, 10004, 0, 0, 0
5429, 1, 1636430372753, 1636430373209, 456, 0, 456, 0, 0, 0
5407, 2, 1636430363385, 1636430373385, 10000, 0, 10000, 0, 0, 0
5408, 2, 1636430364633, 1636430374633, 10000, 0, 10000, 0, 0, 0
5410, 2, 1636430365056, 1636430375057, 10001, 0, 10001, 0, 0, 0
5411, 2, 1636430365492, 1636430375497, 10005, 0, 10005, 0, 0, 0
5412, 2, 1636430365716, 1636430375713, 9997, 0, 9997, 0, 0, 0
5413, 2, 1636430366100, 1636430376100, 10000, 0, 10000, 0, 0, 0
5414, 2, 1636430366728, 1636430376729, 10001, 0, 10001, 0, 0, 0
5416, 2, 1636430367353, 1636430377353, 10000, 0, 10000, 0, 0, 0
5417, 2, 1636430367913, 1636430377913, 10000, 0, 10000, 0, 0, 0
5418, 2, 1636430368533, 1636430378533, 10000, 0, 10000, 0, 0, 0
5420, 1, 1636430368988, 1636430378985, 9997, 9545, 452, 0, 9545, 9545
5421, 2, 1636430369212, 1636430379213, 10001, 0, 10001, 0, 0, 0
5422, 2, 1636430369212, 1636430379256, 10044, 0, 10044, 0, 0, 0
5423, 2, 1636430369816, 1636430379817, 10001, 0, 10001, 0, 0, 0
5424, 2, 1636430370265, 1636430380264, 9999, 0, 9999, 0, 0, 0
5425, 2, 1636430370809, 1636430380809, 10000, 0, 10000, 0, 0, 0
5427, 2, 1636430371389, 1636430381389, 10000, 0, 10000, 0, 0, 0
5428, 2, 1636430371844, 1636430381845, 10001, 0, 10001, 0, 0, 0
5430, 2, 1636430372869, 1636430382869, 10000, 0, 10000, 0, 0, 0
5431, 2, 1636430373697, 1636430383697, 10000, 0, 10000, 0, 0, 0
5432, 2, 1636430374944, 1636430384945, 10001, 0, 10001, 0, 0, 0
5433, 2, 1636430375361, 1636430385361, 10000, 0, 10000, 0, 0, 0
5434, 2, 1636430375805, 1636430385805, 10000, 0, 10000, 0, 0, 0
5435, 2, 1636430376020, 1636430386021, 10001, 0, 10001, 0, 0, 0
5436, 2, 1636430376409, 1636430386409, 10000, 0, 10000, 0, 0, 0
5437, 2, 1636430377029, 1636430387033, 10004, 0, 10004, 0, 0, 0
5438, 2, 1636430377661, 1636430387661, 10000, 0, 10000, 0, 0, 0
5439, 2, 1636430378221, 1636430388221, 10000, 0, 10000, 0, 0, 0
5440, 2, 1636430378845, 1636430388845, 10000, 0, 10000, 0, 0, 0
5441, 1, 1636430379201, 1636430389301, 10100, 9644, 456, 0, 9644, 9644
5442, 2, 1636430379524, 1636430389525, 10001, 0, 10001, 0, 0, 0
5443, 2, 1636430379524, 1636430389568, 10044, 0, 10044, 0, 0, 0
5444, 2, 1636430380128, 1636430390129, 10001, 0, 10001, 0, 0, 0
5462, 1, 1636430389836, 1636430390289, 453, 0, 453, 0, 0, 0
5445, 2, 1636430380576, 1636430390577, 10001, 0, 10001, 0, 0, 0
5461, 1, 1636430389836, 1636430390745, 909, 454, 455, 453, 0, 453
5446, 2, 1636430381121, 1636430391121, 10000, 0, 10000, 0, 0, 0
5463, 1, 1636430390437, 1636430391196, 759, 308, 451, 308, 0, 308
5464, 1, 1636430390885, 1636430391649, 764, 312, 452, 312, 0, 312
5447, 2, 1636430381700, 1636430391701, 10001, 0, 10001, 0, 0, 0
5465, 1, 1636430391433, 1636430392109, 676, 217, 459, 216, 0, 216
5448, 2, 1636430382144, 1636430392144, 10000, 0, 10000, 0, 0, 0
5466, 1, 1636430391748, 1636430392196, 448, 0, 448, 0, 0, 0
5468, 1, 1636430392009, 1636430392561, 552, 101, 451, 100, 1, 101
5467, 1, 1636430391836, 1636430392645, 809, 361, 448, 361, 0, 361
5469, 1, 1636430392449, 1636430393013, 564, 112, 452, 112, 0, 112
5470, 1, 1636430392437, 1636430393097, 660, 208, 452, 208, 0, 208
5449, 2, 1636430383177, 1636430393177, 10000, 0, 10000, 0, 0, 0
5471, 1, 1636430392877, 1636430393589, 712, 220, 492, 220, 0, 220
5473, 1, 1636430393485, 1636430393941, 456, 0, 456, 0, 0, 0
5450, 2, 1636430384005, 1636430394005, 10000, 0, 10000, 0, 0, 0
5472, 1, 1636430393364, 1636430394044, 680, 226, 454, 224, 0, 224
5474, 1, 1636430393829, 1636430394313, 484, 0, 484, 0, 0, 0
5476, 1, 1636430393965, 1636430394485, 520, 80, 440, 80, 0, 80
5477, 1, 1636430394313, 1636430394761, 448, 0, 448, 0, 0, 0
5475, 1, 1636430393924, 1636430394773, 849, 389, 460, 388, 0, 388
5478, 1, 1636430394413, 1636430394941, 528, 72, 456, 72, 0, 72
5479, 1, 1636430394437, 1636430395225, 788, 336, 452, 336, 0, 336
5451, 2, 1636430385252, 1636430395252, 10000, 0, 10000, 0, 0, 0
5452, 2, 1636430385669, 1636430395669, 10000, 0, 10000, 0, 0, 0
5480, 1, 1636430394960, 1636430395676, 716, 265, 451, 264, 0, 264
5482, 1, 1636430395457, 1636430395913, 456, 0, 456, 0, 0, 0
5483, 1, 1636430395561, 1636430396021, 460, 0, 460, 0, 0, 0
5481, 1, 1636430395417, 1636430396116, 699, 260, 439, 260, 0, 260
5453, 2, 1636430386113, 1636430396116, 10003, 0, 10003, 0, 0, 0
5484, 1, 1636430395761, 1636430396209, 448, 0, 448, 0, 0, 0
5454, 2, 1636430386325, 1636430396324, 9999, 0, 9999, 0, 0, 0
5486, 1, 1636430395976, 1636430396477, 501, 46, 455, 45, 0, 45
5487, 1, 1636430395993, 1636430396569, 576, 124, 452, 124, 0, 124
5485, 1, 1636430395845, 1636430396661, 816, 364, 452, 364, 0, 364
5455, 2, 1636430386721, 1636430396721, 10000, 0, 10000, 0, 0, 0
5488, 1, 1636430396292, 1636430396748, 456, 1, 455, 0, 1, 1
5490, 1, 1636430396421, 1636430396949, 528, 56, 472, 56, 0, 56
5491, 1, 1636430396461, 1636430397037, 576, 108, 468, 108, 0, 108
5489, 1, 1636430396369, 1636430397124, 755, 292, 463, 292, 0, 292
5456, 2, 1636430387337, 1636430397337, 10000, 0, 10000, 0, 0, 0
5492, 1, 1636430396628, 1636430397405, 777, 321, 456, 320, 0, 320
5493, 1, 1636430396857, 1636430397577, 720, 268, 452, 268, 0, 268
5494, 1, 1636430397033, 1636430397853, 820, 372, 448, 372, 0, 372
5496, 1, 1636430397472, 1636430397921, 449, 0, 449, 0, 0, 0
5497, 1, 1636430397516, 1636430397965, 449, 0, 449, 0, 0, 0
5457, 2, 1636430387973, 1636430397972, 9999, 0, 9999, 0, 0, 0
5495, 1, 1636430397432, 1636430398032, 600, 145, 455, 144, 0, 144
5498, 1, 1636430397597, 1636430398040, 443, 0, 443, 0, 0, 0
5499, 1, 1636430397648, 1636430398296, 648, 205, 443, 205, 0, 205
5502, 1, 1636430398017, 1636430398469, 452, 0, 452, 0, 0, 0
5501, 1, 1636430397956, 1636430398480, 524, 77, 447, 77, 0, 77
5500, 1, 1636430397781, 1636430398492, 711, 260, 451, 260, 0, 260
5458, 2, 1636430388532, 1636430398532, 10000, 0, 10000, 0, 0, 0
5503, 1, 1636430398284, 1636430398760, 476, 13, 463, 13, 0, 13
5504, 1, 1636430398308, 1636430398760, 452, 0, 452, 0, 0, 0
5507, 1, 1636430398364, 1636430398941, 577, 117, 460, 117, 0, 117
5506, 1, 1636430398340, 1636430398944, 604, 130, 474, 129, 0, 129
5505, 1, 1636430398340, 1636430398952, 612, 153, 459, 153, 0, 153
5459, 2, 1636430389157, 1636430399156, 9999, 0, 9999, 0, 0, 0
5509, 1, 1636430398837, 1636430399289, 452, 0, 452, 0, 0, 0
5508, 1, 1636430398625, 1636430399396, 771, 320, 451, 320, 0, 320
5510, 1, 1636430398825, 1636430399413, 588, 128, 460, 128, 0, 128
5460, 1, 1636430389524, 1636430399609, 10085, 9633, 452, 0, 9632, 9632
5513, 1, 1636430399352, 1636430399797, 445, 1, 444, 0, 1, 1
5511, 1, 1636430399016, 1636430399840, 824, 381, 443, 381, 0, 381
5512, 1, 1636430399305, 1636430399861, 556, 108, 448, 108, 0, 108
5514, 1, 1636430399460, 1636430399897, 437, 1, 436, 0, 1, 1
5515, 1, 1636430399524, 1636430399972, 448, 0, 448, 0, 0, 0
5516, 1, 1636430399568, 1636430400016, 448, 0, 448, 0, 0, 0
5517, 1, 1636430399596, 1636430400285, 689, 245, 444, 245, 0, 245
5519, 1, 1636430399833, 1636430400348, 515, 64, 451, 64, 0, 64
5520, 1, 1636430399952, 1636430400397, 445, 1, 444, 1, 0, 1
5518, 1, 1636430399721, 1636430400461, 740, 295, 445, 295, 0, 295
5521, 1, 1636430400108, 1636430400553, 445, 1, 444, 0, 0, 0
5522, 1, 1636430400189, 1636430400637, 448, 0, 448, 0, 0, 0
5523, 1, 1636430400253, 1636430400733, 480, 32, 448, 32, 0, 32
5525, 1, 1636430400344, 1636430400844, 500, 53, 447, 53, 0, 53
5524, 1, 1636430400293, 1636430400913, 620, 168, 452, 168, 0, 168
5526, 1, 1636430400444, 1636430400996, 552, 109, 443, 108, 0, 108
5529, 1, 1636430400844, 1636430401293, 449, 1, 448, 0, 1, 1
5528, 1, 1636430400792, 1636430401369, 577, 121, 456, 121, 0, 121
5527, 1, 1636430400660, 1636430401444, 784, 337, 447, 336, 0, 336
5532, 1, 1636430401297, 1636430401745, 448, 0, 448, 0, 0, 0
5531, 1, 1636430401268, 1636430401824, 556, 101, 455, 101, 0, 101
5530, 1, 1636430401084, 1636430401881, 797, 361, 436, 361, 0, 361
5533, 1, 1636430401485, 1636430401928, 443, 0, 443, 0, 0, 0
5534, 1, 1636430401488, 1636430401928, 440, 0, 440, 0, 0, 0
5535, 1, 1636430401548, 1636430402000, 452, 1, 451, 0, 0, 0
5537, 1, 1636430401713, 1636430402329, 616, 168, 448, 168, 0, 168
5539, 1, 1636430401905, 1636430402348, 443, 0, 443, 0, 0, 0
5538, 1, 1636430401828, 1636430402372, 544, 101, 443, 101, 0, 101
5536, 1, 1636430401696, 1636430402456, 760, 305, 455, 305, 0, 305
5540, 1, 1636430402064, 1636430402512, 448, 1, 447, 1, 0, 1
5541, 1, 1636430402133, 1636430402581, 448, 0, 448, 0, 0, 0
5544, 1, 1636430402340, 1636430402797, 457, 0, 457, 0, 0, 0
5543, 1, 1636430402241, 1636430402801, 560, 108, 452, 108, 0, 108
5542, 1, 1636430402237, 1636430402913, 676, 220, 456, 220, 0, 220
5545, 1, 1636430402380, 1636430402960, 580, 133, 447, 133, 0, 133
5547, 1, 1636430402705, 1636430403365, 660, 208, 452, 208, 0, 208
5548, 1, 1636430402925, 1636430403372, 447, 0, 447, 0, 0, 0
5546, 1, 1636430402652, 1636430403408, 756, 309, 447, 308, 0, 308
5551, 1, 1636430403269, 1636430403721, 452, 0, 452, 0, 0, 0
5550, 1, 1636430403232, 1636430403825, 593, 133, 460, 132, 0, 132
5549, 1, 1636430402996, 1636430403861, 865, 413, 452, 413, 0, 413
5552, 1, 1636430403433, 1636430403884, 451, 0, 451, 0, 0, 0
5553, 1, 1636430403433, 1636430403888, 455, 0, 455, 0, 0, 0
5555, 1, 1636430403620, 1636430404064, 444, 1, 443, 0, 1, 1
5557, 1, 1636430403797, 1636430404281, 484, 29, 455, 28, 0, 28
5554, 1, 1636430403608, 1636430404320, 712, 253, 459, 253, 0, 253
5556, 1, 1636430403656, 1636430404341, 685, 229, 456, 229, 0, 229
5559, 1, 1636430404012, 1636430404461, 449, 1, 448, 1, 0, 1
5558, 1, 1636430403869, 1636430404520, 651, 196, 455, 196, 0, 196
5560, 1, 1636430404100, 1636430404552, 452, 1, 451, 0, 1, 1
5562, 1, 1636430404200, 1636430404729, 529, 81, 448, 80, 0, 80
5563, 1, 1636430404224, 1636430404773, 549, 97, 452, 96, 0, 96
5561, 1, 1636430404128, 1636430404801, 673, 213, 460, 213, 0, 213
5564, 1, 1636430404360, 1636430404917, 557, 101, 456, 100, 0, 100
5567, 1, 1636430404800, 1636430405253, 453, 1, 452, 0, 0, 0
5566, 1, 1636430404625, 1636430405253, 628, 176, 452, 176, 0, 176
5565, 1, 1636430404580, 1636430405368, 788, 337, 451, 337, 0, 337
5570, 1, 1636430405189, 1636430405645, 456, 0, 456, 0, 0, 0
5569, 1, 1636430405189, 1636430405712, 523, 65, 458, 65, 0, 65
5571, 1, 1636430405332, 1636430405784, 452, 1, 451, 0, 1, 1
5568, 1, 1636430404993, 1636430405820, 827, 376, 451, 376, 0, 376
5572, 1, 1636430405413, 1636430405856, 443, 0, 443, 0, 0, 0
5573, 1, 1636430405580, 1636430406028, 448, 0, 448, 0, 0, 0
5576, 1, 1636430405732, 1636430406185, 453, 1, 452, 0, 0, 0
5575, 1, 1636430405597, 1636430406260, 663, 224, 439, 224, 0, 224
5574, 1, 1636430405588, 1636430406304, 716, 269, 447, 269, 0, 269
5578, 1, 1636430405981, 1636430406437, 456, 0, 456, 0, 0, 0
5577, 1, 1636430405856, 1636430406477, 621, 173, 448, 173, 0, 173
5580, 1, 1636430406084, 1636430406528, 444, 0, 444, 0, 0, 0
5582, 1, 1636430406136, 1636430406637, 501, 49, 452, 49, 0, 49
5581, 1, 1636430406096, 1636430406717, 621, 165, 456, 165, 0, 165
5579, 1, 1636430406040, 1636430406753, 713, 265, 448, 265, 0, 265
5583, 1, 1636430406332, 1636430406889, 557, 105, 452, 105, 0, 105
5586, 1, 1636430406720, 1636430407168, 448, 1, 447, 0, 0, 0
5585, 1, 1636430406524, 1636430407205, 681, 229, 452, 229, 0, 229
5584, 1, 1636430406500, 1636430407341, 841, 389, 452, 389, 0, 389
5588, 1, 1636430407148, 1636430407596, 448, 0, 448, 0, 0, 0
5589, 1, 1636430407160, 1636430407648, 488, 45, 443, 45, 0, 45
5590, 1, 1636430407313, 1636430407765, 452, 0, 452, 0, 0, 0
5587, 1, 1636430406912, 1636430407797, 885, 429, 456, 429, 0, 429
5591, 1, 1636430407509, 1636430407957, 448, 0, 448, 0, 0, 0
5592, 1, 1636430407529, 1636430407972, 443, 0, 443, 0, 0, 0
5595, 1, 1636430407713, 1636430408169, 456, 0, 456, 0, 0, 0
5593, 1, 1636430407584, 1636430408244, 660, 214, 446, 213, 0, 213
5597, 1, 1636430407964, 1636430408412, 448, 1, 447, 1, 0, 1
5594, 1, 1636430407640, 1636430408413, 773, 317, 456, 317, 0, 317
5598, 1, 1636430407968, 1636430408424, 456, 1, 455, 1, 0, 1
5596, 1, 1636430407760, 1636430408432, 672, 213, 459, 213, 0, 213
5600, 1, 1636430408060, 1636430408629, 569, 110, 459, 109, 1, 110
5599, 1, 1636430408048, 1636430408697, 649, 197, 452, 197, 0, 197
5601, 1, 1636430408093, 1636430408869, 776, 321, 455, 320, 1, 321
5602, 1, 1636430408280, 1636430408869, 589, 133, 456, 133, 0, 133
5605, 1, 1636430408692, 1636430409148, 456, 5, 451, 4, 0, 4
5603, 1, 1636430408436, 1636430409321, 885, 434, 451, 433, 0, 433
5604, 1, 1636430408600, 1636430409324, 724, 269, 455, 268, 0, 268
5607, 1, 1636430409105, 1636430409552, 447, 0, 447, 0, 0, 0
5608, 1, 1636430409189, 1636430409640, 451, 0, 451, 0, 0, 0
5606, 1, 1636430408889, 1636430409769, 880, 432, 448, 432, 0, 432
5609, 1, 1636430409285, 1636430409773, 488, 40, 448, 39, 1, 40
5610, 1, 1636430409388, 1636430409829, 441, 1, 440, 0, 0, 0
5611, 1, 1636430409472, 1636430409924, 452, 1, 451, 0, 0, 0
5612, 1, 1636430409585, 1636430410217, 632, 184, 448, 184, 0, 184
5615, 1, 1636430409781, 1636430410220, 439, 0, 439, 0, 0, 0
5613, 1, 1636430409640, 1636430410285, 645, 189, 456, 189, 0, 189
5616, 1, 1636430409849, 1636430410288, 439, 0, 439, 0, 0, 0
5617, 1, 1636430409944, 1636430410384, 440, 0, 440, 0, 0, 0
5614, 1, 1636430409684, 1636430410384, 700, 241, 459, 241, 0, 241
5618, 1, 1636430410044, 1636430410668, 624, 173, 451, 173, 0, 173
5620, 1, 1636430410153, 1636430410676, 523, 68, 455, 68, 0, 68
5621, 1, 1636430410260, 1636430410737, 477, 29, 448, 29, 0, 29
5619, 1, 1636430410084, 1636430410737, 653, 201, 452, 201, 0, 201
5624, 1, 1636430410608, 1636430411128, 520, 61, 459, 61, 0, 61
5622, 1, 1636430410352, 1636430411189, 837, 385, 452, 385, 0, 385
5623, 1, 1636430410560, 1636430411192, 632, 178, 454, 177, 0, 177
5626, 1, 1636430411148, 1636430411588, 440, 0, 440, 0, 0, 0
5625, 1, 1636430410800, 1636430411640, 840, 389, 451, 388, 0, 388
5627, 1, 1636430411204, 1636430411648, 444, 1, 443, 0, 0, 0
5628, 1, 1636430411232, 1636430411676, 444, 1, 443, 0, 0, 0
5629, 1, 1636430411372, 1636430411821, 449, 0, 449, 0, 0, 0
5630, 1, 1636430411456, 1636430411905, 449, 0, 449, 0, 0, 0
5631, 1, 1636430411488, 1636430412088, 600, 153, 447, 153, 0, 153
5634, 1, 1636430411764, 1636430412213, 449, 1, 448, 0, 0, 0
5635, 1, 1636430411768, 1636430412213, 445, 1, 444, 1, 0, 1
5633, 1, 1636430411625, 1636430412268, 643, 196, 447, 196, 0, 196
5632, 1, 1636430411577, 1636430412364, 787, 329, 458, 328, 0, 328
5636, 1, 1636430411956, 1636430412404, 448, 1, 447, 0, 0, 0
5637, 1, 1636430411956, 1636430412532, 576, 133, 443, 133, 0, 133
5638, 1, 1636430412048, 1636430412665, 617, 166, 451, 165, 1, 166
5640, 1, 1636430412216, 1636430412665, 449, 0, 449, 0, 0, 0
5639, 1, 1636430412068, 1636430412708, 640, 201, 439, 201, 0, 201
5643, 1, 1636430412576, 1636430413021, 445, 1, 444, 0, 0, 0
5641, 1, 1636430412268, 1636430413109, 841, 398, 443, 398, 0, 398
5642, 1, 1636430412532, 1636430413160, 628, 177, 451, 177, 0, 177
5645, 1, 1636430413085, 1636430413537, 452, 0, 452, 0, 0, 0
5644, 1, 1636430412720, 1636430413560, 840, 389, 451, 389, 0, 389
5646, 1, 1636430413152, 1636430413601, 449, 0, 449, 0, 0, 0
5647, 1, 1636430413176, 1636430413628, 452, 1, 451, 0, 0, 0
5648, 1, 1636430413296, 1636430413748, 452, 0, 452, 0, 0, 0
5649, 1, 1636430413340, 1636430413784, 444, 0, 444, 0, 0, 0
5650, 1, 1636430413421, 1636430414000, 579, 140, 439, 140, 0, 140
5653, 1, 1636430413696, 1636430414140, 444, 0, 444, 0, 0, 0
5652, 1, 1636430413601, 1636430414197, 596, 148, 448, 148, 0, 148
5651, 1, 1636430413476, 1636430414221, 745, 309, 436, 309, 0, 309
5654, 1, 1636430413832, 1636430414273, 441, 0, 441, 0, 0, 0
5655, 1, 1636430413869, 1636430414317, 448, 0, 448, 0, 0, 0
5656, 1, 1636430413869, 1636430414453, 584, 132, 452, 132, 0, 132
5657, 1, 1636430414016, 1636430414601, 585, 125, 460, 125, 0, 125
5658, 1, 1636430414025, 1636430414657, 632, 172, 460, 172, 0, 172
5659, 1, 1636430414280, 1636430414773, 493, 37, 456, 37, 0, 37
5662, 1, 1636430414536, 1636430414984, 448, 1, 447, 0, 0, 0
5661, 1, 1636430414436, 1636430415108, 672, 221, 451, 221, 0, 221
5664, 1, 1636430415020, 1636430415469, 449, 1, 448, 1, 0, 1
5665, 1, 1636430415036, 1636430415488, 452, 1, 451, 0, 0, 0
5666, 1, 1636430415136, 1636430415589, 453, 0, 453, 0, 0, 0
5667, 1, 1636430415289, 1636430415741, 452, 0, 452, 0, 0, 0
5668, 1, 1636430415385, 1636430415828, 443, 0, 443, 0, 0, 0
5671, 1, 1636430415657, 1636430416100, 443, 0, 443, 0, 0, 0
5669, 1, 1636430415409, 1636430416185, 776, 332, 444, 332, 0, 332
5673, 1, 1636430415748, 1636430416188, 440, 1, 439, 1, 0, 1
5674, 1, 1636430415820, 1636430416261, 441, 0, 441, 0, 0, 0
5672, 1, 1636430415661, 1636430416272, 611, 168, 443, 168, 0, 168
5676, 1, 1636430415977, 1636430416553, 576, 124, 452, 124, 0, 124
5678, 1, 1636430416168, 1636430416641, 473, 21, 452, 20, 0, 20
5677, 1, 1636430416104, 1636430416725, 621, 169, 452, 169, 0, 169
5679, 1, 1636430416441, 1636430417181, 740, 284, 456, 284, 0, 284
5681, 1, 1636430416941, 1636430417388, 447, 0, 447, 0, 0, 0
5682, 1, 1636430416977, 1636430417432, 455, 0, 455, 0, 0, 0
5683, 1, 1636430417213, 1636430417665, 452, 0, 452, 0, 0, 0
5685, 1, 1636430417453, 1636430417904, 451, 0, 451, 0, 0, 0
5688, 1, 1636430417680, 1636430418129, 449, 1, 448, 0, 0, 0
5689, 1, 1636430417729, 1636430418172, 443, 0, 443, 0, 0, 0
5690, 1, 1636430417781, 1636430418221, 440, 0, 440, 0, 0, 0
5687, 1, 1636430417665, 1636430418352, 687, 240, 447, 240, 0, 240
5691, 1, 1636430418057, 1636430418577, 520, 72, 448, 72, 0, 72
5692, 1, 1636430418153, 1636430418621, 468, 20, 448, 20, 0, 20
5693, 1, 1636430418188, 1636430418801, 613, 165, 448, 164, 0, 164
5694, 1, 1636430418529, 1636430419253, 724, 273, 451, 272, 0, 272
5695, 1, 1636430418937, 1636430419385, 448, 0, 448, 0, 0, 0
5696, 1, 1636430419029, 1636430419485, 456, 0, 456, 0, 0, 0
5697, 1, 1636430419289, 1636430419745, 456, 0, 456, 0, 0, 0
5698, 1, 1636430419560, 1636430420017, 457, 1, 456, 0, 1, 1
5700, 1, 1636430419692, 1636430420141, 449, 1, 448, 0, 0, 0
5701, 1, 1636430419756, 1636430420205, 449, 1, 448, 0, 0, 0
5702, 1, 1636430419800, 1636430420241, 441, 1, 440, 0, 0, 0
5699, 1, 1636430419681, 1636430420465, 784, 336, 448, 336, 0, 336
5703, 1, 1636430420068, 1636430420593, 525, 74, 451, 73, 0, 73
5704, 1, 1636430420132, 1636430420661, 529, 73, 456, 73, 0, 73
5705, 1, 1636430420261, 1636430420921, 660, 204, 456, 204, 0, 204
5706, 1, 1636430420553, 1636430421377, 824, 368, 456, 368, 0, 368
5707, 1, 1636430421024, 1636430421473, 449, 1, 448, 1, 0, 1
5708, 1, 1636430421116, 1636430421564, 448, 1, 447, 0, 0, 0
5709, 1, 1636430421397, 1636430421849, 452, 0, 452, 0, 0, 0
5710, 1, 1636430421548, 1636430422001, 453, 0, 453, 0, 0, 0
5712, 1, 1636430421772, 1636430422225, 453, 1, 452, 1, 0, 1
5713, 1, 1636430421860, 1636430422309, 449, 1, 448, 0, 0, 0
5714, 1, 1636430421920, 1636430422368, 448, 1, 447, 1, 0, 1
5711, 1, 1636430421636, 1636430422453, 817, 365, 452, 365, 0, 365
5715, 1, 1636430422140, 1636430422677, 537, 85, 452, 84, 0, 84
5717, 1, 1636430422232, 1636430422765, 533, 77, 456, 77, 0, 77
5716, 1, 1636430422161, 1636430422909, 748, 292, 456, 292, 0, 292
5718, 1, 1636430422557, 1636430423361, 804, 352, 452, 352, 0, 352
5719, 1, 1636430423093, 1636430423545, 452, 0, 452, 0, 0, 0
5720, 1, 1636430423148, 1636430423601, 453, 1, 452, 1, 0, 1
5721, 1, 1636430423349, 1636430423813, 464, 12, 452, 12, 0, 12
5724, 1, 1636430423805, 1636430424269, 464, 8, 456, 8, 0, 8
5725, 1, 1636430423857, 1636430424305, 448, 0, 448, 0, 0, 0
5660, 2, 1636430414337, 1636430424337, 10000, 0, 10000, 436, 0, 436
5726, 1, 1636430423948, 1636430424393, 445, 1, 444, 0, 0, 0
5727, 1, 1636430424124, 1636430424749, 625, 145, 480, 145, 0, 145
5728, 1, 1636430424149, 1636430424756, 607, 156, 451, 156, 0, 156
5663, 2, 1636430414769, 1636430424769, 10000, 0, 10000, 4, 0, 4
5670, 2, 1636430415428, 1636430425432, 10004, 0, 10004, 0, 0, 0
5732, 1, 1636430425080, 1636430425528, 448, 1, 447, 0, 0, 0
5733, 1, 1636430425136, 1636430425581, 445, 1, 444, 0, 0, 0
5734, 1, 1636430425201, 1636430425657, 456, 0, 456, 0, 0, 0
5675, 2, 1636430415968, 1636430425969, 10001, 0, 10001, 0, 0, 0
5731, 1, 1636430425088, 1636430425976, 888, 441, 447, 441, 0, 441
5738, 1, 1636430425873, 1636430426325, 452, 0, 452, 0, 0, 0
5739, 1, 1636430425893, 1636430426369, 476, 0, 476, 0, 0, 0
5736, 1, 1636430425732, 1636430426413, 681, 245, 436, 244, 0, 244
5680, 2, 1636430416633, 1636430426633, 10000, 0, 10000, 0, 0, 0
5742, 1, 1636430426236, 1636430426856, 620, 133, 487, 133, 0, 133
5741, 1, 1636430426280, 1636430426868, 588, 133, 455, 133, 0, 133
5743, 1, 1636430426940, 1636430427388, 448, 0, 448, 0, 0, 0
5684, 2, 1636430417392, 1636430427393, 10001, 0, 10001, 0, 0, 0
5744, 1, 1636430427037, 1636430427485, 448, 0, 448, 0, 0, 0
5747, 1, 1636430427188, 1636430427641, 453, 1, 452, 0, 0, 0
5686, 1, 1636430417504, 1636430427845, 10341, 9889, 452, 1, 9888, 9889
5745, 1, 1636430427068, 1636430427933, 865, 417, 448, 417, 0, 417
5749, 1, 1636430427696, 1636430428149, 453, 1, 452, 0, 0, 0
5750, 1, 1636430427848, 1636430428296, 448, 0, 448, 0, 0, 0
5748, 1, 1636430427652, 1636430428389, 737, 282, 455, 281, 0, 281
5752, 1, 1636430428060, 1636430428605, 545, 89, 456, 89, 0, 89
5753, 1, 1636430428221, 1636430428753, 532, 76, 456, 76, 0, 76
5754, 1, 1636430428281, 1636430428841, 560, 109, 451, 108, 0, 108
5755, 1, 1636430428901, 1636430429349, 448, 0, 448, 0, 0, 0
5756, 1, 1636430429061, 1636430429517, 456, 0, 456, 0, 0, 0
5757, 1, 1636430429100, 1636430429973, 873, 418, 455, 417, 1, 418
5759, 1, 1636430429661, 1636430430105, 444, 0, 444, 0, 0, 0
5760, 1, 1636430429673, 1636430430424, 751, 301, 450, 300, 1, 301
5762, 1, 1636430430140, 1636430430593, 453, 1, 452, 0, 0, 0
5764, 1, 1636430430352, 1636430430873, 521, 73, 448, 73, 0, 73
5765, 1, 1636430430917, 1636430431373, 456, 0, 456, 0, 0, 0
5766, 1, 1636430430941, 1636430431393, 452, 0, 452, 0, 0, 0
5767, 1, 1636430431061, 1636430431849, 788, 332, 456, 332, 0, 332
5769, 1, 1636430431677, 1636430432129, 452, 0, 452, 0, 0, 0
5768, 1, 1636430431581, 1636430432301, 720, 268, 452, 268, 0, 268
5770, 1, 1636430432217, 1636430432665, 448, 0, 448, 0, 0, 0
5771, 1, 1636430432308, 1636430432756, 448, 1, 447, 0, 0, 0
5772, 1, 1636430432800, 1636430433253, 453, 1, 452, 0, 0, 0
5773, 1, 1636430432917, 1636430433369, 452, 0, 452, 0, 0, 0
5723, 2, 1636430423669, 1636430433664, 9995, 0, 9995, 0, 0, 0
5722, 2, 1636430423669, 1636430433708, 10039, 0, 10039, 0, 0, 0
5774, 1, 1636430433033, 1636430433820, 787, 337, 450, 336, 0, 336
5776, 1, 1636430433600, 1636430434117, 517, 1, 516, 0, 0, 0
5729, 2, 1636430424213, 1636430434213, 10000, 0, 10000, 0, 0, 0
5775, 1, 1636430433512, 1636430434268, 756, 309, 447, 309, 0, 309
5730, 2, 1636430424581, 1636430434580, 9999, 0, 9999, 0, 0, 0
5779, 1, 1636430434137, 1636430434620, 483, 0, 483, 0, 0, 0
5780, 1, 1636430434304, 1636430434753, 449, 1, 448, 1, 0, 1
5782, 1, 1636430434737, 1636430435204, 467, 16, 451, 16, 0, 16
5784, 1, 1636430435020, 1636430435469, 449, 0, 449, 0, 0, 0
5735, 2, 1636430425476, 1636430435480, 10004, 0, 10004, 0, 0, 0
5737, 2, 1636430425856, 1636430435857, 10001, 0, 10001, 1, 0, 1
5785, 1, 1636430435084, 1636430435921, 837, 386, 451, 385, 0, 385
5786, 1, 1636430435524, 1636430435972, 448, 0, 448, 0, 0, 0
5740, 2, 1636430426180, 1636430436180, 10000, 0, 10000, 0, 0, 0
5787, 1, 1636430435612, 1636430436401, 789, 309, 480, 309, 0, 309
5789, 1, 1636430436108, 1636430436581, 473, 0, 473, 0, 0, 0
5791, 1, 1636430436349, 1636430436857, 508, 53, 455, 53, 0, 53
5746, 2, 1636430427156, 1636430437160, 10004, 0, 10004, 0, 0, 0
5793, 1, 1636430436841, 1636430437308, 467, 16, 451, 16, 0, 16
5794, 1, 1636430437125, 1636430437581, 456, 0, 456, 0, 0, 0
5751, 2, 1636430427892, 1636430437893, 10001, 0, 10001, 0, 0, 0
5797, 1, 1636430437525, 1636430437972, 447, 0, 447, 0, 0, 0
5795, 1, 1636430437204, 1636430438037, 833, 377, 456, 376, 0, 376
5798, 1, 1636430437617, 1636430438485, 868, 420, 448, 420, 0, 420
5800, 1, 1636430438217, 1636430438661, 444, 0, 444, 0, 0, 0
5801, 1, 1636430438444, 1636430438941, 497, 41, 456, 41, 0, 41
5758, 2, 1636430429313, 1636430439309, 9996, 0, 9996, 0, 0, 0
5802, 1, 1636430438977, 1636430439428, 451, 0, 451, 0, 0, 0
5803, 1, 1636430439024, 1636430439472, 448, 1, 447, 1, 0, 1
5761, 2, 1636430429865, 1636430439865, 10000, 0, 10000, 0, 0, 0
5804, 1, 1636430439093, 1636430439920, 827, 380, 447, 380, 0, 380
5807, 1, 1636430439629, 1636430440092, 463, 0, 463, 0, 0, 0
5763, 1, 1636430430265, 1636430440313, 10048, 9600, 448, 0, 9600, 9600
5805, 1, 1636430439537, 1636430440365, 828, 384, 444, 384, 0, 384
5809, 1, 1636430440317, 1636430440757, 440, 0, 440, 0, 0, 0
5810, 1, 1636430440388, 1636430440845, 457, 1, 456, 0, 0, 0
5812, 1, 1636430440877, 1636430441333, 456, 0, 456, 0, 0, 0
5816, 1, 1636430441617, 1636430442073, 456, 0, 456, 0, 0, 0
5817, 1, 1636430442237, 1636430442697, 460, 0, 460, 0, 0, 0
5777, 2, 1636430433981, 1636430443981, 10000, 0, 10000, 0, 0, 0
5778, 2, 1636430433981, 1636430444024, 10043, 0, 10043, 0, 0, 0
5781, 2, 1636430434525, 1636430444520, 9995, 0, 9995, 0, 0, 0
5822, 1, 1636430444292, 1636430444740, 448, 1, 447, 0, 0, 0
5783, 2, 1636430434885, 1636430444885, 10000, 0, 10000, 0, 0, 0
5821, 1, 1636430444292, 1636430445205, 913, 449, 464, 449, 0, 449
5788, 2, 1636430435784, 1636430445785, 10001, 0, 10001, 0, 0, 0
5790, 2, 1636430436168, 1636430446169, 10001, 0, 10001, 0, 0, 0
5792, 2, 1636430436480, 1636430446485, 10005, 0, 10005, 0, 0, 0
5827, 1, 1636430446133, 1636430446593, 460, 0, 460, 0, 0, 0
5828, 1, 1636430446165, 1636430447049, 884, 428, 456, 428, 0, 428
5796, 2, 1636430437461, 1636430447461, 10000, 0, 10000, 0, 0, 0
5799, 2, 1636430438201, 1636430448201, 10000, 0, 10000, 0, 0, 0
5832, 1, 1636430448185, 1636430448637, 452, 0, 452, 0, 0, 0
5833, 1, 1636430448244, 1636430449093, 849, 393, 456, 393, 0, 393
5806, 2, 1636430439624, 1636430449625, 10001, 0, 10001, 0, 0, 0
5808, 2, 1636430440173, 1636430450173, 10000, 0, 10000, 0, 0, 0
5811, 2, 1636430440537, 1636430450537, 10000, 0, 10000, 0, 0, 0
5836, 1, 1636430450309, 1636430450761, 452, 0, 452, 0, 0, 0
5813, 2, 1636430441137, 1636430451137, 10000, 0, 10000, 0, 0, 0
5814, 2, 1636430441145, 1636430451181, 10036, 0, 10036, 0, 0, 0
5837, 1, 1636430450316, 1636430451217, 901, 445, 456, 445, 0, 445
5815, 2, 1636430441588, 1636430451589, 10001, 0, 10001, 0, 0, 0
5818, 2, 1636430442461, 1636430452461, 10000, 0, 10000, 0, 0, 0
5843, 1, 1636430452197, 1636430452681, 484, 0, 484, 0, 0, 0
5819, 2, 1636430442949, 1636430452948, 9999, 0, 9999, 0, 0, 0
5844, 1, 1636430452293, 1636430453177, 884, 388, 496, 388, 0, 388
5820, 2, 1636430443692, 1636430453693, 10001, 0, 10001, 0, 0, 0
5823, 1, 1636430444292, 1636430454145, 9853, 9401, 452, 0, 9401, 9401
5848, 1, 1636430454217, 1636430454669, 452, 0, 452, 0, 0, 0
5824, 2, 1636430444833, 1636430454837, 10004, 0, 10004, 372, 0, 372
5850, 1, 1636430454361, 1636430455157, 796, 308, 488, 308, 0, 308
5825, 2, 1636430445193, 1636430455193, 10000, 0, 10000, 12, 0, 12
5852, 1, 1636430455517, 1636430455969, 452, 0, 452, 0, 0, 0
5826, 2, 1636430446093, 1636430456093, 10000, 0, 10000, 0, 0, 0
5851, 1, 1636430455517, 1636430456424, 907, 452, 455, 452, 0, 452
5829, 2, 1636430446477, 1636430456476, 9999, 0, 9999, 0, 0, 0
5830, 2, 1636430446789, 1636430456784, 9995, 0, 9995, 0, 0, 0
5853, 1, 1636430456317, 1636430456788, 471, 0, 471, 0, 0, 0
5854, 1, 1636430456405, 1636430456876, 471, 20, 451, 20, 0, 20
5855, 1, 1636430456432, 1636430457241, 809, 357, 452, 357, 0, 357
5856, 1, 1636430456828, 1636430457328, 500, 49, 451, 49, 0, 49
5831, 2, 1636430447769, 1636430457769, 10000, 0, 10000, 0, 0, 0
5857, 1, 1636430457097, 1636430457780, 683, 232, 451, 232, 0, 232
5858, 1, 1636430457429, 1636430457880, 451, 0, 451, 0, 0, 0
5859, 1, 1636430457520, 1636430458333, 813, 361, 452, 361, 0, 361
5834, 2, 1636430448504, 1636430458505, 10001, 0, 10001, 0, 0, 0
5860, 1, 1636430458080, 1636430458528, 448, 0, 448, 0, 0, 0
5861, 1, 1636430458309, 1636430458752, 443, 0, 443, 0, 0, 0
5862, 1, 1636430458364, 1636430458821, 457, 1, 456, 0, 0, 0
5863, 1, 1636430458425, 1636430459209, 784, 328, 456, 328, 0, 328
5865, 1, 1636430458808, 1636430459261, 453, 1, 452, 1, 0, 1
5864, 1, 1636430458757, 1636430459277, 520, 64, 456, 64, 0, 64
5866, 1, 1636430459085, 1636430459733, 648, 192, 456, 192, 0, 192
5867, 1, 1636430459429, 1636430459881, 452, 0, 452, 0, 0, 0
5835, 2, 1636430449933, 1636430459933, 10000, 0, 10000, 0, 0, 0
5868, 1, 1636430459489, 1636430460345, 856, 392, 464, 392, 0, 392
5869, 1, 1636430460020, 1636430460469, 449, 0, 449, 0, 0, 0
5838, 2, 1636430450485, 1636430460484, 9999, 0, 9999, 0, 0, 0
5870, 1, 1636430460241, 1636430460712, 471, 0, 471, 0, 0, 0
5871, 1, 1636430460233, 1636430460800, 567, 112, 455, 112, 0, 112
5839, 2, 1636430450845, 1636430460844, 9999, 0, 9999, 0, 0, 0
5872, 1, 1636430460400, 1636430460892, 492, 1, 491, 0, 0, 0
5874, 1, 1636430460796, 1636430461249, 453, 1, 452, 0, 0, 0
5876, 1, 1636430460756, 1636430461249, 493, 45, 448, 44, 1, 45
5875, 1, 1636430460756, 1636430461249, 493, 1, 492, 1, 0, 1
5873, 1, 1636430460529, 1636430461336, 807, 364, 443, 364, 0, 364
5840, 2, 1636430451445, 1636430461445, 10000, 0, 10000, 0, 0, 0
5841, 2, 1636430451457, 1636430461488, 10031, 0, 10031, 0, 0, 0
5877, 1, 1636430460981, 1636430461712, 731, 269, 462, 269, 0, 269
5878, 1, 1636430461165, 1636430461712, 547, 85, 462, 85, 0, 85
5842, 2, 1636430451888, 1636430461892, 10004, 0, 10004, 0, 0, 0
5881, 1, 1636430461744, 1636430462204, 460, 1, 459, 0, 1, 1
5883, 1, 1636430461936, 1636430462385, 449, 0, 449, 0, 0, 0
5885, 1, 1636430462196, 1636430462649, 453, 1, 452, 0, 0, 0
5884, 1, 1636430462196, 1636430462660, 464, 9, 455, 8, 1, 9
5845, 2, 1636430452772, 1636430462773, 10001, 0, 10001, 1, 0, 1
5887, 1, 1636430462336, 1636430462780, 444, 1, 443, 0, 1, 1
5889, 1, 1636430462629, 1636430463084, 455, 0, 455, 0, 0, 0
5882, 1, 1636430461768, 1636430463104, 1336, 893, 443, 892, 0, 892
5888, 1, 1636430462428, 1636430463220, 792, 353, 439, 353, 0, 353
5846, 2, 1636430453261, 1636430463261, 10000, 0, 10000, 0, 0, 0
5890, 1, 1636430462820, 1636430463261, 441, 1, 440, 0, 0, 0
5893, 1, 1636430463077, 1636430463580, 503, 28, 475, 27, 1, 28
5894, 1, 1636430463077, 1636430463708, 631, 185, 446, 185, 0, 185
5847, 2, 1636430453997, 1636430463992, 9995, 0, 9995, 0, 0, 0
5895, 1, 1636430463572, 1636430464032, 460, 9, 451, 8, 0, 8
5896, 1, 1636430463681, 1636430464156, 475, 28, 447, 28, 0, 28
5849, 1, 1636430454369, 1636430464440, 10071, 9624, 447, 0, 9624, 9624
5897, 1, 1636430463752, 1636430464601, 849, 405, 444, 405, 0, 405
5900, 1, 1636430464200, 1636430464648, 448, 0, 448, 0, 0, 0
5901, 1, 1636430464305, 1636430464756, 451, 0, 451, 0, 0, 0
5902, 1, 1636430464320, 1636430464765, 445, 1, 444, 1, 0, 1
5899, 1, 1636430464188, 1636430465053, 865, 413, 452, 413, 0, 413
5904, 1, 1636430464661, 1636430465212, 551, 96, 455, 96, 0, 96
5903, 1, 1636430464425, 1636430465221, 796, 340, 456, 340, 0, 340
5906, 1, 1636430464785, 1636430465233, 448, 0, 448, 0, 0, 0
5907, 1, 1636430465017, 1636430465509, 492, 36, 456, 36, 0, 36
5908, 1, 1636430465017, 1636430465693, 676, 216, 460, 216, 0, 216
5909, 1, 1636430465565, 1636430466017, 452, 0, 452, 0, 0, 0
5910, 1, 1636430465673, 1636430466149, 476, 20, 456, 20, 0, 20
5911, 1, 1636430465712, 1636430466604, 892, 437, 455, 436, 0, 436
5913, 1, 1636430466233, 1636430466677, 444, 0, 444, 0, 0, 0
5914, 1, 1636430466305, 1636430466752, 447, 0, 447, 0, 0, 0
5912, 1, 1636430466188, 1636430467057, 869, 417, 452, 417, 0, 417
5916, 1, 1636430466416, 1636430467129, 713, 261, 452, 261, 0, 261
5917, 1, 1636430466736, 1636430467201, 465, 17, 448, 16, 0, 16
5918, 1, 1636430466896, 1636430467513, 617, 161, 456, 161, 0, 161
5921, 1, 1636430467433, 1636430467973, 540, 80, 460, 80, 0, 80
5924, 1, 1636430468201, 1636430468653, 452, 0, 452, 0, 0, 0
5926, 1, 1636430468309, 1636430468757, 448, 0, 448, 0, 0, 0
5927, 1, 1636430468321, 1636430469109, 788, 332, 456, 332, 0, 332
5928, 1, 1636430468721, 1636430469213, 492, 36, 456, 36, 0, 36
5931, 1, 1636430470133, 1636430470589, 456, 0, 456, 0, 0, 0
5932, 1, 1636430470305, 1636430471040, 735, 285, 450, 284, 1, 285
5879, 2, 1636430461580, 1636430471581, 10001, 0, 10001, 0, 0, 0
5880, 2, 1636430461580, 1636430471625, 10045, 0, 10045, 0, 0, 0
5886, 2, 1636430462317, 1636430472317, 10000, 0, 10000, 0, 0, 0
5935, 1, 1636430471885, 1636430472332, 447, 0, 447, 0, 0, 0
5937, 1, 1636430472001, 1636430472457, 456, 0, 456, 0, 0, 0
5936, 1, 1636430471892, 1636430472789, 897, 441, 456, 441, 0, 441
5891, 2, 1636430462820, 1636430472820, 10000, 0, 10000, 0, 0, 0
5938, 1, 1636430472232, 1636430472913, 681, 225, 456, 225, 0, 225
5892, 2, 1636430463004, 1636430473008, 10004, 0, 10004, 0, 0, 0
5939, 1, 1636430472625, 1636430473245, 620, 164, 456, 164, 0, 164
5940, 1, 1636430473136, 1636430473701, 565, 110, 455, 109, 1, 110
5898, 2, 1636430463952, 1636430473953, 10001, 0, 10001, 0, 0, 0
5941, 1, 1636430473309, 1636430474176, 867, 392, 475, 392, 0, 392
5942, 1, 1636430473821, 1636430474272, 451, 0, 451, 0, 0, 0
5944, 1, 1636430473996, 1636430474457, 461, 1, 460, 0, 0, 0
5945, 1, 1636430474252, 1636430474701, 449, 1, 448, 0, 0, 0
5943, 1, 1636430473905, 1636430474721, 816, 368, 448, 368, 0, 368
5905, 2, 1636430464732, 1636430474740, 10008, 0, 10008, 0, 0, 0
5946, 1, 1636430474220, 1636430474913, 693, 237, 456, 237, 0, 237
5947, 1, 1636430474648, 1636430475173, 525, 73, 452, 73, 0, 73
5948, 1, 1636430475037, 1636430475489, 452, 0, 452, 0, 0, 0
5949, 1, 1636430475141, 1636430475629, 488, 32, 456, 32, 0, 32
5950, 1, 1636430475261, 1636430476085, 824, 368, 456, 368, 0, 368
5951, 1, 1636430475841, 1636430476293, 452, 0, 452, 0, 0, 0
5915, 2, 1636430466329, 1636430476328, 9999, 0, 9999, 0, 0, 0
5953, 1, 1636430475973, 1636430476420, 447, 0, 447, 0, 0, 0
5955, 1, 1636430476268, 1636430476736, 468, 1, 467, 0, 0, 0
5952, 1, 1636430475960, 1636430476740, 780, 333, 447, 333, 0, 333
5954, 1, 1636430476145, 1636430476873, 728, 276, 452, 276, 0, 276
5919, 2, 1636430466908, 1636430476913, 10005, 0, 10005, 0, 0, 0
5956, 1, 1636430476640, 1636430477089, 449, 1, 448, 0, 0, 0
5920, 2, 1636430467112, 1636430477113, 10001, 0, 10001, 1, 0, 1
5957, 1, 1636430476773, 1636430477233, 460, 0, 460, 0, 0, 0
5958, 1, 1636430477053, 1636430477521, 468, 0, 468, 0, 0, 0
5960, 1, 1636430477217, 1636430477669, 452, 0, 452, 0, 0, 0
5922, 2, 1636430467685, 1636430477684, 9999, 0, 9999, 0, 0, 0
5959, 1, 1636430477205, 1636430477692, 487, 28, 459, 28, 0, 28
5923, 2, 1636430467789, 1636430477785, 9996, 0, 9996, 0, 0, 0
5962, 1, 1636430477421, 1636430478120, 699, 248, 451, 248, 0, 248
5961, 1, 1636430477321, 1636430478136, 815, 372, 443, 372, 0, 372
5963, 1, 1636430477728, 1636430478193, 465, 0, 465, 0, 0, 0
5925, 2, 1636430468244, 1636430478245, 10001, 0, 10001, 0, 0, 0
5965, 1, 1636430477881, 1636430478332, 451, 0, 451, 0, 0, 0
5967, 1, 1636430478096, 1636430478581, 485, 25, 460, 24, 0, 24
5964, 1, 1636430477876, 1636430478649, 773, 317, 456, 317, 0, 317
5968, 1, 1636430478080, 1636430478785, 705, 253, 452, 253, 0, 253
5969, 1, 1636430478380, 1636430478837, 457, 1, 456, 0, 0, 0
5929, 2, 1636430468912, 1636430478913, 10001, 0, 10001, 0, 0, 0
5971, 1, 1636430478584, 1636430479032, 448, 0, 448, 0, 0, 0
5972, 1, 1636430478657, 1636430479141, 484, 0, 484, 0, 0, 0
5930, 2, 1636430469529, 1636430479525, 9996, 0, 9996, 0, 0, 0
5974, 1, 1636430479148, 1636430479589, 441, 1, 440, 0, 0, 0
5973, 1, 1636430479116, 1636430479592, 476, 25, 451, 25, 0, 25
5975, 1, 1636430479164, 1636430479600, 436, 0, 436, 0, 0, 0
5977, 1, 1636430479256, 1636430480049, 793, 337, 456, 337, 0, 337
5978, 1, 1636430479424, 1636430480053, 629, 177, 452, 177, 0, 177
5979, 1, 1636430479745, 1636430480197, 452, 0, 452, 0, 0, 0
5933, 2, 1636430470413, 1636430480413, 10000, 0, 10000, 0, 0, 0
5982, 1, 1636430479977, 1636430480432, 455, 0, 455, 0, 0, 0
5983, 1, 1636430480064, 1636430480508, 444, 1, 443, 0, 1, 1
5981, 1, 1636430479881, 1636430480657, 776, 316, 460, 316, 0, 316
5985, 1, 1636430480261, 1636430480733, 472, 0, 472, 0, 0, 0
5934, 1, 1636430470804, 1636430480865, 10061, 9609, 452, 0, 9609, 9609
5984, 1, 1636430480112, 1636430480881, 769, 321, 448, 321, 0, 321
5986, 1, 1636430480605, 1636430481060, 455, 0, 455, 0, 0, 0
5987, 1, 1636430480684, 1636430481137, 453, 1, 452, 0, 0, 0
5990, 1, 1636430481104, 1636430481540, 436, 1, 435, 0, 0, 0
5991, 1, 1636430481133, 1636430481584, 451, 4, 447, 4, 0, 4
5992, 1, 1636430481192, 1636430481628, 436, 1, 435, 1, 0, 1
5993, 1, 1636430481257, 1636430482028, 771, 328, 443, 328, 0, 328
5994, 1, 1636430481472, 1636430482072, 600, 157, 443, 157, 0, 157
5995, 1, 1636430481772, 1636430482233, 461, 1, 460, 1, 0, 1
5996, 1, 1636430481856, 1636430482309, 453, 1, 452, 0, 0, 0
5999, 1, 1636430482096, 1636430482545, 449, 1, 448, 0, 0, 0
5997, 1, 1636430481920, 1636430482692, 772, 313, 459, 312, 0, 312
6000, 1, 1636430482280, 1636430482725, 445, 1, 444, 0, 1, 1
5998, 1, 1636430482092, 1636430482756, 664, 217, 447, 217, 0, 217
6001, 1, 1636430482489, 1636430482945, 456, 0, 456, 0, 0, 0
6002, 1, 1636430482708, 1636430483161, 453, 0, 453, 0, 0, 0
6003, 1, 1636430483105, 1636430483557, 452, 0, 452, 0, 0, 0
6004, 1, 1636430483140, 1636430483584, 444, 1, 443, 1, 0, 1
6005, 1, 1636430483176, 1636430483628, 452, 1, 451, 0, 1, 1
6007, 1, 1636430483377, 1636430484036, 659, 208, 451, 208, 0, 208
6006, 1, 1636430483281, 1636430484077, 796, 348, 448, 348, 0, 348
6008, 1, 1636430483816, 1636430484269, 453, 1, 452, 1, 0, 1
6009, 1, 1636430483868, 1636430484316, 448, 1, 447, 0, 0, 0
6011, 1, 1636430484048, 1636430484508, 460, 1, 459, 0, 1, 1
6012, 1, 1636430484060, 1636430484724, 664, 209, 455, 209, 0, 209
6013, 1, 1636430484324, 1636430484760, 436, 0, 436, 0, 0, 0
6010, 1, 1636430484012, 1636430484765, 753, 305, 448, 305, 0, 305
6014, 1, 1636430484497, 1636430484945, 448, 0, 448, 0, 0, 0
6015, 1, 1636430484804, 1636430485257, 453, 0, 453, 0, 0, 0
6016, 1, 1636430485124, 1636430485573, 449, 1, 448, 0, 0, 0
6017, 1, 1636430485144, 1636430485593, 449, 1, 448, 0, 0, 0
6018, 1, 1636430485228, 1636430485713, 485, 29, 456, 28, 0, 28
6020, 1, 1636430485376, 1636430486045, 669, 217, 452, 216, 0, 216
6019, 1, 1636430485337, 1636430486173, 836, 376, 460, 376, 0, 376
6021, 1, 1636430485749, 1636430486205, 456, 0, 456, 0, 0, 0
6022, 1, 1636430485869, 1636430486317, 448, 0, 448, 0, 0, 0
6025, 1, 1636430486061, 1636430486504, 443, 0, 443, 0, 0, 0
6024, 1, 1636430486020, 1636430486656, 636, 185, 451, 185, 0, 185
6023, 1, 1636430485925, 1636430486773, 848, 392, 456, 392, 0, 392
6026, 1, 1636430486408, 1636430486861, 453, 0, 453, 0, 0, 0
6027, 1, 1636430486536, 1636430486989, 453, 0, 453, 0, 0, 0
6028, 1, 1636430486709, 1636430487224, 515, 64, 451, 64, 0, 64
6029, 1, 1636430487168, 1636430487621, 453, 1, 452, 1, 0, 1
6030, 1, 1636430487180, 1636430487637, 457, 0, 457, 0, 0, 0
6031, 1, 1636430487200, 1636430487672, 472, 25, 447, 25, 0, 25
5966, 2, 1636430477997, 1636430487996, 9999, 0, 9999, 584, 0, 584
6033, 1, 1636430487473, 1636430488077, 604, 148, 456, 148, 0, 148
6032, 1, 1636430487272, 1636430488120, 848, 401, 447, 401, 0, 401
6034, 1, 1636430487684, 1636430488132, 448, 1, 447, 0, 1, 1
6035, 1, 1636430487904, 1636430488357, 453, 1, 452, 1, 0, 1
5970, 2, 1636430478549, 1636430488549, 10000, 0, 10000, 32, 0, 32
6036, 1, 1636430487912, 1636430488581, 669, 221, 448, 221, 0, 221
6038, 1, 1636430488136, 1636430488592, 456, 0, 456, 0, 0, 0
6039, 1, 1636430488317, 1636430488776, 459, 0, 459, 0, 0, 0
6037, 1, 1636430487933, 1636430488801, 868, 425, 443, 425, 0, 425
6040, 1, 1636430488636, 1636430489088, 452, 0, 452, 0, 0, 0
5976, 2, 1636430479220, 1636430489224, 10004, 0, 10004, 0, 0, 0
6041, 1, 1636430488760, 1636430489248, 488, 41, 447, 41, 0, 41
6042, 1, 1636430488888, 1636430489333, 445, 1, 444, 1, 0, 1
6044, 1, 1636430489084, 1636430489540, 456, 1, 455, 1, 0, 1
6045, 1, 1636430489220, 1636430489697, 477, 29, 448, 29, 0, 29
6046, 1, 1636430489268, 1636430489713, 445, 1, 444, 1, 0, 1
6043, 1, 1636430488893, 1636430489784, 891, 440, 451, 440, 0, 440
5980, 2, 1636430479841, 1636430489841, 10000, 0, 10000, 0, 0, 0
6047, 1, 1636430489312, 1636430490157, 845, 385, 460, 385, 0, 385
6049, 1, 1636430489540, 1636430490161, 621, 173, 448, 173, 0, 173
6050, 1, 1636430489724, 1636430490172, 448, 1, 447, 0, 0, 0
6048, 1, 1636430489525, 1636430490249, 724, 260, 464, 260, 0, 260
6051, 1, 1636430490001, 1636430490452, 451, 0, 451, 0, 0, 0
6055, 1, 1636430490176, 1636430490625, 449, 0, 449, 0, 0, 0
6052, 1, 1636430490001, 1636430490625, 624, 172, 452, 172, 0, 172
6054, 1, 1636430490148, 1636430490713, 565, 102, 463, 101, 0, 101
5988, 2, 1636430480720, 1636430490716, 9996, 0, 9996, 0, 0, 0
6056, 1, 1636430490409, 1636430490864, 455, 0, 455, 0, 0, 0
6053, 1, 1636430490012, 1636430490940, 928, 441, 487, 441, 0, 441
6057, 1, 1636430490540, 1636430490980, 440, 1, 439, 0, 0, 0
5989, 1, 1636430481088, 1636430491164, 10076, 9628, 448, 0, 9628, 9628
6059, 1, 1636430490873, 1636430491321, 448, 0, 448, 0, 0, 0
6058, 1, 1636430490849, 1636430491392, 543, 92, 451, 92, 0, 92
6061, 1, 1636430491024, 1636430491473, 449, 1, 448, 0, 0, 0
6062, 1, 1636430491172, 1636430491621, 449, 1, 448, 0, 0, 0
6063, 1, 1636430491180, 1636430491633, 453, 1, 452, 0, 0, 0
6060, 1, 1636430490884, 1636430491773, 889, 437, 452, 437, 0, 437
6066, 1, 1636430491348, 1636430491841, 493, 45, 448, 45, 0, 45
6065, 1, 1636430491385, 1636430491924, 539, 88, 451, 88, 0, 88
6068, 1, 1636430491460, 1636430492072, 612, 161, 451, 161, 0, 161
6067, 1, 1636430491444, 1636430492233, 789, 329, 460, 329, 0, 329
6069, 1, 1636430491832, 1636430492280, 448, 1, 447, 0, 0, 0
6064, 1, 1636430491332, 1636430492297, 965, 509, 456, 509, 0, 509
6070, 1, 1636430492028, 1636430492485, 457, 1, 456, 0, 0, 0
6074, 1, 1636430492172, 1636430492621, 449, 1, 448, 0, 0, 0
6073, 1, 1636430492088, 1636430492685, 597, 145, 452, 145, 0, 145
6072, 1, 1636430492080, 1636430492736, 656, 201, 455, 201, 0, 201
6071, 1, 1636430492036, 1636430492933, 897, 449, 448, 449, 0, 449
6075, 1, 1636430492516, 1636430492964, 448, 1, 447, 0, 0, 0
6076, 1, 1636430492604, 1636430493052, 448, 1, 447, 0, 1, 1
6078, 1, 1636430492908, 1636430493356, 448, 1, 447, 0, 0, 0
6077, 1, 1636430492869, 1636430493388, 519, 64, 455, 64, 0, 64
6080, 1, 1636430493052, 1636430493505, 453, 1, 452, 0, 0, 0
6081, 1, 1636430493209, 1636430493660, 451, 0, 451, 0, 0, 0
6082, 1, 1636430493285, 1636430493736, 451, 0, 451, 0, 0, 0
6079, 1, 1636430493008, 1636430493805, 797, 349, 448, 349, 0, 349
6084, 1, 1636430493377, 1636430493837, 460, 12, 448, 12, 0, 12
6085, 1, 1636430493396, 1636430493960, 564, 109, 455, 109, 0, 109
6087, 1, 1636430493561, 1636430494105, 544, 100, 444, 100, 0, 100
6088, 1, 1636430493704, 1636430494164, 460, 0, 460, 0, 0, 0
6086, 1, 1636430493472, 1636430494252, 780, 333, 447, 333, 0, 333
6083, 1, 1636430493377, 1636430494289, 912, 460, 452, 460, 0, 460
6090, 1, 1636430494120, 1636430494573, 453, 1, 452, 0, 1, 1
6089, 1, 1636430493997, 1636430494613, 616, 168, 448, 168, 0, 168
6093, 1, 1636430494204, 1636430494649, 445, 1, 444, 1, 0, 1
6092, 1, 1636430494176, 1636430494692, 516, 77, 439, 77, 0, 77
6094, 1, 1636430494553, 1636430495000, 447, 0, 447, 0, 0, 0
6091, 1, 1636430494148, 1636430495024, 876, 425, 451, 425, 0, 425
6095, 1, 1636430494732, 1636430495185, 453, 0, 453, 0, 0, 0
6096, 1, 1636430494840, 1636430495292, 452, 1, 451, 1, 0, 1
6097, 1, 1636430494960, 1636430495476, 516, 65, 451, 65, 0, 65
6099, 1, 1636430495192, 1636430495640, 448, 1, 447, 0, 0, 0
6098, 1, 1636430494989, 1636430495757, 768, 304, 464, 304, 0, 304
6100, 1, 1636430495336, 1636430495789, 453, 0, 453, 0, 0, 0
6102, 1, 1636430495413, 1636430495861, 448, 0, 448, 0, 0, 0
6101, 1, 1636430495380, 1636430495933, 553, 97, 456, 97, 0, 97
6106, 1, 1636430495596, 1636430496037, 441, 1, 440, 0, 0, 0
6103, 1, 1636430495452, 1636430496088, 636, 189, 447, 189, 0, 189
6104, 1, 1636430495472, 1636430496208, 736, 286, 450, 285, 0, 285
6107, 1, 1636430495677, 1636430496245, 568, 112, 456, 112, 0, 112
6105, 1, 1636430495500, 1636430496385, 885, 433, 452, 433, 0, 433
6108, 1, 1636430495904, 1636430496497, 593, 133, 460, 133, 0, 133
6109, 1, 1636430496072, 1636430496516, 444, 1, 443, 1, 0, 1
6111, 1, 1636430496168, 1636430496657, 489, 41, 448, 41, 0, 41
6112, 1, 1636430496280, 1636430496721, 441, 1, 440, 1, 0, 1
6110, 1, 1636430496120, 1636430496965, 845, 397, 448, 397, 0, 397
6113, 1, 1636430496636, 1636430497093, 457, 1, 456, 1, 0, 1
6114, 1, 1636430496844, 1636430497292, 448, 1, 447, 1, 0, 1
6115, 1, 1636430496860, 1636430497308, 448, 1, 447, 0, 1, 1
6116, 1, 1636430496892, 1636430497425, 533, 73, 460, 73, 0, 73
6118, 1, 1636430497125, 1636430497576, 451, 0, 451, 0, 0, 0
6117, 1, 1636430497016, 1636430497740, 724, 277, 447, 277, 0, 277
6121, 1, 1636430497424, 1636430497877, 453, 1, 452, 0, 0, 0
6122, 1, 1636430497464, 1636430497912, 448, 0, 448, 0, 0, 0
6123, 1, 1636430497480, 1636430497924, 444, 0, 444, 0, 0, 0
6124, 1, 1636430497501, 1636430497953, 452, 0, 452, 0, 0, 0
6120, 1, 1636430497352, 1636430498024, 672, 225, 447, 225, 0, 225
6125, 1, 1636430497560, 1636430498196, 636, 181, 455, 181, 0, 181
6119, 1, 1636430497288, 1636430498321, 1033, 589, 444, 589, 0, 589
6126, 1, 1636430497716, 1636430498365, 649, 197, 452, 197, 0, 197
6127, 1, 1636430497889, 1636430498368, 479, 36, 443, 36, 0, 36
6128, 1, 1636430498081, 1636430498533, 452, 0, 452, 0, 0, 0
6130, 1, 1636430498200, 1636430498648, 448, 0, 448, 0, 0, 0
6131, 1, 1636430498316, 1636430498812, 496, 49, 447, 49, 0, 49
6129, 1, 1636430498189, 1636430498984, 795, 344, 451, 344, 0, 344
6132, 1, 1636430498596, 1636430499044, 448, 1, 447, 0, 0, 0
6133, 1, 1636430498769, 1636430499217, 448, 0, 448, 0, 0, 0
6134, 1, 1636430498953, 1636430499404, 451, 0, 451, 0, 0, 0
6136, 1, 1636430498977, 1636430499436, 459, 8, 451, 7, 1, 8
6137, 1, 1636430499128, 1636430499581, 453, 1, 452, 0, 0, 0
6135, 1, 1636430498977, 1636430499672, 695, 240, 455, 240, 0, 240
6140, 1, 1636430499412, 1636430499864, 452, 1, 451, 1, 0, 1
6138, 1, 1636430499317, 1636430499884, 567, 120, 447, 120, 0, 120
6141, 1, 1636430499448, 1636430499905, 457, 1, 456, 0, 0, 0
6144, 1, 1636430499556, 1636430500000, 444, 0, 444, 0, 0, 0
6139, 1, 1636430499376, 1636430500029, 653, 205, 448, 205, 0, 205
6143, 1, 1636430499484, 1636430500121, 637, 189, 448, 189, 0, 189
6142, 1, 1636430499460, 1636430500336, 876, 425, 451, 425, 0, 425
6146, 1, 1636430499853, 1636430500361, 508, 52, 456, 52, 0, 52
6145, 1, 1636430499808, 1636430500449, 641, 193, 448, 193, 0, 193
6147, 1, 1636430500109, 1636430500569, 460, 12, 448, 12, 0, 12
6148, 1, 1636430500212, 1636430500656, 444, 1, 443, 0, 0, 0
6150, 1, 1636430500324, 1636430500901, 577, 125, 452, 125, 0, 125
6151, 1, 1636430500609, 1636430501061, 452, 0, 452, 0, 0, 0
6152, 1, 1636430500629, 1636430501076, 447, 0, 447, 0, 0, 0
6149, 1, 1636430500253, 1636430501108, 855, 404, 451, 404, 0, 404
6153, 1, 1636430500860, 1636430501317, 457, 0, 457, 0, 0, 0
6155, 1, 1636430501049, 1636430501488, 439, 0, 439, 0, 0, 0
6154, 1, 1636430500929, 1636430501524, 595, 148, 447, 148, 0, 148
6156, 1, 1636430501116, 1636430501572, 456, 1, 455, 0, 0, 0
6158, 1, 1636430501368, 1636430501821, 453, 1, 452, 0, 0, 0
6159, 1, 1636430501428, 1636430501872, 444, 1, 443, 1, 0, 1
6162, 1, 1636430501469, 1636430501917, 448, 0, 448, 0, 0, 0
6157, 1, 1636430501348, 1636430501933, 585, 141, 444, 141, 0, 141
6161, 1, 1636430501445, 1636430501977, 532, 80, 452, 80, 0, 80
6165, 1, 1636430501845, 1636430502301, 456, 0, 456, 0, 0, 0
6164, 1, 1636430501756, 1636430502369, 613, 161, 452, 161, 0, 161
6166, 1, 1636430502009, 1636430502456, 447, 0, 447, 0, 0, 0
6167, 1, 1636430502225, 1636430502669, 444, 0, 444, 0, 0, 0
6168, 1, 1636430502308, 1636430502821, 513, 61, 452, 60, 0, 60
6170, 1, 1636430502541, 1636430502988, 447, 0, 447, 0, 0, 0
6169, 1, 1636430502333, 1636430503120, 787, 336, 451, 336, 0, 336
6173, 1, 1636430502892, 1636430503348, 456, 1, 455, 0, 0, 0
6172, 1, 1636430502813, 1636430503436, 623, 176, 447, 176, 0, 176
6174, 1, 1636430503028, 1636430503472, 444, 0, 444, 0, 0, 0
6175, 1, 1636430503197, 1636430503644, 447, 0, 447, 0, 0, 0
6177, 1, 1636430503324, 1636430503892, 568, 113, 455, 113, 0, 113
6179, 1, 1636430503440, 1636430503892, 452, 0, 452, 0, 0, 0
6180, 1, 1636430503476, 1636430503921, 445, 0, 445, 0, 0, 0
6176, 1, 1636430503285, 1636430503921, 636, 188, 448, 188, 0, 188
6183, 1, 1636430503921, 1636430504373, 452, 1, 451, 0, 1, 1
6181, 1, 1636430503768, 1636430504376, 608, 154, 454, 153, 0, 153
6182, 1, 1636430503921, 1636430504376, 455, 0, 455, 0, 0, 0
6184, 1, 1636430504124, 1636430504577, 453, 1, 452, 1, 0, 1
6186, 1, 1636430504397, 1636430504849, 452, 0, 452, 0, 0, 0
6187, 1, 1636430504504, 1636430504957, 453, 1, 452, 0, 0, 0
6185, 1, 1636430504256, 1636430505037, 781, 322, 459, 321, 1, 322
6188, 1, 1636430504697, 1636430505408, 711, 260, 451, 260, 0, 260
6189, 1, 1636430504965, 1636430505417, 452, 0, 452, 0, 0, 0
6191, 1, 1636430505101, 1636430505553, 452, 0, 452, 0, 0, 0
6194, 1, 1636430505357, 1636430505817, 460, 0, 460, 0, 0, 0
6193, 1, 1636430505309, 1636430505852, 543, 100, 443, 100, 0, 100
6192, 1, 1636430505261, 1636430505873, 612, 156, 456, 156, 0, 156
6196, 1, 1636430505785, 1636430506273, 488, 32, 456, 32, 0, 32
6198, 1, 1636430505873, 1636430506325, 452, 0, 452, 0, 0, 0
6199, 1, 1636430506033, 1636430506485, 452, 0, 452, 0, 0, 0
6200, 1, 1636430506157, 1636430506940, 783, 328, 455, 328, 0, 328
6202, 1, 1636430506504, 1636430506948, 444, 1, 443, 0, 0, 0
6204, 1, 1636430506912, 1636430507365, 453, 0, 453, 0, 0, 0
6203, 1, 1636430506632, 1636430507396, 764, 317, 447, 317, 0, 317
6205, 1, 1636430507001, 1636430507453, 452, 0, 452, 0, 0, 0
6207, 1, 1636430507225, 1636430507825, 600, 140, 460, 140, 0, 140
6206, 1, 1636430507201, 1636430507848, 647, 196, 451, 196, 0, 196
6208, 1, 1636430507440, 1636430507889, 449, 1, 448, 0, 1, 1
6209, 1, 1636430507808, 1636430508297, 489, 41, 448, 41, 0, 41
6210, 1, 1636430507841, 1636430508344, 503, 48, 455, 48, 0, 48
6211, 1, 1636430507916, 1636430508369, 453, 1, 452, 1, 0, 1
6212, 1, 1636430508121, 1636430508821, 700, 248, 452, 248, 0, 248
6213, 1, 1636430508424, 1636430508877, 453, 1, 452, 1, 0, 1
6214, 1, 1636430508561, 1636430509329, 768, 316, 452, 316, 0, 316
6215, 1, 1636430508893, 1636430509345, 452, 0, 452, 0, 0, 0
6216, 1, 1636430508913, 1636430509365, 452, 0, 452, 0, 0, 0
6217, 1, 1636430509144, 1636430509785, 641, 185, 456, 184, 0, 184
6218, 1, 1636430509225, 1636430509821, 596, 140, 456, 140, 0, 140
6219, 1, 1636430509548, 1636430509997, 449, 1, 448, 1, 0, 1
6220, 1, 1636430509724, 1636430510245, 521, 61, 460, 61, 0, 61
6222, 1, 1636430509913, 1636430510365, 452, 0, 452, 0, 0, 0
6221, 1, 1636430509888, 1636430510453, 565, 110, 455, 109, 0, 109
6223, 1, 1636430510048, 1636430510817, 769, 317, 452, 317, 0, 317
6224, 1, 1636430510420, 1636430510873, 453, 1, 452, 0, 1, 1
6226, 1, 1636430510776, 1636430511273, 497, 41, 456, 40, 0, 40
6227, 1, 1636430510832, 1636430511293, 461, 1, 460, 1, 0, 1
6225, 1, 1636430510468, 1636430511325, 857, 405, 452, 405, 0, 405
6160, 2, 1636430501437, 1636430511437, 10000, 0, 10000, 135, 0, 135
6163, 2, 1636430501500, 1636430511505, 10005, 0, 10005, 72, 0, 72
6229, 1, 1636430511165, 1636430511756, 591, 128, 463, 128, 0, 128
6228, 1, 1636430511064, 1636430511829, 765, 261, 504, 261, 0, 261
6230, 1, 1636430511485, 1636430511936, 451, 0, 451, 0, 0, 0
6231, 1, 1636430511640, 1636430512281, 641, 189, 452, 189, 0, 189
6233, 1, 1636430511880, 1636430512328, 448, 1, 447, 1, 0, 1
6234, 1, 1636430511865, 1636430512385, 520, 72, 448, 72, 0, 72
6235, 1, 1636430511980, 1636430512429, 449, 0, 449, 0, 0, 0
6171, 2, 1636430502737, 1636430512740, 10003, 0, 10003, 0, 0, 0
6232, 1, 1636430511884, 1636430512777, 893, 445, 448, 445, 0, 445
6237, 1, 1636430512364, 1636430512813, 449, 1, 448, 1, 0, 1
6236, 1, 1636430512145, 1636430512881, 736, 284, 452, 284, 0, 284
6239, 1, 1636430512784, 1636430513241, 457, 0, 457, 0, 0, 0
6238, 1, 1636430512397, 1636430513265, 868, 416, 452, 416, 0, 416
6240, 1, 1636430512788, 1636430513336, 548, 93, 455, 93, 0, 93
6178, 2, 1636430503440, 1636430513441, 10001, 0, 10001, 1, 0, 1
6241, 1, 1636430513041, 1636430513488, 447, 0, 447, 0, 0, 0
6243, 1, 1636430513069, 1636430513693, 624, 172, 452, 172, 0, 172
6242, 1, 1636430513053, 1636430513761, 708, 212, 496, 212, 0, 212
6244, 1, 1636430513384, 1636430513853, 469, 1, 468, 0, 0, 0
6247, 1, 1636430513708, 1636430514161, 453, 1, 452, 1, 0, 1
6246, 1, 1636430513744, 1636430514192, 448, 1, 447, 1, 0, 1
6245, 1, 1636430513532, 1636430514217, 685, 229, 456, 229, 0, 229
6249, 1, 1636430513844, 1636430514304, 460, 9, 451, 9, 0, 9
6250, 1, 1636430513952, 1636430514397, 445, 1, 444, 0, 0, 0
6248, 1, 1636430513724, 1636430514617, 893, 437, 456, 437, 0, 437
6252, 1, 1636430514260, 1636430514705, 445, 1, 444, 0, 0, 0
6251, 1, 1636430514125, 1636430514852, 727, 272, 455, 272, 0, 272
6190, 2, 1636430505028, 1636430515028, 10000, 0, 10000, 1, 0, 1
6254, 1, 1636430514672, 1636430515121, 449, 1, 448, 1, 0, 1
6253, 1, 1636430514324, 1636430515157, 833, 381, 452, 380, 0, 380
6255, 1, 1636430514712, 1636430515344, 632, 141, 491, 141, 0, 141
6256, 1, 1636430514896, 1636430515348, 452, 0, 452, 0, 0, 0
6195, 2, 1636430505489, 1636430515488, 9999, 0, 9999, 0, 0, 0
6258, 1, 1636430515076, 1636430515577, 501, 45, 456, 45, 0, 45
6257, 1, 1636430514977, 1636430515612, 635, 180, 455, 180, 0, 180
6259, 1, 1636430515336, 1636430515809, 473, 0, 473, 0, 0, 0
6197, 2, 1636430505844, 1636430515845, 10001, 0, 10001, 0, 0, 0
6260, 1, 1636430515436, 1636430515908, 472, 1, 471, 0, 1, 1
6261, 1, 1636430515457, 1636430516072, 615, 156, 459, 156, 0, 156
6262, 1, 1636430515628, 1636430516076, 448, 0, 448, 0, 0, 0
6263, 1, 1636430515664, 1636430516164, 500, 0, 500, 0, 0, 0
6265, 1, 1636430515800, 1636430516252, 452, 9, 443, 9, 0, 9
6201, 1, 1636430506412, 1636430516292, 9880, 9433, 447, 0, 9432, 9432
6266, 1, 1636430515892, 1636430516336, 444, 0, 444, 0, 0, 0
6267, 1, 1636430515936, 1636430516380, 444, 0, 444, 0, 0, 0
6264, 1, 1636430515668, 1636430516609, 941, 497, 444, 497, 0, 497
6269, 1, 1636430516145, 1636430516697, 552, 108, 444, 108, 0, 108
6268, 1, 1636430516012, 1636430516785, 773, 325, 448, 324, 0, 324
6273, 1, 1636430516573, 1636430517025, 452, 0, 452, 0, 0, 0
6274, 1, 1636430516656, 1636430517241, 585, 129, 456, 129, 0, 129
6275, 1, 1636430516893, 1636430517345, 452, 0, 452, 0, 0, 0
6276, 1, 1636430516945, 1636430517480, 535, 80, 455, 80, 0, 80
6278, 1, 1636430517120, 1636430517572, 452, 1, 451, 0, 0, 0
6279, 1, 1636430517412, 1636430517865, 453, 1, 452, 0, 1, 1
6281, 1, 1636430517548, 1636430518001, 453, 1, 452, 0, 1, 1
6282, 1, 1636430517592, 1636430518045, 453, 0, 453, 0, 0, 0
6284, 1, 1636430517656, 1636430518108, 452, 0, 452, 0, 0, 0
6286, 1, 1636430517884, 1636430518333, 449, 1, 448, 0, 1, 1
6285, 1, 1636430517889, 1636430518344, 455, 0, 455, 0, 0, 0
6283, 1, 1636430517628, 1636430518501, 873, 417, 456, 417, 0, 417
6288, 1, 1636430518048, 1636430518560, 512, 61, 451, 61, 0, 61
6287, 1, 1636430518045, 1636430518789, 744, 288, 456, 288, 0, 288
6290, 1, 1636430518693, 1636430519245, 552, 96, 456, 96, 0, 96
6291, 1, 1636430518821, 1636430519273, 452, 0, 452, 0, 0, 0
6293, 1, 1636430519081, 1636430519536, 455, 0, 455, 0, 0, 0
6294, 1, 1636430519289, 1636430519737, 448, 0, 448, 0, 0, 0
6295, 1, 1636430519481, 1636430519940, 459, 0, 459, 0, 0, 0
6296, 1, 1636430519572, 1636430520024, 452, 1, 451, 0, 1, 1
6298, 1, 1636430519656, 1636430520109, 453, 1, 452, 1, 0, 1
6299, 1, 1636430519768, 1636430520217, 449, 1, 448, 0, 0, 0
6300, 1, 1636430519821, 1636430520264, 443, 0, 443, 0, 0, 0
6297, 1, 1636430519597, 1636430520473, 876, 428, 448, 428, 0, 428
6301, 1, 1636430519981, 1636430520561, 580, 128, 452, 128, 0, 128
6302, 1, 1636430520044, 1636430520717, 673, 221, 452, 221, 0, 221
6303, 1, 1636430520581, 1636430521173, 592, 136, 456, 136, 0, 136
6304, 1, 1636430520809, 1636430521260, 451, 0, 451, 0, 0, 0
6305, 1, 1636430521013, 1636430521461, 448, 0, 448, 0, 0, 0
6306, 1, 1636430521369, 1636430521817, 448, 0, 448, 0, 0, 0
6307, 1, 1636430521424, 1636430521872, 448, 1, 447, 1, 0, 1
6308, 1, 1636430521585, 1636430522036, 451, 0, 451, 0, 0, 0
6309, 1, 1636430521612, 1636430522061, 449, 0, 449, 0, 0, 0
6311, 1, 1636430521717, 1636430522165, 448, 0, 448, 0, 0, 0
6312, 1, 1636430521829, 1636430522277, 448, 0, 448, 0, 0, 0
6313, 1, 1636430521952, 1636430522481, 529, 85, 444, 85, 0, 85
6310, 1, 1636430521621, 1636430522513, 892, 440, 452, 440, 0, 440
6314, 1, 1636430522009, 1636430522621, 612, 156, 456, 156, 0, 156
6315, 1, 1636430522569, 1636430523077, 508, 52, 456, 52, 0, 52
6316, 1, 1636430522809, 1636430523261, 452, 0, 452, 0, 0, 0
6317, 1, 1636430522993, 1636430523444, 451, 0, 451, 0, 0, 0
6318, 1, 1636430523424, 1636430523872, 448, 1, 447, 0, 0, 0
6319, 1, 1636430523432, 1636430523876, 444, 1, 443, 1, 0, 1
6320, 1, 1636430523568, 1636430524009, 441, 0, 441, 0, 0, 0
6321, 1, 1636430523621, 1636430524064, 443, 0, 443, 0, 0, 0
6322, 1, 1636430523652, 1636430524096, 444, 1, 443, 0, 1, 1
6324, 1, 1636430523897, 1636430524357, 460, 0, 460, 0, 0, 0
6325, 1, 1636430523916, 1636430524457, 541, 93, 448, 93, 0, 93
6326, 1, 1636430523977, 1636430524517, 540, 88, 452, 88, 0, 88
6323, 1, 1636430523721, 1636430524544, 823, 376, 447, 376, 0, 376
6327, 1, 1636430524500, 1636430524973, 473, 17, 456, 16, 0, 16
6328, 1, 1636430524921, 1636430525373, 452, 0, 452, 0, 0, 0
6329, 1, 1636430525032, 1636430525485, 453, 1, 452, 0, 0, 0
6330, 1, 1636430525537, 1636430525984, 447, 0, 447, 0, 0, 0
6331, 1, 1636430525573, 1636430526025, 452, 0, 452, 0, 0, 0
6332, 1, 1636430525609, 1636430526061, 452, 0, 452, 0, 0, 0
6334, 1, 1636430525752, 1636430526204, 452, 1, 451, 1, 0, 1
6270, 2, 1636430516332, 1636430526337, 10005, 0, 10005, 365, 0, 365
6271, 2, 1636430516413, 1636430526413, 10000, 0, 10000, 284, 0, 284
6333, 1, 1636430525649, 1636430526477, 828, 376, 452, 376, 0, 376
6272, 2, 1636430516513, 1636430526513, 10000, 0, 10000, 184, 0, 184
6335, 1, 1636430525920, 1636430526561, 641, 141, 500, 141, 0, 141
6336, 1, 1636430526097, 1636430526653, 556, 108, 448, 108, 0, 108
6277, 2, 1636430517080, 1636430527080, 10000, 0, 10000, 0, 0, 0
6337, 1, 1636430526649, 1636430527100, 451, 4, 447, 4, 0, 4
6338, 1, 1636430526784, 1636430527229, 445, 0, 445, 0, 0, 0
6280, 2, 1636430517472, 1636430527472, 10000, 0, 10000, 0, 0, 0
6340, 1, 1636430527000, 1636430527484, 484, 0, 484, 0, 0, 0
6342, 1, 1636430527124, 1636430527577, 453, 0, 453, 0, 0, 0
6344, 1, 1636430527405, 1636430527881, 476, 0, 476, 0, 0, 0
6343, 1, 1636430527384, 1636430527933, 549, 101, 448, 100, 0, 100
6346, 1, 1636430527564, 1636430528012, 448, 0, 448, 0, 0, 0
6347, 1, 1636430527665, 1636430528108, 443, 0, 443, 0, 0, 0
6349, 1, 1636430527828, 1636430528281, 453, 1, 452, 0, 0, 0
6345, 1, 1636430527608, 1636430528461, 853, 405, 448, 405, 0, 405
6350, 1, 1636430527956, 1636430528553, 597, 153, 444, 153, 0, 153
6289, 2, 1636430518644, 1636430528641, 9997, 0, 9997, 0, 0, 0
6351, 1, 1636430528189, 1636430528732, 543, 92, 451, 92, 0, 92
6292, 1, 1636430518965, 1636430529089, 10124, 9676, 448, 0, 9676, 9676
6353, 1, 1636430528732, 1636430529181, 449, 1, 448, 1, 0, 1
6352, 1, 1636430528776, 1636430529224, 448, 0, 448, 0, 0, 0
6355, 1, 1636430528925, 1636430529373, 448, 0, 448, 0, 0, 0
6356, 1, 1636430529065, 1636430529513, 448, 0, 448, 0, 0, 0
6359, 1, 1636430529317, 1636430529768, 451, 0, 451, 0, 0, 0
6358, 1, 1636430529317, 1636430529829, 512, 56, 456, 56, 0, 56
6360, 1, 1636430529521, 1636430529973, 452, 0, 452, 0, 0, 0
6362, 1, 1636430529588, 1636430530033, 445, 1, 444, 0, 0, 0
6363, 1, 1636430529845, 1636430530293, 448, 0, 448, 0, 0, 0
6361, 1, 1636430529568, 1636430530429, 861, 406, 455, 405, 1, 406
6364, 1, 1636430529857, 1636430530489, 632, 176, 456, 176, 0, 176
6365, 1, 1636430530308, 1636430530757, 449, 0, 449, 0, 0, 0
6366, 1, 1636430530748, 1636430531201, 453, 0, 453, 0, 0, 0
6367, 1, 1636430530789, 1636430531237, 448, 0, 448, 0, 0, 0
6368, 1, 1636430530884, 1636430531336, 452, 1, 451, 1, 0, 1
6369, 1, 1636430531057, 1636430531508, 451, 0, 451, 0, 0, 0
6371, 1, 1636430531273, 1636430531724, 451, 0, 451, 0, 0, 0
6370, 1, 1636430531213, 1636430531785, 572, 124, 448, 124, 0, 124
6372, 1, 1636430531464, 1636430531909, 445, 0, 445, 0, 0, 0
6374, 1, 1636430531577, 1636430532029, 452, 0, 452, 0, 0, 0
6375, 1, 1636430531816, 1636430532269, 453, 0, 453, 0, 0, 0
6373, 1, 1636430531516, 1636430532361, 845, 393, 452, 393, 0, 393
6376, 1, 1636430531860, 1636430532485, 625, 169, 456, 169, 0, 169
6377, 1, 1636430532289, 1636430532736, 447, 0, 447, 0, 0, 0
6378, 1, 1636430532693, 1636430533145, 452, 0, 452, 0, 0, 0
6379, 1, 1636430532769, 1636430533224, 455, 0, 455, 0, 0, 0
6380, 1, 1636430532957, 1636430533405, 448, 0, 448, 0, 0, 0
6381, 1, 1636430533004, 1636430533449, 445, 1, 444, 1, 0, 1
6382, 1, 1636430533213, 1636430533665, 452, 0, 452, 0, 0, 0
6384, 1, 1636430533369, 1636430533829, 460, 0, 460, 0, 0, 0
6383, 1, 1636430533268, 1636430533857, 589, 137, 452, 137, 0, 137
6386, 1, 1636430533533, 1636430533981, 448, 0, 448, 0, 0, 0
6385, 1, 1636430533488, 1636430534285, 797, 341, 456, 341, 0, 341
6388, 1, 1636430533845, 1636430534305, 460, 0, 460, 0, 0, 0
6387, 1, 1636430533809, 1636430534437, 628, 172, 456, 172, 0, 172
6389, 1, 1636430534312, 1636430534765, 453, 1, 452, 0, 0, 0
6390, 1, 1636430534613, 1636430535061, 448, 0, 448, 0, 0, 0
6391, 1, 1636430534844, 1636430535293, 449, 1, 448, 0, 0, 0
6392, 1, 1636430534952, 1636430535405, 453, 1, 452, 0, 0, 0
6394, 1, 1636430535121, 1636430535573, 452, 0, 452, 0, 0, 0
6393, 1, 1636430535017, 1636430535748, 731, 277, 454, 276, 0, 276
6396, 1, 1636430535429, 1636430535877, 448, 0, 448, 0, 0, 0
6397, 1, 1636430535476, 1636430535929, 453, 1, 452, 0, 0, 0
6399, 1, 1636430535717, 1636430536169, 452, 0, 452, 0, 0, 0
6395, 1, 1636430535388, 1636430536197, 809, 361, 448, 361, 0, 361
6398, 1, 1636430535497, 1636430536329, 832, 380, 452, 380, 0, 380
6400, 1, 1636430535784, 1636430536377, 593, 145, 448, 145, 0, 145
6401, 1, 1636430536277, 1636430536721, 444, 0, 444, 0, 0, 0
6341, 2, 1636430527004, 1636430537005, 10001, 0, 10001, 929, 0, 929
6339, 2, 1636430527004, 1636430537053, 10049, 0, 10049, 929, 0, 929
6402, 1, 1636430536637, 1636430537093, 456, 0, 456, 0, 0, 0
6403, 1, 1636430536713, 1636430537180, 467, 8, 459, 8, 0, 8
6404, 1, 1636430536817, 1636430537272, 455, 0, 455, 0, 0, 0
6405, 1, 1636430536941, 1636430537453, 512, 0, 512, 0, 0, 0
6406, 1, 1636430537144, 1636430537589, 445, 1, 444, 0, 0, 0
6348, 2, 1636430527776, 1636430537777, 10001, 0, 10001, 157, 0, 157
6408, 1, 1636430537340, 1636430537789, 449, 0, 449, 0, 0, 0
6409, 1, 1636430537384, 1636430537832, 448, 0, 448, 0, 0, 0
6407, 1, 1636430537317, 1636430537909, 592, 136, 456, 136, 0, 136
6412, 1, 1636430537725, 1636430538184, 459, 0, 459, 0, 0, 0
6410, 1, 1636430537449, 1636430538236, 787, 340, 447, 340, 0, 340
6411, 1, 1636430537712, 1636430538276, 564, 121, 443, 121, 0, 121
6414, 1, 1636430538244, 1636430538701, 457, 1, 456, 1, 0, 1
6416, 1, 1636430538400, 1636430538853, 453, 1, 452, 1, 0, 1
6354, 2, 1636430528949, 1636430538949, 10000, 0, 10000, 0, 0, 0
6417, 1, 1636430538505, 1636430538952, 447, 0, 447, 0, 0, 0
6413, 1, 1636430538244, 1636430539173, 929, 457, 472, 456, 0, 456
6418, 1, 1636430538776, 1636430539309, 533, 77, 456, 77, 0, 77
6419, 1, 1636430538889, 1636430539352, 463, 0, 463, 0, 0, 0
6357, 1, 1636430529317, 1636430539396, 10079, 9632, 447, 0, 9632, 9632
6421, 1, 1636430539040, 1636430539489, 449, 0, 449, 0, 0, 0
6420, 1, 1636430539084, 1636430539532, 448, 0, 448, 0, 0, 0
6415, 1, 1636430538244, 1636430539625, 1381, 929, 452, 928, 0, 928
6424, 1, 1636430539400, 1636430539845, 445, 0, 445, 0, 0, 0
6425, 1, 1636430539408, 1636430539849, 441, 1, 440, 1, 0, 1
6423, 1, 1636430539364, 1636430539941, 577, 125, 452, 124, 0, 124
6427, 1, 1636430539616, 1636430540077, 461, 9, 452, 9, 0, 9
6428, 1, 1636430539625, 1636430540077, 452, 0, 452, 0, 0, 0
6429, 1, 1636430539820, 1636430540296, 476, 25, 451, 25, 0, 25
6426, 1, 1636430539517, 1636430540309, 792, 332, 460, 332, 0, 332
6430, 1, 1636430540089, 1636430540532, 443, 0, 443, 0, 0, 0
6422, 1, 1636430539256, 1636430540532, 1276, 821, 455, 820, 0, 820
6433, 1, 1636430540296, 1636430540749, 453, 0, 453, 0, 0, 0
6434, 1, 1636430540572, 1636430541021, 449, 0, 449, 0, 0, 0
6436, 1, 1636430540752, 1636430541196, 444, 1, 443, 0, 0, 0
6435, 1, 1636430540676, 1636430541200, 524, 73, 451, 73, 0, 73
6437, 1, 1636430540960, 1636430541409, 449, 0, 449, 0, 0, 0
6439, 1, 1636430541148, 1636430541596, 448, 1, 447, 0, 0, 0
6441, 1, 1636430541337, 1636430541796, 459, 0, 459, 0, 0, 0
6440, 1, 1636430541297, 1636430541861, 564, 112, 452, 112, 0, 112
6442, 1, 1636430541456, 1636430541909, 453, 1, 452, 0, 1, 1
6446, 1, 1636430541753, 1636430542200, 447, 0, 447, 0, 0, 0
6445, 1, 1636430541685, 1636430542244, 559, 112, 447, 112, 0, 112
6444, 1, 1636430541524, 1636430542365, 841, 385, 456, 384, 0, 384
6447, 1, 1636430541973, 1636430542420, 447, 0, 447, 0, 0, 0
6448, 1, 1636430542373, 1636430542825, 452, 0, 452, 0, 0, 0
6449, 1, 1636430542681, 1636430543133, 452, 0, 452, 0, 0, 0
6450, 1, 1636430542713, 1636430543277, 564, 112, 452, 112, 0, 112
6451, 1, 1636430542856, 1636430543304, 448, 0, 448, 0, 0, 0
6452, 1, 1636430543073, 1636430543524, 451, 0, 451, 0, 0, 0
6453, 1, 1636430543253, 1636430543701, 448, 0, 448, 0, 0, 0
6455, 1, 1636430543389, 1636430543833, 444, 0, 444, 0, 0, 0
6456, 1, 1636430543440, 1636430543885, 445, 1, 444, 0, 0, 0
6454, 1, 1636430543324, 1636430543969, 645, 201, 444, 201, 0, 201
6457, 1, 1636430543453, 1636430544277, 824, 380, 444, 380, 0, 380
6459, 1, 1636430543857, 1636430544293, 436, 0, 436, 0, 0, 0
6458, 1, 1636430543693, 1636430544329, 636, 192, 444, 192, 0, 192
6460, 1, 1636430544613, 1636430545069, 456, 0, 456, 0, 0, 0
6461, 1, 1636430544969, 1636430545425, 456, 0, 456, 0, 0, 0
6462, 1, 1636430545188, 1636430545637, 449, 1, 448, 1, 0, 1
6463, 1, 1636430545193, 1636430545640, 447, 0, 447, 0, 0, 0
6467, 1, 1636430545545, 1636430545997, 452, 0, 452, 0, 0, 0
6469, 1, 1636430545724, 1636430546177, 453, 1, 452, 0, 0, 0
6468, 1, 1636430545704, 1636430546448, 744, 293, 451, 292, 0, 292
6471, 1, 1636430546945, 1636430547393, 448, 0, 448, 0, 0, 0
6473, 1, 1636430547193, 1636430547645, 452, 0, 452, 0, 0, 0
6474, 1, 1636430547520, 1636430547964, 444, 0, 444, 0, 0, 0
6476, 1, 1636430547836, 1636430548289, 453, 0, 453, 0, 0, 0
6475, 1, 1636430547692, 1636430548417, 725, 273, 452, 273, 0, 273
6478, 1, 1636430549277, 1636430549733, 456, 0, 456, 0, 0, 0
6431, 2, 1636430540152, 1636430550153, 10001, 0, 10001, 381, 0, 381
6432, 2, 1636430540152, 1636430550201, 10049, 0, 10049, 381, 0, 381
6481, 1, 1636430549817, 1636430550269, 452, 0, 452, 0, 0, 0
6438, 2, 1636430541141, 1636430551140, 9999, 0, 9999, 0, 0, 0
6482, 1, 1636430550845, 1636430551296, 451, 0, 451, 0, 0, 0
6443, 1, 1636430541521, 1636430551593, 10072, 9620, 452, 0, 9620, 9620
6483, 1, 1636430550845, 1636430551749, 904, 452, 452, 452, 0, 452
6484, 1, 1636430551404, 1636430551853, 449, 0, 449, 0, 0, 0
6485, 1, 1636430551448, 1636430552200, 752, 301, 451, 301, 0, 301
6487, 1, 1636430551784, 1636430552237, 453, 0, 453, 0, 0, 0
6486, 1, 1636430551816, 1636430552657, 841, 385, 456, 385, 0, 385
6488, 1, 1636430552684, 1636430553137, 453, 1, 452, 0, 0, 0
6489, 1, 1636430552704, 1636430553588, 884, 434, 450, 433, 0, 433
6491, 1, 1636430553405, 1636430553852, 447, 0, 447, 0, 0, 0
6490, 1, 1636430553321, 1636430554041, 720, 268, 452, 268, 0, 268
6493, 1, 1636430553861, 1636430554313, 452, 0, 452, 0, 0, 0
6492, 1, 1636430553773, 1636430554492, 719, 268, 451, 268, 0, 268
6494, 1, 1636430554620, 1636430555073, 453, 1, 452, 0, 0, 0
6464, 2, 1636430545317, 1636430555317, 10000, 0, 10000, 324, 0, 324
6465, 2, 1636430545352, 1636430555365, 10013, 0, 10013, 288, 0, 288
6466, 2, 1636430545428, 1636430555429, 10001, 0, 10001, 213, 0, 213
6495, 1, 1636430554645, 1636430555593, 948, 429, 519, 428, 0, 428
6497, 1, 1636430555413, 1636430555860, 447, 0, 447, 0, 0, 0
6496, 1, 1636430555281, 1636430556045, 764, 312, 452, 312, 0, 312
6499, 1, 1636430555820, 1636430556273, 453, 0, 453, 0, 0, 0
6502, 1, 1636430555949, 1636430556401, 452, 0, 452, 0, 0, 0
6498, 1, 1636430555716, 1636430556492, 776, 330, 446, 329, 0, 329
6470, 2, 1636430546516, 1636430556513, 9997, 0, 9997, 0, 0, 0
6501, 1, 1636430555953, 1636430556733, 780, 320, 460, 320, 0, 320
6500, 1, 1636430555953, 1636430556841, 888, 448, 440, 448, 0, 448
6472, 2, 1636430547089, 1636430557089, 10000, 0, 10000, 0, 0, 0
6503, 1, 1636430556648, 1636430557100, 452, 1, 451, 1, 0, 1
6505, 1, 1636430556817, 1636430557312, 495, 24, 471, 24, 0, 24
6504, 1, 1636430556669, 1636430557557, 888, 432, 456, 432, 0, 432
6507, 1, 1636430557393, 1636430557836, 443, 0, 443, 0, 0, 0
6508, 1, 1636430557413, 1636430557864, 451, 0, 451, 0, 0, 0
6506, 1, 1636430557312, 1636430558017, 705, 245, 460, 245, 0, 245
6509, 1, 1636430557729, 1636430558177, 448, 0, 448, 0, 0, 0
6511, 1, 1636430557816, 1636430558265, 449, 1, 448, 0, 0, 0
6510, 1, 1636430557809, 1636430558473, 664, 208, 456, 208, 0, 208
6513, 1, 1636430557864, 1636430558629, 765, 313, 452, 313, 0, 313
6512, 1, 1636430557844, 1636430558721, 877, 421, 456, 421, 0, 421
6477, 2, 1636430548873, 1636430558873, 10000, 0, 10000, 0, 0, 0
6514, 1, 1636430558680, 1636430559133, 453, 0, 453, 0, 0, 0
6515, 1, 1636430558704, 1636430559188, 484, 17, 467, 17, 0, 17
6479, 2, 1636430549405, 1636430559405, 10000, 0, 10000, 0, 0, 0
6516, 1, 1636430558713, 1636430559633, 920, 421, 499, 420, 0, 420
6517, 1, 1636430559180, 1636430559633, 453, 0, 453, 0, 0, 0
6518, 1, 1636430559284, 1636430559729, 445, 1, 444, 1, 0, 1
6519, 1, 1636430559380, 1636430559828, 448, 1, 447, 1, 0, 1
6480, 1, 1636430549617, 1636430559848, 10231, 9788, 443, 0, 9788, 9788
6520, 1, 1636430559448, 1636430560089, 641, 185, 456, 185, 0, 185
6521, 1, 1636430559653, 1636430560109, 456, 0, 456, 0, 0, 0
6522, 1, 1636430559717, 1636430560173, 456, 0, 456, 0, 0, 0
6525, 1, 1636430559888, 1636430560340, 452, 1, 451, 0, 0, 0
6524, 1, 1636430559884, 1636430560541, 657, 205, 452, 205, 0, 205
6523, 1, 1636430559817, 1636430560568, 751, 292, 459, 292, 0, 292
6527, 1, 1636430560069, 1636430560625, 556, 104, 452, 104, 0, 104
6526, 1, 1636430559925, 1636430560789, 864, 416, 448, 416, 0, 416
6528, 1, 1636430560625, 1636430561072, 447, 0, 447, 0, 0, 0
6530, 1, 1636430560812, 1636430561260, 448, 1, 447, 1, 0, 1
6529, 1, 1636430560680, 1636430561521, 841, 393, 448, 393, 0, 393
6531, 1, 1636430561069, 1636430561521, 452, 0, 452, 0, 0, 0
6533, 1, 1636430561360, 1636430561817, 457, 1, 456, 0, 0, 0
6534, 1, 1636430561500, 1636430561953, 453, 1, 452, 0, 0, 0
6532, 1, 1636430561325, 1636430561976, 651, 196, 455, 196, 0, 196
6535, 1, 1636430561609, 1636430562053, 444, 0, 444, 0, 0, 0
6536, 1, 1636430561757, 1636430562209, 452, 0, 452, 0, 0, 0
6537, 1, 1636430561812, 1636430562440, 628, 165, 463, 165, 0, 165
6539, 1, 1636430561944, 1636430562509, 565, 109, 456, 108, 0, 108
6538, 1, 1636430561896, 1636430562665, 769, 313, 456, 313, 0, 313
6540, 1, 1636430562609, 1636430563065, 456, 0, 456, 0, 0, 0
6541, 1, 1636430562620, 1636430563521, 901, 445, 456, 445, 0, 445
6542, 1, 1636430563149, 1636430563609, 460, 0, 460, 0, 0, 0
6544, 1, 1636430563496, 1636430563944, 448, 1, 447, 0, 0, 0
6543, 1, 1636430563269, 1636430563973, 704, 252, 452, 252, 0, 252
6545, 1, 1636430563684, 1636430564141, 457, 1, 456, 0, 0, 0
6546, 1, 1636430563781, 1636430564233, 452, 0, 452, 0, 0, 0
6547, 1, 1636430563809, 1636430564429, 620, 164, 456, 164, 0, 164
6549, 1, 1636430563996, 1636430564593, 597, 145, 452, 145, 0, 145
6548, 1, 1636430563908, 1636430564689, 781, 325, 456, 325, 0, 325
6550, 1, 1636430564536, 1636430564993, 457, 1, 456, 0, 0, 0
6551, 1, 1636430564560, 1636430565457, 897, 433, 464, 433, 0, 433
6552, 1, 1636430565164, 1636430565905, 741, 293, 448, 292, 0, 292
6553, 1, 1636430565573, 1636430566025, 452, 0, 452, 0, 0, 0
6555, 1, 1636430565800, 1636430566253, 453, 1, 452, 0, 1, 1
6554, 1, 1636430565733, 1636430566365, 632, 172, 460, 172, 0, 172
6556, 1, 1636430565921, 1636430566709, 788, 333, 455, 332, 0, 332
6557, 1, 1636430566413, 1636430566865, 452, 0, 452, 0, 0, 0
6558, 1, 1636430566521, 1636430567317, 796, 344, 452, 344, 0, 344
6559, 1, 1636430567069, 1636430567769, 700, 248, 452, 248, 0, 248
6561, 1, 1636430567752, 1636430568205, 453, 0, 453, 0, 0, 0
6560, 1, 1636430567717, 1636430568216, 499, 52, 447, 52, 0, 52
6562, 1, 1636430567868, 1636430568657, 789, 336, 453, 336, 0, 336
6563, 1, 1636430568321, 1636430568777, 456, 0, 456, 0, 0, 0
6564, 1, 1636430568476, 1636430569237, 761, 302, 459, 300, 0, 300
6565, 1, 1636430569029, 1636430569692, 663, 208, 455, 208, 0, 208
6566, 1, 1636430569676, 1636430570145, 469, 17, 452, 17, 0, 17
6567, 1, 1636430569825, 1636430570272, 447, 0, 447, 0, 0, 0
6568, 1, 1636430569920, 1636430570729, 809, 353, 456, 353, 0, 353
6569, 1, 1636430570393, 1636430570853, 460, 0, 460, 0, 0, 0
6570, 1, 1636430570537, 1636430571309, 772, 316, 456, 316, 0, 316
6571, 1, 1636430571041, 1636430571764, 723, 269, 454, 268, 0, 268
6572, 1, 1636430571737, 1636430572224, 487, 28, 459, 28, 0, 28
6573, 1, 1636430571788, 1636430572244, 456, 1, 455, 0, 1, 1
6574, 1, 1636430571901, 1636430572701, 800, 344, 456, 344, 0, 344
6575, 1, 1636430572361, 1636430572813, 452, 0, 452, 0, 0, 0
6576, 1, 1636430572461, 1636430573273, 812, 352, 460, 352, 0, 352
6577, 1, 1636430572961, 1636430573729, 768, 313, 455, 312, 1, 313
6578, 1, 1636430573689, 1636430574181, 492, 41, 451, 40, 0, 40
6579, 1, 1636430573797, 1636430574244, 447, 0, 447, 0, 0, 0
6580, 1, 1636430573901, 1636430574701, 800, 344, 456, 344, 0, 344
6581, 1, 1636430574461, 1636430574917, 456, 0, 456, 0, 0, 0
6582, 1, 1636430574481, 1636430575377, 896, 437, 459, 436, 0, 436
6583, 1, 1636430574985, 1636430575833, 848, 392, 456, 392, 0, 392
6584, 1, 1636430575801, 1636430576289, 488, 32, 456, 32, 0, 32
6586, 1, 1636430576569, 1636430577021, 452, 0, 452, 0, 0, 0
6587, 1, 1636430577001, 1636430577477, 476, 20, 456, 20, 0, 20
6585, 1, 1636430576569, 1636430577933, 1364, 909, 455, 908, 0, 908
6588, 1, 1636430577865, 1636430578389, 524, 68, 456, 68, 0, 68
6589, 1, 1636430578505, 1636430578961, 456, 0, 456, 0, 0, 0
6591, 1, 1636430578876, 1636430579417, 541, 86, 455, 85, 0, 85
6590, 1, 1636430578556, 1636430579873, 1317, 861, 456, 861, 0, 861
6592, 1, 1636430579749, 1636430580329, 580, 124, 456, 124, 0, 124
6593, 1, 1636430580409, 1636430580857, 448, 0, 448, 0, 0, 0
6597, 1, 1636430582461, 1636430582913, 452, 0, 452, 0, 0, 0
6594, 2, 1636430580557, 1636430590557, 10000, 0, 10000, 300, 0, 300
6595, 2, 1636430580833, 1636430590833, 10000, 0, 10000, 24, 0, 24
6596, 1, 1636430581704, 1636430591280, 9576, 9129, 447, 1, 9128, 9129
6599, 1, 1636430591164, 1636430591617, 453, 0, 453, 0, 0, 0
6600, 1, 1636430591501, 1636430592073, 572, 116, 456, 116, 0, 116
6598, 1, 1636430591168, 1636430592529, 1361, 905, 456, 905, 0, 905
6601, 1, 1636430665537, 1636430665989, 452, 0, 452, 0, 0, 0
6602, 1, 1636430666249, 1636430666701, 452, 0, 452, 0, 0, 0
6603, 1, 1636430666701, 1636430667157, 456, 0, 456, 0, 0, 0
6604, 1, 1636430666921, 1636430667373, 452, 0, 452, 0, 0, 0
6606, 1, 1636430667401, 1636430667853, 452, 0, 452, 0, 0, 0
6605, 1, 1636430667409, 1636430667864, 455, 0, 455, 0, 0, 0
6607, 1, 1636430667589, 1636430668045, 456, 0, 456, 0, 0, 0
6608, 1, 1636430668005, 1636430668461, 456, 0, 456, 0, 0, 0
6609, 1, 1636430668085, 1636430668533, 448, 0, 448, 0, 0, 0
6610, 1, 1636430668109, 1636430668560, 451, 0, 451, 0, 0, 0
6611, 1, 1636430668261, 1636430668712, 451, 0, 451, 0, 0, 0
6612, 1, 1636430668516, 1636430668960, 444, 0, 444, 0, 0, 0
6613, 1, 1636430668712, 1636430669157, 445, 0, 445, 0, 0, 0
6614, 1, 1636430668756, 1636430669212, 456, 0, 456, 0, 0, 0
6615, 1, 1636430668777, 1636430669236, 459, 0, 459, 0, 0, 0
6616, 1, 1636430668937, 1636430669384, 447, 0, 447, 0, 0, 0
6617, 1, 1636430669004, 1636430669452, 448, 1, 447, 0, 1, 1
6618, 1, 1636430669224, 1636430669677, 453, 1, 452, 0, 0, 0
6619, 1, 1636430669381, 1636430669829, 448, 0, 448, 0, 0, 0
6620, 1, 1636430669428, 1636430669885, 457, 1, 456, 0, 0, 0
6621, 1, 1636430669456, 1636430669905, 449, 0, 449, 0, 0, 0
6622, 1, 1636430669489, 1636430669944, 455, 0, 455, 0, 0, 0
6624, 1, 1636430669713, 1636430670160, 447, 0, 447, 0, 0, 0
6625, 1, 1636430669904, 1636430670364, 460, 1, 459, 0, 0, 0
6623, 1, 1636430669600, 1636430670397, 797, 345, 452, 345, 0, 345
6627, 1, 1636430670053, 1636430670509, 456, 0, 456, 0, 0, 0
6628, 1, 1636430670108, 1636430670560, 452, 1, 451, 0, 0, 0
6629, 1, 1636430670133, 1636430670585, 452, 0, 452, 0, 0, 0
6630, 1, 1636430670196, 1636430670644, 448, 1, 447, 0, 1, 1
6631, 1, 1636430670380, 1636430670829, 449, 0, 449, 0, 0, 0
6626, 1, 1636430669981, 1636430670845, 864, 416, 448, 416, 0, 416
6633, 1, 1636430670585, 1636430671048, 463, 0, 463, 0, 0, 0
6634, 1, 1636430670616, 1636430671077, 461, 1, 460, 0, 0, 0
6635, 1, 1636430670733, 1636430671177, 444, 0, 444, 0, 0, 0
6637, 1, 1636430670808, 1636430671256, 448, 1, 447, 0, 0, 0
6636, 1, 1636430670780, 1636430671293, 513, 65, 448, 64, 0, 64
6638, 1, 1636430670865, 1636430671316, 451, 0, 451, 0, 0, 0
6639, 1, 1636430671057, 1636430671513, 456, 0, 456, 0, 0, 0
6640, 1, 1636430671064, 1636430671520, 456, 1, 455, 0, 0, 0
6641, 1, 1636430671268, 1636430671725, 457, 1, 456, 1, 0, 1
6642, 1, 1636430671292, 1636430671740, 448, 1, 447, 0, 0, 0
6632, 1, 1636430670440, 1636430671748, 1308, 853, 455, 853, 0, 853
6643, 1, 1636430671401, 1636430671849, 448, 0, 448, 0, 0, 0
6645, 1, 1636430671516, 1636430671973, 457, 1, 456, 0, 0, 0
6646, 1, 1636430671541, 1636430671992, 451, 0, 451, 0, 0, 0
6648, 1, 1636430671732, 1636430672177, 445, 1, 444, 0, 0, 0
6647, 1, 1636430671732, 1636430672177, 445, 1, 444, 1, 0, 1
6644, 1, 1636430671480, 1636430672188, 708, 269, 439, 269, 0, 269
6650, 1, 1636430671944, 1636430672388, 444, 0, 444, 0, 0, 0
6652, 1, 1636430671964, 1636430672408, 444, 1, 443, 0, 0, 0
6651, 1, 1636430671973, 1636430672420, 447, 0, 447, 0, 0, 0
6654, 1, 1636430672200, 1636430672652, 452, 0, 452, 0, 0, 0
6653, 1, 1636430672073, 1636430672652, 579, 116, 463, 116, 0, 116
6655, 1, 1636430672213, 1636430672656, 443, 0, 443, 0, 0, 0
6656, 1, 1636430672400, 1636430672844, 444, 0, 444, 0, 0, 0
6657, 1, 1636430672404, 1636430672848, 444, 1, 443, 0, 1, 1
6658, 1, 1636430672408, 1636430672852, 444, 0, 444, 0, 0, 0
6662, 1, 1636430672636, 1636430673085, 449, 0, 449, 0, 0, 0
6661, 1, 1636430672636, 1636430673088, 452, 0, 452, 0, 0, 0
6665, 1, 1636430672872, 1636430673316, 444, 1, 443, 0, 0, 0
6663, 1, 1636430672872, 1636430673320, 448, 1, 447, 0, 0, 0
6664, 1, 1636430672872, 1636430673320, 448, 1, 447, 0, 0, 0
6668, 1, 1636430673076, 1636430673529, 453, 1, 452, 0, 0, 0
6669, 1, 1636430673080, 1636430673529, 449, 1, 448, 0, 0, 0
6670, 1, 1636430673300, 1636430673748, 448, 0, 448, 0, 0, 0
6671, 1, 1636430673304, 1636430673752, 448, 0, 448, 0, 0, 0
6672, 1, 1636430673540, 1636430673988, 448, 0, 448, 0, 0, 0
6673, 1, 1636430673540, 1636430673992, 452, 0, 452, 0, 0, 0
6676, 1, 1636430673744, 1636430674197, 453, 1, 452, 0, 0, 0
6677, 1, 1636430673760, 1636430674208, 448, 1, 447, 0, 0, 0
6679, 1, 1636430673972, 1636430674425, 453, 1, 452, 1, 0, 1
6678, 1, 1636430673972, 1636430674425, 453, 1, 452, 1, 0, 1
6674, 1, 1636430673544, 1636430674432, 888, 445, 443, 445, 0, 445
6681, 1, 1636430674204, 1636430674660, 456, 5, 451, 5, 0, 5
6682, 1, 1636430674216, 1636430674664, 448, 0, 448, 0, 0, 0
6683, 1, 1636430674425, 1636430674876, 451, 0, 451, 0, 0, 0
6684, 1, 1636430674428, 1636430674880, 452, 0, 452, 0, 0, 0
6686, 1, 1636430674649, 1636430675092, 443, 0, 443, 0, 0, 0
6685, 1, 1636430674644, 1636430675096, 452, 1, 451, 0, 0, 0
6687, 1, 1636430674656, 1636430675116, 460, 5, 455, 4, 0, 4
6690, 1, 1636430674876, 1636430675328, 452, 5, 447, 4, 0, 4
6689, 1, 1636430674888, 1636430675345, 457, 0, 457, 0, 0, 0
6691, 1, 1636430675092, 1636430675540, 448, 0, 448, 0, 0, 0
6692, 1, 1636430675100, 1636430675544, 444, 0, 444, 0, 0, 0
6695, 1, 1636430675313, 1636430675761, 448, 0, 448, 0, 0, 0
6694, 1, 1636430675313, 1636430675761, 448, 0, 448, 0, 0, 0
6696, 1, 1636430675336, 1636430675780, 444, 0, 444, 0, 0, 0
6697, 1, 1636430675544, 1636430675992, 448, 1, 447, 1, 0, 1
6698, 1, 1636430675572, 1636430676024, 452, 0, 452, 0, 0, 0
6700, 1, 1636430675768, 1636430676220, 452, 1, 451, 0, 0, 0
6702, 1, 1636430675981, 1636430676429, 448, 0, 448, 0, 0, 0
6703, 1, 1636430675984, 1636430676437, 453, 0, 453, 0, 0, 0
6704, 1, 1636430676005, 1636430676452, 447, 0, 447, 0, 0, 0
6705, 1, 1636430676216, 1636430676677, 461, 5, 456, 5, 0, 5
6706, 1, 1636430676249, 1636430676700, 451, 0, 451, 0, 0, 0
6708, 1, 1636430676444, 1636430676893, 449, 0, 449, 0, 0, 0
6711, 1, 1636430676677, 1636430677137, 460, 0, 460, 0, 0, 0
6713, 1, 1636430676896, 1636430677344, 448, 1, 447, 1, 0, 1
6714, 1, 1636430676921, 1636430677376, 455, 0, 455, 0, 0, 0
6715, 1, 1636430677113, 1636430677561, 448, 0, 448, 0, 0, 0
6716, 1, 1636430677360, 1636430677812, 452, 1, 451, 0, 0, 0
6717, 1, 1636430677560, 1636430678013, 453, 1, 452, 0, 0, 0
6719, 1, 1636430677781, 1636430678233, 452, 0, 452, 0, 0, 0
6720, 1, 1636430678033, 1636430678480, 447, 0, 447, 0, 0, 0
6721, 1, 1636430678233, 1636430678689, 456, 0, 456, 0, 0, 0
6723, 1, 1636430678700, 1636430679157, 457, 1, 456, 0, 1, 1
6649, 2, 1636430671812, 1636430681817, 10005, 0, 10005, 841, 0, 841
6659, 2, 1636430672472, 1636430682477, 10005, 0, 10005, 181, 0, 181
6660, 2, 1636430672608, 1636430682609, 10001, 0, 10001, 45, 0, 45
6666, 2, 1636430673021, 1636430683020, 9999, 0, 9999, 0, 0, 0
6667, 2, 1636430673068, 1636430683065, 9997, 0, 9997, 0, 0, 0
6728, 1, 1636430682964, 1636430683468, 504, 0, 504, 0, 0, 0
6726, 1, 1636430682960, 1636430683472, 512, 0, 512, 0, 0, 0
6675, 2, 1636430673621, 1636430683624, 10003, 0, 10003, 0, 0, 0
6730, 1, 1636430683376, 1636430683932, 556, 93, 463, 93, 0, 93
6729, 1, 1636430683324, 1636430683932, 608, 149, 459, 149, 0, 149
6680, 2, 1636430674124, 1636430684124, 10000, 0, 10000, 0, 0, 0
6732, 1, 1636430683716, 1636430684168, 452, 1, 451, 0, 0, 0
6731, 1, 1636430683716, 1636430684169, 453, 1, 452, 1, 0, 1
6735, 1, 1636430684168, 1636430684624, 456, 1, 455, 1, 0, 1
6688, 2, 1636430674668, 1636430684668, 10000, 0, 10000, 0, 0, 0
6736, 1, 1636430684389, 1636430684836, 447, 0, 447, 0, 0, 0
6737, 1, 1636430684389, 1636430684836, 447, 0, 447, 0, 0, 0
6693, 2, 1636430675228, 1636430685229, 10001, 0, 10001, 1, 0, 1
6739, 1, 1636430684844, 1636430685305, 461, 1, 460, 0, 1, 1
6741, 1, 1636430685056, 1636430685545, 489, 1, 488, 0, 1, 1
6742, 1, 1636430685056, 1636430685545, 489, 1, 488, 0, 1, 1
6701, 2, 1636430675745, 1636430685745, 10000, 0, 10000, 0, 0, 0
6699, 2, 1636430675768, 1636430685792, 10024, 0, 10024, 0, 0, 0
6743, 1, 1636430685524, 1636430686020, 496, 21, 475, 21, 0, 21
6707, 2, 1636430676237, 1636430686237, 10000, 0, 10000, 0, 0, 0
6746, 1, 1636430685837, 1636430686284, 447, 0, 447, 0, 0, 0
6745, 1, 1636430685837, 1636430686292, 455, 0, 455, 0, 0, 0
6748, 1, 1636430686072, 1636430686560, 488, 0, 488, 0, 0, 0
6709, 2, 1636430676652, 1636430686653, 10001, 0, 10001, 0, 0, 0
6710, 2, 1636430676661, 1636430686700, 10039, 0, 10039, 0, 0, 0
6749, 1, 1636430686280, 1636430686729, 449, 5, 444, 4, 0, 4
6712, 2, 1636430676753, 1636430686749, 9996, 0, 9996, 0, 0, 0
6750, 1, 1636430686505, 1636430687020, 515, 0, 515, 0, 0, 0
6751, 1, 1636430686508, 1636430687020, 512, 0, 512, 0, 0, 0
6753, 1, 1636430686797, 1636430687244, 447, 0, 447, 0, 0, 0
6755, 1, 1636430686964, 1636430687417, 453, 1, 452, 0, 0, 0
6756, 1, 1636430687017, 1636430687464, 447, 0, 447, 0, 0, 0
6754, 1, 1636430686953, 1636430687464, 511, 68, 443, 68, 0, 68
6718, 2, 1636430677597, 1636430687596, 9999, 0, 9999, 0, 0, 0
6759, 1, 1636430687240, 1636430687685, 445, 0, 445, 0, 0, 0
6760, 1, 1636430687461, 1636430687916, 455, 0, 455, 0, 0, 0
6761, 1, 1636430687644, 1636430688088, 444, 0, 444, 0, 0, 0
6762, 1, 1636430687688, 1636430688132, 444, 0, 444, 0, 0, 0
6764, 1, 1636430687908, 1636430688361, 453, 0, 453, 0, 0, 0
6722, 2, 1636430678456, 1636430688460, 10004, 0, 10004, 0, 0, 0
6766, 1, 1636430688132, 1636430688580, 448, 1, 447, 0, 0, 0
6767, 1, 1636430688309, 1636430688777, 468, 0, 468, 0, 0, 0
6768, 1, 1636430688352, 1636430688805, 453, 1, 452, 0, 0, 0
6724, 2, 1636430678913, 1636430688913, 10000, 0, 10000, 0, 0, 0
6769, 1, 1636430688580, 1636430689028, 448, 1, 447, 0, 0, 0
6770, 1, 1636430688769, 1636430689228, 459, 0, 459, 0, 0, 0
6771, 1, 1636430688800, 1636430689244, 444, 1, 443, 0, 0, 0
6725, 2, 1636430679381, 1636430689381, 10000, 0, 10000, 0, 0, 0
6772, 1, 1636430689000, 1636430689449, 449, 0, 449, 0, 0, 0
6773, 1, 1636430689016, 1636430689465, 449, 0, 449, 0, 0, 0
6774, 1, 1636430689216, 1636430689696, 480, 13, 467, 13, 0, 13
6775, 1, 1636430689248, 1636430689696, 448, 1, 447, 0, 0, 0
6765, 1, 1636430687904, 1636430689828, 1924, 1477, 447, 0, 1477, 1477
6777, 1, 1636430689472, 1636430689916, 444, 1, 443, 0, 0, 0
6776, 1, 1636430689472, 1636430689924, 452, 1, 451, 1, 0, 1
6778, 1, 1636430689672, 1636430690129, 457, 0, 457, 0, 0, 0
6780, 1, 1636430689689, 1636430690140, 451, 0, 451, 0, 0, 0
6779, 1, 1636430689689, 1636430690144, 455, 8, 447, 8, 0, 8
6782, 1, 1636430689916, 1636430690368, 452, 1, 451, 0, 0, 0
6781, 1, 1636430689913, 1636430690372, 459, 12, 447, 12, 0, 12
6783, 1, 1636430690049, 1636430690500, 451, 0, 451, 0, 0, 0
6785, 1, 1636430690144, 1636430690592, 448, 0, 448, 0, 0, 0
6786, 1, 1636430690348, 1636430690804, 456, 1, 455, 0, 0, 0
6787, 1, 1636430690365, 1636430690812, 447, 0, 447, 0, 0, 0
6788, 1, 1636430690365, 1636430690812, 447, 8, 439, 8, 0, 8
6790, 1, 1636430690588, 1636430691036, 448, 5, 443, 4, 0, 4
6789, 1, 1636430690588, 1636430691040, 452, 1, 451, 0, 0, 0
6791, 1, 1636430690721, 1636430691165, 444, 0, 444, 0, 0, 0
6792, 1, 1636430690808, 1636430691257, 449, 0, 449, 0, 0, 0
6795, 1, 1636430691033, 1636430691481, 448, 0, 448, 0, 0, 0
6794, 1, 1636430691033, 1636430691481, 448, 4, 444, 3, 0, 3
6797, 1, 1636430691260, 1636430691708, 448, 1, 447, 0, 1, 1
6796, 1, 1636430691260, 1636430691708, 448, 1, 447, 0, 0, 0
6798, 1, 1636430691384, 1636430691833, 449, 0, 449, 0, 0, 0
6799, 1, 1636430691476, 1636430691924, 448, 0, 448, 0, 0, 0
6734, 1, 1636430684168, 1636430691928, 7760, 7313, 447, 7313, 0, 7313
6800, 1, 1636430691696, 1636430692149, 453, 0, 453, 0, 0, 0
6801, 1, 1636430691696, 1636430692156, 460, 13, 447, 13, 0, 13
6803, 1, 1636430691933, 1636430692376, 443, 0, 443, 0, 0, 0
6802, 1, 1636430691924, 1636430692376, 452, 1, 451, 1, 0, 1
6804, 1, 1636430692057, 1636430692504, 447, 0, 447, 0, 0, 0
6806, 1, 1636430692149, 1636430692592, 443, 0, 443, 0, 0, 0
6805, 1, 1636430692144, 1636430692593, 449, 1, 448, 0, 0, 0
6807, 1, 1636430692368, 1636430692813, 445, 0, 445, 0, 0, 0
6808, 1, 1636430692376, 1636430692820, 444, 1, 443, 1, 0, 1
6727, 2, 1636430682964, 1636430692964, 10000, 0, 10000, 969, 0, 969
6809, 1, 1636430692592, 1636430693040, 448, 1, 447, 0, 0, 0
6810, 1, 1636430692600, 1636430693040, 440, 0, 440, 0, 0, 0
6811, 1, 1636430692725, 1636430693188, 463, 0, 463, 0, 0, 0
6813, 1, 1636430692813, 1636430693277, 464, 0, 464, 0, 0, 0
6812, 1, 1636430692813, 1636430693277, 464, 0, 464, 0, 0, 0
6814, 1, 1636430693056, 1636430693504, 448, 1, 447, 0, 0, 0
6815, 1, 1636430693056, 1636430693504, 448, 1, 447, 0, 0, 0
6817, 1, 1636430693268, 1636430693720, 452, 1, 451, 1, 0, 1
6816, 1, 1636430693261, 1636430693724, 463, 16, 447, 16, 0, 16
6818, 1, 1636430693408, 1636430693856, 448, 1, 447, 1, 0, 1
6733, 2, 1636430683924, 1636430693928, 10004, 0, 10004, 9, 0, 9
6819, 1, 1636430693496, 1636430693940, 444, 0, 444, 0, 0, 0
6820, 1, 1636430693501, 1636430693948, 447, 0, 447, 0, 0, 0
6821, 1, 1636430693724, 1636430694168, 444, 1, 443, 1, 0, 1
6822, 1, 1636430693724, 1636430694177, 453, 1, 452, 0, 0, 0
6824, 1, 1636430693973, 1636430694421, 448, 0, 448, 0, 0, 0
6823, 1, 1636430693973, 1636430694421, 448, 0, 448, 0, 0, 0
6738, 2, 1636430684428, 1636430694432, 10004, 0, 10004, 0, 0, 0
6827, 1, 1636430694168, 1636430694660, 492, 1, 491, 0, 0, 0
6826, 1, 1636430694165, 1636430694660, 495, 0, 495, 0, 0, 0
6828, 1, 1636430694241, 1636430694688, 447, 0, 447, 0, 0, 0
6830, 1, 1636430694392, 1636430694844, 452, 1, 451, 0, 1, 1
6831, 1, 1636430694400, 1636430694869, 469, 21, 448, 21, 0, 21
6740, 2, 1636430684973, 1636430694972, 9999, 0, 9999, 0, 0, 0
6832, 1, 1636430694644, 1636430695089, 445, 1, 444, 1, 0, 1
6833, 1, 1636430694644, 1636430695112, 468, 17, 451, 17, 0, 17
6829, 1, 1636430694241, 1636430695132, 891, 448, 443, 448, 0, 448
6835, 1, 1636430694881, 1636430695325, 444, 0, 444, 0, 0, 0
6836, 1, 1636430694881, 1636430695325, 444, 0, 444, 0, 0, 0
6837, 1, 1636430694904, 1636430695368, 464, 1, 463, 0, 0, 0
6838, 1, 1636430695060, 1636430695504, 444, 0, 444, 0, 0, 0
6744, 2, 1636430685541, 1636430695540, 9999, 0, 9999, 0, 0, 0
6839, 1, 1636430695089, 1636430695565, 476, 24, 452, 24, 0, 24
6834, 1, 1636430694732, 1636430695573, 841, 401, 440, 401, 0, 401
6841, 1, 1636430695313, 1636430695760, 447, 0, 447, 0, 0, 0
6842, 1, 1636430695328, 1636430695776, 448, 0, 448, 0, 0, 0
6843, 1, 1636430695348, 1636430695861, 513, 20, 493, 20, 0, 20
6840, 1, 1636430695277, 1636430696024, 747, 296, 451, 296, 0, 296
6844, 1, 1636430695588, 1636430696028, 440, 0, 440, 0, 0, 0
6845, 1, 1636430695592, 1636430696048, 456, 0, 456, 0, 0, 0
6747, 2, 1636430686057, 1636430696057, 10000, 0, 10000, 0, 0, 0
6846, 1, 1636430695632, 1636430696072, 440, 0, 440, 0, 0, 0
6847, 1, 1636430695732, 1636430696173, 441, 1, 440, 1, 0, 1
6848, 1, 1636430695789, 1636430696285, 496, 0, 496, 0, 0, 0
6849, 1, 1636430695789, 1636430696316, 527, 72, 455, 72, 0, 72
6850, 1, 1636430695848, 1636430696465, 617, 177, 440, 177, 0, 177
6851, 1, 1636430695980, 1636430696465, 485, 1, 484, 0, 0, 0
6852, 1, 1636430695996, 1636430696492, 496, 53, 443, 53, 0, 53
6853, 1, 1636430696100, 1636430696536, 436, 1, 435, 0, 0, 0
6752, 2, 1636430686544, 1636430696540, 9996, 0, 9996, 0, 0, 0
6855, 1, 1636430696248, 1636430696697, 449, 0, 449, 0, 0, 0
6856, 1, 1636430696264, 1636430696708, 444, 1, 443, 0, 0, 0
6854, 1, 1636430696244, 1636430696764, 520, 73, 447, 73, 0, 73
6857, 1, 1636430696285, 1636430696768, 483, 0, 483, 0, 0, 0
6859, 1, 1636430696396, 1636430696860, 464, 0, 464, 0, 0, 0
6860, 1, 1636430696500, 1636430696956, 456, 0, 456, 0, 0, 0
6858, 1, 1636430696364, 1636430696956, 592, 101, 491, 101, 0, 101
6861, 1, 1636430696533, 1636430696988, 455, 3, 452, 3, 0, 3
6757, 2, 1636430687060, 1636430697065, 10005, 0, 10005, 0, 0, 0
6863, 1, 1636430696720, 1636430697164, 444, 1, 443, 1, 0, 1
6862, 1, 1636430696716, 1636430697172, 456, 1, 455, 0, 0, 0
6865, 1, 1636430696756, 1636430697204, 448, 13, 435, 12, 1, 13
6864, 1, 1636430696720, 1636430697208, 488, 45, 443, 44, 0, 44
6758, 2, 1636430687236, 1636430697240, 10004, 0, 10004, 0, 0, 0
6868, 1, 1636430696932, 1636430697380, 448, 1, 447, 0, 0, 0
6867, 1, 1636430696913, 1636430697388, 475, 0, 475, 0, 0, 0
6866, 1, 1636430696848, 1636430697404, 556, 109, 447, 109, 0, 109
6870, 1, 1636430696984, 1636430697468, 484, 1, 483, 1, 0, 1
6869, 1, 1636430696984, 1636430697476, 492, 5, 487, 4, 1, 5
6871, 1, 1636430697112, 1636430697556, 444, 1, 443, 0, 0, 0
6873, 1, 1636430697180, 1636430697632, 452, 1, 451, 0, 0, 0
6872, 1, 1636430697180, 1636430697644, 464, 29, 435, 28, 0, 28
6763, 2, 1636430687688, 1636430697684, 9996, 0, 9996, 0, 0, 0
6874, 1, 1636430697284, 1636430697724, 440, 0, 440, 0, 0, 0
6875, 1, 1636430697368, 1636430697852, 484, 37, 447, 37, 0, 37
6876, 1, 1636430697416, 1636430697908, 492, 0, 492, 0, 0, 0
6878, 1, 1636430697420, 1636430697909, 489, 49, 440, 49, 0, 49
6877, 1, 1636430697428, 1636430697909, 481, 0, 481, 0, 0, 0
6879, 1, 1636430697428, 1636430697932, 504, 49, 455, 48, 1, 49
6880, 1, 1636430697545, 1636430697996, 451, 0, 451, 0, 0, 0
6881, 1, 1636430697596, 1636430698033, 437, 1, 436, 0, 1, 1
6882, 1, 1636430697604, 1636430698084, 480, 0, 480, 0, 0, 0
6883, 1, 1636430697620, 1636430698084, 464, 25, 439, 24, 1, 25
6884, 1, 1636430697680, 1636430698125, 445, 0, 445, 0, 0, 0
6885, 1, 1636430697728, 1636430698176, 448, 0, 448, 0, 0, 0
6886, 1, 1636430697772, 1636430698213, 441, 0, 441, 0, 0, 0
6887, 1, 1636430697856, 1636430698352, 496, 53, 443, 53, 0, 53
6889, 1, 1636430697945, 1636430698388, 443, 0, 443, 0, 0, 0
6888, 1, 1636430697864, 1636430698392, 528, 69, 459, 69, 0, 69
6890, 1, 1636430697996, 1636430698444, 448, 1, 447, 0, 0, 0
6891, 1, 1636430698072, 1636430698540, 468, 13, 455, 13, 0, 13
6893, 1, 1636430698128, 1636430698572, 444, 0, 444, 0, 0, 0
6892, 1, 1636430698125, 1636430698572, 447, 0, 447, 0, 0, 0
6894, 1, 1636430698136, 1636430698576, 440, 0, 440, 0, 0, 0
6895, 1, 1636430698152, 1636430698620, 468, 25, 443, 24, 0, 24
6896, 1, 1636430698216, 1636430698660, 444, 1, 443, 0, 0, 0
6897, 1, 1636430698268, 1636430698712, 444, 0, 444, 0, 0, 0
6898, 1, 1636430698304, 1636430698752, 448, 1, 447, 0, 0, 0
6900, 1, 1636430698352, 1636430698804, 452, 0, 452, 0, 0, 0
6901, 1, 1636430698396, 1636430698844, 448, 0, 448, 0, 0, 0
6899, 1, 1636430698304, 1636430698844, 540, 89, 451, 89, 0, 89
6902, 1, 1636430698444, 1636430698896, 452, 1, 451, 0, 0, 0
6903, 1, 1636430698568, 1636430699012, 444, 5, 439, 5, 0, 5
6904, 1, 1636430698613, 1636430699061, 448, 0, 448, 0, 0, 0
6905, 1, 1636430698613, 1636430699064, 451, 8, 443, 8, 0, 8
6906, 1, 1636430698664, 1636430699104, 440, 0, 440, 0, 0, 0
6908, 1, 1636430698793, 1636430699240, 447, 0, 447, 0, 0, 0
6910, 1, 1636430698800, 1636430699244, 444, 4, 440, 4, 0, 4
6909, 1, 1636430698800, 1636430699244, 444, 0, 444, 0, 0, 0
6911, 1, 1636430698840, 1636430699284, 444, 5, 439, 5, 0, 5
6907, 1, 1636430698760, 1636430699309, 549, 85, 464, 85, 0, 85
6913, 1, 1636430698928, 1636430699381, 453, 0, 453, 0, 0, 0
6914, 1, 1636430698968, 1636430699424, 456, 1, 455, 0, 1, 1
6915, 1, 1636430699020, 1636430699460, 440, 0, 440, 0, 0, 0
6917, 1, 1636430699064, 1636430699512, 448, 0, 448, 0, 0, 0
6916, 1, 1636430699060, 1636430699516, 456, 5, 451, 4, 0, 4
6918, 1, 1636430699120, 1636430699549, 429, 1, 428, 1, 0, 1
6919, 1, 1636430699236, 1636430699685, 449, 5, 444, 5, 0, 5
6912, 1, 1636430698880, 1636430699688, 808, 365, 443, 365, 0, 365
6921, 1, 1636430699280, 1636430699728, 448, 5, 443, 5, 0, 5
6923, 1, 1636430699457, 1636430699908, 451, 0, 451, 0, 0, 0
6924, 1, 1636430699472, 1636430699908, 436, 0, 436, 0, 0, 0
6925, 1, 1636430699468, 1636430699908, 440, 0, 440, 0, 0, 0
6926, 1, 1636430699504, 1636430699948, 444, 9, 435, 9, 0, 9
6927, 1, 1636430699532, 1636430699981, 449, 1, 448, 1, 0, 1
6928, 1, 1636430699600, 1636430700036, 436, 0, 436, 0, 0, 0
6929, 1, 1636430699644, 1636430700092, 448, 0, 448, 0, 0, 0
6930, 1, 1636430699688, 1636430700132, 444, 0, 444, 0, 0, 0
6784, 2, 1636430690136, 1636430700136, 10000, 0, 10000, 1, 0, 1
6932, 1, 1636430699728, 1636430700172, 444, 1, 443, 1, 0, 1
6933, 1, 1636430699780, 1636430700220, 440, 0, 440, 0, 0, 0
6934, 1, 1636430699912, 1636430700360, 448, 0, 448, 0, 0, 0
6935, 1, 1636430699912, 1636430700364, 452, 0, 452, 0, 0, 0
6936, 1, 1636430699944, 1636430700401, 457, 5, 452, 5, 0, 5
6937, 1, 1636430700128, 1636430700576, 448, 1, 447, 0, 0, 0
6938, 1, 1636430700180, 1636430700617, 437, 0, 437, 0, 0, 0
6939, 1, 1636430700184, 1636430700637, 453, 0, 453, 0, 0, 0
6941, 1, 1636430700224, 1636430700664, 440, 0, 440, 0, 0, 0
6942, 1, 1636430700264, 1636430700708, 444, 0, 444, 0, 0, 0
6944, 1, 1636430700349, 1636430700797, 448, 0, 448, 0, 0, 0
6945, 1, 1636430700404, 1636430700840, 436, 0, 436, 0, 0, 0
6947, 1, 1636430700444, 1636430700896, 452, 1, 451, 1, 0, 1
6946, 1, 1636430700444, 1636430700896, 452, 1, 451, 0, 0, 0
6948, 1, 1636430700576, 1636430701020, 444, 0, 444, 0, 0, 0
6793, 2, 1636430691025, 1636430701020, 9995, 0, 9995, 0, 0, 0
6949, 1, 1636430700580, 1636430701024, 444, 0, 444, 0, 0, 0
6951, 1, 1636430700792, 1636430701244, 452, 0, 452, 0, 0, 0
6952, 1, 1636430700836, 1636430701280, 444, 0, 444, 0, 0, 0
6953, 1, 1636430700860, 1636430701336, 476, 0, 476, 0, 0, 0
6954, 1, 1636430700884, 1636430701340, 456, 1, 455, 0, 0, 0
6955, 1, 1636430700932, 1636430701380, 448, 1, 447, 0, 1, 1
6956, 1, 1636430701016, 1636430701461, 445, 1, 444, 0, 1, 1
6958, 1, 1636430701112, 1636430701548, 436, 0, 436, 0, 0, 0
6959, 1, 1636430701116, 1636430701560, 444, 0, 444, 0, 0, 0
6960, 1, 1636430701240, 1636430701688, 448, 5, 443, 5, 0, 5
6961, 1, 1636430701244, 1636430701700, 456, 0, 456, 0, 0, 0
6962, 1, 1636430701324, 1636430701772, 448, 0, 448, 0, 0, 0
6963, 1, 1636430701461, 1636430701905, 444, 0, 444, 0, 0, 0
6964, 1, 1636430701500, 1636430701937, 437, 0, 437, 0, 0, 0
6965, 1, 1636430701560, 1636430701996, 436, 1, 435, 0, 1, 1
6967, 1, 1636430701596, 1636430702036, 440, 0, 440, 0, 0, 0
6968, 1, 1636430701680, 1636430702133, 453, 1, 452, 0, 1, 1
6969, 1, 1636430701784, 1636430702237, 453, 1, 452, 0, 0, 0
6971, 1, 1636430701904, 1636430702364, 460, 1, 459, 0, 0, 0
6972, 1, 1636430701917, 1636430702376, 459, 0, 459, 0, 0, 0
6973, 1, 1636430701992, 1636430702441, 449, 1, 448, 1, 0, 1
6974, 1, 1636430702128, 1636430702576, 448, 0, 448, 0, 0, 0
6976, 1, 1636430702224, 1636430702673, 449, 0, 449, 0, 0, 0
6977, 1, 1636430702264, 1636430702717, 453, 1, 452, 1, 0, 1
6978, 1, 1636430702352, 1636430702804, 452, 1, 451, 1, 0, 1
6979, 1, 1636430702460, 1636430702908, 448, 1, 447, 1, 0, 1
6980, 1, 1636430702588, 1636430703032, 444, 0, 444, 0, 0, 0
6981, 1, 1636430702596, 1636430703057, 461, 0, 461, 0, 0, 0
6983, 1, 1636430702793, 1636430703248, 455, 0, 455, 0, 0, 0
6984, 1, 1636430702892, 1636430703336, 444, 0, 444, 0, 0, 0
6985, 1, 1636430702936, 1636430703392, 456, 0, 456, 0, 0, 0
6987, 1, 1636430703129, 1636430703585, 456, 0, 456, 0, 0, 0
6988, 1, 1636430703252, 1636430703692, 440, 0, 440, 0, 0, 0
6989, 1, 1636430703280, 1636430703732, 452, 1, 451, 0, 0, 0
6990, 1, 1636430703472, 1636430703908, 436, 1, 435, 1, 0, 1
6991, 1, 1636430703557, 1636430704005, 448, 0, 448, 0, 0, 0
6992, 1, 1636430703616, 1636430704064, 448, 1, 447, 0, 0, 0
6825, 2, 1636430694109, 1636430704108, 9999, 0, 9999, 0, 0, 0
6993, 1, 1636430703804, 1636430704252, 448, 1, 447, 1, 0, 1
6994, 1, 1636430703920, 1636430704365, 445, 1, 444, 0, 0, 0
6995, 1, 1636430703949, 1636430704424, 475, 0, 475, 0, 0, 0
6996, 1, 1636430704153, 1636430704604, 451, 0, 451, 0, 0, 0
6997, 1, 1636430704229, 1636430704677, 448, 0, 448, 0, 0, 0
6998, 1, 1636430704288, 1636430704736, 448, 1, 447, 1, 0, 1
6999, 1, 1636430704420, 1636430704868, 448, 1, 447, 1, 0, 1
7000, 1, 1636430704468, 1636430704912, 444, 0, 444, 0, 0, 0
7001, 1, 1636430704592, 1636430705049, 457, 13, 444, 13, 0, 13
7002, 1, 1636430704641, 1636430705092, 451, 0, 451, 0, 0, 0
7003, 1, 1636430704821, 1636430705268, 447, 0, 447, 0, 0, 0
7004, 1, 1636430704897, 1636430705345, 448, 0, 448, 0, 0, 0
7005, 1, 1636430704952, 1636430705400, 448, 1, 447, 0, 1, 1
7006, 1, 1636430705088, 1636430705536, 448, 1, 447, 0, 0, 0
7007, 1, 1636430705136, 1636430705576, 440, 0, 440, 0, 0, 0
7008, 1, 1636430705272, 1636430705716, 444, 0, 444, 0, 0, 0
7009, 1, 1636430705312, 1636430705757, 445, 1, 444, 0, 0, 0
7010, 1, 1636430705485, 1636430705929, 444, 0, 444, 0, 0, 0
7011, 1, 1636430705569, 1636430706013, 444, 0, 444, 0, 0, 0
7012, 1, 1636430705620, 1636430706068, 448, 1, 447, 1, 0, 1
7014, 1, 1636430705808, 1636430706257, 449, 1, 448, 1, 0, 1
7015, 1, 1636430705932, 1636430706376, 444, 1, 443, 0, 0, 0
7016, 1, 1636430705976, 1636430706420, 444, 1, 443, 0, 0, 0
7017, 1, 1636430706156, 1636430706596, 440, 1, 439, 0, 0, 0
7018, 1, 1636430706237, 1636430706684, 447, 0, 447, 0, 0, 0
7019, 1, 1636430706289, 1636430706736, 447, 0, 447, 0, 0, 0
7020, 1, 1636430706480, 1636430706929, 449, 1, 448, 1, 0, 1
7021, 1, 1636430706605, 1636430707049, 444, 0, 444, 0, 0, 0
7022, 1, 1636430706640, 1636430707089, 449, 0, 449, 0, 0, 0
7023, 1, 1636430706821, 1636430707265, 444, 0, 444, 0, 0, 0
7025, 1, 1636430706956, 1636430707405, 449, 1, 448, 0, 0, 0
7024, 1, 1636430706904, 1636430707540, 636, 185, 451, 185, 0, 185
7026, 1, 1636430707144, 1636430707584, 440, 1, 439, 1, 0, 1
7027, 1, 1636430707272, 1636430707737, 465, 0, 465, 0, 0, 0
7029, 1, 1636430707489, 1636430707940, 451, 0, 451, 0, 0, 0
7028, 1, 1636430707312, 1636430708033, 721, 273, 448, 273, 0, 273
7030, 1, 1636430707624, 1636430708072, 448, 0, 448, 0, 0, 0
7031, 1, 1636430707760, 1636430708208, 448, 1, 447, 0, 1, 1
7032, 1, 1636430707812, 1636430708249, 437, 1, 436, 1, 0, 1
7033, 1, 1636430707965, 1636430708409, 444, 0, 444, 0, 0, 0
7034, 1, 1636430708161, 1636430708608, 447, 0, 447, 0, 0, 0
7035, 1, 1636430708249, 1636430708700, 451, 0, 451, 0, 0, 0
7036, 1, 1636430708300, 1636430708748, 448, 1, 447, 0, 1, 1
7037, 1, 1636430708429, 1636430708872, 443, 0, 443, 0, 0, 0
7038, 1, 1636430708480, 1636430708928, 448, 1, 447, 0, 1, 1
7039, 1, 1636430708628, 1636430709080, 452, 0, 452, 0, 0, 0
6920, 2, 1636430699276, 1636430709281, 10005, 0, 10005, 413, 0, 413
7040, 1, 1636430708832, 1636430709288, 456, 0, 456, 0, 0, 0
6922, 2, 1636430699332, 1636430709337, 10005, 0, 10005, 357, 0, 357
7041, 1, 1636430708916, 1636430709357, 441, 0, 441, 0, 0, 0
7042, 1, 1636430708972, 1636430709412, 440, 0, 440, 0, 0, 0
7043, 1, 1636430709097, 1636430709560, 463, 0, 463, 0, 0, 0
7044, 1, 1636430709148, 1636430709597, 449, 1, 448, 1, 0, 1
6931, 2, 1636430699728, 1636430709728, 10000, 0, 10000, 1, 0, 1
7045, 1, 1636430709324, 1636430709772, 448, 1, 447, 0, 0, 0
7046, 1, 1636430709513, 1636430709960, 447, 0, 447, 0, 0, 0
7047, 1, 1636430709581, 1636430710040, 459, 0, 459, 0, 0, 0
7048, 1, 1636430709636, 1636430710080, 444, 1, 443, 0, 0, 0
6940, 2, 1636430700184, 1636430710180, 9996, 0, 9996, 0, 0, 0
7049, 1, 1636430709776, 1636430710212, 436, 0, 436, 0, 0, 0
7050, 1, 1636430709816, 1636430710252, 436, 0, 436, 0, 0, 0
6943, 2, 1636430700316, 1636430710320, 10004, 0, 10004, 0, 0, 0
7052, 1, 1636430709996, 1636430710433, 437, 0, 437, 0, 0, 0
7051, 1, 1636430709988, 1636430710436, 448, 1, 447, 0, 0, 0
6950, 2, 1636430700616, 1636430710617, 10001, 0, 10001, 0, 0, 0
7055, 1, 1636430710176, 1636430710640, 464, 1, 463, 0, 0, 0
7056, 1, 1636430710272, 1636430710724, 452, 1, 451, 0, 0, 0
7057, 1, 1636430710296, 1636430710748, 452, 0, 452, 0, 0, 0
7054, 1, 1636430710032, 1636430710924, 892, 401, 491, 401, 0, 401
7053, 1, 1636430709996, 1636430710928, 932, 441, 491, 441, 0, 441
7058, 1, 1636430710444, 1636430710928, 484, 1, 483, 0, 0, 0
7060, 1, 1636430710508, 1636430710949, 441, 1, 440, 1, 0, 1
7061, 1, 1636430710616, 1636430711060, 444, 1, 443, 1, 0, 1
6957, 2, 1636430701064, 1636430711068, 10004, 0, 10004, 0, 0, 0
7062, 1, 1636430710660, 1636430711116, 456, 1, 455, 1, 0, 1
7063, 1, 1636430710660, 1636430711116, 456, 1, 455, 0, 1, 1
7064, 1, 1636430710857, 1636430711304, 447, 0, 447, 0, 0, 0
7065, 1, 1636430710924, 1636430711380, 456, 1, 455, 1, 0, 1
7067, 1, 1636430710968, 1636430711417, 449, 0, 449, 0, 0, 0
7066, 1, 1636430710956, 1636430711417, 461, 1, 460, 1, 0, 1
6966, 2, 1636430701564, 1636430711564, 10000, 0, 10000, 0, 0, 0
7070, 1, 1636430711160, 1636430711596, 436, 1, 435, 1, 0, 1
7071, 1, 1636430711168, 1636430711616, 448, 0, 448, 0, 0, 0
7068, 1, 1636430711160, 1636430711620, 460, 1, 459, 0, 1, 1
7069, 1, 1636430711160, 1636430711620, 460, 1, 459, 1, 0, 1
7072, 1, 1636430711284, 1636430711732, 448, 1, 447, 0, 0, 0
6970, 2, 1636430701784, 1636430711784, 10000, 0, 10000, 0, 0, 0
7074, 1, 1636430711332, 1636430711788, 456, 1, 455, 0, 0, 0
7073, 1, 1636430711332, 1636430711788, 456, 1, 455, 0, 0, 0
7076, 1, 1636430711520, 1636430712012, 492, 0, 492, 0, 0, 0
7077, 1, 1636430711616, 1636430712092, 476, 5, 471, 4, 1, 5
7078, 1, 1636430711653, 1636430712101, 448, 0, 448, 0, 0, 0
7079, 1, 1636430711653, 1636430712101, 448, 0, 448, 0, 0, 0
6975, 2, 1636430702172, 1636430712172, 10000, 0, 10000, 0, 0, 0
7081, 1, 1636430711832, 1636430712268, 436, 0, 436, 0, 0, 0
7080, 1, 1636430711828, 1636430712272, 444, 0, 444, 0, 0, 0
7083, 1, 1636430711876, 1636430712321, 445, 0, 445, 0, 0, 0
7082, 1, 1636430711872, 1636430712321, 449, 0, 449, 0, 0, 0
7087, 1, 1636430712012, 1636430712488, 476, 0, 476, 0, 0, 0
7086, 1, 1636430712016, 1636430712488, 472, 0, 472, 0, 0, 0
7088, 1, 1636430712084, 1636430712576, 492, 0, 492, 0, 0, 0
6986, 1, 1636430703021, 1636430712620, 9599, 9152, 447, 0, 9152, 9152
6982, 2, 1636430702657, 1636430712657, 10000, 0, 10000, 0, 0, 0
7089, 1, 1636430712260, 1636430712708, 448, 1, 447, 1, 0, 1
7092, 1, 1636430712356, 1636430712804, 448, 1, 447, 1, 0, 1
7090, 1, 1636430712356, 1636430712804, 448, 1, 447, 0, 0, 0
7091, 1, 1636430712356, 1636430712804, 448, 1, 447, 0, 0, 0
7094, 1, 1636430712492, 1636430712968, 476, 0, 476, 0, 0, 0
7093, 1, 1636430712476, 1636430712972, 496, 0, 496, 0, 0, 0
7095, 1, 1636430712508, 1636430712972, 464, 1, 463, 1, 0, 1
7096, 1, 1636430712536, 1636430712976, 440, 0, 440, 0, 0, 0
7097, 1, 1636430712548, 1636430712992, 444, 1, 443, 0, 1, 1
7099, 1, 1636430712705, 1636430713152, 447, 4, 443, 3, 0, 3
7098, 1, 1636430712705, 1636430713152, 447, 0, 447, 0, 0, 0
7100, 1, 1636430712828, 1636430713272, 444, 0, 444, 0, 0, 0
7102, 1, 1636430712920, 1636430713368, 448, 0, 448, 0, 0, 0
7103, 1, 1636430712960, 1636430713404, 444, 0, 444, 0, 0, 0
7101, 1, 1636430712832, 1636430713420, 588, 141, 447, 140, 0, 140
7104, 1, 1636430713028, 1636430713485, 457, 1, 456, 0, 0, 0
7105, 1, 1636430713028, 1636430713485, 457, 1, 456, 0, 0, 0
7106, 1, 1636430713028, 1636430713492, 464, 1, 463, 0, 0, 0
7107, 1, 1636430713188, 1636430713637, 449, 0, 449, 0, 0, 0
7109, 1, 1636430713196, 1636430713649, 453, 1, 452, 0, 0, 0
7110, 1, 1636430713204, 1636430713652, 448, 0, 448, 0, 0, 0
7108, 1, 1636430713196, 1636430713656, 460, 1, 459, 0, 1, 1
7111, 1, 1636430713212, 1636430713660, 448, 0, 448, 0, 0, 0
7113, 1, 1636430713376, 1636430713832, 456, 1, 455, 1, 0, 1
7112, 1, 1636430713376, 1636430713832, 456, 1, 455, 0, 0, 0
7114, 1, 1636430713501, 1636430713952, 451, 0, 451, 0, 0, 0
7115, 1, 1636430713589, 1636430714036, 447, 0, 447, 0, 0, 0
7116, 1, 1636430713620, 1636430714064, 444, 0, 444, 0, 0, 0
7117, 1, 1636430713644, 1636430714100, 456, 5, 451, 5, 0, 5
7118, 1, 1636430713708, 1636430714156, 448, 1, 447, 0, 0, 0
7120, 1, 1636430713712, 1636430714156, 444, 0, 444, 0, 0, 0
7119, 1, 1636430713708, 1636430714160, 452, 1, 451, 0, 0, 0
7121, 1, 1636430713861, 1636430714313, 452, 0, 452, 0, 0, 0
7124, 1, 1636430713876, 1636430714325, 449, 1, 448, 0, 1, 1
7123, 1, 1636430713876, 1636430714328, 452, 1, 451, 1, 0, 1
7125, 1, 1636430713876, 1636430714332, 456, 1, 455, 1, 0, 1
7127, 1, 1636430714052, 1636430714504, 452, 2, 450, 0, 0, 0
7126, 1, 1636430714052, 1636430714508, 456, 1, 455, 0, 0, 0
7128, 1, 1636430714172, 1636430714625, 453, 0, 453, 0, 0, 0
7129, 1, 1636430714252, 1636430714697, 445, 0, 445, 0, 0, 0
7130, 1, 1636430714296, 1636430714744, 448, 0, 448, 0, 0, 0
7132, 1, 1636430714381, 1636430714824, 443, 0, 443, 0, 0, 0
7133, 1, 1636430714381, 1636430714832, 451, 0, 451, 0, 0, 0
7134, 1, 1636430714381, 1636430714844, 463, 0, 463, 0, 0, 0
7135, 1, 1636430714536, 1636430714968, 432, 1, 431, 0, 0, 0
7138, 1, 1636430714556, 1636430714992, 436, 0, 436, 0, 0, 0
7137, 1, 1636430714548, 1636430714997, 449, 0, 449, 0, 0, 0
7136, 1, 1636430714548, 1636430714997, 449, 0, 449, 0, 0, 0
7139, 1, 1636430714721, 1636430715172, 451, 0, 451, 0, 0, 0
7140, 1, 1636430714729, 1636430715180, 451, 0, 451, 0, 0, 0
7141, 1, 1636430714836, 1636430715301, 465, 1, 464, 0, 0, 0
7142, 1, 1636430714920, 1636430715368, 448, 0, 448, 0, 0, 0
7143, 1, 1636430714964, 1636430715409, 445, 0, 445, 0, 0, 0
7144, 1, 1636430715040, 1636430715497, 457, 1, 456, 0, 0, 0
7145, 1, 1636430715052, 1636430715497, 445, 1, 444, 1, 0, 1
7146, 1, 1636430715064, 1636430715517, 453, 1, 452, 0, 1, 1
7147, 1, 1636430715196, 1636430715648, 452, 1, 451, 0, 0, 0
7150, 1, 1636430715224, 1636430715668, 444, 0, 444, 0, 0, 0
7149, 1, 1636430715224, 1636430715668, 444, 1, 443, 0, 0, 0
7013, 2, 1636430705757, 1636430715756, 9999, 0, 9999, 0, 0, 0
7151, 1, 1636430715397, 1636430715848, 451, 0, 451, 0, 0, 0
7152, 1, 1636430715401, 1636430715856, 455, 0, 455, 0, 0, 0
7153, 1, 1636430715529, 1636430715980, 451, 0, 451, 0, 0, 0
7154, 1, 1636430715588, 1636430716068, 480, 1, 479, 0, 1, 1
7155, 1, 1636430715624, 1636430716072, 448, 1, 447, 1, 0, 1
7157, 1, 1636430715716, 1636430716161, 445, 1, 444, 0, 0, 0
7156, 1, 1636430715712, 1636430716161, 449, 0, 449, 0, 0, 0
7158, 1, 1636430715748, 1636430716200, 452, 0, 452, 0, 0, 0
7159, 1, 1636430715868, 1636430716317, 449, 1, 448, 0, 0, 0
7160, 1, 1636430715892, 1636430716344, 452, 0, 452, 0, 0, 0
7161, 1, 1636430715936, 1636430716384, 448, 0, 448, 0, 0, 0
7162, 1, 1636430716072, 1636430716517, 445, 1, 444, 1, 0, 1
7163, 1, 1636430716072, 1636430716520, 448, 1, 447, 0, 1, 1
7165, 1, 1636430716208, 1636430716656, 448, 0, 448, 0, 0, 0
7166, 1, 1636430716285, 1636430716728, 443, 0, 443, 0, 0, 0
7167, 1, 1636430716297, 1636430716740, 443, 0, 443, 0, 0, 0
7168, 1, 1636430716381, 1636430716825, 444, 0, 444, 0, 0, 0
7169, 1, 1636430716384, 1636430716828, 444, 0, 444, 0, 0, 0
7170, 1, 1636430716420, 1636430716872, 452, 1, 451, 1, 0, 1
7171, 1, 1636430716540, 1636430716992, 452, 0, 452, 0, 0, 0
7174, 1, 1636430716736, 1636430717181, 445, 0, 445, 0, 0, 0
7175, 1, 1636430716740, 1636430717184, 444, 1, 443, 0, 1, 1
7176, 1, 1636430716868, 1636430717309, 441, 0, 441, 0, 0, 0
7177, 1, 1636430716952, 1636430717396, 444, 0, 444, 0, 0, 0
7178, 1, 1636430716960, 1636430717412, 452, 0, 452, 0, 0, 0
7180, 1, 1636430717048, 1636430717504, 456, 1, 455, 0, 1, 1
7181, 1, 1636430717092, 1636430717544, 452, 0, 452, 0, 0, 0
7182, 1, 1636430717217, 1636430717664, 447, 0, 447, 0, 0, 0
7184, 1, 1636430717409, 1636430717856, 447, 0, 447, 0, 0, 0
7183, 1, 1636430717409, 1636430717856, 447, 0, 447, 0, 0, 0
7185, 1, 1636430717537, 1636430717989, 452, 0, 452, 0, 0, 0
7187, 1, 1636430717625, 1636430718065, 440, 0, 440, 0, 0, 0
7186, 1, 1636430717620, 1636430718068, 448, 0, 448, 0, 0, 0
7188, 1, 1636430717724, 1636430718177, 453, 1, 452, 0, 0, 0
7189, 1, 1636430717768, 1636430718216, 448, 0, 448, 0, 0, 0
7190, 1, 1636430717885, 1636430718332, 447, 0, 447, 0, 0, 0
7192, 1, 1636430718077, 1636430718520, 443, 0, 443, 0, 0, 0
7191, 1, 1636430718077, 1636430718528, 451, 0, 451, 0, 0, 0
7193, 1, 1636430718208, 1636430718649, 441, 1, 440, 1, 0, 1
7195, 1, 1636430718297, 1636430718737, 440, 0, 440, 0, 0, 0
7194, 1, 1636430718288, 1636430718740, 452, 1, 451, 0, 0, 0
7196, 1, 1636430718392, 1636430718837, 445, 1, 444, 0, 0, 0
7197, 1, 1636430718444, 1636430718897, 453, 1, 452, 0, 0, 0
7198, 1, 1636430718552, 1636430719001, 449, 1, 448, 1, 0, 1
7199, 1, 1636430718740, 1636430719193, 453, 1, 452, 1, 0, 1
7200, 1, 1636430718748, 1636430719196, 448, 1, 447, 1, 0, 1
7201, 1, 1636430718872, 1636430719325, 453, 1, 452, 1, 0, 1
7203, 1, 1636430718961, 1636430719409, 448, 0, 448, 0, 0, 0
7204, 1, 1636430719064, 1636430719509, 445, 1, 444, 1, 0, 1
7205, 1, 1636430719116, 1636430719565, 449, 1, 448, 1, 0, 1
7206, 1, 1636430719221, 1636430719669, 448, 0, 448, 0, 0, 0
7208, 1, 1636430719420, 1636430719873, 453, 1, 452, 0, 0, 0
7209, 1, 1636430719544, 1636430719993, 449, 1, 448, 0, 0, 0
7210, 1, 1636430719633, 1636430720081, 448, 0, 448, 0, 0, 0
7211, 1, 1636430719729, 1636430720177, 448, 0, 448, 0, 0, 0
7212, 1, 1636430719789, 1636430720237, 448, 0, 448, 0, 0, 0
7213, 1, 1636430719897, 1636430720348, 451, 0, 451, 0, 0, 0
7059, 2, 1636430710496, 1636430720501, 10005, 0, 10005, 884, 0, 884
7214, 1, 1636430720093, 1636430720544, 451, 0, 451, 0, 0, 0
7215, 1, 1636430720212, 1636430720660, 448, 1, 447, 0, 0, 0
7216, 1, 1636430720301, 1636430720753, 452, 0, 452, 0, 0, 0
7217, 1, 1636430720404, 1636430720853, 449, 1, 448, 1, 0, 1
7218, 1, 1636430720460, 1636430720905, 445, 1, 444, 0, 1, 1
7219, 1, 1636430720588, 1636430721048, 460, 0, 460, 0, 0, 0
7220, 1, 1636430720764, 1636430721208, 444, 1, 443, 0, 0, 0
7221, 1, 1636430720880, 1636430721329, 449, 1, 448, 0, 0, 0
7075, 2, 1636430711368, 1636430721369, 10001, 0, 10001, 13, 0, 13
7222, 1, 1636430720976, 1636430721432, 456, 1, 455, 0, 0, 0
7223, 1, 1636430721076, 1636430721524, 448, 1, 447, 0, 1, 1
7225, 1, 1636430721268, 1636430721716, 448, 1, 447, 0, 0, 0
7084, 1, 1636430711876, 1636430721812, 9936, 9493, 443, 0, 9493, 9493
7226, 1, 1636430721456, 1636430721905, 449, 0, 449, 0, 0, 0
7085, 2, 1636430711957, 1636430721960, 10003, 0, 10003, 0, 0, 0
7224, 1, 1636430721128, 1636430721973, 845, 397, 448, 397, 0, 397
7227, 1, 1636430721544, 1636430721980, 436, 1, 435, 0, 0, 0
7228, 1, 1636430721648, 1636430722096, 448, 0, 448, 0, 0, 0
7231, 1, 1636430721740, 1636430722180, 440, 0, 440, 0, 0, 0
7229, 1, 1636430721692, 1636430722180, 488, 1, 487, 0, 0, 0
7232, 1, 1636430721937, 1636430722385, 448, 0, 448, 0, 0, 0
7234, 1, 1636430722140, 1636430722581, 441, 0, 441, 0, 0, 0
7235, 1, 1636430722188, 1636430722644, 456, 0, 456, 0, 0, 0
7237, 1, 1636430722260, 1636430722708, 448, 0, 448, 0, 0, 0
7238, 1, 1636430722316, 1636430722764, 448, 0, 448, 0, 0, 0
7236, 1, 1636430722208, 1636430722840, 632, 177, 455, 177, 0, 177
7239, 1, 1636430722404, 1636430722853, 449, 1, 448, 0, 0, 0
7240, 1, 1636430722408, 1636430722861, 453, 0, 453, 0, 0, 0
7241, 1, 1636430722609, 1636430723057, 448, 0, 448, 0, 0, 0
7242, 1, 1636430722804, 1636430723252, 448, 1, 447, 0, 1, 1
7243, 1, 1636430722869, 1636430723316, 447, 0, 447, 0, 0, 0
7245, 1, 1636430722985, 1636430723441, 456, 0, 456, 0, 0, 0
7246, 1, 1636430723056, 1636430723509, 453, 1, 452, 0, 0, 0
7247, 1, 1636430723073, 1636430723520, 447, 0, 447, 0, 0, 0
7249, 1, 1636430723273, 1636430723712, 439, 0, 439, 0, 0, 0
7244, 1, 1636430722928, 1636430723752, 824, 389, 435, 389, 0, 389
7122, 2, 1636430713868, 1636430723872, 10004, 0, 10004, 0, 0, 0
7248, 1, 1636430723084, 1636430723889, 805, 357, 448, 357, 0, 357
7251, 1, 1636430723532, 1636430723984, 452, 1, 451, 0, 0, 0
7252, 1, 1636430723664, 1636430724116, 452, 1, 451, 0, 0, 0
7253, 1, 1636430723729, 1636430724193, 464, 0, 464, 0, 0, 0
7254, 1, 1636430723741, 1636430724193, 452, 0, 452, 0, 0, 0
7131, 2, 1636430714321, 1636430724321, 10000, 0, 10000, 0, 0, 0
7250, 1, 1636430723473, 1636430724352, 879, 416, 463, 416, 0, 416
7256, 1, 1636430723972, 1636430724420, 448, 1, 447, 0, 0, 0
7257, 1, 1636430724113, 1636430724565, 452, 0, 452, 0, 0, 0
7258, 1, 1636430724180, 1636430724636, 456, 1, 455, 0, 1, 1
7260, 1, 1636430724372, 1636430724816, 444, 0, 444, 0, 0, 0
7261, 1, 1636430724409, 1636430724857, 448, 0, 448, 0, 0, 0
7262, 1, 1636430724413, 1636430724864, 451, 0, 451, 0, 0, 0
7263, 1, 1636430724573, 1636430725021, 448, 0, 448, 0, 0, 0
7265, 1, 1636430724636, 1636430725080, 444, 0, 444, 0, 0, 0
7264, 1, 1636430724625, 1636430725080, 455, 11, 444, 11, 0, 11
7148, 2, 1636430715216, 1636430725216, 10000, 0, 10000, 0, 0, 0
7266, 1, 1636430724784, 1636430725232, 448, 1, 447, 0, 0, 0
7267, 1, 1636430724857, 1636430725308, 451, 0, 451, 0, 0, 0
7268, 1, 1636430725032, 1636430725481, 449, 1, 448, 0, 1, 1
7270, 1, 1636430725084, 1636430725528, 444, 0, 444, 0, 0, 0
7269, 1, 1636430725076, 1636430725528, 452, 0, 452, 0, 0, 0
7271, 1, 1636430725260, 1636430725704, 444, 0, 444, 0, 0, 0
7272, 1, 1636430725304, 1636430725748, 444, 5, 439, 4, 0, 4
7273, 1, 1636430725304, 1636430725760, 456, 0, 456, 0, 0, 0
7274, 1, 1636430725453, 1636430725900, 447, 0, 447, 0, 0, 0
7276, 1, 1636430725525, 1636430725972, 447, 0, 447, 0, 0, 0
7275, 1, 1636430725521, 1636430725980, 459, 0, 459, 0, 0, 0
7164, 2, 1636430716076, 1636430726077, 10001, 0, 10001, 0, 0, 0
7277, 1, 1636430725701, 1636430726145, 444, 0, 444, 0, 0, 0
7279, 1, 1636430725748, 1636430726200, 452, 1, 451, 1, 0, 1
7280, 1, 1636430725924, 1636430726388, 464, 0, 464, 0, 0, 0
7281, 1, 1636430725961, 1636430726416, 455, 12, 443, 12, 0, 12
7282, 1, 1636430725980, 1636430726424, 444, 0, 444, 0, 0, 0
7179, 1, 1636430717044, 1636430726520, 9476, 9033, 443, 0, 9032, 9032
7283, 1, 1636430726120, 1636430726560, 440, 0, 440, 0, 0, 0
7172, 2, 1636430716572, 1636430726573, 10001, 0, 10001, 257, 0, 257
7173, 2, 1636430716600, 1636430726621, 10021, 0, 10021, 229, 0, 229
7284, 1, 1636430726193, 1636430726632, 439, 0, 439, 0, 0, 0
7285, 1, 1636430726200, 1636430726640, 440, 1, 439, 0, 0, 0
7287, 1, 1636430726384, 1636430726848, 464, 1, 463, 1, 0, 1
7286, 1, 1636430726368, 1636430726852, 484, 1, 483, 1, 0, 1
7288, 1, 1636430726416, 1636430726936, 520, 1, 519, 0, 1, 1
7290, 1, 1636430726668, 1636430727120, 452, 0, 452, 0, 0, 0
7289, 1, 1636430726668, 1636430727121, 453, 1, 452, 0, 0, 0
7291, 1, 1636430726668, 1636430727120, 452, 0, 452, 0, 0, 0
7293, 1, 1636430726801, 1636430727252, 451, 0, 451, 0, 0, 0
7292, 1, 1636430726756, 1636430727292, 536, 93, 443, 93, 0, 93
7294, 1, 1636430726856, 1636430727296, 440, 0, 440, 0, 0, 0
7295, 1, 1636430726864, 1636430727316, 452, 0, 452, 0, 0, 0
7297, 1, 1636430727068, 1636430727516, 448, 1, 447, 0, 1, 1
7296, 1, 1636430727068, 1636430727520, 452, 0, 452, 0, 0, 0
7299, 1, 1636430727137, 1636430727593, 456, 0, 456, 0, 0, 0
7300, 1, 1636430727152, 1636430727593, 441, 1, 440, 0, 0, 0
7301, 1, 1636430727332, 1636430727772, 440, 1, 439, 0, 0, 0
7302, 1, 1636430727336, 1636430727780, 444, 0, 444, 0, 0, 0
7303, 1, 1636430727340, 1636430727792, 452, 0, 452, 0, 0, 0
7304, 1, 1636430727472, 1636430727921, 449, 0, 449, 0, 0, 0
7307, 1, 1636430727537, 1636430727988, 451, 0, 451, 0, 0, 0
7308, 1, 1636430727740, 1636430728189, 449, 0, 449, 0, 0, 0
7306, 1, 1636430727528, 1636430728225, 697, 253, 444, 253, 0, 253
7310, 1, 1636430727816, 1636430728260, 444, 0, 444, 0, 0, 0
7311, 1, 1636430727821, 1636430728260, 439, 0, 439, 0, 0, 0
7313, 1, 1636430728009, 1636430728460, 451, 0, 451, 0, 0, 0
7314, 1, 1636430728012, 1636430728472, 460, 0, 460, 0, 0, 0
7315, 1, 1636430728148, 1636430728600, 452, 0, 452, 0, 0, 0
7316, 1, 1636430728209, 1636430728652, 443, 0, 443, 0, 0, 0
7312, 1, 1636430728009, 1636430728673, 664, 216, 448, 216, 0, 216
7317, 1, 1636430728408, 1636430728853, 445, 1, 444, 1, 0, 1
7318, 1, 1636430728444, 1636430728912, 468, 17, 451, 17, 0, 17
7319, 1, 1636430728485, 1636430728933, 448, 0, 448, 0, 0, 0
7202, 2, 1636430718961, 1636430728957, 9996, 0, 9996, 0, 0, 0
7321, 1, 1636430728680, 1636430729125, 445, 0, 445, 0, 0, 0
7322, 1, 1636430728692, 1636430729181, 489, 0, 489, 0, 0, 0
7324, 1, 1636430728869, 1636430729321, 452, 0, 452, 0, 0, 0
7325, 1, 1636430728889, 1636430729364, 475, 24, 451, 24, 0, 24
7207, 2, 1636430719409, 1636430729409, 10000, 0, 10000, 0, 0, 0
7326, 1, 1636430729076, 1636430729529, 453, 0, 453, 0, 0, 0
7328, 1, 1636430729148, 1636430729636, 488, 1, 487, 0, 0, 0
7327, 1, 1636430729140, 1636430729640, 500, 0, 500, 0, 0, 0
7329, 1, 1636430729264, 1636430729724, 460, 1, 459, 0, 0, 0
7330, 1, 1636430729345, 1636430729816, 471, 0, 471, 0, 0, 0
7331, 1, 1636430729400, 1636430729852, 452, 1, 451, 0, 1, 1
7333, 1, 1636430729589, 1636430730032, 443, 0, 443, 0, 0, 0
7332, 1, 1636430729589, 1636430730080, 491, 52, 439, 52, 0, 52
7334, 1, 1636430729717, 1636430730168, 451, 8, 443, 8, 0, 8
7335, 1, 1636430729752, 1636430730205, 453, 0, 453, 0, 0, 0
7337, 1, 1636430729856, 1636430730297, 441, 0, 441, 0, 0, 0
7336, 1, 1636430729852, 1636430730297, 445, 0, 445, 0, 0, 0
7338, 1, 1636430729941, 1636430730393, 452, 0, 452, 0, 0, 0
7339, 1, 1636430730032, 1636430730480, 448, 1, 447, 1, 0, 1
7340, 1, 1636430730073, 1636430730517, 444, 0, 444, 0, 0, 0
7342, 1, 1636430730300, 1636430730756, 456, 0, 456, 0, 0, 0
7343, 1, 1636430730388, 1636430730848, 460, 5, 455, 5, 0, 5
7344, 1, 1636430730429, 1636430730876, 447, 0, 447, 0, 0, 0
7341, 1, 1636430730256, 1636430730969, 713, 261, 452, 261, 0, 261
7346, 1, 1636430730529, 1636430730981, 452, 0, 452, 0, 0, 0
7345, 1, 1636430730529, 1636430730989, 460, 0, 460, 0, 0, 0
7347, 1, 1636430730609, 1636430731049, 440, 0, 440, 0, 0, 0
7348, 1, 1636430730696, 1636430731136, 440, 0, 440, 0, 0, 0
7349, 1, 1636430730740, 1636430731180, 440, 0, 440, 0, 0, 0
7350, 1, 1636430730969, 1636430731433, 464, 12, 452, 12, 0, 12
7351, 1, 1636430731064, 1636430731513, 449, 1, 448, 0, 0, 0
7352, 1, 1636430731092, 1636430731549, 457, 0, 457, 0, 0, 0
7353, 1, 1636430731184, 1636430731632, 448, 1, 447, 0, 0, 0
7354, 1, 1636430731204, 1636430731657, 453, 0, 453, 0, 0, 0
7355, 1, 1636430731216, 1636430731669, 453, 0, 453, 0, 0, 0
7230, 2, 1636430721692, 1636430731693, 10001, 0, 10001, 489, 0, 489
7356, 1, 1636430731281, 1636430731729, 448, 0, 448, 0, 0, 0
7357, 1, 1636430731364, 1636430731804, 440, 1, 439, 0, 0, 0
7358, 1, 1636430731405, 1636430731848, 443, 0, 443, 0, 0, 0
7359, 1, 1636430731648, 1636430732108, 460, 9, 451, 9, 0, 9
7233, 1, 1636430722049, 1636430732145, 10096, 9644, 452, 132, 9512, 9644
7360, 1, 1636430731744, 1636430732192, 448, 1, 447, 0, 0, 0
7361, 1, 1636430731781, 1636430732224, 443, 0, 443, 0, 0, 0
7362, 1, 1636430731868, 1636430732312, 444, 1, 443, 0, 0, 0
7363, 1, 1636430731881, 1636430732316, 435, 0, 435, 0, 0, 0
7364, 1, 1636430731884, 1636430732328, 444, 1, 443, 0, 0, 0
7365, 1, 1636430731949, 1636430732396, 447, 0, 447, 0, 0, 0
7366, 1, 1636430732033, 1636430732476, 443, 0, 443, 0, 0, 0
7367, 1, 1636430732073, 1636430732516, 443, 0, 443, 0, 0, 0
7368, 1, 1636430732324, 1636430732760, 436, 1, 435, 0, 0, 0
7369, 1, 1636430732364, 1636430732800, 436, 1, 435, 1, 0, 1
7370, 1, 1636430732408, 1636430732852, 444, 0, 444, 0, 0, 0
7371, 1, 1636430732444, 1636430732889, 445, 1, 444, 1, 0, 1
7374, 1, 1636430732544, 1636430732980, 436, 0, 436, 0, 0, 0
7373, 1, 1636430732532, 1636430732984, 452, 1, 451, 1, 0, 1
7375, 1, 1636430732556, 1636430733001, 445, 0, 445, 0, 0, 0
7376, 1, 1636430732612, 1636430733065, 453, 1, 452, 1, 0, 1
7377, 1, 1636430732700, 1636430733144, 444, 0, 444, 0, 0, 0
7372, 1, 1636430732452, 1636430733248, 796, 349, 447, 349, 0, 349
7379, 1, 1636430732988, 1636430733428, 440, 0, 440, 0, 0, 0
7380, 1, 1636430733024, 1636430733468, 444, 0, 444, 0, 0, 0
7381, 1, 1636430733072, 1636430733520, 448, 0, 448, 0, 0, 0
7382, 1, 1636430733109, 1636430733557, 448, 0, 448, 0, 0, 0
7383, 1, 1636430733200, 1636430733644, 444, 1, 443, 1, 0, 1
7384, 1, 1636430733216, 1636430733661, 445, 1, 444, 0, 0, 0
7386, 1, 1636430733284, 1636430733729, 445, 0, 445, 0, 0, 0
7387, 1, 1636430733364, 1636430733812, 448, 1, 447, 0, 0, 0
7388, 1, 1636430733465, 1636430733912, 447, 4, 443, 4, 0, 4
7255, 2, 1636430723968, 1636430733969, 10001, 0, 10001, 0, 0, 0
7389, 1, 1636430733652, 1636430734112, 460, 9, 451, 9, 0, 9
7390, 1, 1636430733696, 1636430734193, 497, 1, 496, 1, 0, 1
7391, 1, 1636430733748, 1636430734193, 445, 1, 444, 0, 0, 0
7259, 2, 1636430724200, 1636430734204, 10004, 0, 10004, 1, 0, 1
7392, 1, 1636430733776, 1636430734228, 452, 1, 451, 0, 1, 1
7393, 1, 1636430733864, 1636430734313, 449, 0, 449, 0, 0, 0
7394, 1, 1636430733876, 1636430734316, 440, 0, 440, 0, 0, 0
7396, 1, 1636430734056, 1636430734520, 464, 1, 463, 1, 0, 1
7397, 1, 1636430734140, 1636430734649, 509, 53, 456, 53, 0, 53
7398, 1, 1636430734296, 1636430734749, 453, 0, 453, 0, 0, 0
7399, 1, 1636430734328, 1636430734772, 444, 0, 444, 0, 0, 0
7400, 1, 1636430734413, 1636430734861, 448, 0, 448, 0, 0, 0
7401, 1, 1636430734413, 1636430734868, 455, 0, 455, 0, 0, 0
7402, 1, 1636430734448, 1636430734897, 449, 0, 449, 0, 0, 0
7404, 1, 1636430734532, 1636430734981, 449, 1, 448, 0, 0, 0
7405, 1, 1636430734545, 1636430735004, 459, 0, 459, 0, 0, 0
7406, 1, 1636430734736, 1636430735188, 452, 0, 452, 0, 0, 0
7407, 1, 1636430734865, 1636430735313, 448, 0, 448, 0, 0, 0
7408, 1, 1636430734964, 1636430735400, 436, 1, 435, 1, 0, 1
7409, 1, 1636430734997, 1636430735444, 447, 0, 447, 0, 0, 0
7411, 1, 1636430735089, 1636430735537, 448, 0, 448, 0, 0, 0
7410, 1, 1636430735085, 1636430735537, 452, 0, 452, 0, 0, 0
7412, 1, 1636430735116, 1636430735564, 448, 1, 447, 0, 0, 0
7413, 1, 1636430735204, 1636430735640, 436, 0, 436, 0, 0, 0
7278, 2, 1636430725748, 1636430735748, 10000, 0, 10000, 1, 0, 1
7415, 1, 1636430735408, 1636430735848, 440, 0, 440, 0, 0, 0
7416, 1, 1636430735537, 1636430735988, 451, 1, 450, 0, 1, 1
7417, 1, 1636430735632, 1636430736084, 452, 0, 452, 0, 0, 0
7418, 1, 1636430735660, 1636430736157, 497, 1, 496, 0, 0, 0
7419, 1, 1636430735796, 1636430736245, 449, 1, 448, 0, 0, 0
7421, 1, 1636430735796, 1636430736252, 456, 1, 455, 1, 0, 1
7422, 1, 1636430735864, 1636430736305, 441, 1, 440, 1, 0, 1
7423, 1, 1636430736065, 1636430736508, 443, 0, 443, 0, 0, 0
7425, 1, 1636430736204, 1636430736688, 484, 41, 443, 41, 0, 41
7426, 1, 1636430736305, 1636430736752, 447, 0, 447, 0, 0, 0
7427, 1, 1636430736373, 1636430736829, 456, 0, 456, 0, 0, 0
7428, 1, 1636430736473, 1636430736929, 456, 0, 456, 0, 0, 0
7429, 1, 1636430736473, 1636430736932, 459, 0, 459, 0, 0, 0
7430, 1, 1636430736536, 1636430736980, 444, 1, 443, 1, 0, 1
7298, 2, 1636430727145, 1636430737141, 9996, 0, 9996, 376, 0, 376
7431, 1, 1636430736729, 1636430737177, 448, 0, 448, 0, 0, 0
7432, 1, 1636430736904, 1636430737393, 489, 25, 464, 24, 0, 24
7433, 1, 1636430736977, 1636430737457, 480, 0, 480, 0, 0, 0
7305, 2, 1636430727516, 1636430737517, 10001, 0, 10001, 5, 0, 5
7435, 1, 1636430737193, 1636430737645, 452, 0, 452, 0, 0, 0
7436, 1, 1636430737193, 1636430737645, 452, 0, 452, 0, 0, 0
7437, 1, 1636430737229, 1636430737676, 447, 0, 447, 0, 0, 0
7309, 2, 1636430727740, 1636430737744, 10004, 0, 10004, 0, 0, 0
7438, 1, 1636430737401, 1636430737853, 452, 0, 452, 0, 0, 0
7439, 1, 1636430737612, 1636430738100, 488, 33, 455, 33, 0, 33
7440, 1, 1636430737692, 1636430738152, 460, 0, 460, 0, 0, 0
7441, 1, 1636430737832, 1636430738276, 444, 0, 444, 0, 0, 0
7442, 1, 1636430737836, 1636430738280, 444, 0, 444, 0, 0, 0
7444, 1, 1636430737869, 1636430738309, 440, 0, 440, 0, 0, 0
7443, 1, 1636430737860, 1636430738312, 452, 1, 451, 0, 0, 0
7445, 1, 1636430737920, 1636430738368, 448, 0, 448, 0, 0, 0
7320, 2, 1636430728485, 1636430738485, 10000, 0, 10000, 0, 0, 0
7446, 1, 1636430738045, 1636430738496, 451, 0, 451, 0, 0, 0
7447, 1, 1636430738081, 1636430738528, 447, 0, 447, 0, 0, 0
7448, 1, 1636430738316, 1636430738797, 481, 1, 480, 1, 0, 1
7449, 1, 1636430738372, 1636430738824, 452, 1, 451, 0, 1, 1
7323, 2, 1636430728824, 1636430738825, 10001, 0, 10001, 0, 0, 0
7450, 1, 1636430738528, 1636430738977, 449, 1, 448, 0, 1, 1
7451, 1, 1636430738532, 1636430738977, 445, 1, 444, 0, 1, 1
7453, 1, 1636430738532, 1636430738977, 445, 1, 444, 1, 0, 1
7454, 1, 1636430738584, 1636430739048, 464, 0, 464, 0, 0, 0
7455, 1, 1636430738712, 1636430739160, 448, 1, 447, 1, 0, 1
7457, 1, 1636430738793, 1636430739228, 435, 0, 435, 0, 0, 0
7456, 1, 1636430738744, 1636430739232, 488, 1, 487, 0, 0, 0
7459, 1, 1636430739044, 1636430739496, 452, 1, 451, 1, 0, 1
7460, 1, 1636430739128, 1636430739576, 448, 0, 448, 0, 0, 0
7462, 1, 1636430739200, 1636430739644, 444, 1, 443, 1, 0, 1
7463, 1, 1636430739200, 1636430739644, 444, 1, 443, 0, 1, 1
7461, 1, 1636430739200, 1636430739648, 448, 1, 447, 1, 0, 1
7464, 1, 1636430739264, 1636430739708, 444, 0, 444, 0, 0, 0
7465, 1, 1636430739380, 1636430739824, 444, 0, 444, 0, 0, 0
7466, 1, 1636430739444, 1636430739888, 444, 0, 444, 0, 0, 0
7467, 1, 1636430739448, 1636430739896, 448, 1, 447, 1, 0, 1
7468, 1, 1636430739716, 1636430740156, 440, 1, 439, 1, 0, 1
7469, 1, 1636430739796, 1636430740245, 449, 1, 448, 0, 0, 0
7472, 1, 1636430739872, 1636430740317, 445, 0, 445, 0, 0, 0
7470, 1, 1636430739868, 1636430740317, 449, 1, 448, 1, 0, 1
7471, 1, 1636430739868, 1636430740320, 452, 1, 451, 0, 0, 0
7473, 1, 1636430739932, 1636430740376, 444, 0, 444, 0, 0, 0
7474, 1, 1636430740048, 1636430740500, 452, 0, 452, 0, 0, 0
7475, 1, 1636430740121, 1636430740572, 451, 0, 451, 0, 0, 0
7476, 1, 1636430740121, 1636430740577, 456, 0, 456, 0, 0, 0
7477, 1, 1636430740381, 1636430740828, 447, 0, 447, 0, 0, 0
7478, 1, 1636430740465, 1636430740917, 452, 0, 452, 0, 0, 0
7480, 1, 1636430740541, 1636430740989, 448, 0, 448, 0, 0, 0
7479, 1, 1636430740541, 1636430740992, 451, 1, 450, 0, 0, 0
7481, 1, 1636430740541, 1636430741001, 460, 1, 459, 1, 0, 1
7482, 1, 1636430740596, 1636430741036, 440, 1, 439, 1, 0, 1
7483, 1, 1636430740720, 1636430741169, 449, 1, 448, 0, 1, 1
7484, 1, 1636430740788, 1636430741240, 452, 1, 451, 0, 0, 0
7485, 1, 1636430740792, 1636430741240, 448, 1, 447, 0, 0, 0
7486, 1, 1636430741044, 1636430741488, 444, 1, 443, 0, 0, 0
7487, 1, 1636430741132, 1636430741577, 445, 1, 444, 0, 0, 0
7489, 1, 1636430741213, 1636430741661, 448, 0, 448, 0, 0, 0
7488, 1, 1636430741204, 1636430741661, 457, 1, 456, 0, 1, 1
7490, 1, 1636430741220, 1636430741672, 452, 0, 452, 0, 0, 0
7491, 1, 1636430741260, 1636430741705, 445, 0, 445, 0, 0, 0
7492, 1, 1636430741392, 1636430741840, 448, 1, 447, 0, 0, 0
7493, 1, 1636430741460, 1636430741912, 452, 1, 451, 1, 0, 1
7494, 1, 1636430741469, 1636430741920, 451, 0, 451, 0, 0, 0
7495, 1, 1636430741712, 1636430742160, 448, 0, 448, 0, 0, 0
7496, 1, 1636430741800, 1636430742236, 436, 0, 436, 0, 0, 0
7498, 1, 1636430741884, 1636430742328, 444, 1, 443, 0, 1, 1
7499, 1, 1636430741892, 1636430742328, 436, 0, 436, 0, 0, 0
7497, 1, 1636430741884, 1636430742333, 449, 1, 448, 0, 1, 1
7500, 1, 1636430741928, 1636430742376, 448, 1, 447, 0, 1, 1
7501, 1, 1636430742065, 1636430742512, 447, 0, 447, 0, 0, 0
7503, 1, 1636430742132, 1636430742580, 448, 0, 448, 0, 0, 0
7502, 1, 1636430742132, 1636430742584, 452, 0, 452, 0, 0, 0
7378, 2, 1636430732736, 1636430742740, 10004, 0, 10004, 1, 0, 1
7504, 1, 1636430742376, 1636430742820, 444, 1, 443, 0, 0, 0
7505, 1, 1636430742468, 1636430742965, 497, 45, 452, 44, 0, 44
7506, 1, 1636430742556, 1636430743000, 444, 0, 444, 0, 0, 0
7509, 1, 1636430742592, 1636430743056, 464, 0, 464, 0, 0, 0
7508, 1, 1636430742564, 1636430743060, 496, 1, 495, 0, 0, 0
7510, 1, 1636430742728, 1636430743176, 448, 0, 448, 0, 0, 0
7385, 2, 1636430733220, 1636430743217, 9997, 0, 9997, 0, 0, 0
7512, 1, 1636430742832, 1636430743272, 440, 0, 440, 0, 0, 0
7511, 1, 1636430742832, 1636430743280, 448, 0, 448, 0, 0, 0
7514, 1, 1636430743044, 1636430743528, 484, 1, 483, 1, 0, 1
7513, 1, 1636430743044, 1636430743540, 496, 1, 495, 1, 0, 1
7515, 1, 1636430743188, 1636430743632, 444, 0, 444, 0, 0, 0
7516, 1, 1636430743216, 1636430743673, 457, 1, 456, 0, 0, 0
7518, 1, 1636430743304, 1636430743752, 448, 1, 447, 1, 0, 1
7517, 1, 1636430743304, 1636430743756, 452, 1, 451, 0, 1, 1
7519, 1, 1636430743397, 1636430743840, 443, 0, 443, 0, 0, 0
7520, 1, 1636430743484, 1636430743932, 448, 1, 447, 0, 0, 0
7521, 1, 1636430743504, 1636430743957, 453, 0, 453, 0, 0, 0
7395, 2, 1636430733949, 1636430743957, 10008, 0, 10008, 0, 0, 0
7522, 1, 1636430743524, 1636430743972, 448, 1, 447, 0, 1, 1
7523, 1, 1636430743748, 1636430744196, 448, 0, 448, 0, 0, 0
7524, 1, 1636430743760, 1636430744208, 448, 0, 448, 0, 0, 0
7526, 1, 1636430743897, 1636430744360, 463, 0, 463, 0, 0, 0
7527, 1, 1636430744000, 1636430744448, 448, 1, 447, 0, 0, 0
7528, 1, 1636430744000, 1636430744448, 448, 1, 447, 1, 0, 1
7529, 1, 1636430744060, 1636430744505, 445, 0, 445, 0, 0, 0
7403, 2, 1636430734508, 1636430744512, 10004, 0, 10004, 0, 0, 0
7530, 1, 1636430744160, 1636430744608, 448, 1, 447, 1, 0, 1
7531, 1, 1636430744177, 1636430744629, 452, 0, 452, 0, 0, 0
7533, 1, 1636430744252, 1636430744744, 492, 1, 491, 0, 0, 0
7534, 1, 1636430744416, 1636430744864, 448, 1, 447, 0, 0, 0
7535, 1, 1636430744433, 1636430744920, 487, 0, 487, 0, 0, 0
7536, 1, 1636430744600, 1636430745048, 448, 1, 447, 0, 1, 1
7538, 1, 1636430744693, 1636430745141, 448, 0, 448, 0, 0, 0
7537, 1, 1636430744693, 1636430745141, 448, 0, 448, 0, 0, 0
7539, 1, 1636430744728, 1636430745177, 449, 1, 448, 0, 0, 0
7414, 2, 1636430735220, 1636430745224, 10004, 0, 10004, 0, 0, 0
7540, 1, 1636430744816, 1636430745264, 448, 1, 447, 1, 0, 1
7541, 1, 1636430744820, 1636430745265, 445, 0, 445, 0, 0, 0
7542, 1, 1636430744852, 1636430745301, 449, 1, 448, 0, 0, 0
7544, 1, 1636430745085, 1636430745540, 455, 0, 455, 0, 0, 0
7545, 1, 1636430745141, 1636430745640, 499, 0, 499, 0, 0, 0
7546, 1, 1636430745268, 1636430745721, 453, 0, 453, 0, 0, 0
7420, 2, 1636430735796, 1636430745797, 10001, 0, 10001, 1, 0, 1
7547, 1, 1636430745401, 1636430745840, 439, 0, 439, 0, 0, 0
7548, 1, 1636430745405, 1636430745860, 455, 0, 455, 0, 0, 0
7549, 1, 1636430745405, 1636430745861, 456, 0, 456, 0, 0, 0
7551, 1, 1636430745488, 1636430745936, 448, 0, 448, 0, 0, 0
7550, 1, 1636430745484, 1636430745940, 456, 0, 456, 0, 0, 0
7553, 1, 1636430745524, 1636430745969, 445, 0, 445, 0, 0, 0
7552, 1, 1636430745520, 1636430746020, 500, 0, 500, 0, 0, 0
7424, 2, 1636430736068, 1636430746072, 10004, 0, 10004, 0, 0, 0
7555, 1, 1636430745884, 1636430746336, 452, 1, 451, 0, 1, 1
7556, 1, 1636430745977, 1636430746420, 443, 0, 443, 0, 0, 0
7557, 1, 1636430746064, 1636430746516, 452, 1, 451, 0, 0, 0
7558, 1, 1636430746120, 1636430746568, 448, 1, 447, 1, 0, 1
7559, 1, 1636430746120, 1636430746572, 452, 1, 451, 0, 1, 1
7560, 1, 1636430746120, 1636430746572, 452, 1, 451, 0, 0, 0
7561, 1, 1636430746160, 1636430746600, 440, 0, 440, 0, 0, 0
7562, 1, 1636430746164, 1636430746616, 452, 0, 452, 0, 0, 0
7563, 1, 1636430746192, 1636430746641, 449, 0, 449, 0, 0, 0
7564, 1, 1636430746252, 1636430746696, 444, 0, 444, 0, 0, 0
7565, 1, 1636430746376, 1636430746828, 452, 0, 452, 0, 0, 0
7566, 1, 1636430746560, 1636430747004, 444, 0, 444, 0, 0, 0
7434, 2, 1636430737044, 1636430747044, 10000, 0, 10000, 1, 0, 1
7567, 1, 1636430746644, 1636430747084, 440, 0, 440, 0, 0, 0
7568, 1, 1636430746732, 1636430747177, 445, 1, 444, 0, 0, 0
7571, 1, 1636430746796, 1636430747264, 468, 0, 468, 0, 0, 0
7572, 1, 1636430746824, 1636430747268, 444, 0, 444, 0, 0, 0
7573, 1, 1636430746832, 1636430747272, 440, 0, 440, 0, 0, 0
7569, 1, 1636430746788, 1636430747276, 488, 1, 487, 0, 0, 0
7574, 1, 1636430746861, 1636430747308, 447, 0, 447, 0, 0, 0
7575, 1, 1636430746912, 1636430747364, 452, 0, 452, 0, 0, 0
7576, 1, 1636430747041, 1636430747488, 447, 0, 447, 0, 0, 0
7577, 1, 1636430747228, 1636430747673, 445, 0, 445, 0, 0, 0
7578, 1, 1636430747308, 1636430747748, 440, 1, 439, 0, 1, 1
7579, 1, 1636430747356, 1636430747792, 436, 0, 436, 0, 0, 0
7580, 1, 1636430747400, 1636430747840, 440, 0, 440, 0, 0, 0
7581, 1, 1636430747484, 1636430747925, 441, 0, 441, 0, 0, 0
7582, 1, 1636430747488, 1636430747932, 444, 0, 444, 0, 0, 0
7583, 1, 1636430747492, 1636430747940, 448, 0, 448, 0, 0, 0
7584, 1, 1636430747496, 1636430747948, 452, 0, 452, 0, 0, 0
7585, 1, 1636430747528, 1636430747968, 440, 0, 440, 0, 0, 0
7586, 1, 1636430747580, 1636430748024, 444, 1, 443, 0, 0, 0
7587, 1, 1636430747708, 1636430748157, 449, 0, 449, 0, 0, 0
7588, 1, 1636430747888, 1636430748332, 444, 1, 443, 1, 0, 1
7589, 1, 1636430747976, 1636430748425, 449, 1, 448, 0, 0, 0
7590, 1, 1636430748008, 1636430748457, 449, 1, 448, 0, 0, 0
7452, 2, 1636430738532, 1636430748532, 10000, 0, 10000, 1, 0, 1
7592, 1, 1636430748148, 1636430748592, 444, 1, 443, 1, 0, 1
7594, 1, 1636430748157, 1636430748600, 443, 0, 443, 0, 0, 0
7593, 1, 1636430748157, 1636430748608, 451, 0, 451, 0, 0, 0
7595, 1, 1636430748176, 1636430748621, 445, 0, 445, 0, 0, 0
7596, 1, 1636430748192, 1636430748636, 444, 0, 444, 0, 0, 0
7597, 1, 1636430748252, 1636430748696, 444, 1, 443, 1, 0, 1
7598, 1, 1636430748376, 1636430748852, 476, 1, 475, 0, 0, 0
7591, 1, 1636430748064, 1636430748881, 817, 361, 456, 361, 0, 361
7458, 2, 1636430739016, 1636430749017, 10001, 0, 10001, 1, 0, 1
7599, 1, 1636430748576, 1636430749033, 457, 1, 456, 1, 0, 1
7600, 1, 1636430748644, 1636430749081, 437, 1, 436, 0, 0, 0
7601, 1, 1636430748712, 1636430749164, 452, 1, 451, 0, 1, 1
7602, 1, 1636430748812, 1636430749261, 449, 0, 449, 0, 0, 0
7603, 1, 1636430748824, 1636430749272, 448, 0, 448, 0, 0, 0
7606, 1, 1636430748840, 1636430749333, 493, 1, 492, 0, 0, 0
7605, 1, 1636430748840, 1636430749333, 493, 0, 493, 0, 0, 0
7607, 1, 1636430748856, 1636430749333, 477, 0, 477, 0, 0, 0
7525, 1, 1636430743861, 1636430749473, 5612, 5156, 456, 0, 5156, 5156
7609, 1, 1636430749108, 1636430749560, 452, 1, 451, 1, 0, 1
7610, 1, 1636430749108, 1636430749560, 452, 1, 451, 1, 0, 1
7611, 1, 1636430749248, 1636430749692, 444, 1, 443, 0, 1, 1
7608, 1, 1636430748912, 1636430749716, 804, 349, 455, 349, 0, 349
7612, 1, 1636430749308, 1636430749753, 445, 0, 445, 0, 0, 0
7613, 1, 1636430749316, 1636430749777, 461, 18, 443, 17, 1, 18
7614, 1, 1636430749376, 1636430749820, 444, 1, 443, 0, 0, 0
7615, 1, 1636430749492, 1636430749937, 445, 1, 444, 0, 0, 0
7616, 1, 1636430749492, 1636430749937, 445, 1, 444, 0, 0, 0
7618, 1, 1636430749556, 1636430750001, 445, 0, 445, 0, 0, 0
7617, 1, 1636430749548, 1636430750001, 453, 0, 453, 0, 0, 0
7619, 1, 1636430749560, 1636430750024, 464, 0, 464, 0, 0, 0
7620, 1, 1636430749696, 1636430750144, 448, 0, 448, 0, 0, 0
7621, 1, 1636430749776, 1636430750224, 448, 1, 447, 0, 0, 0
7622, 1, 1636430749780, 1636430750232, 452, 0, 452, 0, 0, 0
7623, 1, 1636430749924, 1636430750372, 448, 1, 447, 1, 0, 1
7624, 1, 1636430749940, 1636430750384, 444, 0, 444, 0, 0, 0
7625, 1, 1636430749976, 1636430750416, 440, 1, 439, 0, 1, 1
7626, 1, 1636430749988, 1636430750444, 456, 14, 442, 13, 1, 14
7627, 1, 1636430750048, 1636430750488, 440, 0, 440, 0, 0, 0
7628, 1, 1636430750156, 1636430750605, 449, 1, 448, 1, 0, 1
7629, 1, 1636430750156, 1636430750608, 452, 1, 451, 1, 0, 1
7630, 1, 1636430750220, 1636430750668, 448, 1, 447, 1, 0, 1
7631, 1, 1636430750220, 1636430750668, 448, 1, 447, 0, 0, 0
7632, 1, 1636430750240, 1636430750684, 444, 0, 444, 0, 0, 0
7634, 1, 1636430750441, 1636430750885, 444, 0, 444, 0, 0, 0
7635, 1, 1636430750448, 1636430750896, 448, 1, 447, 0, 0, 0
7636, 1, 1636430750588, 1636430751036, 448, 0, 448, 0, 0, 0
7637, 1, 1636430750608, 1636430751056, 448, 1, 447, 1, 0, 1
7638, 1, 1636430750644, 1636430751092, 448, 0, 448, 0, 0, 0
7639, 1, 1636430750656, 1636430751124, 468, 13, 455, 12, 1, 13
7640, 1, 1636430750708, 1636430751156, 448, 1, 447, 1, 0, 1
7641, 1, 1636430750820, 1636430751268, 448, 1, 447, 0, 0, 0
7642, 1, 1636430750828, 1636430751276, 448, 0, 448, 0, 0, 0
7644, 1, 1636430750884, 1636430751328, 444, 1, 443, 0, 0, 0
7643, 1, 1636430750892, 1636430751336, 444, 1, 443, 0, 0, 0
7645, 1, 1636430750912, 1636430751364, 452, 1, 451, 1, 0, 1
7646, 1, 1636430751112, 1636430751564, 452, 1, 451, 1, 0, 1
7648, 1, 1636430751260, 1636430751713, 453, 0, 453, 0, 0, 0
7649, 1, 1636430751276, 1636430751728, 452, 0, 452, 0, 0, 0
7650, 1, 1636430751312, 1636430751760, 448, 1, 447, 0, 0, 0
7651, 1, 1636430751340, 1636430751785, 445, 0, 445, 0, 0, 0
7652, 1, 1636430751376, 1636430751828, 452, 1, 451, 0, 0, 0
7653, 1, 1636430751493, 1636430751945, 452, 0, 452, 0, 0, 0
7655, 1, 1636430751552, 1636430752009, 457, 0, 457, 0, 0, 0
7656, 1, 1636430751560, 1636430752009, 449, 0, 449, 0, 0, 0
7657, 1, 1636430751584, 1636430752032, 448, 0, 448, 0, 0, 0
7658, 1, 1636430751781, 1636430752236, 455, 0, 455, 0, 0, 0
7659, 1, 1636430751936, 1636430752385, 449, 1, 448, 0, 0, 0
7660, 1, 1636430751945, 1636430752405, 460, 0, 460, 0, 0, 0
7661, 1, 1636430751976, 1636430752420, 444, 0, 444, 0, 0, 0
7662, 1, 1636430752008, 1636430752457, 449, 1, 448, 0, 0, 0
7663, 1, 1636430752044, 1636430752500, 456, 1, 455, 0, 1, 1
7507, 2, 1636430742564, 1636430752561, 9997, 0, 9997, 0, 0, 0
7666, 1, 1636430752232, 1636430752680, 448, 0, 448, 0, 0, 0
7665, 1, 1636430752228, 1636430752680, 452, 1, 451, 1, 0, 1
7667, 1, 1636430752252, 1636430752704, 452, 1, 451, 0, 0, 0
7664, 1, 1636430752173, 1636430752868, 695, 248, 447, 248, 0, 248
7668, 1, 1636430752457, 1636430752904, 447, 0, 447, 0, 0, 0
7669, 1, 1636430752608, 1636430753056, 448, 0, 448, 0, 0, 0
7670, 1, 1636430752652, 1636430753096, 444, 1, 443, 1, 0, 1
7672, 1, 1636430752676, 1636430753132, 456, 5, 451, 5, 0, 5
7673, 1, 1636430752732, 1636430753168, 436, 1, 435, 0, 0, 0
7674, 1, 1636430752884, 1636430753333, 449, 1, 448, 0, 0, 0
7675, 1, 1636430752901, 1636430753353, 452, 0, 452, 0, 0, 0
7676, 1, 1636430752901, 1636430753356, 455, 0, 455, 0, 0, 0
7677, 1, 1636430752920, 1636430753360, 440, 0, 440, 0, 0, 0
7671, 1, 1636430752652, 1636430753500, 848, 405, 443, 405, 0, 405
7678, 1, 1636430753096, 1636430753548, 452, 1, 451, 0, 0, 0
7679, 1, 1636430753120, 1636430753569, 449, 1, 448, 0, 1, 1
7680, 1, 1636430753276, 1636430753712, 436, 0, 436, 0, 0, 0
7681, 1, 1636430753312, 1636430753752, 440, 1, 439, 0, 1, 1
7682, 1, 1636430753348, 1636430753800, 452, 9, 443, 8, 1, 9
7683, 1, 1636430753404, 1636430753844, 440, 0, 440, 0, 0, 0
7684, 1, 1636430753548, 1636430753992, 444, 1, 443, 0, 0, 0
7685, 1, 1636430753568, 1636430754021, 453, 1, 452, 0, 0, 0
7686, 1, 1636430753572, 1636430754024, 452, 1, 451, 0, 1, 1
7687, 1, 1636430753589, 1636430754028, 439, 0, 439, 0, 0, 0
7688, 1, 1636430753720, 1636430754160, 440, 1, 439, 1, 0, 1
7532, 2, 1636430744192, 1636430754193, 10001, 0, 10001, 1, 0, 1
7689, 1, 1636430753764, 1636430754200, 436, 1, 435, 1, 0, 1
7690, 1, 1636430753793, 1636430754288, 495, 52, 443, 52, 0, 52
7692, 1, 1636430753984, 1636430754448, 464, 9, 455, 9, 0, 9
7693, 1, 1636430754016, 1636430754508, 492, 9, 483, 8, 0, 8
7694, 1, 1636430754068, 1636430754508, 440, 0, 440, 0, 0, 0
7691, 1, 1636430753945, 1636430754640, 695, 256, 439, 255, 1, 256
7696, 1, 1636430754240, 1636430754692, 452, 1, 451, 1, 0, 1
7697, 1, 1636430754240, 1636430754692, 452, 1, 451, 0, 1, 1
7695, 1, 1636430754240, 1636430754692, 452, 1, 451, 1, 0, 1
7698, 1, 1636430754284, 1636430754740, 456, 0, 456, 0, 0, 0
7699, 1, 1636430754388, 1636430754836, 448, 1, 447, 0, 0, 0
7700, 1, 1636430754428, 1636430754872, 444, 1, 443, 0, 0, 0
7701, 1, 1636430754500, 1636430754952, 452, 0, 452, 0, 0, 0
7702, 1, 1636430754504, 1636430754953, 449, 5, 444, 5, 0, 5
7543, 2, 1636430744961, 1636430754960, 9999, 0, 9999, 0, 0, 0
7705, 1, 1636430754732, 1636430755185, 453, 0, 453, 0, 0, 0
7704, 1, 1636430754724, 1636430755185, 461, 1, 460, 0, 0, 0
7703, 1, 1636430754672, 1636430755185, 513, 21, 492, 21, 0, 21
7707, 1, 1636430754916, 1636430755368, 452, 1, 451, 0, 1, 1
7708, 1, 1636430754916, 1636430755372, 456, 1, 455, 0, 0, 0
7710, 1, 1636430755004, 1636430755449, 445, 0, 445, 0, 0, 0
7711, 1, 1636430755056, 1636430755492, 436, 0, 436, 0, 0, 0
7712, 1, 1636430755136, 1636430755588, 452, 0, 452, 0, 0, 0
7714, 1, 1636430755173, 1636430755620, 447, 0, 447, 0, 0, 0
7713, 1, 1636430755173, 1636430755620, 447, 0, 447, 0, 0, 0
7709, 1, 1636430754920, 1636430755632, 712, 266, 446, 265, 0, 265
7715, 1, 1636430755260, 1636430755708, 448, 1, 447, 0, 0, 0
7554, 2, 1636430745757, 1636430755760, 10003, 0, 10003, 0, 0, 0
7716, 1, 1636430755396, 1636430755844, 448, 1, 447, 1, 0, 1
7718, 1, 1636430755408, 1636430755856, 448, 1, 447, 0, 0, 0
7720, 1, 1636430755592, 1636430756076, 484, 1, 483, 0, 0, 0
7719, 1, 1636430755592, 1636430756076, 484, 1, 483, 0, 0, 0
7717, 1, 1636430755408, 1636430756080, 672, 225, 447, 225, 0, 225
7721, 1, 1636430755664, 1636430756120, 456, 1, 455, 0, 0, 0
7722, 1, 1636430755724, 1636430756172, 448, 0, 448, 0, 0, 0
7723, 1, 1636430755808, 1636430756245, 437, 0, 437, 0, 0, 0
7724, 1, 1636430755848, 1636430756296, 448, 0, 448, 0, 0, 0
7725, 1, 1636430755852, 1636430756297, 445, 0, 445, 0, 0, 0
7726, 1, 1636430755856, 1636430756300, 444, 0, 444, 0, 0, 0
7727, 1, 1636430755937, 1636430756388, 451, 0, 451, 0, 0, 0
7729, 1, 1636430756069, 1636430756516, 447, 0, 447, 0, 0, 0
7728, 1, 1636430756069, 1636430756517, 448, 0, 448, 0, 0, 0
7730, 1, 1636430756080, 1636430756520, 440, 1, 439, 0, 0, 0
7732, 1, 1636430756296, 1636430756740, 444, 1, 443, 1, 0, 1
7731, 1, 1636430756296, 1636430756744, 448, 1, 447, 1, 0, 1
7733, 1, 1636430756296, 1636430756752, 456, 5, 451, 3, 1, 4
7734, 1, 1636430756340, 1636430756784, 444, 0, 444, 0, 0, 0
7570, 2, 1636430746788, 1636430756784, 9996, 0, 9996, 0, 0, 0
7735, 1, 1636430756388, 1636430756828, 440, 1, 439, 0, 1, 1
7736, 1, 1636430756472, 1636430756917, 445, 0, 445, 0, 0, 0
7738, 1, 1636430756520, 1636430757008, 488, 1, 487, 1, 0, 1
7739, 1, 1636430756520, 1636430757008, 488, 1, 487, 0, 1, 1
7740, 1, 1636430756605, 1636430757052, 447, 0, 447, 0, 0, 0
7741, 1, 1636430756733, 1636430757188, 455, 0, 455, 0, 0, 0
7742, 1, 1636430756736, 1636430757188, 452, 1, 451, 1, 0, 1
7743, 1, 1636430756736, 1636430757192, 456, 9, 447, 8, 0, 8
7737, 1, 1636430756516, 1636430757229, 713, 269, 444, 269, 0, 269
7744, 1, 1636430756964, 1636430757404, 440, 1, 439, 0, 0, 0
7745, 1, 1636430756964, 1636430757408, 444, 1, 443, 0, 0, 0
7746, 1, 1636430756972, 1636430757448, 476, 37, 439, 37, 0, 37
7747, 1, 1636430757008, 1636430757456, 448, 1, 447, 0, 1, 1
7748, 1, 1636430757060, 1636430757500, 440, 1, 439, 0, 0, 0
7749, 1, 1636430757088, 1636430757532, 444, 1, 443, 1, 0, 1
7750, 1, 1636430757140, 1636430757580, 440, 1, 439, 1, 0, 1
7751, 1, 1636430757228, 1636430757672, 444, 1, 443, 0, 0, 0
7752, 1, 1636430757228, 1636430757672, 444, 1, 443, 0, 0, 0
7753, 1, 1636430757276, 1636430757720, 444, 0, 444, 0, 0, 0
7756, 1, 1636430757404, 1636430757848, 444, 5, 439, 4, 0, 4
7755, 1, 1636430757404, 1636430757852, 448, 1, 447, 0, 1, 1
7757, 1, 1636430757444, 1636430757884, 440, 1, 439, 0, 1, 1
7759, 1, 1636430757628, 1636430758076, 448, 0, 448, 0, 0, 0
7758, 1, 1636430757624, 1636430758076, 452, 0, 452, 0, 0, 0
7761, 1, 1636430757672, 1636430758128, 456, 1, 455, 1, 0, 1
7760, 1, 1636430757668, 1636430758128, 460, 5, 455, 5, 0, 5
7763, 1, 1636430757748, 1636430758193, 445, 0, 445, 0, 0, 0
7764, 1, 1636430757804, 1636430758256, 452, 0, 452, 0, 0, 0
7762, 1, 1636430757720, 1636430758300, 580, 129, 451, 128, 1, 129
7765, 1, 1636430757888, 1636430758332, 444, 1, 443, 0, 0, 0
7766, 1, 1636430757896, 1636430758340, 444, 0, 444, 0, 0, 0
7767, 1, 1636430757944, 1636430758396, 452, 0, 452, 0, 0, 0
7768, 1, 1636430758080, 1636430758520, 440, 0, 440, 0, 0, 0
7769, 1, 1636430758080, 1636430758524, 444, 0, 444, 0, 0, 0
7770, 1, 1636430758120, 1636430758564, 444, 1, 443, 0, 0, 0
7772, 1, 1636430758300, 1636430758741, 441, 0, 441, 0, 0, 0
7774, 1, 1636430758344, 1636430758792, 448, 0, 448, 0, 0, 0
7773, 1, 1636430758344, 1636430758792, 448, 0, 448, 0, 0, 0
7604, 2, 1636430748820, 1636430758825, 10005, 0, 10005, 0, 0, 0
7775, 1, 1636430758416, 1636430758861, 445, 1, 444, 0, 0, 0
7776, 1, 1636430758480, 1636430758920, 440, 1, 439, 0, 0, 0
7777, 1, 1636430758516, 1636430758961, 445, 0, 445, 0, 0, 0
7780, 1, 1636430758612, 1636430759048, 436, 0, 436, 0, 0, 0
7779, 1, 1636430758560, 1636430759048, 488, 1, 487, 0, 1, 1
7778, 1, 1636430758556, 1636430759052, 496, 1, 495, 0, 0, 0
7782, 1, 1636430758741, 1636430759232, 491, 1, 490, 0, 1, 1
7783, 1, 1636430758784, 1636430759232, 448, 0, 448, 0, 0, 0
7781, 1, 1636430758741, 1636430759232, 491, 0, 491, 0, 0, 0
7784, 1, 1636430759004, 1636430759456, 452, 0, 452, 0, 0, 0
7786, 1, 1636430759016, 1636430759464, 448, 1, 447, 0, 0, 0
7785, 1, 1636430759016, 1636430759496, 480, 37, 443, 37, 0, 37
7787, 1, 1636430759080, 1636430759524, 444, 1, 443, 1, 0, 1
7788, 1, 1636430759133, 1636430759568, 435, 0, 435, 0, 0, 0
7789, 1, 1636430759144, 1636430759584, 440, 0, 440, 0, 0, 0
7790, 1, 1636430759188, 1636430759632, 444, 0, 444, 0, 0, 0
7792, 1, 1636430759268, 1636430759716, 448, 0, 448, 0, 0, 0
7793, 1, 1636430759276, 1636430759725, 449, 0, 449, 0, 0, 0
7794, 1, 1636430759449, 1636430759900, 451, 8, 443, 8, 0, 8
7796, 1, 1636430759456, 1636430759904, 448, 1, 447, 1, 0, 1
7795, 1, 1636430759456, 1636430760012, 556, 113, 443, 113, 0, 113
7798, 1, 1636430759684, 1636430760128, 444, 0, 444, 0, 0, 0
7797, 1, 1636430759676, 1636430760134, 458, 0, 458, 0, 0, 0
7799, 1, 1636430759724, 1636430760176, 452, 1, 451, 0, 0, 0
7800, 1, 1636430759748, 1636430760196, 448, 1, 447, 1, 0, 1
7801, 1, 1636430759788, 1636430760237, 449, 1, 448, 1, 0, 1
7802, 1, 1636430759808, 1636430760252, 444, 0, 444, 0, 0, 0
7803, 1, 1636430759848, 1636430760297, 449, 0, 449, 0, 0, 0
7633, 2, 1636430750360, 1636430760364, 10004, 0, 10004, 0, 0, 0
7805, 1, 1636430759944, 1636430760385, 441, 1, 440, 0, 0, 0
7804, 1, 1636430759937, 1636430760385, 448, 0, 448, 0, 0, 0
7806, 1, 1636430760112, 1636430760584, 472, 22, 450, 22, 0, 22
7807, 1, 1636430760124, 1636430760592, 468, 0, 468, 0, 0, 0
7808, 1, 1636430760233, 1636430760681, 448, 0, 448, 0, 0, 0
7810, 1, 1636430760356, 1636430760800, 444, 0, 444, 0, 0, 0
7809, 1, 1636430760352, 1636430760804, 452, 1, 451, 0, 1, 1
7812, 1, 1636430760412, 1636430760848, 436, 0, 436, 0, 0, 0
7811, 1, 1636430760408, 1636430760848, 440, 1, 439, 1, 0, 1
7813, 1, 1636430760452, 1636430760896, 444, 0, 444, 0, 0, 0
7814, 1, 1636430760472, 1636430760916, 444, 0, 444, 0, 0, 0
7815, 1, 1636430760544, 1636430760996, 452, 0, 452, 0, 0, 0
7817, 1, 1636430760608, 1636430761052, 444, 1, 443, 0, 1, 1
7816, 1, 1636430760604, 1636430761056, 452, 1, 451, 0, 0, 0
7818, 1, 1636430760668, 1636430761112, 444, 1, 443, 0, 0, 0
7647, 2, 1636430751116, 1636430761117, 10001, 0, 10001, 0, 0, 0
7819, 1, 1636430760800, 1636430761248, 448, 1, 447, 1, 0, 1
7820, 1, 1636430760812, 1636430761264, 452, 0, 452, 0, 0, 0
7821, 1, 1636430760896, 1636430761352, 456, 1, 455, 0, 1, 1
7654, 2, 1636430751493, 1636430761496, 10003, 0, 10003, 0, 0, 0
7823, 1, 1636430761028, 1636430761524, 496, 1, 495, 1, 0, 1
7822, 1, 1636430761028, 1636430761525, 497, 1, 496, 0, 0, 0
7824, 1, 1636430761072, 1636430761524, 452, 0, 452, 0, 0, 0
7825, 1, 1636430761084, 1636430761528, 444, 0, 444, 0, 0, 0
7826, 1, 1636430761164, 1636430761616, 452, 1, 451, 0, 0, 0
7828, 1, 1636430761212, 1636430761656, 444, 0, 444, 0, 0, 0
7830, 1, 1636430761292, 1636430761741, 449, 1, 448, 0, 1, 1
7829, 1, 1636430761296, 1636430761741, 445, 1, 444, 0, 1, 1
7831, 1, 1636430761332, 1636430761812, 480, 1, 479, 0, 0, 0
7832, 1, 1636430761416, 1636430761900, 484, 1, 483, 1, 0, 1
7834, 1, 1636430761484, 1636430761932, 448, 0, 448, 0, 0, 0
7833, 1, 1636430761468, 1636430761984, 516, 57, 459, 57, 0, 57
7835, 1, 1636430761584, 1636430762028, 444, 1, 443, 1, 0, 1
7836, 1, 1636430761744, 1636430762197, 453, 0, 453, 0, 0, 0
7838, 1, 1636430761756, 1636430762208, 452, 1, 451, 0, 1, 1
7837, 1, 1636430761752, 1636430762209, 457, 1, 456, 0, 0, 0
7839, 1, 1636430761756, 1636430762212, 456, 1, 455, 0, 1, 1
7840, 1, 1636430761804, 1636430762252, 448, 0, 448, 0, 0, 0
7841, 1, 1636430761832, 1636430762288, 456, 0, 456, 0, 0, 0
7842, 1, 1636430761884, 1636430762336, 452, 1, 451, 0, 1, 1
7843, 1, 1636430761961, 1636430762413, 452, 0, 452, 0, 0, 0
7844, 1, 1636430761969, 1636430762420, 451, 0, 451, 0, 0, 0
7845, 1, 1636430762032, 1636430762484, 452, 0, 452, 0, 0, 0
7846, 1, 1636430762120, 1636430762576, 456, 1, 455, 0, 0, 0
7847, 1, 1636430762156, 1636430762600, 444, 1, 443, 0, 0, 0
7848, 1, 1636430762197, 1636430762644, 447, 0, 447, 0, 0, 0
7849, 1, 1636430762252, 1636430762700, 448, 1, 447, 0, 1, 1
7852, 1, 1636430762428, 1636430762864, 436, 0, 436, 0, 0, 0
7851, 1, 1636430762420, 1636430762865, 445, 1, 444, 0, 1, 1
7850, 1, 1636430762416, 1636430762864, 448, 1, 447, 0, 0, 0
7853, 1, 1636430762436, 1636430762884, 448, 0, 448, 0, 0, 0
7854, 1, 1636430762472, 1636430762912, 440, 0, 440, 0, 0, 0
7855, 1, 1636430762500, 1636430762953, 453, 1, 452, 0, 0, 0
7856, 1, 1636430762552, 1636430763000, 448, 0, 448, 0, 0, 0
7857, 1, 1636430762632, 1636430763084, 452, 1, 451, 1, 0, 1
7858, 1, 1636430762637, 1636430763084, 447, 0, 447, 0, 0, 0
7859, 1, 1636430762708, 1636430763160, 452, 1, 451, 1, 0, 1
7860, 1, 1636430762792, 1636430763248, 456, 1, 455, 1, 0, 1
7861, 1, 1636430762832, 1636430763276, 444, 1, 443, 0, 1, 1
7862, 1, 1636430762868, 1636430763312, 444, 0, 444, 0, 0, 0
7863, 1, 1636430762920, 1636430763364, 444, 1, 443, 0, 0, 0
7864, 1, 1636430763092, 1636430763532, 440, 0, 440, 0, 0, 0
7865, 1, 1636430763100, 1636430763548, 448, 1, 447, 0, 0, 0
7866, 1, 1636430763100, 1636430763548, 448, 1, 447, 1, 0, 1
7867, 1, 1636430763108, 1636430763560, 452, 0, 452, 0, 0, 0
7868, 1, 1636430763136, 1636430763584, 448, 0, 448, 0, 0, 0
7869, 1, 1636430763168, 1636430763624, 456, 0, 456, 0, 0, 0
7872, 1, 1636430763376, 1636430763828, 452, 0, 452, 0, 0, 0
7873, 1, 1636430763465, 1636430763904, 439, 0, 439, 0, 0, 0
7875, 1, 1636430763540, 1636430763981, 441, 0, 441, 0, 0, 0
7874, 1, 1636430763500, 1636430763996, 496, 49, 447, 49, 0, 49
7879, 1, 1636430763768, 1636430764212, 444, 1, 443, 1, 0, 1
7878, 1, 1636430763768, 1636430764212, 444, 1, 443, 1, 0, 1
7881, 1, 1636430763804, 1636430764256, 452, 1, 451, 0, 0, 0
7882, 1, 1636430763840, 1636430764288, 448, 1, 447, 0, 1, 1
7880, 1, 1636430763780, 1636430764432, 652, 201, 451, 201, 0, 201
7883, 1, 1636430764052, 1636430764504, 452, 1, 451, 0, 0, 0
7884, 1, 1636430764137, 1636430764584, 447, 0, 447, 0, 0, 0
7886, 1, 1636430764216, 1636430764657, 441, 1, 440, 0, 0, 0
7706, 2, 1636430754860, 1636430764860, 10000, 0, 10000, 1, 0, 1
7887, 1, 1636430764436, 1636430764888, 452, 1, 451, 0, 1, 1
7888, 1, 1636430764436, 1636430764888, 452, 1, 451, 0, 1, 1
7889, 1, 1636430764476, 1636430764924, 448, 1, 447, 0, 0, 0
7890, 1, 1636430764512, 1636430764964, 452, 1, 451, 1, 0, 1
7891, 1, 1636430764729, 1636430765176, 447, 0, 447, 0, 0, 0
7892, 1, 1636430764801, 1636430765260, 459, 0, 459, 0, 0, 0
7893, 1, 1636430764904, 1636430765356, 452, 0, 452, 0, 0, 0
7896, 1, 1636430765148, 1636430765588, 440, 0, 440, 0, 0, 0
7898, 1, 1636430765176, 1636430765620, 444, 0, 444, 0, 0, 0
7897, 1, 1636430765172, 1636430765628, 456, 1, 455, 0, 0, 0
7899, 1, 1636430765396, 1636430765836, 440, 0, 440, 0, 0, 0
7900, 1, 1636430765472, 1636430765917, 445, 0, 445, 0, 0, 0
7902, 1, 1636430765816, 1636430766265, 449, 0, 449, 0, 0, 0
7904, 1, 1636430765848, 1636430766292, 444, 1, 443, 0, 0, 0
7903, 1, 1636430765848, 1636430766300, 452, 1, 451, 0, 0, 0
7905, 1, 1636430766065, 1636430766516, 451, 0, 451, 0, 0, 0
7906, 1, 1636430766145, 1636430766597, 452, 0, 452, 0, 0, 0
7907, 1, 1636430766488, 1636430766925, 437, 0, 437, 0, 0, 0
7909, 1, 1636430766520, 1636430766968, 448, 0, 448, 0, 0, 0
7910, 1, 1636430766740, 1636430767193, 453, 1, 452, 1, 0, 1
7911, 1, 1636430766816, 1636430767269, 453, 1, 452, 1, 0, 1
7754, 2, 1636430757400, 1636430767405, 10005, 0, 10005, 0, 0, 0
7912, 1, 1636430767153, 1636430767629, 476, 0, 476, 0, 0, 0
7913, 1, 1636430767188, 1636430767640, 452, 1, 451, 0, 0, 0
7914, 1, 1636430767452, 1636430767900, 448, 0, 448, 0, 0, 0
7916, 1, 1636430767708, 1636430768161, 453, 1, 452, 0, 1, 1
7917, 1, 1636430767848, 1636430768293, 445, 1, 444, 0, 0, 0
7918, 1, 1636430767860, 1636430768301, 441, 0, 441, 0, 0, 0
7771, 2, 1636430758296, 1636430768301, 10005, 0, 10005, 0, 0, 0
7919, 1, 1636430768121, 1636430768564, 443, 0, 443, 0, 0, 0
7920, 1, 1636430768392, 1636430768849, 457, 1, 456, 0, 0, 0
7921, 1, 1636430768517, 1636430768960, 443, 0, 443, 0, 0, 0
7922, 1, 1636430768528, 1636430768973, 445, 1, 444, 0, 0, 0
7924, 1, 1636430768784, 1636430769229, 445, 1, 444, 0, 0, 0
7791, 2, 1636430759264, 1636430769265, 10001, 0, 10001, 0, 0, 0
7923, 1, 1636430768596, 1636430769424, 828, 377, 451, 376, 0, 376
7925, 1, 1636430769065, 1636430769516, 451, 0, 451, 0, 0, 0
7926, 1, 1636430769180, 1636430769669, 489, 0, 489, 0, 0, 0
7927, 1, 1636430769197, 1636430769672, 475, 0, 475, 0, 0, 0
7928, 1, 1636430769452, 1636430769913, 461, 0, 461, 0, 0, 0
7929, 1, 1636430769568, 1636430770025, 457, 1, 456, 0, 1, 1
7930, 1, 1636430769648, 1636430770088, 440, 1, 439, 0, 0, 0
7931, 1, 1636430769732, 1636430770176, 444, 1, 443, 1, 0, 1
7933, 1, 1636430769897, 1636430770352, 455, 0, 455, 0, 0, 0
7932, 1, 1636430769897, 1636430770352, 455, 0, 455, 0, 0, 0
7934, 1, 1636430770132, 1636430770572, 440, 1, 439, 0, 0, 0
7935, 1, 1636430770245, 1636430770697, 452, 0, 452, 0, 0, 0
7936, 1, 1636430770316, 1636430770752, 436, 0, 436, 0, 0, 0
7937, 1, 1636430770396, 1636430770840, 444, 0, 444, 0, 0, 0
7939, 1, 1636430770572, 1636430771024, 452, 1, 451, 1, 0, 1
7827, 2, 1636430761164, 1636430771161, 9997, 0, 9997, 0, 0, 0
7940, 1, 1636430770796, 1636430771244, 448, 1, 447, 1, 0, 1
7941, 1, 1636430770921, 1636430771384, 463, 0, 463, 0, 0, 0
7942, 1, 1636430770981, 1636430771425, 444, 0, 444, 0, 0, 0
7943, 1, 1636430771064, 1636430771517, 453, 1, 452, 0, 1, 1
7944, 1, 1636430771253, 1636430771700, 447, 0, 447, 0, 0, 0
7947, 1, 1636430771605, 1636430772044, 439, 0, 439, 0, 0, 0
7948, 1, 1636430771644, 1636430772085, 441, 1, 440, 0, 0, 0
7946, 1, 1636430771469, 1636430772148, 679, 232, 447, 232, 0, 232
7949, 1, 1636430771728, 1636430772177, 449, 1, 448, 0, 0, 0
7950, 1, 1636430771921, 1636430772369, 448, 0, 448, 0, 0, 0
7951, 1, 1636430772268, 1636430772720, 452, 1, 451, 0, 0, 0
7952, 1, 1636430772312, 1636430772764, 452, 0, 452, 0, 0, 0
7953, 1, 1636430772373, 1636430772821, 448, 0, 448, 0, 0, 0
7954, 1, 1636430772397, 1636430772849, 452, 0, 452, 0, 0, 0
7871, 2, 1636430763300, 1636430773304, 10004, 0, 10004, 0, 0, 0
7870, 2, 1636430763300, 1636430773348, 10048, 0, 10048, 0, 0, 0
7956, 1, 1636430772944, 1636430773388, 444, 0, 444, 0, 0, 0
7957, 1, 1636430772988, 1636430773436, 448, 0, 448, 0, 0, 0
7959, 1, 1636430773072, 1636430773568, 496, 1, 495, 0, 0, 0
7958, 1, 1636430773041, 1636430773573, 532, 0, 532, 0, 0, 0
7876, 2, 1636430763588, 1636430773589, 10001, 0, 10001, 0, 0, 0
7877, 2, 1636430763756, 1636430773757, 10001, 0, 10001, 0, 0, 0
7962, 1, 1636430773636, 1636430774093, 457, 1, 456, 1, 0, 1
7961, 1, 1636430773636, 1636430774093, 457, 1, 456, 0, 1, 1
7960, 1, 1636430773636, 1636430774093, 457, 1, 456, 0, 0, 0
7963, 1, 1636430773676, 1636430774156, 480, 0, 480, 0, 0, 0
7885, 2, 1636430764200, 1636430774200, 10000, 0, 10000, 0, 0, 0
7964, 1, 1636430773804, 1636430774256, 452, 1, 451, 0, 1, 1
7965, 1, 1636430773804, 1636430774260, 456, 1, 455, 1, 0, 1
7967, 1, 1636430774069, 1636430774517, 448, 0, 448, 0, 0, 0
7966, 1, 1636430773893, 1636430774700, 807, 364, 443, 364, 0, 364
7969, 1, 1636430774308, 1636430774756, 448, 0, 448, 0, 0, 0
7970, 1, 1636430774312, 1636430774760, 448, 1, 447, 1, 0, 1
7968, 1, 1636430774312, 1636430774764, 452, 1, 451, 1, 0, 1
7971, 1, 1636430774372, 1636430774816, 444, 0, 444, 0, 0, 0
7972, 1, 1636430774480, 1636430774924, 444, 1, 443, 0, 1, 1
7973, 1, 1636430774480, 1636430774928, 448, 1, 447, 1, 0, 1
7974, 1, 1636430774500, 1636430774968, 468, 18, 450, 17, 0, 17
7895, 2, 1636430765108, 1636430775109, 10001, 0, 10001, 1, 0, 1
7894, 2, 1636430765113, 1636430775156, 10043, 0, 10043, 0, 0, 0
7975, 1, 1636430774744, 1636430775188, 444, 1, 443, 0, 0, 0
7976, 1, 1636430774917, 1636430775380, 463, 0, 463, 0, 0, 0
7977, 1, 1636430774981, 1636430775476, 495, 0, 495, 0, 0, 0
7979, 1, 1636430774984, 1636430775476, 492, 0, 492, 0, 0, 0
7978, 1, 1636430774981, 1636430775476, 495, 0, 495, 0, 0, 0
7980, 1, 1636430775041, 1636430775560, 519, 0, 519, 0, 0, 0
7901, 2, 1636430765572, 1636430775572, 10000, 0, 10000, 1, 0, 1
7983, 1, 1636430775208, 1636430775656, 448, 0, 448, 0, 0, 0
7985, 1, 1636430775412, 1636430775888, 476, 1, 475, 0, 1, 1
7984, 1, 1636430775408, 1636430775888, 480, 0, 480, 0, 0, 0
7986, 1, 1636430775428, 1636430775892, 464, 0, 464, 0, 0, 0
7982, 1, 1636430775200, 1636430775924, 724, 277, 447, 277, 0, 277
7987, 1, 1636430775616, 1636430776053, 437, 0, 437, 0, 0, 0
7988, 1, 1636430775688, 1636430776132, 444, 0, 444, 0, 0, 0
7990, 1, 1636430775700, 1636430776144, 444, 1, 443, 0, 0, 0
7991, 1, 1636430775776, 1636430776216, 440, 0, 440, 0, 0, 0
7993, 1, 1636430775876, 1636430776337, 461, 13, 448, 13, 0, 13
7992, 1, 1636430775868, 1636430776337, 469, 21, 448, 21, 0, 21
7908, 2, 1636430766513, 1636430776516, 10003, 0, 10003, 0, 0, 0
7995, 1, 1636430776104, 1636430776548, 444, 0, 444, 0, 0, 0
7994, 1, 1636430776113, 1636430776569, 456, 0, 456, 0, 0, 0
7996, 1, 1636430776113, 1636430776572, 459, 0, 459, 0, 0, 0
7997, 1, 1636430776144, 1636430776580, 436, 0, 436, 0, 0, 0
7998, 1, 1636430776272, 1636430776740, 468, 0, 468, 0, 0, 0
7999, 1, 1636430776360, 1636430776836, 476, 1, 475, 0, 0, 0
8000, 1, 1636430776364, 1636430776836, 472, 1, 471, 0, 0, 0
8001, 1, 1636430776445, 1636430776932, 487, 0, 487, 0, 0, 0
8003, 1, 1636430776569, 1636430777020, 451, 0, 451, 0, 0, 0
8002, 1, 1636430776560, 1636430777020, 460, 9, 451, 9, 0, 9
8004, 1, 1636430776773, 1636430777217, 444, 0, 444, 0, 0, 0
8005, 1, 1636430776793, 1636430777240, 447, 0, 447, 0, 0, 0
8007, 1, 1636430776804, 1636430777241, 437, 0, 437, 0, 0, 0
8006, 1, 1636430776796, 1636430777248, 452, 0, 452, 0, 0, 0
8008, 1, 1636430776821, 1636430777260, 439, 0, 439, 0, 0, 0
8009, 1, 1636430776960, 1636430777409, 449, 1, 448, 0, 1, 1
7915, 2, 1636430767496, 1636430777497, 10001, 0, 10001, 0, 0, 0
8011, 1, 1636430777048, 1636430777500, 452, 0, 452, 0, 0, 0
8012, 1, 1636430777148, 1636430777596, 448, 1, 447, 0, 1, 1
8013, 1, 1636430777236, 1636430777717, 481, 1, 480, 0, 0, 0
8014, 1, 1636430777240, 1636430777720, 480, 1, 479, 1, 0, 1
8015, 1, 1636430777436, 1636430777892, 456, 0, 456, 0, 0, 0
8016, 1, 1636430777456, 1636430777896, 440, 1, 439, 0, 0, 0
8017, 1, 1636430777468, 1636430777908, 440, 1, 439, 0, 0, 0
8019, 1, 1636430777476, 1636430777928, 452, 1, 451, 0, 1, 1
8018, 1, 1636430777476, 1636430777928, 452, 1, 451, 1, 0, 1
8021, 1, 1636430777716, 1636430778164, 448, 1, 447, 0, 0, 0
8020, 1, 1636430777676, 1636430778168, 492, 41, 451, 41, 0, 41
8022, 1, 1636430777800, 1636430778244, 444, 1, 443, 0, 0, 0
8023, 1, 1636430777820, 1636430778272, 452, 1, 451, 0, 1, 1
8024, 1, 1636430777932, 1636430778392, 460, 0, 460, 0, 0, 0
8025, 1, 1636430777940, 1636430778393, 453, 0, 453, 0, 0, 0
8026, 1, 1636430778104, 1636430778557, 453, 0, 453, 0, 0, 0
8028, 1, 1636430778132, 1636430778581, 449, 0, 449, 0, 0, 0
8027, 1, 1636430778124, 1636430778585, 461, 0, 461, 0, 0, 0
8030, 1, 1636430778148, 1636430778597, 449, 0, 449, 0, 0, 0
8029, 1, 1636430778144, 1636430778604, 460, 0, 460, 0, 0, 0
8031, 1, 1636430778388, 1636430778840, 452, 1, 451, 1, 0, 1
8032, 1, 1636430778392, 1636430778848, 456, 1, 455, 0, 0, 0
8033, 1, 1636430778460, 1636430778912, 452, 1, 451, 0, 0, 0
8034, 1, 1636430778485, 1636430778936, 451, 0, 451, 0, 0, 0
8036, 1, 1636430778608, 1636430779061, 453, 1, 452, 1, 0, 1
8035, 1, 1636430778608, 1636430779061, 453, 1, 452, 1, 0, 1
8037, 1, 1636430778776, 1636430779228, 452, 1, 451, 1, 0, 1
8038, 1, 1636430778797, 1636430779244, 447, 0, 447, 0, 0, 0
8039, 1, 1636430778800, 1636430779244, 444, 0, 444, 0, 0, 0
8041, 1, 1636430778820, 1636430779264, 444, 0, 444, 0, 0, 0
8042, 1, 1636430779064, 1636430779504, 440, 1, 439, 1, 0, 1
8043, 1, 1636430779064, 1636430779512, 448, 1, 447, 1, 0, 1
8044, 1, 1636430779132, 1636430779576, 444, 1, 443, 1, 0, 1
8045, 1, 1636430779160, 1636430779596, 436, 0, 436, 0, 0, 0
8040, 1, 1636430778816, 1636430779681, 865, 413, 452, 413, 0, 413
8047, 1, 1636430779281, 1636430779724, 443, 0, 443, 0, 0, 0
8048, 1, 1636430779444, 1636430779896, 452, 0, 452, 0, 0, 0
8049, 1, 1636430779476, 1636430779924, 448, 1, 447, 0, 0, 0
8050, 1, 1636430779476, 1636430779928, 452, 1, 451, 1, 0, 1
8051, 1, 1636430779484, 1636430779928, 444, 0, 444, 0, 0, 0
8046, 1, 1636430779281, 1636430780128, 847, 400, 447, 400, 0, 400
8052, 1, 1636430779732, 1636430780176, 444, 1, 443, 1, 0, 1
8053, 1, 1636430779740, 1636430780184, 444, 1, 443, 1, 0, 1
8055, 1, 1636430779824, 1636430780272, 448, 1, 447, 0, 0, 0
8056, 1, 1636430779896, 1636430780348, 452, 0, 452, 0, 0, 0
8057, 1, 1636430779956, 1636430780400, 444, 1, 443, 0, 0, 0
8058, 1, 1636430780116, 1636430780560, 444, 0, 444, 0, 0, 0
7938, 2, 1636430770572, 1636430780572, 10000, 0, 10000, 0, 0, 0
8054, 1, 1636430779792, 1636430780588, 796, 337, 459, 337, 0, 337
8059, 1, 1636430780149, 1636430780600, 451, 0, 451, 0, 0, 0
8060, 1, 1636430780149, 1636430780604, 455, 0, 455, 0, 0, 0
8062, 1, 1636430780352, 1636430780800, 448, 0, 448, 0, 0, 0
8064, 1, 1636430780408, 1636430780885, 477, 1, 476, 1, 0, 1
8063, 1, 1636430780393, 1636430780896, 503, 0, 503, 0, 0, 0
8065, 1, 1636430780492, 1636430780968, 476, 1, 475, 1, 0, 1
8066, 1, 1636430780564, 1636430781004, 440, 0, 440, 0, 0, 0
8068, 1, 1636430780780, 1636430781220, 440, 0, 440, 0, 0, 0
8067, 1, 1636430780616, 1636430781240, 624, 185, 439, 184, 1, 185
8069, 1, 1636430780804, 1636430781260, 456, 0, 456, 0, 0, 0
8071, 1, 1636430780820, 1636430781268, 448, 0, 448, 0, 0, 0
8070, 1, 1636430780816, 1636430781272, 456, 1, 455, 1, 0, 1
8072, 1, 1636430780884, 1636430781332, 448, 1, 447, 0, 0, 0
7945, 2, 1636430771464, 1636430781465, 10001, 0, 10001, 1, 0, 1
8074, 1, 1636430781104, 1636430781552, 448, 1, 447, 0, 1, 1
8075, 1, 1636430781116, 1636430781564, 448, 1, 447, 1, 0, 1
8076, 1, 1636430781192, 1636430781632, 440, 0, 440, 0, 0, 0
8073, 1, 1636430781020, 1636430781780, 760, 313, 447, 313, 0, 313
8078, 1, 1636430781449, 1636430781896, 447, 0, 447, 0, 0, 0
8061, 1, 1636430780156, 1636430781912, 1756, 1309, 447, 0, 1309, 1309
8079, 1, 1636430781460, 1636430781916, 456, 1, 455, 0, 0, 0
8081, 1, 1636430781512, 1636430781952, 440, 1, 439, 0, 1, 1
8082, 1, 1636430781512, 1636430781960, 448, 1, 447, 0, 0, 0
8080, 1, 1636430781512, 1636430781964, 452, 1, 451, 1, 0, 1
8083, 1, 1636430781552, 1636430782001, 449, 0, 449, 0, 0, 0
8077, 1, 1636430781240, 1636430782080, 840, 393, 447, 392, 0, 392
8084, 1, 1636430781776, 1636430782232, 456, 1, 455, 0, 0, 0
8086, 1, 1636430781796, 1636430782245, 449, 1, 448, 0, 0, 0
8087, 1, 1636430781856, 1636430782301, 445, 0, 445, 0, 0, 0
8088, 1, 1636430782000, 1636430782448, 448, 1, 447, 0, 0, 0
8085, 1, 1636430781776, 1636430782528, 752, 305, 447, 304, 0, 304
8089, 1, 1636430782116, 1636430782572, 456, 0, 456, 0, 0, 0
8091, 1, 1636430782132, 1636430782576, 444, 1, 443, 0, 0, 0
7955, 2, 1636430772589, 1636430782588, 9999, 0, 9999, 0, 0, 0
8092, 1, 1636430782168, 1636430782612, 444, 1, 443, 0, 0, 0
8093, 1, 1636430782180, 1636430782620, 440, 0, 440, 0, 0, 0
8094, 1, 1636430782176, 1636430782624, 448, 0, 448, 0, 0, 0
8095, 1, 1636430782216, 1636430782656, 440, 0, 440, 0, 0, 0
8090, 1, 1636430782132, 1636430782680, 548, 101, 447, 100, 0, 100
8096, 1, 1636430782301, 1636430782748, 447, 0, 447, 0, 0, 0
8097, 1, 1636430782452, 1636430782908, 456, 1, 455, 1, 0, 1
8098, 1, 1636430782464, 1636430782920, 456, 1, 455, 1, 0, 1
8099, 1, 1636430782520, 1636430783000, 480, 0, 480, 0, 0, 0
8100, 1, 1636430782676, 1636430783136, 460, 0, 460, 0, 0, 0
8101, 1, 1636430782768, 1636430783220, 452, 1, 451, 1, 0, 1
8102, 1, 1636430782789, 1636430783244, 455, 0, 455, 0, 0, 0
8103, 1, 1636430782804, 1636430783253, 449, 0, 449, 0, 0, 0
8104, 1, 1636430782836, 1636430783284, 448, 1, 447, 0, 1, 1
8106, 1, 1636430782848, 1636430783300, 452, 1, 451, 1, 0, 1
8107, 1, 1636430782889, 1636430783336, 447, 0, 447, 0, 0, 0
8109, 1, 1636430782908, 1636430783352, 444, 1, 443, 1, 0, 1
8108, 1, 1636430782905, 1636430783352, 447, 0, 447, 0, 0, 0
8110, 1, 1636430782964, 1636430783440, 476, 37, 439, 37, 0, 37
8111, 1, 1636430783129, 1636430783572, 443, 0, 443, 0, 0, 0
8112, 1, 1636430783140, 1636430783576, 436, 0, 436, 0, 0, 0
8113, 1, 1636430783216, 1636430783660, 444, 1, 443, 1, 0, 1
8114, 1, 1636430783356, 1636430783804, 448, 0, 448, 0, 0, 0
8115, 1, 1636430783440, 1636430783884, 444, 1, 443, 0, 0, 0
8117, 1, 1636430783469, 1636430783912, 443, 0, 443, 0, 0, 0
8116, 1, 1636430783457, 1636430783912, 455, 0, 455, 0, 0, 0
8118, 1, 1636430783508, 1636430783956, 448, 0, 448, 0, 0, 0
8122, 1, 1636430783568, 1636430784004, 436, 1, 435, 1, 0, 1
8120, 1, 1636430783556, 1636430784004, 448, 0, 448, 0, 0, 0
8121, 1, 1636430783572, 1636430784020, 448, 1, 447, 1, 0, 1
8123, 1, 1636430783652, 1636430784108, 456, 9, 447, 9, 0, 9
8124, 1, 1636430783800, 1636430784257, 457, 1, 456, 1, 0, 1
8126, 1, 1636430783880, 1636430784324, 444, 1, 443, 0, 0, 0
8119, 1, 1636430783524, 1636430784364, 840, 389, 451, 389, 0, 389
8125, 1, 1636430783808, 1636430784368, 560, 105, 455, 105, 0, 105
8128, 1, 1636430784136, 1636430784584, 448, 1, 447, 1, 0, 1
8127, 1, 1636430784132, 1636430784592, 460, 0, 460, 0, 0, 0
8130, 1, 1636430784224, 1636430784669, 445, 0, 445, 0, 0, 0
8131, 1, 1636430784236, 1636430784684, 448, 0, 448, 0, 0, 0
8132, 1, 1636430784240, 1636430784712, 472, 17, 455, 17, 0, 17
8133, 1, 1636430784332, 1636430784781, 449, 1, 448, 1, 0, 1
8129, 1, 1636430784176, 1636430784812, 636, 193, 443, 192, 1, 193
8134, 1, 1636430784480, 1636430784928, 448, 1, 447, 0, 0, 0
8135, 1, 1636430784548, 1636430784988, 440, 0, 440, 0, 0, 0
8136, 1, 1636430784580, 1636430785028, 448, 1, 447, 0, 0, 0
8137, 1, 1636430784584, 1636430785028, 444, 0, 444, 0, 0, 0
7981, 2, 1636430775200, 1636430785157, 9957, 0, 9957, 0, 0, 0
8138, 1, 1636430784800, 1636430785244, 444, 1, 443, 0, 0, 0
8139, 1, 1636430784812, 1636430785256, 444, 0, 444, 0, 0, 0
8141, 1, 1636430784900, 1636430785380, 480, 0, 480, 0, 0, 0
8140, 1, 1636430784888, 1636430785380, 492, 0, 492, 0, 0, 0
8142, 1, 1636430784936, 1636430785380, 444, 0, 444, 0, 0, 0
8143, 1, 1636430784996, 1636430785468, 472, 0, 472, 0, 0, 0
8144, 1, 1636430785032, 1636430785493, 461, 0, 461, 0, 0, 0
8145, 1, 1636430785149, 1636430785601, 452, 0, 452, 0, 0, 0
8146, 1, 1636430785244, 1636430785684, 440, 0, 440, 0, 0, 0
8147, 1, 1636430785256, 1636430785700, 444, 0, 444, 0, 0, 0
8148, 1, 1636430785256, 1636430785701, 445, 0, 445, 0, 0, 0
7989, 2, 1636430775700, 1636430785701, 10001, 0, 10001, 0, 0, 0
8149, 1, 1636430785468, 1636430785924, 456, 1, 455, 1, 0, 1
8150, 1, 1636430785504, 1636430785956, 452, 1, 451, 0, 1, 1
8153, 1, 1636430785600, 1636430786041, 441, 1, 440, 0, 0, 0
8151, 1, 1636430785597, 1636430786044, 447, 0, 447, 0, 0, 0
8152, 1, 1636430785600, 1636430786044, 444, 1, 443, 0, 0, 0
8154, 1, 1636430785684, 1636430786133, 449, 1, 448, 0, 0, 0
8155, 1, 1636430785748, 1636430786196, 448, 0, 448, 0, 0, 0
8156, 1, 1636430785820, 1636430786264, 444, 0, 444, 0, 0, 0
8159, 1, 1636430785920, 1636430786357, 437, 0, 437, 0, 0, 0
8157, 1, 1636430785904, 1636430786357, 453, 0, 453, 0, 0, 0
8158, 1, 1636430785912, 1636430786357, 445, 0, 445, 0, 0, 0
8160, 1, 1636430786008, 1636430786488, 480, 37, 443, 37, 0, 37
8162, 1, 1636430786173, 1636430786624, 451, 0, 451, 0, 0, 0
8163, 1, 1636430786268, 1636430786716, 448, 1, 447, 1, 0, 1
8164, 1, 1636430786268, 1636430786720, 452, 1, 451, 0, 1, 1
8165, 1, 1636430786268, 1636430786720, 452, 1, 451, 0, 1, 1
8166, 1, 1636430786356, 1636430786813, 457, 1, 456, 0, 0, 0
8167, 1, 1636430786416, 1636430786865, 449, 1, 448, 1, 0, 1
8168, 1, 1636430786488, 1636430786936, 448, 1, 447, 1, 0, 1
8170, 1, 1636430786580, 1636430787028, 448, 1, 447, 0, 1, 1
8169, 1, 1636430786576, 1636430787028, 452, 1, 451, 1, 0, 1
8171, 1, 1636430786584, 1636430787028, 444, 0, 444, 0, 0, 0
8010, 2, 1636430777057, 1636430787060, 10003, 0, 10003, 0, 0, 0
8172, 1, 1636430786704, 1636430787152, 448, 0, 448, 0, 0, 0
8173, 1, 1636430786844, 1636430787292, 448, 1, 447, 1, 0, 1
8175, 1, 1636430786940, 1636430787388, 448, 0, 448, 0, 0, 0
8176, 1, 1636430786944, 1636430787396, 452, 0, 452, 0, 0, 0
8174, 1, 1636430786944, 1636430787396, 452, 0, 452, 0, 0, 0
8177, 1, 1636430787036, 1636430787484, 448, 0, 448, 0, 0, 0
8179, 1, 1636430787156, 1636430787600, 444, 0, 444, 0, 0, 0
8180, 1, 1636430787252, 1636430787692, 440, 1, 439, 0, 0, 0
8181, 1, 1636430787252, 1636430787692, 440, 1, 439, 0, 0, 0
8182, 1, 1636430787252, 1636430787696, 444, 1, 443, 0, 0, 0
8183, 1, 1636430787368, 1636430787813, 445, 0, 445, 0, 0, 0
8184, 1, 1636430787372, 1636430787816, 444, 1, 443, 1, 0, 1
8185, 1, 1636430787508, 1636430787960, 452, 1, 451, 0, 0, 0
8188, 1, 1636430787620, 1636430788060, 440, 1, 439, 1, 0, 1
8187, 1, 1636430787620, 1636430788060, 440, 1, 439, 1, 0, 1
8186, 1, 1636430787608, 1636430788064, 456, 1, 455, 1, 0, 1
8189, 1, 1636430787704, 1636430788149, 445, 1, 444, 0, 1, 1
8190, 1, 1636430787824, 1636430788264, 440, 1, 439, 0, 1, 1
8191, 1, 1636430787908, 1636430788352, 444, 1, 443, 1, 0, 1
8192, 1, 1636430787916, 1636430788356, 440, 1, 439, 0, 0, 0
8193, 1, 1636430787920, 1636430788412, 492, 41, 451, 41, 0, 41
8195, 1, 1636430788036, 1636430788481, 445, 1, 444, 1, 0, 1
8194, 1, 1636430788028, 1636430788481, 453, 1, 452, 0, 1, 1
8196, 1, 1636430788176, 1636430788624, 448, 1, 447, 1, 0, 1
8198, 1, 1636430788284, 1636430788740, 456, 1, 455, 0, 0, 0
8197, 1, 1636430788284, 1636430788740, 456, 2, 454, 0, 0, 0
8199, 1, 1636430788284, 1636430788744, 460, 1, 459, 0, 0, 0
8200, 1, 1636430788376, 1636430788825, 449, 1, 448, 0, 0, 0
8201, 1, 1636430788484, 1636430788944, 460, 0, 460, 0, 0, 0
8202, 1, 1636430788577, 1636430789024, 447, 0, 447, 0, 0, 0
8203, 1, 1636430788584, 1636430789032, 448, 0, 448, 0, 0, 0
8204, 1, 1636430788632, 1636430789084, 452, 0, 452, 0, 0, 0
8205, 1, 1636430788700, 1636430789148, 448, 0, 448, 0, 0, 0
8206, 1, 1636430788704, 1636430789149, 445, 0, 445, 0, 0, 0
8207, 1, 1636430788844, 1636430789288, 444, 0, 444, 0, 0, 0
8208, 1, 1636430788960, 1636430789400, 440, 1, 439, 0, 1, 1
8209, 1, 1636430788960, 1636430789404, 444, 0, 444, 0, 0, 0
8210, 1, 1636430788960, 1636430789408, 448, 0, 448, 0, 0, 0
8212, 1, 1636430789160, 1636430789608, 448, 0, 448, 0, 0, 0
8214, 1, 1636430789248, 1636430789692, 444, 1, 443, 0, 1, 1
8213, 1, 1636430789248, 1636430789692, 444, 1, 443, 0, 1, 1
8215, 1, 1636430789300, 1636430789736, 436, 1, 435, 0, 1, 1
8211, 1, 1636430789040, 1636430789744, 704, 249, 455, 249, 0, 249
8217, 1, 1636430789368, 1636430789817, 449, 0, 449, 0, 0, 0
8218, 1, 1636430789504, 1636430789956, 452, 0, 452, 0, 0, 0
8219, 1, 1636430789620, 1636430790068, 448, 1, 447, 1, 0, 1
8221, 1, 1636430789632, 1636430790076, 444, 0, 444, 0, 0, 0
8216, 1, 1636430789364, 1636430790132, 768, 329, 439, 329, 0, 329
8222, 1, 1636430789828, 1636430790281, 453, 1, 452, 0, 1, 1
8223, 1, 1636430789912, 1636430790360, 448, 1, 447, 1, 0, 1
8224, 1, 1636430789920, 1636430790368, 448, 1, 447, 0, 1, 1
8225, 1, 1636430789964, 1636430790400, 436, 0, 436, 0, 0, 0
8226, 1, 1636430789972, 1636430790412, 440, 1, 439, 0, 0, 0
8227, 1, 1636430790040, 1636430790485, 445, 1, 444, 0, 1, 1
8228, 1, 1636430790172, 1636430790620, 448, 0, 448, 0, 0, 0
8229, 1, 1636430790288, 1636430790741, 453, 1, 452, 1, 0, 1
8230, 1, 1636430790296, 1636430790745, 449, 0, 449, 0, 0, 0
8231, 1, 1636430790348, 1636430790796, 448, 0, 448, 0, 0, 0
8233, 1, 1636430790588, 1636430791037, 449, 1, 448, 0, 1, 1
8232, 1, 1636430790584, 1636430791037, 453, 1, 452, 0, 0, 0
8235, 1, 1636430790640, 1636430791084, 444, 0, 444, 0, 0, 0
8234, 1, 1636430790632, 1636430791084, 452, 0, 452, 0, 0, 0
8236, 1, 1636430790709, 1636430791165, 456, 0, 456, 0, 0, 0
8237, 1, 1636430790837, 1636430791284, 447, 0, 447, 0, 0, 0
8238, 1, 1636430790965, 1636430791416, 451, 0, 451, 0, 0, 0
8239, 1, 1636430790965, 1636430791416, 451, 0, 451, 0, 0, 0
8240, 1, 1636430791021, 1636430791468, 447, 0, 447, 0, 0, 0
8242, 1, 1636430791264, 1636430791708, 444, 0, 444, 0, 0, 0
8243, 1, 1636430791308, 1636430791756, 448, 1, 447, 0, 0, 0
8244, 1, 1636430791308, 1636430791760, 452, 1, 451, 0, 1, 1
8245, 1, 1636430791384, 1636430791828, 444, 1, 443, 0, 0, 0
8241, 1, 1636430791257, 1636430791913, 656, 212, 444, 212, 0, 212
8246, 1, 1636430791512, 1636430791956, 444, 1, 443, 0, 1, 1
8247, 1, 1636430791637, 1636430792084, 447, 0, 447, 0, 0, 0
8248, 1, 1636430791637, 1636430792084, 447, 0, 447, 0, 0, 0
8249, 1, 1636430791684, 1636430792136, 452, 0, 452, 0, 0, 0
8250, 1, 1636430791928, 1636430792380, 452, 1, 451, 0, 0, 0
8252, 1, 1636430791976, 1636430792420, 444, 1, 443, 0, 0, 0
8251, 1, 1636430791976, 1636430792420, 444, 1, 443, 0, 0, 0
8253, 1, 1636430792048, 1636430792492, 444, 0, 444, 0, 0, 0
8254, 1, 1636430792132, 1636430792585, 453, 0, 453, 0, 0, 0
8255, 1, 1636430792168, 1636430792620, 452, 1, 451, 0, 0, 0
8256, 1, 1636430792308, 1636430792756, 448, 1, 447, 0, 0, 0
8257, 1, 1636430792308, 1636430792756, 448, 0, 448, 0, 0, 0
8258, 1, 1636430792352, 1636430792796, 444, 0, 444, 0, 0, 0
8105, 2, 1636430782848, 1636430792848, 10000, 0, 10000, 0, 0, 0
8259, 1, 1636430792604, 1636430793069, 465, 0, 465, 0, 0, 0
8260, 1, 1636430792640, 1636430793085, 445, 0, 445, 0, 0, 0
8261, 1, 1636430792640, 1636430793088, 448, 0, 448, 0, 0, 0
8262, 1, 1636430792712, 1636430793161, 449, 1, 448, 0, 0, 0
8263, 1, 1636430792804, 1636430793252, 448, 0, 448, 0, 0, 0
8264, 1, 1636430792844, 1636430793296, 452, 1, 451, 0, 0, 0
8265, 1, 1636430792976, 1636430793420, 444, 1, 443, 0, 0, 0
8266, 1, 1636430792976, 1636430793421, 445, 1, 444, 0, 0, 0
8267, 1, 1636430793020, 1636430793536, 516, 65, 451, 65, 0, 65
8268, 1, 1636430793161, 1636430793608, 447, 0, 447, 0, 0, 0
8269, 1, 1636430793288, 1636430793737, 449, 1, 448, 0, 0, 0
8271, 1, 1636430793316, 1636430793765, 449, 1, 448, 1, 0, 1
8270, 1, 1636430793309, 1636430793765, 456, 0, 456, 0, 0, 0
8273, 1, 1636430793468, 1636430793920, 452, 0, 452, 0, 0, 0
8274, 1, 1636430793512, 1636430793956, 444, 0, 444, 0, 0, 0
8275, 1, 1636430793640, 1636430794088, 448, 0, 448, 0, 0, 0
8276, 1, 1636430793756, 1636430794200, 444, 1, 443, 0, 0, 0
8277, 1, 1636430793825, 1636430794276, 451, 0, 451, 0, 0, 0
8278, 1, 1636430793952, 1636430794393, 441, 1, 440, 0, 1, 1
8279, 1, 1636430793988, 1636430794437, 449, 1, 448, 0, 0, 0
8280, 1, 1636430793988, 1636430794437, 449, 1, 448, 0, 0, 0
8281, 1, 1636430794144, 1636430794592, 448, 0, 448, 0, 0, 0
8282, 1, 1636430794180, 1636430794621, 441, 1, 440, 0, 0, 0
8283, 1, 1636430794308, 1636430794752, 444, 0, 444, 0, 0, 0
8284, 1, 1636430794420, 1636430794872, 452, 1, 451, 1, 0, 1
8285, 1, 1636430794496, 1636430794944, 448, 1, 447, 0, 0, 0
8286, 1, 1636430794621, 1636430795076, 455, 0, 455, 0, 0, 0
8287, 1, 1636430794656, 1636430795105, 449, 1, 448, 1, 0, 1
8288, 1, 1636430794661, 1636430795109, 448, 0, 448, 0, 0, 0
8289, 1, 1636430794804, 1636430795256, 452, 0, 452, 0, 0, 0
8290, 1, 1636430794841, 1636430795288, 447, 0, 447, 0, 0, 0
8291, 1, 1636430794972, 1636430795429, 457, 0, 457, 0, 0, 0
8292, 1, 1636430795093, 1636430795545, 452, 0, 452, 0, 0, 0
8293, 1, 1636430795160, 1636430795608, 448, 1, 447, 1, 0, 1
8294, 1, 1636430795288, 1636430795732, 444, 1, 443, 0, 1, 1
8296, 1, 1636430795328, 1636430795777, 449, 0, 449, 0, 0, 0
8295, 1, 1636430795324, 1636430795777, 453, 0, 453, 0, 0, 0
8297, 1, 1636430795472, 1636430795916, 444, 0, 444, 0, 0, 0
8298, 1, 1636430795512, 1636430795960, 448, 1, 447, 1, 0, 1
8299, 1, 1636430795644, 1636430796096, 452, 1, 451, 0, 0, 0
8161, 2, 1636430786136, 1636430796137, 10001, 0, 10001, 0, 0, 0
8300, 1, 1636430795768, 1636430796208, 440, 1, 439, 1, 0, 1
8301, 1, 1636430795828, 1636430796280, 452, 1, 451, 0, 0, 0
8302, 1, 1636430795960, 1636430796448, 488, 1, 487, 1, 0, 1
8303, 1, 1636430795996, 1636430796460, 464, 0, 464, 0, 0, 0
8304, 1, 1636430796136, 1636430796576, 440, 1, 439, 1, 0, 1
8305, 1, 1636430796184, 1636430796628, 444, 0, 444, 0, 0, 0
8306, 1, 1636430796316, 1636430796760, 444, 0, 444, 0, 0, 0
8307, 1, 1636430796428, 1636430796877, 449, 0, 449, 0, 0, 0
8308, 1, 1636430796440, 1636430796877, 437, 0, 437, 0, 0, 0
8309, 1, 1636430796496, 1636430796940, 444, 0, 444, 0, 0, 0
8178, 2, 1636430787104, 1636430797104, 10000, 0, 10000, 0, 0, 0
8310, 1, 1636430796664, 1636430797104, 440, 0, 440, 0, 0, 0
8311, 1, 1636430796804, 1636430797252, 448, 0, 448, 0, 0, 0
8312, 1, 1636430796840, 1636430797281, 441, 0, 441, 0, 0, 0
8313, 1, 1636430796988, 1636430797433, 445, 0, 445, 0, 0, 0
8315, 1, 1636430797100, 1636430797545, 445, 1, 444, 1, 0, 1
8314, 1, 1636430797100, 1636430797548, 448, 1, 447, 1, 0, 1
8316, 1, 1636430797196, 1636430797633, 437, 1, 436, 1, 0, 1
8317, 1, 1636430797328, 1636430797772, 444, 0, 444, 0, 0, 0
8318, 1, 1636430797416, 1636430797864, 448, 1, 447, 1, 0, 1
8319, 1, 1636430797508, 1636430797960, 452, 0, 452, 0, 0, 0
8320, 1, 1636430797660, 1636430798112, 452, 1, 451, 0, 0, 0
8321, 1, 1636430797765, 1636430798209, 444, 0, 444, 0, 0, 0
8322, 1, 1636430797768, 1636430798213, 445, 1, 444, 0, 0, 0
8323, 1, 1636430797852, 1636430798305, 453, 0, 453, 0, 0, 0
8324, 1, 1636430797997, 1636430798436, 439, 0, 439, 0, 0, 0
8325, 1, 1636430798081, 1636430798524, 443, 0, 443, 0, 0, 0
8326, 1, 1636430798176, 1636430798617, 441, 0, 441, 0, 0, 0
8327, 1, 1636430798329, 1636430798781, 452, 0, 452, 0, 0, 0
8329, 1, 1636430798432, 1636430798877, 445, 1, 444, 0, 0, 0
8328, 1, 1636430798432, 1636430798880, 448, 1, 447, 0, 0, 0
8330, 1, 1636430798520, 1636430798969, 449, 1, 448, 0, 0, 0
8331, 1, 1636430798664, 1636430799104, 440, 1, 439, 0, 0, 0
8332, 1, 1636430798753, 1636430799192, 439, 0, 439, 0, 0, 0
8333, 1, 1636430798849, 1636430799285, 436, 0, 436, 0, 0, 0
8334, 1, 1636430799005, 1636430799453, 448, 0, 448, 0, 0, 0
8335, 1, 1636430799101, 1636430799548, 447, 0, 447, 0, 0, 0
8336, 1, 1636430799101, 1636430799561, 460, 0, 460, 0, 0, 0
8220, 2, 1636430789624, 1636430799629, 10005, 0, 10005, 0, 0, 0
8337, 1, 1636430799189, 1636430799632, 443, 0, 443, 0, 0, 0
8338, 1, 1636430799328, 1636430799773, 445, 1, 444, 0, 0, 0
8339, 1, 1636430799416, 1636430799869, 453, 1, 452, 0, 1, 1
8340, 1, 1636430799508, 1636430799960, 452, 1, 451, 0, 0, 0
8272, 1, 1636430793384, 1636430800077, 6693, 6245, 448, 0, 6245, 6245
8341, 1, 1636430799672, 1636430800120, 448, 1, 447, 0, 1, 1
8342, 1, 1636430799804, 1636430800249, 445, 1, 444, 0, 0, 0
8343, 1, 1636430799808, 1636430800253, 445, 1, 444, 1, 0, 1
8344, 1, 1636430799852, 1636430800296, 444, 1, 443, 0, 0, 0
8345, 1, 1636430799937, 1636430800389, 452, 0, 452, 0, 0, 0
8346, 1, 1636430800097, 1636430800552, 455, 0, 455, 0, 0, 0
8347, 1, 1636430800177, 1636430800624, 447, 0, 447, 0, 0, 0
8348, 1, 1636430800300, 1636430800844, 544, 89, 455, 89, 0, 89
8349, 1, 1636430800472, 1636430800924, 452, 1, 451, 0, 0, 0
8350, 1, 1636430800476, 1636430800929, 453, 1, 452, 1, 0, 1
8351, 1, 1636430800524, 1636430800976, 452, 0, 452, 0, 0, 0
8352, 1, 1636430800612, 1636430801065, 453, 1, 452, 1, 0, 1
8353, 1, 1636430800773, 1636430801224, 451, 0, 451, 0, 0, 0
8354, 1, 1636430800848, 1636430801296, 448, 1, 447, 1, 0, 1
8355, 1, 1636430801065, 1636430801512, 447, 0, 447, 0, 0, 0
8356, 1, 1636430801140, 1636430801588, 448, 1, 447, 0, 1, 1
8357, 1, 1636430801152, 1636430801592, 440, 0, 440, 0, 0, 0
8358, 1, 1636430801196, 1636430801640, 444, 0, 444, 0, 0, 0
8359, 1, 1636430801280, 1636430801725, 445, 0, 445, 0, 0, 0
8360, 1, 1636430801445, 1636430801897, 452, 0, 452, 0, 0, 0
8361, 1, 1636430801512, 1636430801960, 448, 1, 447, 1, 0, 1
8362, 1, 1636430801733, 1636430802181, 448, 0, 448, 0, 0, 0
8363, 1, 1636430801809, 1636430802256, 447, 0, 447, 0, 0, 0
8364, 1, 1636430801816, 1636430802268, 452, 1, 451, 1, 0, 1
8365, 1, 1636430801868, 1636430802316, 448, 1, 447, 1, 0, 1
8366, 1, 1636430801948, 1636430802396, 448, 1, 447, 0, 0, 0
8367, 1, 1636430802121, 1636430802568, 447, 0, 447, 0, 0, 0
8368, 1, 1636430802180, 1636430802616, 436, 1, 435, 0, 0, 0
8369, 1, 1636430802404, 1636430802856, 452, 1, 451, 0, 1, 1
8370, 1, 1636430802469, 1636430802916, 447, 0, 447, 0, 0, 0
8372, 1, 1636430802533, 1636430802976, 443, 0, 443, 0, 0, 0
8373, 1, 1636430802612, 1636430803060, 448, 0, 448, 0, 0, 0
8374, 1, 1636430802789, 1636430803240, 451, 0, 451, 0, 0, 0
8375, 1, 1636430802844, 1636430803280, 436, 1, 435, 1, 0, 1
8371, 1, 1636430802497, 1636430803304, 807, 360, 447, 360, 0, 360
8376, 1, 1636430803072, 1636430803520, 448, 0, 448, 0, 0, 0
8377, 1, 1636430803144, 1636430803588, 444, 1, 443, 0, 0, 0
8378, 1, 1636430803196, 1636430803645, 449, 0, 449, 0, 0, 0
8379, 1, 1636430803280, 1636430803729, 449, 0, 449, 0, 0, 0
8380, 1, 1636430803464, 1636430803909, 445, 1, 444, 1, 0, 1
8381, 1, 1636430803512, 1636430803953, 441, 1, 440, 0, 1, 1
8382, 1, 1636430803524, 1636430803969, 445, 0, 445, 0, 0, 0
8383, 1, 1636430803736, 1636430804176, 440, 1, 439, 1, 0, 1
8384, 1, 1636430803805, 1636430804252, 447, 0, 447, 0, 0, 0
8385, 1, 1636430803868, 1636430804312, 444, 0, 444, 0, 0, 0
8386, 1, 1636430803953, 1636430804397, 444, 0, 444, 0, 0, 0
8387, 1, 1636430804132, 1636430804572, 440, 1, 439, 0, 0, 0
8388, 1, 1636430804176, 1636430804616, 440, 1, 439, 0, 1, 1
8389, 1, 1636430804196, 1636430804644, 448, 1, 447, 0, 0, 0
8390, 1, 1636430804404, 1636430804844, 440, 1, 439, 0, 1, 1
8391, 1, 1636430804469, 1636430804925, 456, 0, 456, 0, 0, 0
8392, 1, 1636430804532, 1636430804980, 448, 1, 447, 0, 0, 0
8393, 1, 1636430804616, 1636430805064, 448, 0, 448, 0, 0, 0
8394, 1, 1636430804804, 1636430805256, 452, 0, 452, 0, 0, 0
8395, 1, 1636430804840, 1636430805288, 448, 1, 447, 1, 0, 1
8396, 1, 1636430804864, 1636430805316, 452, 0, 452, 0, 0, 0
8397, 1, 1636430805068, 1636430805528, 460, 0, 460, 0, 0, 0
8399, 1, 1636430805204, 1636430805652, 448, 1, 447, 0, 0, 0
8398, 1, 1636430805145, 1636430805704, 559, 112, 447, 112, 0, 112
8400, 1, 1636430805285, 1636430805728, 443, 0, 443, 0, 0, 0
8401, 1, 1636430805477, 1636430805920, 443, 0, 443, 0, 0, 0
8402, 1, 1636430805508, 1636430805960, 452, 1, 451, 0, 1, 1
8403, 1, 1636430805532, 1636430805977, 445, 0, 445, 0, 0, 0
8404, 1, 1636430805744, 1636430806192, 448, 1, 447, 1, 0, 1
8405, 1, 1636430805873, 1636430806312, 439, 0, 439, 0, 0, 0
8406, 1, 1636430805924, 1636430806368, 444, 0, 444, 0, 0, 0
8407, 1, 1636430805948, 1636430806392, 444, 0, 444, 0, 0, 0
8408, 1, 1636430806141, 1636430806577, 436, 0, 436, 0, 0, 0
8409, 1, 1636430806181, 1636430806620, 439, 0, 439, 0, 0, 0
8410, 1, 1636430806200, 1636430806652, 452, 0, 452, 0, 0, 0
8411, 1, 1636430806416, 1636430806860, 444, 1, 443, 1, 0, 1
8412, 1, 1636430806541, 1636430806993, 452, 0, 452, 0, 0, 0
8413, 1, 1636430806588, 1636430807032, 444, 1, 443, 1, 0, 1
8414, 1, 1636430806616, 1636430807064, 448, 1, 447, 0, 1, 1
8415, 1, 1636430806808, 1636430807252, 444, 0, 444, 0, 0, 0
8416, 1, 1636430806840, 1636430807288, 448, 0, 448, 0, 0, 0
8417, 1, 1636430807080, 1636430807529, 449, 1, 448, 0, 0, 0
8418, 1, 1636430807208, 1636430807661, 453, 0, 453, 0, 0, 0
8419, 1, 1636430807248, 1636430807693, 445, 0, 445, 0, 0, 0
8420, 1, 1636430807281, 1636430807728, 447, 0, 447, 0, 0, 0
8421, 1, 1636430807477, 1636430807924, 447, 0, 447, 0, 0, 0
8422, 1, 1636430807508, 1636430807952, 444, 1, 443, 0, 0, 0
8423, 1, 1636430807749, 1636430808188, 439, 0, 439, 0, 0, 0
8424, 1, 1636430807888, 1636430808341, 453, 1, 452, 1, 0, 1
8425, 1, 1636430807920, 1636430808376, 456, 0, 456, 0, 0, 0
8426, 1, 1636430807948, 1636430808396, 448, 0, 448, 0, 0, 0
8427, 1, 1636430808145, 1636430808585, 440, 0, 440, 0, 0, 0
8428, 1, 1636430808408, 1636430808852, 444, 1, 443, 0, 0, 0
8429, 1, 1636430808560, 1636430809004, 444, 1, 443, 1, 0, 1
8430, 1, 1636430808596, 1636430809033, 437, 0, 437, 0, 0, 0
8431, 1, 1636430808616, 1636430809056, 440, 1, 439, 0, 1, 1
8432, 1, 1636430808808, 1636430809248, 440, 1, 439, 1, 0, 1
8433, 1, 1636430809080, 1636430809532, 452, 0, 452, 0, 0, 0
8434, 1, 1636430809228, 1636430809689, 461, 1, 460, 1, 0, 1
8435, 1, 1636430809264, 1636430809708, 444, 1, 443, 0, 0, 0
8436, 1, 1636430809280, 1636430809732, 452, 1, 451, 1, 0, 1
8437, 1, 1636430809476, 1636430809917, 441, 1, 440, 0, 1, 1
8438, 1, 1636430809749, 1636430810196, 447, 0, 447, 0, 0, 0
8439, 1, 1636430809916, 1636430810360, 444, 1, 443, 0, 0, 0
8440, 1, 1636430809920, 1636430810364, 444, 0, 444, 0, 0, 0
8441, 1, 1636430809952, 1636430810396, 444, 1, 443, 0, 1, 1
8442, 1, 1636430810149, 1636430810592, 443, 0, 443, 0, 0, 0
8443, 1, 1636430810416, 1636430810853, 437, 1, 436, 0, 0, 0
8444, 1, 1636430810576, 1636430811013, 437, 1, 436, 1, 0, 1
8445, 1, 1636430810592, 1636430811036, 444, 1, 443, 1, 0, 1
8446, 1, 1636430810612, 1636430811048, 436, 0, 436, 0, 0, 0
8447, 1, 1636430810817, 1636430811264, 447, 0, 447, 0, 0, 0
8448, 1, 1636430811080, 1636430811532, 452, 0, 452, 0, 0, 0
8449, 1, 1636430811244, 1636430811696, 452, 1, 451, 1, 0, 1
8450, 1, 1636430811252, 1636430811729, 477, 13, 464, 13, 0, 13
8451, 1, 1636430811285, 1636430811737, 452, 0, 452, 0, 0, 0
8452, 1, 1636430811488, 1636430811936, 448, 0, 448, 0, 0, 0
8453, 1, 1636430811753, 1636430812196, 443, 0, 443, 0, 0, 0
8454, 1, 1636430811944, 1636430812384, 440, 1, 439, 0, 0, 0
8455, 1, 1636430811956, 1636430812412, 456, 0, 456, 0, 0, 0
8456, 1, 1636430812156, 1636430812605, 449, 1, 448, 0, 0, 0
8457, 1, 1636430812416, 1636430812864, 448, 1, 447, 1, 0, 1
8458, 1, 1636430812612, 1636430813060, 448, 1, 447, 0, 0, 0
8459, 1, 1636430812633, 1636430813076, 443, 0, 443, 0, 0, 0
8460, 1, 1636430812829, 1636430813284, 455, 0, 455, 0, 0, 0
8461, 1, 1636430813084, 1636430813537, 453, 0, 453, 0, 0, 0
8462, 1, 1636430813277, 1636430813732, 455, 0, 455, 0, 0, 0
8463, 1, 1636430813297, 1636430813749, 452, 0, 452, 0, 0, 0
8464, 1, 1636430813504, 1636430813952, 448, 1, 447, 0, 0, 0
8465, 1, 1636430813757, 1636430814209, 452, 0, 452, 0, 0, 0
8466, 1, 1636430813948, 1636430814396, 448, 1, 447, 0, 0, 0
8467, 1, 1636430813964, 1636430814417, 453, 0, 453, 0, 0, 0
8468, 1, 1636430814173, 1636430814620, 447, 0, 447, 0, 0, 0
8469, 1, 1636430814437, 1636430814888, 451, 0, 451, 0, 0, 0
8470, 1, 1636430814616, 1636430815068, 452, 1, 451, 0, 0, 0
8471, 1, 1636430814636, 1636430815089, 453, 1, 452, 0, 0, 0
8472, 1, 1636430814836, 1636430815284, 448, 0, 448, 0, 0, 0
8473, 1, 1636430815109, 1636430815552, 443, 0, 443, 0, 0, 0
8474, 1, 1636430815288, 1636430815733, 445, 1, 444, 1, 0, 1
8475, 1, 1636430815312, 1636430815761, 449, 1, 448, 1, 0, 1
8476, 1, 1636430815509, 1636430815961, 452, 0, 452, 0, 0, 0
8477, 1, 1636430815772, 1636430816212, 440, 1, 439, 1, 0, 1
8478, 1, 1636430815961, 1636430816404, 443, 0, 443, 0, 0, 0
8479, 1, 1636430815985, 1636430816428, 443, 0, 443, 0, 0, 0
8480, 1, 1636430816184, 1636430816624, 440, 0, 440, 0, 0, 0
8481, 1, 1636430816616, 1636430817064, 448, 1, 447, 0, 0, 0
8482, 1, 1636430816648, 1636430817104, 456, 0, 456, 0, 0, 0
8483, 1, 1636430816849, 1636430817293, 444, 0, 444, 0, 0, 0
8484, 1, 1636430817288, 1636430817733, 445, 1, 444, 1, 0, 1
8485, 1, 1636430817328, 1636430817772, 444, 1, 443, 0, 0, 0
8486, 1, 1636430817513, 1636430817952, 439, 0, 439, 0, 0, 0
8487, 1, 1636430817948, 1636430818396, 448, 0, 448, 0, 0, 0
8488, 1, 1636430817988, 1636430818436, 448, 1, 447, 1, 0, 1
8489, 1, 1636430818189, 1636430818632, 443, 0, 443, 0, 0, 0
8490, 1, 1636430818616, 1636430819084, 468, 17, 451, 17, 0, 17
8491, 1, 1636430818653, 1636430819092, 439, 0, 439, 0, 0, 0
8492, 1, 1636430818853, 1636430819305, 452, 0, 452, 0, 0, 0
8493, 1, 1636430819300, 1636430819765, 465, 5, 460, 4, 0, 4
8494, 1, 1636430819325, 1636430819780, 455, 0, 455, 0, 0, 0
8495, 1, 1636430819524, 1636430819972, 448, 1, 447, 0, 1, 1
8496, 1, 1636430819976, 1636430820425, 449, 0, 449, 0, 0, 0
8497, 1, 1636430820196, 1636430820644, 448, 1, 447, 0, 1, 1
8498, 1, 1636430820644, 1636430821085, 441, 1, 440, 1, 0, 1
8499, 1, 1636430820861, 1636430821312, 451, 0, 451, 0, 0, 0
8500, 1, 1636430821316, 1636430821752, 436, 1, 435, 1, 0, 1
8501, 1, 1636431074229, 1636431074681, 452, 0, 452, 0, 0, 0
8502, 1, 1636431074729, 1636431075185, 456, 0, 456, 0, 0, 0
8503, 1, 1636431075357, 1636431075809, 452, 0, 452, 0, 0, 0
8504, 1, 1636431075533, 1636431075981, 448, 0, 448, 0, 0, 0
8505, 1, 1636431075893, 1636431076341, 448, 0, 448, 0, 0, 0
8506, 1, 1636431076041, 1636431076492, 451, 0, 451, 0, 0, 0
8507, 1, 1636431076469, 1636431076921, 452, 0, 452, 0, 0, 0
8508, 1, 1636431076665, 1636431077117, 452, 0, 452, 0, 0, 0
8509, 1, 1636431076864, 1636431077312, 448, 1, 447, 0, 0, 0
8510, 1, 1636431077157, 1636431077613, 456, 0, 456, 0, 0, 0
8511, 1, 1636431077213, 1636431077664, 451, 0, 451, 0, 0, 0
8512, 1, 1636431077364, 1636431077813, 449, 0, 449, 0, 0, 0
8513, 1, 1636431077717, 1636431078164, 447, 0, 447, 0, 0, 0
8514, 1, 1636431077757, 1636431078209, 452, 0, 452, 0, 0, 0
8515, 1, 1636431077997, 1636431078449, 452, 0, 452, 0, 0, 0
8516, 1, 1636431078236, 1636431078684, 448, 0, 448, 0, 0, 0
8517, 1, 1636431078276, 1636431078729, 453, 1, 452, 0, 0, 0
8518, 1, 1636431078468, 1636431078924, 456, 1, 455, 0, 0, 0
8519, 1, 1636431078549, 1636431079004, 455, 0, 455, 0, 0, 0
8520, 1, 1636431078708, 1636431079157, 449, 1, 448, 0, 0, 0
8521, 1, 1636431078865, 1636431079317, 452, 0, 452, 0, 0, 0
8522, 1, 1636431079008, 1636431079456, 448, 1, 447, 0, 1, 1
8523, 1, 1636431079089, 1636431079536, 447, 0, 447, 0, 0, 0
8524, 1, 1636431079313, 1636431079769, 456, 4, 452, 4, 0, 4
8525, 1, 1636431079389, 1636431079848, 459, 0, 459, 0, 0, 0
8526, 1, 1636431079565, 1636431080013, 448, 0, 448, 0, 0, 0
8527, 1, 1636431079628, 1636431080077, 449, 1, 448, 1, 0, 1
8528, 1, 1636431079772, 1636431080225, 453, 1, 452, 1, 0, 1
8529, 1, 1636431079933, 1636431080380, 447, 0, 447, 0, 0, 0
8530, 1, 1636431080052, 1636431080533, 481, 25, 456, 25, 0, 25
8531, 1, 1636431080173, 1636431080624, 451, 0, 451, 0, 0, 0
8532, 1, 1636431080332, 1636431080781, 449, 0, 449, 0, 0, 0
8533, 1, 1636431080460, 1636431080908, 448, 1, 447, 1, 0, 1
8534, 1, 1636431080584, 1636431081037, 453, 0, 453, 0, 0, 0
8535, 1, 1636431080621, 1636431081068, 447, 4, 443, 4, 0, 4
8536, 1, 1636431080781, 1636431081237, 456, 0, 456, 0, 0, 0
8537, 1, 1636431080893, 1636431081340, 447, 0, 447, 0, 0, 0
8539, 1, 1636431081149, 1636431081601, 452, 0, 452, 0, 0, 0
8538, 1, 1636431080961, 1636431081688, 727, 276, 451, 276, 0, 276
8540, 1, 1636431081288, 1636431081736, 448, 0, 448, 0, 0, 0
8543, 1, 1636431081501, 1636431081957, 456, 0, 456, 0, 0, 0
8542, 1, 1636431081364, 1636431082149, 785, 325, 460, 325, 0, 325
8544, 1, 1636431081708, 1636431082156, 448, 1, 447, 0, 1, 1
8546, 1, 1636431081876, 1636431082328, 452, 1, 451, 0, 0, 0
8547, 1, 1636431081920, 1636431082364, 444, 0, 444, 0, 0, 0
8548, 1, 1636431081948, 1636431082405, 457, 9, 448, 9, 0, 9
8550, 1, 1636431082229, 1636431082673, 444, 0, 444, 0, 0, 0
8551, 1, 1636431082309, 1636431082817, 508, 55, 453, 55, 0, 55
8554, 1, 1636431082612, 1636431083057, 445, 1, 444, 0, 1, 1
8556, 1, 1636431082892, 1636431083340, 448, 1, 447, 1, 0, 1
8559, 1, 1636431083200, 1636431083649, 449, 0, 449, 0, 0, 0
8560, 1, 1636431083240, 1636431083688, 448, 1, 447, 0, 0, 0
8561, 1, 1636431083336, 1636431083785, 449, 5, 444, 4, 0, 4
8564, 1, 1636431083685, 1636431084133, 448, 0, 448, 0, 0, 0
8565, 1, 1636431083940, 1636431084389, 449, 1, 448, 1, 0, 1
8569, 1, 1636431084545, 1636431085001, 456, 0, 456, 0, 0, 0
8570, 1, 1636431084548, 1636431085001, 453, 0, 453, 0, 0, 0
8573, 1, 1636431085040, 1636431085481, 441, 1, 440, 0, 0, 0
8574, 1, 1636431085317, 1636431085773, 456, 0, 456, 0, 0, 0
8577, 1, 1636431085925, 1636431086377, 452, 0, 452, 0, 0, 0
8578, 1, 1636431086440, 1636431086888, 448, 0, 448, 0, 0, 0
8581, 1, 1636431087713, 1636431088161, 448, 0, 448, 0, 0, 0
8582, 1, 1636431089013, 1636431089469, 456, 0, 456, 0, 0, 0
8583, 1, 1636431090297, 1636431090753, 456, 0, 456, 0, 0, 0
8541, 2, 1636431081325, 1636431091325, 10000, 0, 10000, 824, 0, 824
8545, 2, 1636431081796, 1636431091801, 10005, 0, 10005, 353, 0, 353
8549, 2, 1636431082045, 1636431092049, 10004, 0, 10004, 104, 0, 104
8584, 1, 1636431091697, 1636431092152, 455, 0, 455, 0, 0, 0
8552, 2, 1636431082429, 1636431092425, 9996, 0, 9996, 388, 0, 388
8553, 2, 1636431082541, 1636431092540, 9999, 0, 9999, 0, 0, 0
8555, 2, 1636431082705, 1636431092709, 10004, 0, 10004, 112, 0, 112
8585, 1, 1636431092473, 1636431092953, 480, 0, 480, 0, 0, 0
8586, 1, 1636431092473, 1636431092953, 480, 1, 479, 0, 0, 0
8557, 2, 1636431082981, 1636431092981, 10000, 0, 10000, 0, 0, 0
8558, 2, 1636431083096, 1636431093096, 10000, 0, 10000, 0, 0, 0
8562, 2, 1636431083476, 1636431093480, 10004, 0, 10004, 1, 0, 1
8589, 1, 1636431093029, 1636431093500, 471, 0, 471, 0, 0, 0
8563, 2, 1636431083621, 1636431093621, 10000, 0, 10000, 0, 0, 0
8590, 1, 1636431093188, 1636431093637, 449, 0, 449, 0, 0, 0
8566, 2, 1636431083977, 1636431093973, 9996, 0, 9996, 0, 0, 0
8594, 1, 1636431093668, 1636431094113, 445, 0, 445, 0, 0, 0
8595, 1, 1636431093712, 1636431094200, 488, 1, 487, 0, 1, 1
8567, 2, 1636431084237, 1636431094237, 10000, 0, 10000, 0, 0, 0
8568, 2, 1636431084444, 1636431094445, 10001, 0, 10001, 1, 0, 1
8571, 2, 1636431084684, 1636431094685, 10001, 0, 10001, 1, 0, 1
8600, 1, 1636431094392, 1636431094852, 460, 0, 460, 0, 0, 0
8599, 1, 1636431094377, 1636431094852, 475, 0, 475, 0, 0, 0
8572, 2, 1636431084937, 1636431094937, 10000, 0, 10000, 0, 0, 0
8575, 1, 1636431085393, 1636431095380, 9987, 9544, 443, 0, 9544, 9544
8605, 1, 1636431094980, 1636431095424, 444, 0, 444, 0, 0, 0
8604, 1, 1636431094988, 1636431095433, 445, 1, 444, 0, 0, 0
8576, 2, 1636431085885, 1636431095884, 9999, 0, 9999, 0, 0, 0
8608, 1, 1636431095656, 1636431096113, 457, 1, 456, 0, 0, 0
8609, 1, 1636431095681, 1636431096133, 452, 0, 452, 0, 0, 0
8611, 1, 1636431096217, 1636431096665, 448, 0, 448, 0, 0, 0
8612, 1, 1636431096252, 1636431096705, 453, 1, 452, 0, 0, 0
8579, 2, 1636431086712, 1636431096712, 10000, 0, 10000, 0, 0, 0
8580, 2, 1636431087321, 1636431097320, 9999, 0, 9999, 0, 0, 0
8615, 1, 1636431096976, 1636431097421, 445, 0, 445, 0, 0, 0
8613, 1, 1636431096972, 1636431097424, 452, 0, 452, 0, 0, 0
8616, 1, 1636431097509, 1636431097965, 456, 0, 456, 0, 0, 0
8617, 1, 1636431097577, 1636431098029, 452, 0, 452, 0, 0, 0
8619, 1, 1636431098345, 1636431098800, 455, 0, 455, 0, 0, 0
8620, 1, 1636431098357, 1636431098804, 447, 0, 447, 0, 0, 0
8621, 1, 1636431098868, 1636431099321, 453, 1, 452, 1, 0, 1
8622, 1, 1636431098896, 1636431099349, 453, 1, 452, 1, 0, 1
8623, 1, 1636431099713, 1636431100168, 455, 0, 455, 0, 0, 0
8624, 1, 1636431099725, 1636431100181, 456, 0, 456, 0, 0, 0
8625, 1, 1636431100252, 1636431100705, 453, 1, 452, 0, 0, 0
8626, 1, 1636431100273, 1636431100725, 452, 0, 452, 0, 0, 0
8627, 1, 1636431101033, 1636431101489, 456, 0, 456, 0, 0, 0
8628, 1, 1636431101101, 1636431101552, 451, 0, 451, 0, 0, 0
8630, 1, 1636431101637, 1636431102093, 456, 0, 456, 0, 0, 0
8629, 1, 1636431101637, 1636431102093, 456, 0, 456, 0, 0, 0
8587, 2, 1636431092473, 1636431102473, 10000, 0, 10000, 480, 0, 480
8631, 1, 1636431102361, 1636431102813, 452, 0, 452, 0, 0, 0
8588, 2, 1636431092889, 1636431102889, 10000, 0, 10000, 64, 0, 64
8632, 1, 1636431102444, 1636431102896, 452, 0, 452, 0, 0, 0
8591, 2, 1636431093188, 1636431103189, 10001, 0, 10001, 0, 0, 0
8592, 2, 1636431093297, 1636431103300, 10003, 0, 10003, 0, 0, 0
8593, 2, 1636431093405, 1636431103405, 10000, 0, 10000, 0, 0, 0
8633, 1, 1636431103020, 1636431103521, 501, 0, 501, 0, 0, 0
8634, 1, 1636431103024, 1636431103524, 500, 0, 500, 0, 0, 0
8596, 2, 1636431093796, 1636431103797, 10001, 0, 10001, 0, 0, 0
8597, 2, 1636431093932, 1636431103933, 10001, 0, 10001, 1, 0, 1
8637, 1, 1636431103493, 1636431103940, 447, 0, 447, 0, 0, 0
8639, 1, 1636431103668, 1636431104160, 492, 1, 491, 0, 0, 0
8641, 1, 1636431103712, 1636431104249, 537, 1, 536, 0, 0, 0
8598, 2, 1636431094284, 1636431104285, 10001, 0, 10001, 0, 0, 0
8638, 1, 1636431103609, 1636431104384, 775, 332, 443, 332, 0, 332
8601, 2, 1636431094541, 1636431104545, 10004, 0, 10004, 0, 0, 0
8602, 2, 1636431094772, 1636431104776, 10004, 0, 10004, 0, 0, 0
8644, 1, 1636431104332, 1636431104784, 452, 0, 452, 0, 0, 0
8642, 1, 1636431104112, 1636431104860, 748, 273, 475, 272, 1, 273
8645, 1, 1636431104420, 1636431104868, 448, 0, 448, 0, 0, 0
8603, 2, 1636431094988, 1636431104985, 9997, 0, 9997, 0, 0, 0
8647, 1, 1636431104717, 1636431105208, 491, 0, 491, 0, 0, 0
8606, 2, 1636431095245, 1636431105245, 10000, 0, 10000, 0, 0, 0
8646, 1, 1636431104592, 1636431105312, 720, 269, 451, 269, 0, 269
8650, 1, 1636431104956, 1636431105401, 445, 0, 445, 0, 0, 0
8651, 1, 1636431105032, 1636431105481, 449, 0, 449, 0, 0, 0
8649, 1, 1636431104868, 1636431105648, 780, 341, 439, 341, 0, 341
8607, 1, 1636431095600, 1636431105692, 10092, 9645, 447, 0, 9644, 9644
8652, 1, 1636431105076, 1636431105764, 688, 237, 451, 236, 1, 237
8656, 1, 1636431105601, 1636431106057, 456, 0, 456, 0, 0, 0
8654, 1, 1636431105332, 1636431106088, 756, 317, 439, 317, 0, 317
8657, 1, 1636431105733, 1636431106177, 444, 0, 444, 0, 0, 0
8610, 2, 1636431096197, 1636431106193, 9996, 0, 9996, 0, 0, 0
8655, 1, 1636431105556, 1636431106217, 661, 209, 452, 209, 0, 209
8658, 1, 1636431105808, 1636431106540, 732, 281, 451, 281, 0, 281
8659, 1, 1636431105913, 1636431106668, 755, 304, 451, 304, 0, 304
8663, 1, 1636431106344, 1636431106793, 449, 1, 448, 1, 0, 1
8664, 1, 1636431106365, 1636431106813, 448, 0, 448, 0, 0, 0
8662, 1, 1636431106328, 1636431106984, 656, 213, 443, 212, 0, 212
8614, 2, 1636431097016, 1636431107013, 9997, 0, 9997, 0, 0, 0
8668, 1, 1636431106940, 1636431107416, 476, 0, 476, 0, 0, 0
8667, 1, 1636431106793, 1636431107429, 636, 192, 444, 192, 0, 192
8618, 1, 1636431097628, 1636431107453, 9825, 9385, 440, 0, 9384, 9384
8669, 1, 1636431107060, 1636431107505, 445, 0, 445, 0, 0, 0
8671, 1, 1636431107196, 1636431107896, 700, 233, 467, 233, 0, 233
8675, 1, 1636431107716, 1636431108165, 449, 0, 449, 0, 0, 0
8676, 1, 1636431107724, 1636431108173, 449, 0, 449, 0, 0, 0
8678, 1, 1636431108321, 1636431108777, 456, 0, 456, 0, 0, 0
8679, 1, 1636431108461, 1636431108913, 452, 0, 452, 0, 0, 0
8681, 1, 1636431109008, 1636431109456, 448, 0, 448, 0, 0, 0
8682, 1, 1636431109116, 1636431109561, 445, 1, 444, 0, 0, 0
8683, 1, 1636431109717, 1636431110173, 456, 0, 456, 0, 0, 0
8684, 1, 1636431109805, 1636431110253, 448, 0, 448, 0, 0, 0
8685, 1, 1636431110320, 1636431110773, 453, 1, 452, 1, 0, 1
8686, 1, 1636431110421, 1636431110873, 452, 0, 452, 0, 0, 0
8687, 1, 1636431111049, 1636431111505, 456, 0, 456, 0, 0, 0
8688, 1, 1636431111201, 1636431111656, 455, 0, 455, 0, 0, 0
8689, 1, 1636431111673, 1636431112129, 456, 0, 456, 0, 0, 0
8690, 1, 1636431111704, 1636431112161, 457, 1, 456, 1, 0, 1
8691, 1, 1636431112357, 1636431112813, 456, 0, 456, 0, 0, 0
8692, 1, 1636431112500, 1636431112949, 449, 0, 449, 0, 0, 0
8635, 2, 1636431103281, 1636431113281, 10000, 0, 10000, 0, 0, 0
8636, 2, 1636431103281, 1636431113324, 10043, 0, 10043, 0, 0, 0
8693, 1, 1636431113029, 1636431113548, 519, 0, 519, 0, 0, 0
8694, 1, 1636431113065, 1636431113548, 483, 0, 483, 0, 0, 0
8640, 2, 1636431103720, 1636431113720, 10000, 0, 10000, 0, 0, 0
8697, 1, 1636431113676, 1636431114129, 453, 0, 453, 0, 0, 0
8643, 2, 1636431104241, 1636431114241, 10000, 0, 10000, 0, 0, 0
8698, 1, 1636431113813, 1636431114261, 448, 0, 448, 0, 0, 0
8700, 1, 1636431114332, 1636431114785, 453, 0, 453, 0, 0, 0
8648, 2, 1636431104868, 1636431114869, 10001, 0, 10001, 0, 0, 0
8701, 1, 1636431114376, 1636431115277, 901, 409, 492, 409, 0, 409
8653, 2, 1636431105292, 1636431115293, 10001, 0, 10001, 0, 0, 0
8704, 1, 1636431115093, 1636431115549, 456, 0, 456, 0, 0, 0
8703, 1, 1636431115001, 1636431115729, 728, 276, 452, 276, 0, 276
8660, 2, 1636431106005, 1636431116005, 10000, 0, 10000, 0, 0, 0
8707, 1, 1636431115648, 1636431116097, 449, 1, 448, 0, 1, 1
8708, 1, 1636431115680, 1636431116128, 448, 0, 448, 0, 0, 0
8661, 2, 1636431106176, 1636431116180, 10004, 0, 10004, 0, 0, 0
8665, 2, 1636431106504, 1636431116504, 10000, 0, 10000, 0, 0, 0
8666, 2, 1636431106632, 1636431116637, 10005, 0, 10005, 0, 0, 0
8709, 1, 1636431116317, 1636431116772, 455, 0, 455, 0, 0, 0
8711, 1, 1636431116401, 1636431116860, 459, 0, 459, 0, 0, 0
8670, 2, 1636431107104, 1636431117108, 10004, 0, 10004, 0, 0, 0
8712, 1, 1636431116489, 1636431117224, 735, 284, 451, 284, 0, 284
8672, 2, 1636431107328, 1636431117324, 9996, 0, 9996, 0, 0, 0
8715, 1, 1636431116945, 1636431117421, 476, 0, 476, 0, 0, 0
8716, 1, 1636431116965, 1636431117424, 459, 0, 459, 0, 0, 0
8673, 2, 1636431107605, 1636431117605, 10000, 0, 10000, 0, 0, 0
8714, 1, 1636431116941, 1636431117668, 727, 284, 443, 284, 0, 284
8674, 2, 1636431107676, 1636431117676, 10000, 0, 10000, 0, 0, 0
8677, 2, 1636431108105, 1636431118105, 10000, 0, 10000, 0, 0, 0
8717, 1, 1636431117412, 1636431118117, 705, 257, 448, 256, 0, 256
8680, 1, 1636431108533, 1636431118557, 10024, 9572, 452, 0, 9572, 9572
8724, 1, 1636431118236, 1636431118684, 448, 0, 448, 0, 0, 0
8726, 1, 1636431118340, 1636431118789, 449, 1, 448, 1, 0, 1
8730, 1, 1636431119504, 1636431119957, 453, 1, 452, 0, 0, 0
8731, 1, 1636431119669, 1636431120125, 456, 0, 456, 0, 0, 0
8732, 1, 1636431120785, 1636431121241, 456, 0, 456, 0, 0, 0
8733, 1, 1636431121029, 1636431121481, 452, 0, 452, 0, 0, 0
8734, 1, 1636431122161, 1636431122613, 452, 0, 452, 0, 0, 0
8735, 1, 1636431122349, 1636431122809, 460, 0, 460, 0, 0, 0
8696, 2, 1636431113592, 1636431123589, 9997, 0, 9997, 0, 0, 0
8695, 2, 1636431113592, 1636431123636, 10044, 0, 10044, 0, 0, 0
8736, 1, 1636431123488, 1636431123953, 465, 1, 464, 0, 0, 0
8699, 2, 1636431114028, 1636431124029, 10001, 0, 10001, 1, 0, 1
8737, 1, 1636431123684, 1636431124137, 453, 0, 453, 0, 0, 0
8702, 2, 1636431114548, 1636431124549, 10001, 0, 10001, 0, 0, 0
8705, 2, 1636431115177, 1636431125177, 10000, 0, 10000, 0, 0, 0
8741, 1, 1636431124769, 1636431125221, 452, 0, 452, 0, 0, 0
8743, 1, 1636431124997, 1636431125492, 495, 0, 495, 0, 0, 0
8706, 2, 1636431115596, 1636431125597, 10001, 0, 10001, 0, 0, 0
8710, 2, 1636431116328, 1636431126329, 10001, 0, 10001, 1788, 0, 1788
8746, 1, 1636431126153, 1636431126653, 500, 0, 500, 0, 0, 0
8713, 2, 1636431116816, 1636431126817, 10001, 0, 10001, 0, 0, 0
8747, 1, 1636431126373, 1636431126820, 447, 0, 447, 0, 0, 0
8719, 2, 1636431117592, 1636431127593, 10001, 0, 10001, 1, 0, 1
8718, 2, 1636431117648, 1636431127648, 10000, 0, 10000, 0, 0, 0
8720, 2, 1636431117772, 1636431127773, 10001, 0, 10001, 0, 0, 0
8721, 2, 1636431117817, 1636431127816, 9999, 0, 9999, 300, 0, 300
8749, 1, 1636431127461, 1636431127912, 451, 0, 451, 0, 0, 0
8722, 2, 1636431117936, 1636431127940, 10004, 0, 10004, 181, 0, 181
8723, 2, 1636431117981, 1636431127985, 10004, 0, 10004, 0, 0, 0
8725, 2, 1636431118196, 1636431128192, 9996, 0, 9996, 0, 0, 0
8750, 1, 1636431127736, 1636431128305, 569, 1, 568, 1, 0, 1
8727, 2, 1636431118413, 1636431128413, 10000, 0, 10000, 0, 0, 0
8751, 1, 1636431128032, 1636431128512, 480, 1, 479, 1, 0, 1
8728, 1, 1636431118689, 1636431128637, 9948, 9503, 445, 0, 9503, 9503
8729, 1, 1636431118781, 1636431128861, 10080, 9632, 448, 0, 9632, 9632
8757, 1, 1636431128460, 1636431128908, 448, 1, 447, 0, 1, 1
8756, 1, 1636431128460, 1636431128912, 452, 1, 451, 1, 0, 1
8758, 1, 1636431128500, 1636431128952, 452, 13, 439, 13, 0, 13
8760, 1, 1636431128768, 1636431129216, 448, 1, 447, 0, 1, 1
8755, 1, 1636431128460, 1636431129348, 888, 449, 439, 449, 0, 449
8759, 1, 1636431128720, 1636431129356, 636, 193, 443, 192, 0, 192
8761, 1, 1636431128857, 1636431129393, 536, 96, 440, 96, 0, 96
8762, 1, 1636431129029, 1636431129480, 451, 0, 451, 0, 0, 0
8763, 1, 1636431129084, 1636431129809, 725, 273, 452, 273, 0, 273
8753, 1, 1636431128116, 1636431129849, 1733, 1277, 456, 1277, 0, 1277
8766, 1, 1636431129689, 1636431130140, 451, 0, 451, 0, 0, 0
8765, 1, 1636431129664, 1636431130301, 637, 185, 452, 184, 0, 184
8770, 1, 1636431130072, 1636431130513, 441, 1, 440, 0, 0, 0
8771, 1, 1636431130116, 1636431130564, 448, 1, 447, 1, 0, 1
8767, 1, 1636431129692, 1636431130593, 901, 449, 452, 449, 0, 449
8769, 1, 1636431129965, 1636431130745, 780, 336, 444, 336, 0, 336
8773, 1, 1636431130296, 1636431130745, 449, 0, 449, 0, 0, 0
8774, 1, 1636431130372, 1636431131196, 824, 373, 451, 373, 0, 373
8776, 1, 1636431131025, 1636431131473, 448, 0, 448, 0, 0, 0
8779, 1, 1636431131388, 1636431131832, 444, 1, 443, 1, 0, 1
8777, 1, 1636431131061, 1636431131921, 860, 412, 448, 412, 0, 412
8780, 1, 1636431131473, 1636431131921, 448, 0, 448, 0, 0, 0
8781, 1, 1636431131660, 1636431132105, 445, 0, 445, 0, 0, 0
8783, 1, 1636431132401, 1636431132852, 451, 0, 451, 0, 0, 0
8785, 1, 1636431132673, 1636431133117, 444, 0, 444, 0, 0, 0
8786, 1, 1636431132832, 1636431133285, 453, 1, 452, 0, 0, 0
8784, 1, 1636431132409, 1636431133300, 891, 444, 447, 444, 0, 444
8787, 1, 1636431133016, 1636431133469, 453, 0, 453, 0, 0, 0
8739, 2, 1636431123904, 1636431133901, 9997, 0, 9997, 0, 0, 0
8738, 2, 1636431123904, 1636431133952, 10048, 0, 10048, 0, 0, 0
8788, 1, 1636431133721, 1636431134176, 455, 0, 455, 0, 0, 0
8740, 2, 1636431124337, 1636431134337, 10000, 0, 10000, 0, 0, 0
8790, 1, 1636431134000, 1636431134448, 448, 0, 448, 0, 0, 0
8789, 1, 1636431133725, 1636431134649, 924, 452, 472, 452, 0, 452
8793, 1, 1636431134217, 1636431134664, 447, 0, 447, 0, 0, 0
8794, 1, 1636431134296, 1636431134741, 445, 0, 445, 0, 0, 0
8742, 2, 1636431124849, 1636431134849, 10000, 0, 10000, 0, 0, 0
8796, 1, 1636431135001, 1636431135452, 451, 0, 451, 0, 0, 0
8744, 2, 1636431125481, 1636431135476, 9995, 0, 9995, 0, 0, 0
8799, 1, 1636431135292, 1636431135744, 452, 1, 451, 1, 0, 1
8745, 2, 1636431125900, 1636431135901, 10001, 0, 10001, 0, 0, 0
8797, 1, 1636431135053, 1636431135908, 855, 400, 455, 400, 0, 400
8800, 1, 1636431135617, 1636431136060, 443, 0, 443, 0, 0, 0
8801, 1, 1636431135660, 1636431136120, 460, 0, 460, 0, 0, 0
8804, 1, 1636431136385, 1636431136832, 447, 0, 447, 0, 0, 0
8806, 1, 1636431136640, 1636431137084, 444, 0, 444, 0, 0, 0
8748, 2, 1636431127125, 1636431137125, 10000, 0, 10000, 0, 0, 0
8805, 1, 1636431136389, 1636431137284, 895, 444, 451, 444, 0, 444
8807, 1, 1636431136953, 1636431137440, 487, 0, 487, 0, 0, 0
8808, 1, 1636431137029, 1636431137472, 443, 0, 443, 0, 0, 0
8752, 2, 1636431128032, 1636431138033, 10001, 0, 10001, 1, 0, 1
8810, 1, 1636431137737, 1636431138197, 460, 0, 460, 0, 0, 0
8754, 2, 1636431128288, 1636431138289, 10001, 0, 10001, 0, 0, 0
8811, 1, 1636431137773, 1636431138648, 875, 425, 450, 424, 0, 424
8813, 1, 1636431138336, 1636431138781, 445, 1, 444, 0, 1, 1
8815, 1, 1636431138380, 1636431138825, 445, 1, 444, 0, 1, 1
8812, 1, 1636431138077, 1636431139100, 1023, 572, 451, 572, 0, 572
8764, 2, 1636431129132, 1636431139137, 10005, 0, 10005, 0, 0, 0
8817, 1, 1636431139068, 1636431139544, 476, 0, 476, 0, 0, 0
8768, 2, 1636431129733, 1636431139736, 10003, 0, 10003, 0, 0, 0
8819, 1, 1636431139373, 1636431139816, 443, 0, 443, 0, 0, 0
8818, 1, 1636431139096, 1636431139996, 900, 449, 451, 449, 0, 449
8821, 1, 1636431139569, 1636431140052, 483, 0, 483, 0, 0, 0
8772, 2, 1636431130140, 1636431140145, 10005, 0, 10005, 0, 0, 0
8822, 1, 1636431139685, 1636431140149, 464, 0, 464, 0, 0, 0
8824, 1, 1636431140372, 1636431140821, 449, 1, 448, 1, 0, 1
8775, 2, 1636431130985, 1636431140985, 10000, 0, 10000, 0, 0, 0
8827, 1, 1636431140736, 1636431141209, 473, 1, 472, 0, 0, 0
8778, 2, 1636431131285, 1636431141285, 10000, 0, 10000, 0, 0, 0
8826, 1, 1636431140408, 1636431141296, 888, 413, 475, 413, 0, 413
8829, 1, 1636431141076, 1636431141529, 453, 1, 452, 0, 1, 1
8782, 2, 1636431131701, 1636431141701, 10000, 0, 10000, 0, 0, 0
8828, 1, 1636431140957, 1636431142157, 1200, 744, 456, 0, 744, 744
8832, 1, 1636431141744, 1636431142197, 453, 1, 452, 0, 1, 1
8835, 1, 1636431142045, 1636431142488, 443, 0, 443, 0, 0, 0
8833, 1, 1636431141744, 1636431142640, 896, 453, 443, 453, 0, 453
8836, 1, 1636431142376, 1636431142829, 453, 0, 453, 0, 0, 0
8838, 1, 1636431142977, 1636431143433, 456, 0, 456, 0, 0, 0
8840, 1, 1636431143361, 1636431143812, 451, 0, 451, 0, 0, 0
8839, 1, 1636431143037, 1636431143884, 847, 396, 451, 396, 0, 396
8841, 1, 1636431143681, 1636431144136, 455, 0, 455, 0, 0, 0
8792, 2, 1636431134220, 1636431144221, 10001, 0, 10001, 1, 0, 1
8791, 2, 1636431134220, 1636431144269, 10049, 0, 10049, 1, 0, 1
8795, 2, 1636431134649, 1636431144645, 9996, 0, 9996, 0, 0, 0
8798, 2, 1636431135157, 1636431145157, 10000, 0, 10000, 0, 0, 0
8846, 1, 1636431144736, 1636431145180, 444, 1, 443, 0, 0, 0
8848, 1, 1636431145020, 1636431145477, 457, 1, 456, 1, 0, 1
8802, 2, 1636431135788, 1636431145789, 10001, 0, 10001, 0, 0, 0
8803, 2, 1636431136204, 1636431146201, 9997, 0, 9997, 1, 0, 1
8850, 1, 1636431146025, 1636431146480, 455, 0, 455, 0, 0, 0
8852, 1, 1636431146356, 1636431146809, 453, 1, 452, 1, 0, 1
8809, 2, 1636431137432, 1636431147437, 10005, 0, 10005, 0, 0, 0
8854, 1, 1636431147349, 1636431147841, 492, 0, 492, 0, 0, 0
8856, 1, 1636431147709, 1636431148161, 452, 0, 452, 0, 0, 0
8814, 2, 1636431138336, 1636431148337, 10001, 0, 10001, 0, 0, 0
8816, 2, 1636431138597, 1636431148597, 10000, 0, 10000, 0, 0, 0
8858, 1, 1636431148733, 1636431149185, 452, 0, 452, 0, 0, 0
8860, 1, 1636431148981, 1636431149433, 452, 0, 452, 0, 0, 0
8820, 2, 1636431139440, 1636431149441, 10001, 0, 10001, 1, 0, 1
8823, 2, 1636431140036, 1636431150040, 10004, 0, 10004, 0, 0, 0
8825, 2, 1636431140452, 1636431150448, 9996, 0, 9996, 0, 0, 0
8862, 1, 1636431150133, 1636431150584, 451, 0, 451, 0, 0, 0
8863, 1, 1636431150296, 1636431150769, 473, 0, 473, 0, 0, 0
8830, 2, 1636431141332, 1636431151333, 10001, 0, 10001, 0, 0, 0
8831, 2, 1636431141592, 1636431151593, 10001, 0, 10001, 0, 0, 0
8866, 1, 1636431151425, 1636431151905, 480, 0, 480, 0, 0, 0
8834, 2, 1636431142017, 1636431152017, 10000, 0, 10000, 0, 0, 0
8867, 1, 1636431151593, 1636431152044, 451, 0, 451, 0, 0, 0
8837, 2, 1636431142360, 1636431152361, 10001, 0, 10001, 1, 0, 1
8871, 1, 1636431152668, 1636431153117, 449, 0, 449, 0, 0, 0
8872, 1, 1636431152680, 1636431153129, 449, 0, 449, 0, 0, 0
8873, 1, 1636431152865, 1636431153321, 456, 0, 456, 0, 0, 0
8842, 2, 1636431144313, 1636431154316, 10003, 0, 10003, 0, 0, 0
8874, 1, 1636431153881, 1636431154332, 451, 0, 451, 0, 0, 0
8843, 2, 1636431144361, 1636431154365, 10004, 9955, 49, 0, 9956, 9956
8844, 2, 1636431144537, 1636431154537, 10000, 0, 10000, 0, 0, 0
8845, 2, 1636431144537, 1636431154584, 10047, 0, 10047, 0, 0, 0
8875, 1, 1636431154065, 1636431154588, 523, 0, 523, 0, 0, 0
8876, 1, 1636431154169, 1636431154681, 512, 0, 512, 0, 0, 0
8847, 2, 1636431144961, 1636431154961, 10000, 0, 10000, 0, 0, 0
8879, 1, 1636431154853, 1636431155308, 455, 0, 455, 0, 0, 0
8849, 2, 1636431145461, 1636431155465, 10004, 0, 10004, 0, 0, 0
8882, 1, 1636431155273, 1636431155733, 460, 0, 460, 0, 0, 0
8883, 1, 1636431155457, 1636431155921, 464, 0, 464, 0, 0, 0
8884, 1, 1636431155508, 1636431155961, 453, 0, 453, 0, 0, 0
8851, 2, 1636431146097, 1636431156097, 10000, 0, 10000, 0, 0, 0
8853, 2, 1636431146512, 1636431156513, 10001, 0, 10001, 0, 0, 0
8886, 1, 1636431156085, 1636431156540, 455, 0, 455, 0, 0, 0
8888, 1, 1636431156653, 1636431157109, 456, 0, 456, 0, 0, 0
8889, 1, 1636431156773, 1636431157225, 452, 0, 452, 0, 0, 0
8891, 1, 1636431156796, 1636431157248, 452, 1, 451, 0, 0, 0
8855, 2, 1636431147741, 1636431157741, 10000, 0, 10000, 0, 0, 0
8892, 1, 1636431157348, 1636431157800, 452, 0, 452, 0, 0, 0
8894, 1, 1636431158005, 1636431158456, 451, 0, 451, 0, 0, 0
8895, 1, 1636431158080, 1636431158533, 453, 1, 452, 1, 0, 1
8896, 1, 1636431158144, 1636431158593, 449, 0, 449, 0, 0, 0
8857, 2, 1636431148644, 1636431158645, 10001, 0, 10001, 0, 0, 0
8859, 2, 1636431148901, 1636431158901, 10000, 0, 10000, 0, 0, 0
8897, 1, 1636431158645, 1636431159124, 479, 0, 479, 0, 0, 0
8861, 2, 1636431149749, 1636431159749, 10000, 0, 10000, 0, 0, 0
8900, 1, 1636431159320, 1636431159769, 449, 0, 449, 0, 0, 0
8901, 1, 1636431159408, 1636431159865, 457, 1, 456, 0, 0, 0
8902, 1, 1636431159513, 1636431159968, 455, 0, 455, 0, 0, 0
8864, 2, 1636431150340, 1636431160341, 10001, 0, 10001, 0, 0, 0
8903, 1, 1636431160005, 1636431160452, 447, 0, 447, 0, 0, 0
8865, 2, 1636431150761, 1636431160760, 9999, 0, 9999, 0, 0, 0
8906, 1, 1636431160712, 1636431161169, 457, 0, 457, 0, 0, 0
8907, 1, 1636431160808, 1636431161257, 449, 0, 449, 0, 0, 0
8908, 1, 1636431160849, 1636431161301, 452, 0, 452, 0, 0, 0
8868, 2, 1636431151636, 1636431161641, 10005, 0, 10005, 0, 0, 0
8910, 1, 1636431161353, 1636431161805, 452, 0, 452, 0, 0, 0
8869, 2, 1636431151896, 1636431161893, 9997, 0, 9997, 0, 0, 0
8870, 1, 1636431152328, 1636431162336, 10008, 9565, 443, 0, 9564, 9564
8912, 1, 1636431162060, 1636431162509, 449, 0, 449, 0, 0, 0
8913, 1, 1636431162084, 1636431162537, 453, 1, 452, 0, 1, 1
8914, 1, 1636431162101, 1636431162549, 448, 0, 448, 0, 0, 0
8917, 1, 1636431162721, 1636431163169, 448, 0, 448, 0, 0, 0
8918, 1, 1636431163340, 1636431163792, 452, 1, 451, 1, 0, 1
8919, 1, 1636431163356, 1636431163808, 452, 1, 451, 0, 0, 0
8920, 1, 1636431163485, 1636431163941, 456, 0, 456, 0, 0, 0
8921, 1, 1636431164065, 1636431164521, 456, 0, 456, 0, 0, 0
8878, 2, 1636431154632, 1636431164633, 10001, 0, 10001, 0, 0, 0
8877, 2, 1636431154632, 1636431164680, 10048, 0, 10048, 0, 0, 0
8880, 2, 1636431154853, 1636431164853, 10000, 0, 10000, 456, 0, 456
8922, 1, 1636431164724, 1636431165168, 444, 0, 444, 0, 0, 0
8923, 1, 1636431164728, 1636431165172, 444, 0, 444, 0, 0, 0
8881, 2, 1636431155273, 1636431165273, 10000, 0, 10000, 36, 0, 36
8924, 1, 1636431164900, 1636431165348, 448, 0, 448, 0, 0, 0
8925, 1, 1636431164944, 1636431165392, 448, 0, 448, 0, 0, 0
8885, 2, 1636431155769, 1636431165764, 9995, 0, 9995, 0, 0, 0
8926, 1, 1636431164948, 1636431165840, 892, 445, 447, 445, 0, 445
8927, 1, 1636431165404, 1636431165852, 448, 0, 448, 0, 0, 0
8930, 1, 1636431165924, 1636431166377, 453, 1, 452, 1, 0, 1
8887, 2, 1636431156405, 1636431166405, 10000, 0, 10000, 0, 0, 0
8932, 1, 1636431166045, 1636431166492, 447, 0, 447, 0, 0, 0
8933, 1, 1636431166152, 1636431166629, 477, 0, 477, 0, 0, 0
8934, 1, 1636431166200, 1636431166644, 444, 0, 444, 0, 0, 0
8890, 2, 1636431156820, 1636431166821, 10001, 0, 10001, 0, 0, 0
8935, 1, 1636431166248, 1636431167141, 893, 397, 496, 397, 0, 397
8937, 1, 1636431166696, 1636431167144, 448, 1, 447, 0, 0, 0
8939, 1, 1636431167277, 1636431167733, 456, 0, 456, 0, 0, 0
8940, 1, 1636431167349, 1636431167813, 464, 0, 464, 0, 0, 0
8941, 1, 1636431167476, 1636431167929, 453, 0, 453, 0, 0, 0
8942, 1, 1636431167556, 1636431168005, 449, 1, 448, 1, 0, 1
8893, 2, 1636431158052, 1636431168052, 10000, 0, 10000, 1, 0, 1
8943, 1, 1636431167604, 1636431168461, 857, 402, 455, 401, 0, 401
8898, 2, 1636431158948, 1636431168949, 10001, 0, 10001, 0, 0, 0
8946, 1, 1636431168668, 1636431169120, 452, 1, 451, 0, 0, 0
8947, 1, 1636431168733, 1636431169180, 447, 0, 447, 0, 0, 0
8899, 2, 1636431159204, 1636431169204, 10000, 0, 10000, 0, 0, 0
8948, 1, 1636431168801, 1636431169261, 460, 0, 460, 0, 0, 0
8949, 1, 1636431168896, 1636431169353, 457, 1, 456, 1, 0, 1
8950, 1, 1636431168992, 1636431169809, 817, 362, 455, 361, 1, 362
8904, 2, 1636431160065, 1636431170061, 9996, 0, 9996, 0, 0, 0
8953, 1, 1636431169937, 1636431170377, 440, 0, 440, 0, 0, 0
8954, 1, 1636431170009, 1636431170469, 460, 0, 460, 0, 0, 0
8955, 1, 1636431170105, 1636431170553, 448, 0, 448, 0, 0, 0
8905, 2, 1636431160645, 1636431170645, 10000, 0, 10000, 0, 0, 0
8956, 1, 1636431170273, 1636431170720, 447, 0, 447, 0, 0, 0
8909, 2, 1636431161073, 1636431171073, 10000, 0, 10000, 0, 0, 0
8957, 1, 1636431170309, 1636431171168, 859, 412, 447, 412, 0, 412
8960, 1, 1636431171221, 1636431171664, 443, 0, 443, 0, 0, 0
8961, 1, 1636431171301, 1636431171749, 448, 0, 448, 0, 0, 0
8963, 1, 1636431171384, 1636431171832, 448, 0, 448, 0, 0, 0
8911, 2, 1636431161940, 1636431171941, 10001, 0, 10001, 0, 0, 0
8964, 1, 1636431171628, 1636431172077, 449, 0, 449, 0, 0, 0
8915, 2, 1636431162196, 1636431172201, 10005, 0, 10005, 1, 0, 1
8965, 1, 1636431171661, 1636431172524, 863, 417, 446, 416, 0, 416
8916, 2, 1636431162556, 1636431172556, 10000, 0, 10000, 0, 0, 0
8968, 1, 1636431172488, 1636431172968, 480, 1, 479, 1, 0, 1
8944, 1, 1636431168096, 1636431173005, 4909, 4460, 449, 0, 4460, 4460
8969, 1, 1636431172652, 1636431173097, 445, 0, 445, 0, 0, 0
8970, 1, 1636431172696, 1636431173149, 453, 0, 453, 0, 0, 0
8972, 1, 1636431172988, 1636431173437, 449, 1, 448, 0, 0, 0
8974, 1, 1636431173229, 1636431173681, 452, 0, 452, 0, 0, 0
8973, 1, 1636431172992, 1636431173892, 900, 446, 454, 445, 1, 446
8975, 1, 1636431173797, 1636431174253, 456, 0, 456, 0, 0, 0
8976, 1, 1636431173973, 1636431174433, 460, 0, 460, 0, 0, 0
8977, 1, 1636431174028, 1636431174476, 448, 1, 447, 0, 0, 0
8978, 1, 1636431174300, 1636431174752, 452, 1, 451, 0, 0, 0
8980, 1, 1636431174493, 1636431174941, 448, 0, 448, 0, 0, 0
8979, 1, 1636431174316, 1636431175205, 889, 435, 454, 435, 0, 435
8981, 1, 1636431175109, 1636431175564, 455, 0, 455, 0, 0, 0
8928, 2, 1636431165620, 1636431175616, 9996, 0, 9996, 0, 0, 0
8929, 2, 1636431165620, 1636431175660, 10040, 0, 10040, 0, 0, 0
8982, 1, 1636431175252, 1636431175709, 457, 1, 456, 0, 0, 0
8983, 1, 1636431175337, 1636431175785, 448, 0, 448, 0, 0, 0
8984, 1, 1636431175572, 1636431176069, 497, 1, 496, 0, 0, 0
8931, 2, 1636431166076, 1636431176072, 9996, 0, 9996, 0, 0, 0
8986, 1, 1636431175825, 1636431176293, 468, 0, 468, 0, 0, 0
8987, 1, 1636431175928, 1636431176385, 457, 1, 456, 0, 0, 0
8985, 1, 1636431175704, 1636431176513, 809, 365, 444, 365, 0, 365
8936, 2, 1636431166712, 1636431176713, 10001, 0, 10001, 0, 0, 0
8989, 1, 1636431176380, 1636431176840, 460, 5, 455, 5, 0, 5
8990, 1, 1636431176441, 1636431176880, 439, 0, 439, 0, 0, 0
8991, 1, 1636431176552, 1636431177033, 481, 1, 480, 1, 0, 1
8992, 1, 1636431176665, 1636431177121, 456, 0, 456, 0, 0, 0
8938, 2, 1636431167129, 1636431177124, 9995, 0, 9995, 0, 0, 0
8988, 1, 1636431175928, 1636431177280, 1352, 913, 439, 913, 0, 913
8993, 1, 1636431176848, 1636431177288, 440, 0, 440, 0, 0, 0
8997, 1, 1636431177212, 1636431177661, 449, 1, 448, 0, 0, 0
8996, 1, 1636431177212, 1636431177661, 449, 1, 448, 0, 0, 0
8995, 1, 1636431177012, 1636431177729, 717, 268, 449, 268, 0, 268
8994, 1, 1636431176948, 1636431177737, 789, 341, 448, 340, 0, 340
8999, 1, 1636431177501, 1636431177949, 448, 0, 448, 0, 0, 0
9000, 1, 1636431177644, 1636431178117, 473, 18, 455, 16, 0, 16
8998, 1, 1636431177432, 1636431178180, 748, 298, 450, 297, 0, 297
9001, 1, 1636431177736, 1636431178184, 448, 1, 447, 0, 0, 0
9002, 1, 1636431177896, 1636431178344, 448, 0, 448, 0, 0, 0
8945, 2, 1636431168361, 1636431178360, 9999, 0, 9999, 0, 0, 0
9003, 1, 1636431177949, 1636431178393, 444, 0, 444, 0, 0, 0
9004, 1, 1636431178248, 1636431178692, 444, 1, 443, 0, 0, 0
9005, 1, 1636431178288, 1636431178768, 480, 1, 479, 0, 1, 1
9007, 1, 1636431178521, 1636431178969, 448, 0, 448, 0, 0, 0
9008, 1, 1636431178568, 1636431179016, 448, 1, 447, 0, 0, 0
9009, 1, 1636431178672, 1636431179113, 441, 0, 441, 0, 0, 0
9006, 1, 1636431178288, 1636431179129, 841, 405, 436, 405, 0, 405
9011, 1, 1636431178736, 1636431179184, 448, 0, 448, 0, 0, 0
9010, 1, 1636431178700, 1636431179220, 520, 69, 451, 69, 0, 69
8951, 2, 1636431169248, 1636431179248, 10000, 0, 10000, 0, 0, 0
9012, 1, 1636431179025, 1636431179468, 443, 0, 443, 0, 0, 0
8952, 2, 1636431169512, 1636431179512, 10000, 0, 10000, 0, 0, 0
9013, 1, 1636431179129, 1636431179580, 451, 0, 451, 0, 0, 0
9014, 1, 1636431179204, 1636431179660, 456, 1, 455, 0, 1, 1
9015, 1, 1636431179384, 1636431179833, 449, 1, 448, 0, 1, 1
9017, 1, 1636431179560, 1636431180008, 448, 1, 447, 0, 1, 1
9016, 1, 1636431179560, 1636431180008, 448, 1, 447, 0, 1, 1
9019, 1, 1636431179664, 1636431180117, 453, 1, 452, 0, 0, 0
9021, 1, 1636431179825, 1636431180276, 451, 0, 451, 0, 0, 0
9022, 1, 1636431179848, 1636431180288, 440, 1, 439, 1, 0, 1
9023, 1, 1636431179924, 1636431180364, 440, 1, 439, 0, 1, 1
8958, 2, 1636431170377, 1636431180376, 9999, 0, 9999, 0, 0, 0
9018, 1, 1636431179600, 1636431180452, 852, 409, 443, 409, 0, 409
9020, 1, 1636431179816, 1636431180452, 636, 193, 443, 193, 0, 193
9025, 1, 1636431180093, 1636431180601, 508, 24, 484, 24, 0, 24
9026, 1, 1636431180288, 1636431180784, 496, 1, 495, 1, 0, 1
9024, 1, 1636431180060, 1636431180900, 840, 393, 447, 393, 0, 393
9027, 1, 1636431180464, 1636431180916, 452, 0, 452, 0, 0, 0
8959, 2, 1636431170957, 1636431180952, 9995, 0, 9995, 0, 0, 0
9028, 1, 1636431180544, 1636431180992, 448, 1, 447, 0, 1, 1
9030, 1, 1636431180708, 1636431181176, 468, 1, 467, 0, 0, 0
9031, 1, 1636431180816, 1636431181268, 452, 0, 452, 0, 0, 0
9029, 1, 1636431180688, 1636431181360, 672, 213, 459, 213, 0, 213
9032, 1, 1636431180916, 1636431181364, 448, 1, 447, 1, 0, 1
8962, 2, 1636431171380, 1636431181384, 10004, 0, 10004, 0, 0, 0
9033, 1, 1636431180936, 1636431181388, 452, 0, 452, 0, 0, 0
9036, 1, 1636431181128, 1636431181604, 476, 1, 475, 0, 0, 0
9037, 1, 1636431181208, 1636431181701, 493, 1, 492, 0, 0, 0
9035, 1, 1636431181092, 1636431181729, 637, 177, 460, 177, 0, 177
9039, 1, 1636431181316, 1636431181789, 473, 1, 472, 0, 0, 0
9038, 1, 1636431181260, 1636431181800, 540, 101, 439, 101, 0, 101
9034, 1, 1636431180944, 1636431181820, 876, 421, 455, 421, 0, 421
9040, 1, 1636431181428, 1636431181877, 449, 1, 448, 1, 0, 1
9041, 1, 1636431181428, 1636431181877, 449, 1, 448, 1, 0, 1
9042, 1, 1636431181580, 1636431182056, 476, 25, 451, 25, 0, 25
9044, 1, 1636431181757, 1636431182204, 447, 0, 447, 0, 0, 0
9043, 1, 1636431181688, 1636431182248, 560, 113, 447, 113, 0, 113
8966, 2, 1636431172244, 1636431182248, 10004, 0, 10004, 0, 0, 0
9045, 1, 1636431181936, 1636431182380, 444, 1, 443, 1, 0, 1
9046, 1, 1636431181972, 1636431182420, 448, 1, 447, 0, 0, 0
8967, 2, 1636431172508, 1636431182509, 10001, 0, 10001, 1, 0, 1
9047, 1, 1636431182080, 1636431182560, 480, 0, 480, 0, 0, 0
9049, 1, 1636431182240, 1636431182732, 492, 1, 491, 0, 1, 1
9053, 1, 1636431182456, 1636431182913, 457, 1, 456, 0, 0, 0
8971, 1, 1636431172865, 1636431182949, 10084, 9644, 440, 0, 9644, 9644
9054, 1, 1636431182556, 1636431182992, 436, 1, 435, 0, 1, 1
9055, 1, 1636431182556, 1636431182996, 440, 1, 439, 0, 1, 1
9056, 1, 1636431182600, 1636431183036, 436, 0, 436, 0, 0, 0
9058, 1, 1636431182692, 1636431183181, 489, 41, 448, 40, 1, 41
9060, 1, 1636431182792, 1636431183245, 453, 0, 453, 0, 0, 0
9061, 1, 1636431182880, 1636431183353, 473, 33, 440, 33, 0, 33
9059, 1, 1636431182813, 1636431183440, 627, 180, 447, 180, 0, 180
9062, 1, 1636431182980, 1636431183444, 464, 17, 447, 17, 0, 17
9063, 1, 1636431183048, 1636431183496, 448, 1, 447, 1, 0, 1
9065, 1, 1636431183273, 1636431183721, 448, 0, 448, 0, 0, 0
9057, 1, 1636431182644, 1636431183808, 1164, 709, 455, 709, 0, 709
9067, 1, 1636431183364, 1636431183812, 448, 1, 447, 0, 0, 0
9064, 1, 1636431183172, 1636431183896, 724, 269, 455, 269, 0, 269
9068, 1, 1636431183569, 1636431184249, 680, 240, 440, 240, 0, 240
9069, 1, 1636431183804, 1636431184249, 445, 0, 445, 0, 0, 0
9070, 1, 1636431183852, 1636431184296, 444, 1, 443, 0, 1, 1
9071, 1, 1636431183889, 1636431184336, 447, 0, 447, 0, 0, 0
9073, 1, 1636431184032, 1636431184477, 445, 0, 445, 0, 0, 0
9076, 1, 1636431184165, 1636431184613, 448, 0, 448, 0, 0, 0
9074, 1, 1636431184016, 1636431184701, 685, 233, 452, 233, 0, 233
9075, 1, 1636431184068, 1636431184701, 633, 182, 451, 182, 0, 182
9077, 1, 1636431184276, 1636431184748, 472, 21, 451, 20, 1, 21
9079, 1, 1636431184396, 1636431184853, 457, 0, 457, 0, 0, 0
9081, 1, 1636431184664, 1636431185109, 445, 0, 445, 0, 0, 0
9080, 1, 1636431184492, 1636431185152, 660, 210, 450, 210, 0, 210
9082, 1, 1636431184756, 1636431185192, 436, 0, 436, 0, 0, 0
9083, 1, 1636431184929, 1636431185372, 443, 0, 443, 0, 0, 0
9084, 1, 1636431185149, 1636431185601, 452, 0, 452, 0, 0, 0
9086, 1, 1636431185257, 1636431185716, 459, 0, 459, 0, 0, 0
9087, 1, 1636431185384, 1636431185828, 444, 1, 443, 0, 0, 0
9088, 1, 1636431185384, 1636431185836, 452, 1, 451, 0, 0, 0
9090, 1, 1636431185509, 1636431185953, 444, 0, 444, 0, 0, 0
9091, 1, 1636431185601, 1636431186048, 447, 0, 447, 0, 0, 0
9092, 1, 1636431185689, 1636431186140, 451, 0, 451, 0, 0, 0
9094, 1, 1636431186065, 1636431186517, 452, 0, 452, 0, 0, 0
9095, 1, 1636431186129, 1636431186577, 448, 0, 448, 0, 0, 0
9096, 1, 1636431186225, 1636431186669, 444, 0, 444, 0, 0, 0
9097, 1, 1636431186545, 1636431186989, 444, 0, 444, 0, 0, 0
9098, 1, 1636431186628, 1636431187072, 444, 0, 444, 0, 0, 0
9099, 1, 1636431186672, 1636431187116, 444, 0, 444, 0, 0, 0
9100, 1, 1636431186753, 1636431187205, 452, 0, 452, 0, 0, 0
9101, 1, 1636431186816, 1636431187257, 441, 1, 440, 1, 0, 1
9102, 1, 1636431186997, 1636431187440, 443, 0, 443, 0, 0, 0
9103, 1, 1636431187004, 1636431187448, 444, 1, 443, 0, 0, 0
9104, 1, 1636431187397, 1636431187845, 448, 0, 448, 0, 0, 0
9105, 1, 1636431187489, 1636431187940, 451, 0, 451, 0, 0, 0
9106, 1, 1636431187573, 1636431188016, 443, 0, 443, 0, 0, 0
9107, 1, 1636431187861, 1636431188305, 444, 0, 444, 0, 0, 0
9108, 1, 1636431187913, 1636431188349, 436, 0, 436, 0, 0, 0
9109, 1, 1636431188068, 1636431188504, 436, 0, 436, 0, 0, 0
9110, 1, 1636431188112, 1636431188548, 436, 1, 435, 0, 0, 0
9111, 1, 1636431188144, 1636431188576, 432, 0, 432, 0, 0, 0
9112, 1, 1636431188265, 1636431188745, 480, 41, 439, 40, 0, 40
9113, 1, 1636431188396, 1636431188829, 433, 1, 432, 0, 0, 0
9114, 1, 1636431188737, 1636431189197, 460, 0, 460, 0, 0, 0
9115, 1, 1636431188800, 1636431189244, 444, 1, 443, 1, 0, 1
9116, 1, 1636431188832, 1636431189277, 445, 0, 445, 0, 0, 0
9117, 1, 1636431189161, 1636431189592, 431, 0, 431, 0, 0, 0
9118, 1, 1636431189193, 1636431189636, 443, 0, 443, 0, 0, 0
9119, 1, 1636431189361, 1636431189805, 444, 0, 444, 0, 0, 0
9120, 1, 1636431189461, 1636431189909, 448, 0, 448, 0, 0, 0
9121, 1, 1636431189512, 1636431189952, 440, 1, 439, 1, 0, 1
9122, 1, 1636431189556, 1636431190037, 481, 37, 444, 37, 0, 37
9123, 1, 1636431189736, 1636431190177, 441, 1, 440, 1, 0, 1
9124, 1, 1636431190060, 1636431190501, 441, 1, 440, 0, 0, 0
9125, 1, 1636431190136, 1636431190569, 433, 0, 433, 0, 0, 0
9126, 1, 1636431190180, 1636431190616, 436, 0, 436, 0, 0, 0
9127, 1, 1636431190528, 1636431190973, 445, 0, 445, 0, 0, 0
9128, 1, 1636431190569, 1636431191020, 451, 0, 451, 0, 0, 0
9129, 1, 1636431190652, 1636431191096, 444, 0, 444, 0, 0, 0
9130, 1, 1636431190732, 1636431191173, 441, 0, 441, 0, 0, 0
9131, 1, 1636431190884, 1636431191317, 433, 1, 432, 0, 1, 1
9132, 1, 1636431190900, 1636431191409, 509, 73, 436, 72, 0, 72
9133, 1, 1636431191137, 1636431191580, 443, 0, 443, 0, 0, 0
9134, 1, 1636431191460, 1636431191913, 453, 1, 452, 0, 0, 0
9135, 1, 1636431191496, 1636431191932, 436, 1, 435, 0, 0, 0
9136, 1, 1636431191533, 1636431191968, 435, 0, 435, 0, 0, 0
9048, 2, 1636431182173, 1636431192173, 10000, 0, 10000, 388, 0, 388
9051, 2, 1636431182292, 1636431192296, 10004, 0, 10004, 0, 0, 0
9050, 2, 1636431182292, 1636431192340, 10048, 0, 10048, 0, 0, 0
9137, 1, 1636431191900, 1636431192344, 444, 1, 443, 0, 0, 0
9138, 1, 1636431191964, 1636431192408, 444, 1, 443, 0, 0, 0
9052, 2, 1636431182444, 1636431192445, 10001, 0, 10001, 116, 0, 116
9139, 1, 1636431192028, 1636431192561, 533, 1, 532, 0, 0, 0
9140, 1, 1636431192125, 1636431192664, 539, 0, 539, 0, 0, 0
9141, 1, 1636431192340, 1636431192772, 432, 5, 427, 4, 0, 4
9142, 1, 1636431192388, 1636431192840, 452, 0, 452, 0, 0, 0
9143, 1, 1636431192428, 1636431192860, 432, 1, 431, 1, 0, 1
9145, 1, 1636431192616, 1636431193049, 433, 0, 433, 0, 0, 0
9146, 1, 1636431192800, 1636431193233, 433, 0, 433, 0, 0, 0
9147, 1, 1636431192808, 1636431193248, 440, 1, 439, 0, 1, 1
9149, 1, 1636431192868, 1636431193297, 429, 1, 428, 0, 1, 1
9150, 1, 1636431192876, 1636431193308, 432, 0, 432, 0, 0, 0
9066, 2, 1636431183333, 1636431193332, 9999, 0, 9999, 0, 0, 0
9144, 1, 1636431192624, 1636431193497, 873, 425, 448, 425, 0, 425
9151, 1, 1636431193181, 1636431193640, 459, 0, 459, 0, 0, 0
9152, 1, 1636431193297, 1636431193737, 440, 0, 440, 0, 0, 0
9148, 1, 1636431192868, 1636431193737, 869, 429, 440, 429, 0, 429
9153, 1, 1636431193420, 1636431193853, 433, 1, 432, 0, 0, 0
9154, 1, 1636431193497, 1636431193940, 443, 0, 443, 0, 0, 0
9072, 2, 1636431183956, 1636431193953, 9997, 0, 9997, 0, 0, 0
9158, 1, 1636431193709, 1636431194176, 467, 0, 467, 0, 0, 0
9155, 1, 1636431193636, 1636431194181, 545, 102, 443, 101, 1, 102
9159, 1, 1636431193852, 1636431194300, 448, 1, 447, 0, 0, 0
9078, 2, 1636431184372, 1636431194376, 10004, 0, 10004, 0, 0, 0
9161, 1, 1636431194092, 1636431194532, 440, 0, 440, 0, 0, 0
9162, 1, 1636431194116, 1636431194593, 477, 1, 476, 0, 1, 1
9165, 1, 1636431194160, 1636431194596, 436, 1, 435, 0, 0, 0
9166, 1, 1636431194257, 1636431194692, 435, 0, 435, 0, 0, 0
9160, 1, 1636431193876, 1636431194769, 893, 425, 468, 425, 0, 425
9167, 1, 1636431194512, 1636431194957, 445, 1, 444, 1, 0, 1
9163, 1, 1636431194132, 1636431195045, 913, 461, 452, 460, 0, 460
9169, 1, 1636431194685, 1636431195145, 460, 8, 452, 8, 0, 8
9085, 2, 1636431185160, 1636431195161, 10001, 0, 10001, 0, 0, 0
9171, 1, 1636431194868, 1636431195329, 461, 0, 461, 0, 0, 0
9089, 2, 1636431185440, 1636431195441, 10001, 0, 10001, 1, 0, 1
9173, 1, 1636431195008, 1636431195500, 492, 37, 455, 37, 0, 37
9174, 1, 1636431195132, 1636431195584, 452, 1, 451, 0, 0, 0
9093, 2, 1636431185869, 1636431195869, 10000, 0, 10000, 0, 0, 0
9178, 1, 1636431195484, 1636431195941, 457, 1, 456, 0, 0, 0
9177, 1, 1636431195484, 1636431195941, 457, 1, 456, 1, 0, 1
9176, 1, 1636431195484, 1636431195944, 460, 1, 459, 0, 0, 0
9172, 1, 1636431194897, 1636431195944, 1047, 604, 443, 604, 0, 604
9179, 1, 1636431195532, 1636431195977, 445, 1, 444, 0, 1, 1
9175, 1, 1636431195204, 1636431196025, 821, 381, 440, 381, 0, 381
9183, 1, 1636431195809, 1636431196280, 471, 0, 471, 0, 0, 0
9168, 1, 1636431194576, 1636431196320, 1744, 1293, 451, 0, 1293, 1293
9180, 1, 1636431195532, 1636431196385, 853, 409, 444, 408, 0, 408
9182, 1, 1636431195749, 1636431196392, 643, 196, 447, 195, 1, 196
9181, 1, 1636431195532, 1636431196393, 861, 413, 448, 413, 0, 413
9188, 1, 1636431196296, 1636431196740, 444, 1, 443, 0, 1, 1
9187, 1, 1636431196245, 1636431196828, 583, 140, 443, 140, 0, 140
9186, 1, 1636431196181, 1636431196845, 664, 212, 452, 212, 0, 212
9184, 1, 1636431195956, 1636431196845, 889, 437, 452, 437, 0, 437
9189, 1, 1636431196484, 1636431196929, 445, 1, 444, 1, 0, 1
9190, 1, 1636431196540, 1636431196988, 448, 1, 447, 1, 0, 1
9194, 1, 1636431196808, 1636431197248, 440, 1, 439, 0, 0, 0
9195, 1, 1636431196816, 1636431197252, 436, 0, 436, 0, 0, 0
9192, 1, 1636431196764, 1636431197296, 532, 81, 451, 81, 0, 81
9197, 1, 1636431196860, 1636431197309, 449, 0, 449, 0, 0, 0
9193, 1, 1636431196784, 1636431197381, 597, 146, 451, 145, 0, 145
9199, 1, 1636431197136, 1636431197580, 444, 1, 443, 1, 0, 1
9196, 1, 1636431196864, 1636431197709, 845, 385, 460, 385, 0, 385
9198, 1, 1636431197009, 1636431197744, 735, 288, 447, 288, 0, 288
9200, 1, 1636431197292, 1636431197760, 468, 17, 451, 17, 0, 17
9191, 1, 1636431196553, 1636431197836, 1283, 828, 455, 828, 0, 828
9203, 1, 1636431197625, 1636431198069, 444, 0, 444, 0, 0, 0
9202, 1, 1636431197620, 1636431198148, 528, 89, 439, 88, 0, 88
9201, 1, 1636431197453, 1636431198192, 739, 292, 447, 292, 0, 292
9204, 1, 1636431197788, 1636431198236, 448, 1, 447, 0, 0, 0
9205, 1, 1636431197824, 1636431198276, 452, 1, 451, 0, 0, 0
9206, 1, 1636431198060, 1636431198525, 465, 9, 456, 9, 0, 9
9207, 1, 1636431198088, 1636431198529, 441, 0, 441, 0, 0, 0
9208, 1, 1636431198136, 1636431198592, 456, 1, 455, 1, 0, 1
9209, 1, 1636431198156, 1636431198596, 440, 0, 440, 0, 0, 0
9210, 1, 1636431198192, 1636431198633, 441, 1, 440, 0, 1, 1
9212, 1, 1636431198220, 1636431198672, 452, 1, 451, 0, 1, 1
9214, 1, 1636431198520, 1636431198968, 448, 1, 447, 1, 0, 1
9213, 1, 1636431198356, 1636431199036, 680, 237, 443, 237, 0, 237
9211, 1, 1636431198204, 1636431199077, 873, 429, 444, 429, 0, 429
9215, 1, 1636431198636, 1636431199128, 492, 37, 455, 37, 0, 37
9217, 1, 1636431198932, 1636431199380, 448, 0, 448, 0, 0, 0
9216, 1, 1636431198804, 1636431199481, 677, 233, 444, 233, 0, 233
9218, 1, 1636431199009, 1636431199524, 515, 68, 447, 68, 0, 68
9219, 1, 1636431199128, 1636431199572, 444, 0, 444, 0, 0, 0
9220, 1, 1636431199164, 1636431199612, 448, 0, 448, 0, 0, 0
9221, 1, 1636431199368, 1636431199812, 444, 1, 443, 0, 0, 0
9222, 1, 1636431199392, 1636431199840, 448, 0, 448, 0, 0, 0
9223, 1, 1636431199481, 1636431199928, 447, 0, 447, 0, 0, 0
9224, 1, 1636431199500, 1636431199944, 444, 0, 444, 0, 0, 0
9225, 1, 1636431199520, 1636431199964, 444, 0, 444, 0, 0, 0
9227, 1, 1636431199612, 1636431200053, 441, 1, 440, 0, 1, 1
9228, 1, 1636431199736, 1636431200401, 665, 209, 456, 209, 0, 209
9229, 1, 1636431199896, 1636431200417, 521, 69, 452, 68, 1, 69
9230, 1, 1636431200029, 1636431200504, 475, 24, 451, 24, 0, 24
9232, 1, 1636431200245, 1636431200696, 451, 0, 451, 0, 0, 0
9231, 1, 1636431200185, 1636431200852, 667, 216, 451, 216, 0, 216
9233, 1, 1636431200296, 1636431200860, 564, 122, 442, 120, 0, 120
9234, 1, 1636431200484, 1636431200936, 452, 0, 452, 0, 0, 0
9235, 1, 1636431200524, 1636431200972, 448, 0, 448, 0, 0, 0
9236, 1, 1636431200732, 1636431201176, 444, 1, 443, 1, 0, 1
9237, 1, 1636431200752, 1636431201196, 444, 1, 443, 1, 0, 1
9238, 1, 1636431200768, 1636431201217, 449, 0, 449, 0, 0, 0
9239, 1, 1636431200840, 1636431201284, 444, 1, 443, 0, 0, 0
9226, 1, 1636431199540, 1636431201313, 1773, 1321, 452, 1320, 0, 1320
9240, 1, 1636431200892, 1636431201349, 457, 0, 457, 0, 0, 0
9243, 1, 1636431201189, 1636431201640, 451, 0, 451, 0, 0, 0
9241, 1, 1636431200920, 1636431201769, 849, 393, 456, 393, 0, 393
9242, 1, 1636431201113, 1636431201800, 687, 236, 451, 236, 0, 236
9245, 1, 1636431201536, 1636431201980, 444, 1, 443, 0, 0, 0
9246, 1, 1636431201544, 1636431201996, 452, 1, 451, 0, 1, 1
9248, 1, 1636431201592, 1636431202032, 440, 0, 440, 0, 0, 0
9244, 1, 1636431201324, 1636431202220, 896, 445, 451, 445, 0, 445
9249, 1, 1636431201788, 1636431202240, 452, 1, 451, 0, 1, 1
9247, 1, 1636431201540, 1636431202248, 708, 261, 447, 261, 0, 261
9250, 1, 1636431201820, 1636431202256, 436, 1, 435, 0, 1, 1
9251, 1, 1636431202020, 1636431202464, 444, 1, 443, 1, 0, 1
9252, 1, 1636431202076, 1636431202517, 441, 1, 440, 1, 0, 1
9253, 1, 1636431202092, 1636431202537, 445, 1, 444, 0, 0, 0
9254, 1, 1636431202161, 1636431202665, 504, 60, 444, 60, 0, 60
9255, 1, 1636431202236, 1636431202680, 444, 1, 443, 1, 0, 1
9256, 1, 1636431202244, 1636431202688, 444, 0, 444, 0, 0, 0
9258, 1, 1636431202512, 1636431202977, 465, 25, 440, 25, 0, 25
9257, 1, 1636431202437, 1636431203104, 667, 228, 439, 228, 0, 228
9259, 1, 1636431202645, 1636431203113, 468, 36, 432, 35, 1, 36
9261, 1, 1636431202884, 1636431203345, 461, 0, 461, 0, 0, 0
9262, 1, 1636431202892, 1636431203345, 453, 0, 453, 0, 0, 0
9263, 1, 1636431202996, 1636431203432, 436, 1, 435, 1, 0, 1
9264, 1, 1636431203101, 1636431203544, 443, 0, 443, 0, 0, 0
9260, 1, 1636431202856, 1636431203552, 696, 249, 447, 249, 0, 249
9265, 1, 1636431203129, 1636431203572, 443, 0, 443, 0, 0, 0
9156, 2, 1636431193605, 1636431203604, 9999, 0, 9999, 36, 0, 36
9157, 2, 1636431193608, 1636431203652, 10044, 0, 10044, 33, 0, 33
9266, 1, 1636431203417, 1636431203880, 463, 0, 463, 0, 0, 0
9268, 1, 1636431203480, 1636431203960, 480, 1, 479, 1, 0, 1
9267, 1, 1636431203424, 1636431203964, 540, 1, 539, 1, 0, 1
9269, 1, 1636431203492, 1636431203968, 476, 1, 475, 1, 0, 1
9271, 1, 1636431203696, 1636431204136, 440, 0, 440, 0, 0, 0
9270, 1, 1636431203696, 1636431204136, 440, 0, 440, 0, 0, 0
9164, 2, 1636431194136, 1636431204136, 10000, 0, 10000, 0, 0, 0
9273, 1, 1636431203892, 1636431204360, 468, 1, 467, 0, 1, 1
9274, 1, 1636431203940, 1636431204388, 448, 1, 447, 1, 0, 1
9275, 1, 1636431203953, 1636431204408, 455, 0, 455, 0, 0, 0
9272, 1, 1636431203744, 1636431204448, 704, 217, 487, 217, 0, 217
9276, 1, 1636431203996, 1636431204580, 584, 141, 443, 141, 0, 141
9278, 1, 1636431204228, 1636431204669, 441, 0, 441, 0, 0, 0
9170, 2, 1636431194692, 1636431204696, 10004, 0, 10004, 1, 0, 1
9279, 1, 1636431204268, 1636431204712, 444, 0, 444, 0, 0, 0
9280, 1, 1636431204384, 1636431204828, 444, 1, 443, 0, 0, 0
9281, 1, 1636431204380, 1636431204828, 448, 0, 448, 0, 0, 0
9283, 1, 1636431204464, 1636431204920, 456, 1, 455, 0, 0, 0
9277, 1, 1636431204184, 1636431204920, 736, 265, 471, 265, 0, 265
9282, 1, 1636431204444, 1636431204928, 484, 0, 484, 0, 0, 0
9185, 1, 1636431196136, 1636431205165, 9029, 8561, 468, 0, 8560, 8560
9285, 1, 1636431204788, 1636431205253, 465, 0, 465, 0, 0, 0
9286, 1, 1636431204788, 1636431205253, 465, 0, 465, 0, 0, 0
9284, 1, 1636431204744, 1636431205285, 541, 85, 456, 85, 0, 85
9287, 1, 1636431204828, 1636431205285, 457, 1, 456, 0, 0, 0
9289, 1, 1636431204988, 1636431205440, 452, 0, 452, 0, 0, 0
9288, 1, 1636431204996, 1636431205444, 448, 0, 448, 0, 0, 0
9292, 1, 1636431205144, 1636431205585, 441, 1, 440, 1, 0, 1
9293, 1, 1636431205204, 1636431205645, 441, 1, 440, 0, 0, 0
9294, 1, 1636431205256, 1636431205704, 448, 1, 447, 0, 0, 0
9290, 1, 1636431205032, 1636431205737, 705, 253, 452, 253, 0, 253
9291, 1, 1636431205100, 1636431205737, 637, 186, 451, 185, 1, 186
9296, 1, 1636431205384, 1636431205824, 440, 0, 440, 0, 0, 0
9298, 1, 1636431205536, 1636431205972, 436, 1, 435, 0, 0, 0
9299, 1, 1636431205557, 1636431206009, 452, 0, 452, 0, 0, 0
9300, 1, 1636431205664, 1636431206108, 444, 1, 443, 1, 0, 1
9301, 1, 1636431205736, 1636431206184, 448, 1, 447, 0, 0, 0
9302, 1, 1636431205748, 1636431206193, 445, 0, 445, 0, 0, 0
9295, 1, 1636431205344, 1636431206193, 849, 393, 456, 393, 0, 393
9297, 1, 1636431205520, 1636431206200, 680, 218, 462, 217, 0, 217
9303, 1, 1636431205800, 1636431206236, 436, 0, 436, 0, 0, 0
9304, 1, 1636431206060, 1636431206508, 448, 0, 448, 0, 0, 0
9305, 1, 1636431206100, 1636431206544, 444, 1, 443, 0, 0, 0
9306, 1, 1636431206152, 1636431206588, 436, 0, 436, 0, 0, 0
9307, 1, 1636431206180, 1636431206632, 452, 14, 438, 13, 0, 13
9308, 1, 1636431206204, 1636431206648, 444, 0, 444, 0, 0, 0
9309, 1, 1636431206288, 1636431206741, 453, 1, 452, 1, 0, 1
9310, 1, 1636431206404, 1636431206865, 461, 0, 461, 0, 0, 0
9312, 1, 1636431206481, 1636431206928, 447, 0, 447, 0, 0, 0
9313, 1, 1636431206496, 1636431206944, 448, 1, 447, 0, 0, 0
9315, 1, 1636431206632, 1636431207077, 445, 1, 444, 0, 1, 1
9311, 1, 1636431206448, 1636431207077, 629, 185, 444, 185, 0, 185
9316, 1, 1636431206685, 1636431207320, 635, 180, 455, 180, 0, 180
9318, 1, 1636431206892, 1636431207345, 453, 1, 452, 0, 0, 0
9314, 1, 1636431206584, 1636431207377, 793, 345, 448, 345, 0, 345
9320, 1, 1636431207025, 1636431207472, 447, 0, 447, 0, 0, 0
9321, 1, 1636431207080, 1636431207528, 448, 1, 447, 0, 1, 1
9317, 1, 1636431206876, 1636431207540, 664, 202, 462, 200, 0, 200
9322, 1, 1636431207080, 1636431207540, 460, 1, 459, 0, 1, 1
9319, 1, 1636431206992, 1636431207828, 836, 385, 451, 385, 0, 385
9323, 1, 1636431207440, 1636431207884, 444, 1, 443, 1, 0, 1
9324, 1, 1636431207448, 1636431207909, 461, 1, 460, 0, 0, 0
9326, 1, 1636431207536, 1636431207984, 448, 0, 448, 0, 0, 0
9327, 1, 1636431207572, 1636431208020, 448, 1, 447, 0, 0, 0
9328, 1, 1636431207600, 1636431208044, 444, 1, 443, 1, 0, 1
9329, 1, 1636431207713, 1636431208152, 439, 0, 439, 0, 0, 0
9330, 1, 1636431207820, 1636431208272, 452, 0, 452, 0, 0, 0
9332, 1, 1636431207828, 1636431208273, 445, 1, 444, 1, 0, 1
9325, 1, 1636431207504, 1636431208284, 780, 325, 455, 325, 0, 325
9333, 1, 1636431207888, 1636431208332, 444, 0, 444, 0, 0, 0
9334, 1, 1636431207908, 1636431208356, 448, 1, 447, 0, 0, 0
9331, 1, 1636431207824, 1636431208464, 640, 197, 443, 197, 0, 197
9335, 1, 1636431208000, 1636431208600, 600, 153, 447, 153, 0, 153
9336, 1, 1636431208232, 1636431208681, 449, 1, 448, 0, 0, 0
9338, 1, 1636431208320, 1636431208772, 452, 1, 451, 0, 0, 0
9339, 1, 1636431208348, 1636431208792, 444, 1, 443, 1, 0, 1
9341, 1, 1636431208392, 1636431208836, 444, 0, 444, 0, 0, 0
9337, 1, 1636431208244, 1636431208916, 672, 221, 451, 221, 0, 221
9340, 1, 1636431208348, 1636431209052, 704, 253, 451, 253, 0, 253
9342, 1, 1636431208736, 1636431209184, 448, 1, 447, 1, 0, 1
9343, 1, 1636431208740, 1636431209184, 444, 1, 443, 0, 1, 1
9344, 1, 1636431208860, 1636431209312, 452, 1, 451, 0, 0, 0
9346, 1, 1636431208928, 1636431209372, 444, 0, 444, 0, 0, 0
9347, 1, 1636431208928, 1636431209376, 448, 0, 448, 0, 0, 0
9348, 1, 1636431209028, 1636431209468, 440, 1, 439, 1, 0, 1
9345, 1, 1636431208904, 1636431209496, 592, 149, 443, 149, 0, 149
9350, 1, 1636431209116, 1636431209553, 437, 1, 436, 1, 0, 1
9351, 1, 1636431209152, 1636431209600, 448, 0, 448, 0, 0, 0
9352, 1, 1636431209200, 1636431209641, 441, 1, 440, 0, 0, 0
9353, 1, 1636431209252, 1636431209693, 441, 1, 440, 0, 0, 0
9354, 1, 1636431209312, 1636431209916, 604, 157, 447, 157, 0, 157
9349, 1, 1636431209108, 1636431209952, 844, 389, 455, 388, 0, 388
9355, 1, 1636431209532, 1636431209981, 449, 1, 448, 0, 0, 0
9357, 1, 1636431209616, 1636431210061, 445, 1, 444, 1, 0, 1
9358, 1, 1636431209705, 1636431210152, 447, 0, 447, 0, 0, 0
9359, 1, 1636431209712, 1636431210160, 448, 1, 447, 0, 1, 1
9360, 1, 1636431209716, 1636431210160, 444, 1, 443, 0, 1, 1
9356, 1, 1636431209568, 1636431210404, 836, 385, 451, 385, 0, 385
9361, 1, 1636431210004, 1636431210456, 452, 1, 451, 0, 0, 0
9362, 1, 1636431210144, 1636431210584, 440, 0, 440, 0, 0, 0
9363, 1, 1636431210156, 1636431210609, 453, 0, 453, 0, 0, 0
9364, 1, 1636431210184, 1636431210636, 452, 0, 452, 0, 0, 0
9365, 1, 1636431210220, 1636431210668, 448, 0, 448, 0, 0, 0
9366, 1, 1636431210264, 1636431210708, 444, 0, 444, 0, 0, 0
9367, 1, 1636431210352, 1636431210801, 449, 0, 449, 0, 0, 0
9370, 1, 1636431210488, 1636431210928, 440, 1, 439, 0, 0, 0
9371, 1, 1636431210532, 1636431210992, 460, 1, 459, 1, 0, 1
9368, 1, 1636431210408, 1636431211060, 652, 201, 451, 201, 0, 201
9373, 1, 1636431210616, 1636431211068, 452, 1, 451, 0, 0, 0
9369, 1, 1636431210420, 1636431211084, 664, 217, 447, 217, 0, 217
9372, 1, 1636431210605, 1636431211245, 640, 196, 444, 196, 0, 196
9374, 1, 1636431210821, 1636431211269, 448, 0, 448, 0, 0, 0
9377, 1, 1636431211012, 1636431211460, 448, 1, 447, 0, 1, 1
9378, 1, 1636431211052, 1636431211496, 444, 1, 443, 0, 0, 0
9376, 1, 1636431210916, 1636431211512, 596, 145, 451, 145, 0, 145
9375, 1, 1636431210888, 1636431211537, 649, 197, 452, 197, 0, 197
9379, 1, 1636431211080, 1636431211537, 457, 1, 456, 0, 0, 0
9380, 1, 1636431211361, 1636431211805, 444, 0, 444, 0, 0, 0
9382, 1, 1636431211468, 1636431211916, 448, 0, 448, 0, 0, 0
9381, 1, 1636431211437, 1636431211960, 523, 76, 447, 76, 0, 76
9383, 1, 1636431211537, 1636431211984, 447, 1, 446, 0, 0, 0
9384, 1, 1636431211580, 1636431212013, 433, 0, 433, 0, 0, 0
9385, 1, 1636431211600, 1636431212036, 436, 0, 436, 0, 0, 0
9386, 1, 1636431211692, 1636431212132, 440, 1, 439, 0, 0, 0
9389, 1, 1636431211860, 1636431212312, 452, 1, 451, 0, 0, 0
9390, 1, 1636431211872, 1636431212312, 440, 1, 439, 0, 1, 1
9388, 1, 1636431211720, 1636431212360, 640, 197, 443, 197, 0, 197
9391, 1, 1636431211920, 1636431212368, 448, 0, 448, 0, 0, 0
9387, 1, 1636431211692, 1636431212469, 777, 321, 456, 321, 0, 321
9392, 1, 1636431211933, 1636431212580, 647, 200, 447, 200, 0, 200
9394, 1, 1636431212204, 1636431212660, 456, 1, 455, 0, 0, 0
9393, 1, 1636431212184, 1636431212801, 617, 177, 440, 177, 0, 177
9396, 1, 1636431212352, 1636431212804, 452, 0, 452, 0, 0, 0
9397, 1, 1636431212389, 1636431212840, 451, 0, 451, 0, 0, 0
9398, 1, 1636431212396, 1636431212844, 448, 0, 448, 0, 0, 0
9395, 1, 1636431212224, 1636431212921, 697, 245, 452, 245, 0, 245
9399, 1, 1636431212664, 1636431213117, 453, 1, 452, 1, 0, 1
9401, 1, 1636431212804, 1636431213252, 448, 1, 447, 0, 0, 0
9402, 1, 1636431212816, 1636431213264, 448, 1, 447, 0, 0, 0
9403, 1, 1636431212928, 1636431213369, 441, 0, 441, 0, 0, 0
9400, 1, 1636431212733, 1636431213369, 636, 188, 448, 188, 0, 188
9404, 1, 1636431212952, 1636431213401, 449, 1, 448, 0, 1, 1
9405, 1, 1636431213004, 1636431213453, 449, 1, 448, 1, 0, 1
9407, 1, 1636431213021, 1636431213464, 443, 0, 443, 0, 0, 0
9408, 1, 1636431213208, 1636431213656, 448, 0, 448, 0, 0, 0
9409, 1, 1636431213252, 1636431213697, 445, 1, 444, 0, 1, 1
9406, 1, 1636431213016, 1636431213700, 684, 237, 447, 237, 0, 237
9411, 1, 1636431213308, 1636431213753, 445, 1, 444, 0, 0, 0
9410, 1, 1636431213292, 1636431213917, 625, 173, 452, 173, 0, 173
9413, 1, 1636431213540, 1636431213992, 452, 1, 451, 0, 0, 0
9414, 1, 1636431213572, 1636431214021, 449, 1, 448, 1, 0, 1
9415, 1, 1636431213680, 1636431214124, 444, 0, 444, 0, 0, 0
9412, 1, 1636431213504, 1636431214157, 653, 197, 456, 197, 0, 197
9416, 1, 1636431213712, 1636431214157, 445, 0, 445, 0, 0, 0
9417, 1, 1636431213764, 1636431214212, 448, 1, 447, 0, 0, 0
9418, 1, 1636431214036, 1636431214492, 456, 1, 455, 0, 1, 1
9419, 1, 1636431214048, 1636431214500, 452, 1, 451, 0, 1, 1
9420, 1, 1636431214140, 1636431214593, 453, 1, 452, 0, 0, 0
9421, 1, 1636431214216, 1636431214665, 449, 1, 448, 0, 0, 0
9422, 1, 1636431214232, 1636431214684, 452, 1, 451, 0, 0, 0
9426, 1, 1636431214401, 1636431214852, 451, 0, 451, 0, 0, 0
9427, 1, 1636431214492, 1636431214937, 445, 1, 444, 1, 0, 1
9428, 1, 1636431214565, 1636431215012, 447, 0, 447, 0, 0, 0
9425, 1, 1636431214392, 1636431215037, 645, 201, 444, 201, 0, 201
9430, 1, 1636431214680, 1636431215132, 452, 1, 451, 1, 0, 1
9429, 1, 1636431214580, 1636431215136, 556, 105, 451, 105, 0, 105
9432, 1, 1636431214865, 1636431215317, 452, 0, 452, 0, 0, 0
9433, 1, 1636431214932, 1636431215376, 444, 1, 443, 1, 0, 1
9431, 1, 1636431214840, 1636431215488, 648, 197, 451, 196, 0, 196
9435, 1, 1636431215052, 1636431215501, 449, 0, 449, 0, 0, 0
9436, 1, 1636431215101, 1636431215548, 447, 0, 447, 0, 0, 0
9437, 1, 1636431215345, 1636431215796, 451, 0, 451, 0, 0, 0
9438, 1, 1636431215413, 1636431215856, 443, 0, 443, 0, 0, 0
9440, 1, 1636431215501, 1636431215941, 440, 0, 440, 0, 0, 0
9441, 1, 1636431215608, 1636431216061, 453, 0, 453, 0, 0, 0
9442, 1, 1636431215688, 1636431216136, 448, 1, 447, 0, 0, 0
9444, 1, 1636431215768, 1636431216209, 441, 1, 440, 0, 1, 1
9445, 1, 1636431215856, 1636431216308, 452, 1, 451, 1, 0, 1
9447, 1, 1636431216005, 1636431216448, 443, 0, 443, 0, 0, 0
9449, 1, 1636431216216, 1636431216664, 448, 1, 447, 0, 0, 0
9450, 1, 1636431216224, 1636431216668, 444, 1, 443, 1, 0, 1
9451, 1, 1636431216396, 1636431216840, 444, 0, 444, 0, 0, 0
9452, 1, 1636431216440, 1636431216880, 440, 0, 440, 0, 0, 0
9453, 1, 1636431216692, 1636431217144, 452, 1, 451, 0, 0, 0
9454, 1, 1636431216732, 1636431217180, 448, 1, 447, 1, 0, 1
9455, 1, 1636431216769, 1636431217224, 455, 0, 455, 0, 0, 0
9456, 1, 1636431216940, 1636431217389, 449, 0, 449, 0, 0, 0
9457, 1, 1636431216988, 1636431217432, 444, 0, 444, 0, 0, 0
9458, 1, 1636431217109, 1636431217557, 448, 0, 448, 0, 0, 0
9459, 1, 1636431217204, 1636431217652, 448, 1, 447, 1, 0, 1
9460, 1, 1636431217284, 1636431217732, 448, 1, 447, 0, 0, 0
9461, 1, 1636431217516, 1636431217965, 449, 1, 448, 0, 0, 0
9462, 1, 1636431217568, 1636431218009, 441, 1, 440, 1, 0, 1
9463, 1, 1636431217729, 1636431218176, 447, 0, 447, 0, 0, 0
9464, 1, 1636431217793, 1636431218233, 440, 0, 440, 0, 0, 0
9465, 1, 1636431217996, 1636431218444, 448, 1, 447, 0, 0, 0
9466, 1, 1636431218132, 1636431218576, 444, 0, 444, 0, 0, 0
9467, 1, 1636431218148, 1636431218593, 445, 0, 445, 0, 0, 0
9468, 1, 1636431218288, 1636431218729, 441, 1, 440, 0, 0, 0
9469, 1, 1636431218373, 1636431218832, 459, 0, 459, 0, 0, 0
9470, 1, 1636431218480, 1636431218929, 449, 0, 449, 0, 0, 0
9471, 1, 1636431218544, 1636431219001, 457, 1, 456, 1, 0, 1
9472, 1, 1636431218660, 1636431219113, 453, 1, 452, 0, 0, 0
9473, 1, 1636431218853, 1636431219293, 440, 0, 440, 0, 0, 0
9474, 1, 1636431218900, 1636431219348, 448, 1, 447, 1, 0, 1
9475, 1, 1636431219081, 1636431219524, 443, 0, 443, 0, 0, 0
9476, 1, 1636431219113, 1636431219572, 459, 0, 459, 0, 0, 0
9477, 1, 1636431219384, 1636431219840, 456, 1, 455, 0, 1, 1
9478, 1, 1636431219404, 1636431219857, 453, 1, 452, 1, 0, 1
9479, 1, 1636431219468, 1636431219913, 445, 0, 445, 0, 0, 0
9480, 1, 1636431219604, 1636431220057, 453, 0, 453, 0, 0, 0
9481, 1, 1636431219664, 1636431220109, 445, 1, 444, 1, 0, 1
9482, 1, 1636431219821, 1636431220261, 440, 0, 440, 0, 0, 0
9483, 1, 1636431219880, 1636431220324, 444, 1, 443, 0, 0, 0
9484, 1, 1636431220053, 1636431220497, 444, 0, 444, 0, 0, 0
9485, 1, 1636431220128, 1636431220577, 449, 1, 448, 0, 1, 1
9486, 1, 1636431220196, 1636431220636, 440, 1, 439, 1, 0, 1
9487, 1, 1636431220421, 1636431220872, 451, 0, 451, 0, 0, 0
9488, 1, 1636431220460, 1636431220916, 456, 0, 456, 0, 0, 0
9489, 1, 1636431220680, 1636431221129, 449, 1, 448, 0, 0, 0
9490, 1, 1636431220709, 1636431221156, 447, 0, 447, 0, 0, 0
9491, 1, 1636431220761, 1636431221209, 448, 0, 448, 0, 0, 0
9492, 1, 1636431220953, 1636431221409, 456, 0, 456, 0, 0, 0
9493, 1, 1636431220976, 1636431221412, 436, 0, 436, 0, 0, 0
9494, 1, 1636431221108, 1636431221548, 440, 1, 439, 0, 0, 0
9495, 1, 1636431221192, 1636431221633, 441, 1, 440, 0, 1, 1
9496, 1, 1636431221340, 1636431221789, 449, 1, 448, 1, 0, 1
9497, 1, 1636431221480, 1636431221933, 453, 0, 453, 0, 0, 0
9498, 1, 1636431221513, 1636431221960, 447, 0, 447, 0, 0, 0
9499, 1, 1636431221729, 1636431222180, 451, 0, 451, 0, 0, 0
9500, 1, 1636431221788, 1636431222245, 457, 1, 456, 0, 0, 0
9501, 1, 1636431221960, 1636431222408, 448, 0, 448, 0, 0, 0
9502, 1, 1636431222004, 1636431222444, 440, 1, 439, 0, 1, 1
9503, 1, 1636431222136, 1636431222576, 440, 1, 439, 1, 0, 1
9504, 1, 1636431222325, 1636431222769, 444, 0, 444, 0, 0, 0
9505, 1, 1636431222356, 1636431222801, 445, 0, 445, 0, 0, 0
9506, 1, 1636431222396, 1636431222852, 456, 13, 443, 13, 0, 13
9508, 1, 1636431222636, 1636431223085, 449, 1, 448, 1, 0, 1
9507, 1, 1636431222524, 1636431223296, 772, 329, 443, 329, 0, 329
9509, 1, 1636431222848, 1636431223296, 448, 1, 447, 0, 0, 0
9510, 1, 1636431222889, 1636431223340, 451, 0, 451, 0, 0, 0
9511, 1, 1636431223096, 1636431223548, 452, 1, 451, 1, 0, 1
9512, 1, 1636431223104, 1636431223552, 448, 1, 447, 1, 0, 1
9513, 1, 1636431223308, 1636431223756, 448, 0, 448, 0, 0, 0
9514, 1, 1636431223396, 1636431223844, 448, 1, 447, 0, 0, 0
9515, 1, 1636431223425, 1636431223873, 448, 0, 448, 0, 0, 0
9516, 1, 1636431223653, 1636431224096, 443, 0, 443, 0, 0, 0
9517, 1, 1636431223680, 1636431224132, 452, 1, 451, 0, 1, 1
9518, 1, 1636431223708, 1636431224152, 444, 0, 444, 0, 0, 0
9519, 1, 1636431223864, 1636431224321, 457, 0, 457, 0, 0, 0
9423, 2, 1636431214328, 1636431224332, 10004, 0, 10004, 809, 0, 809
9520, 1, 1636431223924, 1636431224377, 453, 1, 452, 0, 0, 0
9424, 2, 1636431214336, 1636431224377, 10041, 0, 10041, 801, 0, 801
9521, 1, 1636431224176, 1636431224692, 516, 0, 516, 0, 0, 0
9522, 1, 1636431224201, 1636431224692, 491, 0, 491, 0, 0, 0
9523, 1, 1636431224469, 1636431224917, 448, 0, 448, 0, 0, 0
9524, 1, 1636431224472, 1636431224920, 448, 0, 448, 0, 0, 0
9434, 2, 1636431214988, 1636431224996, 10008, 0, 10008, 149, 0, 149
9525, 1, 1636431224668, 1636431225140, 472, 25, 447, 25, 0, 25
9526, 1, 1636431224704, 1636431225156, 452, 0, 452, 0, 0, 0
9527, 1, 1636431224712, 1636431225164, 452, 1, 451, 1, 0, 1
9439, 2, 1636431215436, 1636431225441, 10005, 0, 10005, 0, 0, 0
9530, 1, 1636431225045, 1636431225496, 451, 1, 450, 0, 1, 1
9529, 1, 1636431225045, 1636431225500, 455, 0, 455, 0, 0, 0
9528, 1, 1636431225045, 1636431225500, 455, 0, 455, 0, 0, 0
9531, 1, 1636431225201, 1636431225664, 463, 0, 463, 0, 0, 0
9532, 1, 1636431225225, 1636431225672, 447, 0, 447, 0, 0, 0
9443, 2, 1636431215704, 1636431225704, 10000, 0, 10000, 0, 0, 0
9446, 2, 1636431215912, 1636431225916, 10004, 0, 10004, 0, 0, 0
9534, 1, 1636431225488, 1636431225936, 448, 1, 447, 0, 1, 1
9533, 1, 1636431225488, 1636431225936, 448, 1, 447, 1, 0, 1
9535, 1, 1636431225488, 1636431225940, 452, 1, 451, 1, 0, 1
9536, 1, 1636431225528, 1636431225968, 440, 1, 439, 1, 0, 1
9537, 1, 1636431225588, 1636431226045, 457, 1, 456, 0, 1, 1
9539, 1, 1636431225748, 1636431226236, 488, 1, 487, 1, 0, 1
9540, 1, 1636431225868, 1636431226320, 452, 1, 451, 1, 0, 1
9448, 1, 1636431216157, 1636431226365, 10208, 9760, 448, 0, 9759, 9759
9538, 1, 1636431225748, 1636431226384, 636, 189, 447, 189, 0, 189
9542, 1, 1636431226052, 1636431226496, 444, 1, 443, 1, 0, 1
9543, 1, 1636431226052, 1636431226504, 452, 1, 451, 1, 0, 1
9544, 1, 1636431226216, 1636431226660, 444, 0, 444, 0, 0, 0
9545, 1, 1636431226268, 1636431226717, 449, 0, 449, 0, 0, 0
9546, 1, 1636431226352, 1636431226800, 448, 1, 447, 0, 0, 0
9541, 1, 1636431226008, 1636431226841, 833, 377, 456, 377, 0, 377
9547, 1, 1636431226428, 1636431226877, 449, 1, 448, 0, 0, 0
9548, 1, 1636431226524, 1636431226977, 453, 0, 453, 0, 0, 0
9549, 1, 1636431226532, 1636431227109, 577, 129, 448, 129, 0, 129
9551, 1, 1636431226660, 1636431227109, 449, 0, 449, 0, 0, 0
9553, 1, 1636431226724, 1636431227176, 452, 1, 451, 0, 0, 0
9554, 1, 1636431226841, 1636431227296, 455, 0, 455, 0, 0, 0
9550, 1, 1636431226584, 1636431227296, 712, 257, 455, 257, 0, 257
9555, 1, 1636431226932, 1636431227380, 448, 1, 447, 1, 0, 1
9557, 1, 1636431227109, 1636431227561, 452, 1, 451, 1, 0, 1
9556, 1, 1636431227024, 1636431227564, 540, 86, 454, 85, 0, 85
9558, 1, 1636431227208, 1636431227648, 440, 1, 439, 1, 0, 1
9560, 1, 1636431227396, 1636431227836, 440, 1, 439, 0, 1, 1
9561, 1, 1636431227408, 1636431227848, 440, 1, 439, 1, 0, 1
9562, 1, 1636431227469, 1636431227916, 447, 0, 447, 0, 0, 0
9563, 1, 1636431227604, 1636431228053, 449, 1, 448, 0, 1, 1
9564, 1, 1636431227612, 1636431228064, 452, 0, 452, 0, 0, 0
9565, 1, 1636431227816, 1636431228264, 448, 1, 447, 1, 0, 1
9566, 1, 1636431227840, 1636431228289, 449, 1, 448, 1, 0, 1
9567, 1, 1636431227860, 1636431228305, 445, 0, 445, 0, 0, 0
9569, 1, 1636431227956, 1636431228417, 461, 1, 460, 0, 0, 0
9570, 1, 1636431228053, 1636431228505, 452, 0, 452, 0, 0, 0
9571, 1, 1636431228132, 1636431228577, 445, 0, 445, 0, 0, 0
9572, 1, 1636431228305, 1636431228756, 451, 0, 451, 0, 0, 0
9573, 1, 1636431228397, 1636431228848, 451, 0, 451, 0, 0, 0
9574, 1, 1636431228485, 1636431228933, 448, 0, 448, 0, 0, 0
9575, 1, 1636431228521, 1636431228968, 447, 0, 447, 0, 0, 0
9576, 1, 1636431228752, 1636431229208, 456, 5, 451, 5, 0, 5
9578, 1, 1636431228789, 1636431229240, 451, 0, 451, 0, 0, 0
9579, 1, 1636431228925, 1636431229376, 451, 0, 451, 0, 0, 0
9580, 1, 1636431228933, 1636431229381, 448, 0, 448, 0, 0, 0
9581, 1, 1636431229152, 1636431229605, 453, 1, 452, 0, 1, 1
9582, 1, 1636431229193, 1636431229640, 447, 0, 447, 0, 0, 0
9583, 1, 1636431229225, 1636431229668, 443, 0, 443, 0, 0, 0
9577, 1, 1636431228776, 1636431229668, 892, 433, 459, 433, 0, 433
9584, 1, 1636431229260, 1636431229708, 448, 0, 448, 0, 0, 0
9585, 1, 1636431229316, 1636431229768, 452, 1, 451, 1, 0, 1
9586, 1, 1636431229424, 1636431229885, 461, 1, 460, 0, 0, 0
9587, 1, 1636431229640, 1636431230089, 449, 0, 449, 0, 0, 0
9588, 1, 1636431229725, 1636431230164, 439, 0, 439, 0, 0, 0
9589, 1, 1636431229752, 1636431230192, 440, 1, 439, 1, 0, 1
9590, 1, 1636431229912, 1636431230356, 444, 1, 443, 0, 1, 1
9591, 1, 1636431230068, 1636431230516, 448, 0, 448, 0, 0, 0
9592, 1, 1636431230112, 1636431230560, 448, 1, 447, 0, 0, 0
9593, 1, 1636431230120, 1636431230560, 440, 1, 439, 0, 0, 0
9594, 1, 1636431230225, 1636431230677, 452, 0, 452, 0, 0, 0
9595, 1, 1636431230261, 1636431230709, 448, 0, 448, 0, 0, 0
9597, 1, 1636431230500, 1636431230941, 441, 0, 441, 0, 0, 0
9596, 1, 1636431230492, 1636431230941, 449, 0, 449, 0, 0, 0
9598, 1, 1636431230516, 1636431230969, 453, 0, 453, 0, 0, 0
9599, 1, 1636431230649, 1636431231092, 443, 0, 443, 0, 0, 0
9600, 1, 1636431230700, 1636431231140, 440, 1, 439, 1, 0, 1
9601, 1, 1636431230744, 1636431231192, 448, 1, 447, 0, 0, 0
9602, 1, 1636431230997, 1636431231449, 452, 0, 452, 0, 0, 0
9603, 1, 1636431231005, 1636431231449, 444, 0, 444, 0, 0, 0
9604, 1, 1636431231064, 1636431231508, 444, 0, 444, 0, 0, 0
9605, 1, 1636431231317, 1636431231764, 447, 0, 447, 0, 0, 0
9606, 1, 1636431231452, 1636431231896, 444, 0, 444, 0, 0, 0
9607, 1, 1636431231472, 1636431231916, 444, 1, 443, 0, 0, 0
9608, 1, 1636431231480, 1636431231928, 448, 1, 447, 0, 0, 0
9609, 1, 1636431231500, 1636431231944, 444, 0, 444, 0, 0, 0
9610, 1, 1636431231556, 1636431231992, 436, 0, 436, 0, 0, 0
9611, 1, 1636431231796, 1636431232244, 448, 0, 448, 0, 0, 0
9612, 1, 1636431231820, 1636431232261, 441, 1, 440, 0, 0, 0
9614, 1, 1636431231988, 1636431232437, 449, 0, 449, 0, 0, 0
9613, 1, 1636431231856, 1636431232445, 589, 137, 452, 137, 0, 137
9615, 1, 1636431232072, 1636431232525, 453, 1, 452, 0, 1, 1
9616, 1, 1636431232101, 1636431232553, 452, 0, 452, 0, 0, 0
9619, 1, 1636431232433, 1636431232880, 447, 0, 447, 0, 0, 0
9617, 1, 1636431232361, 1636431232901, 540, 84, 456, 84, 0, 84
9618, 1, 1636431232388, 1636431233012, 624, 165, 459, 165, 0, 165
9620, 1, 1636431232661, 1636431233129, 468, 0, 468, 0, 0, 0
9621, 1, 1636431232808, 1636431233260, 452, 1, 451, 1, 0, 1
9622, 1, 1636431232824, 1636431233264, 440, 1, 439, 1, 0, 1
9625, 1, 1636431232908, 1636431233352, 444, 1, 443, 1, 0, 1
9623, 1, 1636431232844, 1636431233360, 516, 57, 459, 57, 0, 57
9624, 1, 1636431232908, 1636431233360, 452, 1, 451, 0, 0, 0
9626, 1, 1636431233068, 1636431233517, 449, 1, 448, 0, 0, 0
9627, 1, 1636431233216, 1636431233669, 453, 1, 452, 0, 0, 0
9628, 1, 1636431233228, 1636431233676, 448, 1, 447, 0, 0, 0
9629, 1, 1636431233280, 1636431233720, 440, 0, 440, 0, 0, 0
9630, 1, 1636431233364, 1636431233812, 448, 0, 448, 0, 0, 0
9631, 1, 1636431233408, 1636431233849, 441, 0, 441, 0, 0, 0
9632, 1, 1636431233737, 1636431234184, 447, 0, 447, 0, 0, 0
9633, 1, 1636431233745, 1636431234188, 443, 0, 443, 0, 0, 0
9634, 1, 1636431233757, 1636431234208, 451, 0, 451, 0, 0, 0
9635, 1, 1636431234065, 1636431234520, 455, 0, 455, 0, 0, 0
9636, 1, 1636431234144, 1636431234593, 449, 0, 449, 0, 0, 0
9637, 1, 1636431234152, 1636431234596, 444, 0, 444, 0, 0, 0
9638, 1, 1636431234188, 1636431234636, 448, 0, 448, 0, 0, 0
9639, 1, 1636431234228, 1636431234676, 448, 1, 447, 0, 1, 1
9640, 1, 1636431234301, 1636431234748, 447, 0, 447, 0, 0, 0
9641, 1, 1636431234461, 1636431234917, 456, 0, 456, 0, 0, 0
9642, 1, 1636431234512, 1636431234961, 449, 0, 449, 0, 0, 0
9643, 1, 1636431234564, 1636431235008, 444, 1, 443, 0, 1, 1
9644, 1, 1636431234576, 1636431235020, 444, 1, 443, 0, 0, 0
9645, 1, 1636431234648, 1636431235101, 453, 1, 452, 1, 0, 1
9646, 1, 1636431234704, 1636431235153, 449, 1, 448, 1, 0, 1
9647, 1, 1636431235064, 1636431235516, 452, 0, 452, 0, 0, 0
9648, 1, 1636431235085, 1636431235529, 444, 0, 444, 0, 0, 0
9649, 1, 1636431235116, 1636431235564, 448, 1, 447, 0, 0, 0
9650, 1, 1636431235373, 1636431235821, 448, 0, 448, 0, 0, 0
9651, 1, 1636431235453, 1636431235904, 451, 0, 451, 0, 0, 0
9652, 1, 1636431235505, 1636431235948, 443, 0, 443, 0, 0, 0
9653, 1, 1636431235541, 1636431235988, 447, 0, 447, 0, 0, 0
9654, 1, 1636431235552, 1636431236000, 448, 1, 447, 0, 0, 0
9656, 1, 1636431235789, 1636431236237, 448, 0, 448, 0, 0, 0
9657, 1, 1636431235840, 1636431236281, 441, 1, 440, 0, 0, 0
9658, 1, 1636431235844, 1636431236296, 452, 1, 451, 0, 0, 0
9655, 1, 1636431235640, 1636431236352, 712, 265, 447, 265, 0, 265
9659, 1, 1636431235924, 1636431236376, 452, 1, 451, 0, 0, 0
9660, 1, 1636431235972, 1636431236416, 444, 1, 443, 1, 0, 1
9661, 1, 1636431235976, 1636431236416, 440, 0, 440, 0, 0, 0
9552, 2, 1636431226708, 1636431236713, 10005, 0, 10005, 856, 0, 856
9662, 1, 1636431236328, 1636431236776, 448, 1, 447, 0, 0, 0
9663, 1, 1636431236380, 1636431236824, 444, 0, 444, 0, 0, 0
9664, 1, 1636431236420, 1636431236868, 448, 0, 448, 0, 0, 0
9666, 1, 1636431236801, 1636431237248, 447, 0, 447, 0, 0, 0
9559, 2, 1636431227264, 1636431237269, 10005, 0, 10005, 300, 0, 300
9665, 1, 1636431236760, 1636431237280, 520, 65, 455, 65, 0, 65
9667, 1, 1636431236848, 1636431237301, 453, 0, 453, 0, 0, 0
9668, 1, 1636431236861, 1636431237313, 452, 0, 452, 0, 0, 0
9669, 1, 1636431236904, 1636431237348, 444, 1, 443, 0, 0, 0
9670, 1, 1636431236969, 1636431237416, 447, 0, 447, 0, 0, 0
9671, 1, 1636431237108, 1636431237588, 480, 0, 480, 0, 0, 0
9672, 1, 1636431237164, 1636431237609, 445, 1, 444, 0, 1, 1
9674, 1, 1636431237240, 1636431237688, 448, 1, 447, 1, 0, 1
9568, 1, 1636431227912, 1636431237712, 9800, 9357, 443, 1, 9356, 9357
9673, 1, 1636431237192, 1636431237724, 532, 89, 443, 89, 0, 89
9675, 1, 1636431237320, 1636431237760, 440, 1, 439, 0, 0, 0
9676, 1, 1636431237401, 1636431237844, 443, 0, 443, 0, 0, 0
9677, 1, 1636431237609, 1636431238068, 459, 0, 459, 0, 0, 0
9678, 1, 1636431237669, 1636431238108, 439, 0, 439, 0, 0, 0
9679, 1, 1636431237773, 1636431238221, 448, 0, 448, 0, 0, 0
9681, 1, 1636431237873, 1636431238320, 447, 0, 447, 0, 0, 0
9683, 1, 1636431238097, 1636431238540, 443, 0, 443, 0, 0, 0
9685, 1, 1636431238104, 1636431238548, 444, 1, 443, 0, 0, 0
9684, 1, 1636431238104, 1636431238552, 448, 1, 447, 0, 0, 0
9686, 1, 1636431238149, 1636431238584, 435, 0, 435, 0, 0, 0
9687, 1, 1636431238192, 1636431238636, 444, 1, 443, 0, 0, 0
9682, 1, 1636431237928, 1636431238760, 832, 393, 439, 393, 0, 393
9689, 1, 1636431238433, 1636431238884, 451, 0, 451, 0, 0, 0
9690, 1, 1636431238480, 1636431238932, 452, 1, 451, 1, 0, 1
9691, 1, 1636431238496, 1636431238940, 444, 0, 444, 0, 0, 0
9692, 1, 1636431238572, 1636431239040, 468, 13, 455, 13, 0, 13
9693, 1, 1636431238617, 1636431239060, 443, 0, 443, 0, 0, 0
9694, 1, 1636431238760, 1636431239205, 445, 0, 445, 0, 0, 0
9680, 1, 1636431237873, 1636431239205, 1332, 888, 444, 888, 0, 888
9695, 1, 1636431238981, 1636431239424, 443, 0, 443, 0, 0, 0
9696, 1, 1636431238997, 1636431239448, 451, 0, 451, 0, 0, 0
9688, 1, 1636431238364, 1636431239476, 1112, 677, 435, 677, 0, 677
9697, 1, 1636431239060, 1636431239508, 448, 1, 447, 0, 0, 0
9698, 1, 1636431239136, 1636431239581, 445, 1, 444, 0, 0, 0
9700, 1, 1636431239428, 1636431239868, 440, 0, 440, 0, 0, 0
9702, 1, 1636431239448, 1636431239888, 440, 1, 439, 0, 1, 1
9701, 1, 1636431239397, 1636431239921, 524, 80, 444, 79, 1, 80
9703, 1, 1636431239472, 1636431239921, 449, 0, 449, 0, 0, 0
9704, 1, 1636431239500, 1636431239944, 444, 0, 444, 0, 0, 0
9699, 1, 1636431239193, 1636431239956, 763, 316, 447, 316, 0, 316
9706, 1, 1636431239736, 1636431240185, 449, 1, 448, 1, 0, 1
9707, 1, 1636431239760, 1636431240208, 448, 0, 448, 0, 0, 0
9708, 1, 1636431239800, 1636431240240, 440, 1, 439, 0, 0, 0
9710, 1, 1636431239904, 1636431240348, 444, 0, 444, 0, 0, 0
9709, 1, 1636431239876, 1636431240377, 501, 45, 456, 45, 0, 45
9705, 1, 1636431239524, 1636431240384, 860, 421, 439, 421, 0, 421
9712, 1, 1636431240164, 1636431240609, 445, 0, 445, 0, 0, 0
9711, 1, 1636431239964, 1636431240692, 728, 277, 451, 277, 0, 277
9713, 1, 1636431240269, 1636431240725, 456, 0, 456, 0, 0, 0
9714, 1, 1636431240273, 1636431240820, 547, 104, 443, 104, 0, 104
9716, 1, 1636431240424, 1636431240876, 452, 1, 451, 0, 0, 0
9718, 1, 1636431240656, 1636431241108, 452, 0, 452, 0, 0, 0
9719, 1, 1636431240696, 1636431241140, 444, 1, 443, 0, 1, 1
9722, 1, 1636431240792, 1636431241245, 453, 1, 452, 1, 0, 1
9717, 1, 1636431240545, 1636431241280, 735, 276, 459, 276, 0, 276
9723, 1, 1636431240864, 1636431241313, 449, 1, 448, 0, 1, 1
9724, 1, 1636431241037, 1636431241484, 447, 0, 447, 0, 0, 0
9725, 1, 1636431241092, 1636431241536, 444, 0, 444, 0, 0, 0
9726, 1, 1636431241104, 1636431241548, 444, 0, 444, 0, 0, 0
9721, 1, 1636431240789, 1636431241588, 799, 352, 447, 352, 0, 352
9727, 1, 1636431241228, 1636431241680, 452, 1, 451, 1, 0, 1
9728, 1, 1636431241236, 1636431241680, 444, 1, 443, 0, 1, 1
9729, 1, 1636431241292, 1636431241724, 432, 1, 431, 1, 0, 1
9715, 1, 1636431240428, 1636431241724, 1296, 853, 443, 853, 0, 853
9730, 1, 1636431241488, 1636431241944, 456, 1, 455, 1, 0, 1
9731, 1, 1636431241565, 1636431242036, 471, 24, 447, 24, 0, 24
9732, 1, 1636431241620, 1636431242065, 445, 1, 444, 1, 0, 1
9733, 1, 1636431241748, 1636431242201, 453, 1, 452, 0, 0, 0
9734, 1, 1636431241893, 1636431242340, 447, 0, 447, 0, 0, 0
9735, 1, 1636431241936, 1636431242376, 440, 1, 439, 0, 1, 1
9720, 1, 1636431240724, 1636431242492, 1768, 1313, 455, 1312, 0, 1312
9738, 1, 1636431242096, 1636431242548, 452, 1, 451, 1, 0, 1
9739, 1, 1636431242148, 1636431242596, 448, 1, 447, 1, 0, 1
9740, 1, 1636431242180, 1636431242641, 461, 21, 440, 21, 0, 21
9741, 1, 1636431242365, 1636431242816, 451, 0, 451, 0, 0, 0
9737, 1, 1636431242044, 1636431242820, 776, 333, 443, 333, 0, 333
9742, 1, 1636431242460, 1636431242909, 449, 1, 448, 0, 0, 0
9743, 1, 1636431242476, 1636431242924, 448, 0, 448, 0, 0, 0
9744, 1, 1636431242564, 1636431243001, 437, 0, 437, 0, 0, 0
9746, 1, 1636431242604, 1636431243052, 448, 1, 447, 1, 0, 1
9745, 1, 1636431242604, 1636431243057, 453, 1, 452, 1, 0, 1
9736, 1, 1636431242040, 1636431243088, 1048, 601, 447, 601, 0, 601
9747, 1, 1636431242720, 1636431243165, 445, 1, 444, 0, 1, 1
9750, 1, 1636431242993, 1636431243445, 452, 0, 452, 0, 0, 0
9749, 1, 1636431242960, 1636431243528, 568, 129, 439, 129, 0, 129
9751, 1, 1636431243105, 1636431243552, 447, 0, 447, 0, 0, 0
9752, 1, 1636431243165, 1636431243608, 443, 0, 443, 0, 0, 0
9748, 1, 1636431242880, 1636431243608, 728, 285, 443, 285, 0, 285
9753, 1, 1636431243212, 1636431243652, 440, 0, 440, 0, 0, 0
9755, 1, 1636431243364, 1636431243813, 449, 1, 448, 1, 0, 1
9756, 1, 1636431243368, 1636431243816, 448, 1, 447, 1, 0, 1
9757, 1, 1636431243508, 1636431243956, 448, 1, 447, 0, 1, 1
9758, 1, 1636431243552, 1636431243997, 445, 1, 444, 0, 1, 1
9754, 1, 1636431243348, 1636431244053, 705, 261, 444, 261, 0, 261
9759, 1, 1636431243753, 1636431244200, 447, 0, 447, 0, 0, 0
9760, 1, 1636431243784, 1636431244220, 436, 0, 436, 0, 0, 0
9761, 1, 1636431243836, 1636431244284, 448, 1, 447, 1, 0, 1
9762, 1, 1636431243856, 1636431244313, 457, 1, 456, 0, 1, 1
9763, 1, 1636431243864, 1636431244316, 452, 0, 452, 0, 0, 0
9764, 1, 1636431243996, 1636431244445, 449, 1, 448, 0, 0, 0
9765, 1, 1636431244020, 1636431244468, 448, 1, 447, 1, 0, 1
9766, 1, 1636431244240, 1636431244688, 448, 1, 447, 1, 0, 1
9768, 1, 1636431244316, 1636431244773, 457, 1, 456, 0, 0, 0
9769, 1, 1636431244420, 1636431244864, 444, 1, 443, 0, 0, 0
9770, 1, 1636431244452, 1636431244896, 444, 1, 443, 0, 0, 0
9767, 1, 1636431244252, 1636431244916, 664, 217, 447, 216, 0, 216
9771, 1, 1636431244500, 1636431244952, 452, 1, 451, 0, 0, 0
9772, 1, 1636431244665, 1636431245112, 447, 0, 447, 0, 0, 0
9774, 1, 1636431244696, 1636431245140, 444, 0, 444, 0, 0, 0
9775, 1, 1636431244820, 1636431245268, 448, 0, 448, 0, 0, 0
9776, 1, 1636431244861, 1636431245308, 447, 0, 447, 0, 0, 0
9773, 1, 1636431244676, 1636431245344, 668, 221, 447, 221, 0, 221
9777, 1, 1636431245104, 1636431245548, 444, 1, 443, 0, 1, 1
9778, 1, 1636431245104, 1636431245552, 448, 0, 448, 0, 0, 0
9779, 1, 1636431245132, 1636431245576, 444, 0, 444, 0, 0, 0
9780, 1, 1636431245164, 1636431245612, 448, 0, 448, 0, 0, 0
9781, 1, 1636431245260, 1636431245704, 444, 1, 443, 1, 0, 1
9782, 1, 1636431245365, 1636431245817, 452, 0, 452, 0, 0, 0
9783, 1, 1636431245380, 1636431245820, 440, 1, 439, 0, 0, 0
9784, 1, 1636431245568, 1636431246016, 448, 0, 448, 0, 0, 0
9786, 1, 1636431245664, 1636431246112, 448, 1, 447, 0, 0, 0
9787, 1, 1636431245776, 1636431246229, 453, 1, 452, 0, 0, 0
9788, 1, 1636431245796, 1636431246240, 444, 1, 443, 1, 0, 1
9785, 1, 1636431245612, 1636431246261, 649, 209, 440, 208, 1, 209
9789, 1, 1636431245848, 1636431246292, 444, 1, 443, 1, 0, 1
9790, 1, 1636431246028, 1636431246480, 452, 1, 451, 0, 0, 0
9792, 1, 1636431246052, 1636431246504, 452, 0, 452, 0, 0, 0
9793, 1, 1636431246208, 1636431246648, 440, 0, 440, 0, 0, 0
9794, 1, 1636431246252, 1636431246692, 440, 0, 440, 0, 0, 0
9791, 1, 1636431246028, 1636431246744, 716, 265, 451, 265, 0, 265
9795, 1, 1636431246384, 1636431246832, 448, 1, 447, 0, 0, 0
9796, 1, 1636431246401, 1636431246841, 440, 0, 440, 0, 0, 0
9797, 1, 1636431246504, 1636431246936, 432, 0, 432, 0, 0, 0
9798, 1, 1636431246536, 1636431246980, 444, 1, 443, 1, 0, 1
9799, 1, 1636431246604, 1636431247045, 441, 1, 440, 1, 0, 1
9800, 1, 1636431246672, 1636431247120, 448, 1, 447, 0, 0, 0
9801, 1, 1636431246708, 1636431247157, 449, 1, 448, 1, 0, 1
9802, 1, 1636431246900, 1636431247352, 452, 1, 451, 0, 0, 0
9804, 1, 1636431247064, 1636431247516, 452, 0, 452, 0, 0, 0
9805, 1, 1636431247104, 1636431247557, 453, 0, 453, 0, 0, 0
9803, 1, 1636431246908, 1636431247572, 664, 212, 452, 212, 0, 212
9806, 1, 1636431247120, 1636431247576, 456, 0, 456, 0, 0, 0
9807, 1, 1636431247160, 1636431247613, 453, 0, 453, 0, 0, 0
9809, 1, 1636431247352, 1636431247800, 448, 1, 447, 0, 1, 1
9810, 1, 1636431247416, 1636431247868, 452, 0, 452, 0, 0, 0
9808, 1, 1636431247324, 1636431248024, 700, 253, 447, 253, 0, 253
9811, 1, 1636431247604, 1636431248048, 444, 1, 443, 0, 1, 1
9812, 1, 1636431247616, 1636431248064, 448, 0, 448, 0, 0, 0
9813, 1, 1636431247740, 1636431248184, 444, 1, 443, 1, 0, 1
9814, 1, 1636431247748, 1636431248196, 448, 1, 447, 1, 0, 1
9815, 1, 1636431247820, 1636431248273, 453, 1, 452, 0, 0, 0
9816, 1, 1636431247884, 1636431248324, 440, 1, 439, 0, 0, 0
9817, 1, 1636431247892, 1636431248336, 444, 1, 443, 0, 1, 1
9818, 1, 1636431248052, 1636431248493, 441, 0, 441, 0, 0, 0
9819, 1, 1636431248092, 1636431248540, 448, 1, 447, 0, 1, 1
9821, 1, 1636431248300, 1636431248744, 444, 1, 443, 1, 0, 1
9822, 1, 1636431248360, 1636431248804, 444, 1, 443, 1, 0, 1
9823, 1, 1636431248404, 1636431248848, 444, 1, 443, 0, 0, 0
9820, 1, 1636431248273, 1636431248936, 663, 220, 443, 220, 0, 220
9824, 1, 1636431248492, 1636431248940, 448, 1, 447, 0, 0, 0
9826, 1, 1636431248628, 1636431249076, 448, 1, 447, 0, 0, 0
9828, 1, 1636431248800, 1636431249249, 449, 0, 449, 0, 0, 0
9827, 1, 1636431248628, 1636431249296, 668, 221, 447, 220, 0, 220
9829, 1, 1636431248904, 1636431249344, 440, 0, 440, 0, 0, 0
9825, 1, 1636431248496, 1636431249388, 892, 445, 447, 445, 0, 445
9830, 1, 1636431248940, 1636431249388, 448, 1, 447, 1, 0, 1
9831, 1, 1636431249040, 1636431249492, 452, 0, 452, 0, 0, 0
9832, 1, 1636431249112, 1636431249565, 453, 0, 453, 0, 0, 0
9833, 1, 1636431249180, 1636431249636, 456, 1, 455, 0, 0, 0
9834, 1, 1636431249248, 1636431249696, 448, 1, 447, 0, 0, 0
9835, 1, 1636431249288, 1636431249732, 444, 1, 443, 0, 0, 0
9836, 1, 1636431249368, 1636431249820, 452, 1, 451, 0, 1, 1
9837, 1, 1636431249400, 1636431249853, 453, 1, 452, 0, 0, 0
9839, 1, 1636431249673, 1636431250117, 444, 0, 444, 0, 0, 0
9840, 1, 1636431249720, 1636431250169, 449, 1, 448, 1, 0, 1
9841, 1, 1636431249784, 1636431250236, 452, 1, 451, 0, 0, 0
9842, 1, 1636431249853, 1636431250304, 451, 0, 451, 0, 0, 0
9838, 1, 1636431249628, 1636431250304, 676, 225, 451, 225, 0, 225
9843, 1, 1636431249876, 1636431250324, 448, 0, 448, 0, 0, 0
9845, 1, 1636431249988, 1636431250429, 441, 1, 440, 0, 0, 0
9846, 1, 1636431250196, 1636431250636, 440, 1, 439, 0, 1, 1
9847, 1, 1636431250204, 1636431250653, 449, 1, 448, 1, 0, 1
9844, 1, 1636431249969, 1636431250684, 715, 268, 447, 268, 0, 268
9848, 1, 1636431250300, 1636431250740, 440, 1, 439, 0, 0, 0
9849, 1, 1636431250344, 1636431250797, 453, 1, 452, 1, 0, 1
9850, 1, 1636431250444, 1636431250888, 444, 1, 443, 1, 0, 1
9851, 1, 1636431250460, 1636431250908, 448, 1, 447, 0, 0, 0
9852, 1, 1636431250596, 1636431251040, 444, 0, 444, 0, 0, 0
9854, 1, 1636431250680, 1636431251128, 448, 0, 448, 0, 0, 0
9855, 1, 1636431250724, 1636431251180, 456, 0, 456, 0, 0, 0
9853, 1, 1636431250620, 1636431251340, 720, 269, 451, 269, 0, 269
9857, 1, 1636431250992, 1636431251436, 444, 1, 443, 0, 0, 0
9856, 1, 1636431250952, 1636431251576, 624, 177, 447, 177, 0, 177
9859, 1, 1636431251128, 1636431251576, 448, 0, 448, 0, 0, 0
9860, 1, 1636431251145, 1636431251588, 443, 0, 443, 0, 0, 0
9858, 1, 1636431251025, 1636431251624, 599, 156, 443, 156, 0, 156
9861, 1, 1636431251188, 1636431251632, 444, 0, 444, 0, 0, 0
9862, 1, 1636431251292, 1636431251745, 453, 1, 452, 1, 0, 1
9864, 1, 1636431251512, 1636431251968, 456, 1, 455, 0, 0, 0
9865, 1, 1636431251532, 1636431251980, 448, 1, 447, 0, 1, 1
9863, 1, 1636431251316, 1636431252040, 724, 273, 451, 272, 0, 272
9866, 1, 1636431251596, 1636431252041, 445, 0, 445, 0, 0, 0
9867, 1, 1636431251728, 1636431252176, 448, 1, 447, 0, 1, 1
9868, 1, 1636431251760, 1636431252212, 452, 1, 451, 0, 0, 0
9869, 1, 1636431251820, 1636431252260, 440, 1, 439, 1, 0, 1
9870, 1, 1636431251937, 1636431252380, 443, 0, 443, 0, 0, 0
9871, 1, 1636431251989, 1636431252432, 443, 0, 443, 0, 0, 0
9872, 1, 1636431252021, 1636431252472, 451, 0, 451, 0, 0, 0
9873, 1, 1636431252096, 1636431252620, 524, 81, 443, 81, 0, 81
9874, 1, 1636431252289, 1636431252736, 447, 0, 447, 0, 0, 0
9876, 1, 1636431252348, 1636431252792, 444, 1, 443, 0, 1, 1
9877, 1, 1636431252424, 1636431252865, 441, 1, 440, 0, 0, 0
9878, 1, 1636431252476, 1636431252920, 444, 0, 444, 0, 0, 0
9875, 1, 1636431252316, 1636431252924, 608, 157, 451, 156, 0, 156
9879, 1, 1636431252509, 1636431252956, 447, 0, 447, 0, 0, 0
9880, 1, 1636431252568, 1636431253012, 444, 0, 444, 0, 0, 0
9882, 1, 1636431252920, 1636431253368, 448, 1, 447, 0, 1, 1
9883, 1, 1636431252928, 1636431253372, 444, 1, 443, 0, 0, 0
9881, 1, 1636431252656, 1636431253404, 748, 301, 447, 301, 0, 301
9884, 1, 1636431253088, 1636431253540, 452, 0, 452, 0, 0, 0
9885, 1, 1636431253121, 1636431253561, 440, 0, 440, 0, 0, 0
9886, 1, 1636431253136, 1636431253584, 448, 0, 448, 0, 0, 0
9887, 1, 1636431253312, 1636431253764, 452, 0, 452, 0, 0, 0
9888, 1, 1636431253360, 1636431253808, 448, 0, 448, 0, 0, 0
9889, 1, 1636431253397, 1636431253844, 447, 0, 447, 0, 0, 0
9890, 1, 1636431253452, 1636431253896, 444, 1, 443, 1, 0, 1
9891, 1, 1636431253576, 1636431254017, 441, 1, 440, 0, 0, 0
9893, 1, 1636431253737, 1636431254176, 439, 0, 439, 0, 0, 0
9894, 1, 1636431253752, 1636431254193, 441, 0, 441, 0, 0, 0
9895, 1, 1636431253832, 1636431254268, 436, 1, 435, 1, 0, 1
9892, 1, 1636431253657, 1636431254284, 627, 188, 439, 188, 0, 188
9896, 1, 1636431253860, 1636431254308, 448, 0, 448, 0, 0, 0
9897, 1, 1636431253888, 1636431254337, 449, 1, 448, 1, 0, 1
9899, 1, 1636431254213, 1636431254668, 455, 0, 455, 0, 0, 0
9900, 1, 1636431254280, 1636431254728, 448, 1, 447, 0, 1, 1
9898, 1, 1636431254013, 1636431254785, 772, 324, 448, 324, 0, 324
9901, 1, 1636431254356, 1636431254809, 453, 1, 452, 1, 0, 1
9902, 1, 1636431254452, 1636431254900, 448, 1, 447, 0, 0, 0
9903, 1, 1636431254528, 1636431254977, 449, 1, 448, 0, 1, 1
9904, 1, 1636431254596, 1636431255044, 448, 1, 447, 1, 0, 1
9906, 1, 1636431254724, 1636431255172, 448, 1, 447, 1, 0, 1
9907, 1, 1636431254768, 1636431255208, 440, 0, 440, 0, 0, 0
9905, 1, 1636431254716, 1636431255256, 540, 93, 447, 93, 0, 93
9910, 1, 1636431255096, 1636431255552, 456, 1, 455, 1, 0, 1
9911, 1, 1636431255212, 1636431255665, 453, 1, 452, 1, 0, 1
9912, 1, 1636431255228, 1636431255684, 456, 1, 455, 0, 0, 0
9913, 1, 1636431255264, 1636431255701, 437, 0, 437, 0, 0, 0
9916, 1, 1636431255652, 1636431256100, 448, 1, 447, 1, 0, 1
9917, 1, 1636431255668, 1636431256116, 448, 1, 447, 0, 0, 0
9914, 1, 1636431255365, 1636431256148, 783, 336, 447, 336, 0, 336
9918, 1, 1636431255769, 1636431256212, 443, 0, 443, 0, 0, 0
9919, 1, 1636431255788, 1636431256232, 444, 1, 443, 1, 0, 1
9920, 1, 1636431255884, 1636431256328, 444, 0, 444, 0, 0, 0
9922, 1, 1636431256056, 1636431256500, 444, 1, 443, 1, 0, 1
9921, 1, 1636431256056, 1636431256508, 452, 1, 451, 0, 1, 1
9923, 1, 1636431256056, 1636431256508, 452, 0, 452, 0, 0, 0
9924, 1, 1636431256448, 1636431256897, 449, 0, 449, 0, 0, 0
9925, 1, 1636431256552, 1636431257001, 449, 0, 449, 0, 0, 0
9926, 1, 1636431256576, 1636431257033, 457, 0, 457, 0, 0, 0
9927, 1, 1636431256660, 1636431257108, 448, 0, 448, 0, 0, 0
9929, 1, 1636431256965, 1636431257412, 447, 0, 447, 0, 0, 0
9930, 1, 1636431256992, 1636431257436, 444, 0, 444, 0, 0, 0
9931, 1, 1636431257096, 1636431257545, 449, 1, 448, 0, 0, 0
9928, 1, 1636431256700, 1636431257548, 848, 409, 439, 409, 0, 409
9932, 1, 1636431257120, 1636431257573, 453, 1, 452, 0, 0, 0
9933, 1, 1636431257152, 1636431257596, 444, 0, 444, 0, 0, 0
9934, 1, 1636431257324, 1636431257777, 453, 1, 452, 0, 1, 1
9935, 1, 1636431257352, 1636431257801, 449, 1, 448, 0, 0, 0
9936, 1, 1636431257448, 1636431257897, 449, 1, 448, 0, 0, 0
9937, 1, 1636431257761, 1636431258213, 452, 0, 452, 0, 0, 0
9938, 1, 1636431257829, 1636431258273, 444, 0, 444, 0, 0, 0
9939, 1, 1636431257972, 1636431258424, 452, 1, 451, 1, 0, 1
9940, 1, 1636431258004, 1636431258456, 452, 1, 451, 0, 0, 0
9942, 1, 1636431258296, 1636431258745, 449, 1, 448, 1, 0, 1
9943, 1, 1636431258356, 1636431258805, 449, 1, 448, 1, 0, 1
9944, 1, 1636431258372, 1636431258821, 449, 1, 448, 0, 0, 0
9945, 1, 1636431258397, 1636431258832, 435, 0, 435, 0, 0, 0
9941, 1, 1636431258060, 1636431258896, 836, 397, 439, 397, 0, 397
9946, 1, 1636431258500, 1636431258940, 440, 1, 439, 0, 0, 0
9947, 1, 1636431258625, 1636431259069, 444, 0, 444, 0, 0, 0
9948, 1, 1636431258672, 1636431259116, 444, 1, 443, 1, 0, 1
9949, 1, 1636431258788, 1636431259276, 488, 45, 443, 45, 0, 45
9950, 1, 1636431259097, 1636431259540, 443, 0, 443, 0, 0, 0
9951, 1, 1636431259152, 1636431259609, 457, 0, 457, 0, 0, 0
9952, 1, 1636431259276, 1636431259724, 448, 1, 447, 0, 0, 0
9953, 1, 1636431259360, 1636431259808, 448, 0, 448, 0, 0, 0
9955, 1, 1636431259584, 1636431260044, 460, 1, 459, 0, 1, 1
9956, 1, 1636431259640, 1636431260077, 437, 1, 436, 1, 0, 1
9957, 1, 1636431259684, 1636431260120, 436, 0, 436, 0, 0, 0
9958, 1, 1636431259696, 1636431260140, 444, 1, 443, 0, 0, 0
9954, 1, 1636431259404, 1636431260256, 852, 405, 447, 405, 0, 405
9960, 1, 1636431259941, 1636431260385, 444, 0, 444, 0, 0, 0
9962, 1, 1636431260076, 1636431260524, 448, 1, 447, 0, 0, 0
9959, 1, 1636431259768, 1636431260593, 825, 373, 452, 373, 0, 373
9961, 1, 1636431259969, 1636431260840, 871, 416, 455, 416, 0, 416
9963, 1, 1636431260444, 1636431260897, 453, 0, 453, 0, 0, 0
9964, 1, 1636431260500, 1636431261036, 536, 93, 443, 93, 0, 93
9965, 1, 1636431260681, 1636431261128, 447, 0, 447, 0, 0, 0
9966, 1, 1636431260728, 1636431261168, 440, 1, 439, 0, 0, 0
9968, 1, 1636431260861, 1636431261308, 447, 0, 447, 0, 0, 0
9969, 1, 1636431260908, 1636431261352, 444, 0, 444, 0, 0, 0
9970, 1, 1636431260981, 1636431261429, 448, 0, 448, 0, 0, 0
9971, 1, 1636431261032, 1636431261476, 444, 1, 443, 0, 0, 0
9972, 1, 1636431261072, 1636431261517, 445, 1, 444, 1, 0, 1
9967, 1, 1636431260740, 1636431261604, 864, 428, 436, 428, 0, 428
9974, 1, 1636431261288, 1636431261732, 444, 1, 443, 0, 0, 0
9973, 1, 1636431261288, 1636431261740, 452, 1, 451, 0, 0, 0
9975, 1, 1636431261417, 1636431261869, 452, 0, 452, 0, 0, 0
9976, 1, 1636431261801, 1636431262252, 451, 0, 451, 0, 0, 0
9977, 1, 1636431261829, 1636431262276, 447, 0, 447, 0, 0, 0
9978, 1, 1636431262008, 1636431262452, 444, 0, 444, 0, 0, 0
9979, 1, 1636431262052, 1636431262496, 444, 0, 444, 0, 0, 0
9981, 1, 1636431262212, 1636431262648, 436, 0, 436, 0, 0, 0
9982, 1, 1636431262221, 1636431262664, 443, 0, 443, 0, 0, 0
9983, 1, 1636431262332, 1636431262781, 449, 1, 448, 0, 1, 1
9984, 1, 1636431262353, 1636431262796, 443, 0, 443, 0, 0, 0
9985, 1, 1636431262420, 1636431262873, 453, 0, 453, 0, 0, 0
9980, 1, 1636431262072, 1636431262941, 869, 425, 444, 424, 0, 424
9986, 1, 1636431262580, 1636431263033, 453, 1, 452, 0, 0, 0
9987, 1, 1636431262613, 1636431263064, 451, 0, 451, 0, 0, 0
9989, 1, 1636431263121, 1636431263569, 448, 0, 448, 0, 0, 0
9990, 1, 1636431263188, 1636431263633, 445, 0, 445, 0, 0, 0
9991, 1, 1636431263316, 1636431263768, 452, 0, 452, 0, 0, 0
9992, 1, 1636431263340, 1636431263788, 448, 1, 447, 0, 0, 0
9994, 1, 1636431263528, 1636431263973, 445, 0, 445, 0, 0, 0
9995, 1, 1636431263541, 1636431263992, 451, 0, 451, 0, 0, 0
9997, 1, 1636431263736, 1636431264185, 449, 1, 448, 0, 0, 0
9993, 1, 1636431263393, 1636431264220, 827, 376, 451, 376, 0, 376
9999, 1, 1636431263869, 1636431264321, 452, 0, 452, 0, 0, 0
9998, 1, 1636431263752, 1636431264429, 677, 221, 456, 221, 0, 221
10000, 1, 1636431263973, 1636431264668, 695, 248, 447, 248, 0, 248
9908, 2, 1636431254845, 1636431264845, 10000, 0, 10000, 412, 0, 412
10001, 1, 1636431264488, 1636431264941, 453, 0, 453, 0, 0, 0
9909, 2, 1636431254944, 1636431264944, 10000, 0, 10000, 313, 0, 313
10003, 1, 1636431264621, 1636431265073, 452, 0, 452, 0, 0, 0
10004, 1, 1636431264676, 1636431265169, 493, 1, 492, 1, 0, 1
10006, 1, 1636431264820, 1636431265264, 444, 1, 443, 0, 0, 0
9915, 2, 1636431255488, 1636431265489, 10001, 0, 10001, 1, 0, 1
10005, 1, 1636431264712, 1636431265520, 808, 361, 447, 361, 0, 361
10007, 1, 1636431265081, 1636431265524, 443, 0, 443, 0, 0, 0
10008, 1, 1636431265100, 1636431265548, 448, 1, 447, 1, 0, 1
10009, 1, 1636431265257, 1636431265708, 451, 0, 451, 0, 0, 0
10010, 1, 1636431265304, 1636431265748, 444, 0, 444, 0, 0, 0
10012, 1, 1636431265580, 1636431266025, 445, 1, 444, 0, 1, 1
10011, 1, 1636431265580, 1636431266028, 448, 1, 447, 1, 0, 1
10014, 1, 1636431265820, 1636431266273, 453, 0, 453, 0, 0, 0
10015, 1, 1636431266009, 1636431266457, 448, 0, 448, 0, 0, 0
10013, 1, 1636431265796, 1636431266472, 676, 229, 447, 229, 0, 229
10016, 1, 1636431266017, 1636431266472, 455, 0, 455, 0, 0, 0
10018, 1, 1636431266101, 1636431266545, 444, 0, 444, 0, 0, 0
10019, 1, 1636431266433, 1636431266877, 444, 0, 444, 0, 0, 0
10020, 1, 1636431266441, 1636431266889, 448, 0, 448, 0, 0, 0
10017, 1, 1636431266076, 1636431266901, 825, 381, 444, 381, 0, 381
10021, 1, 1636431266564, 1636431267013, 449, 1, 448, 0, 0, 0
10023, 1, 1636431266816, 1636431267260, 444, 1, 443, 1, 0, 1
10024, 1, 1636431266864, 1636431267312, 448, 0, 448, 0, 0, 0
10022, 1, 1636431266600, 1636431267353, 753, 301, 452, 300, 0, 300
10026, 1, 1636431267121, 1636431267573, 452, 0, 452, 0, 0, 0
10025, 1, 1636431267073, 1636431267713, 640, 188, 452, 188, 0, 188
10027, 1, 1636431267280, 1636431267736, 456, 1, 455, 1, 0, 1
10029, 1, 1636431267408, 1636431267861, 453, 1, 452, 1, 0, 1
10030, 1, 1636431267408, 1636431267861, 453, 1, 452, 1, 0, 1
10031, 1, 1636431267720, 1636431268176, 456, 1, 455, 1, 0, 1
10028, 1, 1636431267396, 1636431268193, 797, 341, 456, 341, 0, 341
10032, 1, 1636431267780, 1636431268229, 449, 0, 449, 0, 0, 0
10034, 1, 1636431267904, 1636431268353, 449, 0, 449, 0, 0, 0
10033, 1, 1636431267900, 1636431268353, 453, 1, 452, 0, 1, 1
10035, 1, 1636431268105, 1636431268561, 456, 0, 456, 0, 0, 0
10036, 1, 1636431268160, 1636431268641, 481, 33, 448, 33, 0, 33
10038, 1, 1636431268428, 1636431268877, 449, 1, 448, 0, 0, 0
10037, 1, 1636431268384, 1636431269021, 637, 177, 460, 177, 0, 177
10039, 1, 1636431268653, 1636431269105, 452, 0, 452, 0, 0, 0
10040, 1, 1636431268732, 1636431269184, 452, 1, 451, 0, 0, 0
10042, 1, 1636431268761, 1636431269212, 451, 0, 451, 0, 0, 0
10041, 1, 1636431268744, 1636431269561, 817, 361, 456, 361, 0, 361
10043, 1, 1636431269116, 1636431269565, 449, 0, 449, 0, 0, 0
10044, 1, 1636431269180, 1636431269628, 448, 1, 447, 0, 0, 0
10045, 1, 1636431269264, 1636431269713, 449, 1, 448, 1, 0, 1
10046, 1, 1636431269297, 1636431269745, 448, 0, 448, 0, 0, 0
10047, 1, 1636431269401, 1636431269860, 459, 0, 459, 0, 0, 0
10048, 1, 1636431269521, 1636431269965, 444, 0, 444, 0, 0, 0
10050, 1, 1636431269777, 1636431270224, 447, 0, 447, 0, 0, 0
10049, 1, 1636431269676, 1636431270309, 633, 185, 448, 185, 0, 185
10051, 1, 1636431270012, 1636431270461, 449, 1, 448, 1, 0, 1
10052, 1, 1636431270033, 1636431270485, 452, 0, 452, 0, 0, 0
10054, 1, 1636431270140, 1636431270597, 457, 1, 456, 0, 0, 0
10053, 1, 1636431270100, 1636431270912, 812, 361, 451, 360, 0, 360
10055, 1, 1636431270512, 1636431270956, 444, 0, 444, 0, 0, 0
10056, 1, 1636431270516, 1636431270957, 441, 1, 440, 1, 0, 1
10057, 1, 1636431270600, 1636431271041, 441, 0, 441, 0, 0, 0
10058, 1, 1636431270644, 1636431271093, 449, 0, 449, 0, 0, 0
10059, 1, 1636431270789, 1636431271229, 440, 0, 440, 0, 0, 0
10060, 1, 1636431270924, 1636431271372, 448, 0, 448, 0, 0, 0
10062, 1, 1636431271117, 1636431271569, 452, 0, 452, 0, 0, 0
10061, 1, 1636431271033, 1636431271685, 652, 196, 456, 196, 0, 196
10063, 1, 1636431271312, 1636431271765, 453, 1, 452, 0, 0, 0
10064, 1, 1636431271328, 1636431271789, 461, 0, 461, 0, 0, 0
10066, 1, 1636431271465, 1636431271913, 448, 0, 448, 0, 0, 0
10065, 1, 1636431271429, 1636431272241, 812, 360, 452, 360, 0, 360
10067, 1, 1636431271844, 1636431272293, 449, 0, 449, 0, 0, 0
10068, 1, 1636431271885, 1636431272337, 452, 0, 452, 0, 0, 0
10069, 1, 1636431271945, 1636431272393, 448, 0, 448, 0, 0, 0
10070, 1, 1636431272033, 1636431272472, 439, 0, 439, 0, 0, 0
10071, 1, 1636431272112, 1636431272556, 444, 1, 443, 0, 1, 1
10072, 1, 1636431272272, 1636431272725, 453, 1, 452, 1, 0, 1
9988, 2, 1636431262793, 1636431272796, 10003, 0, 10003, 0, 0, 0
10074, 1, 1636431272497, 1636431272945, 448, 0, 448, 0, 0, 0
10073, 1, 1636431272364, 1636431273025, 661, 193, 468, 193, 0, 193
10075, 1, 1636431272612, 1636431273065, 453, 1, 452, 1, 0, 1
10076, 1, 1636431272684, 1636431273128, 444, 1, 443, 1, 0, 1
10077, 1, 1636431272765, 1636431273213, 448, 0, 448, 0, 0, 0
10079, 1, 1636431273100, 1636431273553, 453, 1, 452, 0, 0, 0
10078, 1, 1636431272780, 1636431273576, 796, 349, 447, 349, 0, 349
10080, 1, 1636431273185, 1636431273632, 447, 0, 447, 0, 0, 0
10081, 1, 1636431273216, 1636431273668, 452, 1, 451, 0, 0, 0
9996, 2, 1636431263713, 1636431273712, 9999, 0, 9999, 0, 0, 0
10083, 1, 1636431273301, 1636431273749, 448, 0, 448, 0, 0, 0
10084, 1, 1636431273512, 1636431273968, 456, 1, 455, 0, 0, 0
10082, 1, 1636431273288, 1636431274036, 748, 265, 483, 265, 0, 265
10085, 1, 1636431273608, 1636431274056, 448, 0, 448, 0, 0, 0
10002, 1, 1636431264564, 1636431274168, 9604, 9148, 456, 0, 9147, 9147
10087, 1, 1636431273804, 1636431274256, 452, 0, 452, 0, 0, 0
10088, 1, 1636431273905, 1636431274344, 439, 0, 439, 0, 0, 0
10086, 1, 1636431273693, 1636431274417, 724, 276, 448, 276, 0, 276
10090, 1, 1636431274020, 1636431274472, 452, 1, 451, 0, 0, 0
10089, 1, 1636431274020, 1636431274480, 460, 17, 443, 16, 0, 16
10091, 1, 1636431274032, 1636431274480, 448, 1, 447, 1, 0, 1
10094, 1, 1636431274352, 1636431274793, 441, 0, 441, 0, 0, 0
10092, 1, 1636431274137, 1636431274924, 787, 336, 451, 336, 0, 336
10093, 1, 1636431274388, 1636431274924, 536, 93, 443, 93, 0, 93
10095, 1, 1636431274516, 1636431274968, 452, 0, 452, 0, 0, 0
10096, 1, 1636431274584, 1636431275037, 453, 1, 452, 0, 1, 1
10097, 1, 1636431274600, 1636431275044, 444, 1, 443, 0, 1, 1
10100, 1, 1636431274884, 1636431275332, 448, 0, 448, 0, 0, 0
10099, 1, 1636431274880, 1636431275336, 456, 0, 456, 0, 0, 0
10098, 1, 1636431274669, 1636431275369, 700, 256, 444, 256, 0, 256
10103, 1, 1636431275276, 1636431275737, 461, 0, 461, 0, 0, 0
10104, 1, 1636431275308, 1636431275757, 449, 0, 449, 0, 0, 0
10101, 1, 1636431275073, 1636431275788, 715, 264, 451, 264, 0, 264
10106, 1, 1636431275361, 1636431275801, 440, 0, 440, 0, 0, 0
10105, 1, 1636431275352, 1636431275801, 449, 0, 449, 0, 0, 0
10102, 1, 1636431275177, 1636431275825, 648, 192, 456, 192, 0, 192
10109, 1, 1636431275724, 1636431276168, 444, 0, 444, 0, 0, 0
10108, 1, 1636431275685, 1636431276212, 527, 72, 455, 72, 0, 72
10107, 1, 1636431275468, 1636431276252, 784, 333, 451, 333, 0, 333
10110, 1, 1636431275884, 1636431276332, 448, 0, 448, 0, 0, 0
10112, 1, 1636431275981, 1636431276425, 444, 0, 444, 0, 0, 0
10113, 1, 1636431275997, 1636431276448, 451, 0, 451, 0, 0, 0
10114, 1, 1636431276201, 1636431276649, 448, 0, 448, 0, 0, 0
10111, 1, 1636431275928, 1636431276697, 769, 325, 444, 325, 0, 325
10115, 1, 1636431276248, 1636431276697, 449, 0, 449, 0, 0, 0
10117, 1, 1636431276549, 1636431277004, 455, 0, 455, 0, 0, 0
10118, 1, 1636431276588, 1636431277049, 461, 1, 460, 0, 0, 0
10116, 1, 1636431276397, 1636431277101, 704, 252, 452, 252, 0, 252
10119, 1, 1636431276661, 1636431277104, 443, 0, 443, 0, 0, 0
10120, 1, 1636431276672, 1636431277120, 448, 0, 448, 0, 0, 0
10121, 1, 1636431276716, 1636431277164, 448, 0, 448, 0, 0, 0
10124, 1, 1636431277052, 1636431277504, 452, 0, 452, 0, 0, 0
10123, 1, 1636431277037, 1636431277552, 515, 68, 447, 68, 0, 68
10122, 1, 1636431276813, 1636431277608, 795, 352, 443, 352, 0, 352
10125, 1, 1636431277228, 1636431277673, 445, 1, 444, 0, 0, 0
10126, 1, 1636431277248, 1636431277700, 452, 0, 452, 0, 0, 0
10127, 1, 1636431277264, 1636431277704, 440, 0, 440, 0, 0, 0
10128, 1, 1636431277344, 1636431277789, 445, 1, 444, 0, 0, 0
10129, 1, 1636431277592, 1636431278044, 452, 0, 452, 0, 0, 0
10130, 1, 1636431277613, 1636431278061, 448, 0, 448, 0, 0, 0
10132, 1, 1636431277905, 1636431278349, 444, 0, 444, 0, 0, 0
10133, 1, 1636431277985, 1636431278429, 444, 0, 444, 0, 0, 0
10134, 1, 1636431277993, 1636431278436, 443, 0, 443, 0, 0, 0
10135, 1, 1636431278036, 1636431278480, 444, 0, 444, 0, 0, 0
10131, 1, 1636431277764, 1636431278488, 724, 281, 443, 281, 0, 281
10136, 1, 1636431278140, 1636431278872, 732, 289, 443, 288, 0, 288
10138, 1, 1636431278452, 1636431278893, 441, 1, 440, 1, 0, 1
10137, 1, 1636431278329, 1636431278893, 564, 108, 456, 108, 0, 108
10139, 1, 1636431278524, 1636431278977, 453, 1, 452, 0, 0, 0
10140, 1, 1636431278644, 1636431279088, 444, 1, 443, 0, 0, 0
10142, 1, 1636431278680, 1636431279124, 444, 1, 443, 1, 0, 1
10141, 1, 1636431278664, 1636431279424, 760, 313, 447, 313, 0, 313
10143, 1, 1636431278996, 1636431279445, 449, 1, 448, 0, 0, 0
10144, 1, 1636431278996, 1636431279448, 452, 1, 451, 0, 0, 0
10146, 1, 1636431279192, 1636431279641, 449, 0, 449, 0, 0, 0
10147, 1, 1636431279313, 1636431279760, 447, 0, 447, 0, 0, 0
10148, 1, 1636431279332, 1636431279785, 453, 1, 452, 0, 1, 1
10149, 1, 1636431279384, 1636431279832, 448, 0, 448, 0, 0, 0
10145, 1, 1636431279120, 1636431279904, 784, 325, 459, 325, 0, 325
10150, 1, 1636431279468, 1636431280220, 752, 293, 459, 293, 0, 293
10151, 1, 1636431279704, 1636431280280, 576, 129, 447, 129, 0, 129
10153, 1, 1636431279908, 1636431280357, 449, 0, 449, 0, 0, 0
10155, 1, 1636431280013, 1636431280453, 440, 0, 440, 0, 0, 0
10154, 1, 1636431280013, 1636431280456, 443, 0, 443, 0, 0, 0
10156, 1, 1636431280032, 1636431280489, 457, 0, 457, 0, 0, 0
10152, 1, 1636431279848, 1636431280721, 873, 433, 440, 433, 0, 433
10157, 1, 1636431280297, 1636431280744, 447, 0, 447, 0, 0, 0
10158, 1, 1636431280324, 1636431280764, 440, 1, 439, 0, 0, 0
10161, 1, 1636431280605, 1636431281049, 444, 0, 444, 0, 0, 0
10160, 1, 1636431280585, 1636431281173, 588, 136, 452, 136, 0, 136
10162, 1, 1636431280721, 1636431281176, 455, 0, 455, 0, 0, 0
10159, 1, 1636431280416, 1636431281208, 792, 349, 443, 348, 0, 348
10164, 1, 1636431280768, 1636431281508, 740, 281, 459, 281, 0, 281
10165, 1, 1636431281049, 1636431281628, 579, 124, 455, 124, 0, 124
10166, 1, 1636431281196, 1636431281648, 452, 1, 451, 0, 0, 0
10167, 1, 1636431281296, 1636431281744, 448, 0, 448, 0, 0, 0
10169, 1, 1636431281312, 1636431281757, 445, 0, 445, 0, 0, 0
10168, 1, 1636431281305, 1636431281761, 456, 0, 456, 0, 0, 0
10170, 1, 1636431281432, 1636431281872, 440, 1, 439, 0, 1, 1
10171, 1, 1636431281593, 1636431282036, 443, 0, 443, 0, 0, 0
10163, 1, 1636431280744, 1636431282080, 1336, 885, 451, 885, 0, 885
10172, 1, 1636431281700, 1636431282153, 453, 1, 452, 0, 0, 0
10174, 1, 1636431281877, 1636431282321, 444, 0, 444, 0, 0, 0
10176, 1, 1636431282064, 1636431282509, 445, 1, 444, 1, 0, 1
10175, 1, 1636431281957, 1636431282529, 572, 124, 448, 124, 0, 124
10173, 1, 1636431281761, 1636431282605, 844, 392, 452, 392, 0, 392
10178, 1, 1636431282296, 1636431282753, 457, 0, 457, 0, 0, 0
10177, 1, 1636431282100, 1636431282768, 668, 221, 447, 221, 0, 221
10179, 1, 1636431282380, 1636431282824, 444, 1, 443, 0, 1, 1
10180, 1, 1636431282552, 1636431282993, 441, 1, 440, 0, 0, 0
10181, 1, 1636431282584, 1636431283033, 449, 0, 449, 0, 0, 0
10182, 1, 1636431282628, 1636431283072, 444, 1, 443, 1, 0, 1
10183, 1, 1636431282696, 1636431283136, 440, 1, 439, 1, 0, 1
10184, 1, 1636431282716, 1636431283165, 449, 1, 448, 0, 1, 1
10185, 1, 1636431282856, 1636431283308, 452, 0, 452, 0, 0, 0
10186, 1, 1636431283028, 1636431283485, 457, 1, 456, 0, 0, 0
10188, 1, 1636431283188, 1636431283632, 444, 1, 443, 0, 0, 0
10189, 1, 1636431283289, 1636431283736, 447, 0, 447, 0, 0, 0
10190, 1, 1636431283352, 1636431283800, 448, 0, 448, 0, 0, 0
10187, 1, 1636431283088, 1636431283936, 848, 397, 451, 397, 0, 397
10192, 1, 1636431283569, 1636431284012, 443, 0, 443, 0, 0, 0
10191, 1, 1636431283392, 1636431284068, 676, 241, 435, 240, 0, 240
10193, 1, 1636431283776, 1636431284216, 440, 0, 440, 0, 0, 0
10194, 1, 1636431283852, 1636431284300, 448, 1, 447, 0, 1, 1
10195, 1, 1636431283868, 1636431284321, 453, 1, 452, 0, 0, 0
10196, 1, 1636431283996, 1636431284444, 448, 1, 447, 0, 0, 0
10198, 1, 1636431284072, 1636431284520, 448, 1, 447, 0, 1, 1
10199, 1, 1636431284152, 1636431284601, 449, 1, 448, 0, 0, 0
10197, 1, 1636431284016, 1636431284669, 653, 201, 452, 201, 0, 201
10200, 1, 1636431284400, 1636431284856, 456, 0, 456, 0, 0, 0
10202, 1, 1636431284505, 1636431284941, 436, 0, 436, 0, 0, 0
10203, 1, 1636431284648, 1636431285101, 453, 1, 452, 1, 0, 1
10204, 1, 1636431284688, 1636431285133, 445, 0, 445, 0, 0, 0
10206, 1, 1636431284840, 1636431285292, 452, 1, 451, 0, 0, 0
10201, 1, 1636431284448, 1636431285304, 856, 409, 447, 409, 0, 409
10205, 1, 1636431284720, 1636431285392, 672, 221, 451, 220, 0, 220
10207, 1, 1636431285069, 1636431285516, 447, 0, 447, 0, 0, 0
10208, 1, 1636431285208, 1636431285652, 444, 1, 443, 1, 0, 1
10209, 1, 1636431285212, 1636431285657, 445, 1, 444, 1, 0, 1
10211, 1, 1636431285304, 1636431285752, 448, 1, 447, 0, 0, 0
10210, 1, 1636431285304, 1636431285752, 448, 1, 447, 0, 1, 1
10212, 1, 1636431285340, 1636431285788, 448, 0, 448, 0, 0, 0
10213, 1, 1636431285496, 1636431285937, 441, 0, 441, 0, 0, 0
10215, 1, 1636431285773, 1636431286225, 452, 0, 452, 0, 0, 0
10214, 1, 1636431285773, 1636431286228, 455, 0, 455, 0, 0, 0
10217, 1, 1636431285977, 1636431286428, 451, 0, 451, 0, 0, 0
10219, 1, 1636431286049, 1636431286492, 443, 0, 443, 0, 0, 0
10220, 1, 1636431286128, 1636431286577, 449, 1, 448, 1, 0, 1
10218, 1, 1636431286008, 1636431286677, 669, 217, 452, 217, 0, 217
10216, 1, 1636431285808, 1636431286677, 869, 421, 448, 421, 0, 421
10221, 1, 1636431286432, 1636431286888, 456, 1, 455, 1, 0, 1
10222, 1, 1636431286496, 1636431286953, 457, 1, 456, 0, 0, 0
10223, 1, 1636431286604, 1636431287049, 445, 1, 444, 0, 0, 0
10224, 1, 1636431286609, 1636431287064, 455, 0, 455, 0, 0, 0
10225, 1, 1636431286644, 1636431287092, 448, 0, 448, 0, 0, 0
10226, 1, 1636431286680, 1636431287136, 456, 0, 456, 0, 0, 0
10227, 1, 1636431286801, 1636431287245, 444, 0, 444, 0, 0, 0
10228, 1, 1636431287028, 1636431287477, 449, 1, 448, 0, 1, 1
10229, 1, 1636431287056, 1636431287500, 444, 1, 443, 1, 0, 1
10232, 1, 1636431287337, 1636431287785, 448, 0, 448, 0, 0, 0
10233, 1, 1636431287340, 1636431287801, 461, 0, 461, 0, 0, 0
10234, 1, 1636431287457, 1636431287905, 448, 0, 448, 0, 0, 0
10230, 1, 1636431287125, 1636431287932, 807, 352, 455, 352, 0, 352
10231, 1, 1636431287317, 1636431287948, 631, 184, 447, 184, 0, 184
10235, 1, 1636431287792, 1636431288245, 453, 1, 452, 1, 0, 1
10236, 1, 1636431287877, 1636431288325, 448, 0, 448, 0, 0, 0
10237, 1, 1636431287896, 1636431288348, 452, 1, 451, 0, 0, 0
10238, 1, 1636431287980, 1636431288429, 449, 1, 448, 0, 0, 0
10239, 1, 1636431287992, 1636431288433, 441, 1, 440, 1, 0, 1
10240, 1, 1636431287992, 1636431288436, 444, 1, 443, 0, 1, 1
10241, 1, 1636431288068, 1636431288512, 444, 0, 444, 0, 0, 0
10243, 1, 1636431288417, 1636431288856, 439, 0, 439, 0, 0, 0
10242, 1, 1636431288341, 1636431288880, 539, 96, 443, 96, 0, 96
10246, 1, 1636431288641, 1636431289101, 460, 0, 460, 0, 0, 0
10247, 1, 1636431288700, 1636431289145, 445, 0, 445, 0, 0, 0
10248, 1, 1636431288808, 1636431289257, 449, 1, 448, 0, 0, 0
10244, 1, 1636431288476, 1636431289312, 836, 381, 455, 381, 0, 381
10245, 1, 1636431288636, 1636431289325, 689, 245, 444, 244, 0, 244
10249, 1, 1636431289181, 1636431289624, 443, 0, 443, 0, 0, 0
10251, 1, 1636431289268, 1636431289717, 449, 0, 449, 0, 0, 0
10252, 1, 1636431289292, 1636431289744, 452, 1, 451, 0, 0, 0
10253, 1, 1636431289304, 1636431289760, 456, 0, 456, 0, 0, 0
10250, 1, 1636431289185, 1636431289776, 591, 140, 451, 140, 0, 140
10254, 1, 1636431289389, 1636431289844, 455, 0, 455, 0, 0, 0
10255, 1, 1636431289429, 1636431289873, 444, 0, 444, 0, 0, 0
10256, 1, 1636431289717, 1636431290165, 448, 0, 448, 0, 0, 0
10257, 1, 1636431289788, 1636431290237, 449, 0, 449, 0, 0, 0
10259, 1, 1636431289981, 1636431290437, 456, 0, 456, 0, 0, 0
10261, 1, 1636431290073, 1636431290520, 447, 0, 447, 0, 0, 0
10262, 1, 1636431290088, 1636431290532, 444, 0, 444, 0, 0, 0
10260, 1, 1636431290001, 1636431290612, 611, 164, 447, 164, 0, 164
10258, 1, 1636431289832, 1636431290689, 857, 405, 452, 405, 0, 405
10263, 1, 1636431290492, 1636431290937, 445, 0, 445, 0, 0, 0
10264, 1, 1636431290524, 1636431290973, 449, 1, 448, 0, 0, 0
10265, 1, 1636431290596, 1636431291048, 452, 1, 451, 0, 1, 1
10266, 1, 1636431290604, 1636431291053, 449, 1, 448, 0, 1, 1
10267, 1, 1636431290676, 1636431291133, 457, 13, 444, 13, 0, 13
10268, 1, 1636431290696, 1636431291136, 440, 1, 439, 0, 0, 0
10269, 1, 1636431290736, 1636431291176, 440, 0, 440, 0, 0, 0
10271, 1, 1636431291052, 1636431291505, 453, 1, 452, 0, 0, 0
10270, 1, 1636431291001, 1636431291620, 619, 176, 443, 176, 0, 176
10274, 1, 1636431291336, 1636431291785, 449, 0, 449, 0, 0, 0
10275, 1, 1636431291356, 1636431291804, 448, 0, 448, 0, 0, 0
10276, 1, 1636431291364, 1636431291808, 444, 1, 443, 0, 0, 0
10272, 1, 1636431291141, 1636431291960, 819, 364, 455, 364, 0, 364
10273, 1, 1636431291320, 1636431292068, 748, 301, 447, 301, 0, 301
10277, 1, 1636431291764, 1636431292225, 461, 0, 461, 0, 0, 0
10278, 1, 1636431291868, 1636431292316, 448, 1, 447, 1, 0, 1
10280, 1, 1636431291980, 1636431292432, 452, 1, 451, 0, 0, 0
10281, 1, 1636431291993, 1636431292440, 447, 0, 447, 0, 0, 0
10282, 1, 1636431292024, 1636431292464, 440, 1, 439, 0, 0, 0
10279, 1, 1636431291876, 1636431292508, 632, 193, 439, 192, 0, 192
10283, 1, 1636431292289, 1636431292733, 444, 0, 444, 0, 0, 0
10284, 1, 1636431292360, 1636431292809, 449, 1, 448, 0, 0, 0
10287, 1, 1636431292657, 1636431293109, 452, 0, 452, 0, 0, 0
10288, 1, 1636431292685, 1636431293132, 447, 0, 447, 0, 0, 0
10286, 1, 1636431292640, 1636431293180, 540, 93, 447, 93, 0, 93
10289, 1, 1636431292736, 1636431293180, 444, 1, 443, 0, 0, 0
10285, 1, 1636431292468, 1636431293264, 796, 341, 455, 341, 0, 341
10290, 1, 1636431293089, 1636431293536, 447, 0, 447, 0, 0, 0
10291, 1, 1636431293172, 1636431293620, 448, 1, 447, 0, 1, 1
10292, 1, 1636431293196, 1636431293649, 453, 1, 452, 0, 0, 0
10293, 1, 1636431293304, 1636431293753, 449, 0, 449, 0, 0, 0
10294, 1, 1636431293348, 1636431293796, 448, 0, 448, 0, 0, 0
10295, 1, 1636431293385, 1636431293836, 451, 0, 451, 0, 0, 0
10296, 1, 1636431293612, 1636431294056, 444, 1, 443, 1, 0, 1
10297, 1, 1636431293696, 1636431294149, 453, 1, 452, 0, 0, 0
10299, 1, 1636431293925, 1636431294380, 455, 0, 455, 0, 0, 0
10301, 1, 163643