Xid, State, StartTime, EndTime, TransactionTime, ExecuteTime, CommunicationTime, ReadTime, WriteTime, DBTime
1, 1, 1636423658444, 1636423658978, 534, 99, 435, 49, 5, 54
2, 1, 1636423659357, 1636423659766, 409, 5, 404, 1, 0, 1
3, 1, 1636423660081, 1636423660494, 413, 5, 408, 1, 1, 2
4, 1, 1636423660809, 1636423661217, 408, 3, 405, 1, 1, 2
5, 1, 1636423661533, 1636423661950, 417, 4, 413, 1, 1, 2
6, 1, 1636423662265, 1636423662678, 413, 4, 409, 0, 1, 1
7, 1, 1636423662989, 1636423663398, 409, 3, 406, 0, 0, 0
8, 1, 1636423663709, 1636423664117, 408, 3, 405, 0, 0, 0
9, 1, 1636423664429, 1636423664857, 428, 4, 424, 1, 0, 1
10, 1, 1636423665169, 1636423665577, 408, 4, 404, 1, 0, 1
11, 1, 1636423665889, 1636423666297, 408, 4, 404, 0, 0, 0
12, 1, 1636423666609, 1636423667014, 405, 4, 401, 0, 0, 0
13, 1, 1636423667325, 1636423667733, 408, 2, 406, 1, 0, 1
14, 1, 1636423668041, 1636423668449, 408, 4, 404, 1, 0, 1
15, 1, 1636423668761, 1636423669169, 408, 3, 405, 2, 0, 2
16, 1, 1636423669481, 1636423669889, 408, 5, 403, 1, 0, 1
17, 1, 1636423670201, 1636423670606, 405, 2, 403, 2, 0, 2
18, 1, 1636423670877, 1636423671237, 360, 2, 358, 0, 0, 0
19, 1, 1636423671509, 1636423671869, 360, 2, 358, 2, 0, 2
20, 1, 1636423672141, 1636423672505, 364, 3, 361, 3, 0, 3
21, 1, 1636423672777, 1636423673137, 360, 1, 359, 1, 0, 1
23, 1, 1636423673413, 1636423673773, 360, 1, 359, 0, 0, 0
24, 1, 1636423674041, 1636423674397, 356, 1, 355, 1, 0, 1
26, 1, 1636423674665, 1636423675029, 364, 3, 361, 0, 0, 0
28, 1, 1636423675297, 1636423675661, 364, 2, 362, 0, 1, 1
30, 1, 1636423675933, 1636423676293, 360, 3, 357, 1, 0, 1
32, 1, 1636423676565, 1636423676929, 364, 1, 363, 1, 0, 1
34, 1, 1636423677201, 1636423677565, 364, 2, 362, 1, 0, 1
36, 1, 1636423677833, 1636423678197, 364, 2, 362, 0, 0, 0
38, 1, 1636423678469, 1636423678832, 363, 3, 360, 0, 1, 1
40, 1, 1636423679101, 1636423679457, 356, 1, 355, 0, 1, 1
42, 1, 1636423679725, 1636423680085, 360, 2, 358, 1, 0, 1
44, 1, 1636423680357, 1636423680717, 360, 3, 357, 1, 0, 1
45, 1, 1636423680981, 1636423681345, 364, 1, 363, 0, 0, 0
47, 1, 1636423681613, 1636423681977, 364, 3, 361, 0, 1, 1
49, 1, 1636423682249, 1636423682613, 364, 0, 364, 0, 0, 0
51, 1, 1636423682881, 1636423683241, 360, 2, 358, 0, 1, 1
53, 1, 1636423683505, 1636423683865, 360, 1, 359, 0, 1, 1
55, 1, 1636423684137, 1636423684501, 364, 2, 362, 0, 0, 0
57, 1, 1636423684773, 1636423685137, 364, 2, 362, 0, 1, 1
59, 1, 1636423685401, 1636423685765, 364, 2, 362, 0, 1, 1
61, 1, 1636423686037, 1636423686401, 364, 1, 363, 0, 0, 0
63, 1, 1636423686673, 1636423687037, 364, 1, 363, 0, 0, 0
65, 1, 1636423687301, 1636423687669, 368, 1, 367, 0, 0, 0
67, 1, 1636423687941, 1636423688305, 364, 2, 362, 0, 1, 1
69, 1, 1636423688569, 1636423688929, 360, 3, 357, 0, 1, 1
71, 1, 1636423689201, 1636423689565, 364, 2, 362, 0, 0, 0
73, 1, 1636423689829, 1636423690185, 356, 3, 353, 0, 0, 0
75, 1, 1636423690453, 1636423690813, 360, 2, 358, 0, 1, 1
78, 1, 1636423691077, 1636423691433, 356, 0, 356, 0, 0, 0
81, 1, 1636423691705, 1636423692069, 364, 0, 364, 0, 0, 0
83, 1, 1636423692337, 1636423692697, 360, 2, 358, 0, 0, 0
86, 1, 1636423692965, 1636423693321, 356, 1, 355, 1, 0, 1
89, 1, 1636423693585, 1636423693945, 360, 0, 360, 0, 0, 0
92, 1, 1636423694213, 1636423694569, 356, 1, 355, 0, 0, 0
95, 1, 1636423694841, 1636423695205, 364, 1, 363, 0, 0, 0
98, 1, 1636423695465, 1636423695821, 356, 0, 356, 0, 0, 0
101, 1, 1636423696093, 1636423696453, 360, 0, 360, 0, 0, 0
104, 1, 1636423696717, 1636423697081, 364, 1, 363, 0, 0, 0
107, 1, 1636423697337, 1636423697693, 356, 0, 356, 0, 0, 0
110, 1, 1636423697957, 1636423698321, 364, 1, 363, 0, 1, 1
113, 1, 1636423698589, 1636423698948, 359, 1, 358, 0, 0, 0
116, 1, 1636423699217, 1636423699573, 356, 0, 356, 0, 0, 0
119, 1, 1636423699849, 1636423700213, 364, 1, 363, 0, 1, 1
121, 1, 1636423700481, 1636423700841, 360, 2, 358, 0, 0, 0
124, 1, 1636423701109, 1636423701461, 352, 1, 351, 0, 0, 0
127, 1, 1636423701732, 1636423702085, 353, 1, 352, 0, 1, 1
130, 1, 1636423702352, 1636423702709, 357, 3, 354, 1, 0, 1
133, 1, 1636423702977, 1636423703337, 360, 3, 357, 0, 0, 0
136, 1, 1636423703601, 1636423703965, 364, 0, 364, 0, 0, 0
139, 1, 1636423704233, 1636423704597, 364, 1, 363, 0, 0, 0
142, 1, 1636423704865, 1636423705221, 356, 0, 356, 0, 0, 0
145, 1, 1636423705489, 1636423705853, 364, 1, 363, 0, 0, 0
148, 1, 1636423706121, 1636423706485, 364, 1, 363, 0, 0, 0
151, 1, 1636423706749, 1636423707109, 360, 0, 360, 0, 0, 0
154, 1, 1636423707377, 1636423707741, 364, 0, 364, 0, 0, 0
157, 1, 1636423708009, 1636423708373, 364, 1, 363, 0, 0, 0
160, 1, 1636423708641, 1636423709005, 364, 1, 363, 0, 1, 1
163, 1, 1636423709273, 1636423709629, 356, 2, 354, 1, 0, 1
166, 1, 1636423709889, 1636423710253, 364, 1, 363, 0, 0, 0
169, 1, 1636423710517, 1636423710881, 364, 1, 363, 0, 0, 0
172, 1, 1636423711152, 1636423711513, 361, 1, 360, 0, 0, 0
175, 1, 1636423711781, 1636423712149, 368, 1, 367, 0, 0, 0
178, 1, 1636423712421, 1636423712777, 356, 0, 356, 0, 0, 0
181, 1, 1636423713045, 1636423713405, 360, 1, 359, 0, 1, 1
184, 1, 1636423713665, 1636423714025, 360, 1, 359, 0, 0, 0
187, 1, 1636423714293, 1636423714649, 356, 1, 355, 0, 0, 0
190, 1, 1636423714913, 1636423715273, 360, 0, 360, 0, 0, 0
193, 1, 1636423715537, 1636423715897, 360, 0, 360, 0, 0, 0
196, 1, 1636423716165, 1636423716521, 356, 2, 354, 1, 0, 1
199, 1, 1636423716793, 1636423717153, 360, 1, 359, 0, 0, 0
202, 1, 1636423717417, 1636423717773, 356, 3, 353, 0, 0, 0
205, 1, 1636423718049, 1636423718409, 360, 0, 360, 0, 0, 0
208, 1, 1636423718677, 1636423719033, 356, 1, 355, 0, 0, 0
211, 1, 1636423719305, 1636423719664, 359, 0, 359, 0, 0, 0
214, 1, 1636423719921, 1636423720277, 356, 1, 355, 0, 0, 0
217, 1, 1636423720545, 1636423720901, 356, 1, 355, 0, 0, 0
220, 1, 1636423721173, 1636423721533, 360, 0, 360, 0, 0, 0
223, 1, 1636423721801, 1636423722165, 364, 0, 364, 0, 0, 0
226, 1, 1636423722437, 1636423722797, 360, 0, 360, 0, 0, 0
229, 1, 1636423723061, 1636423723421, 360, 1, 359, 0, 0, 0
232, 1, 1636423723681, 1636423724049, 368, 0, 368, 0, 0, 0
235, 1, 1636423724313, 1636423724681, 368, 0, 368, 0, 0, 0
238, 1, 1636423724949, 1636423725305, 356, 1, 355, 0, 0, 0
241, 1, 1636423725573, 1636423725933, 360, 0, 360, 0, 0, 0
244, 1, 1636423726205, 1636423726569, 364, 1, 363, 0, 0, 0
247, 1, 1636423726837, 1636423727201, 364, 0, 364, 0, 0, 0
250, 1, 1636423727469, 1636423727829, 360, 0, 360, 0, 0, 0
253, 1, 1636423728097, 1636423728457, 360, 0, 360, 0, 0, 0
256, 1, 1636423728729, 1636423729085, 356, 0, 356, 0, 0, 0
259, 1, 1636423729353, 1636423729709, 356, 0, 356, 0, 0, 0
262, 1, 1636423729977, 1636423730333, 356, 0, 356, 0, 0, 0
265, 1, 1636423730601, 1636423730957, 356, 1, 355, 1, 0, 1
268, 1, 1636423731228, 1636423731581, 353, 1, 352, 0, 0, 0
271, 1, 1636423731849, 1636423732209, 360, 0, 360, 0, 0, 0
274, 1, 1636423732477, 1636423732833, 356, 1, 355, 0, 0, 0
277, 1, 1636423733101, 1636423733457, 356, 3, 353, 0, 0, 0
280, 1, 1636423733729, 1636423734089, 360, 3, 357, 2, 0, 2
283, 1, 1636423734353, 1636423734713, 360, 2, 358, 1, 1, 2
286, 1, 1636423734981, 1636423735340, 359, 0, 359, 0, 0, 0
289, 1, 1636423735605, 1636423735961, 356, 0, 356, 0, 0, 0
292, 1, 1636423736229, 1636423736585, 356, 1, 355, 0, 0, 0
295, 1, 1636423736857, 1636423737213, 356, 1, 355, 0, 0, 0
298, 1, 1636423737481, 1636423737845, 364, 1, 363, 0, 0, 0
301, 1, 1636423738113, 1636423738473, 360, 0, 360, 0, 0, 0
304, 1, 1636423738737, 1636423739101, 364, 0, 364, 0, 0, 0
307, 1, 1636423739364, 1636423739721, 357, 1, 356, 1, 0, 1
310, 1, 1636423739985, 1636423740336, 351, 2, 349, 1, 0, 1
313, 1, 1636423740605, 1636423740961, 356, 1, 355, 0, 0, 0
316, 1, 1636423741221, 1636423741577, 356, 2, 354, 1, 0, 1
319, 1, 1636423741840, 1636423742193, 353, 1, 352, 0, 0, 0
322, 1, 1636423742465, 1636423742821, 356, 1, 355, 0, 0, 0
325, 1, 1636423743089, 1636423743441, 352, 2, 350, 0, 0, 0
328, 1, 1636423743704, 1636423744053, 349, 2, 347, 0, 0, 0
331, 1, 1636423744321, 1636423744677, 356, 1, 355, 0, 0, 0
334, 1, 1636423744936, 1636423745284, 348, 1, 347, 0, 0, 0
337, 1, 1636423745545, 1636423745897, 352, 1, 351, 0, 0, 0
340, 1, 1636423746161, 1636423746517, 356, 0, 356, 0, 0, 0
343, 1, 1636423746781, 1636423747145, 364, 0, 364, 0, 0, 0
346, 1, 1636423747417, 1636423747765, 348, 0, 348, 0, 0, 0
349, 1, 1636423748033, 1636423748392, 359, 2, 357, 1, 0, 1
352, 1, 1636423748657, 1636423749017, 360, 2, 358, 1, 0, 1
354, 1, 1636423749277, 1636423749633, 356, 0, 356, 0, 0, 0
357, 1, 1636423749889, 1636423750245, 356, 0, 356, 0, 0, 0
360, 1, 1636423750509, 1636423750869, 360, 0, 360, 0, 0, 0
363, 1, 1636423751137, 1636423751493, 356, 0, 356, 0, 0, 0
366, 1, 1636423751752, 1636423752113, 361, 1, 360, 0, 0, 0
369, 1, 1636423752381, 1636423752737, 356, 0, 356, 0, 0, 0
372, 1, 1636423753005, 1636423753361, 356, 0, 356, 0, 0, 0
375, 1, 1636423753625, 1636423753981, 356, 1, 355, 0, 0, 0
378, 1, 1636423754249, 1636423754605, 356, 1, 355, 0, 1, 1
380, 1, 1636423754877, 1636423755233, 356, 0, 356, 0, 0, 0
383, 1, 1636423755501, 1636423755848, 347, 0, 347, 0, 0, 0
386, 1, 1636423756109, 1636423756461, 352, 1, 351, 1, 0, 1
389, 1, 1636423756724, 1636423757077, 353, 1, 352, 0, 0, 0
392, 1, 1636423757341, 1636423757697, 356, 0, 356, 0, 0, 0
395, 1, 1636423757957, 1636423758309, 352, 0, 352, 0, 0, 0
398, 1, 1636423758577, 1636423758929, 352, 0, 352, 0, 0, 0
401, 1, 1636423759189, 1636423759537, 348, 1, 347, 0, 0, 0
404, 1, 1636423759809, 1636423760169, 360, 0, 360, 0, 0, 0
407, 1, 1636423760437, 1636423760797, 360, 0, 360, 0, 0, 0
410, 1, 1636423761065, 1636423761428, 363, 0, 363, 0, 0, 0
413, 1, 1636423761701, 1636423762053, 352, 2, 350, 0, 0, 0
416, 1, 1636423762321, 1636423762689, 368, 0, 368, 0, 0, 0
419, 1, 1636423762961, 1636423763321, 360, 0, 360, 0, 0, 0
422, 1, 1636423763593, 1636423763945, 352, 0, 352, 0, 0, 0
425, 1, 1636423764209, 1636423764572, 363, 0, 363, 0, 0, 0
428, 1, 1636423764833, 1636423765184, 351, 0, 351, 0, 0, 0
431, 1, 1636423765449, 1636423765805, 356, 0, 356, 0, 0, 0
434, 1, 1636423766069, 1636423766425, 356, 1, 355, 0, 0, 0
437, 1, 1636423766693, 1636423767057, 364, 1, 363, 0, 0, 0
440, 1, 1636423767325, 1636423767681, 356, 0, 356, 0, 0, 0
443, 1, 1636423767949, 1636423768301, 352, 0, 352, 0, 0, 0
446, 1, 1636423768565, 1636423768929, 364, 0, 364, 0, 0, 0
449, 1, 1636423769193, 1636423769549, 356, 0, 356, 0, 0, 0
452, 1, 1636423769817, 1636423770185, 368, 0, 368, 0, 0, 0
455, 1, 1636423770453, 1636423770817, 364, 0, 364, 0, 0, 0
458, 1, 1636423771089, 1636423771449, 360, 0, 360, 0, 0, 0
461, 1, 1636423771717, 1636423772081, 364, 0, 364, 0, 0, 0
464, 1, 1636423772349, 1636423772709, 360, 0, 360, 0, 0, 0
467, 1, 1636423772981, 1636423773349, 368, 0, 368, 0, 0, 0
470, 1, 1636423773621, 1636423773977, 356, 1, 355, 0, 0, 0
473, 1, 1636423774249, 1636423774609, 360, 1, 359, 0, 0, 0
476, 1, 1636423774877, 1636423775237, 360, 1, 359, 0, 0, 0
479, 1, 1636423775501, 1636423775853, 352, 0, 352, 0, 0, 0
482, 1, 1636423776117, 1636423776481, 364, 0, 364, 0, 0, 0
485, 1, 1636423776749, 1636423777108, 359, 1, 358, 0, 0, 0
488, 1, 1636423777372, 1636423777725, 353, 2, 351, 0, 0, 0
491, 1, 1636423777993, 1636423778353, 360, 0, 360, 0, 0, 0
494, 1, 1636423778621, 1636423778981, 360, 0, 360, 0, 0, 0
497, 1, 1636423779249, 1636423779605, 356, 1, 355, 0, 0, 0
500, 1, 1636423779869, 1636423780225, 356, 0, 356, 0, 0, 0
503, 1, 1636423780501, 1636423780857, 356, 0, 356, 0, 0, 0
506, 1, 1636423781125, 1636423781481, 356, 0, 356, 0, 0, 0
509, 1, 1636423781745, 1636423782105, 360, 0, 360, 0, 0, 0
512, 1, 1636423782373, 1636423782737, 364, 0, 364, 0, 0, 0
515, 1, 1636423783005, 1636423783369, 364, 0, 364, 0, 0, 0
518, 1, 1636423783641, 1636423784005, 364, 0, 364, 0, 0, 0
521, 1, 1636423784269, 1636423784629, 360, 0, 360, 0, 0, 0
524, 1, 1636423784901, 1636423785261, 360, 0, 360, 0, 0, 0
601, 1, 1636423994673, 1636423995313, 640, 10, 630, 0, 0, 0
602, 1, 1636423995225, 1636423995901, 676, 91, 585, 91, 0, 91
603, 1, 1636423995804, 1636423996489, 685, 98, 587, 98, 0, 98
604, 1, 1636423995985, 1636423996568, 583, 1, 582, 1, 0, 1
605, 1, 1636423996425, 1636423997069, 644, 64, 580, 64, 0, 64
606, 1, 1636423996544, 1636423997153, 609, 26, 583, 25, 0, 25
607, 1, 1636423996989, 1636423997649, 660, 81, 579, 81, 0, 81
608, 1, 1636423997125, 1636423997737, 612, 29, 583, 29, 0, 29
609, 1, 1636423997277, 1636423997861, 584, 1, 583, 1, 0, 1
610, 1, 1636423997557, 1636423998241, 684, 93, 591, 93, 0, 93
611, 1, 1636423997696, 1636423998321, 625, 42, 583, 42, 0, 42
612, 1, 1636423997873, 1636423998457, 584, 0, 584, 0, 0, 0
613, 1, 1636423998140, 1636423998825, 685, 102, 583, 102, 0, 102
614, 1, 1636423998256, 1636423998893, 637, 66, 571, 66, 0, 66
615, 1, 1636423998453, 1636423999045, 592, 5, 587, 5, 0, 5
616, 1, 1636423998645, 1636423999225, 580, 1, 579, 0, 0, 0
617, 1, 1636423998680, 1636423999285, 605, 146, 459, 145, 1, 146
618, 1, 1636423998764, 1636423999353, 589, 130, 459, 128, 1, 129
619, 1, 1636423998977, 1636423999497, 520, 69, 451, 69, 0, 69
620, 1, 1636423999196, 1636423999681, 485, 30, 455, 30, 0, 30
621, 1, 1636423999313, 1636423999764, 451, 0, 451, 0, 0, 0
622, 1, 1636423999341, 1636423999809, 468, 13, 455, 13, 0, 13
623, 1, 1636423999548, 1636424000001, 453, 1, 452, 0, 0, 0
624, 1, 1636423999788, 1636424000245, 457, 0, 457, 0, 0, 0
625, 1, 1636423999925, 1636424000380, 455, 0, 455, 0, 0, 0
627, 1, 1636423999953, 1636424000405, 452, 0, 452, 0, 0, 0
626, 1, 1636423999965, 1636424000421, 456, 0, 456, 0, 0, 0
628, 1, 1636424000064, 1636424000512, 448, 1, 447, 0, 0, 0
629, 1, 1636424000333, 1636424000793, 460, 0, 460, 0, 0, 0
630, 1, 1636424000545, 1636424001001, 456, 0, 456, 0, 0, 0
631, 1, 1636424000580, 1636424001032, 452, 1, 451, 1, 0, 1
632, 1, 1636424000624, 1636424001072, 448, 1, 447, 0, 1, 1
633, 1, 1636424000941, 1636424001396, 455, 0, 455, 0, 0, 0
634, 1, 1636424001184, 1636424001637, 453, 1, 452, 1, 0, 1
635, 1, 1636424001201, 1636424001657, 456, 0, 456, 0, 0, 0
636, 1, 1636424001224, 1636424001677, 453, 1, 452, 0, 0, 0
638, 1, 1636424001440, 1636424001892, 452, 1, 451, 0, 0, 0
637, 1, 1636424001284, 1636424002093, 809, 354, 455, 354, 0, 354
639, 1, 1636424001660, 1636424002108, 448, 1, 447, 1, 0, 1
641, 1, 1636424001848, 1636424002305, 457, 1, 456, 0, 0, 0
643, 1, 1636424002005, 1636424002460, 455, 0, 455, 0, 0, 0
644, 1, 1636424002217, 1636424002673, 456, 0, 456, 0, 0, 0
647, 1, 1636424002508, 1636424002965, 457, 1, 456, 0, 1, 1
648, 1, 1636424002604, 1636424003053, 449, 1, 448, 0, 1, 1
649, 1, 1636424002648, 1636424003121, 473, 26, 447, 25, 0, 25
651, 1, 1636424002837, 1636424003289, 452, 0, 452, 0, 0, 0
652, 1, 1636424002925, 1636424003577, 652, 197, 455, 196, 1, 197
653, 1, 1636424003244, 1636424003693, 449, 1, 448, 1, 0, 1
655, 1, 1636424003449, 1636424003900, 451, 0, 451, 0, 0, 0
656, 1, 1636424003597, 1636424004053, 456, 1, 455, 0, 1, 1
657, 1, 1636424003900, 1636424004357, 457, 1, 456, 1, 0, 1
659, 1, 1636424004037, 1636424004493, 456, 0, 456, 0, 0, 0
660, 1, 1636424004145, 1636424004592, 447, 0, 447, 0, 0, 0
662, 1, 1636424004169, 1636424004629, 460, 0, 460, 0, 0, 0
661, 1, 1636424004192, 1636424004645, 453, 1, 452, 0, 0, 0
664, 1, 1636424004745, 1636424005201, 456, 0, 456, 0, 0, 0
665, 1, 1636424004777, 1636424005229, 452, 0, 452, 0, 0, 0
666, 1, 1636424004829, 1636424005277, 448, 0, 448, 0, 0, 0
668, 1, 1636424005348, 1636424005813, 465, 1, 464, 0, 0, 0
669, 1, 1636424005428, 1636424005877, 449, 1, 448, 1, 0, 1
670, 1, 1636424005444, 1636424005901, 457, 1, 456, 0, 1, 1
671, 1, 1636424005472, 1636424005921, 449, 1, 448, 0, 0, 0
672, 1, 1636424005561, 1636424006009, 448, 0, 448, 0, 0, 0
673, 1, 1636424005957, 1636424006409, 452, 0, 452, 0, 0, 0
674, 1, 1636424005981, 1636424006433, 452, 0, 452, 0, 0, 0
675, 1, 1636424006149, 1636424006609, 460, 0, 460, 0, 0, 0
676, 1, 1636424006157, 1636424006609, 452, 0, 452, 0, 0, 0
677, 1, 1636424006501, 1636424006948, 447, 0, 447, 0, 0, 0
678, 1, 1636424006585, 1636424007041, 456, 0, 456, 0, 0, 0
679, 1, 1636424006729, 1636424007181, 452, 0, 452, 0, 0, 0
680, 1, 1636424006828, 1636424007277, 449, 1, 448, 1, 0, 1
681, 1, 1636424006848, 1636424007301, 453, 1, 452, 1, 0, 1
683, 1, 1636424007077, 1636424007529, 452, 0, 452, 0, 0, 0
684, 1, 1636424007193, 1636424007637, 444, 0, 444, 0, 0, 0
685, 1, 1636424007289, 1636424007741, 452, 0, 452, 0, 0, 0
687, 1, 1636424007548, 1636424008001, 453, 1, 452, 0, 0, 0
688, 1, 1636424007681, 1636424008132, 451, 0, 451, 0, 0, 0
689, 1, 1636424007889, 1636424008341, 452, 0, 452, 0, 0, 0
690, 1, 1636424008092, 1636424008548, 456, 1, 455, 1, 0, 1
691, 1, 1636424008104, 1636424008564, 460, 1, 459, 0, 0, 0
693, 1, 1636424008317, 1636424008777, 460, 0, 460, 0, 0, 0
694, 1, 1636424008517, 1636424008969, 452, 0, 452, 0, 0, 0
695, 1, 1636424008661, 1636424009117, 456, 0, 456, 0, 0, 0
697, 1, 1636424009009, 1636424009456, 447, 0, 447, 0, 0, 0
698, 1, 1636424009265, 1636424009717, 452, 0, 452, 0, 0, 0
699, 1, 1636424009397, 1636424009853, 456, 0, 456, 0, 0, 0
701, 1, 1636424009597, 1636424010053, 456, 0, 456, 0, 0, 0
702, 1, 1636424009893, 1636424010349, 456, 0, 456, 0, 0, 0
704, 1, 1636424010385, 1636424010841, 456, 0, 456, 0, 0, 0
706, 1, 1636424010681, 1636424011137, 456, 0, 456, 0, 0, 0
707, 1, 1636424010993, 1636424011449, 456, 0, 456, 0, 0, 0
640, 2, 1636424001729, 1636424011739, 10010, 0, 10010, 364, 0, 364
642, 2, 1636424001913, 1636424011912, 9999, 0, 9999, 180, 0, 180
645, 2, 1636424002341, 1636424012341, 10000, 0, 10000, 0, 0, 0
646, 2, 1636424002453, 1636424012453, 10000, 0, 10000, 0, 0, 0
710, 1, 1636424012076, 1636424012564, 488, 1, 487, 0, 0, 0
650, 2, 1636424002781, 1636424012781, 10000, 0, 10000, 0, 0, 0
712, 1, 1636424012544, 1636424013005, 461, 0, 461, 0, 0, 0
713, 1, 1636424012540, 1636424013005, 465, 0, 465, 0, 0, 0
654, 2, 1636424003397, 1636424013397, 10000, 0, 10000, 0, 0, 0
715, 1, 1636424012824, 1636424013460, 636, 182, 454, 182, 0, 182
714, 1, 1636424012725, 1636424013461, 736, 281, 455, 281, 0, 281
717, 1, 1636424013353, 1636424013801, 448, 0, 448, 0, 0, 0
716, 1, 1636424013148, 1636424013917, 769, 314, 455, 312, 1, 313
658, 2, 1636424003944, 1636424013944, 10000, 0, 10000, 0, 0, 0
719, 1, 1636424013708, 1636424014172, 464, 1, 463, 0, 0, 0
718, 1, 1636424013704, 1636424014173, 469, 1, 468, 0, 0, 0
720, 1, 1636424013765, 1636424014369, 604, 153, 451, 152, 0, 152
663, 2, 1636424004586, 1636424014588, 10002, 0, 10002, 0, 0, 0
721, 1, 1636424013992, 1636424014629, 637, 182, 455, 181, 1, 182
722, 1, 1636424014081, 1636424014629, 548, 93, 455, 92, 1, 93
723, 1, 1636424014316, 1636424014821, 505, 54, 451, 54, 0, 54
724, 1, 1636424014392, 1636424015080, 688, 238, 450, 238, 0, 238
725, 1, 1636424014753, 1636424015213, 460, 0, 460, 0, 0, 0
667, 2, 1636424005301, 1636424015301, 10000, 0, 10000, 0, 0, 0
726, 1, 1636424014941, 1636424015401, 460, 0, 460, 0, 0, 0
728, 1, 1636424014988, 1636424015441, 453, 0, 453, 0, 0, 0
729, 1, 1636424014996, 1636424015453, 457, 0, 457, 0, 0, 0
727, 1, 1636424014964, 1636424015529, 565, 116, 449, 115, 0, 115
730, 1, 1636424015277, 1636424015897, 620, 165, 455, 164, 1, 165
731, 1, 1636424015349, 1636424015913, 564, 105, 459, 105, 0, 105
732, 1, 1636424015509, 1636424015985, 476, 21, 455, 21, 0, 21
733, 1, 1636424015665, 1636424016117, 452, 0, 452, 0, 0, 0
734, 1, 1636424015716, 1636424016357, 641, 182, 459, 181, 0, 181
735, 1, 1636424016061, 1636424016513, 452, 0, 452, 0, 0, 0
736, 1, 1636424016184, 1636424016632, 448, 1, 447, 0, 1, 1
737, 1, 1636424016273, 1636424016717, 444, 0, 444, 0, 0, 0
739, 1, 1636424016305, 1636424016757, 452, 0, 452, 0, 0, 0
738, 1, 1636424016281, 1636424016809, 528, 77, 451, 77, 0, 77
682, 2, 1636424006900, 1636424016901, 10001, 0, 10001, 0, 0, 0
741, 1, 1636424016652, 1636424017221, 569, 66, 503, 66, 0, 66
740, 1, 1636424016580, 1636424017221, 641, 178, 463, 178, 0, 178
742, 1, 1636424016809, 1636424017312, 503, 1, 502, 1, 0, 1
743, 1, 1636424016948, 1636424017397, 449, 1, 448, 0, 1, 1
686, 2, 1636424007501, 1636424017501, 10000, 0, 10000, 0, 0, 0
744, 1, 1636424017037, 1636424017673, 636, 185, 451, 185, 0, 185
745, 1, 1636424017264, 1636424017729, 465, 0, 465, 0, 0, 0
746, 1, 1636424017356, 1636424017817, 461, 0, 461, 0, 0, 0
747, 1, 1636424017489, 1636424017940, 451, 0, 451, 0, 0, 0
749, 1, 1636424017588, 1636424018045, 457, 1, 456, 0, 0, 0
748, 1, 1636424017593, 1636424018052, 459, 0, 459, 0, 0, 0
750, 1, 1636424017593, 1636424018125, 532, 81, 451, 81, 0, 81
692, 2, 1636424008237, 1636424018241, 10004, 0, 10004, 0, 0, 0
751, 1, 1636424017873, 1636424018329, 456, 0, 456, 0, 0, 0
752, 1, 1636424017873, 1636424018497, 624, 173, 451, 173, 0, 173
753, 1, 1636424017964, 1636424018509, 545, 88, 457, 87, 0, 87
754, 1, 1636424018092, 1636424018568, 476, 33, 443, 33, 0, 33
755, 1, 1636424018196, 1636424018648, 452, 1, 451, 0, 1, 1
696, 2, 1636424008893, 1636424018893, 10000, 0, 10000, 0, 0, 0
756, 1, 1636424018332, 1636424018961, 629, 166, 463, 165, 0, 165
757, 1, 1636424018493, 1636424018961, 468, 17, 451, 16, 1, 17
758, 1, 1636424018592, 1636424019044, 452, 1, 451, 0, 0, 0
759, 1, 1636424018712, 1636424019212, 500, 1, 499, 0, 0, 0
760, 1, 1636424018800, 1636424019253, 453, 1, 452, 0, 0, 0
763, 1, 1636424018940, 1636424019389, 449, 1, 448, 0, 1, 1
762, 1, 1636424018877, 1636424019417, 540, 85, 455, 84, 1, 85
761, 1, 1636424018860, 1636424019420, 560, 102, 458, 101, 0, 101
700, 2, 1636424009500, 1636424019501, 10001, 0, 10001, 1, 0, 1
766, 1, 1636424019252, 1636424019724, 472, 0, 472, 0, 0, 0
767, 1, 1636424019349, 1636424019841, 492, 40, 452, 40, 0, 40
765, 1, 1636424019157, 1636424019908, 751, 264, 487, 264, 0, 264
768, 1, 1636424019360, 1636424019912, 552, 58, 494, 56, 0, 56
769, 1, 1636424019548, 1636424019992, 444, 1, 443, 0, 0, 0
703, 2, 1636424010057, 1636424020057, 10000, 0, 10000, 0, 0, 0
771, 1, 1636424019780, 1636424020229, 449, 1, 448, 0, 1, 1
772, 1, 1636424019861, 1636424020308, 447, 0, 447, 0, 0, 0
774, 1, 1636424020053, 1636424020509, 456, 0, 456, 0, 0, 0
775, 1, 1636424020148, 1636424020604, 456, 1, 455, 0, 1, 1
705, 2, 1636424010604, 1636424020605, 10001, 0, 10001, 0, 0, 0
777, 1, 1636424020196, 1636424020648, 452, 1, 451, 0, 0, 0
778, 1, 1636424020292, 1636424020737, 445, 1, 444, 0, 0, 0
779, 1, 1636424020424, 1636424020929, 505, 1, 504, 1, 0, 1
781, 1, 1636424020516, 1636424021108, 592, 133, 459, 132, 0, 132
783, 1, 1636424020740, 1636424021192, 452, 1, 451, 0, 1, 1
784, 1, 1636424020804, 1636424021253, 449, 1, 448, 0, 0, 0
708, 2, 1636424011285, 1636424021285, 10000, 0, 10000, 0, 0, 0
785, 1, 1636424020956, 1636424021412, 456, 1, 455, 0, 0, 0
787, 1, 1636424021092, 1636424021545, 453, 1, 452, 0, 1, 1
709, 2, 1636424011788, 1636424021788, 10000, 0, 10000, 0, 0, 0
788, 1, 1636424021376, 1636424021824, 448, 1, 447, 0, 1, 1
790, 1, 1636424021548, 1636424022008, 460, 1, 459, 0, 0, 0
791, 1, 1636424021649, 1636424022096, 447, 0, 447, 0, 0, 0
793, 1, 1636424021636, 1636424022104, 468, 1, 467, 0, 0, 0
711, 1, 1636424012388, 1636424022240, 9852, 9401, 451, 0, 9400, 9400
794, 1, 1636424021876, 1636424022460, 584, 133, 451, 133, 0, 133
797, 1, 1636424022108, 1636424022552, 444, 1, 443, 0, 0, 0
796, 1, 1636424022140, 1636424022592, 452, 1, 451, 0, 0, 0
799, 1, 1636424022416, 1636424022869, 453, 0, 453, 0, 0, 0
800, 1, 1636424022476, 1636424023044, 568, 117, 451, 117, 0, 117
801, 1, 1636424022688, 1636424023141, 453, 1, 452, 0, 0, 0
803, 1, 1636424022936, 1636424023385, 449, 1, 448, 0, 0, 0
804, 1, 1636424022977, 1636424023432, 455, 0, 455, 0, 0, 0
805, 1, 1636424023261, 1636424023840, 579, 125, 454, 124, 0, 124
807, 1, 1636424023497, 1636424023953, 456, 0, 456, 0, 0, 0
810, 1, 1636424023989, 1636424024436, 447, 0, 447, 0, 0, 0
811, 1, 1636424024285, 1636424024733, 448, 0, 448, 0, 0, 0
812, 1, 1636424024297, 1636424024740, 443, 0, 443, 0, 0, 0
813, 1, 1636424024617, 1636424025189, 572, 117, 455, 116, 1, 117
814, 1, 1636424024825, 1636424025277, 452, 0, 452, 0, 0, 0
815, 1, 1636424025265, 1636424025712, 447, 0, 447, 0, 0, 0
816, 1, 1636424025553, 1636424026009, 456, 0, 456, 0, 0, 0
817, 1, 1636424025625, 1636424026077, 452, 0, 452, 0, 0, 0
818, 1, 1636424025949, 1636424026469, 520, 61, 459, 61, 0, 61
819, 1, 1636424026128, 1636424026581, 453, 1, 452, 0, 0, 0
820, 1, 1636424026652, 1636424027104, 452, 1, 451, 0, 1, 1
821, 1, 1636424026861, 1636424027317, 456, 0, 456, 0, 0, 0
822, 1, 1636424027021, 1636424027477, 456, 0, 456, 0, 0, 0
823, 1, 1636424027256, 1636424027769, 513, 61, 452, 61, 0, 61
824, 1, 1636424027473, 1636424027933, 460, 5, 455, 5, 0, 5
825, 1, 1636424028033, 1636424028484, 451, 0, 451, 0, 0, 0
826, 1, 1636424028205, 1636424028657, 452, 0, 452, 0, 0, 0
827, 1, 1636424028373, 1636424028825, 452, 0, 452, 0, 0, 0
764, 2, 1636424019096, 1636424029101, 10005, 0, 10005, 812, 0, 812
828, 1, 1636424028585, 1636424029104, 519, 72, 447, 72, 0, 72
829, 1, 1636424028825, 1636424029329, 504, 1, 503, 0, 0, 0
770, 2, 1636424019632, 1636424029637, 10005, 0, 10005, 277, 0, 277
830, 1, 1636424029317, 1636424029769, 452, 0, 452, 0, 0, 0
773, 2, 1636424019824, 1636424029825, 10001, 0, 10001, 85, 0, 85
831, 1, 1636424029557, 1636424030052, 495, 0, 495, 0, 0, 0
776, 2, 1636424020192, 1636424030196, 10004, 0, 10004, 1, 0, 1
832, 1, 1636424029773, 1636424030236, 463, 0, 463, 0, 0, 0
780, 2, 1636424020488, 1636424030488, 10000, 0, 10000, 0, 0, 0
833, 1, 1636424029965, 1636424030509, 544, 88, 456, 88, 0, 88
782, 2, 1636424020700, 1636424030697, 9997, 0, 9997, 0, 0, 0
836, 1, 1636424030240, 1636424030713, 473, 1, 472, 0, 1, 1
835, 1, 1636424030240, 1636424030713, 473, 1, 472, 0, 1, 1
837, 1, 1636424030184, 1636424030713, 529, 53, 476, 53, 0, 53
786, 2, 1636424021089, 1636424031088, 9999, 0, 9999, 0, 0, 0
839, 1, 1636424030628, 1636424031104, 476, 0, 476, 0, 0, 0
834, 1, 1636424030240, 1636424031177, 937, 474, 463, 474, 0, 474
838, 1, 1636424030532, 1636424031177, 645, 182, 463, 182, 0, 182
841, 1, 1636424030952, 1636424031408, 456, 1, 455, 0, 0, 0
789, 2, 1636424021420, 1636424031421, 10001, 0, 10001, 0, 0, 0
843, 1, 1636424031057, 1636424031508, 451, 0, 451, 0, 0, 0
792, 2, 1636424021621, 1636424031620, 9999, 0, 9999, 0, 0, 0
840, 1, 1636424030796, 1636424031645, 849, 382, 467, 382, 0, 382
842, 1, 1636424031012, 1636424031645, 633, 166, 467, 166, 0, 166
844, 1, 1636424031329, 1636424031869, 540, 80, 460, 80, 0, 80
849, 1, 1636424031516, 1636424031969, 453, 1, 452, 0, 1, 1
848, 1, 1636424031516, 1636424031969, 453, 1, 452, 0, 1, 1
795, 2, 1636424022092, 1636424032093, 10001, 0, 10001, 0, 0, 0
845, 1, 1636424031396, 1636424032100, 704, 250, 454, 248, 0, 248
850, 1, 1636424031724, 1636424032177, 453, 1, 452, 0, 0, 0
798, 2, 1636424022200, 1636424032204, 10004, 0, 10004, 0, 0, 0
851, 1, 1636424031757, 1636424032429, 672, 213, 459, 213, 0, 213
853, 1, 1636424032008, 1636424032548, 540, 93, 447, 92, 0, 92
855, 1, 1636424032252, 1636424032709, 457, 1, 456, 0, 0, 0
857, 1, 1636424032365, 1636424032817, 452, 0, 452, 0, 0, 0
858, 1, 1636424032400, 1636424032849, 449, 0, 449, 0, 0, 0
802, 2, 1636424022877, 1636424032877, 10000, 0, 10000, 0, 0, 0
856, 1, 1636424032300, 1636424032888, 588, 130, 458, 128, 0, 128
859, 1, 1636424032513, 1636424033000, 487, 37, 450, 36, 0, 36
861, 1, 1636424032632, 1636424033197, 565, 77, 488, 76, 0, 76
862, 1, 1636424032796, 1636424033289, 493, 22, 471, 22, 0, 22
863, 1, 1636424032849, 1636424033301, 452, 0, 452, 0, 0, 0
806, 2, 1636424023377, 1636424033377, 10000, 0, 10000, 0, 0, 0
852, 1, 1636424031928, 1636424033453, 1525, 1073, 452, 1073, 0, 1073
864, 1, 1636424033028, 1636424033485, 457, 1, 456, 0, 0, 0
808, 2, 1636424023708, 1636424033712, 10004, 0, 10004, 0, 0, 0
809, 2, 1636424023760, 1636424033761, 10001, 9952, 49, 1, 9952, 9953
865, 1, 1636424033097, 1636424033784, 687, 205, 482, 204, 0, 204
867, 1, 1636424033424, 1636424033877, 453, 1, 452, 0, 0, 0
866, 1, 1636424033189, 1636424033984, 795, 265, 530, 265, 0, 265
868, 1, 1636424033568, 1636424034028, 460, 1, 459, 0, 0, 0
872, 1, 1636424033672, 1636424034177, 505, 1, 504, 0, 0, 0
871, 1, 1636424033700, 1636424034177, 477, 1, 476, 0, 0, 0
873, 1, 1636424033704, 1636424034177, 473, 1, 472, 0, 0, 0
869, 1, 1636424033621, 1636424034240, 619, 164, 455, 164, 0, 164
870, 1, 1636424033692, 1636424034433, 741, 293, 448, 292, 0, 292
875, 1, 1636424033969, 1636424034480, 511, 61, 450, 60, 1, 61
876, 1, 1636424034028, 1636424034480, 452, 1, 451, 0, 0, 0
878, 1, 1636424034092, 1636424034633, 541, 86, 455, 84, 0, 84
879, 1, 1636424034216, 1636424034668, 452, 1, 451, 0, 0, 0
880, 1, 1636424034364, 1636424034812, 448, 0, 448, 0, 0, 0
877, 1, 1636424034040, 1636424034884, 844, 393, 451, 393, 0, 393
882, 1, 1636424034453, 1636424035112, 659, 216, 443, 216, 0, 216
883, 1, 1636424034697, 1636424035148, 451, 0, 451, 0, 0, 0
884, 1, 1636424034877, 1636424035328, 451, 0, 451, 0, 0, 0
888, 1, 1636424035037, 1636424035484, 447, 0, 447, 0, 0, 0
889, 1, 1636424035040, 1636424035497, 457, 1, 456, 1, 0, 1
886, 1, 1636424034980, 1636424035561, 581, 133, 448, 132, 0, 132
887, 1, 1636424034992, 1636424035605, 613, 158, 455, 158, 0, 158
892, 1, 1636424035304, 1636424035757, 453, 1, 452, 0, 0, 0
890, 1, 1636424035236, 1636424035785, 549, 93, 456, 92, 0, 92
894, 1, 1636424035481, 1636424035932, 451, 0, 451, 0, 0, 0
893, 1, 1636424035364, 1636424036056, 692, 242, 450, 242, 0, 242
896, 1, 1636424035760, 1636424036213, 453, 1, 452, 0, 0, 0
895, 1, 1636424035733, 1636424036388, 655, 201, 454, 200, 0, 200
897, 1, 1636424035969, 1636424036421, 452, 0, 452, 0, 0, 0
898, 1, 1636424036181, 1636424036632, 451, 0, 451, 0, 0, 0
900, 1, 1636424036360, 1636424036812, 452, 1, 451, 0, 0, 0
899, 1, 1636424036265, 1636424036841, 576, 124, 452, 124, 0, 124
901, 1, 1636424036424, 1636424036877, 453, 1, 452, 0, 1, 1
902, 1, 1636424036441, 1636424036889, 448, 0, 448, 0, 0, 0
903, 1, 1636424036512, 1636424037084, 572, 121, 451, 121, 0, 121
904, 1, 1636424036664, 1636424037113, 449, 0, 449, 0, 0, 0
906, 1, 1636424036800, 1636424037253, 453, 1, 452, 0, 0, 0
905, 1, 1636424036736, 1636424037269, 533, 77, 456, 76, 0, 76
907, 1, 1636424037057, 1636424037508, 451, 0, 451, 0, 0, 0
908, 1, 1636424037065, 1636424037709, 644, 188, 456, 188, 0, 188
909, 1, 1636424037269, 1636424037720, 451, 0, 451, 0, 0, 0
910, 1, 1636424037525, 1636424037976, 451, 0, 451, 0, 0, 0
911, 1, 1636424037548, 1636424038168, 620, 162, 458, 161, 0, 161
913, 1, 1636424037729, 1636424038176, 447, 0, 447, 0, 0, 0
914, 1, 1636424037801, 1636424038252, 451, 0, 451, 0, 0, 0
915, 1, 1636424037880, 1636424038428, 548, 97, 451, 96, 0, 96
917, 1, 1636424038052, 1636424038505, 453, 1, 452, 1, 0, 1
918, 1, 1636424038148, 1636424038601, 453, 1, 452, 0, 1, 1
919, 1, 1636424038381, 1636424038833, 452, 0, 452, 0, 0, 0
920, 1, 1636424038405, 1636424039064, 659, 197, 462, 197, 0, 197
921, 1, 1636424038652, 1636424039101, 449, 1, 448, 0, 0, 0
924, 1, 1636424039036, 1636424039480, 444, 1, 443, 0, 0, 0
923, 1, 1636424038901, 1636424039516, 615, 164, 451, 164, 0, 164
925, 1, 1636424039072, 1636424039553, 481, 30, 451, 30, 0, 30
927, 1, 1636424039317, 1636424039777, 460, 0, 460, 0, 0, 0
928, 1, 1636424039464, 1636424039917, 453, 0, 453, 0, 0, 0
930, 1, 1636424039769, 1636424040220, 451, 0, 451, 0, 0, 0
929, 1, 1636424039713, 1636424040369, 656, 205, 451, 205, 0, 205
931, 1, 1636424039981, 1636424040432, 451, 0, 451, 0, 0, 0
932, 1, 1636424040197, 1636424040824, 627, 173, 454, 172, 0, 172
933, 1, 1636424040376, 1636424040832, 456, 0, 456, 0, 0, 0
934, 1, 1636424040384, 1636424040832, 448, 0, 448, 0, 0, 0
935, 1, 1636424040597, 1636424041049, 452, 0, 452, 0, 0, 0
936, 1, 1636424040765, 1636424041217, 452, 0, 452, 0, 0, 0
847, 2, 1636424031468, 1636424041468, 10000, 0, 10000, 0, 0, 0
846, 2, 1636424031468, 1636424041513, 10045, 0, 10045, 0, 0, 0
938, 1, 1636424041089, 1636424041541, 452, 0, 452, 0, 0, 0
937, 1, 1636424041044, 1636424041732, 688, 174, 514, 173, 1, 174
939, 1, 1636424041365, 1636424041832, 467, 0, 467, 0, 0, 0
854, 2, 1636424032029, 1636424042029, 10000, 0, 10000, 0, 0, 0
941, 1, 1636424041669, 1636424042120, 451, 0, 451, 0, 0, 0
942, 1, 1636424041700, 1636424042153, 453, 1, 452, 1, 0, 1
940, 1, 1636424041557, 1636424042177, 620, 176, 444, 176, 0, 176
944, 1, 1636424041776, 1636424042256, 480, 1, 479, 1, 0, 1
945, 1, 1636424041945, 1636424042441, 496, 0, 496, 0, 0, 0
946, 1, 1636424042116, 1636424042569, 453, 0, 453, 0, 0, 0
860, 2, 1636424032632, 1636424042633, 10001, 0, 10001, 0, 0, 0
943, 1, 1636424041780, 1636424042708, 928, 477, 451, 476, 0, 476
948, 1, 1636424042393, 1636424042861, 468, 0, 468, 0, 0, 0
949, 1, 1636424042396, 1636424043044, 648, 174, 474, 173, 1, 174
950, 1, 1636424042680, 1636424043121, 441, 1, 440, 0, 0, 0
947, 1, 1636424042337, 1636424043165, 828, 371, 457, 371, 0, 371
953, 1, 1636424043000, 1636424043449, 449, 1, 448, 0, 0, 0
954, 1, 1636424043020, 1636424043472, 452, 1, 451, 0, 0, 0
955, 1, 1636424043033, 1636424043480, 447, 0, 447, 0, 0, 0
951, 1, 1636424042844, 1636424043492, 648, 201, 447, 200, 0, 200
952, 1, 1636424042945, 1636424043625, 680, 220, 460, 220, 0, 220
957, 1, 1636424043224, 1636424043677, 453, 1, 452, 0, 0, 0
874, 2, 1636424033756, 1636424043757, 10001, 0, 10001, 0, 0, 0
958, 1, 1636424043449, 1636424043901, 452, 0, 452, 0, 0, 0
956, 1, 1636424043085, 1636424043977, 892, 396, 496, 396, 0, 396
960, 1, 1636424043800, 1636424044253, 453, 1, 452, 0, 0, 0
961, 1, 1636424043800, 1636424044353, 553, 102, 451, 101, 1, 102
962, 1, 1636424043969, 1636424044421, 452, 0, 452, 0, 0, 0
959, 1, 1636424043604, 1636424044428, 824, 374, 450, 372, 1, 373
881, 2, 1636424034432, 1636424044432, 10000, 0, 10000, 0, 0, 0
963, 1, 1636424044065, 1636424044520, 455, 0, 455, 0, 0, 0
966, 1, 1636424044336, 1636424044788, 452, 1, 451, 0, 0, 0
968, 1, 1636424044392, 1636424044840, 448, 1, 447, 0, 1, 1
964, 1, 1636424044212, 1636424044844, 632, 141, 491, 140, 0, 140
967, 1, 1636424044348, 1636424044844, 496, 1, 495, 0, 0, 0
965, 1, 1636424044224, 1636424044877, 653, 205, 448, 204, 0, 204
885, 2, 1636424034924, 1636424044925, 10001, 0, 10001, 1, 0, 1
970, 1, 1636424044568, 1636424045025, 457, 1, 456, 0, 0, 0
971, 1, 1636424044744, 1636424045240, 496, 1, 495, 0, 1, 1
972, 1, 1636424044748, 1636424045240, 492, 0, 492, 0, 0, 0
891, 2, 1636424035268, 1636424045268, 10000, 0, 10000, 0, 0, 0
969, 1, 1636424044424, 1636424045341, 917, 417, 500, 417, 0, 417
975, 1, 1636424045109, 1636424045585, 476, 0, 476, 0, 0, 0
974, 1, 1636424045081, 1636424045676, 595, 160, 435, 160, 0, 160
976, 1, 1636424045232, 1636424045696, 464, 9, 455, 9, 0, 9
977, 1, 1636424045312, 1636424045752, 440, 1, 439, 0, 0, 0
973, 1, 1636424044972, 1636424045788, 816, 370, 446, 368, 1, 369
978, 1, 1636424045356, 1636424045801, 445, 1, 444, 1, 0, 1
979, 1, 1636424045548, 1636424046117, 569, 129, 440, 129, 0, 129
982, 1, 1636424045688, 1636424046129, 441, 1, 440, 0, 0, 0
980, 1, 1636424045617, 1636424046141, 524, 80, 444, 80, 0, 80
983, 1, 1636424045716, 1636424046168, 452, 1, 451, 0, 0, 0
984, 1, 1636424045728, 1636424046172, 444, 1, 443, 0, 0, 0
981, 1, 1636424045576, 1636424046233, 657, 213, 444, 213, 0, 213
986, 1, 1636424045928, 1636424046385, 457, 1, 456, 0, 0, 0
987, 1, 1636424046009, 1636424046469, 460, 0, 460, 0, 0, 0
988, 1, 1636424046024, 1636424046476, 452, 1, 451, 0, 0, 0
985, 1, 1636424045740, 1636424046589, 849, 389, 460, 389, 0, 389
991, 1, 1636424046432, 1636424046884, 452, 1, 451, 1, 0, 1
990, 1, 1636424046377, 1636424046921, 544, 100, 444, 100, 0, 100
992, 1, 1636424046520, 1636424046968, 448, 1, 447, 0, 0, 0
989, 1, 1636424046288, 1636424047041, 753, 301, 452, 300, 0, 300
993, 1, 1636424046664, 1636424047113, 449, 1, 448, 1, 0, 1
994, 1, 1636424046701, 1636424047145, 444, 0, 444, 0, 0, 0
995, 1, 1636424046873, 1636424047364, 491, 48, 443, 48, 0, 48
997, 1, 1636424046901, 1636424047405, 504, 68, 436, 68, 0, 68
998, 1, 1636424046968, 1636424047416, 448, 1, 447, 0, 1, 1
999, 1, 1636424047016, 1636424047448, 432, 0, 432, 0, 0, 0
996, 1, 1636424046873, 1636424047476, 603, 168, 435, 168, 0, 168
1000, 1, 1636424047037, 1636424047477, 440, 0, 440, 0, 0, 0
912, 2, 1636424037672, 1636424047673, 10001, 0, 10001, 0, 0, 0
1002, 1, 1636424047320, 1636424047768, 448, 1, 447, 0, 0, 0
1003, 1, 1636424047388, 1636424047833, 445, 1, 444, 1, 0, 1
1004, 1, 1636424047404, 1636424047848, 444, 1, 443, 0, 0, 0
1001, 1, 1636424047045, 1636424047897, 852, 372, 480, 372, 0, 372
916, 2, 1636424038008, 1636424048008, 10000, 0, 10000, 0, 0, 0
1006, 1, 1636424047720, 1636424048173, 453, 0, 453, 0, 0, 0
1007, 1, 1636424047764, 1636424048324, 560, 85, 475, 85, 0, 85
1005, 1, 1636424047585, 1636424048357, 772, 312, 460, 312, 0, 312
1008, 1, 1636424047921, 1636424048421, 500, 0, 500, 0, 0, 0
1010, 1, 1636424047972, 1636424048436, 464, 1, 463, 1, 0, 1
1009, 1, 1636424047993, 1636424048444, 451, 0, 451, 0, 0, 0
1011, 1, 1636424048056, 1636424048500, 444, 0, 444, 0, 0, 0
1017, 1, 1636424048296, 1636424048749, 453, 0, 453, 0, 0, 0
1018, 1, 1636424048308, 1636424048752, 444, 1, 443, 0, 0, 0
1013, 1, 1636424048224, 1636424048776, 552, 101, 451, 101, 0, 101
1012, 1, 1636424048205, 1636424048804, 599, 152, 447, 152, 0, 152
922, 2, 1636424038821, 1636424048821, 10000, 0, 10000, 0, 0, 0
1015, 1, 1636424048272, 1636424048885, 613, 149, 464, 148, 0, 148
1016, 1, 1636424048320, 1636424048888, 568, 124, 444, 124, 0, 124
1020, 1, 1636424048625, 1636424049081, 456, 0, 456, 0, 0, 0
1022, 1, 1636424048776, 1636424049228, 452, 1, 451, 1, 0, 1
926, 1, 1636424039161, 1636424049277, 10116, 9660, 456, 0, 9660, 9660
1025, 1, 1636424049104, 1636424049556, 452, 1, 451, 0, 0, 0
1024, 1, 1636424049128, 1636424049576, 448, 1, 447, 1, 0, 1
1026, 1, 1636424049141, 1636424049685, 544, 88, 456, 88, 0, 88
1028, 1, 1636424049257, 1636424049708, 451, 0, 451, 0, 0, 0
1029, 1, 1636424049285, 1636424049737, 452, 0, 452, 0, 0, 0
1036, 1, 1636424049644, 1636424050092, 448, 0, 448, 0, 0, 0
1034, 1, 1636424049592, 1636424050132, 540, 93, 447, 92, 0, 92
1037, 1, 1636424049685, 1636424050132, 447, 0, 447, 0, 0, 0
1033, 1, 1636424049584, 1636424050181, 597, 153, 444, 153, 0, 153
1038, 1, 1636424049933, 1636424050380, 447, 0, 447, 0, 0, 0
1040, 1, 1636424050421, 1636424050869, 448, 0, 448, 0, 0, 0
1042, 1, 1636424050473, 1636424050925, 452, 0, 452, 0, 0, 0
1044, 1, 1636424050665, 1636424051117, 452, 0, 452, 0, 0, 0
1047, 1, 1636424051021, 1636424051469, 448, 0, 448, 0, 0, 0
1048, 1, 1636424051056, 1636424051508, 452, 0, 452, 0, 0, 0
1046, 1, 1636424050928, 1636424051573, 645, 189, 456, 188, 0, 188
1049, 1, 1636424051313, 1636424051769, 456, 0, 456, 0, 0, 0
1051, 1, 1636424051801, 1636424052253, 452, 0, 452, 0, 0, 0
1052, 1, 1636424051985, 1636424052437, 452, 0, 452, 0, 0, 0
1054, 1, 1636424052312, 1636424052760, 448, 1, 447, 0, 0, 0
1053, 1, 1636424052253, 1636424052893, 640, 185, 455, 185, 0, 185
1056, 1, 1636424052684, 1636424053145, 461, 1, 460, 1, 0, 1
1057, 1, 1636424053125, 1636424053577, 452, 0, 452, 0, 0, 0
1058, 1, 1636424053253, 1636424053709, 456, 0, 456, 0, 0, 0
1060, 1, 1636424053641, 1636424054093, 452, 0, 452, 0, 0, 0
1059, 1, 1636424053545, 1636424054165, 620, 165, 455, 164, 1, 165
1062, 1, 1636424054409, 1636424054861, 452, 0, 452, 0, 0, 0
1063, 1, 1636424054609, 1636424055065, 456, 0, 456, 0, 0, 0
1065, 1, 1636424054937, 1636424055389, 452, 0, 452, 0, 0, 0
1064, 1, 1636424054897, 1636424055521, 624, 168, 456, 168, 0, 168
1066, 1, 1636424055761, 1636424056213, 452, 0, 452, 0, 0, 0
1067, 1, 1636424056001, 1636424056449, 448, 0, 448, 0, 0, 0
1068, 1, 1636424056213, 1636424056665, 452, 0, 452, 0, 0, 0
1069, 1, 1636424056232, 1636424056905, 673, 218, 455, 216, 1, 217
1070, 1, 1636424057153, 1636424057605, 452, 0, 452, 0, 0, 0
1071, 1, 1636424057289, 1636424057745, 456, 0, 456, 0, 0, 0
1073, 1, 1636424057601, 1636424058053, 452, 0, 452, 0, 0, 0
1072, 1, 1636424057537, 1636424058197, 660, 209, 451, 208, 1, 209
1014, 2, 1636424048252, 1636424058253, 10001, 0, 10001, 185, 0, 185
1019, 2, 1636424048384, 1636424058385, 10001, 0, 10001, 52, 0, 52
1021, 2, 1636424048729, 1636424058729, 10000, 0, 10000, 0, 0, 0
1023, 2, 1636424048913, 1636424058912, 9999, 0, 9999, 0, 0, 0
1074, 1, 1636424058476, 1636424058957, 481, 1, 480, 0, 1, 1
1075, 1, 1636424058572, 1636424059041, 469, 0, 469, 0, 0, 0
1027, 2, 1636424049224, 1636424059224, 10000, 0, 10000, 0, 0, 0
1076, 1, 1636424058776, 1636424059228, 452, 1, 451, 1, 0, 1
1030, 2, 1636424049297, 1636424059297, 10000, 0, 10000, 279, 0, 279
1079, 1, 1636424059008, 1636424059465, 457, 1, 456, 0, 0, 0
1031, 2, 1636424049512, 1636424059513, 10001, 0, 10001, 64, 0, 64
1080, 1, 1636424059041, 1636424059541, 500, 0, 500, 0, 0, 0
1078, 1, 1636424058864, 1636424059549, 685, 178, 507, 178, 0, 178
1032, 2, 1636424049528, 1636424059561, 10033, 0, 10033, 0, 0, 0
1035, 2, 1636424049600, 1636424059608, 10008, 0, 10008, 0, 0, 0
1077, 1, 1636424058776, 1636424059828, 1052, 453, 599, 452, 0, 452
1043, 1, 1636424050541, 1636424060057, 9516, 9067, 449, 0, 9067, 9067
1039, 2, 1636424050077, 1636424060076, 9999, 0, 9999, 0, 0, 0
1082, 1, 1636424059656, 1636424060109, 453, 0, 453, 0, 0, 0
1083, 1, 1636424059772, 1636424060216, 444, 0, 444, 0, 0, 0
1081, 1, 1636424059272, 1636424060300, 1028, 556, 472, 556, 0, 556
1085, 1, 1636424059880, 1636424060320, 440, 0, 440, 0, 0, 0
1087, 1, 1636424059872, 1636424060324, 452, 0, 452, 0, 0, 0
1088, 1, 1636424059928, 1636424060393, 465, 0, 465, 0, 0, 0
1041, 2, 1636424050424, 1636424060425, 10001, 0, 10001, 1, 0, 1
1090, 1, 1636424060041, 1636424060497, 456, 0, 456, 0, 0, 0
1089, 1, 1636424060068, 1636424060522, 454, 1, 453, 0, 1, 1
1086, 1, 1636424059908, 1636424060564, 656, 201, 455, 201, 0, 201
1093, 1, 1636424060289, 1636424060740, 451, 0, 451, 0, 0, 0
1094, 1, 1636424060308, 1636424060756, 448, 0, 448, 0, 0, 0
1091, 1, 1636424060213, 1636424060772, 559, 112, 447, 112, 0, 112
1095, 1, 1636424060384, 1636424060828, 444, 1, 443, 1, 0, 1
1045, 2, 1636424050873, 1636424060873, 10000, 0, 10000, 0, 0, 0
1096, 1, 1636424060528, 1636424060977, 449, 1, 448, 1, 0, 1
1097, 1, 1636424060733, 1636424061280, 547, 96, 451, 96, 0, 96
1098, 1, 1636424060825, 1636424061284, 459, 0, 459, 0, 0, 0
1099, 1, 1636424061069, 1636424061517, 448, 0, 448, 0, 0, 0
1100, 1, 1636424061084, 1636424061540, 456, 0, 456, 0, 0, 0
1103, 1, 1636424061176, 1636424061624, 448, 0, 448, 0, 0, 0
1104, 1, 1636424061184, 1636424061628, 444, 0, 444, 0, 0, 0
1102, 1, 1636424061176, 1636424061733, 557, 109, 448, 108, 1, 109
1101, 1, 1636424061180, 1636424061733, 553, 101, 452, 101, 0, 101
1050, 2, 1636424051772, 1636424061773, 10001, 0, 10001, 0, 0, 0
1105, 1, 1636424061329, 1636424061784, 455, 0, 455, 0, 0, 0
1108, 1, 1636424061581, 1636424062032, 451, 0, 451, 0, 0, 0
1109, 1, 1636424061617, 1636424062093, 476, 0, 476, 0, 0, 0
1107, 1, 1636424061464, 1636424062093, 629, 161, 468, 160, 0, 160
1106, 1, 1636424061357, 1636424062177, 820, 377, 443, 377, 0, 377
1111, 1, 1636424061820, 1636424062269, 449, 0, 449, 0, 0, 0
1055, 2, 1636424052356, 1636424062356, 10000, 0, 10000, 0, 0, 0
1112, 1, 1636424061956, 1636424062484, 528, 77, 451, 77, 0, 77
1113, 1, 1636424062076, 1636424062672, 596, 101, 495, 101, 0, 101
1061, 1, 1636424053993, 1636424062809, 8816, 8364, 452, 0, 8363, 8363
1115, 1, 1636424062404, 1636424062845, 441, 1, 440, 1, 0, 1
1117, 1, 1636424062448, 1636424062896, 448, 0, 448, 0, 0, 0
1116, 1, 1636424062404, 1636424062940, 536, 81, 455, 81, 0, 81
1122, 1, 1636424062652, 1636424063104, 452, 1, 451, 0, 0, 0
1123, 1, 1636424062657, 1636424063117, 460, 0, 460, 0, 0, 0
1121, 1, 1636424062657, 1636424063125, 468, 16, 452, 16, 0, 16
1125, 1, 1636424062884, 1636424063349, 465, 13, 452, 12, 0, 12
1127, 1, 1636424063045, 1636424063577, 532, 80, 452, 80, 0, 80
1128, 1, 1636424063141, 1636424063605, 464, 0, 464, 0, 0, 0
1130, 1, 1636424063317, 1636424063773, 456, 0, 456, 0, 0, 0
1129, 1, 1636424063229, 1636424063804, 575, 120, 455, 120, 0, 120
1132, 1, 1636424063701, 1636424064252, 551, 104, 447, 103, 0, 103
1134, 1, 1636424063852, 1636424064301, 449, 1, 448, 0, 0, 0
1135, 1, 1636424064005, 1636424064457, 452, 0, 452, 0, 0, 0
1136, 1, 1636424064005, 1636424064461, 456, 0, 456, 0, 0, 0
1138, 1, 1636424064309, 1636424064760, 451, 0, 451, 0, 0, 0
1139, 1, 1636424064541, 1636424065001, 460, 0, 460, 0, 0, 0
1141, 1, 1636424064625, 1636424065077, 452, 0, 452, 0, 0, 0
1143, 1, 1636424065164, 1636424065617, 453, 0, 453, 0, 0, 0
1144, 1, 1636424065321, 1636424065769, 448, 0, 448, 0, 0, 0
1145, 1, 1636424065357, 1636424065805, 448, 0, 448, 0, 0, 0
1146, 1, 1636424065617, 1636424066073, 456, 1, 455, 1, 0, 1
1147, 1, 1636424065869, 1636424066317, 448, 0, 448, 0, 0, 0
1150, 1, 1636424066620, 1636424067077, 457, 1, 456, 0, 0, 0
1151, 1, 1636424066753, 1636424067205, 452, 0, 452, 0, 0, 0
1153, 1, 1636424067169, 1636424067621, 452, 0, 452, 0, 0, 0
1154, 1, 1636424067973, 1636424068429, 456, 0, 456, 0, 0, 0
1155, 1, 1636424068057, 1636424068509, 452, 0, 452, 0, 0, 0
1156, 1, 1636424068505, 1636424068957, 452, 0, 452, 0, 0, 0
1158, 1, 1636424069365, 1636424069820, 455, 1, 454, 0, 0, 0
1157, 1, 1636424069365, 1636424069820, 455, 0, 455, 0, 0, 0
1084, 2, 1636424059872, 1636424069877, 10005, 0, 10005, 429, 0, 429
1092, 2, 1636424060296, 1636424070297, 10001, 0, 10001, 4, 0, 4
1159, 1, 1636424069925, 1636424070380, 455, 0, 455, 0, 0, 0
1162, 1, 1636424070677, 1636424071129, 452, 0, 452, 0, 0, 0
1163, 1, 1636424070688, 1636424071141, 453, 1, 452, 0, 0, 0
1110, 2, 1636424061656, 1636424071657, 10001, 0, 10001, 1, 0, 1
1164, 1, 1636424071225, 1636424071676, 451, 0, 451, 0, 0, 0
1114, 2, 1636424062216, 1636424072217, 10001, 0, 10001, 0, 0, 0
1166, 1, 1636424071980, 1636424072441, 461, 0, 461, 0, 0, 0
1167, 1, 1636424071988, 1636424072441, 453, 0, 453, 0, 0, 0
1119, 2, 1636424062488, 1636424072488, 10000, 0, 10000, 0, 0, 0
1118, 2, 1636424062488, 1636424072536, 10048, 0, 10048, 0, 0, 0
1120, 1, 1636424062533, 1636424072665, 10132, 9684, 448, 0, 9684, 9684
1124, 2, 1636424062761, 1636424072761, 10000, 0, 10000, 0, 0, 0
1126, 2, 1636424062996, 1636424072997, 10001, 0, 10001, 0, 0, 0
1169, 1, 1636424072580, 1636424073029, 449, 1, 448, 1, 0, 1
1170, 1, 1636424072809, 1636424073260, 451, 0, 451, 0, 0, 0
1171, 1, 1636424072809, 1636424073260, 451, 0, 451, 0, 0, 0
1131, 2, 1636424063669, 1636424073669, 10000, 0, 10000, 0, 0, 0
1173, 1, 1636424073088, 1636424073713, 625, 173, 452, 172, 0, 172
1174, 1, 1636424073304, 1636424073748, 444, 1, 443, 0, 1, 1
1133, 2, 1636424063793, 1636424073792, 9999, 0, 9999, 0, 0, 0
1175, 1, 1636424073373, 1636424073821, 448, 0, 448, 0, 0, 0
1176, 1, 1636424073381, 1636424073825, 444, 0, 444, 0, 0, 0
1137, 2, 1636424064241, 1636424074240, 9999, 0, 9999, 0, 0, 0
1177, 1, 1636424073925, 1636424074369, 444, 0, 444, 0, 0, 0
1178, 1, 1636424073985, 1636424074473, 488, 0, 488, 0, 0, 0
1180, 1, 1636424074016, 1636424074473, 457, 1, 456, 0, 0, 0
1179, 1, 1636424074012, 1636424074473, 461, 1, 460, 0, 0, 0
1181, 1, 1636424074097, 1636424074561, 464, 0, 464, 0, 0, 0
1140, 2, 1636424064580, 1636424074581, 10001, 0, 10001, 0, 0, 0
1182, 1, 1636424074288, 1636424074929, 641, 186, 455, 186, 0, 186
1184, 1, 1636424074524, 1636424074993, 469, 1, 468, 1, 0, 1
1183, 1, 1636424074553, 1636424075025, 472, 8, 464, 8, 0, 8
1142, 2, 1636424065077, 1636424075077, 10000, 0, 10000, 0, 0, 0
1185, 1, 1636424074673, 1636424075121, 448, 0, 448, 0, 0, 0
1186, 1, 1636424074748, 1636424075197, 449, 1, 448, 1, 0, 1
1187, 1, 1636424074888, 1636424075493, 605, 137, 468, 137, 0, 137
1188, 1, 1636424075216, 1636424075681, 465, 1, 464, 0, 0, 0
1189, 1, 1636424075293, 1636424075745, 452, 0, 452, 0, 0, 0
1190, 1, 1636424075321, 1636424075769, 448, 0, 448, 0, 0, 0
1193, 1, 1636424075384, 1636424075837, 453, 1, 452, 0, 1, 1
1191, 1, 1636424075392, 1636424075949, 557, 102, 455, 101, 0, 101
1148, 2, 1636424065977, 1636424075977, 10000, 0, 10000, 0, 0, 0
1195, 1, 1636424075772, 1636424076212, 440, 1, 439, 1, 0, 1
1194, 1, 1636424075660, 1636424076289, 629, 177, 452, 176, 0, 176
1196, 1, 1636424075865, 1636424076301, 436, 0, 436, 0, 0, 0
1197, 1, 1636424075952, 1636424076393, 441, 1, 440, 1, 0, 1
1198, 1, 1636424076064, 1636424076513, 449, 0, 449, 0, 0, 0
1149, 2, 1636424066513, 1636424076513, 10000, 0, 10000, 0, 0, 0
1199, 1, 1636424076112, 1636424076669, 557, 101, 456, 101, 0, 101
1200, 1, 1636424076285, 1636424076736, 451, 0, 451, 0, 0, 0
1152, 2, 1636424066984, 1636424076985, 10001, 0, 10001, 0, 0, 0
1201, 1, 1636424076560, 1636424077009, 449, 0, 449, 0, 0, 0
1202, 1, 1636424076604, 1636424077056, 452, 0, 452, 0, 0, 0
1203, 1, 1636424076645, 1636424077097, 452, 0, 452, 0, 0, 0
1204, 1, 1636424076601, 1636424077129, 528, 69, 459, 68, 1, 69
1205, 1, 1636424076748, 1636424077204, 456, 1, 455, 0, 0, 0
1206, 1, 1636424076817, 1636424077296, 479, 0, 479, 0, 0, 0
1192, 1, 1636424075356, 1636424077432, 2076, 1629, 447, 0, 1629, 1629
1208, 1, 1636424077076, 1636424077549, 473, 21, 452, 21, 0, 21
1207, 1, 1636424077032, 1636424077649, 617, 173, 444, 173, 0, 173
1211, 1, 1636424077252, 1636424077697, 445, 0, 445, 0, 0, 0
1209, 1, 1636424077248, 1636424077700, 452, 1, 451, 0, 0, 0
1210, 1, 1636424077292, 1636424077749, 457, 4, 453, 4, 0, 4
1212, 1, 1636424077376, 1636424077833, 457, 0, 457, 0, 0, 0
1214, 1, 1636424077508, 1636424077964, 456, 0, 456, 0, 0, 0
1213, 1, 1636424077384, 1636424078001, 617, 165, 452, 165, 0, 165
1215, 1, 1636424077660, 1636424078112, 452, 1, 451, 0, 1, 1
1217, 1, 1636424077916, 1636424078373, 457, 1, 456, 0, 0, 0
1218, 1, 1636424077928, 1636424078384, 456, 1, 455, 1, 0, 1
1216, 1, 1636424077901, 1636424078456, 555, 100, 455, 100, 0, 100
1219, 1, 1636424078017, 1636424078465, 448, 0, 448, 0, 0, 0
1220, 1, 1636424078068, 1636424078513, 445, 1, 444, 0, 0, 0
1221, 1, 1636424078137, 1636424078589, 452, 0, 452, 0, 0, 0
1223, 1, 1636424078421, 1636424078924, 503, 44, 459, 44, 0, 44
1224, 1, 1636424078512, 1636424078972, 460, 1, 459, 0, 0, 0
1226, 1, 1636424078533, 1636424078976, 443, 0, 443, 0, 0, 0
1225, 1, 1636424078525, 1636424078980, 455, 0, 455, 0, 0, 0
1222, 1, 1636424078384, 1636424079049, 665, 205, 460, 204, 0, 204
1228, 1, 1636424078756, 1636424079208, 452, 1, 451, 0, 0, 0
1229, 1, 1636424078812, 1636424079265, 453, 1, 452, 0, 0, 0
1227, 1, 1636424078736, 1636424079377, 641, 189, 452, 189, 0, 189
1230, 1, 1636424078964, 1636424079412, 448, 1, 447, 0, 0, 0
1231, 1, 1636424079256, 1636424079696, 440, 1, 439, 0, 1, 1
1233, 1, 1636424079296, 1636424079749, 453, 1, 452, 0, 0, 0
1234, 1, 1636424079296, 1636424079749, 453, 1, 452, 0, 0, 0
1235, 1, 1636424079368, 1636424079813, 445, 1, 444, 0, 0, 0
1232, 1, 1636424079276, 1636424079832, 556, 101, 455, 100, 0, 100
1236, 1, 1636424079412, 1636424079856, 444, 1, 443, 0, 1, 1
1238, 1, 1636424079728, 1636424080209, 481, 22, 459, 22, 0, 22
1240, 1, 1636424079813, 1636424080252, 439, 0, 439, 0, 0, 0
1239, 1, 1636424079781, 1636424080264, 483, 32, 451, 32, 0, 32
1237, 1, 1636424079684, 1636424080304, 620, 173, 447, 173, 0, 173
1241, 1, 1636424079920, 1636424080368, 448, 1, 447, 0, 0, 0
1243, 1, 1636424080084, 1636424080536, 452, 1, 451, 1, 0, 1
1161, 2, 1636424070612, 1636424080613, 10001, 0, 10001, 1, 0, 1
1244, 1, 1636424080201, 1636424080648, 447, 0, 447, 0, 0, 0
1242, 1, 1636424080065, 1636424080660, 595, 144, 451, 144, 0, 144
1160, 2, 1636424070612, 1636424080660, 10048, 0, 10048, 1, 0, 1
1245, 1, 1636424080264, 1636424080720, 456, 0, 456, 0, 0, 0
1246, 1, 1636424080564, 1636424081072, 508, 1, 507, 0, 1, 1
1247, 1, 1636424080564, 1636424081076, 512, 1, 511, 0, 1, 1
1248, 1, 1636424080608, 1636424081109, 501, 53, 448, 53, 0, 53
1249, 1, 1636424080708, 1636424081152, 444, 1, 443, 0, 0, 0
1251, 1, 1636424080796, 1636424081240, 444, 1, 443, 0, 1, 1
1254, 1, 1636424080973, 1636424081516, 543, 100, 443, 100, 0, 100
1257, 1, 1636424081204, 1636424081652, 448, 1, 447, 1, 0, 1
1258, 1, 1636424081240, 1636424081684, 444, 1, 443, 1, 0, 1
1256, 1, 1636424081144, 1636424081684, 540, 97, 443, 96, 0, 96
1260, 1, 1636424081384, 1636424081837, 453, 1, 452, 1, 0, 1
1261, 1, 1636424081489, 1636424081944, 455, 0, 455, 0, 0, 0
1165, 2, 1636424071964, 1636424081964, 10000, 0, 10000, 0, 0, 0
1262, 1, 1636424081557, 1636424082008, 451, 0, 451, 0, 0, 0
1264, 1, 1636424081900, 1636424082373, 473, 1, 472, 0, 0, 0
1265, 1, 1636424081929, 1636424082388, 459, 0, 459, 0, 0, 0
1267, 1, 1636424082056, 1636424082513, 457, 1, 456, 0, 1, 1
1168, 2, 1636424072580, 1636424082537, 9957, 0, 9957, 1, 0, 1
1269, 1, 1636424082337, 1636424082784, 447, 0, 447, 0, 0, 0
1270, 1, 1636424082425, 1636424082969, 544, 89, 455, 89, 0, 89
1271, 1, 1636424082537, 1636424082988, 451, 0, 451, 0, 0, 0
1172, 1, 1636424072888, 1636424082992, 10104, 9649, 455, 0, 9649, 9649
1272, 1, 1636424082628, 1636424083077, 449, 0, 449, 0, 0, 0
1274, 1, 1636424082772, 1636424083224, 452, 1, 451, 0, 1, 1
1276, 1, 1636424082900, 1636424083352, 452, 1, 451, 0, 0, 0
1278, 1, 1636424083269, 1636424083716, 447, 0, 447, 0, 0, 0
1279, 1, 1636424083288, 1636424083740, 452, 1, 451, 0, 0, 0
1281, 1, 1636424083693, 1636424084145, 452, 0, 452, 0, 0, 0
1283, 1, 1636424083877, 1636424084325, 448, 0, 448, 0, 0, 0
1284, 1, 1636424083964, 1636424084417, 453, 1, 452, 0, 0, 0
1285, 1, 1636424084161, 1636424084617, 456, 0, 456, 0, 0, 0
1286, 1, 1636424084249, 1636424084696, 447, 0, 447, 0, 0, 0
1287, 1, 1636424084653, 1636424085100, 447, 0, 447, 0, 0, 0
1288, 1, 1636424084657, 1636424085104, 447, 0, 447, 0, 0, 0
1289, 1, 1636424084973, 1636424085424, 451, 0, 451, 0, 0, 0
1290, 1, 1636424085164, 1636424085617, 453, 0, 453, 0, 0, 0
1291, 1, 1636424085305, 1636424085757, 452, 0, 452, 0, 0, 0
1292, 1, 1636424085453, 1636424085909, 456, 0, 456, 0, 0, 0
1293, 1, 1636424085625, 1636424086077, 452, 0, 452, 0, 0, 0
1294, 1, 1636424085948, 1636424086396, 448, 1, 447, 0, 0, 0
1295, 1, 1636424086037, 1636424086481, 444, 0, 444, 0, 0, 0
1296, 1, 1636424086340, 1636424086849, 509, 57, 452, 57, 0, 57
1298, 1, 1636424086677, 1636424087129, 452, 0, 452, 0, 0, 0
1299, 1, 1636424086729, 1636424087177, 448, 0, 448, 0, 0, 0
1300, 1, 1636424086904, 1636424087353, 449, 0, 449, 0, 0, 0
1301, 1, 1636424087233, 1636424087685, 452, 0, 452, 0, 0, 0
1302, 1, 1636424087389, 1636424087841, 452, 0, 452, 0, 0, 0
1303, 1, 1636424087721, 1636424088173, 452, 0, 452, 0, 0, 0
1304, 1, 1636424088021, 1636424088473, 452, 0, 452, 0, 0, 0
1306, 1, 1636424088277, 1636424088733, 456, 0, 456, 0, 0, 0
1308, 1, 1636424088757, 1636424089201, 444, 0, 444, 0, 0, 0
1309, 1, 1636424089013, 1636424089465, 452, 0, 452, 0, 0, 0
1310, 1, 1636424089389, 1636424089841, 452, 0, 452, 0, 0, 0
1311, 1, 1636424089629, 1636424090081, 452, 0, 452, 0, 0, 0
1312, 1, 1636424090113, 1636424090565, 452, 0, 452, 0, 0, 0
1250, 2, 1636424080752, 1636424090757, 10005, 0, 10005, 765, 0, 765
1313, 1, 1636424090325, 1636424090777, 452, 0, 452, 0, 0, 0
1253, 2, 1636424080932, 1636424090929, 9997, 0, 9997, 1, 0, 1
1252, 2, 1636424080932, 1636424090973, 10041, 0, 10041, 0, 0, 0
1255, 2, 1636424081041, 1636424091041, 10000, 0, 10000, 476, 0, 476
1314, 1, 1636424090805, 1636424091285, 480, 0, 480, 0, 0, 0
1259, 2, 1636424081368, 1636424091369, 10001, 0, 10001, 148, 0, 148
1315, 1, 1636424091020, 1636424091477, 457, 1, 456, 1, 0, 1
1263, 2, 1636424081892, 1636424091893, 10001, 0, 10001, 0, 0, 0
1266, 2, 1636424081937, 1636424091940, 10003, 0, 10003, 0, 0, 0
1318, 1, 1636424091505, 1636424091956, 451, 0, 451, 0, 0, 0
1319, 1, 1636424091673, 1636424092164, 491, 0, 491, 0, 0, 0
1268, 2, 1636424082277, 1636424092277, 10000, 0, 10000, 0, 0, 0
1320, 1, 1636424091832, 1636424092356, 524, 1, 523, 0, 1, 1
1273, 2, 1636424082768, 1636424092769, 10001, 0, 10001, 1, 0, 1
1275, 2, 1636424082884, 1636424092885, 10001, 0, 10001, 0, 0, 0
1277, 2, 1636424083213, 1636424093212, 9999, 0, 9999, 0, 0, 0
1280, 2, 1636424083340, 1636424093341, 10001, 0, 10001, 0, 0, 0
1329, 1, 1636424093021, 1636424093473, 452, 0, 452, 0, 0, 0
1331, 1, 1636424093077, 1636424093573, 496, 0, 496, 0, 0, 0
1326, 1, 1636424092249, 1636424093669, 1420, 963, 457, 0, 963, 963
1282, 2, 1636424083713, 1636424093713, 10000, 0, 10000, 0, 0, 0
1335, 1, 1636424093893, 1636424094345, 452, 0, 452, 0, 0, 0
1337, 1, 1636424094356, 1636424094805, 449, 1, 448, 1, 0, 1
1339, 1, 1636424095173, 1636424095625, 452, 0, 452, 0, 0, 0
1340, 1, 1636424095657, 1636424096109, 452, 0, 452, 0, 0, 0
1297, 2, 1636424086448, 1636424096449, 10001, 0, 10001, 0, 0, 0
1341, 1, 1636424096496, 1636424096948, 452, 1, 451, 0, 1, 1
1343, 1, 1636424097029, 1636424097485, 456, 0, 456, 0, 0, 0
1305, 2, 1636424088057, 1636424098057, 10000, 0, 10000, 0, 0, 0
1344, 1, 1636424097745, 1636424098201, 456, 0, 456, 0, 0, 0
1307, 2, 1636424088557, 1636424098557, 10000, 0, 10000, 0, 0, 0
1345, 1, 1636424098301, 1636424098781, 480, 0, 480, 0, 0, 0
1346, 1, 1636424098369, 1636424098820, 451, 0, 451, 0, 0, 0
1347, 1, 1636424098864, 1636424099325, 461, 1, 460, 1, 0, 1
1348, 1, 1636424099016, 1636424099469, 453, 1, 452, 0, 1, 1
1349, 1, 1636424099613, 1636424100060, 447, 0, 447, 0, 0, 0
1350, 1, 1636424099693, 1636424100145, 452, 0, 452, 0, 0, 0
1351, 1, 1636424100121, 1636424100573, 452, 0, 452, 0, 0, 0
1352, 1, 1636424100345, 1636424100797, 452, 0, 452, 0, 0, 0
1316, 2, 1636424091240, 1636424101241, 10001, 0, 10001, 0, 0, 0
1317, 2, 1636424091240, 1636424101284, 10044, 0, 10044, 0, 0, 0
1353, 1, 1636424100933, 1636424101380, 447, 0, 447, 0, 0, 0
1354, 1, 1636424101057, 1636424101512, 455, 0, 455, 0, 0, 0
1321, 2, 1636424091832, 1636424101833, 10001, 0, 10001, 1, 0, 1
1322, 2, 1636424091832, 1636424101880, 10048, 0, 10048, 1, 0, 1
1355, 1, 1636424101440, 1636424101884, 444, 1, 443, 0, 0, 0
1357, 1, 1636424101553, 1636424102005, 452, 0, 452, 0, 0, 0
1323, 2, 1636424092140, 1636424102141, 10001, 0, 10001, 216, 0, 216
1358, 1, 1636424101677, 1636424102197, 520, 0, 520, 0, 0, 0
1324, 2, 1636424092208, 1636424102209, 10001, 0, 10001, 149, 0, 149
1325, 2, 1636424092249, 1636424102252, 10003, 0, 10003, 0, 0, 0
1356, 1, 1636424101556, 1636424102477, 921, 450, 471, 449, 1, 450
1327, 2, 1636424092589, 1636424102589, 10000, 0, 10000, 0, 0, 0
1328, 1, 1636424092861, 1636424102673, 9812, 9348, 464, 0, 9348, 9348
1361, 1, 1636424102301, 1636424102748, 447, 0, 447, 0, 0, 0
1362, 1, 1636424102388, 1636424102836, 448, 0, 448, 0, 0, 0
1360, 1, 1636424102189, 1636424102929, 740, 289, 451, 288, 0, 288
1330, 2, 1636424093077, 1636424103077, 10000, 0, 10000, 0, 0, 0
1332, 2, 1636424093188, 1636424103189, 10001, 0, 10001, 0, 0, 0
1367, 1, 1636424102756, 1636424103201, 445, 0, 445, 0, 0, 0
1366, 1, 1636424102737, 1636424103201, 464, 12, 452, 12, 0, 12
1370, 1, 1636424102904, 1636424103412, 508, 26, 482, 25, 0, 25
1371, 1, 1636424103013, 1636424103505, 492, 0, 492, 0, 0, 0
1333, 2, 1636424093520, 1636424103521, 10001, 0, 10001, 0, 0, 0
1334, 2, 1636424093644, 1636424103644, 10000, 0, 10000, 1, 0, 1
1368, 1, 1636424102788, 1636424103648, 860, 413, 447, 413, 0, 413
1373, 1, 1636424103416, 1636424103869, 453, 1, 452, 1, 0, 1
1372, 1, 1636424103384, 1636424103877, 493, 29, 464, 29, 0, 29
1338, 1, 1636424094397, 1636424103972, 9575, 9124, 451, 0, 9124, 9124
1336, 2, 1636424094025, 1636424104025, 10000, 0, 10000, 0, 0, 0
1375, 1, 1636424103613, 1636424104065, 452, 0, 452, 0, 0, 0
1376, 1, 1636424103776, 1636424104253, 477, 0, 477, 0, 0, 0
1342, 1, 1636424096761, 1636424104473, 7712, 7264, 448, 0, 7264, 7264
1382, 1, 1636424104120, 1636424104577, 457, 1, 456, 1, 0, 1
1380, 1, 1636424104120, 1636424104577, 457, 1, 456, 0, 1, 1
1379, 1, 1636424104120, 1636424104581, 461, 1, 460, 1, 0, 1
1383, 1, 1636424104205, 1636424104657, 452, 0, 452, 0, 0, 0
1384, 1, 1636424104300, 1636424104748, 448, 1, 447, 0, 0, 0
1381, 1, 1636424104164, 1636424105037, 873, 417, 456, 417, 0, 417
1387, 1, 1636424104685, 1636424105145, 460, 0, 460, 0, 0, 0
1388, 1, 1636424104736, 1636424105184, 448, 1, 447, 0, 0, 0
1389, 1, 1636424104977, 1636424105425, 448, 0, 448, 0, 0, 0
1390, 1, 1636424105129, 1636424105581, 452, 0, 452, 0, 0, 0
1391, 1, 1636424105373, 1636424105825, 452, 0, 452, 0, 0, 0
1393, 1, 1636424105481, 1636424105933, 452, 0, 452, 0, 0, 0
1394, 1, 1636424105497, 1636424105941, 444, 0, 444, 0, 0, 0
1395, 1, 1636424105505, 1636424105957, 452, 0, 452, 0, 0, 0
1396, 1, 1636424105581, 1636424106021, 440, 0, 440, 0, 0, 0
1392, 1, 1636424105449, 1636424106281, 832, 377, 455, 376, 0, 376
1397, 1, 1636424106008, 1636424106457, 449, 1, 448, 0, 0, 0
1398, 1, 1636424106041, 1636424106501, 460, 0, 460, 0, 0, 0
1399, 1, 1636424106317, 1636424106765, 448, 0, 448, 0, 0, 0
1400, 1, 1636424106464, 1636424106912, 448, 1, 447, 0, 0, 0
1401, 1, 1636424106677, 1636424107129, 452, 0, 452, 0, 0, 0
1403, 1, 1636424106825, 1636424107272, 447, 0, 447, 0, 0, 0
1404, 1, 1636424106832, 1636424107284, 452, 1, 451, 0, 0, 0
1405, 1, 1636424106844, 1636424107292, 448, 1, 447, 1, 0, 1
1406, 1, 1636424106860, 1636424107309, 449, 1, 448, 1, 0, 1
1402, 1, 1636424106768, 1636424107585, 817, 362, 455, 360, 0, 360
1407, 1, 1636424107312, 1636424107773, 461, 1, 460, 1, 0, 1
1408, 1, 1636424107408, 1636424107861, 453, 1, 452, 1, 0, 1
1409, 1, 1636424107589, 1636424108041, 452, 0, 452, 0, 0, 0
1410, 1, 1636424107824, 1636424108276, 452, 1, 451, 0, 0, 0
1411, 1, 1636424108009, 1636424108461, 452, 0, 452, 0, 0, 0
1412, 1, 1636424108113, 1636424108560, 447, 0, 447, 0, 0, 0
1413, 1, 1636424108120, 1636424108569, 449, 1, 448, 0, 0, 0
1415, 1, 1636424108124, 1636424108577, 453, 1, 452, 0, 0, 0
1416, 1, 1636424108164, 1636424108613, 449, 0, 449, 0, 0, 0
1414, 1, 1636424108120, 1636424108917, 797, 342, 455, 340, 1, 341
1417, 1, 1636424108685, 1636424109133, 448, 0, 448, 0, 0, 0
1418, 1, 1636424108769, 1636424109221, 452, 0, 452, 0, 0, 0
1419, 1, 1636424108857, 1636424109309, 452, 0, 452, 0, 0, 0
1420, 1, 1636424109092, 1636424109544, 452, 0, 452, 0, 0, 0
1421, 1, 1636424109377, 1636424109829, 452, 0, 452, 0, 0, 0
1423, 1, 1636424109416, 1636424109861, 445, 1, 444, 0, 0, 0
1422, 1, 1636424109405, 1636424109861, 456, 0, 456, 0, 0, 0
1424, 1, 1636424109460, 1636424109905, 445, 1, 444, 0, 0, 0
1426, 1, 1636424109556, 1636424110004, 448, 1, 447, 0, 0, 0
1425, 1, 1636424109472, 1636424110313, 841, 390, 451, 390, 0, 390
1427, 1, 1636424110048, 1636424110497, 449, 1, 448, 1, 0, 1
1428, 1, 1636424110104, 1636424110549, 445, 1, 444, 0, 0, 0
1429, 1, 1636424110205, 1636424110661, 456, 0, 456, 0, 0, 0
1430, 1, 1636424110396, 1636424110848, 452, 0, 452, 0, 0, 0
1431, 1, 1636424110685, 1636424111133, 448, 0, 448, 0, 0, 0
1432, 1, 1636424110701, 1636424111145, 444, 0, 444, 0, 0, 0
1433, 1, 1636424110736, 1636424111185, 449, 0, 449, 0, 0, 0
1435, 1, 1636424110804, 1636424111253, 449, 0, 449, 0, 0, 0
1436, 1, 1636424110929, 1636424111381, 452, 0, 452, 0, 0, 0
1434, 1, 1636424110780, 1636424111593, 813, 353, 460, 353, 0, 353
1437, 1, 1636424111381, 1636424111833, 452, 0, 452, 0, 0, 0
1438, 1, 1636424111417, 1636424111857, 440, 0, 440, 0, 0, 0
1439, 1, 1636424111561, 1636424112008, 447, 0, 447, 0, 0, 0
1440, 1, 1636424111685, 1636424112132, 447, 0, 447, 0, 0, 0
1359, 2, 1636424102189, 1636424112188, 9999, 0, 9999, 1689, 0, 1689
1441, 1, 1636424111964, 1636424112412, 448, 1, 447, 1, 0, 1
1442, 1, 1636424111989, 1636424112440, 451, 0, 451, 0, 0, 0
1444, 1, 1636424112097, 1636424112541, 444, 0, 444, 0, 0, 0
1363, 2, 1636424102561, 1636424112561, 10000, 0, 10000, 1316, 0, 1316
1445, 1, 1636424112108, 1636424112593, 485, 0, 485, 0, 0, 0
1364, 2, 1636424102677, 1636424112680, 10003, 0, 10003, 0, 0, 0
1446, 1, 1636424112232, 1636424112700, 468, 0, 468, 0, 0, 0
1365, 2, 1636424102677, 1636424112724, 10047, 0, 10047, 0, 0, 0
1443, 1, 1636424112097, 1636424112945, 848, 344, 504, 344, 0, 344
1447, 1, 1636424112656, 1636424113128, 472, 1, 471, 0, 1, 1
1369, 1, 1636424102892, 1636424113172, 10280, 9833, 447, 0, 9832, 9832
1448, 1, 1636424112776, 1636424113228, 452, 0, 452, 0, 0, 0
1449, 1, 1636424112860, 1636424113309, 449, 0, 449, 0, 0, 0
1452, 1, 1636424112961, 1636424113404, 443, 0, 443, 0, 0, 0
1450, 1, 1636424112985, 1636424113441, 456, 0, 456, 0, 0, 0
1374, 2, 1636424103492, 1636424113492, 10000, 0, 10000, 385, 0, 385
1453, 1, 1636424113272, 1636424113720, 448, 1, 447, 0, 1, 1
1455, 1, 1636424113373, 1636424113825, 452, 0, 452, 0, 0, 0
1377, 2, 1636424103833, 1636424113833, 10000, 0, 10000, 44, 0, 44
1456, 1, 1636424113400, 1636424113853, 453, 1, 452, 0, 0, 0
1454, 1, 1636424113388, 1636424113904, 516, 54, 462, 52, 0, 52
1457, 1, 1636424113424, 1636424113908, 484, 1, 483, 0, 0, 0
1378, 2, 1636424103948, 1636424113948, 10000, 0, 10000, 0, 0, 0
1459, 1, 1636424113536, 1636424113989, 453, 0, 453, 0, 0, 0
1458, 1, 1636424113452, 1636424114280, 828, 374, 454, 373, 0, 373
1385, 2, 1636424104344, 1636424114345, 10001, 0, 10001, 0, 0, 0
1451, 1, 1636424112993, 1636424114364, 1371, 912, 459, 912, 0, 912
1460, 1, 1636424113992, 1636424114444, 452, 1, 451, 1, 0, 1
1463, 1, 1636424114212, 1636424114665, 453, 1, 452, 0, 1, 1
1462, 1, 1636424114208, 1636424114665, 457, 0, 457, 0, 0, 0
1466, 1, 1636424114180, 1636424114665, 485, 1, 484, 0, 1, 1
1469, 1, 1636424114277, 1636424114756, 479, 0, 479, 0, 0, 0
1468, 1, 1636424114272, 1636424114756, 484, 1, 483, 0, 0, 0
1386, 1, 1636424104713, 1636424114797, 10084, 9632, 452, 0, 9632, 9632
1461, 1, 1636424114088, 1636424114824, 736, 277, 459, 276, 0, 276
1471, 1, 1636424114592, 1636424115052, 460, 1, 459, 1, 0, 1
1470, 1, 1636424114600, 1636424115060, 460, 1, 459, 1, 0, 1
1472, 1, 1636424114656, 1636424115113, 457, 10, 447, 10, 0, 10
1465, 1, 1636424114220, 1636424115120, 900, 446, 454, 446, 0, 446
1474, 1, 1636424114744, 1636424115184, 440, 0, 440, 0, 0, 0
1473, 1, 1636424114724, 1636424115204, 480, 33, 447, 33, 0, 33
1475, 1, 1636424114764, 1636424115204, 440, 0, 440, 0, 0, 0
1476, 1, 1636424114768, 1636424115220, 452, 0, 452, 0, 0, 0
1478, 1, 1636424114804, 1636424115253, 449, 1, 448, 1, 0, 1
1477, 1, 1636424114788, 1636424115632, 844, 397, 447, 397, 0, 397
1480, 1, 1636424115309, 1636424115761, 452, 0, 452, 0, 0, 0
1481, 1, 1636424115457, 1636424115897, 440, 0, 440, 0, 0, 0
1482, 1, 1636424115476, 1636424115929, 453, 0, 453, 0, 0, 0
1484, 1, 1636424115492, 1636424115944, 452, 0, 452, 0, 0, 0
1485, 1, 1636424115552, 1636424115992, 440, 1, 439, 0, 0, 0
1486, 1, 1636424115585, 1636424116032, 447, 0, 447, 0, 0, 0
1487, 1, 1636424115608, 1636424116057, 449, 1, 448, 0, 0, 0
1488, 1, 1636424115849, 1636424116292, 443, 0, 443, 0, 0, 0
1489, 1, 1636424115860, 1636424116304, 444, 1, 443, 1, 0, 1
1483, 1, 1636424115488, 1636424116380, 892, 442, 450, 441, 0, 441
1490, 1, 1636424115929, 1636424116400, 471, 16, 455, 16, 0, 16
1491, 1, 1636424116028, 1636424116485, 457, 0, 457, 0, 0, 0
1492, 1, 1636424116049, 1636424116513, 464, 8, 456, 8, 0, 8
1494, 1, 1636424116112, 1636424116561, 449, 0, 449, 0, 0, 0
1495, 1, 1636424116128, 1636424116577, 449, 0, 449, 0, 0, 0
1496, 1, 1636424116140, 1636424116593, 453, 0, 453, 0, 0, 0
1493, 1, 1636424116113, 1636424116932, 819, 372, 447, 372, 0, 372
1497, 1, 1636424116664, 1636424117120, 456, 1, 455, 0, 0, 0
1498, 1, 1636424116757, 1636424117208, 451, 0, 451, 0, 0, 0
1499, 1, 1636424116796, 1636424117252, 456, 1, 455, 0, 0, 0
1501, 1, 1636424116824, 1636424117268, 444, 0, 444, 0, 0, 0
1502, 1, 1636424116848, 1636424117296, 448, 1, 447, 0, 0, 0
1503, 1, 1636424116896, 1636424117340, 444, 1, 443, 1, 0, 1
1504, 1, 1636424116976, 1636424117433, 457, 1, 456, 0, 1, 1
1505, 1, 1636424117124, 1636424117565, 441, 0, 441, 0, 0, 0
1506, 1, 1636424117177, 1636424117624, 447, 0, 447, 0, 0, 0
1500, 1, 1636424116820, 1636424117701, 881, 433, 448, 433, 0, 433
1507, 1, 1636424117284, 1636424117744, 460, 13, 447, 12, 0, 12
1510, 1, 1636424117400, 1636424117841, 441, 0, 441, 0, 0, 0
1511, 1, 1636424117420, 1636424117869, 449, 1, 448, 1, 0, 1
1512, 1, 1636424117440, 1636424117884, 444, 0, 444, 0, 0, 0
1509, 1, 1636424117396, 1636424117892, 496, 37, 459, 37, 0, 37
1508, 1, 1636424117380, 1636424118189, 809, 365, 444, 364, 0, 364
1513, 1, 1636424117461, 1636424118301, 840, 380, 460, 380, 0, 380
1515, 1, 1636424118100, 1636424118541, 441, 0, 441, 0, 0, 0
1516, 1, 1636424118128, 1636424118584, 456, 1, 455, 0, 0, 0
1517, 1, 1636424118128, 1636424118584, 456, 1, 455, 0, 0, 0
1519, 1, 1636424118216, 1636424118672, 456, 1, 455, 0, 0, 0
1520, 1, 1636424118236, 1636424118680, 444, 1, 443, 0, 1, 1
1514, 1, 1636424117945, 1636424118752, 807, 357, 450, 356, 0, 356
1521, 1, 1636424118312, 1636424118764, 452, 1, 451, 0, 0, 0
1522, 1, 1636424118469, 1636424118913, 444, 0, 444, 0, 0, 0
1523, 1, 1636424118525, 1636424118976, 451, 0, 451, 0, 0, 0
1518, 1, 1636424118152, 1636424118988, 836, 390, 446, 389, 0, 389
1524, 1, 1636424118624, 1636424119128, 504, 57, 447, 57, 0, 57
1525, 1, 1636424118716, 1636424119160, 444, 1, 443, 0, 0, 0
1526, 1, 1636424118724, 1636424119172, 448, 0, 448, 0, 0, 0
1527, 1, 1636424118736, 1636424119185, 449, 1, 448, 0, 0, 0
1528, 1, 1636424118748, 1636424119213, 465, 17, 448, 17, 0, 17
1530, 1, 1636424118833, 1636424119285, 452, 0, 452, 0, 0, 0
1529, 1, 1636424118796, 1636424119641, 845, 389, 456, 389, 0, 389
1531, 1, 1636424119288, 1636424119737, 449, 1, 448, 0, 1, 1
1532, 1, 1636424119464, 1636424119908, 444, 1, 443, 1, 0, 1
1533, 1, 1636424119488, 1636424119936, 448, 1, 447, 0, 0, 0
1534, 1, 1636424119496, 1636424119949, 453, 1, 452, 0, 0, 0
1536, 1, 1636424119504, 1636424119952, 448, 0, 448, 0, 0, 0
1537, 1, 1636424119608, 1636424120052, 444, 1, 443, 0, 0, 0
1538, 1, 1636424119608, 1636424120052, 444, 1, 443, 0, 0, 0
1539, 1, 1636424119797, 1636424120249, 452, 0, 452, 0, 0, 0
1540, 1, 1636424119816, 1636424120273, 457, 1, 456, 1, 0, 1
1535, 1, 1636424119497, 1636424120365, 868, 412, 456, 412, 0, 412
1542, 1, 1636424120016, 1636424120473, 457, 1, 456, 0, 1, 1
1541, 1, 1636424119976, 1636424120504, 528, 77, 451, 76, 0, 76
1544, 1, 1636424120068, 1636424120521, 453, 1, 452, 0, 0, 0
1543, 1, 1636424120060, 1636424120524, 464, 1, 463, 0, 0, 0
1545, 1, 1636424120076, 1636424120524, 448, 0, 448, 0, 0, 0
1547, 1, 1636424120192, 1636424120653, 461, 1, 460, 0, 0, 0
1546, 1, 1636424120124, 1636424120976, 852, 401, 451, 401, 0, 401
1548, 1, 1636424120617, 1636424121064, 447, 0, 447, 0, 0, 0
1549, 1, 1636424120800, 1636424121241, 441, 1, 440, 0, 1, 1
1550, 1, 1636424120836, 1636424121284, 448, 0, 448, 0, 0, 0
1551, 1, 1636424120844, 1636424121288, 444, 1, 443, 1, 0, 1
1553, 1, 1636424120844, 1636424121292, 448, 1, 447, 0, 0, 0
1554, 1, 1636424120940, 1636424121385, 445, 0, 445, 0, 0, 0
1555, 1, 1636424120944, 1636424121396, 452, 0, 452, 0, 0, 0
1556, 1, 1636424121097, 1636424121549, 452, 0, 452, 0, 0, 0
1557, 1, 1636424121149, 1636424121597, 448, 0, 448, 0, 0, 0
1552, 1, 1636424120844, 1636424121737, 893, 441, 452, 441, 0, 441
1558, 1, 1636424121329, 1636424121781, 452, 0, 452, 0, 0, 0
1560, 1, 1636424121385, 1636424121824, 439, 0, 439, 0, 0, 0
1561, 1, 1636424121392, 1636424121849, 457, 0, 457, 0, 0, 0
1559, 1, 1636424121365, 1636424121849, 484, 32, 452, 32, 0, 32
1562, 1, 1636424121424, 1636424121873, 449, 1, 448, 1, 0, 1
1564, 1, 1636424121520, 1636424121969, 449, 1, 448, 0, 1, 1
1563, 1, 1636424121440, 1636424122237, 797, 341, 456, 341, 0, 341
1565, 1, 1636424121913, 1636424122361, 448, 0, 448, 0, 0, 0
1566, 1, 1636424122124, 1636424122577, 453, 1, 452, 1, 0, 1
1568, 1, 1636424122129, 1636424122589, 460, 0, 460, 0, 0, 0
1567, 1, 1636424122129, 1636424122589, 460, 0, 460, 0, 0, 0
1570, 1, 1636424122201, 1636424122644, 443, 0, 443, 0, 0, 0
1571, 1, 1636424122284, 1636424122740, 456, 0, 456, 0, 0, 0
1572, 1, 1636424122284, 1636424122740, 456, 1, 455, 0, 0, 0
1573, 1, 1636424122368, 1636424122820, 452, 1, 451, 0, 0, 0
1574, 1, 1636424122509, 1636424122956, 447, 0, 447, 0, 0, 0
1569, 1, 1636424122156, 1636424123040, 884, 433, 451, 433, 0, 433
1575, 1, 1636424122712, 1636424123152, 440, 0, 440, 0, 0, 0
1577, 1, 1636424122756, 1636424123205, 449, 0, 449, 0, 0, 0
1578, 1, 1636424122760, 1636424123205, 445, 0, 445, 0, 0, 0
1576, 1, 1636424122752, 1636424123208, 456, 1, 455, 0, 0, 0
1581, 1, 1636424122800, 1636424123248, 448, 1, 447, 0, 1, 1
1580, 1, 1636424122800, 1636424123249, 449, 1, 448, 0, 1, 1
1579, 1, 1636424122788, 1636424123596, 808, 365, 443, 364, 0, 364
1582, 1, 1636424123224, 1636424123672, 448, 1, 447, 0, 0, 0
1583, 1, 1636424123389, 1636424123841, 452, 0, 452, 0, 0, 0
1584, 1, 1636424123412, 1636424123869, 457, 1, 456, 0, 0, 0
1586, 1, 1636424123489, 1636424123945, 456, 0, 456, 0, 0, 0
1587, 1, 1636424123496, 1636424123952, 456, 1, 455, 0, 1, 1
1590, 1, 1636424123661, 1636424124104, 443, 0, 443, 0, 0, 0
1589, 1, 1636424123652, 1636424124105, 453, 1, 452, 0, 0, 0
1464, 2, 1636424114216, 1636424124217, 10001, 0, 10001, 897, 0, 897
1591, 1, 1636424123785, 1636424124233, 448, 0, 448, 0, 0, 0
1467, 2, 1636424114252, 1636424124261, 10009, 0, 10009, 861, 0, 861
1585, 1, 1636424123472, 1636424124317, 845, 397, 448, 397, 0, 397
1588, 1, 1636424123636, 1636424124489, 853, 317, 536, 316, 0, 316
1593, 1, 1636424124084, 1636424124581, 497, 1, 496, 1, 0, 1
1592, 1, 1636424124045, 1636424124581, 536, 0, 536, 0, 0, 0
1596, 1, 1636424124116, 1636424124581, 465, 1, 464, 1, 0, 1
1598, 1, 1636424124184, 1636424124669, 485, 1, 484, 0, 0, 0
1594, 1, 1636424124104, 1636424124944, 840, 386, 454, 385, 1, 386
1479, 2, 1636424115017, 1636424125017, 10000, 0, 10000, 96, 0, 96
1595, 1, 1636424124112, 1636424125024, 912, 470, 442, 470, 0, 470
1597, 1, 1636424124136, 1636424125028, 892, 446, 446, 444, 1, 445
1600, 1, 1636424124672, 1636424125116, 444, 1, 443, 1, 0, 1
1601, 1, 1636424124716, 1636424125172, 456, 1, 455, 0, 0, 0
1603, 1, 1636424124829, 1636424125289, 460, 0, 460, 0, 0, 0
1605, 1, 1636424124981, 1636424125417, 436, 0, 436, 0, 0, 0
1606, 1, 1636424124988, 1636424125420, 432, 1, 431, 0, 0, 0
1607, 1, 1636424125001, 1636424125441, 440, 0, 440, 0, 0, 0
1608, 1, 1636424125172, 1636424125625, 453, 1, 452, 0, 0, 0
1602, 1, 1636424124788, 1636424125625, 837, 385, 452, 384, 0, 384
1609, 1, 1636424125325, 1636424125777, 452, 0, 452, 0, 0, 0
1613, 1, 1636424125417, 1636424125865, 448, 0, 448, 0, 0, 0
1614, 1, 1636424125444, 1636424125897, 453, 1, 452, 0, 0, 0
1615, 1, 1636424125448, 1636424125897, 449, 1, 448, 0, 1, 1
1617, 1, 1636424125513, 1636424125957, 444, 0, 444, 0, 0, 0
1618, 1, 1636424125540, 1636424125985, 445, 1, 444, 1, 0, 1
1610, 1, 1636424125356, 1636424126081, 725, 270, 455, 268, 1, 269
1611, 1, 1636424125424, 1636424126224, 800, 354, 446, 353, 1, 354
1616, 1, 1636424125468, 1636424126313, 845, 397, 448, 397, 0, 397
1619, 1, 1636424126000, 1636424126456, 456, 1, 455, 1, 0, 1
1620, 1, 1636424126000, 1636424126460, 460, 1, 459, 0, 1, 1
1622, 1, 1636424126180, 1636424126633, 453, 1, 452, 0, 0, 0
1612, 1, 1636424125420, 1636424126689, 1269, 805, 464, 805, 0, 805
1623, 1, 1636424126257, 1636424126709, 452, 0, 452, 0, 0, 0
1624, 1, 1636424126296, 1636424126744, 448, 1, 447, 0, 0, 0
1625, 1, 1636424126385, 1636424126828, 443, 0, 443, 0, 0, 0
1621, 1, 1636424126121, 1636424126905, 784, 336, 448, 336, 0, 336
1626, 1, 1636424126516, 1636424126961, 445, 1, 444, 0, 0, 0
1629, 1, 1636424126708, 1636424127156, 448, 1, 447, 0, 0, 0
1630, 1, 1636424126724, 1636424127168, 444, 0, 444, 0, 0, 0
1631, 1, 1636424126752, 1636424127196, 444, 0, 444, 0, 0, 0
1633, 1, 1636424126780, 1636424127221, 441, 1, 440, 0, 0, 0
1634, 1, 1636424126824, 1636424127277, 453, 0, 453, 0, 0, 0
1636, 1, 1636424126928, 1636424127389, 461, 1, 460, 0, 0, 0
1632, 1, 1636424126780, 1636424127604, 824, 377, 447, 377, 0, 377
1637, 1, 1636424127352, 1636424127797, 445, 0, 445, 0, 0, 0
1638, 1, 1636424127396, 1636424127840, 444, 1, 443, 0, 1, 1
1640, 1, 1636424127529, 1636424127981, 452, 0, 452, 0, 0, 0
1641, 1, 1636424127601, 1636424128053, 452, 0, 452, 0, 0, 0
1642, 1, 1636424127628, 1636424128092, 464, 1, 463, 0, 0, 0
1643, 1, 1636424127725, 1636424128172, 447, 0, 447, 0, 0, 0
1644, 1, 1636424127804, 1636424128256, 452, 1, 451, 0, 1, 1
1639, 1, 1636424127469, 1636424128281, 812, 372, 440, 372, 0, 372
1645, 1, 1636424127980, 1636424128424, 444, 1, 443, 0, 0, 0
1646, 1, 1636424128013, 1636424128460, 447, 0, 447, 0, 0, 0
1647, 1, 1636424128100, 1636424128549, 449, 1, 448, 0, 0, 0
1649, 1, 1636424128108, 1636424128556, 448, 0, 448, 0, 0, 0
1650, 1, 1636424128152, 1636424128605, 453, 0, 453, 0, 0, 0
1651, 1, 1636424128213, 1636424128669, 456, 0, 456, 0, 0, 0
1648, 1, 1636424128100, 1636424128873, 773, 324, 449, 324, 0, 324
1652, 1, 1636424128688, 1636424129136, 448, 1, 447, 0, 0, 0
1653, 1, 1636424128776, 1636424129224, 448, 1, 447, 0, 0, 0
1655, 1, 1636424128820, 1636424129264, 444, 0, 444, 0, 0, 0
1656, 1, 1636424128928, 1636424129372, 444, 1, 443, 0, 1, 1
1657, 1, 1636424128972, 1636424129416, 444, 1, 443, 0, 1, 1
1658, 1, 1636424128992, 1636424129436, 444, 1, 443, 0, 1, 1
1659, 1, 1636424129172, 1636424129620, 448, 1, 447, 0, 0, 0
1654, 1, 1636424128824, 1636424129672, 848, 401, 447, 401, 0, 401
1660, 1, 1636424129288, 1636424129737, 449, 0, 449, 0, 0, 0
1661, 1, 1636424129312, 1636424129757, 445, 0, 445, 0, 0, 0
1664, 1, 1636424129444, 1636424129905, 461, 0, 461, 0, 0, 0
1663, 1, 1636424129440, 1636424129905, 465, 0, 465, 0, 0, 0
1665, 1, 1636424129480, 1636424129924, 444, 1, 443, 0, 0, 0
1666, 1, 1636424129488, 1636424129937, 449, 0, 449, 0, 0, 0
1662, 1, 1636424129440, 1636424130192, 752, 297, 455, 297, 0, 297
1667, 1, 1636424129985, 1636424130441, 456, 0, 456, 0, 0, 0
1668, 1, 1636424130061, 1636424130517, 456, 0, 456, 0, 0, 0
1670, 1, 1636424130220, 1636424130676, 456, 1, 455, 0, 0, 0
1671, 1, 1636424130276, 1636424130720, 444, 0, 444, 0, 0, 0
1672, 1, 1636424130316, 1636424130773, 457, 1, 456, 0, 0, 0
1673, 1, 1636424130332, 1636424130784, 452, 1, 451, 1, 0, 1
1674, 1, 1636424130437, 1636424130889, 452, 0, 452, 0, 0, 0
1669, 1, 1636424130137, 1636424130969, 832, 380, 452, 380, 0, 380
1676, 1, 1636424130720, 1636424131177, 457, 1, 456, 0, 0, 0
1678, 1, 1636424130764, 1636424131209, 445, 1, 444, 0, 0, 0
1679, 1, 1636424130828, 1636424131273, 445, 0, 445, 0, 0, 0
1680, 1, 1636424130848, 1636424131296, 448, 0, 448, 0, 0, 0
1681, 1, 1636424130868, 1636424131317, 449, 1, 448, 0, 0, 0
1682, 1, 1636424131281, 1636424131737, 456, 0, 456, 0, 0, 0
1683, 1, 1636424131389, 1636424131837, 448, 0, 448, 0, 0, 0
1686, 1, 1636424131553, 1636424132000, 447, 0, 447, 0, 0, 0
1689, 1, 1636424131737, 1636424132189, 452, 0, 452, 0, 0, 0
1684, 1, 1636424131441, 1636424132289, 848, 397, 451, 396, 0, 396
1691, 1, 1636424132076, 1636424132529, 453, 1, 452, 0, 0, 0
1693, 1, 1636424132209, 1636424132661, 452, 0, 452, 0, 0, 0
1694, 1, 1636424132228, 1636424132681, 453, 1, 452, 1, 0, 1
1698, 1, 1636424132897, 1636424133349, 452, 0, 452, 0, 0, 0
1699, 1, 1636424133029, 1636424133477, 448, 0, 448, 0, 0, 0
1700, 1, 1636424133477, 1636424133929, 452, 0, 452, 0, 0, 0
1701, 1, 1636424133552, 1636424134001, 449, 1, 448, 0, 0, 0
1702, 1, 1636424133565, 1636424134013, 448, 0, 448, 0, 0, 0
1599, 2, 1636424124569, 1636424134569, 10000, 0, 10000, 376, 0, 376
1703, 1, 1636424134280, 1636424134733, 453, 1, 452, 0, 0, 0
1704, 1, 1636424134305, 1636424134796, 491, 0, 491, 0, 0, 0
1604, 2, 1636424124845, 1636424134845, 10000, 0, 10000, 100, 0, 100
1705, 1, 1636424134761, 1636424135253, 492, 0, 492, 0, 0, 0
1706, 1, 1636424134840, 1636424135293, 453, 1, 452, 0, 1, 1
1707, 1, 1636424134936, 1636424135389, 453, 1, 452, 0, 0, 0
1708, 1, 1636424135153, 1636424135605, 452, 0, 452, 0, 0, 0
1709, 1, 1636424135256, 1636424135709, 453, 1, 452, 0, 0, 0
1710, 1, 1636424135553, 1636424136009, 456, 0, 456, 0, 0, 0
1711, 1, 1636424135589, 1636424136040, 451, 0, 451, 0, 0, 0
1712, 1, 1636424136033, 1636424136492, 459, 0, 459, 0, 0, 0
1627, 2, 1636424126528, 1636424136529, 10001, 0, 10001, 216, 0, 216
1713, 1, 1636424136113, 1636424136561, 448, 0, 448, 0, 0, 0
1714, 1, 1636424136205, 1636424136657, 452, 0, 452, 0, 0, 0
1628, 2, 1636424126664, 1636424136665, 10001, 0, 10001, 81, 0, 81
1635, 2, 1636424126836, 1636424136832, 9996, 0, 9996, 0, 0, 0
1716, 1, 1636424136524, 1636424136993, 469, 1, 468, 0, 0, 0
1715, 1, 1636424136461, 1636424136993, 532, 0, 532, 0, 0, 0
1717, 1, 1636424136924, 1636424137373, 449, 1, 448, 0, 1, 1
1718, 1, 1636424136924, 1636424137373, 449, 1, 448, 0, 1, 1
1722, 1, 1636424137357, 1636424137808, 451, 0, 451, 0, 0, 0
1721, 1, 1636424137144, 1636424137829, 685, 230, 455, 230, 0, 230
1723, 1, 1636424137469, 1636424137917, 448, 0, 448, 0, 0, 0
1725, 1, 1636424137821, 1636424138273, 452, 0, 452, 0, 0, 0
1724, 1, 1636424137573, 1636424138292, 719, 256, 463, 256, 0, 256
1726, 1, 1636424137840, 1636424138301, 461, 0, 461, 0, 0, 0
1727, 1, 1636424138181, 1636424138629, 448, 0, 448, 0, 0, 0
1728, 1, 1636424138272, 1636424138721, 449, 1, 448, 0, 0, 0
1729, 1, 1636424138361, 1636424138809, 448, 0, 448, 0, 0, 0
1730, 1, 1636424138645, 1636424139092, 447, 0, 447, 0, 0, 0
1731, 1, 1636424138824, 1636424139277, 453, 1, 452, 0, 0, 0
1732, 1, 1636424138924, 1636424139369, 445, 1, 444, 0, 0, 0
1733, 1, 1636424139148, 1636424139601, 453, 0, 453, 0, 0, 0
1734, 1, 1636424139196, 1636424139644, 448, 1, 447, 0, 0, 0
1735, 1, 1636424139469, 1636424139925, 456, 0, 456, 0, 0, 0
1736, 1, 1636424139648, 1636424140105, 457, 1, 456, 0, 1, 1
1738, 1, 1636424139980, 1636424140433, 453, 1, 452, 0, 0, 0
1739, 1, 1636424140105, 1636424140552, 447, 0, 447, 0, 0, 0
1675, 2, 1636424130577, 1636424140580, 10003, 0, 10003, 0, 0, 0
1677, 2, 1636424130740, 1636424140741, 10001, 0, 10001, 0, 0, 0
1740, 1, 1636424140304, 1636424140761, 457, 1, 456, 0, 0, 0
1741, 1, 1636424140464, 1636424140917, 453, 1, 452, 0, 1, 1
1742, 1, 1636424140512, 1636424140988, 476, 0, 476, 0, 0, 0
1743, 1, 1636424140788, 1636424141232, 444, 1, 443, 0, 0, 0
1745, 1, 1636424140944, 1636424141401, 457, 0, 457, 0, 0, 0
1685, 2, 1636424131545, 1636424141545, 10000, 0, 10000, 193, 0, 193
1687, 2, 1636424131613, 1636424141613, 10000, 0, 10000, 124, 0, 124
1688, 2, 1636424131633, 1636424141660, 10027, 0, 10027, 105, 0, 105
1747, 1, 1636424141252, 1636424141705, 453, 1, 452, 0, 0, 0
1748, 1, 1636424141473, 1636424141985, 512, 0, 512, 0, 0, 0
1690, 2, 1636424132056, 1636424142056, 10000, 0, 10000, 0, 0, 0
1692, 2, 1636424132124, 1636424142124, 10000, 0, 10000, 1, 0, 1
1749, 1, 1636424141709, 1636424142160, 451, 0, 451, 0, 0, 0
1750, 1, 1636424141796, 1636424142277, 481, 0, 481, 0, 0, 0
1751, 1, 1636424141840, 1636424142293, 453, 0, 453, 0, 0, 0
1754, 1, 1636424142048, 1636424142532, 484, 1, 483, 1, 0, 1
1752, 1, 1636424142045, 1636424142540, 495, 0, 495, 0, 0, 0
1753, 1, 1636424142048, 1636424142540, 492, 1, 491, 1, 0, 1
1695, 1, 1636424132560, 1636424142573, 10013, 9565, 448, 0, 9564, 9564
1755, 1, 1636424142168, 1636424142616, 448, 1, 447, 0, 0, 0
1756, 1, 1636424142264, 1636424142713, 449, 1, 448, 0, 0, 0
1696, 2, 1636424132757, 1636424142757, 10000, 0, 10000, 0, 0, 0
1697, 2, 1636424132785, 1636424142805, 10020, 0, 10020, 0, 0, 0
1759, 1, 1636424142548, 1636424143028, 480, 0, 480, 0, 0, 0
1758, 1, 1636424142436, 1636424143028, 592, 97, 495, 97, 0, 97
1737, 1, 1636424139753, 1636424143248, 3495, 3052, 443, 0, 3052, 3052
1761, 1, 1636424142852, 1636424143296, 444, 1, 443, 0, 0, 0
1760, 1, 1636424142852, 1636424143300, 448, 1, 447, 0, 0, 0
1762, 1, 1636424142941, 1636424143388, 447, 0, 447, 0, 0, 0
1764, 1, 1636424143032, 1636424143480, 448, 0, 448, 0, 0, 0
1763, 1, 1636424143069, 1636424143516, 447, 0, 447, 0, 0, 0
1766, 1, 1636424143149, 1636424143600, 451, 0, 451, 0, 0, 0
1767, 1, 1636424143245, 1636424143697, 452, 0, 452, 0, 0, 0
1768, 1, 1636424143248, 1636424143697, 449, 0, 449, 0, 0, 0
1769, 1, 1636424143276, 1636424143720, 444, 0, 444, 0, 0, 0
1771, 1, 1636424143448, 1636424143897, 449, 0, 449, 0, 0, 0
1770, 1, 1636424143468, 1636424143929, 461, 13, 448, 13, 0, 13
1765, 1, 1636424143088, 1636424143965, 877, 429, 448, 429, 0, 429
1772, 1, 1636424143537, 1636424143989, 452, 0, 452, 0, 0, 0
1773, 1, 1636424143649, 1636424144172, 523, 72, 451, 72, 0, 72
1774, 1, 1636424143825, 1636424144273, 448, 0, 448, 0, 0, 0
1775, 1, 1636424144056, 1636424144504, 448, 1, 447, 1, 0, 1
1776, 1, 1636424144145, 1636424144592, 447, 0, 447, 0, 0, 0
1777, 1, 1636424144181, 1636424144624, 443, 0, 443, 0, 0, 0
1778, 1, 1636424144293, 1636424144740, 447, 0, 447, 0, 0, 0
1779, 1, 1636424144304, 1636424144749, 445, 1, 444, 0, 0, 0
1781, 1, 1636424144444, 1636424144905, 461, 0, 461, 0, 0, 0
1782, 1, 1636424144581, 1636424145033, 452, 0, 452, 0, 0, 0
1784, 1, 1636424144636, 1636424145085, 449, 1, 448, 1, 0, 1
1783, 1, 1636424144636, 1636424145088, 452, 1, 451, 1, 0, 1
1780, 1, 1636424144329, 1636424145192, 863, 412, 451, 412, 0, 412
1786, 1, 1636424144776, 1636424145228, 452, 1, 451, 0, 0, 0
1787, 1, 1636424144837, 1636424145285, 448, 0, 448, 0, 0, 0
1788, 1, 1636424144972, 1636424145488, 516, 61, 455, 60, 0, 60
1785, 1, 1636424144720, 1636424145532, 812, 369, 443, 369, 0, 369
1789, 1, 1636424145192, 1636424145640, 448, 1, 447, 1, 0, 1
1792, 1, 1636424145456, 1636424145905, 449, 1, 448, 0, 1, 1
1791, 1, 1636424145452, 1636424145908, 456, 1, 455, 0, 0, 0
1790, 1, 1636424145441, 1636424145980, 539, 92, 447, 92, 0, 92
1793, 1, 1636424145596, 1636424146048, 452, 0, 452, 0, 0, 0
1794, 1, 1636424145608, 1636424146060, 452, 0, 452, 0, 0, 0
1796, 1, 1636424145721, 1636424146168, 447, 0, 447, 0, 0, 0
1797, 1, 1636424145905, 1636424146361, 456, 0, 456, 0, 0, 0
1798, 1, 1636424145980, 1636424146425, 445, 0, 445, 0, 0, 0
1799, 1, 1636424145992, 1636424146441, 449, 0, 449, 0, 0, 0
1800, 1, 1636424146024, 1636424146473, 449, 1, 448, 0, 0, 0
1795, 1, 1636424145640, 1636424146497, 857, 409, 448, 409, 0, 409
1801, 1, 1636424146076, 1636424146525, 449, 1, 448, 0, 0, 0
1802, 1, 1636424146181, 1636424146633, 452, 0, 452, 0, 0, 0
1803, 1, 1636424146272, 1636424146817, 545, 90, 455, 89, 0, 89
1719, 2, 1636424137057, 1636424147056, 9999, 0, 9999, 0, 0, 0
1720, 2, 1636424137057, 1636424147100, 10043, 0, 10043, 0, 0, 0
1805, 1, 1636424146825, 1636424147324, 499, 0, 499, 0, 0, 0
1804, 1, 1636424146813, 1636424147324, 511, 0, 511, 0, 0, 0
1806, 1, 1636424146852, 1636424147324, 472, 1, 471, 0, 0, 0
1810, 1, 1636424147024, 1636424147508, 484, 1, 483, 0, 0, 0
1811, 1, 1636424147192, 1636424147644, 452, 1, 451, 0, 0, 0
1813, 1, 1636424147268, 1636424147717, 449, 1, 448, 0, 0, 0
1807, 1, 1636424146933, 1636424147769, 836, 392, 444, 392, 0, 392
1816, 1, 1636424147328, 1636424147777, 449, 0, 449, 0, 0, 0
1817, 1, 1636424147384, 1636424147821, 437, 1, 436, 0, 0, 0
1818, 1, 1636424147452, 1636424147901, 449, 0, 449, 0, 0, 0
1819, 1, 1636424147569, 1636424148100, 531, 76, 455, 76, 0, 76
1821, 1, 1636424148144, 1636424148596, 452, 1, 451, 0, 1, 1
1822, 1, 1636424148213, 1636424148665, 452, 0, 452, 0, 0, 0
1823, 1, 1636424148249, 1636424148701, 452, 0, 452, 0, 0, 0
1825, 1, 1636424148480, 1636424148933, 453, 1, 452, 0, 0, 0
1824, 1, 1636424148305, 1636424149121, 816, 360, 456, 360, 0, 360
1827, 1, 1636424148716, 1636424149164, 448, 1, 447, 0, 0, 0
1828, 1, 1636424148725, 1636424149173, 448, 0, 448, 0, 0, 0
1830, 1, 1636424148864, 1636424149393, 529, 69, 460, 68, 0, 68
1829, 1, 1636424148789, 1636424149569, 780, 332, 448, 332, 0, 332
1831, 1, 1636424149417, 1636424149873, 456, 0, 456, 0, 0, 0
1832, 1, 1636424149532, 1636424149989, 457, 0, 457, 0, 0, 0
1833, 1, 1636424149568, 1636424150021, 453, 1, 452, 0, 0, 0
1834, 1, 1636424149636, 1636424150089, 453, 1, 452, 0, 0, 0
1835, 1, 1636424149808, 1636424150260, 452, 1, 451, 0, 0, 0
1836, 1, 1636424150081, 1636424150528, 447, 0, 447, 0, 0, 0
1837, 1, 1636424150089, 1636424150537, 448, 0, 448, 0, 0, 0
1838, 1, 1636424150156, 1636424150613, 457, 1, 456, 0, 1, 1
1839, 1, 1636424150192, 1636424150717, 525, 69, 456, 69, 0, 69
1744, 2, 1636424140924, 1636424150924, 10000, 0, 10000, 0, 0, 0
1746, 2, 1636424141049, 1636424151049, 10000, 0, 10000, 0, 0, 0
1840, 1, 1636424150781, 1636424151272, 491, 0, 491, 0, 0, 0
1841, 1, 1636424150809, 1636424151276, 467, 0, 467, 0, 0, 0
1842, 1, 1636424150880, 1636424151364, 484, 0, 484, 0, 0, 0
1843, 1, 1636424150968, 1636424151460, 492, 1, 491, 0, 0, 0
1757, 1, 1636424142397, 1636424151492, 9095, 8652, 443, 0, 8652, 8652
1844, 1, 1636424151184, 1636424151629, 445, 0, 445, 0, 0, 0
1848, 1, 1636424151357, 1636424151812, 455, 0, 455, 0, 0, 0
1847, 1, 1636424151357, 1636424151812, 455, 0, 455, 0, 0, 0
1849, 1, 1636424151533, 1636424151993, 460, 0, 460, 0, 0, 0
1850, 1, 1636424151568, 1636424152081, 513, 62, 451, 60, 0, 60
1852, 1, 1636424152053, 1636424152500, 447, 0, 447, 0, 0, 0
1853, 1, 1636424152144, 1636424152589, 445, 1, 444, 0, 0, 0
1854, 1, 1636424152232, 1636424152676, 444, 1, 443, 0, 0, 0
1855, 1, 1636424152276, 1636424152724, 448, 0, 448, 0, 0, 0
1856, 1, 1636424152453, 1636424152901, 448, 0, 448, 0, 0, 0
1858, 1, 1636424152660, 1636424153113, 453, 1, 452, 0, 0, 0
1857, 1, 1636424152660, 1636424153117, 457, 1, 456, 1, 0, 1
1859, 1, 1636424152817, 1636424153265, 448, 0, 448, 0, 0, 0
1860, 1, 1636424152837, 1636424153353, 516, 65, 451, 64, 0, 64
1861, 1, 1636424153352, 1636424153805, 453, 1, 452, 0, 0, 0
1862, 1, 1636424153473, 1636424153925, 452, 0, 452, 0, 0, 0
1863, 1, 1636424153584, 1636424154036, 452, 0, 452, 0, 0, 0
1864, 1, 1636424153628, 1636424154080, 452, 1, 451, 0, 0, 0
1865, 1, 1636424153729, 1636424154173, 444, 0, 444, 0, 0, 0
1866, 1, 1636424153929, 1636424154381, 452, 0, 452, 0, 0, 0
1867, 1, 1636424153949, 1636424154405, 456, 0, 456, 0, 0, 0
1868, 1, 1636424154129, 1636424154625, 496, 44, 452, 44, 0, 44
1869, 1, 1636424154184, 1636424154637, 453, 1, 452, 0, 0, 0
1870, 1, 1636424154677, 1636424155128, 451, 0, 451, 0, 0, 0
1871, 1, 1636424154753, 1636424155201, 448, 0, 448, 0, 0, 0
1872, 1, 1636424154912, 1636424155364, 452, 1, 451, 0, 0, 0
1873, 1, 1636424154933, 1636424155384, 451, 0, 451, 0, 0, 0
1874, 1, 1636424155012, 1636424155469, 457, 1, 456, 0, 1, 1
1875, 1, 1636424155261, 1636424155713, 452, 0, 452, 0, 0, 0
1876, 1, 1636424155340, 1636424155793, 453, 1, 452, 0, 1, 1
1877, 1, 1636424155424, 1636424155925, 501, 46, 455, 45, 0, 45
1878, 1, 1636424155536, 1636424155989, 453, 1, 452, 0, 0, 0
1879, 1, 1636424156041, 1636424156497, 456, 0, 456, 0, 0, 0
1880, 1, 1636424156061, 1636424156517, 456, 0, 456, 0, 0, 0
1881, 1, 1636424156184, 1636424156633, 449, 0, 449, 0, 0, 0
1882, 1, 1636424156232, 1636424156676, 444, 0, 444, 0, 0, 0
1883, 1, 1636424156320, 1636424156769, 449, 0, 449, 0, 0, 0
1808, 2, 1636424146980, 1636424156981, 10001, 0, 10001, 345, 0, 345
1809, 2, 1636424146993, 1636424157029, 10036, 0, 10036, 332, 0, 332
1885, 1, 1636424156680, 1636424157133, 453, 0, 453, 0, 0, 0
1886, 1, 1636424156756, 1636424157256, 500, 14, 486, 12, 0, 12
1812, 2, 1636424147257, 1636424157256, 9999, 0, 9999, 0, 0, 0
1887, 1, 1636424156889, 1636424157348, 459, 0, 459, 0, 0, 0
1815, 2, 1636424147368, 1636424157369, 10001, 0, 10001, 1, 0, 1
1814, 2, 1636424147368, 1636424157416, 10048, 0, 10048, 1, 0, 1
1826, 1, 1636424148608, 1636424157480, 8872, 8421, 451, 1, 8420, 8421
1888, 1, 1636424157348, 1636424157829, 481, 1, 480, 0, 0, 0
1889, 1, 1636424157464, 1636424157921, 457, 0, 457, 0, 0, 0
1890, 1, 1636424157508, 1636424157961, 453, 1, 452, 0, 0, 0
1892, 1, 1636424157625, 1636424158073, 448, 0, 448, 0, 0, 0
1897, 1, 1636424157677, 1636424158129, 452, 0, 452, 0, 0, 0
1820, 2, 1636424148137, 1636424158137, 10000, 0, 10000, 0, 0, 0
1898, 1, 1636424157712, 1636424158164, 452, 1, 451, 0, 0, 0
1891, 1, 1636424157596, 1636424158377, 781, 326, 455, 324, 0, 324
1899, 1, 1636424158024, 1636424158489, 465, 1, 464, 0, 0, 0
1900, 1, 1636424158129, 1636424158589, 460, 1, 459, 0, 1, 1
1901, 1, 1636424158184, 1636424158633, 449, 0, 449, 0, 0, 0
1902, 1, 1636424158452, 1636424158905, 453, 1, 452, 0, 0, 0
1903, 1, 1636424158689, 1636424159140, 451, 0, 451, 0, 0, 0
1904, 1, 1636424158749, 1636424159200, 451, 0, 451, 0, 0, 0
1905, 1, 1636424158801, 1636424159244, 443, 0, 443, 0, 0, 0
1907, 1, 1636424158997, 1636424159453, 456, 0, 456, 0, 0, 0
1908, 1, 1636424159065, 1636424159517, 452, 0, 452, 0, 0, 0
1909, 1, 1636424159065, 1636424159517, 452, 0, 452, 0, 0, 0
1906, 1, 1636424158813, 1636424159641, 828, 388, 440, 388, 0, 388
1910, 1, 1636424159300, 1636424159745, 445, 1, 444, 0, 1, 1
1911, 1, 1636424159516, 1636424159973, 457, 1, 456, 0, 0, 0
1912, 1, 1636424159524, 1636424159973, 449, 0, 449, 0, 0, 0
1913, 1, 1636424159720, 1636424160181, 461, 1, 460, 0, 0, 0
1915, 1, 1636424160061, 1636424160512, 451, 0, 451, 0, 0, 0
1914, 1, 1636424160061, 1636424160513, 452, 0, 452, 0, 0, 0
1917, 1, 1636424160145, 1636424160592, 447, 0, 447, 0, 0, 0
1918, 1, 1636424160337, 1636424160789, 452, 0, 452, 0, 0, 0
1919, 1, 1636424160389, 1636424160833, 444, 0, 444, 0, 0, 0
1920, 1, 1636424160416, 1636424160869, 453, 0, 453, 0, 0, 0
1916, 1, 1636424160129, 1636424160949, 820, 384, 436, 384, 0, 384
1921, 1, 1636424160697, 1636424161145, 448, 0, 448, 0, 0, 0
1845, 2, 1636424151232, 1636424161233, 10001, 0, 10001, 0, 0, 0
1922, 1, 1636424160844, 1636424161292, 448, 1, 447, 0, 0, 0
1923, 1, 1636424160857, 1636424161309, 452, 0, 452, 0, 0, 0
1846, 2, 1636424151360, 1636424161361, 10001, 0, 10001, 0, 0, 0
1924, 1, 1636424161032, 1636424161488, 456, 1, 455, 0, 0, 0
1851, 2, 1636424151733, 1636424161732, 9999, 0, 9999, 0, 0, 0
1925, 1, 1636424161324, 1636424161772, 448, 1, 447, 0, 0, 0
1926, 1, 1636424161452, 1636424161905, 453, 0, 453, 0, 0, 0
1929, 1, 1636424161521, 1636424161973, 452, 0, 452, 0, 0, 0
1930, 1, 1636424161624, 1636424162081, 457, 0, 457, 0, 0, 0
1884, 1, 1636424156573, 1636424162185, 5612, 5160, 452, 0, 5160, 5160
1933, 1, 1636424161780, 1636424162233, 453, 0, 453, 0, 0, 0
1927, 1, 1636424161504, 1636424162357, 853, 402, 451, 401, 1, 402
1935, 1, 1636424162012, 1636424162464, 452, 0, 452, 0, 0, 0
1936, 1, 1636424162144, 1636424162601, 457, 1, 456, 0, 0, 0
1937, 1, 1636424162252, 1636424162700, 448, 1, 447, 0, 1, 1
1939, 1, 1636424162385, 1636424162832, 447, 0, 447, 0, 0, 0
1938, 1, 1636424162404, 1636424162857, 453, 1, 452, 0, 0, 0
1940, 1, 1636424162612, 1636424163065, 453, 0, 453, 0, 0, 0
1941, 1, 1636424162737, 1636424163189, 452, 0, 452, 0, 0, 0
1942, 1, 1636424162789, 1636424163241, 452, 0, 452, 0, 0, 0
1945, 1, 1636424163061, 1636424163512, 451, 0, 451, 0, 0, 0
1944, 1, 1636424162909, 1636424163512, 603, 157, 446, 156, 0, 156
1943, 1, 1636424162796, 1636424163645, 849, 393, 456, 392, 0, 392
1946, 1, 1636424163344, 1636424163789, 445, 1, 444, 0, 0, 0
1947, 1, 1636424163429, 1636424163969, 540, 84, 456, 84, 0, 84
1948, 1, 1636424163637, 1636424164093, 456, 0, 456, 0, 0, 0
1949, 1, 1636424163717, 1636424164168, 451, 0, 451, 0, 0, 0
1950, 1, 1636424163724, 1636424164173, 449, 1, 448, 0, 1, 1
1951, 1, 1636424163897, 1636424164424, 527, 72, 455, 72, 0, 72
1952, 1, 1636424164077, 1636424164529, 452, 0, 452, 0, 0, 0
1955, 1, 1636424164233, 1636424164685, 452, 0, 452, 0, 0, 0
1953, 1, 1636424164093, 1636424164873, 780, 332, 448, 332, 0, 332
1956, 1, 1636424164424, 1636424164877, 453, 0, 453, 0, 0, 0
1954, 1, 1636424164157, 1636424164981, 824, 372, 452, 372, 0, 372
1957, 1, 1636424164680, 1636424165133, 453, 1, 452, 0, 1, 1
1958, 1, 1636424164740, 1636424165189, 449, 1, 448, 0, 0, 0
1959, 1, 1636424164945, 1636424165397, 452, 0, 452, 0, 0, 0
1961, 1, 1636424165081, 1636424165537, 456, 0, 456, 0, 0, 0
1962, 1, 1636424165189, 1636424165641, 452, 0, 452, 0, 0, 0
1963, 1, 1636424165397, 1636424165849, 452, 0, 452, 0, 0, 0
1964, 1, 1636424165404, 1636424165852, 448, 0, 448, 0, 0, 0
1966, 1, 1636424165537, 1636424165989, 452, 0, 452, 0, 0, 0
1967, 1, 1636424165793, 1636424166248, 455, 0, 455, 0, 0, 0
1965, 1, 1636424165460, 1636424166305, 845, 389, 456, 389, 0, 389
1968, 1, 1636424166005, 1636424166452, 447, 0, 447, 0, 0, 0
1969, 1, 1636424166073, 1636424166521, 448, 0, 448, 0, 0, 0
1970, 1, 1636424166308, 1636424166756, 448, 0, 448, 0, 0, 0
1971, 1, 1636424166401, 1636424166849, 448, 0, 448, 0, 0, 0
1972, 1, 1636424166460, 1636424166913, 453, 0, 453, 0, 0, 0
1973, 1, 1636424166704, 1636424167161, 457, 1, 456, 1, 0, 1
1974, 1, 1636424166788, 1636424167237, 449, 1, 448, 0, 0, 0
1976, 1, 1636424166904, 1636424167353, 449, 1, 448, 0, 0, 0
1977, 1, 1636424167132, 1636424167585, 453, 1, 452, 0, 0, 0
1895, 2, 1636424157685, 1636424167685, 10000, 0, 10000, 1, 0, 1
1975, 1, 1636424166793, 1636424167700, 907, 444, 463, 444, 0, 444
1893, 2, 1636424157685, 1636424167732, 10047, 0, 10047, 0, 0, 0
1896, 2, 1636424157685, 1636424167776, 10091, 0, 10091, 0, 0, 0
1978, 1, 1636424167373, 1636424167820, 447, 0, 447, 0, 0, 0
1894, 2, 1636424157685, 1636424167820, 10135, 0, 10135, 0, 0, 0
1979, 1, 1636424167433, 1636424168044, 611, 0, 611, 0, 0, 0
1980, 1, 1636424167673, 1636424168233, 560, 0, 560, 0, 0, 0
1932, 1, 1636424161776, 1636424168265, 6489, 6045, 444, 0, 6045, 6045
1981, 1, 1636424167868, 1636424168313, 445, 0, 445, 0, 0, 0
1982, 1, 1636424167912, 1636424168356, 444, 1, 443, 0, 1, 1
1983, 1, 1636424167977, 1636424168425, 448, 0, 448, 0, 0, 0
1984, 1, 1636424168080, 1636424168524, 444, 0, 444, 0, 0, 0
1985, 1, 1636424168088, 1636424168545, 457, 0, 457, 0, 0, 0
1988, 1, 1636424168128, 1636424168572, 444, 1, 443, 0, 0, 0
1990, 1, 1636424168201, 1636424168653, 452, 0, 452, 0, 0, 0
1992, 1, 1636424168481, 1636424168925, 444, 0, 444, 0, 0, 0
1987, 1, 1636424168096, 1636424168981, 885, 429, 456, 428, 0, 428
1986, 1, 1636424168096, 1636424169001, 905, 450, 455, 448, 0, 448
1989, 1, 1636424168180, 1636424169024, 844, 393, 451, 393, 0, 393
1993, 1, 1636424168672, 1636424169128, 456, 1, 455, 0, 0, 0
1994, 1, 1636424168733, 1636424169189, 456, 0, 456, 0, 0, 0
1995, 1, 1636424169056, 1636424169505, 449, 1, 448, 0, 0, 0
1997, 1, 1636424169140, 1636424169589, 449, 1, 448, 0, 0, 0
1996, 1, 1636424169137, 1636424169592, 455, 0, 455, 0, 0, 0
1999, 1, 1636424169340, 1636424169793, 453, 1, 452, 1, 0, 1
1998, 1, 1636424169340, 1636424169793, 453, 1, 452, 0, 1, 1
2000, 1, 1636424169352, 1636424169804, 452, 1, 451, 0, 0, 0
2003, 1, 1636424169416, 1636424169856, 440, 1, 439, 0, 0, 0
2005, 1, 1636424169592, 1636424170049, 457, 1, 456, 0, 0, 0
2006, 1, 1636424169732, 1636424170172, 440, 1, 439, 1, 0, 1
2002, 1, 1636424169381, 1636424170245, 864, 413, 451, 413, 0, 413
2001, 1, 1636424169356, 1636424170248, 892, 449, 443, 448, 1, 449
2004, 1, 1636424169496, 1636424170309, 813, 361, 452, 361, 0, 361
2007, 1, 1636424170024, 1636424170465, 441, 1, 440, 0, 0, 0
2008, 1, 1636424170065, 1636424170516, 451, 0, 451, 0, 0, 0
2010, 1, 1636424170468, 1636424170925, 457, 0, 457, 0, 0, 0
2011, 1, 1636424170500, 1636424170965, 465, 17, 448, 17, 0, 17
2012, 1, 1636424170640, 1636424171093, 453, 1, 452, 0, 0, 0
2013, 1, 1636424170652, 1636424171101, 449, 1, 448, 0, 1, 1
2014, 1, 1636424170676, 1636424171124, 448, 0, 448, 0, 0, 0
2016, 1, 1636424170692, 1636424171144, 452, 1, 451, 0, 0, 0
2019, 1, 1636424170937, 1636424171384, 447, 0, 447, 0, 0, 0
2020, 1, 1636424170996, 1636424171449, 453, 1, 452, 0, 0, 0
2015, 1, 1636424170692, 1636424171549, 857, 409, 448, 408, 0, 408
1928, 2, 1636424161541, 1636424171553, 10012, 0, 10012, 0, 0, 0
2018, 1, 1636424170809, 1636424171576, 767, 316, 451, 316, 0, 316
2017, 1, 1636424170729, 1636424171592, 863, 416, 447, 416, 0, 416
1931, 2, 1636424161669, 1636424171669, 10000, 0, 10000, 0, 0, 0
2021, 1, 1636424171337, 1636424171781, 444, 0, 444, 0, 0, 0
2022, 1, 1636424171408, 1636424171897, 489, 1, 488, 1, 0, 1
1934, 2, 1636424162045, 1636424172044, 9999, 0, 9999, 0, 0, 0
2023, 1, 1636424171761, 1636424172217, 456, 0, 456, 0, 0, 0
2024, 1, 1636424171857, 1636424172305, 448, 0, 448, 0, 0, 0
2025, 1, 1636424171877, 1636424172356, 479, 20, 459, 20, 0, 20
2027, 1, 1636424171952, 1636424172393, 441, 1, 440, 0, 0, 0
2028, 1, 1636424172025, 1636424172473, 448, 0, 448, 0, 0, 0
2031, 1, 1636424172036, 1636424172476, 440, 0, 440, 0, 0, 0
2034, 1, 1636424172228, 1636424172672, 444, 1, 443, 1, 0, 1
2026, 1, 1636424171980, 1636424172757, 777, 325, 452, 325, 0, 325
2033, 1, 1636424172132, 1636424172840, 708, 261, 447, 260, 0, 260
2032, 1, 1636424172088, 1636424172929, 841, 385, 456, 385, 0, 385
2038, 1, 1636424172688, 1636424173140, 452, 0, 452, 0, 0, 0
2037, 1, 1636424172646, 1636424173208, 562, 112, 450, 111, 1, 112
2039, 1, 1636424173073, 1636424173532, 459, 0, 459, 0, 0, 0
2040, 1, 1636424173132, 1636424173576, 444, 1, 443, 0, 0, 0
2041, 1, 1636424173153, 1636424173604, 451, 0, 451, 0, 0, 0
2036, 1, 1636424172348, 1636424173661, 1313, 861, 452, 861, 0, 861
2044, 1, 1636424173300, 1636424173749, 449, 0, 449, 0, 0, 0
2046, 1, 1636424173416, 1636424173869, 453, 1, 452, 1, 0, 1
2048, 1, 1636424173520, 1636424173969, 449, 1, 448, 1, 0, 1
2042, 1, 1636424173233, 1636424174024, 791, 344, 447, 344, 0, 344
2045, 1, 1636424173392, 1636424174205, 813, 357, 456, 356, 0, 356
2049, 1, 1636424173880, 1636424174337, 457, 0, 457, 0, 0, 0
2050, 1, 1636424173944, 1636424174397, 453, 1, 452, 0, 0, 0
2051, 1, 1636424173973, 1636424174425, 452, 0, 452, 0, 0, 0
2053, 1, 1636424174444, 1636424174893, 449, 1, 448, 0, 0, 0
2054, 1, 1636424174492, 1636424174945, 453, 1, 452, 0, 0, 0
1960, 2, 1636424164992, 1636424174992, 10000, 0, 10000, 0, 0, 0
2056, 1, 1636424174637, 1636424175088, 451, 0, 451, 0, 0, 0
2058, 1, 1636424174721, 1636424175220, 499, 0, 499, 0, 0, 0
2055, 1, 1636424174576, 1636424175405, 829, 369, 460, 368, 0, 368
2059, 1, 1636424174917, 1636424175413, 496, 0, 496, 0, 0, 0
2057, 1, 1636424174700, 1636424175537, 837, 389, 448, 388, 0, 388
2060, 1, 1636424175188, 1636424175641, 453, 1, 452, 0, 1, 1
2061, 1, 1636424175301, 1636424175749, 448, 0, 448, 0, 0, 0
2063, 1, 1636424175332, 1636424175781, 449, 0, 449, 0, 0, 0
2062, 1, 1636424175304, 1636424175864, 560, 110, 450, 108, 0, 108
2064, 1, 1636424175840, 1636424176321, 481, 25, 456, 25, 0, 25
2065, 1, 1636424175876, 1636424176329, 453, 1, 452, 0, 1, 1
2067, 1, 1636424175996, 1636424176449, 453, 0, 453, 0, 0, 0
2068, 1, 1636424176032, 1636424176484, 452, 1, 451, 0, 0, 0
2070, 1, 1636424176197, 1636424176648, 451, 0, 451, 0, 0, 0
2066, 1, 1636424175908, 1636424176777, 869, 421, 448, 421, 0, 421
2069, 1, 1636424176048, 1636424176901, 853, 401, 452, 400, 0, 400
2071, 1, 1636424176528, 1636424176985, 457, 0, 457, 0, 0, 0
2072, 1, 1636424176588, 1636424177037, 449, 1, 448, 1, 0, 1
2073, 1, 1636424176625, 1636424177089, 464, 24, 440, 24, 0, 24
2074, 1, 1636424176640, 1636424177092, 452, 0, 452, 0, 0, 0
2075, 1, 1636424177136, 1636424177589, 453, 1, 452, 0, 0, 0
2076, 1, 1636424177161, 1636424177613, 452, 0, 452, 0, 0, 0
2078, 1, 1636424177357, 1636424177813, 456, 0, 456, 0, 0, 0
2080, 1, 1636424177432, 1636424177884, 452, 1, 451, 0, 0, 0
2081, 1, 1636424177504, 1636424177957, 453, 1, 452, 1, 0, 1
2077, 1, 1636424177221, 1636424178069, 848, 392, 456, 392, 0, 392
2079, 1, 1636424177396, 1636424178261, 865, 418, 447, 417, 0, 417
2082, 1, 1636424177873, 1636424178325, 452, 0, 452, 0, 0, 0
2083, 1, 1636424177892, 1636424178345, 453, 1, 452, 0, 0, 0
2084, 1, 1636424177929, 1636424178405, 476, 28, 448, 28, 0, 28
1991, 2, 1636424168428, 1636424178429, 10001, 0, 10001, 0, 0, 0
2085, 1, 1636424177989, 1636424178432, 443, 0, 443, 0, 0, 0
2086, 1, 1636424178429, 1636424178880, 451, 1, 450, 0, 0, 0
2087, 1, 1636424178476, 1636424178924, 448, 0, 448, 0, 0, 0
2089, 1, 1636424178681, 1636424179144, 463, 0, 463, 0, 0, 0
2092, 1, 1636424178732, 1636424179180, 448, 1, 447, 0, 0, 0
2090, 1, 1636424178732, 1636424179188, 456, 1, 455, 1, 0, 1
2093, 1, 1636424178880, 1636424179328, 448, 0, 448, 0, 0, 0
2088, 1, 1636424178564, 1636424179332, 768, 317, 451, 317, 0, 317
2091, 1, 1636424178704, 1636424179589, 885, 441, 444, 441, 0, 441
2095, 1, 1636424179232, 1636424179677, 445, 1, 444, 1, 0, 1
2094, 1, 1636424179232, 1636424179680, 448, 1, 447, 0, 0, 0
2096, 1, 1636424179316, 1636424179785, 469, 13, 456, 12, 1, 13
2097, 1, 1636424179336, 1636424179793, 457, 0, 457, 0, 0, 0
2098, 1, 1636424179768, 1636424180213, 445, 1, 444, 0, 1, 1
2099, 1, 1636424179801, 1636424180240, 439, 0, 439, 0, 0, 0
2009, 2, 1636424170372, 1636424180373, 10001, 0, 10001, 0, 0, 0
2101, 1, 1636424179972, 1636424180420, 448, 0, 448, 0, 0, 0
2102, 1, 1636424180013, 1636424180464, 451, 0, 451, 0, 0, 0
2103, 1, 1636424180036, 1636424180488, 452, 1, 451, 0, 1, 1
2100, 1, 1636424179877, 1636424180680, 803, 336, 467, 336, 0, 336
2105, 1, 1636424180273, 1636424180724, 451, 0, 451, 0, 0, 0
2035, 1, 1636424172300, 1636424180833, 8533, 8073, 460, 0, 8072, 8072
2104, 1, 1636424180041, 1636424180921, 880, 424, 456, 424, 0, 424
2106, 1, 1636424180524, 1636424180977, 453, 0, 453, 0, 0, 0
2107, 1, 1636424180581, 1636424181033, 452, 0, 452, 0, 0, 0
2108, 1, 1636424180680, 1636424181137, 457, 1, 456, 0, 0, 0
2109, 1, 1636424180680, 1636424181177, 497, 45, 452, 45, 0, 45
2110, 1, 1636424181056, 1636424181505, 449, 1, 448, 0, 1, 1
2111, 1, 1636424181137, 1636424181581, 444, 0, 444, 0, 0, 0
2112, 1, 1636424181185, 1636424181637, 452, 0, 452, 0, 0, 0
2114, 1, 1636424181281, 1636424181729, 448, 0, 448, 0, 0, 0
2115, 1, 1636424181348, 1636424181793, 445, 1, 444, 1, 0, 1
2117, 1, 1636424181413, 1636424181864, 451, 0, 451, 0, 0, 0
2113, 1, 1636424181236, 1636424182033, 797, 345, 452, 345, 0, 345
2029, 2, 1636424172032, 1636424182033, 10001, 0, 10001, 0, 0, 0
2030, 2, 1636424172032, 1636424182080, 10048, 0, 10048, 0, 0, 0
2118, 1, 1636424181669, 1636424182116, 447, 0, 447, 0, 0, 0
2116, 1, 1636424181388, 1636424182304, 916, 405, 511, 405, 0, 405
2119, 1, 1636424181860, 1636424182393, 533, 1, 532, 0, 1, 1
2120, 1, 1636424181908, 1636424182393, 485, 1, 484, 0, 1, 1
2121, 1, 1636424181917, 1636424182396, 479, 0, 479, 0, 0, 0
2122, 1, 1636424182128, 1636424182576, 448, 1, 447, 0, 0, 0
2123, 1, 1636424182288, 1636424182737, 449, 1, 448, 0, 0, 0
2124, 1, 1636424182345, 1636424182797, 452, 0, 452, 0, 0, 0
2126, 1, 1636424182408, 1636424183032, 624, 169, 455, 169, 0, 169
2129, 1, 1636424182613, 1636424183065, 452, 0, 452, 0, 0, 0
2130, 1, 1636424182640, 1636424183096, 456, 0, 456, 0, 0, 0
2125, 1, 1636424182348, 1636424183244, 896, 449, 447, 449, 0, 449
2132, 1, 1636424182808, 1636424183248, 440, 0, 440, 0, 0, 0
2043, 2, 1636424173252, 1636424183260, 10008, 0, 10008, 409, 0, 409
2133, 1, 1636424182973, 1636424183416, 443, 0, 443, 0, 0, 0
2047, 2, 1636424173429, 1636424183433, 10004, 0, 10004, 232, 0, 232
2131, 1, 1636424182708, 1636424183512, 804, 357, 447, 357, 0, 357
2134, 1, 1636424183140, 1636424183588, 448, 1, 447, 0, 0, 0
2135, 1, 1636424183212, 1636424183664, 452, 0, 452, 0, 0, 0
2136, 1, 1636424183229, 1636424183689, 460, 0, 460, 0, 0, 0
2137, 1, 1636424183352, 1636424183873, 521, 64, 457, 64, 0, 64
2052, 1, 1636424174376, 1636424183892, 9516, 9057, 459, 0, 9056, 9056
2138, 1, 1636424183585, 1636424184037, 452, 0, 452, 0, 0, 0
2139, 1, 1636424183601, 1636424184057, 456, 0, 456, 0, 0, 0
2141, 1, 1636424183789, 1636424184241, 452, 0, 452, 0, 0, 0
2142, 1, 1636424183924, 1636424184368, 444, 0, 444, 0, 0, 0
2146, 1, 1636424184024, 1636424184468, 444, 1, 443, 0, 1, 1
2140, 1, 1636424183613, 1636424184512, 899, 444, 455, 444, 0, 444
2149, 1, 1636424184248, 1636424184697, 449, 0, 449, 0, 0, 0
2145, 1, 1636424184020, 1636424184829, 809, 349, 460, 348, 0, 348
2150, 1, 1636424184517, 1636424184969, 452, 0, 452, 0, 0, 0
2151, 1, 1636424184532, 1636424184980, 448, 1, 447, 0, 0, 0
2152, 1, 1636424184581, 1636424185024, 443, 0, 443, 0, 0, 0
2153, 1, 1636424184672, 1636424185153, 481, 26, 455, 24, 0, 24
2154, 1, 1636424184940, 1636424185397, 457, 0, 457, 0, 0, 0
2156, 1, 1636424184969, 1636424185424, 455, 1, 454, 0, 1, 1
2157, 1, 1636424185121, 1636424185561, 440, 0, 440, 0, 0, 0
2158, 1, 1636424185272, 1636424185729, 457, 0, 457, 0, 0, 0
2159, 1, 1636424185316, 1636424185765, 449, 1, 448, 0, 1, 1
2155, 1, 1636424184969, 1636424185852, 883, 428, 455, 428, 0, 428
2160, 1, 1636424185357, 1636424186185, 828, 373, 455, 372, 1, 373
2162, 1, 1636424185904, 1636424186353, 449, 1, 448, 1, 0, 1
2163, 1, 1636424185920, 1636424186372, 452, 1, 451, 0, 1, 1
2164, 1, 1636424185924, 1636424186385, 461, 1, 460, 0, 0, 0
2166, 1, 1636424186265, 1636424186712, 447, 0, 447, 0, 0, 0
2167, 1, 1636424186301, 1636424186752, 451, 0, 451, 0, 0, 0
2169, 1, 1636424186388, 1636424186841, 453, 1, 452, 1, 0, 1
2170, 1, 1636424186620, 1636424187073, 453, 1, 452, 0, 0, 0
2171, 1, 1636424186628, 1636424187081, 453, 1, 452, 0, 0, 0
2168, 1, 1636424186312, 1636424187209, 897, 442, 455, 441, 1, 442
2172, 1, 1636424186697, 1636424187537, 840, 384, 456, 384, 0, 384
2173, 1, 1636424187177, 1636424187628, 451, 0, 451, 0, 0, 0
2174, 1, 1636424187189, 1636424187648, 459, 0, 459, 0, 0, 0
2175, 1, 1636424187236, 1636424187689, 453, 1, 452, 0, 0, 0
2176, 1, 1636424187604, 1636424188056, 452, 1, 451, 0, 0, 0
2179, 1, 1636424187692, 1636424188145, 453, 1, 452, 0, 0, 0
2180, 1, 1636424187909, 1636424188361, 452, 0, 452, 0, 0, 0
2181, 1, 1636424188005, 1636424188453, 448, 0, 448, 0, 0, 0
2182, 1, 1636424188044, 1636424188905, 861, 410, 451, 410, 0, 410
2183, 1, 1636424188480, 1636424188933, 453, 1, 452, 0, 1, 1
2185, 1, 1636424188532, 1636424188985, 453, 0, 453, 0, 0, 0
2184, 1, 1636424188524, 1636424188985, 461, 0, 461, 0, 0, 0
2186, 1, 1636424188969, 1636424189417, 448, 0, 448, 0, 0, 0
2187, 1, 1636424189045, 1636424189501, 456, 0, 456, 0, 0, 0
2188, 1, 1636424189205, 1636424189657, 452, 0, 452, 0, 0, 0
2189, 1, 1636424189312, 1636424189764, 452, 1, 451, 0, 0, 0
2190, 1, 1636424189356, 1636424190216, 860, 409, 451, 409, 0, 409
2191, 1, 1636424189764, 1636424190216, 452, 0, 452, 0, 0, 0
2192, 1, 1636424189808, 1636424190260, 452, 1, 451, 1, 0, 1
2193, 1, 1636424189901, 1636424190345, 444, 0, 444, 0, 0, 0
2194, 1, 1636424190252, 1636424190705, 453, 1, 452, 0, 0, 0
2195, 1, 1636424190401, 1636424190849, 448, 0, 448, 0, 0, 0
2196, 1, 1636424190472, 1636424190925, 453, 1, 452, 0, 0, 0
2197, 1, 1636424190684, 1636424191136, 452, 1, 451, 0, 0, 0
2199, 1, 1636424191092, 1636424191537, 445, 1, 444, 0, 1, 1
2200, 1, 1636424191104, 1636424191557, 453, 0, 453, 0, 0, 0
2198, 1, 1636424190689, 1636424191581, 892, 448, 444, 448, 0, 448
2201, 1, 1636424191177, 1636424191628, 451, 0, 451, 0, 0, 0
2202, 1, 1636424191649, 1636424192101, 452, 0, 452, 0, 0, 0
2203, 1, 1636424191781, 1636424192237, 456, 0, 456, 0, 0, 0
2204, 1, 1636424191865, 1636424192312, 447, 0, 447, 0, 0, 0
2127, 2, 1636424182540, 1636424192541, 10001, 0, 10001, 493, 0, 493
2128, 2, 1636424182588, 1636424192589, 10001, 0, 10001, 445, 0, 445
2207, 1, 1636424192356, 1636424192817, 461, 1, 460, 0, 0, 0
2208, 1, 1636424192397, 1636424192909, 512, 0, 512, 0, 0, 0
2209, 1, 1636424192589, 1636424193044, 455, 1, 454, 0, 1, 1
2148, 1, 1636424184208, 1636424193044, 8836, 8381, 455, 0, 8381, 8381
2210, 1, 1636424193048, 1636424193497, 449, 0, 449, 0, 0, 0
2211, 1, 1636424193060, 1636424193512, 452, 1, 451, 0, 1, 1
2212, 1, 1636424193165, 1636424193621, 456, 0, 456, 0, 0, 0
2213, 1, 1636424193281, 1636424193737, 456, 0, 456, 0, 0, 0
2215, 1, 1636424193340, 1636424193797, 457, 1, 456, 0, 0, 0
2144, 2, 1636424183968, 1636424193969, 10001, 0, 10001, 273, 0, 273
2143, 2, 1636424183972, 1636424194017, 10045, 0, 10045, 269, 0, 269
2147, 2, 1636424184116, 1636424194117, 10001, 0, 10001, 124, 0, 124
2217, 1, 1636424193761, 1636424194244, 483, 0, 483, 0, 0, 0
2214, 1, 1636424193349, 1636424194244, 895, 389, 506, 388, 0, 388
2218, 1, 1636424193932, 1636424194444, 512, 1, 511, 0, 0, 0
2219, 1, 1636424194368, 1636424194821, 453, 0, 453, 0, 0, 0
2220, 1, 1636424194433, 1636424194885, 452, 0, 452, 0, 0, 0
2224, 1, 1636424194528, 1636424194985, 457, 1, 456, 0, 0, 0
2222, 1, 1636424194552, 1636424195009, 457, 0, 457, 0, 0, 0
2225, 1, 1636424194556, 1636424195009, 453, 1, 452, 0, 0, 0
2228, 1, 1636424195052, 1636424195500, 448, 0, 448, 0, 0, 0
2161, 2, 1636424185521, 1636424195520, 9999, 0, 9999, 0, 0, 0
2229, 1, 1636424195248, 1636424195740, 492, 1, 491, 0, 0, 0
2165, 2, 1636424185984, 1636424195985, 10001, 0, 10001, 0, 0, 0
2230, 1, 1636424195712, 1636424196205, 493, 1, 492, 0, 1, 1
2233, 1, 1636424195817, 1636424196301, 484, 0, 484, 0, 0, 0
2235, 1, 1636424195924, 1636424196385, 461, 1, 460, 0, 0, 0
2234, 1, 1636424195912, 1636424196392, 480, 1, 479, 0, 0, 0
2237, 1, 1636424196609, 1636424197061, 452, 0, 452, 0, 0, 0
2238, 1, 1636424197009, 1636424197465, 456, 0, 456, 0, 0, 0
2239, 1, 1636424197161, 1636424197613, 452, 0, 452, 0, 0, 0
2240, 1, 1636424197184, 1636424197637, 453, 1, 452, 1, 0, 1
2177, 2, 1636424187640, 1636424197641, 10001, 0, 10001, 0, 0, 0
2178, 2, 1636424187656, 1636424197685, 10029, 9985, 44, 1, 9985, 9986
2242, 1, 1636424197876, 1636424198329, 453, 0, 453, 0, 0, 0
2244, 1, 1636424197948, 1636424198401, 453, 1, 452, 0, 0, 0
2245, 1, 1636424198376, 1636424198829, 453, 1, 452, 0, 1, 1
2243, 1, 1636424197953, 1636424198849, 896, 448, 448, 448, 0, 448
2246, 1, 1636424198448, 1636424198897, 449, 1, 448, 0, 1, 1
2247, 1, 1636424198469, 1636424198925, 456, 0, 456, 0, 0, 0
2248, 1, 1636424199148, 1636424199601, 453, 0, 453, 0, 0, 0
2249, 1, 1636424199180, 1636424199632, 452, 1, 451, 0, 0, 0
2250, 1, 1636424199193, 1636424200056, 863, 409, 454, 408, 0, 408
2251, 1, 1636424199721, 1636424200173, 452, 0, 452, 0, 0, 0
2252, 1, 1636424199805, 1636424200257, 452, 0, 452, 0, 0, 0
2253, 1, 1636424200469, 1636424200921, 452, 0, 452, 0, 0, 0
2254, 1, 1636424200536, 1636424200989, 453, 1, 452, 0, 0, 0
2255, 1, 1636424200540, 1636424201445, 905, 450, 455, 448, 1, 449
2256, 1, 1636424201017, 1636424201472, 455, 0, 455, 0, 0, 0
2257, 1, 1636424201100, 1636424201557, 457, 1, 456, 0, 1, 1
2205, 2, 1636424192037, 1636424202037, 10000, 0, 10000, 276, 0, 276
2206, 2, 1636424192041, 1636424202085, 10044, 0, 10044, 272, 0, 272
2258, 1, 1636424201741, 1636424202193, 452, 0, 452, 0, 0, 0
2259, 1, 1636424201880, 1636424202400, 520, 1, 519, 0, 0, 0
2261, 1, 1636424202368, 1636424202821, 453, 0, 453, 0, 0, 0
2260, 1, 1636424201920, 1636424202853, 933, 481, 452, 481, 0, 481
2262, 1, 1636424202404, 1636424202861, 457, 0, 457, 0, 0, 0
2265, 1, 1636424203045, 1636424203492, 447, 0, 447, 0, 0, 0
2266, 1, 1636424203249, 1636424203697, 448, 0, 448, 0, 0, 0
2216, 2, 1636424193749, 1636424203748, 9999, 0, 9999, 0, 0, 0
2267, 1, 1636424203256, 1636424204149, 893, 441, 452, 440, 0, 440
2268, 1, 1636424203744, 1636424204197, 453, 1, 452, 0, 0, 0
2231, 1, 1636424195784, 1636424204197, 8413, 7965, 448, 0, 7964, 7964
2269, 1, 1636424203792, 1636424204240, 448, 1, 447, 0, 1, 1
2223, 2, 1636424194556, 1636424204553, 9997, 0, 9997, 453, 0, 453
2227, 2, 1636424194596, 1636424204601, 10005, 0, 10005, 414, 0, 414
2226, 2, 1636424194580, 1636424204649, 10069, 0, 10069, 430, 0, 430
2270, 1, 1636424204061, 1636424204652, 591, 137, 454, 136, 0, 136
2221, 2, 1636424194556, 1636424204701, 10145, 0, 10145, 453, 0, 453
2271, 1, 1636424204365, 1636424204924, 559, 0, 559, 0, 0, 0
2275, 1, 1636424204969, 1636424205421, 452, 0, 452, 0, 0, 0
2277, 1, 1636424205152, 1636424205613, 461, 0, 461, 0, 0, 0
2278, 1, 1636424205312, 1636424205761, 449, 1, 448, 0, 1, 1
2279, 1, 1636424205320, 1636424205772, 452, 1, 451, 1, 0, 1
2232, 2, 1636424195836, 1636424205837, 10001, 0, 10001, 0, 0, 0
2282, 1, 1636424205676, 1636424206157, 481, 1, 480, 0, 0, 0
2280, 1, 1636424205320, 1636424206253, 933, 442, 491, 442, 0, 442
2236, 2, 1636424196285, 1636424206285, 10000, 0, 10000, 0, 0, 0
2283, 1, 1636424206141, 1636424206704, 563, 113, 450, 113, 0, 113
2284, 1, 1636424206268, 1636424206708, 440, 1, 439, 1, 0, 1
2241, 1, 1636424197224, 1636424206736, 9512, 9061, 451, 0, 9061, 9061
2285, 1, 1636424206525, 1636424206969, 444, 0, 444, 0, 0, 0
2288, 1, 1636424206576, 1636424207013, 437, 0, 437, 0, 0, 0
2287, 1, 1636424206564, 1636424207013, 449, 0, 449, 0, 0, 0
2286, 1, 1636424206592, 1636424207157, 565, 113, 452, 113, 0, 113
2291, 1, 1636424207009, 1636424207461, 452, 0, 452, 0, 0, 0
2289, 1, 1636424206600, 1636424207468, 868, 414, 454, 414, 0, 414
2290, 1, 1636424206957, 1636424207613, 656, 200, 456, 200, 0, 200
2292, 1, 1636424207409, 1636424207917, 508, 60, 448, 60, 0, 60
2293, 1, 1636424207597, 1636424208049, 452, 0, 452, 0, 0, 0
2294, 1, 1636424207812, 1636424208269, 457, 1, 456, 0, 1, 1
2295, 1, 1636424207820, 1636424208277, 457, 1, 456, 0, 0, 0
2297, 1, 1636424207896, 1636424208345, 449, 1, 448, 0, 1, 1
2296, 1, 1636424207856, 1636424208377, 521, 61, 460, 61, 0, 61
2300, 1, 1636424208341, 1636424208793, 452, 0, 452, 0, 0, 0
2298, 1, 1636424207920, 1636424208800, 880, 425, 455, 425, 0, 425
2299, 1, 1636424208273, 1636424208829, 556, 105, 451, 104, 1, 105
2301, 1, 1636424208697, 1636424209249, 552, 104, 448, 104, 0, 104
2302, 1, 1636424208961, 1636424209413, 452, 0, 452, 0, 0, 0
2303, 1, 1636424209133, 1636424209581, 448, 0, 448, 0, 0, 0
2305, 1, 1636424209204, 1636424209661, 457, 1, 456, 0, 0, 0
2304, 1, 1636424209169, 1636424209693, 524, 80, 444, 80, 0, 80
2306, 1, 1636424209589, 1636424210144, 555, 105, 450, 104, 0, 104
2307, 1, 1636424209693, 1636424210144, 451, 0, 451, 0, 0, 0
2308, 1, 1636424210305, 1636424210757, 452, 0, 452, 0, 0, 0
2309, 1, 1636424210408, 1636424210861, 453, 1, 452, 0, 0, 0
2310, 1, 1636424210509, 1636424210965, 456, 0, 456, 0, 0, 0
2311, 1, 1636424210969, 1636424211421, 452, 0, 452, 0, 0, 0
2312, 1, 1636424211593, 1636424212045, 452, 0, 452, 0, 0, 0
2313, 1, 1636424211673, 1636424212125, 452, 0, 452, 0, 0, 0
2263, 2, 1636424202625, 1636424212625, 10000, 0, 10000, 0, 0, 0
2264, 2, 1636424202625, 1636424212669, 10044, 0, 10044, 0, 0, 0
2314, 1, 1636424212244, 1636424212693, 449, 0, 449, 0, 0, 0
2272, 1, 1636424204436, 1636424213116, 8680, 8233, 447, 0, 8232, 8232
2315, 1, 1636424212937, 1636424213389, 452, 0, 452, 0, 0, 0
2317, 1, 1636424212937, 1636424213400, 463, 1, 462, 0, 1, 1
2318, 1, 1636424212952, 1636424213400, 448, 0, 448, 0, 0, 0
2320, 1, 1636424213536, 1636424213989, 453, 1, 452, 1, 0, 1
2321, 1, 1636424214137, 1636424214593, 456, 0, 456, 0, 0, 0
2274, 2, 1636424204749, 1636424214697, 9948, 0, 9948, 0, 0, 0
2273, 2, 1636424204749, 1636424214741, 9992, 9948, 44, 0, 9948, 9948
2322, 1, 1636424214301, 1636424214753, 452, 0, 452, 0, 0, 0
2276, 2, 1636424205009, 1636424215009, 10000, 0, 10000, 0, 0, 0
2281, 2, 1636424205284, 1636424215284, 10000, 0, 10000, 0, 0, 0
2323, 1, 1636424214877, 1636424215328, 451, 0, 451, 0, 0, 0
2324, 1, 1636424215005, 1636424215456, 451, 0, 451, 0, 0, 0
2326, 1, 1636424215328, 1636424215789, 461, 1, 460, 0, 1, 1
2327, 1, 1636424215456, 1636424215908, 452, 1, 451, 0, 1, 1
2325, 1, 1636424215052, 1636424215908, 856, 405, 451, 405, 0, 405
2329, 1, 1636424215608, 1636424216061, 453, 1, 452, 0, 1, 1
2328, 1, 1636424215588, 1636424216244, 656, 201, 455, 201, 0, 201
2330, 1, 1636424216189, 1636424216640, 451, 0, 451, 0, 0, 0
2331, 1, 1636424216284, 1636424216741, 457, 0, 457, 0, 0, 0
2333, 1, 1636424216596, 1636424217045, 449, 0, 449, 0, 0, 0
2332, 1, 1636424216308, 1636424217197, 889, 434, 455, 433, 0, 433
2334, 1, 1636424216773, 1636424217225, 452, 0, 452, 0, 0, 0
2335, 1, 1636424216873, 1636424217501, 628, 173, 455, 172, 1, 173
2337, 1, 1636424217565, 1636424218012, 447, 0, 447, 0, 0, 0
2338, 1, 1636424217625, 1636424218081, 456, 0, 456, 0, 0, 0
2340, 1, 1636424217905, 1636424218360, 455, 0, 455, 0, 0, 0
2339, 1, 1636424217657, 1636424218545, 888, 424, 464, 424, 0, 424
2341, 1, 1636424218165, 1636424218613, 448, 0, 448, 0, 0, 0
2342, 1, 1636424218180, 1636424218809, 629, 181, 448, 181, 0, 181
2344, 1, 1636424218948, 1636424219401, 453, 1, 452, 0, 0, 0
2346, 1, 1636424219269, 1636424219721, 452, 0, 452, 0, 0, 0
2345, 1, 1636424218981, 1636424219857, 876, 421, 455, 420, 0, 420
2347, 1, 1636424219440, 1636424219893, 453, 0, 453, 0, 0, 0
2348, 1, 1636424219509, 1636424220177, 668, 213, 455, 212, 1, 213
2349, 1, 1636424220257, 1636424220709, 452, 0, 452, 0, 0, 0
2351, 1, 1636424220597, 1636424221049, 452, 0, 452, 0, 0, 0
2350, 1, 1636424220309, 1636424221165, 856, 400, 456, 400, 0, 400
2352, 1, 1636424220732, 1636424221189, 457, 0, 457, 0, 0, 0
2353, 1, 1636424220809, 1636424221505, 696, 241, 455, 240, 1, 241
2354, 1, 1636424221605, 1636424222057, 452, 0, 452, 0, 0, 0
2356, 1, 1636424221937, 1636424222388, 451, 0, 451, 0, 0, 0
2355, 1, 1636424221669, 1636424222513, 844, 388, 456, 388, 0, 388
2357, 1, 1636424222068, 1636424222521, 453, 0, 453, 0, 0, 0
2358, 1, 1636424222164, 1636424222845, 681, 225, 456, 224, 0, 224
2316, 2, 1636424212937, 1636424222937, 10000, 0, 10000, 452, 0, 452
2319, 2, 1636424213332, 1636424223337, 10005, 0, 10005, 57, 0, 57
2359, 1, 1636424222984, 1636424223433, 449, 0, 449, 0, 0, 0
2361, 1, 1636424223209, 1636424223660, 451, 0, 451, 0, 0, 0
2336, 1, 1636424216992, 1636424223781, 6789, 6345, 444, 0, 6344, 6344
2362, 1, 1636424223380, 1636424223833, 453, 1, 452, 0, 1, 1
2360, 1, 1636424223028, 1636424223885, 857, 405, 452, 405, 0, 405
2363, 1, 1636424223472, 1636424224117, 645, 189, 456, 189, 0, 189
2365, 1, 1636424223700, 1636424224153, 453, 0, 453, 0, 0, 0
2367, 1, 1636424224296, 1636424224745, 449, 1, 448, 1, 0, 1
2369, 1, 1636424224600, 1636424225053, 453, 0, 453, 0, 0, 0
2370, 1, 1636424224725, 1636424225177, 452, 0, 452, 0, 0, 0
2368, 1, 1636424224376, 1636424225201, 825, 369, 456, 368, 0, 368
2372, 1, 1636424224944, 1636424225397, 453, 1, 452, 0, 0, 0
2371, 1, 1636424224800, 1636424225513, 713, 254, 459, 253, 0, 253
2373, 1, 1636424225608, 1636424226061, 453, 1, 452, 0, 0, 0
2375, 1, 1636424225992, 1636424226445, 453, 1, 452, 0, 0, 0
2374, 1, 1636424225697, 1636424226509, 812, 364, 448, 364, 0, 364
2376, 1, 1636424226085, 1636424226533, 448, 0, 448, 0, 0, 0
2378, 1, 1636424226341, 1636424226796, 455, 0, 455, 0, 0, 0
2377, 1, 1636424226145, 1636424226896, 751, 301, 450, 300, 0, 300
2379, 1, 1636424226981, 1636424227433, 452, 0, 452, 0, 0, 0
2381, 1, 1636424227317, 1636424227768, 451, 0, 451, 0, 0, 0
2382, 1, 1636424227368, 1636424227816, 448, 1, 447, 0, 0, 0
2380, 1, 1636424227037, 1636424227893, 856, 397, 459, 396, 0, 396
2384, 1, 1636424227709, 1636424228165, 456, 0, 456, 0, 0, 0
2383, 1, 1636424227472, 1636424228225, 753, 297, 456, 297, 0, 297
2385, 1, 1636424228329, 1636424228781, 452, 0, 452, 0, 0, 0
2343, 2, 1636424218828, 1636424228828, 10000, 0, 10000, 0, 0, 0
2387, 1, 1636424228621, 1636424229072, 451, 0, 451, 0, 0, 0
2388, 1, 1636424228764, 1636424229241, 477, 1, 476, 0, 0, 0
2386, 1, 1636424228389, 1636424229241, 852, 392, 460, 392, 0, 392
2389, 1, 1636424228800, 1636424229521, 721, 273, 448, 272, 0, 272
2391, 1, 1636424229101, 1636424229549, 448, 0, 448, 0, 0, 0
2390, 1, 1636424229137, 1636424229589, 452, 0, 452, 0, 0, 0
2394, 1, 1636424229896, 1636424230349, 453, 1, 452, 0, 0, 0
2396, 1, 1636424230113, 1636424230564, 451, 0, 451, 0, 0, 0
2395, 1, 1636424230097, 1636424230797, 700, 252, 448, 252, 0, 252
2397, 1, 1636424230392, 1636424230841, 449, 1, 448, 0, 1, 1
2398, 1, 1636424230488, 1636424230941, 453, 1, 452, 1, 0, 1
2399, 1, 1636424231189, 1636424231641, 452, 0, 452, 0, 0, 0
2401, 1, 1636424231445, 1636424231901, 456, 0, 456, 0, 0, 0
2400, 1, 1636424231413, 1636424232092, 679, 228, 451, 228, 0, 228
2402, 1, 1636424231793, 1636424232245, 452, 0, 452, 0, 0, 0
2403, 1, 1636424231801, 1636424232253, 452, 0, 452, 0, 0, 0
2404, 1, 1636424232477, 1636424232929, 452, 0, 452, 0, 0, 0
2406, 1, 1636424232845, 1636424233305, 460, 0, 460, 0, 0, 0
2405, 1, 1636424232717, 1636424233389, 672, 213, 459, 212, 0, 212
2407, 1, 1636424233097, 1636424233549, 452, 0, 452, 0, 0, 0
2408, 1, 1636424233161, 1636424233608, 447, 0, 447, 0, 0, 0
2364, 2, 1636424223700, 1636424233701, 10001, 0, 10001, 454, 0, 454
2366, 2, 1636424224009, 1636424234009, 10000, 0, 10000, 145, 0, 145
2409, 1, 1636424234145, 1636424234592, 447, 0, 447, 0, 0, 0
2412, 1, 1636424234444, 1636424234897, 453, 0, 453, 0, 0, 0
2410, 1, 1636424234464, 1636424234917, 453, 0, 453, 0, 0, 0
2413, 1, 1636424234524, 1636424234973, 449, 0, 449, 0, 0, 0
2411, 1, 1636424234464, 1636424235377, 913, 454, 459, 453, 1, 454
2414, 1, 1636424235501, 1636424235952, 451, 0, 451, 0, 0, 0
2417, 1, 1636424235825, 1636424236277, 452, 0, 452, 0, 0, 0
2418, 1, 1636424235908, 1636424236357, 449, 0, 449, 0, 0, 0
2419, 1, 1636424236849, 1636424237301, 452, 0, 452, 0, 0, 0
2421, 1, 1636424237208, 1636424237661, 453, 1, 452, 0, 1, 1
2422, 1, 1636424238141, 1636424238597, 456, 0, 456, 0, 0, 0
2423, 1, 1636424238481, 1636424238933, 452, 0, 452, 0, 0, 0
2392, 2, 1636424229681, 1636424239681, 10000, 0, 10000, 0, 0, 0
2393, 2, 1636424229729, 1636424239724, 9995, 0, 9995, 0, 0, 0
2424, 1, 1636424239529, 1636424239996, 467, 0, 467, 0, 0, 0
2425, 1, 1636424239769, 1636424240221, 452, 0, 452, 0, 0, 0
2426, 1, 1636424239984, 1636424240437, 453, 1, 452, 1, 0, 1
2427, 1, 1636424240045, 1636424240896, 851, 393, 458, 393, 0, 393
2428, 1, 1636424240889, 1636424241341, 452, 0, 452, 0, 0, 0
2429, 1, 1636424241037, 1636424241489, 452, 0, 452, 0, 0, 0
2433, 1, 1636424242381, 1636424242837, 456, 0, 456, 0, 0, 0
2434, 1, 1636424243653, 1636424244105, 452, 0, 452, 0, 0, 0
2435, 1, 1636424244981, 1636424245433, 452, 0, 452, 0, 0, 0
2415, 2, 1636424235653, 1636424245653, 10000, 0, 10000, 0, 0, 0
2416, 2, 1636424235709, 1636424245708, 9999, 0, 9999, 0, 0, 0
2436, 1, 1636424245977, 1636424246429, 452, 0, 452, 0, 0, 0
2438, 1, 1636424246345, 1636424246793, 448, 0, 448, 0, 0, 0
2437, 1, 1636424246017, 1636424246881, 864, 413, 451, 412, 1, 413
2420, 2, 1636424237149, 1636424247149, 10000, 0, 10000, 0, 0, 0
2439, 1, 1636424247240, 1636424247692, 452, 1, 451, 0, 1, 1
2441, 1, 1636424247461, 1636424247913, 452, 0, 452, 0, 0, 0
2442, 1, 1636424247621, 1636424248073, 452, 0, 452, 0, 0, 0
2440, 1, 1636424247284, 1636424248145, 861, 409, 452, 409, 0, 409
2443, 1, 1636424248565, 1636424249017, 452, 0, 452, 0, 0, 0
2445, 1, 1636424248709, 1636424249161, 452, 0, 452, 0, 0, 0
2446, 1, 1636424248921, 1636424249373, 452, 0, 452, 0, 0, 0
2444, 1, 1636424248597, 1636424249473, 876, 421, 455, 420, 0, 420
2447, 1, 1636424249841, 1636424250293, 452, 0, 452, 0, 0, 0
2449, 1, 1636424250017, 1636424250469, 452, 0, 452, 0, 0, 0
2450, 1, 1636424250245, 1636424250697, 452, 0, 452, 0, 0, 0
2448, 1, 1636424249913, 1636424250749, 836, 380, 456, 380, 0, 380
2430, 2, 1636424241180, 1636424251181, 10001, 0, 10001, 1, 0, 1
2431, 2, 1636424241269, 1636424251269, 10000, 9912, 88, 0, 9912, 9912
2451, 1, 1636424251133, 1636424251592, 459, 0, 459, 0, 0, 0
2453, 1, 1636424251405, 1636424251853, 448, 0, 448, 0, 0, 0
2454, 1, 1636424251488, 1636424251941, 453, 0, 453, 0, 0, 0
2452, 1, 1636424251224, 1636424252044, 820, 369, 451, 369, 0, 369
2456, 1, 1636424251636, 1636424252089, 453, 0, 453, 0, 0, 0
2432, 2, 1636424242153, 1636424252153, 10000, 0, 10000, 0, 0, 0
2455, 1, 1636424251532, 1636424252401, 869, 409, 460, 409, 0, 409
2457, 1, 1636424252461, 1636424252912, 451, 0, 451, 0, 0, 0
2458, 1, 1636424252473, 1636424252925, 452, 0, 452, 0, 0, 0
2460, 1, 1636424252657, 1636424253105, 448, 0, 448, 0, 0, 0
2461, 1, 1636424252732, 1636424253181, 449, 0, 449, 0, 0, 0
2459, 1, 1636424252569, 1636424253385, 816, 356, 460, 356, 0, 356
2463, 1, 1636424253012, 1636424253461, 449, 1, 448, 0, 0, 0
2462, 1, 1636424252776, 1636424253637, 861, 405, 456, 405, 0, 405
2464, 1, 1636424253709, 1636424254168, 459, 0, 459, 0, 0, 0
2465, 1, 1636424253764, 1636424254212, 448, 0, 448, 0, 0, 0
2467, 1, 1636424254061, 1636424254513, 452, 0, 452, 0, 0, 0
2466, 1, 1636424253884, 1636424254665, 781, 329, 452, 328, 0, 328
2470, 1, 1636424254400, 1636424254853, 453, 1, 452, 0, 0, 0
2471, 1, 1636424255017, 1636424255468, 451, 0, 451, 0, 0, 0
2472, 1, 1636424255109, 1636424255561, 452, 0, 452, 0, 0, 0
2474, 1, 1636424255333, 1636424255785, 452, 0, 452, 0, 0, 0
2473, 1, 1636424255241, 1636424256021, 780, 320, 460, 320, 0, 320
2475, 1, 1636424255709, 1636424256157, 448, 0, 448, 0, 0, 0
2476, 1, 1636424256381, 1636424256837, 456, 0, 456, 0, 0, 0
2477, 1, 1636424256468, 1636424256921, 453, 1, 452, 0, 0, 0
2479, 1, 1636424256725, 1636424257180, 455, 0, 455, 0, 0, 0
2478, 1, 1636424256601, 1636424257376, 775, 320, 455, 320, 0, 320
2480, 1, 1636424257073, 1636424257524, 451, 0, 451, 0, 0, 0
2481, 1, 1636424257681, 1636424258136, 455, 0, 455, 0, 0, 0
2482, 1, 1636424257752, 1636424258205, 453, 0, 453, 0, 0, 0
2484, 1, 1636424258121, 1636424258573, 452, 0, 452, 0, 0, 0
2483, 1, 1636424257913, 1636424258657, 744, 292, 452, 292, 0, 292
2485, 1, 1636424258404, 1636424258857, 453, 1, 452, 0, 1, 1
2486, 1, 1636424259041, 1636424259492, 451, 0, 451, 0, 0, 0
2487, 1, 1636424259149, 1636424259593, 444, 0, 444, 0, 0, 0
2489, 1, 1636424259448, 1636424259901, 453, 1, 452, 0, 0, 0
2488, 1, 1636424259281, 1636424260049, 768, 313, 455, 313, 0, 313
2490, 1, 1636424259760, 1636424260216, 456, 0, 456, 0, 0, 0
2491, 1, 1636424260308, 1636424260757, 449, 1, 448, 0, 1, 1
2492, 1, 1636424260548, 1636424261001, 453, 1, 452, 0, 0, 0
2494, 1, 1636424260748, 1636424261201, 453, 1, 452, 1, 0, 1
2493, 1, 1636424260620, 1636424261452, 832, 381, 451, 381, 0, 381
2495, 1, 1636424261036, 1636424261489, 453, 0, 453, 0, 0, 0
2496, 1, 1636424261705, 1636424262157, 452, 0, 452, 0, 0, 0
2497, 1, 1636424261880, 1636424262333, 453, 1, 452, 1, 0, 1
2499, 1, 1636424262025, 1636424262477, 452, 0, 452, 0, 0, 0
2498, 1, 1636424261940, 1636424262789, 849, 394, 455, 392, 1, 393
2500, 1, 1636424262421, 1636424262873, 452, 0, 452, 0, 0, 0
2501, 1, 1636424263101, 1636424263553, 452, 0, 452, 0, 0, 0
2502, 1, 1636424263277, 1636424263733, 456, 0, 456, 0, 0, 0
2469, 2, 1636424254129, 1636424264129, 10000, 0, 10000, 0, 0, 0
2468, 2, 1636424254129, 1636424264172, 10043, 0, 10043, 0, 0, 0
2503, 1, 1636424263305, 1636424264184, 879, 429, 450, 428, 0, 428
2504, 1, 1636424263816, 1636424264269, 453, 1, 452, 0, 0, 0
2507, 1, 1636424264413, 1636424264865, 452, 0, 452, 0, 0, 0
2506, 1, 1636424264436, 1636424264889, 453, 1, 452, 0, 0, 0
2508, 1, 1636424264552, 1636424265009, 457, 1, 456, 1, 0, 1
2505, 1, 1636424264441, 1636424265341, 900, 448, 452, 448, 0, 448
2509, 1, 1636424264621, 1636424265469, 848, 389, 459, 388, 0, 388
2510, 1, 1636424265125, 1636424265581, 456, 0, 456, 0, 0, 0
2511, 1, 1636424265697, 1636424266149, 452, 0, 452, 0, 0, 0
2514, 1, 1636424265924, 1636424266381, 457, 0, 457, 0, 0, 0
2515, 1, 1636424265977, 1636424266837, 860, 405, 455, 404, 0, 404
2517, 1, 1636424266973, 1636424267425, 452, 0, 452, 0, 0, 0
2518, 1, 1636424267273, 1636424267725, 452, 0, 452, 0, 0, 0
2519, 1, 1636424267336, 1636424268181, 845, 390, 455, 389, 1, 390
2520, 1, 1636424268337, 1636424268785, 448, 0, 448, 0, 0, 0
2521, 1, 1636424268593, 1636424269045, 452, 0, 452, 0, 0, 0
2522, 1, 1636424268657, 1636424269501, 844, 388, 456, 388, 0, 388
2523, 1, 1636424269701, 1636424270157, 456, 0, 456, 0, 0, 0
2524, 1, 1636424269981, 1636424270433, 452, 0, 452, 0, 0, 0
2525, 1, 1636424270017, 1636424270889, 872, 416, 456, 416, 0, 416
2526, 1, 1636424271044, 1636424271497, 453, 1, 452, 1, 0, 1
2527, 1, 1636424271349, 1636424271800, 451, 0, 451, 0, 0, 0
2528, 1, 1636424271357, 1636424272252, 895, 444, 451, 444, 0, 444
2529, 1, 1636424272341, 1636424272797, 456, 0, 456, 0, 0, 0
2532, 1, 1636424273641, 1636424274093, 452, 0, 452, 0, 0, 0
2533, 1, 1636424274905, 1636424275361, 456, 0, 456, 0, 0, 0
2512, 2, 1636424265713, 1636424275713, 10000, 0, 10000, 437, 0, 437
2513, 2, 1636424265744, 1636424275757, 10013, 0, 10013, 405, 0, 405
2516, 1, 1636424266416, 1636424276208, 9792, 9341, 451, 0, 9341, 9341
2534, 1, 1636424276180, 1636424276633, 453, 1, 452, 0, 1, 1
2535, 1, 1636424276428, 1636424276881, 453, 1, 452, 0, 0, 0
2537, 1, 1636424276461, 1636424276913, 452, 0, 452, 0, 0, 0
2536, 1, 1636424276461, 1636424277333, 872, 421, 451, 420, 1, 421
2538, 1, 1636424277577, 1636424278029, 452, 0, 452, 0, 0, 0
2539, 1, 1636424277709, 1636424278161, 452, 0, 452, 0, 0, 0
2540, 1, 1636424278845, 1636424279297, 452, 0, 452, 0, 0, 0
2541, 1, 1636424279037, 1636424279489, 452, 0, 452, 0, 0, 0
2542, 1, 1636424280121, 1636424280573, 452, 0, 452, 0, 0, 0
2543, 1, 1636424280389, 1636424280845, 456, 0, 456, 0, 0, 0
2544, 1, 1636424281485, 1636424281937, 452, 0, 452, 0, 0, 0
2545, 1, 1636424281669, 1636424282125, 456, 0, 456, 0, 0, 0
2530, 2, 1636424272613, 1636424282613, 10000, 0, 10000, 0, 0, 0
2531, 2, 1636424272664, 1636424282664, 10000, 0, 10000, 0, 0, 0
2546, 1, 1636424282757, 1636424283209, 452, 0, 452, 0, 0, 0
2547, 1, 1636424282933, 1636424283381, 448, 0, 448, 0, 0, 0
2549, 1, 1636424282941, 1636424283388, 447, 0, 447, 0, 0, 0
2548, 1, 1636424282972, 1636424283837, 865, 409, 456, 409, 0, 409
2550, 1, 1636424284061, 1636424284513, 452, 0, 452, 0, 0, 0
2551, 1, 1636424284216, 1636424284669, 453, 1, 452, 0, 0, 0
2553, 1, 1636424284229, 1636424284680, 451, 0, 451, 0, 0, 0
2552, 1, 1636424284225, 1636424285125, 900, 445, 455, 445, 0, 445
2554, 1, 1636424285385, 1636424285837, 452, 0, 452, 0, 0, 0
2555, 1, 1636424285529, 1636424285981, 452, 0, 452, 0, 0, 0
2556, 1, 1636424285536, 1636424285989, 453, 1, 452, 0, 0, 0
2557, 1, 1636424285549, 1636424286437, 888, 432, 456, 432, 0, 432
2558, 1, 1636424286769, 1636424287221, 452, 0, 452, 0, 0, 0
2559, 1, 1636424286881, 1636424287333, 452, 0, 452, 0, 0, 0
2561, 1, 1636424286889, 1636424287341, 452, 0, 452, 0, 0, 0
2560, 1, 1636424286888, 1636424287789, 901, 446, 455, 444, 1, 445
2562, 1, 1636424288108, 1636424288561, 453, 1, 452, 0, 0, 0
2563, 1, 1636424288209, 1636424288665, 456, 0, 456, 0, 0, 0
2565, 1, 1636424288260, 1636424288705, 445, 1, 444, 1, 0, 1
2564, 1, 1636424288213, 1636424289125, 912, 452, 460, 452, 0, 452
2566, 1, 1636424289449, 1636424289905, 456, 0, 456, 0, 0, 0
2568, 1, 1636424289549, 1636424290001, 452, 0, 452, 0, 0, 0
2569, 1, 1636424289569, 1636424290457, 888, 432, 456, 432, 0, 432
2570, 1, 1636424290757, 1636424291208, 451, 0, 451, 0, 0, 0
2571, 1, 1636424290817, 1636424291264, 447, 0, 447, 0, 0, 0
2572, 1, 1636424290881, 1636424291717, 836, 384, 452, 384, 0, 384
2573, 1, 1636424292121, 1636424292569, 448, 0, 448, 0, 0, 0
2574, 1, 1636424292177, 1636424292629, 452, 0, 452, 0, 0, 0
2575, 1, 1636424292217, 1636424293080, 863, 412, 451, 412, 0, 412
2576, 1, 1636424293449, 1636424293901, 452, 0, 452, 0, 0, 0
2577, 1, 1636424293561, 1636424294017, 456, 0, 456, 0, 0, 0
2578, 1, 1636424293569, 1636424294473, 904, 448, 456, 448, 0, 448
2579, 1, 1636424294785, 1636424295233, 448, 0, 448, 0, 0, 0
2580, 1, 1636424294877, 1636424295313, 436, 0, 436, 0, 0, 0
2581, 1, 1636424294889, 1636424295769, 880, 424, 456, 424, 0, 424
2582, 1, 1636424296056, 1636424296509, 453, 1, 452, 1, 0, 1
2583, 1, 1636424297445, 1636424297897, 452, 0, 452, 0, 0, 0
2584, 1, 1636424298837, 1636424299293, 456, 0, 456, 0, 0, 0
2567, 2, 1636424289529, 1636424299529, 10000, 0, 10000, 0, 0, 0
2585, 1, 1636424299844, 1636424300293, 449, 0, 449, 0, 0, 0
2586, 1, 1636424300148, 1636424300601, 453, 0, 453, 0, 0, 0
2587, 1, 1636424301105, 1636424301561, 456, 0, 456, 0, 0, 0
2588, 1, 1636424302469, 1636424302921, 452, 0, 452, 0, 0, 0
2589, 1, 1636424303761, 1636424304217, 456, 0, 456, 0, 0, 0
2590, 1, 1636424305149, 1636424305605, 456, 0, 456, 0, 0, 0
2591, 1, 1636424306529, 1636424306981, 452, 0, 452, 0, 0, 0
2592, 2, 1636424307857, 1636424317857, 10000, 0, 10000, 0, 0, 0
2593, 1, 1636424318169, 1636424318621, 452, 0, 452, 0, 0, 0
2594, 1, 1636424319421, 1636424319873, 452, 0, 452, 0, 0, 0
2595, 1, 1636424320729, 1636424321181, 452, 0, 452, 0, 0, 0
2596, 1, 1636424322081, 1636424322533, 452, 0, 452, 0, 0, 0
2597, 1, 1636424323413, 1636424323869, 456, 0, 456, 0, 0, 0
2598, 1, 1636424324773, 1636424325225, 452, 0, 452, 0, 0, 0
2599, 1, 1636424326045, 1636424326497, 452, 0, 452, 0, 0, 0
2600, 1, 1636424327433, 1636424327885, 452, 0, 452, 0, 0, 0
2601, 1, 1636424485257, 1636424485708, 451, 0, 451, 0, 0, 0
2602, 1, 1636424485749, 1636424486201, 452, 0, 452, 0, 0, 0
2603, 1, 1636424486321, 1636424486773, 452, 0, 452, 0, 0, 0
2604, 1, 1636424486996, 1636424487448, 452, 1, 451, 0, 1, 1
2605, 1, 1636424487121, 1636424487572, 451, 0, 451, 0, 0, 0
2606, 1, 1636424487612, 1636424488065, 453, 0, 453, 0, 0, 0
2607, 1, 1636424487616, 1636424488065, 449, 1, 448, 0, 1, 1
2608, 1, 1636424488249, 1636424488701, 452, 0, 452, 0, 0, 0
2609, 1, 1636424488317, 1636424488769, 452, 0, 452, 0, 0, 0
2610, 1, 1636424488857, 1636424489308, 451, 0, 451, 0, 0, 0
2611, 1, 1636424488860, 1636424489316, 456, 1, 455, 0, 0, 0
2612, 1, 1636424489069, 1636424489520, 451, 0, 451, 0, 0, 0
2613, 1, 1636424489484, 1636424489937, 453, 1, 452, 1, 0, 1
2614, 1, 1636424489564, 1636424490013, 449, 1, 448, 1, 0, 1
2615, 1, 1636424489605, 1636424490069, 464, 4, 460, 0, 0, 0
2616, 1, 1636424490141, 1636424490593, 452, 0, 452, 0, 0, 0
2617, 1, 1636424490249, 1636424490700, 451, 0, 451, 0, 0, 0
2618, 1, 1636424490264, 1636424490717, 453, 1, 452, 0, 0, 0
2619, 1, 1636424490693, 1636424491144, 451, 0, 451, 0, 0, 0
2620, 1, 1636424490813, 1636424491269, 456, 0, 456, 0, 0, 0
2621, 1, 1636424490852, 1636424491309, 457, 0, 457, 0, 0, 0
2622, 1, 1636424491108, 1636424491564, 456, 1, 455, 0, 0, 0
2623, 1, 1636424491433, 1636424491889, 456, 0, 456, 0, 0, 0
2624, 1, 1636424491513, 1636424491965, 452, 0, 452, 0, 0, 0
2625, 1, 1636424491608, 1636424492057, 449, 1, 448, 0, 1, 1
2626, 1, 1636424492108, 1636424492561, 453, 1, 452, 1, 0, 1
2627, 1, 1636424492137, 1636424492593, 456, 0, 456, 0, 0, 0
2628, 1, 1636424492196, 1636424492644, 448, 1, 447, 0, 0, 0
2629, 1, 1636424492305, 1636424492753, 448, 0, 448, 0, 0, 0
2630, 1, 1636424492552, 1636424493049, 497, 41, 456, 41, 0, 41
2631, 1, 1636424492805, 1636424493253, 448, 0, 448, 0, 0, 0
2632, 1, 1636424492828, 1636424493285, 457, 1, 456, 0, 0, 0
2633, 1, 1636424492916, 1636424493369, 453, 1, 452, 0, 0, 0
2634, 1, 1636424493197, 1636424493653, 456, 0, 456, 0, 0, 0
2635, 1, 1636424493284, 1636424493821, 537, 85, 452, 84, 0, 84
2636, 1, 1636424493448, 1636424493901, 453, 1, 452, 1, 0, 1
2637, 1, 1636424493460, 1636424493913, 453, 1, 452, 0, 0, 0
2638, 1, 1636424493733, 1636424494180, 447, 0, 447, 0, 0, 0
2639, 1, 1636424493968, 1636424494416, 448, 1, 447, 0, 0, 0
2640, 1, 1636424494077, 1636424494529, 452, 0, 452, 0, 0, 0
2641, 1, 1636424494088, 1636424494545, 457, 1, 456, 0, 0, 0
2642, 1, 1636424494240, 1636424494693, 453, 1, 452, 0, 0, 0
2643, 1, 1636424494433, 1636424494880, 447, 0, 447, 0, 0, 0
2644, 1, 1636424494472, 1636424494997, 525, 73, 452, 72, 0, 72
2646, 1, 1636424494845, 1636424495301, 456, 0, 456, 0, 0, 0
2645, 1, 1636424494845, 1636424495301, 456, 0, 456, 0, 0, 0
2647, 1, 1636424494904, 1636424495361, 457, 0, 457, 0, 0, 0
2648, 1, 1636424494908, 1636424495368, 460, 1, 459, 0, 0, 0
2650, 1, 1636424495116, 1636424495757, 641, 186, 455, 184, 1, 185
2649, 1, 1636424495065, 1636424495813, 748, 296, 452, 296, 0, 296
2651, 1, 1636424495168, 1636424495820, 652, 201, 451, 201, 0, 201
2652, 1, 1636424495508, 1636424495956, 448, 1, 447, 0, 0, 0
2654, 1, 1636424495641, 1636424496269, 628, 172, 456, 172, 0, 172
2655, 1, 1636424495901, 1636424496348, 447, 0, 447, 0, 0, 0
2656, 1, 1636424495921, 1636424496368, 447, 0, 447, 0, 0, 0
2657, 1, 1636424495936, 1636424496392, 456, 1, 455, 0, 0, 0
2658, 1, 1636424496096, 1636424496549, 453, 1, 452, 1, 0, 1
2653, 1, 1636424495536, 1636424496725, 1189, 734, 455, 732, 0, 732
2661, 1, 1636424496500, 1636424496949, 449, 1, 448, 0, 0, 0
2662, 1, 1636424496577, 1636424497028, 451, 0, 451, 0, 0, 0
2663, 1, 1636424496753, 1636424497200, 447, 0, 447, 0, 0, 0
2665, 1, 1636424496872, 1636424497320, 448, 1, 447, 0, 1, 1
2667, 1, 1636424497017, 1636424497469, 452, 0, 452, 0, 0, 0
2669, 1, 1636424497117, 1636424497649, 532, 84, 448, 84, 0, 84
2668, 1, 1636424497081, 1636424497773, 692, 240, 452, 240, 0, 240
2670, 1, 1636424497157, 1636424497925, 768, 313, 455, 312, 1, 313
2673, 1, 1636424497633, 1636424498085, 452, 0, 452, 0, 0, 0
2675, 1, 1636424497889, 1636424498329, 440, 0, 440, 0, 0, 0
2676, 1, 1636424497896, 1636424498345, 449, 1, 448, 0, 0, 0
2677, 1, 1636424497957, 1636424498404, 447, 0, 447, 0, 0, 0
2679, 1, 1636424498497, 1636424498948, 451, 0, 451, 0, 0, 0
2680, 1, 1636424498704, 1636424499149, 445, 1, 444, 1, 0, 1
2682, 1, 1636424498880, 1636424499325, 445, 0, 445, 0, 0, 0
2683, 1, 1636424499017, 1636424499460, 443, 0, 443, 0, 0, 0
2685, 1, 1636424499088, 1636424499609, 521, 61, 460, 60, 0, 60
2686, 1, 1636424499160, 1636424499621, 461, 0, 461, 0, 0, 0
2684, 1, 1636424499088, 1636424499773, 685, 237, 448, 236, 0, 236
2688, 1, 1636424499848, 1636424500297, 449, 1, 448, 0, 1, 1
2689, 1, 1636424499948, 1636424500400, 452, 1, 451, 0, 1, 1
2691, 1, 1636424500444, 1636424500901, 457, 1, 456, 0, 1, 1
2692, 1, 1636424500741, 1636424501181, 440, 0, 440, 0, 0, 0
2693, 1, 1636424500960, 1636424501409, 449, 0, 449, 0, 0, 0
2696, 1, 1636424501204, 1636424501652, 448, 1, 447, 0, 0, 0
2697, 1, 1636424501244, 1636424501696, 452, 1, 451, 0, 1, 1
2698, 1, 1636424501889, 1636424502340, 451, 0, 451, 0, 0, 0
2700, 1, 1636424502461, 1636424502913, 452, 0, 452, 0, 0, 0
2702, 1, 1636424503001, 1636424503449, 448, 0, 448, 0, 0, 0
2703, 1, 1636424503309, 1636424503753, 444, 0, 444, 0, 0, 0
2708, 1, 1636424505293, 1636424505745, 452, 0, 452, 0, 0, 0
2659, 2, 1636424496324, 1636424506325, 10001, 0, 10001, 401, 0, 401
2660, 2, 1636424496340, 1636424506373, 10033, 0, 10033, 384, 0, 384
2664, 2, 1636424496817, 1636424506816, 9999, 0, 9999, 0, 0, 0
2666, 2, 1636424496872, 1636424506873, 10001, 0, 10001, 1, 0, 1
2709, 1, 1636424507048, 1636424507484, 436, 0, 436, 0, 0, 0
2710, 1, 1636424507048, 1636424507496, 448, 0, 448, 0, 0, 0
2671, 2, 1636424497529, 1636424507529, 10000, 0, 10000, 0, 0, 0
2713, 1, 1636424507164, 1636424507604, 440, 0, 440, 0, 0, 0
2672, 2, 1636424497633, 1636424507632, 9999, 0, 9999, 292, 0, 292
2674, 2, 1636424497684, 1636424507688, 10004, 0, 10004, 241, 0, 241
2712, 1, 1636424507176, 1636424507948, 772, 321, 451, 321, 0, 321
2711, 1, 1636424507140, 1636424507948, 808, 345, 463, 345, 0, 345
2678, 2, 1636424498233, 1636424508233, 10000, 0, 10000, 0, 0, 0
2714, 1, 1636424507865, 1636424508405, 540, 84, 456, 84, 0, 84
2681, 2, 1636424498704, 1636424508705, 10001, 0, 10001, 1, 0, 1
2716, 1, 1636424508276, 1636424508732, 456, 1, 455, 0, 0, 0
2717, 1, 1636424508545, 1636424509017, 472, 0, 472, 0, 0, 0
2718, 1, 1636424508889, 1636424509336, 447, 0, 447, 0, 0, 0
2719, 1, 1636424508960, 1636424509405, 445, 0, 445, 0, 0, 0
2720, 1, 1636424509008, 1636424509464, 456, 9, 447, 9, 0, 9
2723, 1, 1636424509077, 1636424509528, 451, 0, 451, 0, 0, 0
2687, 2, 1636424499537, 1636424509545, 10008, 0, 10008, 0, 0, 0
2721, 1, 1636424509049, 1636424509789, 740, 288, 452, 288, 0, 288
2722, 1, 1636424509053, 1636424509865, 812, 352, 460, 352, 0, 352
2690, 2, 1636424500084, 1636424510085, 10001, 0, 10001, 1, 0, 1
2724, 1, 1636424509685, 1636424510244, 559, 104, 455, 104, 0, 104
2725, 1, 1636424509849, 1636424510309, 460, 0, 460, 0, 0, 0
2726, 1, 1636424510132, 1636424510593, 461, 1, 460, 0, 0, 0
2727, 1, 1636424510397, 1636424510849, 452, 0, 452, 0, 0, 0
2728, 1, 1636424510437, 1636424510889, 452, 0, 452, 0, 0, 0
2694, 2, 1636424501004, 1636424511005, 10001, 0, 10001, 0, 0, 0
2695, 2, 1636424501145, 1636424511145, 10000, 0, 10000, 0, 0, 0
2730, 1, 1636424510849, 1636424511372, 523, 40, 483, 40, 0, 40
2729, 1, 1636424510832, 1636424511376, 544, 1, 543, 0, 0, 0
2731, 1, 1636424510936, 1636424511465, 529, 1, 528, 1, 0, 1
2734, 1, 1636424511237, 1636424511688, 451, 0, 451, 0, 0, 0
2735, 1, 1636424511321, 1636424511773, 452, 0, 452, 0, 0, 0
2732, 1, 1636424510944, 1636424511829, 885, 433, 452, 433, 0, 433
2733, 1, 1636424511048, 1636424511908, 860, 417, 443, 417, 0, 417
2699, 2, 1636424502072, 1636424512077, 10005, 0, 10005, 0, 0, 0
2738, 1, 1636424511673, 1636424512121, 448, 0, 448, 0, 0, 0
2736, 1, 1636424511449, 1636424512221, 772, 324, 448, 324, 0, 324
2737, 1, 1636424511552, 1636424512301, 749, 277, 472, 277, 0, 277
2739, 1, 1636424511988, 1636424512481, 493, 1, 492, 0, 0, 0
2740, 1, 1636424512297, 1636424512749, 452, 0, 452, 0, 0, 0
2701, 2, 1636424502809, 1636424512809, 10000, 0, 10000, 0, 0, 0
2741, 1, 1636424512373, 1636424512820, 447, 0, 447, 0, 0, 0
2742, 1, 1636424512393, 1636424512844, 451, 0, 451, 0, 0, 0
2744, 1, 1636424512796, 1636424513245, 449, 1, 448, 1, 0, 1
2743, 1, 1636424512776, 1636424513292, 516, 69, 447, 69, 0, 69
2704, 2, 1636424503329, 1636424513329, 10000, 0, 10000, 0, 0, 0
2746, 1, 1636424512900, 1636424513344, 444, 1, 443, 1, 0, 1
2748, 1, 1636424513121, 1636424513569, 448, 0, 448, 0, 0, 0
2749, 1, 1636424513180, 1636424513644, 464, 0, 464, 0, 0, 0
2750, 1, 1636424513212, 1636424513661, 449, 0, 449, 0, 0, 0
2745, 1, 1636424512900, 1636424513733, 833, 345, 488, 345, 0, 345
2747, 1, 1636424512996, 1636424513796, 800, 349, 451, 349, 0, 349
2705, 2, 1636424504017, 1636424514017, 10000, 0, 10000, 0, 0, 0
2753, 1, 1636424513640, 1636424514085, 445, 1, 444, 0, 0, 0
2751, 1, 1636424513328, 1636424514109, 781, 333, 448, 333, 0, 333
2752, 1, 1636424513496, 1636424514180, 684, 237, 447, 237, 0, 237
2754, 1, 1636424513616, 1636424514244, 628, 181, 447, 180, 0, 180
2755, 1, 1636424513988, 1636424514561, 573, 121, 452, 121, 0, 121
2706, 2, 1636424504589, 1636424514588, 9999, 0, 9999, 0, 0, 0
2757, 1, 1636424514260, 1636424514705, 445, 0, 445, 0, 0, 0
2759, 1, 1636424514348, 1636424514813, 465, 1, 464, 0, 0, 0
2758, 1, 1636424514328, 1636424514816, 488, 1, 487, 0, 0, 0
2756, 1, 1636424514224, 1636424515004, 780, 337, 443, 337, 0, 337
2707, 2, 1636424505068, 1636424515069, 10001, 0, 10001, 1, 0, 1
2761, 1, 1636424514784, 1636424515229, 445, 1, 444, 0, 0, 0
2760, 1, 1636424514752, 1636424515292, 540, 61, 479, 61, 0, 61
2764, 1, 1636424514896, 1636424515380, 484, 0, 484, 0, 0, 0
2715, 1, 1636424507992, 1636424515513, 7521, 7077, 444, 0, 7077, 7077
2767, 1, 1636424515156, 1636424515605, 449, 0, 449, 0, 0, 0
2765, 1, 1636424514940, 1636424515681, 741, 289, 452, 289, 0, 289
2768, 1, 1636424515276, 1636424515724, 448, 0, 448, 0, 0, 0
2770, 1, 1636424515372, 1636424515836, 464, 9, 455, 8, 0, 8
2773, 1, 1636424515568, 1636424516024, 456, 1, 455, 1, 0, 1
2769, 1, 1636424515328, 1636424516061, 733, 277, 456, 277, 0, 277
2774, 1, 1636424515733, 1636424516184, 451, 0, 451, 0, 0, 0
2775, 1, 1636424516068, 1636424516520, 452, 1, 451, 0, 1, 1
2777, 1, 1636424516196, 1636424516649, 453, 1, 452, 0, 0, 0
2778, 1, 1636424516204, 1636424516653, 449, 0, 449, 0, 0, 0
2779, 1, 1636424516300, 1636424516737, 437, 0, 437, 0, 0, 0
2780, 1, 1636424516656, 1636424517189, 533, 81, 452, 81, 0, 81
2784, 1, 1636424517125, 1636424517576, 451, 0, 451, 0, 0, 0
2786, 1, 1636424517240, 1636424517693, 453, 1, 452, 0, 0, 0
2788, 1, 1636424517521, 1636424517973, 452, 0, 452, 0, 0, 0
2785, 1, 1636424517225, 1636424518021, 796, 352, 444, 352, 0, 352
2789, 1, 1636424517592, 1636424518044, 452, 0, 452, 0, 0, 0
2790, 1, 1636424518088, 1636424518544, 456, 1, 455, 0, 0, 0
2791, 1, 1636424518140, 1636424518588, 448, 1, 447, 1, 0, 1
2792, 1, 1636424518209, 1636424518661, 452, 0, 452, 0, 0, 0
2795, 1, 1636424519012, 1636424519461, 449, 0, 449, 0, 0, 0
2796, 1, 1636424519117, 1636424519569, 452, 0, 452, 0, 0, 0
2797, 1, 1636424519141, 1636424519917, 776, 321, 455, 320, 1, 321
2799, 1, 1636424519597, 1636424520045, 448, 0, 448, 0, 0, 0
2800, 1, 1636424520024, 1636424520477, 453, 0, 453, 0, 0, 0
2802, 1, 1636424520285, 1636424520737, 452, 0, 452, 0, 0, 0
2805, 1, 1636424521213, 1636424521660, 447, 0, 447, 0, 0, 0
2806, 1, 1636424521732, 1636424522185, 453, 0, 453, 0, 0, 0
2808, 1, 1636424522357, 1636424522813, 456, 0, 456, 0, 0, 0
2809, 1, 1636424523257, 1636424523713, 456, 0, 456, 0, 0, 0
2810, 1, 1636424523736, 1636424524184, 448, 1, 447, 0, 0, 0
2811, 1, 1636424524325, 1636424524777, 452, 0, 452, 0, 0, 0
2762, 2, 1636424514800, 1636424524801, 10001, 0, 10001, 205, 0, 205
2763, 2, 1636424514808, 1636424524845, 10037, 0, 10037, 197, 0, 197
2766, 2, 1636424514992, 1636424524997, 10005, 0, 10005, 13, 0, 13
2771, 2, 1636424515460, 1636424525461, 10001, 0, 10001, 0, 0, 0
2772, 2, 1636424515485, 1636424525509, 10024, 0, 10024, 0, 0, 0
2812, 1, 1636424525220, 1636424525737, 517, 0, 517, 0, 0, 0
2813, 1, 1636424525313, 1636424525825, 512, 0, 512, 0, 0, 0
2814, 1, 1636424525313, 1636424525832, 519, 0, 519, 0, 0, 0
2776, 2, 1636424516160, 1636424526161, 10001, 0, 10001, 0, 0, 0
2817, 1, 1636424525737, 1636424526188, 451, 0, 451, 0, 0, 0
2818, 1, 1636424525788, 1636424526288, 500, 45, 455, 45, 0, 45
2781, 2, 1636424516672, 1636424526673, 10001, 0, 10001, 1, 0, 1
2819, 1, 1636424526248, 1636424526705, 457, 1, 456, 0, 0, 0
2782, 2, 1636424516756, 1636424526757, 10001, 0, 10001, 0, 0, 0
2783, 2, 1636424516889, 1636424526889, 10000, 0, 10000, 0, 0, 0
2820, 1, 1636424526469, 1636424526920, 451, 0, 451, 0, 0, 0
2787, 2, 1636424517284, 1636424527285, 10001, 0, 10001, 1, 0, 1
2821, 1, 1636424527072, 1636424527516, 444, 1, 443, 0, 0, 0
2823, 1, 1636424527113, 1636424527600, 487, 0, 487, 0, 0, 0
2824, 1, 1636424527149, 1636424527604, 455, 0, 455, 0, 0, 0
2826, 1, 1636424527256, 1636424527709, 453, 1, 452, 0, 0, 0
2827, 1, 1636424527589, 1636424528041, 452, 0, 452, 0, 0, 0
2828, 1, 1636424527689, 1636424528145, 456, 0, 456, 0, 0, 0
2829, 1, 1636424527728, 1636424528181, 453, 1, 452, 0, 0, 0
2793, 2, 1636424518285, 1636424528284, 9999, 0, 9999, 0, 0, 0
2794, 2, 1636424518613, 1636424528617, 10004, 0, 10004, 0, 0, 0
2831, 1, 1636424528332, 1636424528785, 453, 0, 453, 0, 0, 0
2830, 1, 1636424528332, 1636424528788, 456, 0, 456, 0, 0, 0
2834, 1, 1636424528957, 1636424529409, 452, 0, 452, 0, 0, 0
2835, 1, 1636424529032, 1636424529485, 453, 0, 453, 0, 0, 0
2836, 1, 1636424529096, 1636424529545, 449, 1, 448, 0, 0, 0
2798, 2, 1636424519593, 1636424529593, 10000, 0, 10000, 0, 0, 0
2837, 1, 1636424529360, 1636424529821, 461, 1, 460, 0, 0, 0
2838, 1, 1636424529493, 1636424529944, 451, 0, 451, 0, 0, 0
2801, 2, 1636424520041, 1636424530040, 9999, 0, 9999, 0, 0, 0
2839, 1, 1636424529640, 1636424530081, 441, 0, 441, 0, 0, 0
2840, 1, 1636424529684, 1636424530125, 441, 1, 440, 0, 0, 0
2841, 1, 1636424529900, 1636424530352, 452, 0, 452, 0, 0, 0
2842, 1, 1636424530260, 1636424530713, 453, 1, 452, 0, 1, 1
2844, 1, 1636424530364, 1636424530817, 453, 0, 453, 0, 0, 0
2803, 2, 1636424520901, 1636424530897, 9996, 0, 9996, 0, 0, 0
2804, 2, 1636424521037, 1636424531036, 9999, 0, 9999, 0, 0, 0
2845, 1, 1636424530841, 1636424531352, 511, 0, 511, 0, 0, 0
2847, 1, 1636424531033, 1636424531493, 460, 0, 460, 0, 0, 0
2846, 1, 1636424531033, 1636424531493, 460, 0, 460, 0, 0, 0
2807, 1, 1636424521973, 1636424531493, 9520, 9063, 457, 0, 9063, 9063
2850, 1, 1636424531377, 1636424531825, 448, 0, 448, 0, 0, 0
2851, 1, 1636424531444, 1636424531896, 452, 1, 451, 0, 0, 0
2852, 1, 1636424531484, 1636424531940, 456, 9, 447, 9, 0, 9
2854, 1, 1636424531689, 1636424532141, 452, 0, 452, 0, 0, 0
2855, 1, 1636424531920, 1636424532373, 453, 0, 453, 0, 0, 0
2856, 1, 1636424532129, 1636424532581, 452, 0, 452, 0, 0, 0
2857, 1, 1636424532473, 1636424532929, 456, 0, 456, 0, 0, 0
2858, 1, 1636424532785, 1636424533241, 456, 0, 456, 0, 0, 0
2860, 1, 1636424533113, 1636424533568, 455, 0, 455, 0, 0, 0
2861, 1, 1636424533356, 1636424533809, 453, 1, 452, 0, 0, 0
2862, 1, 1636424533377, 1636424533829, 452, 0, 452, 0, 0, 0
2864, 1, 1636424533733, 1636424534185, 452, 0, 452, 0, 0, 0
2865, 1, 1636424533829, 1636424534285, 456, 0, 456, 0, 0, 0
2867, 1, 1636424534405, 1636424534861, 456, 0, 456, 0, 0, 0
2815, 2, 1636424525324, 1636424535325, 10001, 0, 10001, 501, 0, 501
2869, 1, 1636424535132, 1636424535584, 452, 1, 451, 1, 0, 1
2870, 1, 1636424535288, 1636424535740, 452, 1, 451, 0, 0, 0
2816, 2, 1636424525772, 1636424535773, 10001, 0, 10001, 52, 0, 52
2872, 1, 1636424535752, 1636424536204, 452, 1, 451, 0, 1, 1
2874, 1, 1636424536132, 1636424536585, 453, 0, 453, 0, 0, 0
2876, 1, 1636424536372, 1636424536825, 453, 1, 452, 0, 0, 0
2822, 2, 1636424527033, 1636424537029, 9996, 0, 9996, 0, 0, 0
2875, 1, 1636424536140, 1636424537041, 901, 446, 455, 445, 0, 445
2825, 2, 1636424527197, 1636424537197, 10000, 0, 10000, 0, 0, 0
2877, 1, 1636424537117, 1636424537609, 492, 0, 492, 0, 0, 0
2878, 1, 1636424537377, 1636424537829, 452, 0, 452, 0, 0, 0
2881, 1, 1636424537684, 1636424538137, 453, 1, 452, 0, 0, 0
2880, 1, 1636424537509, 1636424538285, 776, 320, 456, 320, 0, 320
2882, 1, 1636424538004, 1636424538457, 453, 0, 453, 0, 0, 0
2832, 2, 1636424528588, 1636424538589, 10001, 0, 10001, 0, 0, 0
2884, 1, 1636424538324, 1636424538817, 493, 1, 492, 0, 1, 1
2883, 1, 1636424538017, 1636424538913, 896, 441, 455, 440, 1, 441
2833, 2, 1636424528921, 1636424538921, 10000, 0, 10000, 0, 0, 0
2885, 1, 1636424538893, 1636424539345, 452, 0, 452, 0, 0, 0
2886, 1, 1636424539088, 1636424539541, 453, 1, 452, 0, 0, 0
2888, 1, 1636424539197, 1636424539653, 456, 0, 456, 0, 0, 0
2887, 1, 1636424539228, 1636424539797, 569, 117, 452, 116, 0, 116
2890, 1, 1636424539656, 1636424540109, 453, 0, 453, 0, 0, 0
2889, 1, 1636424539400, 1636424540109, 709, 253, 456, 252, 0, 252
2843, 2, 1636424530348, 1636424540349, 10001, 0, 10001, 0, 0, 0
2891, 1, 1636424539921, 1636424540377, 456, 0, 456, 0, 0, 0
2893, 1, 1636424540301, 1636424540757, 456, 0, 456, 0, 0, 0
2892, 1, 1636424539961, 1636424540829, 868, 416, 452, 416, 0, 416
2895, 1, 1636424540741, 1636424541193, 452, 0, 452, 0, 0, 0
2848, 2, 1636424531217, 1636424541217, 10000, 0, 10000, 0, 0, 0
2894, 1, 1636424540652, 1636424541289, 637, 178, 459, 177, 1, 178
2849, 2, 1636424531349, 1636424541349, 10000, 0, 10000, 0, 0, 0
2896, 1, 1636424541117, 1636424541665, 548, 76, 472, 76, 0, 76
2898, 1, 1636424541140, 1636424541673, 533, 1, 532, 0, 1, 1
2853, 2, 1636424531713, 1636424541713, 10000, 0, 10000, 0, 0, 0
2897, 1, 1636424541125, 1636424541756, 631, 164, 467, 164, 0, 164
2902, 1, 1636424541633, 1636424542124, 491, 0, 491, 0, 0, 0
2903, 1, 1636424541973, 1636424542428, 455, 0, 455, 0, 0, 0
2906, 1, 1636424542328, 1636424542781, 453, 1, 452, 0, 0, 0
2905, 1, 1636424542048, 1636424542880, 832, 381, 451, 381, 0, 381
2907, 1, 1636424542541, 1636424542988, 447, 0, 447, 0, 0, 0
2859, 2, 1636424533052, 1636424543049, 9997, 0, 9997, 1, 0, 1
2863, 2, 1636424533568, 1636424543569, 10001, 0, 10001, 0, 0, 0
2910, 1, 1636424543197, 1636424543644, 447, 0, 447, 0, 0, 0
2911, 1, 1636424543212, 1636424543665, 453, 0, 453, 0, 0, 0
2913, 1, 1636424543553, 1636424544005, 452, 0, 452, 0, 0, 0
2866, 2, 1636424534205, 1636424544205, 10000, 0, 10000, 0, 0, 0
2915, 1, 1636424543905, 1636424544357, 452, 0, 452, 0, 0, 0
2917, 1, 1636424544297, 1636424544749, 452, 0, 452, 0, 0, 0
2916, 1, 1636424543968, 1636424544813, 845, 389, 456, 389, 0, 389
2868, 2, 1636424534865, 1636424544865, 10000, 0, 10000, 0, 0, 0
2871, 2, 1636424535461, 1636424545461, 10000, 0, 10000, 0, 0, 0
2921, 1, 1636424545177, 1636424545629, 452, 0, 452, 0, 0, 0
2922, 1, 1636424545185, 1636424545637, 452, 0, 452, 0, 0, 0
2879, 1, 1636424537361, 1636424545916, 8555, 8100, 455, 0, 8100, 8100
2873, 2, 1636424535960, 1636424545960, 10000, 0, 10000, 0, 0, 0
2923, 1, 1636424545596, 1636424546044, 448, 1, 447, 0, 0, 0
2925, 1, 1636424546012, 1636424546468, 456, 0, 456, 0, 0, 0
2927, 1, 1636424546145, 1636424546601, 456, 0, 456, 0, 0, 0
2929, 1, 1636424546240, 1636424546693, 453, 0, 453, 0, 0, 0
2928, 1, 1636424546269, 1636424546717, 448, 0, 448, 0, 0, 0
2926, 1, 1636424546048, 1636424546925, 877, 421, 456, 421, 0, 421
2930, 1, 1636424547073, 1636424547526, 453, 0, 453, 0, 0, 0
2931, 1, 1636424547276, 1636424547737, 461, 1, 460, 0, 0, 0
2932, 1, 1636424547524, 1636424547977, 453, 1, 452, 0, 0, 0
2933, 1, 1636424547921, 1636424548373, 452, 0, 452, 0, 0, 0
2934, 1, 1636424547997, 1636424548445, 448, 0, 448, 0, 0, 0
2936, 1, 1636424548093, 1636424548549, 456, 0, 456, 0, 0, 0
2937, 1, 1636424548200, 1636424548653, 453, 1, 452, 0, 0, 0
2935, 1, 1636424548008, 1636424548825, 817, 365, 452, 365, 0, 365
2938, 1, 1636424549005, 1636424549457, 452, 0, 452, 0, 0, 0
2939, 1, 1636424549185, 1636424549637, 452, 0, 452, 0, 0, 0
2940, 1, 1636424549473, 1636424549924, 451, 0, 451, 0, 0, 0
2941, 1, 1636424549877, 1636424550329, 452, 0, 452, 0, 0, 0
2943, 1, 1636424550041, 1636424550493, 452, 0, 452, 0, 0, 0
2944, 1, 1636424550093, 1636424550545, 452, 0, 452, 0, 0, 0
2945, 1, 1636424550100, 1636424550549, 449, 1, 448, 0, 0, 0
2942, 1, 1636424549965, 1636424550781, 816, 364, 452, 364, 0, 364
2899, 2, 1636424541392, 1636424551392, 10000, 0, 10000, 365, 0, 365
2900, 2, 1636424541529, 1636424551530, 10001, 0, 10001, 228, 0, 228
2947, 1, 1636424551141, 1636424551621, 480, 0, 480, 0, 0, 0
2901, 2, 1636424541652, 1636424551653, 10001, 0, 10001, 104, 0, 104
2948, 1, 1636424551436, 1636424551884, 448, 0, 448, 0, 0, 0
2904, 2, 1636424542024, 1636424552024, 10000, 0, 10000, 0, 0, 0
2950, 1, 1636424551992, 1636424552433, 441, 0, 441, 0, 0, 0
2949, 1, 1636424551980, 1636424552433, 453, 0, 453, 0, 0, 0
2953, 1, 1636424552072, 1636424552521, 449, 1, 448, 0, 0, 0
2951, 1, 1636424552072, 1636424552521, 449, 1, 448, 0, 0, 0
2955, 1, 1636424552156, 1636424552605, 449, 0, 449, 0, 0, 0
2908, 2, 1636424542657, 1636424552657, 10000, 0, 10000, 0, 0, 0
2956, 1, 1636424552220, 1636424552673, 453, 0, 453, 0, 0, 0
2954, 1, 1636424552072, 1636424552889, 817, 362, 455, 361, 0, 361
2909, 2, 1636424543017, 1636424553021, 10004, 0, 10004, 0, 0, 0
2912, 2, 1636424543361, 1636424553361, 10000, 0, 10000, 0, 0, 0
2958, 1, 1636424552961, 1636424553433, 472, 0, 472, 0, 0, 0
2959, 1, 1636424553257, 1636424553709, 452, 0, 452, 0, 0, 0
2961, 1, 1636424553304, 1636424553769, 465, 1, 464, 0, 0, 0
2914, 2, 1636424543873, 1636424553873, 10000, 0, 10000, 0, 0, 0
2960, 1, 1636424553324, 1636424553888, 564, 109, 455, 108, 0, 108
2963, 1, 1636424554029, 1636424554472, 443, 0, 443, 0, 0, 0
2964, 1, 1636424554029, 1636424554480, 451, 0, 451, 0, 0, 0
2919, 2, 1636424544516, 1636424554517, 10001, 0, 10001, 0, 0, 0
2967, 1, 1636424554112, 1636424554560, 448, 0, 448, 0, 0, 0
2918, 2, 1636424544516, 1636424554560, 10044, 0, 10044, 0, 0, 0
2970, 1, 1636424554176, 1636424554624, 448, 0, 448, 0, 0, 0
2968, 1, 1636424554124, 1636424555017, 893, 436, 457, 436, 0, 436
2920, 2, 1636424545177, 1636424555177, 10000, 0, 10000, 0, 0, 0
2972, 1, 1636424554829, 1636424555284, 455, 0, 455, 0, 0, 0
2973, 1, 1636424554981, 1636424555428, 447, 0, 447, 0, 0, 0
2974, 1, 1636424555312, 1636424555765, 453, 1, 452, 0, 1, 1
2924, 2, 1636424545769, 1636424555769, 10000, 0, 10000, 0, 0, 0
2976, 1, 1636424555381, 1636424555832, 451, 0, 451, 0, 0, 0
2975, 1, 1636424555321, 1636424555877, 556, 108, 448, 108, 0, 108
2978, 1, 1636424556016, 1636424556469, 453, 1, 452, 0, 0, 0
2980, 1, 1636424556049, 1636424556505, 456, 0, 456, 0, 0, 0
2981, 1, 1636424556077, 1636424556528, 451, 0, 451, 0, 0, 0
2983, 1, 1636424556113, 1636424556924, 811, 356, 455, 356, 0, 356
2982, 1, 1636424556088, 1636424556960, 872, 417, 455, 417, 0, 417
2984, 1, 1636424556793, 1636424557240, 447, 0, 447, 0, 0, 0
2985, 1, 1636424556968, 1636424557408, 440, 0, 440, 0, 0, 0
2986, 1, 1636424557248, 1636424557689, 441, 0, 441, 0, 0, 0
2988, 1, 1636424557264, 1636424557705, 441, 0, 441, 0, 0, 0
2987, 1, 1636424557256, 1636424557852, 596, 153, 443, 153, 0, 153
2989, 1, 1636424557920, 1636424558369, 449, 1, 448, 0, 1, 1
2990, 1, 1636424558001, 1636424558449, 448, 0, 448, 0, 0, 0
2992, 1, 1636424558077, 1636424558525, 448, 0, 448, 0, 0, 0
2993, 1, 1636424558077, 1636424558529, 452, 0, 452, 0, 0, 0
2991, 1, 1636424558060, 1636424558904, 844, 389, 455, 388, 0, 388
2995, 1, 1636424558873, 1636424559325, 452, 0, 452, 0, 0, 0
2994, 1, 1636424558781, 1636424559356, 575, 124, 451, 124, 0, 124
2996, 1, 1636424559113, 1636424559573, 460, 0, 460, 0, 0, 0
2998, 1, 1636424559220, 1636424559781, 561, 105, 456, 105, 0, 105
2997, 1, 1636424559196, 1636424559813, 617, 161, 456, 161, 0, 161
2999, 1, 1636424559885, 1636424560336, 451, 0, 451, 0, 0, 0
3000, 1, 1636424560016, 1636424560468, 452, 1, 451, 0, 0, 0
3001, 1, 1636424560020, 1636424560484, 464, 0, 464, 0, 0, 0
3003, 1, 1636424560065, 1636424560513, 448, 0, 448, 0, 0, 0
3002, 1, 1636424560056, 1636424560785, 729, 280, 449, 280, 0, 280
2946, 2, 1636424551049, 1636424561045, 9996, 0, 9996, 0, 0, 0
3004, 1, 1636424560761, 1636424561217, 456, 0, 456, 0, 0, 0
3005, 1, 1636424560969, 1636424561457, 488, 0, 488, 0, 0, 0
2966, 1, 1636424554100, 1636424561489, 7389, 6945, 444, 0, 6945, 6945
3006, 1, 1636424561180, 1636424561629, 449, 0, 449, 0, 0, 0
3007, 1, 1636424561248, 1636424561701, 453, 1, 452, 0, 0, 0
3009, 1, 1636424561356, 1636424561813, 457, 1, 456, 1, 0, 1
3008, 1, 1636424561284, 1636424561917, 633, 173, 460, 173, 0, 173
2952, 2, 1636424552072, 1636424562072, 10000, 0, 10000, 448, 0, 448
3010, 1, 1636424561709, 1636424562157, 448, 0, 448, 0, 0, 0
3011, 1, 1636424561833, 1636424562297, 464, 0, 464, 0, 0, 0
2957, 2, 1636424552328, 1636424562328, 10000, 0, 10000, 192, 0, 192
3012, 1, 1636424561968, 1636424562421, 453, 1, 452, 0, 0, 0
3015, 1, 1636424562068, 1636424562552, 484, 1, 483, 0, 0, 0
3014, 1, 1636424562056, 1636424562552, 496, 1, 495, 0, 0, 0
3013, 1, 1636424562048, 1636424562757, 709, 248, 461, 248, 0, 248
3016, 1, 1636424562784, 1636424563233, 449, 0, 449, 0, 0, 0
3019, 1, 1636424563037, 1636424563492, 455, 0, 455, 0, 0, 0
3020, 1, 1636424563117, 1636424563569, 452, 0, 452, 0, 0, 0
3021, 1, 1636424563120, 1636424563577, 457, 1, 456, 0, 0, 0
2962, 2, 1636424553669, 1636424563669, 10000, 0, 10000, 0, 0, 0
3023, 1, 1636424563380, 1636424563984, 604, 113, 491, 113, 0, 113
2965, 2, 1636424554044, 1636424564045, 10001, 0, 10001, 0, 0, 0
2969, 2, 1636424554184, 1636424564189, 10005, 0, 10005, 0, 0, 0
3025, 1, 1636424563873, 1636424564360, 487, 0, 487, 0, 0, 0
3027, 1, 1636424563988, 1636424564448, 460, 0, 460, 0, 0, 0
3029, 1, 1636424564136, 1636424564597, 461, 0, 461, 0, 0, 0
3030, 1, 1636424564180, 1636424564637, 457, 1, 456, 0, 0, 0
3028, 1, 1636424564092, 1636424564813, 721, 269, 452, 269, 0, 269
2971, 2, 1636424554825, 1636424564825, 10000, 0, 10000, 0, 0, 0
3033, 1, 1636424564793, 1636424565245, 452, 0, 452, 0, 0, 0
2977, 2, 1636424555489, 1636424565489, 10000, 0, 10000, 0, 0, 0
3034, 1, 1636424565065, 1636424565520, 455, 0, 455, 0, 0, 0
3036, 1, 1636424565116, 1636424565573, 457, 1, 456, 0, 0, 0
3037, 1, 1636424565240, 1636424565717, 477, 0, 477, 0, 0, 0
2979, 1, 1636424556076, 1636424565941, 9865, 9412, 453, 0, 9412, 9412
3038, 1, 1636424565397, 1636424566033, 636, 176, 460, 176, 0, 176
3040, 1, 1636424565937, 1636424566388, 451, 0, 451, 0, 0, 0
3041, 1, 1636424566028, 1636424566477, 449, 0, 449, 0, 0, 0
3042, 1, 1636424566036, 1636424566489, 453, 1, 452, 0, 0, 0
3044, 1, 1636424566129, 1636424566581, 452, 0, 452, 0, 0, 0
3043, 1, 1636424566072, 1636424566845, 773, 317, 456, 317, 0, 317
3046, 1, 1636424566869, 1636424567321, 452, 0, 452, 0, 0, 0
3047, 1, 1636424567053, 1636424567505, 452, 0, 452, 0, 0, 0
3049, 1, 1636424567284, 1636424567737, 453, 0, 453, 0, 0, 0
3050, 1, 1636424567300, 1636424567965, 665, 205, 460, 205, 0, 205
3051, 1, 1636424567889, 1636424568337, 448, 0, 448, 0, 0, 0
3053, 1, 1636424568033, 1636424568485, 452, 0, 452, 0, 0, 0
3054, 1, 1636424568052, 1636424568497, 445, 0, 445, 0, 0, 0
3055, 1, 1636424568096, 1636424568540, 444, 1, 443, 0, 0, 0
3052, 1, 1636424568028, 1636424568789, 761, 309, 452, 309, 0, 309
3056, 1, 1636424568797, 1636424569248, 451, 0, 451, 0, 0, 0
3057, 1, 1636424569021, 1636424569477, 456, 0, 456, 0, 0, 0
3058, 1, 1636424569240, 1636424569693, 453, 0, 453, 0, 0, 0
3059, 1, 1636424569276, 1636424569933, 657, 201, 456, 201, 0, 201
3060, 1, 1636424569892, 1636424570345, 453, 1, 452, 0, 0, 0
3061, 1, 1636424569984, 1636424570429, 445, 1, 444, 0, 0, 0
3063, 1, 1636424570041, 1636424570493, 452, 0, 452, 0, 0, 0
3064, 1, 1636424570044, 1636424570493, 449, 1, 448, 0, 1, 1
3062, 1, 1636424569996, 1636424570801, 805, 349, 456, 349, 0, 349
3065, 1, 1636424570765, 1636424571217, 452, 0, 452, 0, 0, 0
3066, 1, 1636424571001, 1636424571453, 452, 0, 452, 0, 0, 0
3068, 1, 1636424571241, 1636424571689, 448, 0, 448, 0, 0, 0
3067, 1, 1636424571172, 1636424571912, 740, 281, 459, 281, 0, 281
3069, 1, 1636424571941, 1636424572397, 456, 0, 456, 0, 0, 0
3070, 1, 1636424571956, 1636424572412, 456, 1, 455, 0, 0, 0
3072, 1, 1636424572041, 1636424572489, 448, 0, 448, 0, 0, 0
3073, 1, 1636424572069, 1636424572521, 452, 0, 452, 0, 0, 0
3018, 2, 1636424562828, 1636424572828, 10000, 0, 10000, 0, 0, 0
3071, 1, 1636424572013, 1636424572844, 831, 385, 446, 384, 1, 385
3017, 2, 1636424562828, 1636424572872, 10044, 0, 10044, 0, 0, 0
3074, 1, 1636424572713, 1636424573193, 480, 0, 480, 0, 0, 0
3022, 2, 1636424563336, 1636424573337, 10001, 0, 10001, 0, 0, 0
3075, 1, 1636424572969, 1636424573416, 447, 0, 447, 0, 0, 0
3076, 1, 1636424573133, 1636424573585, 452, 0, 452, 0, 0, 0
3079, 1, 1636424573249, 1636424573736, 487, 0, 487, 0, 0, 0
3024, 2, 1636424563761, 1636424573761, 10000, 0, 10000, 0, 0, 0
3078, 1, 1636424573153, 1636424573869, 716, 264, 452, 264, 0, 264
3026, 2, 1636424563976, 1636424573976, 10000, 0, 10000, 0, 0, 0
3077, 1, 1636424573140, 1636424574077, 937, 445, 492, 444, 0, 444
3080, 1, 1636424573645, 1636424574092, 447, 0, 447, 0, 0, 0
3031, 2, 1636424564364, 1636424574364, 10000, 0, 10000, 0, 0, 0
3081, 1, 1636424573932, 1636424574380, 448, 0, 448, 0, 0, 0
3082, 1, 1636424573969, 1636424574412, 443, 0, 443, 0, 0, 0
3083, 1, 1636424574024, 1636424574468, 444, 0, 444, 0, 0, 0
3032, 2, 1636424564492, 1636424574492, 10000, 0, 10000, 0, 0, 0
3084, 1, 1636424574068, 1636424574516, 448, 0, 448, 0, 0, 0
3086, 1, 1636424574136, 1636424574589, 453, 1, 452, 0, 0, 0
3087, 1, 1636424574285, 1636424574813, 528, 0, 528, 0, 0, 0
3085, 1, 1636424574108, 1636424574904, 796, 305, 491, 304, 0, 304
3088, 1, 1636424574628, 1636424575077, 449, 0, 449, 0, 0, 0
3035, 2, 1636424565137, 1636424575137, 10000, 0, 10000, 0, 0, 0
3092, 1, 1636424575000, 1636424575457, 457, 1, 456, 0, 1, 1
3091, 1, 1636424574993, 1636424575457, 464, 0, 464, 0, 0, 0
3039, 2, 1636424565797, 1636424575797, 10000, 0, 10000, 0, 0, 0
3095, 1, 1636424575372, 1636424575820, 448, 1, 447, 1, 0, 1
3093, 1, 1636424575029, 1636424575913, 884, 428, 456, 428, 0, 428
3094, 1, 1636424575272, 1636424575913, 641, 186, 455, 186, 0, 186
3097, 1, 1636424575496, 1636424575944, 448, 1, 447, 0, 0, 0
3045, 1, 1636424566169, 1636424576252, 10083, 9628, 455, 0, 9628, 9628
3098, 1, 1636424575932, 1636424576384, 452, 1, 451, 0, 0, 0
3099, 1, 1636424575932, 1636424576384, 452, 1, 451, 0, 0, 0
3101, 1, 1636424576005, 1636424576453, 448, 0, 448, 0, 0, 0
3103, 1, 1636424576052, 1636424576497, 445, 1, 444, 0, 0, 0
3105, 1, 1636424576096, 1636424576549, 453, 1, 452, 0, 0, 0
3100, 1, 1636424575948, 1636424576841, 893, 437, 456, 437, 0, 437
3048, 2, 1636424567077, 1636424577077, 10000, 0, 10000, 0, 0, 0
3107, 1, 1636424576653, 1636424577104, 451, 0, 451, 0, 0, 0
3102, 1, 1636424576020, 1636424577300, 1280, 821, 459, 821, 0, 821
3108, 1, 1636424576933, 1636424577396, 463, 0, 463, 0, 0, 0
3112, 1, 1636424577340, 1636424577793, 453, 0, 453, 0, 0, 0
3113, 1, 1636424577384, 1636424577840, 456, 0, 456, 0, 0, 0
3111, 1, 1636424577168, 1636424577844, 676, 229, 447, 229, 0, 229
3114, 1, 1636424577453, 1636424577897, 444, 0, 444, 0, 0, 0
3115, 1, 1636424577897, 1636424578349, 452, 0, 452, 0, 0, 0
3117, 1, 1636424577952, 1636424578396, 444, 1, 443, 0, 0, 0
3116, 1, 1636424577956, 1636424578408, 452, 1, 451, 0, 0, 0
3118, 1, 1636424577960, 1636424578420, 460, 1, 459, 0, 0, 0
3120, 1, 1636424577993, 1636424578444, 451, 0, 451, 0, 0, 0
3119, 1, 1636424577977, 1636424578861, 884, 432, 452, 432, 0, 432
3122, 1, 1636424578604, 1636424579057, 453, 1, 452, 0, 1, 1
3123, 1, 1636424578885, 1636424579521, 636, 172, 464, 172, 0, 172
3125, 1, 1636424579209, 1636424579660, 451, 0, 451, 0, 0, 0
3126, 1, 1636424579229, 1636424579681, 452, 0, 452, 0, 0, 0
3124, 1, 1636424579072, 1636424579968, 896, 449, 447, 449, 0, 449
3127, 1, 1636424579549, 1636424580000, 451, 0, 451, 0, 0, 0
3128, 1, 1636424579880, 1636424580332, 452, 0, 452, 0, 0, 0
3130, 1, 1636424579924, 1636424580365, 441, 1, 440, 0, 0, 0
3131, 1, 1636424579928, 1636424580365, 437, 0, 437, 0, 0, 0
3129, 1, 1636424579904, 1636424580413, 509, 65, 444, 64, 0, 64
3133, 1, 1636424580029, 1636424580477, 448, 0, 448, 0, 0, 0
3132, 1, 1636424579972, 1636424580785, 813, 361, 452, 361, 0, 361
3134, 1, 1636424580513, 1636424580965, 452, 0, 452, 0, 0, 0
3135, 1, 1636424580789, 1636424581249, 460, 0, 460, 0, 0, 0
3137, 1, 1636424581117, 1636424581565, 448, 0, 448, 0, 0, 0
3138, 1, 1636424581189, 1636424581641, 452, 0, 452, 0, 0, 0
3136, 1, 1636424580996, 1636424581705, 709, 253, 456, 252, 0, 252
3139, 1, 1636424581433, 1636424581888, 455, 0, 455, 0, 0, 0
3140, 1, 1636424581833, 1636424582285, 452, 0, 452, 0, 0, 0
3141, 1, 1636424581853, 1636424582305, 452, 0, 452, 0, 0, 0
3142, 1, 1636424581961, 1636424582413, 452, 0, 452, 0, 0, 0
3145, 1, 1636424582017, 1636424582461, 444, 0, 444, 0, 0, 0
3144, 1, 1636424582017, 1636424582461, 444, 0, 444, 0, 0, 0
3143, 1, 1636424582017, 1636424582917, 900, 445, 455, 445, 0, 445
3146, 1, 1636424582477, 1636424582933, 456, 0, 456, 0, 0, 0
3147, 1, 1636424582673, 1636424583125, 452, 0, 452, 0, 0, 0
3148, 1, 1636424582949, 1636424583581, 632, 176, 456, 176, 0, 176
3149, 1, 1636424583156, 1636424583609, 453, 0, 453, 0, 0, 0
3150, 1, 1636424583288, 1636424583737, 449, 0, 449, 0, 0, 0
3151, 1, 1636424583332, 1636424583789, 457, 0, 457, 0, 0, 0
3152, 1, 1636424583709, 1636424584160, 451, 0, 451, 0, 0, 0
3153, 1, 1636424583848, 1636424584292, 444, 1, 443, 0, 1, 1
3154, 1, 1636424583892, 1636424584336, 444, 0, 444, 0, 0, 0
3157, 1, 1636424584136, 1636424584584, 448, 1, 447, 0, 0, 0
3089, 2, 1636424574672, 1636424584669, 9997, 0, 9997, 141, 0, 141
3090, 2, 1636424574797, 1636424584797, 10000, 0, 10000, 16, 0, 16
3158, 1, 1636424584360, 1636424584813, 453, 1, 452, 0, 0, 0
3159, 1, 1636424584761, 1636424585209, 448, 0, 448, 0, 0, 0
3096, 2, 1636424575444, 1636424585445, 10001, 0, 10001, 0, 0, 0
3160, 1, 1636424585041, 1636424585668, 627, 168, 459, 168, 0, 168
3164, 1, 1636424585172, 1636424585669, 497, 1, 496, 0, 0, 0
3165, 1, 1636424585292, 1636424585760, 468, 1, 467, 0, 0, 0
3166, 1, 1636424585593, 1636424586040, 447, 0, 447, 0, 0, 0
3104, 2, 1636424576109, 1636424586109, 10000, 0, 10000, 0, 0, 0
3168, 1, 1636424585752, 1636424586196, 444, 0, 444, 0, 0, 0
3169, 1, 1636424585796, 1636424586249, 453, 1, 452, 0, 0, 0
3170, 1, 1636424586013, 1636424586465, 452, 0, 452, 0, 0, 0
3106, 1, 1636424576468, 1636424586561, 10093, 9641, 452, 0, 9641, 9641
3172, 1, 1636424586449, 1636424586901, 452, 0, 452, 0, 0, 0
3173, 1, 1636424586628, 1636424587089, 461, 1, 460, 0, 0, 0
3109, 2, 1636424577124, 1636424587124, 10000, 0, 10000, 0, 0, 0
3110, 2, 1636424577124, 1636424587168, 10044, 0, 10044, 0, 0, 0
3176, 1, 1636424587116, 1636424587568, 452, 0, 452, 0, 0, 0
3175, 1, 1636424587009, 1636424587585, 576, 80, 496, 80, 0, 80
3121, 1, 1636424578173, 1636424587612, 9439, 8995, 444, 0, 8995, 8995
3177, 1, 1636424587316, 1636424587769, 453, 1, 452, 0, 1, 1
3178, 1, 1636424587428, 1636424587876, 448, 1, 447, 0, 0, 0
3180, 1, 1636424587612, 1636424588061, 449, 1, 448, 1, 0, 1
3181, 1, 1636424587621, 1636424588073, 452, 0, 452, 0, 0, 0
3183, 1, 1636424587852, 1636424588309, 457, 1, 456, 0, 0, 0
3184, 1, 1636424587968, 1636424588420, 452, 0, 452, 0, 0, 0
3185, 1, 1636424588316, 1636424588773, 457, 1, 456, 0, 0, 0
3186, 1, 1636424588613, 1636424589069, 456, 0, 456, 0, 0, 0
3188, 1, 1636424589037, 1636424589481, 444, 0, 444, 0, 0, 0
3187, 1, 1636424588901, 1636424589520, 619, 169, 450, 168, 0, 168
3189, 1, 1636424589308, 1636424589749, 441, 1, 440, 0, 0, 0
3190, 1, 1636424589384, 1636424589825, 441, 1, 440, 0, 0, 0
3191, 1, 1636424589481, 1636424589925, 444, 0, 444, 0, 0, 0
3192, 1, 1636424589657, 1636424590120, 463, 0, 463, 0, 0, 0
3193, 1, 1636424589972, 1636424590417, 445, 1, 444, 0, 0, 0
3194, 1, 1636424590021, 1636424590473, 452, 0, 452, 0, 0, 0
3195, 1, 1636424590252, 1636424590704, 452, 0, 452, 0, 0, 0
3196, 1, 1636424590744, 1636424591193, 449, 0, 449, 0, 0, 0
3198, 1, 1636424591125, 1636424591572, 447, 0, 447, 0, 0, 0
3197, 1, 1636424590945, 1636424591644, 699, 248, 451, 248, 0, 248
3199, 1, 1636424591212, 1636424591660, 448, 0, 448, 0, 0, 0
3200, 1, 1636424591352, 1636424591793, 441, 0, 441, 0, 0, 0
3201, 1, 1636424591389, 1636424591836, 447, 0, 447, 0, 0, 0
3202, 1, 1636424591528, 1636424591989, 461, 1, 460, 1, 0, 1
3203, 1, 1636424591989, 1636424592440, 451, 0, 451, 0, 0, 0
3204, 1, 1636424592028, 1636424592481, 453, 0, 453, 0, 0, 0
3205, 1, 1636424592289, 1636424592736, 447, 0, 447, 0, 0, 0
3206, 1, 1636424592641, 1636424593089, 448, 0, 448, 0, 0, 0
3207, 1, 1636424592845, 1636424593545, 700, 244, 456, 244, 0, 244
3208, 1, 1636424593193, 1636424593645, 452, 0, 452, 0, 0, 0
3209, 1, 1636424593313, 1636424593761, 448, 0, 448, 0, 0, 0
3211, 1, 1636424593437, 1636424593888, 451, 0, 451, 0, 0, 0
3212, 1, 1636424593472, 1636424593925, 453, 1, 452, 0, 0, 0
3155, 2, 1636424584004, 1636424594005, 10001, 0, 10001, 0, 0, 0
3156, 2, 1636424584004, 1636424594056, 10052, 0, 10052, 0, 0, 0
3213, 1, 1636424593908, 1636424594377, 469, 1, 468, 0, 0, 0
3163, 1, 1636424585100, 1636424594505, 9405, 8957, 448, 0, 8957, 8957
3214, 1, 1636424594148, 1636424594593, 445, 0, 445, 0, 0, 0
3215, 1, 1636424594192, 1636424594636, 444, 0, 444, 0, 0, 0
3218, 1, 1636424594585, 1636424595041, 456, 0, 456, 0, 0, 0
3162, 2, 1636424585124, 1636424595125, 10001, 0, 10001, 0, 0, 0
3161, 2, 1636424585124, 1636424595168, 10044, 0, 10044, 0, 0, 0
3220, 1, 1636424594753, 1636424595572, 819, 289, 530, 288, 1, 289
3167, 2, 1636424585745, 1636424595749, 10004, 0, 10004, 0, 0, 0
3221, 1, 1636424595313, 1636424595760, 447, 0, 447, 0, 0, 0
3222, 1, 1636424595320, 1636424595768, 448, 1, 447, 0, 0, 0
3223, 1, 1636424595332, 1636424595784, 452, 0, 452, 0, 0, 0
3225, 1, 1636424595440, 1636424595884, 444, 0, 444, 0, 0, 0
3227, 1, 1636424595840, 1636424596289, 449, 0, 449, 0, 0, 0
3224, 1, 1636424595440, 1636424596332, 892, 445, 447, 445, 0, 445
3171, 2, 1636424586417, 1636424596417, 10000, 0, 10000, 0, 0, 0
3229, 1, 1636424596057, 1636424596508, 451, 0, 451, 0, 0, 0
3230, 1, 1636424596133, 1636424596745, 612, 156, 456, 156, 0, 156
3228, 1, 1636424596053, 1636424596829, 776, 280, 496, 280, 0, 280
3174, 1, 1636424586784, 1636424596865, 10081, 9633, 448, 0, 9632, 9632
3232, 1, 1636424596732, 1636424597285, 553, 97, 456, 97, 0, 97
3179, 2, 1636424587437, 1636424597437, 10000, 0, 10000, 440, 0, 440
3236, 1, 1636424597297, 1636424597749, 452, 0, 452, 0, 0, 0
3235, 1, 1636424597276, 1636424597756, 480, 1, 479, 0, 0, 0
3234, 1, 1636424597085, 1636424597757, 672, 200, 472, 200, 0, 200
3237, 1, 1636424597336, 1636424597773, 437, 0, 437, 0, 0, 0
3182, 2, 1636424587833, 1636424597833, 10000, 0, 10000, 44, 0, 44
3238, 1, 1636424597400, 1636424597844, 444, 1, 443, 0, 1, 1
3239, 1, 1636424597421, 1636424598293, 872, 424, 448, 424, 0, 424
3240, 1, 1636424597920, 1636424598372, 452, 0, 452, 0, 0, 0
3242, 1, 1636424597989, 1636424598441, 452, 0, 452, 0, 0, 0
3243, 1, 1636424598141, 1636424598593, 452, 0, 452, 0, 0, 0
3241, 1, 1636424597977, 1636424598741, 764, 316, 448, 316, 0, 316
3244, 1, 1636424598188, 1636424599049, 861, 405, 456, 405, 0, 405
3246, 1, 1636424598704, 1636424599197, 493, 37, 456, 37, 0, 37
3247, 1, 1636424599065, 1636424599648, 583, 133, 450, 132, 0, 132
3248, 1, 1636424599269, 1636424599716, 447, 0, 447, 0, 0, 0
3250, 1, 1636424599320, 1636424599772, 452, 1, 451, 0, 0, 0
3249, 1, 1636424599320, 1636424599772, 452, 1, 451, 1, 0, 1
3251, 1, 1636424599364, 1636424600229, 865, 409, 456, 409, 0, 409
3254, 1, 1636424600000, 1636424600453, 453, 0, 453, 0, 0, 0
3255, 1, 1636424600028, 1636424600476, 448, 0, 448, 0, 0, 0
3257, 1, 1636424600117, 1636424600569, 452, 0, 452, 0, 0, 0
3253, 1, 1636424599880, 1636424600689, 809, 349, 460, 349, 0, 349
3256, 1, 1636424600081, 1636424600913, 832, 373, 459, 372, 0, 372
3258, 1, 1636424600705, 1636424601157, 452, 0, 452, 0, 0, 0
3259, 1, 1636424601061, 1636424601617, 556, 97, 459, 96, 0, 96
3260, 1, 1636424601241, 1636424601677, 436, 0, 436, 0, 0, 0
3261, 1, 1636424601288, 1636424601741, 453, 1, 452, 0, 0, 0
3263, 1, 1636424601324, 1636424601772, 448, 1, 447, 0, 0, 0
3262, 1, 1636424601288, 1636424602201, 913, 453, 460, 452, 0, 452
3265, 1, 1636424601941, 1636424602392, 451, 0, 451, 0, 0, 0
3266, 1, 1636424602073, 1636424602525, 452, 0, 452, 0, 0, 0
3264, 1, 1636424601812, 1636424602648, 836, 389, 447, 389, 0, 389
3268, 1, 1636424602220, 1636424602673, 453, 0, 453, 0, 0, 0
3267, 1, 1636424602081, 1636424602981, 900, 444, 456, 444, 0, 444
3269, 1, 1636424602668, 1636424603120, 452, 1, 451, 0, 0, 0
3210, 2, 1636424593340, 1636424603341, 10001, 0, 10001, 0, 0, 0
3270, 1, 1636424602965, 1636424603573, 608, 156, 452, 156, 0, 156
3271, 1, 1636424603164, 1636424603656, 492, 0, 492, 0, 0, 0
3273, 1, 1636424603388, 1636424603840, 452, 1, 451, 0, 1, 1
3274, 1, 1636424603481, 1636424603933, 452, 0, 452, 0, 0, 0
3275, 1, 1636424603649, 1636424604100, 451, 0, 451, 0, 0, 0
3276, 1, 1636424603817, 1636424604297, 480, 29, 451, 29, 0, 29
3217, 2, 1636424594320, 1636424604320, 10000, 0, 10000, 0, 0, 0
3216, 2, 1636424594324, 1636424604364, 10040, 0, 10040, 0, 0, 0
3277, 1, 1636424604028, 1636424604484, 456, 1, 455, 0, 0, 0
3279, 1, 1636424604053, 1636424604588, 535, 0, 535, 0, 0, 0
3280, 1, 1636424604116, 1636424604588, 472, 1, 471, 0, 0, 0
3219, 2, 1636424594741, 1636424604741, 10000, 0, 10000, 0, 0, 0
3272, 1, 1636424603388, 1636424604780, 1392, 909, 483, 908, 0, 908
3278, 1, 1636424604044, 1636424604969, 925, 441, 484, 440, 0, 440
3282, 1, 1636424604632, 1636424605081, 449, 1, 448, 0, 0, 0
3283, 1, 1636424604784, 1636424605229, 445, 0, 445, 0, 0, 0
3286, 1, 1636424605081, 1636424605533, 452, 0, 452, 0, 0, 0
3226, 2, 1636424595536, 1636424605537, 10001, 0, 10001, 0, 0, 0
3287, 1, 1636424605232, 1636424605685, 453, 0, 453, 0, 0, 0
3285, 1, 1636424605029, 1636424605688, 659, 200, 459, 200, 0, 200
3289, 1, 1636424605365, 1636424605860, 495, 0, 495, 0, 0, 0
3290, 1, 1636424605629, 1636424606081, 452, 0, 452, 0, 0, 0
3288, 1, 1636424605336, 1636424606136, 800, 349, 451, 349, 0, 349
3293, 1, 1636424605960, 1636424606417, 457, 0, 457, 0, 0, 0
3291, 1, 1636424605705, 1636424606577, 872, 432, 440, 432, 0, 432
3295, 1, 1636424606153, 1636424606596, 443, 0, 443, 0, 0, 0
3296, 1, 1636424606180, 1636424606628, 448, 1, 447, 0, 0, 0
3231, 2, 1636424596668, 1636424606669, 10001, 0, 10001, 0, 0, 0
3233, 2, 1636424596817, 1636424606816, 9999, 0, 9999, 0, 0, 0
3294, 1, 1636424606004, 1636424606893, 889, 413, 476, 413, 0, 413
3297, 1, 1636424606456, 1636424606909, 453, 0, 453, 0, 0, 0
3298, 1, 1636424606652, 1636424607136, 484, 1, 483, 1, 0, 1
3300, 1, 1636424607021, 1636424607580, 559, 116, 443, 116, 0, 116
3302, 1, 1636424607180, 1636424607633, 453, 1, 452, 0, 1, 1
3303, 1, 1636424607188, 1636424607641, 453, 0, 453, 0, 0, 0
3305, 1, 1636424607449, 1636424607889, 440, 0, 440, 0, 0, 0
3306, 1, 1636424607641, 1636424608093, 452, 0, 452, 0, 0, 0
3307, 1, 1636424607705, 1636424608153, 448, 0, 448, 0, 0, 0
3245, 2, 1636424598237, 1636424608236, 9999, 0, 9999, 0, 0, 0
3308, 1, 1636424608005, 1636424608464, 459, 0, 459, 0, 0, 0
3310, 1, 1636424608065, 1636424608553, 488, 0, 488, 0, 0, 0
3304, 1, 1636424607300, 1636424608556, 1256, 794, 462, 793, 0, 793
3311, 1, 1636424608285, 1636424608737, 452, 0, 452, 0, 0, 0
3312, 1, 1636424608437, 1636424608889, 452, 0, 452, 0, 0, 0
3309, 1, 1636424608052, 1636424608917, 865, 413, 452, 413, 0, 413
3314, 1, 1636424608568, 1636424609021, 453, 1, 452, 0, 1, 1
3252, 2, 1636424599404, 1636424609404, 10000, 0, 10000, 0, 0, 0
3315, 1, 1636424609013, 1636424609469, 456, 8, 448, 8, 0, 8
3316, 1, 1636424609133, 1636424609576, 443, 0, 443, 0, 0, 0
3317, 1, 1636424609221, 1636424609676, 455, 0, 455, 0, 0, 0
3319, 1, 1636424609496, 1636424609953, 457, 1, 456, 0, 0, 0
3322, 1, 1636424609692, 1636424610145, 453, 0, 453, 0, 0, 0
3323, 1, 1636424609953, 1636424610409, 456, 0, 456, 0, 0, 0
3324, 1, 1636424610017, 1636424610469, 452, 0, 452, 0, 0, 0
3326, 1, 1636424610169, 1636424610621, 452, 0, 452, 0, 0, 0
3325, 1, 1636424610068, 1636424610928, 860, 401, 459, 401, 0, 401
3327, 1, 1636424610533, 1636424610985, 452, 0, 452, 0, 0, 0
3330, 1, 1636424611109, 1636424611561, 452, 0, 452, 0, 0, 0
3331, 1, 1636424611257, 1636424611713, 456, 0, 456, 0, 0, 0
3332, 1, 1636424611461, 1636424611909, 448, 0, 448, 0, 0, 0
3333, 1, 1636424611585, 1636424612036, 451, 0, 451, 0, 0, 0
3334, 1, 1636424612008, 1636424612460, 452, 1, 451, 1, 0, 1
3336, 1, 1636424612020, 1636424612468, 448, 0, 448, 0, 0, 0
3337, 1, 1636424612060, 1636424612504, 444, 1, 443, 0, 1, 1
3338, 1, 1636424612416, 1636424612864, 448, 0, 448, 0, 0, 0
3335, 1, 1636424612008, 1636424612908, 900, 453, 447, 452, 0, 452
3339, 1, 1636424612985, 1636424613436, 451, 0, 451, 0, 0, 0
3340, 1, 1636424613248, 1636424613705, 457, 0, 457, 0, 0, 0
3341, 1, 1636424613561, 1636424614012, 451, 0, 451, 0, 0, 0
3342, 1, 1636424613612, 1636424614061, 449, 1, 448, 0, 0, 0
3343, 1, 1636424613893, 1636424614345, 452, 0, 452, 0, 0, 0
3345, 1, 1636424614057, 1636424614513, 456, 4, 452, 4, 0, 4
3281, 2, 1636424604632, 1636424614633, 10001, 0, 10001, 449, 0, 449
3344, 1, 1636424614005, 1636424614797, 792, 340, 452, 340, 0, 340
3347, 1, 1636424614356, 1636424614812, 456, 1, 455, 0, 0, 0
3346, 1, 1636424614084, 1636424614969, 885, 429, 456, 429, 0, 429
3284, 2, 1636424605052, 1636424615053, 10001, 0, 10001, 29, 0, 29
3348, 1, 1636424614848, 1636424615296, 448, 1, 447, 1, 0, 1
3349, 1, 1636424615192, 1636424615648, 456, 0, 456, 0, 0, 0
3292, 2, 1636424605844, 1636424615844, 10000, 0, 10000, 0, 0, 0
3352, 1, 1636424615648, 1636424616101, 453, 1, 452, 0, 1, 1
3353, 1, 1636424615688, 1636424616160, 472, 0, 472, 0, 0, 0
3354, 1, 1636424615936, 1636424616397, 461, 1, 460, 0, 0, 0
3357, 1, 1636424616121, 1636424616581, 460, 0, 460, 0, 0, 0
3358, 1, 1636424616149, 1636424616597, 448, 0, 448, 0, 0, 0
3359, 1, 1636424616312, 1636424616761, 449, 0, 449, 0, 0, 0
3355, 1, 1636424616012, 1636424616853, 841, 385, 456, 384, 0, 384
3299, 2, 1636424606993, 1636424616993, 10000, 0, 10000, 0, 0, 0
3301, 2, 1636424607121, 1636424617121, 10000, 0, 10000, 0, 0, 0
3360, 1, 1636424616937, 1636424617449, 512, 0, 512, 0, 0, 0
3361, 1, 1636424617260, 1636424617713, 453, 1, 452, 0, 1, 1
3364, 1, 1636424617649, 1636424618101, 452, 0, 452, 0, 0, 0
3365, 1, 1636424617713, 1636424618161, 448, 0, 448, 0, 0, 0
3366, 1, 1636424618004, 1636424618461, 457, 1, 456, 0, 1, 1
3367, 1, 1636424618013, 1636424618469, 456, 0, 456, 0, 0, 0
3313, 2, 1636424608545, 1636424618545, 10000, 0, 10000, 0, 0, 0
3369, 1, 1636424618209, 1636424618660, 451, 0, 451, 0, 0, 0
3370, 1, 1636424618405, 1636424618865, 460, 0, 460, 0, 0, 0
3368, 1, 1636424618076, 1636424618948, 872, 393, 479, 393, 0, 393
3320, 1, 1636424609709, 1636424618992, 9283, 8836, 447, 0, 8836, 8836
3318, 2, 1636424609333, 1636424619333, 10000, 0, 10000, 344, 0, 344
3372, 1, 1636424618932, 1636424619389, 457, 1, 456, 0, 0, 0
3321, 2, 1636424609676, 1636424619677, 10001, 0, 10001, 1, 0, 1
3374, 1, 1636424619333, 1636424619780, 447, 0, 447, 0, 0, 0
3375, 1, 1636424619669, 1636424620120, 451, 0, 451, 0, 0, 0
3376, 1, 1636424619720, 1636424620164, 444, 0, 444, 0, 0, 0
3377, 1, 1636424619937, 1636424620388, 451, 0, 451, 0, 0, 0
3378, 1, 1636424619988, 1636424620440, 452, 1, 451, 1, 0, 1
3381, 1, 1636424620065, 1636424620517, 452, 0, 452, 0, 0, 0
3382, 1, 1636424620089, 1636424620569, 480, 32, 448, 32, 0, 32
3328, 2, 1636424610689, 1636424620689, 10000, 0, 10000, 0, 0, 0
3380, 1, 1636424620013, 1636424620845, 832, 376, 456, 376, 0, 376
3379, 1, 1636424619992, 1636424620912, 920, 449, 471, 449, 0, 449
3329, 1, 1636424611053, 1636424621133, 10080, 9636, 444, 0, 9636, 9636
3384, 1, 1636424620869, 1636424621317, 448, 0, 448, 0, 0, 0
3383, 1, 1636424620484, 1636424621357, 873, 429, 444, 429, 0, 429
3386, 1, 1636424621213, 1636424621665, 452, 0, 452, 0, 0, 0
3388, 1, 1636424621597, 1636424622049, 452, 0, 452, 0, 0, 0
3389, 1, 1636424621765, 1636424622217, 452, 0, 452, 0, 0, 0
3390, 1, 1636424621833, 1636424622285, 452, 0, 452, 0, 0, 0
3392, 1, 1636424621933, 1636424622385, 452, 0, 452, 0, 0, 0
3394, 1, 1636424622112, 1636424622565, 453, 1, 452, 0, 0, 0
3395, 1, 1636424622112, 1636424622677, 565, 106, 459, 104, 1, 105
3391, 1, 1636424621853, 1636424622737, 884, 432, 452, 432, 0, 432
3393, 1, 1636424622072, 1636424622837, 765, 313, 452, 313, 0, 313
3396, 1, 1636424622544, 1636424622993, 449, 1, 448, 0, 0, 0
3397, 1, 1636424622905, 1636424623361, 456, 0, 456, 0, 0, 0
3398, 1, 1636424623217, 1636424623669, 452, 0, 452, 0, 0, 0
3399, 1, 1636424623541, 1636424623989, 448, 0, 448, 0, 0, 0
3400, 1, 1636424623705, 1636424624149, 444, 0, 444, 0, 0, 0
3401, 1, 1636424623793, 1636424624240, 447, 0, 447, 0, 0, 0
3403, 1, 1636424624068, 1636424624521, 453, 1, 452, 1, 0, 1
3402, 1, 1636424623840, 1636424624605, 765, 309, 456, 309, 0, 309
3405, 1, 1636424624196, 1636424624641, 445, 1, 444, 1, 0, 1
3406, 1, 1636424624224, 1636424624681, 457, 17, 440, 16, 0, 16
3404, 1, 1636424624076, 1636424624977, 901, 445, 456, 445, 0, 445
3408, 1, 1636424624773, 1636424625229, 456, 0, 456, 0, 0, 0
3351, 2, 1636424615392, 1636424625392, 10000, 0, 10000, 0, 0, 0
3350, 2, 1636424615392, 1636424625436, 10044, 0, 10044, 0, 0, 0
3409, 1, 1636424625348, 1636424625840, 492, 0, 492, 0, 0, 0
3410, 1, 1636424625480, 1636424625924, 444, 0, 444, 0, 0, 0
3411, 1, 1636424625620, 1636424626077, 457, 0, 457, 0, 0, 0
3356, 2, 1636424616152, 1636424626153, 10001, 0, 10001, 0, 0, 0
3412, 1, 1636424625704, 1636424626160, 456, 0, 456, 0, 0, 0
3415, 1, 1636424625844, 1636424626293, 449, 0, 449, 0, 0, 0
3416, 1, 1636424626045, 1636424626501, 456, 0, 456, 0, 0, 0
3414, 1, 1636424625792, 1636424626561, 769, 285, 484, 285, 0, 285
3413, 1, 1636424625704, 1636424626601, 897, 457, 440, 457, 0, 457
3418, 1, 1636424626196, 1636424626645, 449, 0, 449, 0, 0, 0
3419, 1, 1636424626321, 1636424626781, 460, 0, 460, 0, 0, 0
3417, 1, 1636424626053, 1636424626953, 900, 448, 452, 448, 0, 448
3420, 1, 1636424626461, 1636424627053, 592, 140, 452, 140, 0, 140
3421, 1, 1636424626720, 1636424627173, 453, 1, 452, 0, 0, 0
3362, 2, 1636424617296, 1636424627297, 10001, 0, 10001, 0, 0, 0
3363, 2, 1636424617425, 1636424627425, 10000, 0, 10000, 0, 0, 0
3422, 1, 1636424627340, 1636424627832, 492, 0, 492, 0, 0, 0
3425, 1, 1636424627560, 1636424628008, 448, 1, 447, 0, 0, 0
3423, 1, 1636424627600, 1636424628052, 452, 0, 452, 0, 0, 0
3426, 1, 1636424627684, 1636424628137, 453, 0, 453, 0, 0, 0
3430, 1, 1636424627840, 1636424628292, 452, 1, 451, 0, 1, 1
3431, 1, 1636424627968, 1636424628425, 457, 0, 457, 0, 0, 0
3427, 1, 1636424627728, 1636424628505, 777, 325, 452, 325, 0, 325
3428, 1, 1636424627728, 1636424628584, 856, 409, 447, 409, 0, 409
3433, 1, 1636424628217, 1636424628669, 452, 0, 452, 0, 0, 0
3434, 1, 1636424628225, 1636424628745, 520, 68, 452, 68, 0, 68
3371, 2, 1636424618853, 1636424628853, 10000, 0, 10000, 0, 0, 0
3432, 1, 1636424628012, 1636424628881, 869, 414, 455, 413, 0, 413
3435, 1, 1636424628421, 1636424629085, 664, 164, 500, 164, 0, 164
3373, 1, 1636424619213, 1636424629305, 10092, 9640, 452, 0, 9640, 9640
3437, 1, 1636424629161, 1636424629613, 452, 0, 452, 0, 0, 0
3438, 1, 1636424629312, 1636424629765, 453, 1, 452, 0, 0, 0
3440, 1, 1636424629493, 1636424629944, 451, 0, 451, 0, 0, 0
3439, 1, 1636424629524, 1636424630065, 541, 89, 452, 89, 0, 89
3441, 1, 1636424629624, 1636424630081, 457, 1, 456, 0, 0, 0
3443, 1, 1636424629801, 1636424630252, 451, 0, 451, 0, 0, 0
3445, 1, 1636424629881, 1636424630337, 456, 0, 456, 0, 0, 0
3446, 1, 1636424630001, 1636424630461, 460, 0, 460, 0, 0, 0
3442, 1, 1636424629733, 1636424630533, 800, 348, 452, 348, 0, 348
3444, 1, 1636424629829, 1636424630705, 876, 424, 452, 424, 0, 424
3447, 1, 1636424630013, 1636424630917, 904, 449, 455, 448, 0, 448
3385, 2, 1636424620997, 1636424630997, 10000, 0, 10000, 360, 0, 360
3450, 1, 1636424630488, 1636424631161, 673, 218, 455, 217, 1, 218
3387, 2, 1636424621352, 1636424631353, 10001, 0, 10001, 4, 0, 4
3451, 1, 1636424631181, 1636424631676, 495, 0, 495, 0, 0, 0
3452, 1, 1636424631348, 1636424631801, 453, 1, 452, 0, 0, 0
3453, 1, 1636424631396, 1636424631852, 456, 0, 456, 0, 0, 0
3455, 1, 1636424631661, 1636424632117, 456, 0, 456, 0, 0, 0
3454, 1, 1636424631528, 1636424632133, 605, 149, 456, 149, 0, 149
3457, 1, 1636424631737, 1636424632185, 448, 0, 448, 0, 0, 0
3462, 1, 1636424632017, 1636424632469, 452, 0, 452, 0, 0, 0
3456, 1, 1636424631668, 1636424632573, 905, 449, 456, 449, 0, 449
3458, 1, 1636424631776, 1636424632641, 865, 409, 456, 408, 0, 408
3463, 1, 1636424632097, 1636424632921, 824, 372, 452, 372, 0, 372
3465, 1, 1636424633261, 1636424633712, 451, 0, 451, 0, 0, 0
3466, 1, 1636424633421, 1636424633868, 447, 0, 447, 0, 0, 0
3468, 1, 1636424633508, 1636424633953, 445, 0, 445, 0, 0, 0
3467, 1, 1636424633508, 1636424633956, 448, 0, 448, 0, 0, 0
3469, 1, 1636424633568, 1636424634165, 597, 145, 452, 145, 0, 145
3473, 1, 1636424633896, 1636424634348, 452, 0, 452, 0, 0, 0
3470, 1, 1636424633573, 1636424634392, 819, 380, 439, 380, 0, 380
3407, 2, 1636424624493, 1636424634493, 10000, 0, 10000, 0, 0, 0
3474, 1, 1636424634029, 1636424634809, 780, 320, 460, 320, 0, 320
3475, 1, 1636424634793, 1636424635245, 452, 0, 452, 0, 0, 0
3477, 1, 1636424635388, 1636424635845, 457, 0, 457, 0, 0, 0
3478, 1, 1636424635409, 1636424635865, 456, 0, 456, 0, 0, 0
3482, 1, 1636424635841, 1636424636293, 452, 0, 452, 0, 0, 0
3483, 1, 1636424636017, 1636424636749, 732, 277, 455, 276, 1, 277
3484, 1, 1636424636721, 1636424637173, 452, 0, 452, 0, 0, 0
3424, 2, 1636424627560, 1636424637560, 10000, 0, 10000, 0, 0, 0
3429, 2, 1636424627772, 1636424637772, 10000, 0, 10000, 0, 0, 0
3485, 1, 1636424637309, 1636424637784, 475, 0, 475, 0, 0, 0
3486, 1, 1636424637457, 1636424637909, 452, 0, 452, 0, 0, 0
3487, 1, 1636424637737, 1636424638193, 456, 0, 456, 0, 0, 0
3488, 1, 1636424637869, 1636424638321, 452, 0, 452, 0, 0, 0
3489, 1, 1636424637968, 1636424638649, 681, 225, 456, 225, 0, 225
3436, 2, 1636424628737, 1636424638737, 10000, 0, 10000, 0, 0, 0
3490, 1, 1636424638080, 1636424638777, 697, 242, 455, 240, 1, 241
3491, 1, 1636424638873, 1636424639321, 448, 0, 448, 0, 0, 0
3492, 1, 1636424639041, 1636424639488, 447, 0, 447, 0, 0, 0
3493, 1, 1636424639261, 1636424639712, 451, 0, 451, 0, 0, 0
3494, 1, 1636424639572, 1636424640016, 444, 0, 444, 0, 0, 0
3495, 1, 1636424639660, 1636424640101, 441, 0, 441, 0, 0, 0
3496, 1, 1636424639696, 1636424640153, 457, 1, 456, 1, 0, 1
3448, 2, 1636424630277, 1636424640277, 10000, 0, 10000, 60, 0, 60
3449, 2, 1636424630317, 1636424640325, 10008, 0, 10008, 20, 0, 20
3497, 1, 1636424639921, 1636424640632, 711, 180, 531, 180, 0, 180
3498, 1, 1636424639977, 1636424640636, 659, 176, 483, 176, 0, 176
3461, 1, 1636424631985, 1636424640777, 8792, 8340, 452, 0, 8340, 8340
3499, 1, 1636424640653, 1636424641100, 447, 0, 447, 0, 0, 0
3500, 1, 1636424640653, 1636424641100, 447, 0, 447, 0, 0, 0
3501, 1, 1636424640761, 1636424641209, 448, 0, 448, 0, 0, 0
3502, 1, 1636424640897, 1636424641349, 452, 0, 452, 0, 0, 0
3503, 1, 1636424640997, 1636424641556, 559, 104, 455, 104, 0, 104
3504, 1, 1636424641245, 1636424641696, 451, 0, 451, 0, 0, 0
3459, 2, 1636424631852, 1636424641853, 10001, 0, 10001, 281, 0, 281
3460, 2, 1636424631929, 1636424641929, 10000, 0, 10000, 204, 0, 204
3505, 1, 1636424641540, 1636424641993, 453, 0, 453, 0, 0, 0
3506, 1, 1636424641641, 1636424642089, 448, 0, 448, 0, 0, 0
3507, 1, 1636424641652, 1636424642101, 449, 0, 449, 0, 0, 0
3464, 2, 1636424632500, 1636424642501, 10001, 0, 10001, 0, 0, 0
3509, 1, 1636424642020, 1636424642536, 516, 69, 447, 68, 0, 68
3508, 1, 1636424641901, 1636424642556, 655, 200, 455, 200, 0, 200
3510, 1, 1636424642445, 1636424642904, 459, 0, 459, 0, 0, 0
3512, 1, 1636424642493, 1636424642944, 451, 0, 451, 0, 0, 0
3513, 1, 1636424642544, 1636424643004, 460, 1, 459, 0, 0, 0
3514, 1, 1636424642645, 1636424643093, 448, 0, 448, 0, 0, 0
3517, 1, 1636424642900, 1636424643397, 497, 45, 452, 45, 0, 45
3516, 1, 1636424642856, 1636424643453, 597, 149, 448, 149, 0, 149
3518, 1, 1636424643205, 1636424643657, 452, 0, 452, 0, 0, 0
3471, 2, 1636424633857, 1636424643857, 10000, 0, 10000, 0, 0, 0
3472, 2, 1636424633857, 1636424643904, 10047, 0, 10047, 0, 0, 0
3519, 1, 1636424643517, 1636424643968, 451, 0, 451, 0, 0, 0
3521, 1, 1636424643656, 1636424644124, 468, 1, 467, 0, 0, 0
3520, 1, 1636424643600, 1636424644128, 528, 0, 528, 0, 0, 0
3523, 1, 1636424643952, 1636424644417, 465, 17, 448, 17, 0, 17
3522, 1, 1636424643785, 1636424644581, 796, 344, 452, 344, 0, 344
3526, 1, 1636424644328, 1636424644777, 449, 0, 449, 0, 0, 0
3527, 1, 1636424644404, 1636424644860, 456, 1, 455, 0, 0, 0
3528, 1, 1636424644417, 1636424644864, 447, 0, 447, 0, 0, 0
3529, 1, 1636424644673, 1636424645313, 640, 188, 452, 188, 0, 188
3530, 1, 1636424644853, 1636424645313, 460, 12, 448, 12, 0, 12
3476, 2, 1636424635384, 1636424645385, 10001, 0, 10001, 0, 0, 0
3531, 1, 1636424644956, 1636424645396, 440, 1, 439, 0, 1, 1
3479, 2, 1636424635452, 1636424645460, 10008, 0, 10008, 0, 0, 0
3532, 1, 1636424645180, 1636424645628, 448, 1, 447, 0, 0, 0
3481, 1, 1636424635633, 1636424645873, 10240, 9752, 488, 0, 9752, 9752
3533, 1, 1636424645377, 1636424645873, 496, 0, 496, 0, 0, 0
3480, 1, 1636424635572, 1636424645909, 10337, 9888, 449, 0, 9888, 9888
3536, 1, 1636424645729, 1636424646181, 452, 0, 452, 0, 0, 0
3535, 1, 1636424645753, 1636424646204, 451, 0, 451, 0, 0, 0
3537, 1, 1636424645753, 1636424646212, 459, 0, 459, 0, 0, 0
3539, 1, 1636424645929, 1636424646376, 447, 0, 447, 0, 0, 0
3538, 1, 1636424645844, 1636424646633, 789, 337, 452, 336, 0, 336
3541, 1, 1636424646129, 1636424646661, 532, 76, 456, 76, 0, 76
3542, 1, 1636424646284, 1636424646733, 449, 1, 448, 1, 0, 1
3543, 1, 1636424646332, 1636424646776, 444, 1, 443, 0, 0, 0
3544, 1, 1636424646357, 1636424646808, 451, 0, 451, 0, 0, 0
3545, 1, 1636424646768, 1636424647212, 444, 1, 443, 0, 0, 0
3546, 1, 1636424646772, 1636424647260, 488, 37, 451, 37, 0, 37
3548, 1, 1636424647280, 1636424647733, 453, 0, 453, 0, 0, 0
3549, 1, 1636424647452, 1636424647904, 452, 1, 451, 0, 1, 1
3551, 1, 1636424647736, 1636424648192, 456, 1, 455, 0, 1, 1
3552, 1, 1636424647744, 1636424648209, 465, 1, 464, 1, 0, 1
3554, 1, 1636424648021, 1636424648473, 452, 0, 452, 0, 0, 0
3555, 1, 1636424648196, 1636424648649, 453, 1, 452, 0, 0, 0
3556, 1, 1636424648261, 1636424648705, 444, 0, 444, 0, 0, 0
3557, 1, 1636424648277, 1636424648721, 444, 0, 444, 0, 0, 0
3558, 1, 1636424648373, 1636424648820, 447, 0, 447, 0, 0, 0
3559, 1, 1636424648769, 1636424649221, 452, 0, 452, 0, 0, 0
3560, 1, 1636424648796, 1636424649249, 453, 1, 452, 0, 0, 0
3562, 1, 1636424649321, 1636424649773, 452, 0, 452, 0, 0, 0
3563, 1, 1636424649773, 1636424650225, 452, 0, 452, 0, 0, 0
3564, 1, 1636424649812, 1636424650260, 448, 0, 448, 0, 0, 0
3565, 1, 1636424649880, 1636424650328, 448, 0, 448, 0, 0, 0
3566, 1, 1636424650173, 1636424650616, 443, 0, 443, 0, 0, 0
3567, 1, 1636424650268, 1636424650712, 444, 0, 444, 0, 0, 0
3568, 1, 1636424650324, 1636424650769, 445, 0, 445, 0, 0, 0
3569, 1, 1636424650440, 1636424650893, 453, 0, 453, 0, 0, 0
3570, 1, 1636424650752, 1636424651205, 453, 0, 453, 0, 0, 0
3571, 1, 1636424650841, 1636424651289, 448, 0, 448, 0, 0, 0
3572, 1, 1636424651193, 1636424651644, 451, 0, 451, 0, 0, 0
3574, 1, 1636424651697, 1636424652149, 452, 0, 452, 0, 0, 0
3573, 1, 1636424651697, 1636424652149, 452, 0, 452, 0, 0, 0
3575, 1, 1636424651757, 1636424652217, 460, 0, 460, 0, 0, 0
3511, 2, 1636424642448, 1636424652449, 10001, 0, 10001, 457, 0, 457
3576, 1, 1636424652181, 1636424652677, 496, 0, 496, 0, 0, 0
3577, 1, 1636424652240, 1636424652693, 453, 1, 452, 0, 0, 0
3578, 1, 1636424652245, 1636424652700, 455, 0, 455, 0, 0, 0
3515, 2, 1636424642809, 1636424652809, 10000, 0, 10000, 96, 0, 96
3579, 1, 1636424652493, 1636424652940, 447, 0, 447, 0, 0, 0
3580, 1, 1636424652857, 1636424653304, 447, 0, 447, 0, 0, 0
3581, 1, 1636424652857, 1636424653304, 447, 0, 447, 0, 0, 0
3584, 1, 1636424653228, 1636424653688, 460, 0, 460, 0, 0, 0
3585, 1, 1636424653713, 1636424654165, 452, 0, 452, 0, 0, 0
3525, 2, 1636424644165, 1636424654165, 10000, 0, 10000, 0, 0, 0
3586, 1, 1636424653749, 1636424654196, 447, 0, 447, 0, 0, 0
3524, 2, 1636424644165, 1636424654216, 10051, 0, 10051, 0, 0, 0
3587, 1, 1636424653884, 1636424654332, 448, 1, 447, 0, 0, 0
3588, 1, 1636424654260, 1636424654712, 452, 0, 452, 0, 0, 0
3589, 1, 1636424654264, 1636424654721, 457, 0, 457, 0, 0, 0
3590, 1, 1636424654264, 1636424654721, 457, 1, 456, 0, 0, 0
3594, 1, 1636424654821, 1636424655269, 448, 0, 448, 0, 0, 0
3595, 1, 1636424654881, 1636424655333, 452, 0, 452, 0, 0, 0
3596, 1, 1636424655101, 1636424655553, 452, 0, 452, 0, 0, 0
3534, 2, 1636424645729, 1636424655729, 10000, 0, 10000, 0, 0, 0
3540, 2, 1636424646096, 1636424656097, 10001, 0, 10001, 0, 0, 0
3597, 1, 1636424655776, 1636424656217, 441, 0, 441, 0, 0, 0
3598, 1, 1636424655820, 1636424656269, 449, 0, 449, 0, 0, 0
3599, 1, 1636424655864, 1636424656316, 452, 1, 451, 0, 0, 0
3602, 1, 1636424656140, 1636424656593, 453, 1, 452, 0, 1, 1
3601, 1, 1636424656140, 1636424656593, 453, 1, 452, 1, 0, 1
3603, 1, 1636424656228, 1636424656681, 453, 1, 452, 0, 0, 0
3547, 2, 1636424646901, 1636424656901, 10000, 0, 10000, 0, 0, 0
3605, 1, 1636424656813, 1636424657309, 496, 0, 496, 0, 0, 0
3606, 1, 1636424656993, 1636424657445, 452, 0, 452, 0, 0, 0
3607, 1, 1636424657045, 1636424657488, 443, 0, 443, 0, 0, 0
3550, 2, 1636424647669, 1636424657669, 10000, 0, 10000, 0, 0, 0
3553, 2, 1636424647816, 1636424657817, 10001, 0, 10001, 1, 0, 1
3609, 1, 1636424657664, 1636424658132, 468, 1, 467, 0, 0, 0
3610, 1, 1636424657712, 1636424658165, 453, 1, 452, 0, 0, 0
3561, 1, 1636424649221, 1636424658273, 9052, 8596, 456, 0, 8596, 8596
3611, 1, 1636424657864, 1636424658313, 449, 0, 449, 0, 0, 0
3613, 1, 1636424658005, 1636424658457, 452, 0, 452, 0, 0, 0
3614, 1, 1636424658060, 1636424658513, 453, 1, 452, 1, 0, 1
3616, 1, 1636424658148, 1636424658625, 477, 17, 460, 17, 0, 17
3618, 1, 1636424658801, 1636424659253, 452, 0, 452, 0, 0, 0
3619, 1, 1636424658885, 1636424659337, 452, 0, 452, 0, 0, 0
3621, 1, 1636424659621, 1636424660072, 451, 0, 451, 0, 0, 0
3623, 1, 1636424659908, 1636424660365, 457, 1, 456, 0, 0, 0
3624, 1, 1636424660041, 1636424660489, 448, 0, 448, 0, 0, 0
3625, 1, 1636424660044, 1636424660501, 457, 0, 457, 0, 0, 0
3626, 1, 1636424660088, 1636424660537, 449, 0, 449, 0, 0, 0
3627, 1, 1636424660840, 1636424661293, 453, 1, 452, 0, 0, 0
3628, 1, 1636424660976, 1636424661425, 449, 0, 449, 0, 0, 0
3629, 1, 1636424661729, 1636424662172, 443, 0, 443, 0, 0, 0
3630, 1, 1636424662036, 1636424662480, 444, 0, 444, 0, 0, 0
3631, 1, 1636424662080, 1636424662524, 444, 0, 444, 0, 0, 0
3632, 1, 1636424662105, 1636424662553, 448, 0, 448, 0, 0, 0
3633, 1, 1636424662196, 1636424662649, 453, 1, 452, 0, 1, 1
3582, 2, 1636424653212, 1636424663216, 10004, 0, 10004, 0, 0, 0
3583, 2, 1636424653212, 1636424663260, 10048, 0, 10048, 0, 0, 0
3634, 1, 1636424662901, 1636424663348, 447, 0, 447, 0, 0, 0
3635, 1, 1636424663113, 1636424663572, 459, 0, 459, 0, 0, 0
3637, 1, 1636424663528, 1636424663981, 453, 1, 452, 0, 1, 1
3638, 1, 1636424663805, 1636424664257, 452, 0, 452, 0, 0, 0
3636, 1, 1636424663528, 1636424664437, 909, 454, 455, 453, 0, 453
3593, 2, 1636424654472, 1636424664473, 10001, 0, 10001, 0, 0, 0
3592, 2, 1636424654484, 1636424664516, 10032, 0, 10032, 0, 0, 0
3591, 2, 1636424654480, 1636424664560, 10080, 0, 10080, 0, 0, 0
3641, 1, 1636424664189, 1636424664636, 447, 0, 447, 0, 0, 0
3642, 1, 1636424664272, 1636424664789, 517, 0, 517, 0, 0, 0
3644, 1, 1636424664821, 1636424665272, 451, 0, 451, 0, 0, 0
3646, 1, 1636424664828, 1636424665280, 452, 0, 452, 0, 0, 0
3647, 1, 1636424665201, 1636424665653, 452, 0, 452, 0, 0, 0
3645, 1, 1636424664821, 1636424665733, 912, 452, 460, 452, 0, 452
3648, 1, 1636424665445, 1636424665896, 451, 0, 451, 0, 0, 0
3600, 2, 1636424656041, 1636424666041, 10000, 0, 10000, 0, 0, 0
3650, 1, 1636424665769, 1636424666269, 500, 0, 500, 0, 0, 0
3649, 1, 1636424665553, 1636424666353, 800, 344, 456, 344, 0, 344
3604, 2, 1636424656405, 1636424666405, 10000, 0, 10000, 0, 0, 0
3652, 1, 1636424666268, 1636424666725, 457, 1, 456, 0, 0, 0
3654, 1, 1636424666709, 1636424667177, 468, 17, 451, 16, 0, 16
3608, 2, 1636424657200, 1636424667201, 10001, 0, 10001, 0, 0, 0
3655, 1, 1636424666772, 1636424667220, 448, 0, 448, 0, 0, 0
3657, 1, 1636424666845, 1636424667672, 827, 376, 451, 376, 0, 376
3658, 1, 1636424667296, 1636424667744, 448, 0, 448, 0, 0, 0
3612, 2, 1636424657997, 1636424667996, 9999, 0, 9999, 0, 0, 0
3660, 1, 1636424667540, 1636424668000, 460, 1, 459, 1, 0, 1
3615, 2, 1636424658129, 1636424668129, 10000, 0, 10000, 0, 0, 0
3662, 1, 1636424667701, 1636424668152, 451, 0, 451, 0, 0, 0
3661, 1, 1636424667605, 1636424668453, 848, 396, 452, 395, 0, 395
3617, 1, 1636424658492, 1636424668581, 10089, 9637, 452, 0, 9637, 9637
3663, 1, 1636424668221, 1636424668673, 452, 0, 452, 0, 0, 0
3620, 2, 1636424659069, 1636424669069, 10000, 0, 10000, 0, 0, 0
3666, 1, 1636424668736, 1636424669189, 453, 1, 452, 0, 1, 1
3668, 1, 1636424668861, 1636424669317, 456, 0, 456, 0, 0, 0
3670, 1, 1636424669248, 1636424669705, 457, 1, 456, 0, 1, 1
3669, 1, 1636424668872, 1636424669773, 901, 446, 455, 445, 1, 446
3622, 2, 1636424659789, 1636424669789, 10000, 0, 10000, 0, 0, 0
3671, 1, 1636424669373, 1636424669825, 452, 0, 452, 0, 0, 0
3672, 1, 1636424669593, 1636424670045, 452, 0, 452, 0, 0, 0
3673, 1, 1636424669668, 1636424670121, 453, 1, 452, 1, 0, 1
3675, 1, 1636424670097, 1636424670549, 452, 0, 452, 0, 0, 0
3676, 1, 1636424670113, 1636424670569, 456, 0, 456, 0, 0, 0
3674, 1, 1636424669676, 1636424670577, 901, 445, 456, 445, 0, 445
3677, 1, 1636424670833, 1636424671285, 452, 0, 452, 0, 0, 0
3678, 1, 1636424670873, 1636424671325, 452, 0, 452, 0, 0, 0
3680, 1, 1636424671197, 1636424671648, 451, 0, 451, 0, 0, 0
3679, 1, 1636424670993, 1636424671777, 784, 333, 451, 332, 0, 332
3681, 1, 1636424671376, 1636424671820, 444, 1, 443, 0, 0, 0
3682, 1, 1636424671572, 1636424672029, 457, 0, 457, 0, 0, 0
3684, 1, 1636424671609, 1636424672101, 492, 40, 452, 40, 0, 40
3686, 1, 1636424672033, 1636424672485, 452, 0, 452, 0, 0, 0
3688, 1, 1636424672845, 1636424673297, 452, 0, 452, 0, 0, 0
3690, 1, 1636424673153, 1636424673605, 452, 0, 452, 0, 0, 0
3691, 1, 1636424673476, 1636424673928, 452, 1, 451, 0, 0, 0
3692, 1, 1636424673509, 1636424673961, 452, 0, 452, 0, 0, 0
3639, 2, 1636424663973, 1636424673972, 9999, 0, 9999, 0, 0, 0
3640, 2, 1636424664036, 1636424674037, 10001, 0, 10001, 0, 0, 0
3695, 1, 1636424674304, 1636424674752, 448, 0, 448, 0, 0, 0
3643, 2, 1636424664769, 1636424674769, 10000, 0, 10000, 0, 0, 0
3696, 1, 1636424674344, 1636424674804, 460, 0, 460, 0, 0, 0
3698, 1, 1636424675077, 1636424675533, 456, 0, 456, 0, 0, 0
3699, 1, 1636424675249, 1636424675700, 451, 0, 451, 0, 0, 0
3700, 1, 1636424675433, 1636424675885, 452, 0, 452, 0, 0, 0
3701, 1, 1636424675561, 1636424676017, 456, 0, 456, 0, 0, 0
3651, 2, 1636424666089, 1636424676089, 10000, 0, 10000, 0, 0, 0
3653, 2, 1636424666349, 1636424676349, 10000, 0, 10000, 828, 0, 828
3702, 1, 1636424676272, 1636424676756, 484, 1, 483, 0, 0, 0
3656, 2, 1636424666784, 1636424676785, 10001, 0, 10001, 392, 0, 392
3703, 1, 1636424676397, 1636424676845, 448, 0, 448, 0, 0, 0
3704, 1, 1636424676397, 1636424676849, 452, 0, 452, 0, 0, 0
3659, 2, 1636424667501, 1636424677500, 9999, 0, 9999, 0, 0, 0
3705, 1, 1636424677073, 1636424677524, 451, 0, 451, 0, 0, 0
3706, 1, 1636424677133, 1636424677581, 448, 0, 448, 0, 0, 0
3709, 1, 1636424677480, 1636424677932, 452, 0, 452, 0, 0, 0
3707, 1, 1636424677489, 1636424677940, 451, 0, 451, 0, 0, 0
3708, 1, 1636424677489, 1636424677940, 451, 0, 451, 0, 0, 0
3664, 2, 1636424668309, 1636424678305, 9996, 0, 9996, 0, 0, 0
3711, 1, 1636424677808, 1636424678392, 584, 133, 451, 133, 0, 133
3710, 1, 1636424677544, 1636424678396, 852, 397, 455, 397, 0, 397
3665, 2, 1636424668437, 1636424678436, 9999, 0, 9999, 0, 0, 0
3712, 1, 1636424678296, 1636424678753, 457, 0, 457, 0, 0, 0
3713, 1, 1636424678396, 1636424678836, 440, 0, 440, 0, 0, 0
3714, 1, 1636424678396, 1636424678840, 444, 1, 443, 0, 0, 0
3667, 1, 1636424668800, 1636424678880, 10080, 9636, 444, 0, 9635, 9635
3715, 1, 1636424678617, 1636424679069, 452, 0, 452, 0, 0, 0
3719, 1, 1636424679109, 1636424679560, 451, 0, 451, 0, 0, 0
3720, 1, 1636424679276, 1636424679724, 448, 1, 447, 0, 0, 0
3721, 1, 1636424679365, 1636424679813, 448, 0, 448, 0, 0, 0
3722, 1, 1636424679365, 1636424679813, 448, 0, 448, 0, 0, 0
3724, 1, 1636424679705, 1636424680173, 468, 20, 448, 20, 0, 20
3723, 1, 1636424679492, 1636424680257, 765, 322, 443, 321, 1, 322
3725, 1, 1636424680377, 1636424680829, 452, 0, 452, 0, 0, 0
3726, 1, 1636424680392, 1636424680856, 464, 1, 463, 0, 0, 0
3727, 1, 1636424680408, 1636424680857, 449, 1, 448, 0, 0, 0
3728, 1, 1636424680428, 1636424680881, 453, 1, 452, 0, 0, 0
3729, 1, 1636424681109, 1636424681545, 436, 0, 436, 0, 0, 0
3683, 2, 1636424671592, 1636424681593, 10001, 0, 10001, 509, 0, 509
3730, 1, 1636424681249, 1636424681693, 444, 0, 444, 0, 0, 0
3731, 1, 1636424681365, 1636424681812, 447, 0, 447, 0, 0, 0
3732, 1, 1636424681417, 1636424681856, 439, 0, 439, 0, 0, 0
3685, 2, 1636424671921, 1636424681921, 10000, 0, 10000, 180, 0, 180
3734, 1, 1636424681732, 1636424682261, 529, 81, 448, 80, 0, 80
3733, 1, 1636424681533, 1636424682321, 788, 324, 464, 324, 0, 324
3735, 1, 1636424682244, 1636424682700, 456, 1, 455, 0, 0, 0
3687, 2, 1636424672797, 1636424682793, 9996, 0, 9996, 0, 0, 0
3737, 1, 1636424682412, 1636424682857, 445, 0, 445, 0, 0, 0
3736, 1, 1636424682409, 1636424682857, 448, 0, 448, 0, 0, 0
3738, 1, 1636424682428, 1636424682880, 452, 1, 451, 0, 0, 0
3689, 2, 1636424672905, 1636424682900, 9995, 0, 9995, 0, 0, 0
3739, 1, 1636424682456, 1636424682904, 448, 0, 448, 0, 0, 0
3740, 1, 1636424682497, 1636424682941, 444, 0, 444, 0, 0, 0
3693, 2, 1636424673533, 1636424683532, 9999, 0, 9999, 0, 0, 0
3741, 1, 1636424683108, 1636424683552, 444, 0, 444, 0, 0, 0
3742, 1, 1636424683125, 1636424683576, 451, 0, 451, 0, 0, 0
3743, 1, 1636424683152, 1636424683596, 444, 0, 444, 0, 0, 0
3745, 1, 1636424683433, 1636424683885, 452, 0, 452, 0, 0, 0
3694, 2, 1636424673912, 1636424683913, 10001, 0, 10001, 0, 0, 0
3746, 1, 1636424683465, 1636424683937, 472, 0, 472, 0, 0, 0
3744, 1, 1636424683208, 1636424684000, 792, 345, 447, 345, 0, 345
3748, 1, 1636424683833, 1636424684316, 483, 0, 483, 0, 0, 0
3749, 1, 1636424683848, 1636424684337, 489, 37, 452, 36, 0, 36
3697, 1, 1636424674812, 1636424684357, 9545, 9101, 444, 0, 9101, 9101
3747, 1, 1636424683576, 1636424684380, 804, 361, 443, 361, 0, 361
3752, 1, 1636424684257, 1636424684708, 451, 0, 451, 0, 0, 0
3753, 1, 1636424684272, 1636424684729, 457, 0, 457, 0, 0, 0
3750, 1, 1636424684220, 1636424684765, 545, 97, 448, 97, 0, 97
3754, 1, 1636424684473, 1636424684925, 452, 0, 452, 0, 0, 0
3755, 1, 1636424684493, 1636424684945, 452, 0, 452, 0, 0, 0
3756, 1, 1636424684577, 1636424685024, 447, 0, 447, 0, 0, 0
3757, 1, 1636424684616, 1636424685068, 452, 0, 452, 0, 0, 0
3760, 1, 1636424685185, 1636424685637, 452, 0, 452, 0, 0, 0
3761, 1, 1636424685236, 1636424685689, 453, 1, 452, 0, 0, 0
3762, 1, 1636424685332, 1636424685788, 456, 1, 455, 1, 0, 1
3763, 1, 1636424685469, 1636424685921, 452, 0, 452, 0, 0, 0
3765, 1, 1636424685729, 1636424686181, 452, 0, 452, 0, 0, 0
3764, 1, 1636424685493, 1636424686237, 744, 295, 449, 295, 0, 295
3766, 1, 1636424685880, 1636424686377, 497, 40, 457, 40, 0, 40
3768, 1, 1636424686152, 1636424686609, 457, 0, 457, 0, 0, 0
3767, 1, 1636424686085, 1636424686637, 552, 96, 456, 96, 0, 96
3769, 1, 1636424686324, 1636424686777, 453, 1, 452, 1, 0, 1
3772, 1, 1636424686509, 1636424686961, 452, 0, 452, 0, 0, 0
3773, 1, 1636424686648, 1636424687101, 453, 1, 452, 0, 0, 0
3775, 1, 1636424687213, 1636424687657, 444, 0, 444, 0, 0, 0
3776, 1, 1636424687352, 1636424687801, 449, 1, 448, 0, 0, 0
3779, 1, 1636424687777, 1636424688229, 452, 0, 452, 0, 0, 0
3778, 1, 1636424687576, 1636424688248, 672, 225, 447, 225, 0, 225
3781, 1, 1636424688117, 1636424688689, 572, 112, 460, 112, 0, 112
3782, 1, 1636424688285, 1636424688732, 447, 0, 447, 0, 0, 0
3716, 2, 1636424678745, 1636424688745, 10000, 0, 10000, 324, 0, 324
3783, 1, 1636424688333, 1636424688777, 444, 0, 444, 0, 0, 0
3718, 2, 1636424679069, 1636424689069, 10000, 0, 10000, 0, 0, 0
3717, 2, 1636424679100, 1636424689113, 10013, 9969, 44, 0, 9969, 9969
3786, 1, 1636424689161, 1636424689613, 452, 0, 452, 0, 0, 0
3789, 1, 1636424689380, 1636424689832, 452, 1, 451, 0, 0, 0
3790, 1, 1636424689484, 1636424689941, 457, 1, 456, 0, 0, 0
3792, 1, 1636424689785, 1636424690236, 451, 0, 451, 0, 0, 0
3791, 1, 1636424689589, 1636424690397, 808, 352, 456, 352, 0, 352
3793, 1, 1636424690236, 1636424690689, 453, 1, 452, 1, 0, 1
3795, 1, 1636424690360, 1636424690813, 453, 0, 453, 0, 0, 0
3796, 1, 1636424691221, 1636424691673, 452, 0, 452, 0, 0, 0
3797, 1, 1636424691289, 1636424691740, 451, 0, 451, 0, 0, 0
3798, 1, 1636424691469, 1636424691921, 452, 0, 452, 0, 0, 0
3799, 1, 1636424691589, 1636424692377, 788, 332, 456, 332, 0, 332
3802, 1, 1636424692324, 1636424692777, 453, 1, 452, 0, 0, 0
3803, 1, 1636424693185, 1636424693637, 452, 0, 452, 0, 0, 0
3804, 1, 1636424693265, 1636424693713, 448, 0, 448, 0, 0, 0
3805, 1, 1636424693501, 1636424693953, 452, 0, 452, 0, 0, 0
3751, 2, 1636424684228, 1636424694229, 10001, 0, 10001, 0, 0, 0
3806, 1, 1636424693661, 1636424694405, 744, 292, 452, 292, 0, 292
3807, 1, 1636424694217, 1636424694673, 456, 0, 456, 0, 0, 0
3758, 2, 1636424684977, 1636424694977, 10000, 0, 10000, 0, 0, 0
3808, 1, 1636424694537, 1636424694988, 451, 0, 451, 0, 0, 0
3759, 2, 1636424685072, 1636424695073, 10001, 0, 10001, 0, 0, 0
3809, 1, 1636424695121, 1636424695573, 452, 0, 452, 0, 0, 0
3810, 1, 1636424695284, 1636424695741, 457, 1, 456, 0, 0, 0
3812, 1, 1636424695389, 1636424695836, 447, 0, 447, 0, 0, 0
3813, 1, 1636424695421, 1636424695868, 447, 0, 447, 0, 0, 0
3811, 1, 1636424695376, 1636424696193, 817, 365, 452, 365, 0, 365
3814, 1, 1636424695628, 1636424696321, 693, 241, 452, 241, 0, 241
3770, 2, 1636424686492, 1636424696493, 10001, 0, 10001, 0, 0, 0
3771, 2, 1636424686500, 1636424696541, 10041, 0, 10041, 0, 0, 0
3815, 1, 1636424696153, 1636424696605, 452, 0, 452, 0, 0, 0
3816, 1, 1636424696585, 1636424697036, 451, 0, 451, 0, 0, 0
3774, 2, 1636424687184, 1636424697185, 10001, 0, 10001, 0, 0, 0
3817, 1, 1636424696804, 1636424697257, 453, 1, 452, 0, 0, 0
3818, 1, 1636424696808, 1636424697273, 465, 1, 464, 0, 0, 0
3777, 2, 1636424687457, 1636424697457, 10000, 0, 10000, 0, 0, 0
3819, 1, 1636424697032, 1636424697500, 468, 1, 467, 0, 0, 0
3820, 1, 1636424697276, 1636424697776, 500, 1, 499, 0, 0, 0
3780, 2, 1636424687785, 1636424697784, 9999, 0, 9999, 0, 0, 0
3822, 1, 1636424697381, 1636424697868, 487, 0, 487, 0, 0, 0
3824, 1, 1636424697504, 1636424697961, 457, 1, 456, 1, 0, 1
3826, 1, 1636424697765, 1636424698213, 448, 0, 448, 0, 0, 0
3821, 1, 1636424697372, 1636424698229, 857, 405, 452, 404, 0, 404
3784, 2, 1636424688389, 1636424698389, 10000, 0, 10000, 0, 0, 0
3785, 2, 1636424688597, 1636424698596, 9999, 0, 9999, 0, 0, 0
3828, 1, 1636424698129, 1636424698612, 483, 0, 483, 0, 0, 0
3827, 1, 1636424698089, 1636424698709, 620, 124, 496, 124, 0, 124
3829, 1, 1636424698552, 1636424699001, 449, 1, 448, 1, 0, 1
3831, 1, 1636424698769, 1636424699212, 443, 0, 443, 0, 0, 0
3832, 1, 1636424698845, 1636424699296, 451, 0, 451, 0, 0, 0
3833, 1, 1636424698904, 1636424699349, 445, 1, 444, 0, 1, 1
3788, 2, 1636424689380, 1636424699380, 10000, 0, 10000, 452, 0, 452
3787, 2, 1636424689380, 1636424699429, 10049, 0, 10049, 452, 0, 452
3834, 1, 1636424699097, 1636424699545, 448, 0, 448, 0, 0, 0
3835, 1, 1636424699308, 1636424699840, 532, 0, 532, 0, 0, 0
3836, 1, 1636424699376, 1636424699841, 465, 1, 464, 0, 0, 0
3838, 1, 1636424699520, 1636424699976, 456, 1, 455, 0, 0, 0
3837, 1, 1636424699476, 1636424700289, 813, 365, 448, 364, 0, 364
3839, 1, 1636424699725, 1636424700289, 564, 116, 448, 116, 0, 116
3794, 2, 1636424690349, 1636424700349, 10000, 0, 10000, 0, 0, 0
3841, 1, 1636424700061, 1636424700508, 447, 0, 447, 0, 0, 0
3842, 1, 1636424700137, 1636424700585, 448, 0, 448, 0, 0, 0
3840, 1, 1636424700020, 1636424700765, 745, 269, 476, 269, 0, 269
3843, 1, 1636424700140, 1636424701032, 892, 446, 446, 444, 0, 444
3846, 1, 1636424700765, 1636424701213, 448, 0, 448, 0, 0, 0
3847, 1, 1636424700876, 1636424701332, 456, 0, 456, 0, 0, 0
3848, 1, 1636424700896, 1636424701344, 448, 0, 448, 0, 0, 0
3845, 1, 1636424700673, 1636424701481, 808, 360, 448, 360, 0, 360
3851, 1, 1636424701365, 1636424701821, 456, 0, 456, 0, 0, 0
3800, 2, 1636424691861, 1636424701861, 10000, 0, 10000, 0, 0, 0
3853, 1, 1636424701492, 1636424701940, 448, 0, 448, 0, 0, 0
3854, 1, 1636424701796, 1636424702264, 468, 1, 467, 0, 0, 0
3801, 1, 1636424692313, 1636424702308, 9995, 9548, 447, 0, 9548, 9548
3856, 1, 1636424702072, 1636424702525, 453, 1, 452, 0, 0, 0
3857, 1, 1636424702113, 1636424702561, 448, 0, 448, 0, 0, 0
3858, 1, 1636424702161, 1636424702605, 444, 0, 444, 0, 0, 0
3855, 1, 1636424702028, 1636424702713, 685, 237, 448, 237, 0, 237
3859, 1, 1636424702125, 1636424703021, 896, 436, 460, 436, 0, 436
3860, 1, 1636424702529, 1636424703052, 523, 76, 447, 76, 0, 76
3863, 1, 1636424702837, 1636424703289, 452, 0, 452, 0, 0, 0
3864, 1, 1636424703021, 1636424703465, 444, 0, 444, 0, 0, 0
3861, 1, 1636424702621, 1636424703468, 847, 400, 447, 400, 0, 400
3865, 1, 1636424703296, 1636424703749, 453, 1, 452, 0, 0, 0
3866, 1, 1636424703569, 1636424704021, 452, 0, 452, 0, 0, 0
3869, 1, 1636424704036, 1636424704492, 456, 0, 456, 0, 0, 0
3872, 1, 1636424704164, 1636424704621, 457, 0, 457, 0, 0, 0
3873, 1, 1636424704597, 1636424705077, 480, 24, 456, 24, 0, 24
3875, 1, 1636424704704, 1636424705157, 453, 1, 452, 0, 0, 0
3877, 1, 1636424705217, 1636424705669, 452, 0, 452, 0, 0, 0
3879, 1, 1636424706073, 1636424706529, 456, 0, 456, 0, 0, 0
3882, 1, 1636424706829, 1636424707280, 451, 0, 451, 0, 0, 0
3823, 2, 1636424697504, 1636424707500, 9996, 0, 9996, 364, 0, 364
3883, 1, 1636424707141, 1636424707592, 451, 0, 451, 0, 0, 0
3825, 2, 1636424697593, 1636424707593, 10000, 0, 10000, 276, 0, 276
3886, 1, 1636424708144, 1636424708585, 441, 0, 441, 0, 0, 0
3884, 1, 1636424708181, 1636424708629, 448, 0, 448, 0, 0, 0
3885, 1, 1636424708181, 1636424708636, 455, 0, 455, 0, 0, 0
3830, 2, 1636424698697, 1636424708697, 10000, 0, 10000, 0, 0, 0
3887, 1, 1636424708744, 1636424709197, 453, 0, 453, 0, 0, 0
3888, 1, 1636424709005, 1636424709457, 452, 0, 452, 0, 0, 0
3889, 1, 1636424709085, 1636424709537, 452, 0, 452, 0, 0, 0
3844, 2, 1636424700484, 1636424710485, 10001, 0, 10001, 0, 0, 0
3890, 1, 1636424710085, 1636424710528, 443, 0, 443, 0, 0, 0
3891, 1, 1636424710117, 1636424710569, 452, 0, 452, 0, 0, 0
3892, 1, 1636424710260, 1636424710709, 449, 1, 448, 0, 1, 1
3849, 2, 1636424701165, 1636424711164, 9999, 0, 9999, 0, 0, 0
3893, 1, 1636424710744, 1636424711196, 452, 0, 452, 0, 0, 0
3894, 1, 1636424710793, 1636424711240, 447, 0, 447, 0, 0, 0
3850, 2, 1636424701253, 1636424711253, 10000, 0, 10000, 0, 0, 0
3852, 2, 1636424701372, 1636424711373, 10001, 0, 10001, 0, 0, 0
3895, 1, 1636424710940, 1636424711384, 444, 0, 444, 0, 0, 0
3896, 1, 1636424710984, 1636424711476, 492, 0, 492, 0, 0, 0
3897, 1, 1636424711548, 1636424712001, 453, 0, 453, 0, 0, 0
3898, 1, 1636424711557, 1636424712004, 447, 0, 447, 0, 0, 0
3900, 1, 1636424711977, 1636424712425, 448, 0, 448, 0, 0, 0
3899, 1, 1636424711677, 1636424712457, 780, 328, 452, 328, 0, 328
3901, 1, 1636424712092, 1636424712545, 453, 1, 452, 0, 0, 0
3902, 1, 1636424712277, 1636424712729, 452, 0, 452, 0, 0, 0
3862, 2, 1636424702832, 1636424712833, 10001, 0, 10001, 1, 0, 1
3903, 1, 1636424712753, 1636424713236, 483, 0, 483, 0, 0, 0
3904, 1, 1636424712880, 1636424713324, 444, 1, 443, 0, 0, 0
3905, 1, 1636424712880, 1636424713328, 448, 1, 447, 1, 0, 1
3906, 1, 1636424713052, 1636424713504, 452, 0, 452, 0, 0, 0
3907, 1, 1636424713136, 1636424713580, 444, 0, 444, 0, 0, 0
3867, 2, 1636424703697, 1636424713697, 10000, 0, 10000, 0, 0, 0
3908, 1, 1636424713493, 1636424713940, 447, 0, 447, 0, 0, 0
3909, 1, 1636424713500, 1636424713953, 453, 1, 452, 0, 0, 0
3868, 2, 1636424704021, 1636424714021, 10000, 0, 10000, 0, 0, 0
3871, 2, 1636424704128, 1636424714128, 10000, 0, 10000, 0, 0, 0
3870, 2, 1636424704128, 1636424714172, 10044, 0, 10044, 1, 0, 1
3910, 1, 1636424713681, 1636424714484, 803, 272, 531, 272, 0, 272
3911, 1, 1636424714005, 1636424714484, 479, 0, 479, 0, 0, 0
3912, 1, 1636424714068, 1636424714581, 513, 0, 513, 0, 0, 0
3913, 1, 1636424714112, 1636424714581, 469, 1, 468, 0, 1, 1
3874, 2, 1636424704689, 1636424714689, 10000, 0, 10000, 0, 0, 0
3876, 2, 1636424704913, 1636424714913, 10000, 0, 10000, 0, 0, 0
3914, 1, 1636424714349, 1636424714932, 583, 136, 447, 136, 0, 136
3917, 1, 1636424714641, 1636424715136, 495, 0, 495, 0, 0, 0
3918, 1, 1636424714732, 1636424715236, 504, 1, 503, 0, 0, 0
3919, 1, 1636424714837, 1636424715320, 483, 0, 483, 0, 0, 0
3878, 1, 1636424705461, 1636424715364, 9903, 9452, 451, 0, 9452, 9452
3921, 1, 1636424715049, 1636424715504, 455, 0, 455, 0, 0, 0
3922, 1, 1636424715080, 1636424715532, 452, 1, 451, 0, 0, 0
3923, 1, 1636424715220, 1636424715673, 453, 1, 452, 0, 0, 0
3924, 1, 1636424715485, 1636424715937, 452, 0, 452, 0, 0, 0
3925, 1, 1636424715492, 1636424715948, 456, 1, 455, 0, 0, 0
3926, 1, 1636424715581, 1636424716133, 552, 92, 460, 92, 0, 92
3880, 2, 1636424706289, 1636424716289, 10000, 0, 10000, 0, 0, 0
3928, 1, 1636424715937, 1636424716384, 447, 0, 447, 0, 0, 0
3927, 1, 1636424715660, 1636424716388, 728, 277, 451, 276, 0, 276
3929, 1, 1636424716021, 1636424716512, 491, 0, 491, 0, 0, 0
3930, 1, 1636424716061, 1636424716516, 455, 0, 455, 0, 0, 0
3881, 1, 1636424706645, 1636424716745, 10100, 9644, 456, 0, 9644, 9644
3931, 1, 1636424716336, 1636424716833, 497, 49, 448, 49, 0, 49
3933, 1, 1636424716649, 1636424717096, 447, 0, 447, 0, 0, 0
3934, 1, 1636424716729, 1636424717180, 451, 0, 451, 0, 0, 0
3935, 1, 1636424716812, 1636424717260, 448, 1, 447, 0, 0, 0
3937, 1, 1636424716968, 1636424717417, 449, 0, 449, 0, 0, 0
3938, 1, 1636424717012, 1636424717465, 453, 0, 453, 0, 0, 0
3939, 1, 1636424717180, 1636424717628, 448, 1, 447, 0, 0, 0
3940, 1, 1636424717400, 1636424717853, 453, 1, 452, 0, 0, 0
3941, 1, 1636424717544, 1636424717992, 448, 1, 447, 0, 0, 0
3942, 1, 1636424717652, 1636424718105, 453, 0, 453, 0, 0, 0
3944, 1, 1636424717821, 1636424718273, 452, 0, 452, 0, 0, 0
3945, 1, 1636424717949, 1636424718393, 444, 0, 444, 0, 0, 0
3946, 1, 1636424717976, 1636424718429, 453, 0, 453, 0, 0, 0
3943, 1, 1636424717741, 1636424718445, 704, 252, 452, 252, 0, 252
3947, 1, 1636424718245, 1636424718728, 483, 28, 455, 28, 0, 28
3948, 1, 1636424718617, 1636424719064, 447, 0, 447, 0, 0, 0
3949, 1, 1636424718724, 1636424719176, 452, 1, 451, 0, 0, 0
3950, 1, 1636424718784, 1636424719232, 448, 1, 447, 0, 0, 0
3951, 1, 1636424719005, 1636424719449, 444, 0, 444, 0, 0, 0
3952, 1, 1636424719028, 1636424719476, 448, 0, 448, 0, 0, 0
3953, 1, 1636424719064, 1636424719516, 452, 0, 452, 0, 0, 0
3954, 1, 1636424719472, 1636424719924, 452, 0, 452, 0, 0, 0
3955, 1, 1636424719541, 1636424719989, 448, 0, 448, 0, 0, 0
3956, 1, 1636424719681, 1636424720133, 452, 0, 452, 0, 0, 0
3959, 1, 1636424719885, 1636424720337, 452, 0, 452, 0, 0, 0
3958, 1, 1636424719885, 1636424720337, 452, 0, 452, 0, 0, 0
3960, 1, 1636424720093, 1636424720544, 451, 0, 451, 0, 0, 0
3957, 1, 1636424719793, 1636424720588, 795, 341, 454, 341, 0, 341
3961, 1, 1636424720357, 1636424720805, 448, 0, 448, 0, 0, 0
3962, 1, 1636424720552, 1636424721004, 452, 1, 451, 0, 0, 0
3963, 1, 1636424720701, 1636424721152, 451, 0, 451, 0, 0, 0
3964, 1, 1636424720717, 1636424721173, 456, 0, 456, 0, 0, 0
3965, 1, 1636424720989, 1636424721441, 452, 0, 452, 0, 0, 0
3966, 1, 1636424721124, 1636424721577, 453, 0, 453, 0, 0, 0
3967, 1, 1636424721164, 1636424721617, 453, 1, 452, 0, 0, 0
3968, 1, 1636424721417, 1636424721869, 452, 0, 452, 0, 0, 0
3969, 1, 1636424721601, 1636424722052, 451, 0, 451, 0, 0, 0
3970, 1, 1636424721660, 1636424722104, 444, 1, 443, 0, 0, 0
3974, 1, 1636424721988, 1636424722429, 441, 0, 441, 0, 0, 0
3973, 1, 1636424721985, 1636424722436, 451, 0, 451, 0, 0, 0
3971, 1, 1636424721773, 1636424722557, 784, 332, 452, 332, 0, 332
3975, 1, 1636424722497, 1636424722948, 451, 0, 451, 0, 0, 0
3976, 1, 1636424722580, 1636424723029, 449, 1, 448, 0, 0, 0
3978, 1, 1636424722748, 1636424723201, 453, 1, 452, 1, 0, 1
3979, 1, 1636424722992, 1636424723444, 452, 0, 452, 0, 0, 0
3980, 1, 1636424723145, 1636424723592, 447, 0, 447, 0, 0, 0
3981, 1, 1636424723261, 1636424723705, 444, 0, 444, 0, 0, 0
3982, 1, 1636424723352, 1636424723808, 456, 1, 455, 0, 1, 1
3983, 1, 1636424723736, 1636424724197, 461, 1, 460, 1, 0, 1
3984, 1, 1636424723753, 1636424724205, 452, 0, 452, 0, 0, 0
3986, 1, 1636424723965, 1636424724421, 456, 0, 456, 0, 0, 0
3916, 2, 1636424714440, 1636424724440, 10000, 0, 10000, 0, 0, 0
3987, 1, 1636424724001, 1636424724448, 447, 0, 447, 0, 0, 0
3915, 2, 1636424714440, 1636424724484, 10044, 0, 10044, 0, 0, 0
3985, 1, 1636424723849, 1636424724704, 855, 356, 499, 356, 0, 356
3988, 1, 1636424724533, 1636424724981, 448, 0, 448, 0, 0, 0
3920, 2, 1636424715004, 1636424725004, 10000, 0, 10000, 0, 0, 0
3989, 1, 1636424724621, 1636424725069, 448, 0, 448, 0, 0, 0
3990, 1, 1636424724653, 1636424725109, 456, 0, 456, 0, 0, 0
3991, 1, 1636424724753, 1636424725229, 476, 0, 476, 0, 0, 0
3993, 1, 1636424725096, 1636424725544, 448, 1, 447, 0, 0, 0
3994, 1, 1636424725144, 1636424725588, 444, 1, 443, 1, 0, 1
3995, 1, 1636424725192, 1636424725637, 445, 1, 444, 1, 0, 1
3992, 1, 1636424724753, 1636424725680, 927, 476, 451, 476, 0, 476
3998, 1, 1636424725660, 1636424726109, 449, 1, 448, 0, 0, 0
3996, 1, 1636424725308, 1636424726133, 825, 373, 452, 373, 0, 373
3999, 1, 1636424725717, 1636424726160, 443, 0, 443, 0, 0, 0
4001, 1, 1636424726072, 1636424726517, 445, 1, 444, 1, 0, 1
4002, 1, 1636424726112, 1636424726560, 448, 0, 448, 0, 0, 0
4000, 1, 1636424725809, 1636424726560, 751, 300, 451, 300, 0, 300
3932, 2, 1636424716597, 1636424726597, 10000, 0, 10000, 0, 0, 0
3936, 2, 1636424716968, 1636424726968, 10000, 0, 10000, 0, 0, 0
4005, 1, 1636424726548, 1636424727005, 457, 0, 457, 0, 0, 0
4004, 1, 1636424726516, 1636424727008, 492, 1, 491, 1, 0, 1
4003, 1, 1636424726493, 1636424727009, 516, 24, 492, 24, 0, 24
4006, 1, 1636424726688, 1636424727141, 453, 1, 452, 0, 1, 1
4008, 1, 1636424726909, 1636424727377, 468, 0, 468, 0, 0, 0
4010, 1, 1636424727109, 1636424727557, 448, 0, 448, 0, 0, 0
4007, 1, 1636424726744, 1636424727597, 853, 397, 456, 397, 0, 397
4013, 1, 1636424727284, 1636424727737, 453, 1, 452, 0, 1, 1
4011, 1, 1636424727280, 1636424727829, 549, 98, 451, 97, 0, 97
4012, 1, 1636424727260, 1636424728041, 781, 337, 444, 336, 0, 336
4014, 1, 1636424727621, 1636424728069, 448, 0, 448, 0, 0, 0
4015, 1, 1636424727716, 1636424728189, 473, 21, 452, 21, 0, 21
4017, 1, 1636424728004, 1636424728453, 449, 0, 449, 0, 0, 0
4016, 1, 1636424727764, 1636424728517, 753, 305, 448, 305, 0, 305
4018, 1, 1636424728068, 1636424728517, 449, 1, 448, 0, 0, 0
4019, 1, 1636424728437, 1636424728905, 468, 16, 452, 16, 0, 16
4020, 1, 1636424728464, 1636424728917, 453, 0, 453, 0, 0, 0
4021, 1, 1636424728580, 1636424729028, 448, 1, 447, 0, 0, 0
4022, 1, 1636424728605, 1636424729052, 447, 0, 447, 0, 0, 0
4024, 1, 1636424728896, 1636424729349, 453, 1, 452, 0, 0, 0
4025, 1, 1636424728984, 1636424729433, 449, 0, 449, 0, 0, 0
4023, 1, 1636424728696, 1636424729505, 809, 357, 452, 357, 0, 357
4027, 1, 1636424729188, 1636424729636, 448, 1, 447, 0, 0, 0
4028, 1, 1636424729293, 1636424729797, 504, 56, 448, 56, 0, 56
4026, 1, 1636424729184, 1636424729961, 777, 321, 456, 320, 0, 320
4029, 1, 1636424729536, 1636424729988, 452, 1, 451, 0, 0, 0
4030, 1, 1636424729600, 1636424730088, 488, 37, 451, 37, 0, 37
4032, 1, 1636424729965, 1636424730416, 451, 0, 451, 0, 0, 0
4031, 1, 1636424729757, 1636424730440, 683, 232, 451, 232, 0, 232
4033, 1, 1636424730124, 1636424730577, 453, 1, 452, 1, 0, 1
4034, 1, 1636424730324, 1636424730869, 545, 93, 452, 92, 0, 92
4035, 1, 1636424730413, 1636424730869, 456, 0, 456, 0, 0, 0
4036, 1, 1636424730657, 1636424731113, 456, 0, 456, 0, 0, 0
4037, 1, 1636424730721, 1636424731172, 451, 0, 451, 0, 0, 0
4039, 1, 1636424730816, 1636424731273, 457, 1, 456, 0, 0, 0
4041, 1, 1636424731152, 1636424731605, 453, 1, 452, 0, 0, 0
4040, 1, 1636424730901, 1636424731625, 724, 272, 452, 272, 0, 272
4042, 1, 1636424731176, 1636424731728, 552, 97, 455, 97, 0, 97
4044, 1, 1636424731485, 1636424731941, 456, 0, 456, 0, 0, 0
3972, 2, 1636424721948, 1636424731945, 9997, 0, 9997, 0, 0, 0
4045, 1, 1636424731553, 1636424732052, 499, 52, 447, 52, 0, 52
4046, 1, 1636424731701, 1636424732384, 683, 240, 443, 240, 0, 240
3977, 2, 1636424722612, 1636424732613, 10001, 0, 10001, 1, 0, 1
4048, 1, 1636424732184, 1636424732641, 457, 1, 456, 0, 0, 0
4049, 1, 1636424732253, 1636424732697, 444, 0, 444, 0, 0, 0
4051, 1, 1636424732340, 1636424732789, 449, 1, 448, 0, 0, 0
3997, 1, 1636424725409, 1636424733073, 7664, 7204, 460, 0, 7204, 7204
4052, 1, 1636424732844, 1636424733296, 452, 1, 451, 0, 0, 0
4053, 1, 1636424732869, 1636424733313, 444, 0, 444, 0, 0, 0
4054, 1, 1636424732921, 1636424733361, 440, 0, 440, 0, 0, 0
4058, 1, 1636424733289, 1636424733813, 524, 72, 452, 72, 0, 72
4059, 1, 1636424733417, 1636424733868, 451, 0, 451, 0, 0, 0
4061, 1, 1636424733641, 1636424734321, 680, 228, 452, 228, 0, 228
4062, 1, 1636424734073, 1636424734521, 448, 0, 448, 0, 0, 0
4063, 1, 1636424734176, 1636424734625, 449, 1, 448, 0, 0, 0
4064, 1, 1636424734296, 1636424734748, 452, 1, 451, 0, 0, 0
4066, 1, 1636424734741, 1636424735193, 452, 0, 452, 0, 0, 0
4065, 1, 1636424734741, 1636424735193, 452, 0, 452, 0, 0, 0
4067, 1, 1636424734860, 1636424735313, 453, 0, 453, 0, 0, 0
4068, 1, 1636424735184, 1636424735649, 465, 10, 455, 10, 0, 10
4069, 1, 1636424735340, 1636424735789, 449, 1, 448, 0, 0, 0
4070, 1, 1636424735561, 1636424736245, 684, 229, 455, 229, 0, 229
4072, 1, 1636424736217, 1636424736669, 452, 0, 452, 0, 0, 0
4073, 1, 1636424736293, 1636424736745, 452, 0, 452, 0, 0, 0
4009, 2, 1636424727060, 1636424737061, 10001, 0, 10001, 0, 0, 0
4074, 1, 1636424736665, 1636424737113, 448, 0, 448, 0, 0, 0
4075, 1, 1636424736781, 1636424737233, 452, 0, 452, 0, 0, 0
4079, 1, 1636424737333, 1636424737781, 448, 0, 448, 0, 0, 0
4078, 1, 1636424737369, 1636424737821, 452, 0, 452, 0, 0, 0
4080, 1, 1636424737477, 1636424738237, 760, 304, 456, 304, 0, 304
4081, 1, 1636424738141, 1636424738593, 452, 0, 452, 0, 0, 0
4082, 1, 1636424738236, 1636424738689, 453, 1, 452, 0, 0, 0
4083, 1, 1636424738696, 1636424739145, 449, 0, 449, 0, 0, 0
4084, 1, 1636424738704, 1636424739161, 457, 0, 457, 0, 0, 0
4085, 1, 1636424739277, 1636424739729, 452, 0, 452, 0, 0, 0
4086, 1, 1636424739341, 1636424739792, 451, 0, 451, 0, 0, 0
4087, 1, 1636424739465, 1636424740185, 720, 265, 455, 264, 1, 265
4088, 1, 1636424740132, 1636424740585, 453, 1, 452, 0, 0, 0
4089, 1, 1636424740253, 1636424740705, 452, 0, 452, 0, 0, 0
4038, 2, 1636424730789, 1636424740789, 10000, 0, 10000, 836, 0, 836
4090, 1, 1636424740677, 1636424741128, 451, 0, 451, 0, 0, 0
4043, 2, 1636424731189, 1636424741185, 9996, 0, 9996, 436, 0, 436
4091, 1, 1636424740729, 1636424741205, 476, 0, 476, 0, 0, 0
4092, 1, 1636424741172, 1636424741624, 452, 1, 451, 0, 0, 0
4093, 1, 1636424741377, 1636424741828, 451, 0, 451, 0, 0, 0
4047, 2, 1636424731881, 1636424741881, 10000, 0, 10000, 0, 0, 0
4094, 1, 1636424741424, 1636424742105, 681, 201, 480, 201, 0, 201
4050, 2, 1636424732320, 1636424742324, 10004, 0, 10004, 0, 0, 0
4096, 1, 1636424741973, 1636424742429, 456, 0, 456, 0, 0, 0
4097, 1, 1636424742188, 1636424742645, 457, 1, 456, 0, 0, 0
4098, 1, 1636424742213, 1636424742669, 456, 0, 456, 0, 0, 0
4099, 1, 1636424742273, 1636424742733, 460, 0, 460, 0, 0, 0
4095, 1, 1636424741973, 1636424742877, 904, 456, 448, 456, 0, 456
4055, 2, 1636424732888, 1636424742888, 10000, 0, 10000, 0, 0, 0
4056, 2, 1636424733065, 1636424743065, 10000, 0, 10000, 0, 0, 0
4101, 1, 1636424742629, 1636424743121, 492, 0, 492, 0, 0, 0
4100, 1, 1636424742629, 1636424743121, 492, 17, 475, 16, 0, 16
4057, 2, 1636424733221, 1636424743221, 10000, 0, 10000, 0, 0, 0
4102, 1, 1636424742812, 1636424743300, 488, 0, 488, 0, 0, 0
4103, 1, 1636424743188, 1636424743641, 453, 1, 452, 0, 0, 0
4060, 1, 1636424733496, 1636424743681, 10185, 9725, 460, 1, 9724, 9725
4104, 1, 1636424743268, 1636424743709, 441, 1, 440, 0, 0, 0
4105, 1, 1636424743268, 1636424743709, 441, 1, 440, 0, 1, 1
4106, 1, 1636424743397, 1636424743844, 447, 0, 447, 0, 0, 0
4108, 1, 1636424743529, 1636424744093, 564, 112, 452, 112, 0, 112
4107, 1, 1636424743460, 1636424744157, 697, 249, 448, 248, 0, 248
4109, 1, 1636424743736, 1636424744188, 452, 1, 451, 0, 0, 0
4111, 1, 1636424743900, 1636424744353, 453, 0, 453, 0, 0, 0
4112, 1, 1636424744073, 1636424744529, 456, 0, 456, 0, 0, 0
4113, 1, 1636424744128, 1636424744584, 456, 1, 455, 0, 0, 0
4114, 1, 1636424744144, 1636424744589, 445, 0, 445, 0, 0, 0
4110, 1, 1636424743844, 1636424744632, 788, 345, 443, 345, 0, 345
4115, 1, 1636424744481, 1636424744988, 507, 48, 459, 48, 0, 48
4116, 1, 1636424744705, 1636424745153, 448, 0, 448, 0, 0, 0
4117, 1, 1636424744753, 1636424745196, 443, 0, 443, 0, 0, 0
4118, 1, 1636424745101, 1636424745561, 460, 0, 460, 0, 0, 0
4119, 1, 1636424745165, 1636424745612, 447, 0, 447, 0, 0, 0
4120, 1, 1636424745168, 1636424745624, 456, 1, 455, 0, 0, 0
4121, 1, 1636424745348, 1636424745796, 448, 1, 447, 0, 0, 0
4122, 1, 1636424745425, 1636424746017, 592, 137, 455, 136, 1, 137
4123, 1, 1636424745445, 1636424746064, 619, 168, 451, 168, 0, 168
4071, 2, 1636424736132, 1636424746133, 10001, 0, 10001, 0, 0, 0
4124, 1, 1636424745740, 1636424746192, 452, 0, 452, 0, 0, 0
4125, 1, 1636424745784, 1636424746236, 452, 1, 451, 0, 0, 0
4127, 1, 1636424746077, 1636424746545, 468, 0, 468, 0, 0, 0
4128, 1, 1636424746124, 1636424746572, 448, 1, 447, 0, 1, 1
4126, 1, 1636424745853, 1636424746688, 835, 384, 451, 384, 0, 384
4076, 2, 1636424736821, 1636424746820, 9999, 0, 9999, 0, 0, 0
4130, 1, 1636424746441, 1636424746892, 451, 0, 451, 0, 0, 0
4129, 1, 1636424746180, 1636424747045, 865, 393, 472, 392, 0, 392
4131, 1, 1636424746517, 1636424747048, 531, 29, 502, 28, 0, 28
4132, 1, 1636424746688, 1636424747132, 444, 1, 443, 0, 1, 1
4077, 2, 1636424737217, 1636424747213, 9996, 0, 9996, 0, 0, 0
4133, 1, 1636424746869, 1636424747308, 439, 0, 439, 0, 0, 0
4136, 1, 1636424747165, 1636424747625, 460, 0, 460, 0, 0, 0
4135, 1, 1636424747149, 1636424747625, 476, 0, 476, 0, 0, 0
4137, 1, 1636424747172, 1636424747625, 453, 0, 453, 0, 0, 0
4134, 1, 1636424747128, 1636424747632, 504, 0, 504, 0, 0, 0
4138, 1, 1636424747385, 1636424747837, 452, 0, 452, 0, 0, 0
4141, 1, 1636424747524, 1636424748072, 548, 109, 439, 108, 1, 109
4140, 1, 1636424747469, 1636424748080, 611, 156, 455, 156, 0, 156
4139, 1, 1636424747408, 1636424748080, 672, 217, 455, 216, 0, 216
4142, 1, 1636424747852, 1636424748309, 457, 1, 456, 0, 0, 0
4143, 1, 1636424747904, 1636424748356, 452, 1, 451, 0, 0, 0
4145, 1, 1636424748009, 1636424748461, 452, 0, 452, 0, 0, 0
4146, 1, 1636424748116, 1636424748573, 457, 1, 456, 0, 1, 1
4148, 1, 1636424748240, 1636424748689, 449, 1, 448, 0, 0, 0
4147, 1, 1636424748240, 1636424748696, 456, 1, 455, 0, 0, 0
4144, 1, 1636424747908, 1636424748813, 905, 449, 456, 449, 0, 449
4149, 1, 1636424748508, 1636424748957, 449, 1, 448, 0, 0, 0
4150, 1, 1636424748640, 1636424749100, 460, 1, 459, 1, 0, 1
4151, 1, 1636424748872, 1636424749321, 449, 1, 448, 0, 0, 0
4152, 1, 1636424748960, 1636424749405, 445, 1, 444, 0, 0, 0
4153, 1, 1636424749041, 1636424749489, 448, 0, 448, 0, 0, 0
4154, 1, 1636424749104, 1636424749552, 448, 1, 447, 0, 0, 0
4155, 1, 1636424749248, 1636424749700, 452, 1, 451, 0, 0, 0
4158, 1, 1636424749413, 1636424749864, 451, 0, 451, 0, 0, 0
4157, 1, 1636424749380, 1636424749941, 561, 109, 452, 108, 0, 108
4159, 1, 1636424749565, 1636424750153, 588, 136, 452, 136, 0, 136
4160, 1, 1636424749725, 1636424750176, 451, 0, 451, 0, 0, 0
4161, 1, 1636424749789, 1636424750237, 448, 0, 448, 0, 0, 0
4163, 1, 1636424749912, 1636424750364, 452, 1, 451, 0, 1, 1
4164, 1, 1636424750052, 1636424750492, 440, 1, 439, 0, 0, 0
4166, 1, 1636424750216, 1636424750664, 448, 1, 447, 0, 0, 0
4162, 1, 1636424749885, 1636424750680, 795, 352, 443, 352, 0, 352
4167, 1, 1636424750404, 1636424750845, 441, 0, 441, 0, 0, 0
4168, 1, 1636424750572, 1636424751024, 452, 1, 451, 0, 0, 0
4169, 1, 1636424750928, 1636424751381, 453, 1, 452, 0, 0, 0
4170, 1, 1636424750945, 1636424751397, 452, 0, 452, 0, 0, 0
4171, 1, 1636424751000, 1636424751448, 448, 0, 448, 0, 0, 0
4172, 1, 1636424751028, 1636424751485, 457, 0, 457, 0, 0, 0
4173, 1, 1636424751132, 1636424751589, 457, 0, 457, 0, 0, 0
4175, 1, 1636424751388, 1636424751845, 457, 9, 448, 8, 0, 8
4174, 1, 1636424751329, 1636424751929, 600, 156, 444, 156, 0, 156
4176, 1, 1636424751488, 1636424752029, 541, 101, 440, 101, 0, 101
4177, 1, 1636424751612, 1636424752065, 453, 0, 453, 0, 0, 0
4178, 1, 1636424751848, 1636424752301, 453, 1, 452, 0, 0, 0
4180, 1, 1636424752025, 1636424752477, 452, 0, 452, 0, 0, 0
4181, 1, 1636424752096, 1636424752541, 445, 1, 444, 0, 0, 0
4182, 1, 1636424752140, 1636424752592, 452, 1, 451, 0, 0, 0
4179, 1, 1636424751949, 1636424752744, 795, 352, 443, 352, 0, 352
4183, 1, 1636424752413, 1636424752932, 519, 64, 455, 64, 0, 64
4184, 1, 1636424752557, 1636424753009, 452, 0, 452, 0, 0, 0
4185, 1, 1636424752837, 1636424753288, 451, 0, 451, 0, 0, 0
4186, 1, 1636424752928, 1636424753373, 445, 1, 444, 0, 0, 0
4187, 1, 1636424753029, 1636424753477, 448, 0, 448, 0, 0, 0
4188, 1, 1636424753080, 1636424753520, 440, 1, 439, 0, 0, 0
4189, 1, 1636424753156, 1636424753601, 445, 1, 444, 0, 0, 0
4190, 1, 1636424753288, 1636424753736, 448, 1, 447, 1, 0, 1
4191, 1, 1636424753424, 1636424753929, 505, 53, 452, 53, 0, 53
4192, 1, 1636424753604, 1636424754053, 449, 1, 448, 0, 0, 0
4193, 1, 1636424753689, 1636424754133, 444, 0, 444, 0, 0, 0
4194, 1, 1636424753893, 1636424754349, 456, 0, 456, 0, 0, 0
4195, 1, 1636424753984, 1636424754433, 449, 1, 448, 1, 0, 1
4197, 1, 1636424754109, 1636424754561, 452, 0, 452, 0, 0, 0
4198, 1, 1636424754253, 1636424754705, 452, 0, 452, 0, 0, 0
4199, 1, 1636424754413, 1636424754864, 451, 0, 451, 0, 0, 0
4196, 1, 1636424754012, 1636424754885, 873, 421, 452, 420, 0, 420
4200, 1, 1636424754597, 1636424755045, 448, 0, 448, 0, 0, 0
4201, 1, 1636424754844, 1636424755301, 457, 1, 456, 0, 0, 0
4202, 1, 1636424754961, 1636424755413, 452, 0, 452, 0, 0, 0
4203, 1, 1636424755045, 1636424755497, 452, 0, 452, 0, 0, 0
4204, 1, 1636424755137, 1636424755585, 448, 0, 448, 0, 0, 0
4205, 1, 1636424755293, 1636424755744, 451, 0, 451, 0, 0, 0
4206, 1, 1636424755300, 1636424755748, 448, 1, 447, 0, 0, 0
4207, 1, 1636424755489, 1636424756036, 547, 97, 450, 96, 0, 96
4208, 1, 1636424755657, 1636424756104, 447, 0, 447, 0, 0, 0
4209, 1, 1636424755744, 1636424756193, 449, 1, 448, 1, 0, 1
4210, 1, 1636424755920, 1636424756373, 453, 1, 452, 0, 0, 0
4211, 1, 1636424755937, 1636424756388, 451, 0, 451, 0, 0, 0
4213, 1, 1636424756068, 1636424756521, 453, 0, 453, 0, 0, 0
4212, 1, 1636424755976, 1636424756821, 845, 397, 448, 397, 0, 397
4215, 1, 1636424756461, 1636424756913, 452, 0, 452, 0, 0, 0
4216, 1, 1636424756704, 1636424757148, 444, 1, 443, 0, 0, 0
4217, 1, 1636424756813, 1636424757268, 455, 0, 455, 0, 0, 0
4220, 1, 1636424757096, 1636424757545, 449, 1, 448, 0, 0, 0
4219, 1, 1636424757092, 1636424757545, 453, 1, 452, 1, 0, 1
4221, 1, 1636424757224, 1636424757676, 452, 0, 452, 0, 0, 0
4222, 1, 1636424757248, 1636424757716, 468, 21, 447, 20, 0, 20
4225, 1, 1636424757673, 1636424758120, 447, 4, 443, 4, 0, 4
4224, 1, 1636424757673, 1636424758120, 447, 0, 447, 0, 0, 0
4226, 1, 1636424757949, 1636424758401, 452, 0, 452, 0, 0, 0
4227, 1, 1636424758053, 1636424758501, 448, 0, 448, 0, 0, 0
4228, 1, 1636424758061, 1636424758857, 796, 340, 456, 340, 0, 340
4229, 1, 1636424758565, 1636424759017, 452, 0, 452, 0, 0, 0
4156, 2, 1636424749260, 1636424759260, 10000, 0, 10000, 0, 0, 0
4231, 1, 1636424759204, 1636424759673, 469, 1, 468, 0, 0, 0
4232, 1, 1636424759216, 1636424759673, 457, 0, 457, 0, 0, 0
4233, 1, 1636424759228, 1636424759673, 445, 0, 445, 0, 0, 0
4234, 1, 1636424759569, 1636424760020, 451, 0, 451, 0, 0, 0
4165, 2, 1636424750116, 1636424760117, 10001, 0, 10001, 0, 0, 0
4235, 1, 1636424759676, 1636424760128, 452, 0, 452, 0, 0, 0
4236, 1, 1636424759785, 1636424760233, 448, 0, 448, 0, 0, 0
4237, 1, 1636424759852, 1636424760345, 493, 1, 492, 0, 0, 0
4238, 1, 1636424760012, 1636424760465, 453, 0, 453, 0, 0, 0
4239, 1, 1636424760016, 1636424760796, 780, 329, 451, 329, 0, 329
4240, 1, 1636424760425, 1636424760877, 452, 0, 452, 0, 0, 0
4241, 1, 1636424760524, 1636424760977, 453, 1, 452, 0, 0, 0
4242, 1, 1636424761121, 1636424761573, 452, 0, 452, 0, 0, 0
4243, 1, 1636424761132, 1636424761588, 456, 1, 455, 0, 0, 0
4244, 1, 1636424761348, 1636424761800, 452, 0, 452, 0, 0, 0
4245, 1, 1636424761485, 1636424761937, 452, 0, 452, 0, 0, 0
4246, 1, 1636424761581, 1636424762033, 452, 8, 444, 8, 0, 8
4247, 1, 1636424761745, 1636424762193, 448, 0, 448, 0, 0, 0
4248, 1, 1636424761808, 1636424762261, 453, 0, 453, 0, 0, 0
4250, 1, 1636424762093, 1636424762541, 448, 0, 448, 0, 0, 0
4249, 1, 1636424761944, 1636424762713, 769, 317, 452, 317, 0, 317
4251, 1, 1636424762340, 1636424762797, 457, 1, 456, 1, 0, 1
4252, 1, 1636424762601, 1636424763057, 456, 0, 456, 0, 0, 0
4253, 1, 1636424762997, 1636424763453, 456, 0, 456, 0, 0, 0
4254, 1, 1636424763177, 1636424763625, 448, 0, 448, 0, 0, 0
4255, 1, 1636424763301, 1636424763760, 459, 0, 459, 0, 0, 0
4256, 1, 1636424763468, 1636424763929, 461, 1, 460, 0, 0, 0
4257, 1, 1636424763540, 1636424763993, 453, 1, 452, 0, 1, 1
4258, 1, 1636424763720, 1636424764173, 453, 1, 452, 0, 0, 0
4259, 1, 1636424763796, 1636424764253, 457, 1, 456, 0, 0, 0
4260, 1, 1636424763865, 1636424764625, 760, 308, 452, 308, 0, 308
4261, 1, 1636424764180, 1636424764641, 461, 0, 461, 0, 0, 0
4262, 1, 1636424764292, 1636424764749, 457, 0, 457, 0, 0, 0
4263, 1, 1636424764692, 1636424765145, 453, 1, 452, 0, 0, 0
4264, 1, 1636424764897, 1636424765349, 452, 0, 452, 0, 0, 0
4265, 1, 1636424765241, 1636424765689, 448, 0, 448, 0, 0, 0
4266, 1, 1636424765329, 1636424765777, 448, 0, 448, 0, 0, 0
4267, 1, 1636424765441, 1636424765909, 468, 0, 468, 0, 0, 0
4214, 2, 1636424756120, 1636424766120, 10000, 0, 10000, 0, 0, 0
4269, 1, 1636424765689, 1636424766141, 452, 0, 452, 0, 0, 0
4268, 1, 1636424765476, 1636424766144, 668, 213, 455, 212, 0, 212
4271, 1, 1636424765893, 1636424766600, 707, 252, 455, 252, 0, 252
4270, 1, 1636424765832, 1636424766600, 768, 309, 459, 309, 0, 309
4272, 1, 1636424766213, 1636424766660, 447, 0, 447, 0, 0, 0
4274, 1, 1636424766433, 1636424766885, 452, 0, 452, 0, 0, 0
4218, 2, 1636424757009, 1636424767008, 9999, 0, 9999, 0, 0, 0
4273, 1, 1636424766369, 1636424767052, 683, 232, 451, 231, 1, 232
4275, 1, 1636424766685, 1636424767137, 452, 0, 452, 0, 0, 0
4276, 1, 1636424766845, 1636424767324, 479, 0, 479, 0, 0, 0
4223, 2, 1636424757469, 1636424767468, 9999, 0, 9999, 0, 0, 0
4277, 1, 1636424767208, 1636424767700, 492, 1, 491, 0, 1, 1
4278, 1, 1636424767309, 1636424767785, 476, 0, 476, 0, 0, 0
4279, 1, 1636424767345, 1636424767785, 440, 0, 440, 0, 0, 0
4280, 1, 1636424767401, 1636424767885, 484, 0, 484, 0, 0, 0
4281, 1, 1636424767424, 1636424767888, 464, 0, 464, 0, 0, 0
4282, 1, 1636424767684, 1636424768137, 453, 1, 452, 0, 0, 0
4283, 1, 1636424767773, 1636424768249, 476, 13, 463, 12, 1, 13
4285, 1, 1636424767825, 1636424768273, 448, 0, 448, 0, 0, 0
4230, 2, 1636424758572, 1636424768573, 10001, 0, 10001, 0, 0, 0
4284, 1, 1636424767744, 1636424768589, 845, 393, 452, 393, 0, 393
4286, 1, 1636424768217, 1636424768668, 451, 0, 451, 0, 0, 0
4287, 1, 1636424768280, 1636424768733, 453, 1, 452, 0, 0, 0
4288, 1, 1636424768425, 1636424768893, 468, 0, 468, 0, 0, 0
4289, 1, 1636424768717, 1636424769169, 452, 0, 452, 0, 0, 0
4290, 1, 1636424768725, 1636424769181, 456, 0, 456, 0, 0, 0
4291, 1, 1636424768881, 1636424769332, 451, 0, 451, 0, 0, 0
4292, 1, 1636424769237, 1636424769684, 447, 0, 447, 0, 0, 0
4293, 1, 1636424769248, 1636424769697, 449, 1, 448, 1, 0, 1
4294, 1, 1636424769361, 1636424769813, 452, 0, 452, 0, 0, 0
4295, 1, 1636424769376, 1636424769824, 448, 1, 447, 0, 0, 0
4296, 1, 1636424769500, 1636424769949, 449, 0, 449, 0, 0, 0
4297, 1, 1636424769600, 1636424770053, 453, 0, 453, 0, 0, 0
4298, 1, 1636424769696, 1636424770145, 449, 1, 448, 1, 0, 1
4300, 1, 1636424769864, 1636424770317, 453, 1, 452, 0, 0, 0
4299, 1, 1636424769696, 1636424770509, 813, 357, 456, 356, 0, 356
4301, 1, 1636424770144, 1636424770592, 448, 1, 447, 0, 0, 0
4302, 1, 1636424770284, 1636424770728, 444, 1, 443, 0, 1, 1
4303, 1, 1636424770537, 1636424770985, 448, 0, 448, 0, 0, 0
4304, 1, 1636424770641, 1636424771093, 452, 0, 452, 0, 0, 0
4305, 1, 1636424770720, 1636424771169, 449, 0, 449, 0, 0, 0
4306, 1, 1636424770853, 1636424771309, 456, 0, 456, 0, 0, 0
4307, 1, 1636424771172, 1636424771621, 449, 1, 448, 0, 0, 0
4308, 1, 1636424771280, 1636424771732, 452, 1, 451, 0, 0, 0
4309, 1, 1636424771281, 1636424771732, 451, 0, 451, 0, 0, 0
4310, 1, 1636424771360, 1636424771804, 444, 1, 443, 0, 0, 0
4311, 1, 1636424771396, 1636424771845, 449, 1, 448, 0, 0, 0
4312, 1, 1636424771529, 1636424771985, 456, 0, 456, 0, 0, 0
4314, 1, 1636424771793, 1636424772245, 452, 0, 452, 0, 0, 0
4315, 1, 1636424771816, 1636424772269, 453, 1, 452, 1, 0, 1
4313, 1, 1636424771637, 1636424772437, 800, 349, 451, 348, 0, 348
4316, 1, 1636424772252, 1636424772701, 449, 1, 448, 0, 0, 0
4317, 1, 1636424772281, 1636424772733, 452, 0, 452, 0, 0, 0
4319, 1, 1636424772633, 1636424773085, 452, 0, 452, 0, 0, 0
4318, 1, 1636424772536, 1636424773157, 621, 166, 455, 164, 0, 164
4321, 1, 1636424772889, 1636424773340, 451, 0, 451, 0, 0, 0
4320, 1, 1636424772833, 1636424773596, 763, 324, 439, 324, 0, 324
4322, 1, 1636424773165, 1636424773604, 439, 0, 439, 0, 0, 0
4323, 1, 1636424773200, 1636424773640, 440, 1, 439, 0, 1, 1
4326, 1, 1636424773468, 1636424773917, 449, 0, 449, 0, 0, 0
4327, 1, 1636424773500, 1636424773953, 453, 0, 453, 0, 0, 0
4328, 1, 1636424773604, 1636424774409, 805, 349, 456, 349, 0, 349
4331, 1, 1636424774372, 1636424774825, 453, 0, 453, 0, 0, 0
4332, 1, 1636424774409, 1636424774856, 447, 0, 447, 0, 0, 0
4333, 1, 1636424774576, 1636424775029, 453, 1, 452, 0, 0, 0
4334, 1, 1636424774589, 1636424775045, 456, 0, 456, 0, 0, 0
4335, 1, 1636424774876, 1636424775329, 453, 1, 452, 0, 0, 0
4337, 1, 1636424775081, 1636424775533, 452, 0, 452, 0, 0, 0
4338, 1, 1636424775200, 1636424775653, 453, 1, 452, 0, 0, 0
4339, 1, 1636424775401, 1636424775857, 456, 0, 456, 0, 0, 0
4341, 1, 1636424775544, 1636424775997, 453, 1, 452, 0, 0, 0
4340, 1, 1636424775508, 1636424776309, 801, 349, 452, 349, 0, 349
4343, 1, 1636424776477, 1636424776929, 452, 0, 452, 0, 0, 0
4344, 1, 1636424776485, 1636424776936, 451, 0, 451, 0, 0, 0
4345, 1, 1636424776717, 1636424777169, 452, 0, 452, 0, 0, 0
4347, 1, 1636424777080, 1636424777532, 452, 1, 451, 0, 0, 0
4348, 1, 1636424777104, 1636424777552, 448, 1, 447, 1, 0, 1
4349, 1, 1636424777476, 1636424777928, 452, 1, 451, 0, 0, 0
4350, 1, 1636424777505, 1636424777956, 451, 0, 451, 0, 0, 0
4351, 1, 1636424777584, 1636424778385, 801, 345, 456, 345, 0, 345
4352, 1, 1636424778445, 1636424778901, 456, 0, 456, 0, 0, 0
4353, 1, 1636424778545, 1636424778997, 452, 0, 452, 0, 0, 0
4355, 1, 1636424779141, 1636424779597, 456, 0, 456, 0, 0, 0
4356, 1, 1636424779169, 1636424779617, 448, 0, 448, 0, 0, 0
4357, 1, 1636424779357, 1636424779813, 456, 0, 456, 0, 0, 0
4358, 1, 1636424779429, 1636424779881, 452, 0, 452, 0, 0, 0
4359, 1, 1636424779541, 1636424780264, 723, 272, 451, 272, 0, 272
4360, 1, 1636424780340, 1636424780785, 445, 1, 444, 0, 1, 1
4361, 1, 1636424780429, 1636424780873, 444, 0, 444, 0, 0, 0
4362, 1, 1636424781032, 1636424781488, 456, 1, 455, 0, 1, 1
4363, 1, 1636424781052, 1636424781505, 453, 0, 453, 0, 0, 0
4364, 1, 1636424781341, 1636424781793, 452, 0, 452, 0, 0, 0
4365, 1, 1636424781357, 1636424781805, 448, 0, 448, 0, 0, 0
4366, 1, 1636424781437, 1636424782252, 815, 368, 447, 368, 0, 368
4367, 1, 1636424782252, 1636424782701, 449, 0, 449, 0, 0, 0
4368, 1, 1636424782381, 1636424782833, 452, 0, 452, 0, 0, 0
4324, 2, 1636424773285, 1636424783285, 10000, 0, 10000, 312, 0, 312
4325, 2, 1636424773360, 1636424783361, 10001, 0, 10001, 236, 0, 236
4369, 1, 1636424783001, 1636424783452, 451, 0, 451, 0, 0, 0
4370, 1, 1636424783048, 1636424783509, 461, 1, 460, 1, 0, 1
4329, 2, 1636424773684, 1636424783684, 10000, 0, 10000, 0, 0, 0
4371, 1, 1636424783332, 1636424783777, 445, 1, 444, 0, 0, 0
4330, 2, 1636424773836, 1636424783837, 10001, 0, 10001, 0, 0, 0
4372, 1, 1636424783408, 1636424783856, 448, 0, 448, 0, 0, 0
4373, 1, 1636424783452, 1636424784301, 849, 405, 444, 405, 0, 405
4375, 1, 1636424783956, 1636424784405, 449, 0, 449, 0, 0, 0
4374, 1, 1636424783948, 1636424784408, 460, 1, 459, 0, 0, 0
4378, 1, 1636424784229, 1636424784676, 447, 0, 447, 0, 0, 0
4379, 1, 1636424784373, 1636424784825, 452, 0, 452, 0, 0, 0
4376, 1, 1636424784012, 1636424784857, 845, 397, 448, 397, 0, 397
4377, 1, 1636424784145, 1636424784860, 715, 260, 455, 260, 0, 260
4336, 2, 1636424774888, 1636424784889, 10001, 0, 10001, 1, 0, 1
4380, 1, 1636424784981, 1636424785437, 456, 0, 456, 0, 0, 0
4381, 1, 1636424785117, 1636424785565, 448, 0, 448, 0, 0, 0
4382, 1, 1636424785192, 1636424785637, 445, 0, 445, 0, 0, 0
4383, 1, 1636424785236, 1636424785680, 444, 0, 444, 0, 0, 0
4384, 1, 1636424785308, 1636424785761, 453, 0, 453, 0, 0, 0
4385, 1, 1636424785360, 1636424786132, 772, 321, 451, 321, 0, 321
4386, 1, 1636424785756, 1636424786209, 453, 1, 452, 0, 0, 0
4342, 2, 1636424776236, 1636424786237, 10001, 0, 10001, 0, 0, 0
4387, 1, 1636424785824, 1636424786273, 449, 1, 448, 0, 0, 0
4390, 1, 1636424786109, 1636424786556, 447, 0, 447, 0, 0, 0
4389, 1, 1636424786009, 1636424786656, 647, 200, 447, 200, 0, 200
4346, 1, 1636424776744, 1636424786688, 9944, 9493, 451, 0, 9492, 9492
4388, 1, 1636424785836, 1636424786724, 888, 437, 451, 437, 0, 437
4391, 1, 1636424786373, 1636424786812, 439, 0, 439, 0, 0, 0
4392, 1, 1636424786545, 1636424786993, 448, 0, 448, 0, 0, 0
4394, 1, 1636424786917, 1636424787368, 451, 0, 451, 0, 0, 0
4393, 1, 1636424786901, 1636424787449, 548, 92, 456, 92, 0, 92
4395, 1, 1636424787028, 1636424787473, 445, 1, 444, 0, 0, 0
4396, 1, 1636424787061, 1636424787513, 452, 0, 452, 0, 0, 0
4397, 1, 1636424787324, 1636424787777, 453, 0, 453, 0, 0, 0
4399, 1, 1636424787681, 1636424788132, 451, 0, 451, 0, 0, 0
4398, 1, 1636424787392, 1636424788233, 841, 386, 455, 384, 1, 385
4400, 1, 1636424787868, 1636424788312, 444, 0, 444, 0, 0, 0
4401, 1, 1636424787912, 1636424788588, 676, 221, 455, 221, 0, 221
4354, 2, 1636424778592, 1636424788593, 10001, 0, 10001, 0, 0, 0
4402, 1, 1636424787940, 1636424788761, 821, 373, 448, 373, 0, 373
4403, 1, 1636424788356, 1636424788821, 465, 1, 464, 0, 0, 0
4404, 1, 1636424788432, 1636424789213, 781, 329, 452, 329, 0, 329
4406, 1, 1636424788901, 1636424789357, 456, 0, 456, 0, 0, 0
4407, 1, 1636424788961, 1636424789413, 452, 0, 452, 0, 0, 0
4408, 1, 1636424788977, 1636424789433, 456, 0, 456, 0, 0, 0
4411, 1, 1636424789436, 1636424789892, 456, 0, 456, 0, 0, 0
4410, 1, 1636424789440, 1636424790340, 900, 453, 447, 453, 0, 453
4414, 1, 1636424789936, 1636424790389, 453, 1, 452, 0, 0, 0
4415, 1, 1636424789988, 1636424790841, 853, 401, 452, 400, 0, 400
4416, 1, 1636424790452, 1636424790905, 453, 1, 452, 0, 0, 0
4419, 1, 1636424790937, 1636424791389, 452, 0, 452, 0, 0, 0
4420, 1, 1636424791021, 1636424791473, 452, 0, 452, 0, 0, 0
4423, 1, 1636424791993, 1636424792449, 456, 0, 456, 0, 0, 0
4424, 1, 1636424792069, 1636424792901, 832, 380, 452, 380, 0, 380
4426, 1, 1636424792885, 1636424793337, 452, 0, 452, 0, 0, 0
4428, 1, 1636424793949, 1636424794401, 452, 0, 452, 0, 0, 0
4429, 1, 1636424794000, 1636424794861, 861, 401, 460, 400, 0, 400
4430, 1, 1636424794912, 1636424795365, 453, 1, 452, 0, 0, 0
4431, 1, 1636424796021, 1636424796473, 452, 0, 452, 0, 0, 0
4432, 1, 1636424796081, 1636424796929, 848, 393, 455, 392, 1, 393
4433, 1, 1636424796781, 1636424797233, 452, 0, 452, 0, 0, 0
4434, 1, 1636424797985, 1636424798437, 452, 0, 452, 0, 0, 0
4405, 2, 1636424788780, 1636424798781, 10001, 0, 10001, 432, 0, 432
4435, 1, 1636424798001, 1636424798896, 895, 436, 459, 436, 0, 436
4409, 2, 1636424789141, 1636424799141, 10000, 0, 10000, 72, 0, 72
4436, 1, 1636424798829, 1636424799281, 452, 0, 452, 0, 0, 0
4412, 2, 1636424789613, 1636424799608, 9995, 0, 9995, 0, 0, 0
4413, 2, 1636424789841, 1636424799841, 10000, 0, 10000, 0, 0, 0
4437, 1, 1636424799521, 1636424799968, 447, 0, 447, 0, 0, 0
4438, 1, 1636424799521, 1636424800012, 491, 0, 491, 0, 0, 0
4439, 1, 1636424799933, 1636424800465, 532, 80, 452, 80, 0, 80
4417, 2, 1636424790473, 1636424800472, 9999, 0, 9999, 0, 0, 0
4440, 1, 1636424800045, 1636424800496, 451, 0, 451, 0, 0, 0
4418, 1, 1636424790909, 1636424800917, 10008, 9564, 444, 0, 9564, 9564
4441, 1, 1636424800148, 1636424800917, 769, 317, 452, 317, 0, 317
4442, 1, 1636424800108, 1636424800953, 845, 389, 456, 387, 1, 388
4443, 1, 1636424800733, 1636424801184, 451, 0, 451, 0, 0, 0
4444, 1, 1636424800780, 1636424801225, 445, 1, 444, 0, 0, 0
4421, 2, 1636424791365, 1636424801365, 10000, 0, 10000, 0, 0, 0
4422, 2, 1636424791376, 1636424801413, 10037, 0, 10037, 0, 0, 0
4445, 1, 1636424801137, 1636424801592, 455, 0, 455, 0, 0, 0
4447, 1, 1636424801461, 1636424801913, 452, 0, 452, 0, 0, 0
4446, 1, 1636424801456, 1636424801913, 457, 1, 456, 1, 0, 1
4449, 1, 1636424801681, 1636424802129, 448, 0, 448, 0, 0, 0
4450, 1, 1636424801821, 1636424802365, 544, 93, 451, 93, 0, 93
4451, 1, 1636424801945, 1636424802389, 444, 0, 444, 0, 0, 0
4425, 2, 1636424792392, 1636424802392, 10000, 0, 10000, 0, 0, 0
4448, 1, 1636424801681, 1636424802617, 936, 449, 487, 448, 1, 449
4452, 1, 1636424802004, 1636424802817, 813, 361, 452, 361, 0, 361
4453, 1, 1636424802037, 1636424802837, 800, 352, 448, 352, 0, 352
4427, 2, 1636424792889, 1636424802888, 9999, 0, 9999, 0, 0, 0
4454, 1, 1636424802692, 1636424803140, 448, 1, 447, 0, 0, 0
4455, 1, 1636424802705, 1636424803152, 447, 0, 447, 0, 0, 0
4456, 1, 1636424802809, 1636424803297, 488, 0, 488, 0, 0, 0
4457, 1, 1636424803024, 1636424803477, 453, 0, 453, 0, 0, 0
4458, 1, 1636424803197, 1636424803645, 448, 0, 448, 0, 0, 0
4459, 1, 1636424803397, 1636424803849, 452, 0, 452, 0, 0, 0
4460, 1, 1636424803561, 1636424804012, 451, 0, 451, 0, 0, 0
4461, 1, 1636424803656, 1636424804109, 453, 1, 452, 0, 0, 0
4463, 1, 1636424803825, 1636424804305, 480, 24, 456, 24, 0, 24
4464, 1, 1636424804008, 1636424804461, 453, 1, 452, 0, 0, 0
4462, 1, 1636424803668, 1636424804565, 897, 442, 455, 440, 0, 440
4466, 1, 1636424804096, 1636424804765, 669, 210, 459, 209, 0, 209
4465, 1, 1636424804037, 1636424804921, 884, 424, 460, 424, 0, 424
4467, 1, 1636424804685, 1636424805137, 452, 0, 452, 0, 0, 0
4468, 1, 1636424804812, 1636424805265, 453, 1, 452, 0, 0, 0
4469, 1, 1636424804929, 1636424805381, 452, 0, 452, 0, 0, 0
4470, 1, 1636424805120, 1636424805565, 445, 0, 445, 0, 0, 0
4471, 1, 1636424805164, 1636424805613, 449, 1, 448, 0, 0, 0
4472, 1, 1636424805493, 1636424805945, 452, 0, 452, 0, 0, 0
4473, 1, 1636424805505, 1636424805956, 451, 0, 451, 0, 0, 0
4474, 1, 1636424805692, 1636424806149, 457, 1, 456, 0, 0, 0
4476, 1, 1636424805937, 1636424806413, 476, 20, 456, 20, 0, 20
4477, 1, 1636424806088, 1636424806541, 453, 1, 452, 0, 0, 0
4475, 1, 1636424805725, 1636424806601, 876, 424, 452, 424, 0, 424
4479, 1, 1636424806121, 1636424806861, 740, 292, 448, 292, 0, 292
4478, 1, 1636424806109, 1636424806993, 884, 433, 451, 432, 0, 432
4480, 1, 1636424806720, 1636424807173, 453, 1, 452, 0, 0, 0
4481, 1, 1636424806745, 1636424807197, 452, 0, 452, 0, 0, 0
4482, 1, 1636424806893, 1636424807341, 448, 0, 448, 0, 0, 0
4483, 1, 1636424807229, 1636424807681, 452, 0, 452, 0, 0, 0
4484, 1, 1636424807280, 1636424807736, 456, 1, 455, 0, 1, 1
4486, 1, 1636424807432, 1636424807881, 449, 1, 448, 0, 0, 0
4487, 1, 1636424807557, 1636424808008, 451, 0, 451, 0, 0, 0
4485, 1, 1636424807421, 1636424808189, 768, 315, 453, 315, 0, 315
4489, 1, 1636424807813, 1636424808337, 524, 68, 456, 68, 0, 68
4488, 1, 1636424807637, 1636424808461, 824, 372, 452, 372, 0, 372
4491, 1, 1636424808040, 1636424808489, 449, 1, 448, 1, 0, 1
4490, 1, 1636424808037, 1636424808788, 751, 300, 451, 300, 0, 300
4492, 1, 1636424808052, 1636424808941, 889, 437, 452, 437, 0, 437
4493, 1, 1636424808673, 1636424809124, 451, 0, 451, 0, 0, 0
4494, 1, 1636424808720, 1636424809169, 449, 1, 448, 0, 0, 0
4495, 1, 1636424808809, 1636424809261, 452, 0, 452, 0, 0, 0
4496, 1, 1636424809156, 1636424809604, 448, 1, 447, 0, 0, 0
4497, 1, 1636424809285, 1636424809732, 447, 0, 447, 0, 0, 0
4498, 1, 1636424809361, 1636424809813, 452, 0, 452, 0, 0, 0
4499, 1, 1636424809521, 1636424809976, 455, 0, 455, 0, 0, 0
4500, 1, 1636424809601, 1636424810049, 448, 0, 448, 0, 0, 0
4502, 1, 1636424809740, 1636424810257, 517, 73, 444, 73, 0, 73
4503, 1, 1636424809964, 1636424810409, 445, 1, 444, 0, 1, 1
4501, 1, 1636424809717, 1636424810497, 780, 333, 447, 332, 1, 333
4505, 1, 1636424809988, 1636424810713, 725, 270, 455, 268, 0, 268
4504, 1, 1636424809980, 1636424810848, 868, 429, 439, 429, 0, 429
4507, 1, 1636424810724, 1636424811173, 449, 1, 448, 0, 0, 0
4506, 1, 1636424810724, 1636424811176, 452, 1, 451, 0, 0, 0
4508, 1, 1636424810760, 1636424811209, 449, 0, 449, 0, 0, 0
4509, 1, 1636424811085, 1636424811537, 452, 0, 452, 0, 0, 0
4510, 1, 1636424811333, 1636424811777, 444, 0, 444, 0, 0, 0
4512, 1, 1636424811417, 1636424811869, 452, 0, 452, 0, 0, 0
4511, 1, 1636424811413, 1636424811869, 456, 0, 456, 0, 0, 0
4513, 1, 1636424811637, 1636424812089, 452, 0, 452, 0, 0, 0
4515, 1, 1636424811748, 1636424812316, 568, 121, 447, 121, 0, 121
4516, 1, 1636424811880, 1636424812329, 449, 0, 449, 0, 0, 0
4514, 1, 1636424811733, 1636424812540, 807, 356, 451, 356, 0, 356
4518, 1, 1636424812037, 1636424812769, 732, 280, 452, 280, 0, 280
4517, 1, 1636424811973, 1636424812785, 812, 356, 456, 356, 0, 356
4519, 1, 1636424812673, 1636424813121, 448, 0, 448, 0, 0, 0
4520, 1, 1636424812796, 1636424813249, 453, 1, 452, 0, 0, 0
4521, 1, 1636424813141, 1636424813596, 455, 0, 455, 0, 0, 0
4522, 1, 1636424813292, 1636424813744, 452, 1, 451, 0, 1, 1
4524, 1, 1636424813365, 1636424813813, 448, 0, 448, 0, 0, 0
4523, 1, 1636424813365, 1636424813813, 448, 0, 448, 0, 0, 0
4525, 1, 1636424813637, 1636424814269, 632, 177, 455, 177, 0, 177
4528, 1, 1636424814029, 1636424814725, 696, 240, 456, 240, 0, 240
4529, 1, 1636424814609, 1636424815061, 452, 0, 452, 0, 0, 0
4531, 1, 1636424815028, 1636424815485, 457, 1, 456, 0, 1, 1
4532, 1, 1636424815245, 1636424815701, 456, 0, 456, 0, 0, 0
4533, 1, 1636424815352, 1636424815801, 449, 1, 448, 0, 0, 0
4535, 1, 1636424815552, 1636424816161, 609, 150, 459, 148, 0, 148
4536, 1, 1636424816017, 1636424816617, 600, 145, 455, 144, 0, 144
4537, 1, 1636424816665, 1636424817117, 452, 0, 452, 0, 0, 0
4538, 1, 1636424816917, 1636424817369, 452, 0, 452, 0, 0, 0
4539, 1, 1636424817301, 1636424817753, 452, 0, 452, 0, 0, 0
4540, 1, 1636424817424, 1636424817877, 453, 1, 452, 0, 0, 0
4541, 1, 1636424817665, 1636424818205, 540, 88, 452, 88, 0, 88
4542, 1, 1636424818049, 1636424818664, 615, 157, 458, 156, 1, 157
4543, 1, 1636424818708, 1636424819161, 453, 1, 452, 0, 0, 0
4544, 1, 1636424818969, 1636424819420, 451, 0, 451, 0, 0, 0
4545, 1, 1636424819373, 1636424819821, 448, 0, 448, 0, 0, 0
4546, 1, 1636424819465, 1636424819917, 452, 0, 452, 0, 0, 0
4547, 1, 1636424819760, 1636424820265, 505, 61, 444, 61, 0, 61
4548, 1, 1636424820101, 1636424820721, 620, 165, 455, 164, 1, 165
4549, 1, 1636424820792, 1636424821245, 453, 1, 452, 0, 0, 0
4550, 1, 1636424821041, 1636424821488, 447, 0, 447, 0, 0, 0
4551, 1, 1636424821345, 1636424821801, 456, 0, 456, 0, 0, 0
4552, 1, 1636424821413, 1636424821865, 452, 0, 452, 0, 0, 0
4553, 1, 1636424821881, 1636424822333, 452, 0, 452, 0, 0, 0
4554, 1, 1636424822221, 1636424822785, 564, 112, 452, 112, 0, 112
4555, 1, 1636424822685, 1636424823141, 456, 0, 456, 0, 0, 0
4556, 1, 1636424823081, 1636424823533, 452, 0, 452, 0, 0, 0
4526, 2, 1636424813637, 1636424823637, 10000, 0, 10000, 0, 0, 0
4527, 2, 1636424813644, 1636424823680, 10036, 0, 10036, 0, 0, 0
4557, 1, 1636424823293, 1636424823740, 447, 0, 447, 0, 0, 0
4558, 1, 1636424823773, 1636424824225, 452, 0, 452, 0, 0, 0
4559, 1, 1636424823944, 1636424824397, 453, 0, 453, 0, 0, 0
4561, 1, 1636424824097, 1636424824685, 588, 129, 459, 128, 0, 128
4530, 2, 1636424814797, 1636424824797, 10000, 0, 10000, 0, 0, 0
4560, 1, 1636424823948, 1636424824852, 904, 449, 455, 448, 0, 448
4534, 2, 1636424815365, 1636424825364, 9999, 0, 9999, 0, 0, 0
4562, 1, 1636424824956, 1636424825408, 452, 1, 451, 0, 0, 0
4563, 1, 1636424825101, 1636424825593, 492, 0, 492, 0, 0, 0
4564, 1, 1636424825673, 1636424826125, 452, 0, 452, 0, 0, 0
4565, 1, 1636424825864, 1636424826317, 453, 1, 452, 0, 1, 1
4566, 1, 1636424825920, 1636424826773, 853, 398, 455, 398, 0, 398
4567, 1, 1636424827057, 1636424827513, 456, 0, 456, 0, 0, 0
4568, 1, 1636424827705, 1636424828157, 452, 0, 452, 0, 0, 0
4569, 1, 1636424827813, 1636424828265, 452, 0, 452, 0, 0, 0
4570, 1, 1636424827921, 1636424828721, 800, 344, 456, 344, 0, 344
4571, 1, 1636424829009, 1636424829461, 452, 0, 452, 0, 0, 0
4572, 1, 1636424829657, 1636424830109, 452, 0, 452, 0, 0, 0
4573, 1, 1636424829841, 1636424830288, 447, 0, 447, 0, 0, 0
4574, 1, 1636424829997, 1636424830737, 740, 292, 448, 292, 0, 292
4575, 1, 1636424831085, 1636424831537, 452, 0, 452, 0, 0, 0
4576, 1, 1636424831685, 1636424832133, 448, 0, 448, 0, 0, 0
4577, 1, 1636424831805, 1636424832257, 452, 0, 452, 0, 0, 0
4578, 1, 1636424831961, 1636424832713, 752, 297, 455, 296, 0, 296
4579, 1, 1636424832953, 1636424833405, 452, 0, 452, 0, 0, 0
4580, 1, 1636424833553, 1636424834004, 451, 0, 451, 0, 0, 0
4581, 1, 1636424833813, 1636424834261, 448, 0, 448, 0, 0, 0
4582, 1, 1636424834033, 1636424834717, 684, 229, 455, 228, 0, 228
4583, 1, 1636424835077, 1636424835529, 452, 0, 452, 0, 0, 0
4584, 1, 1636424835677, 1636424836125, 448, 0, 448, 0, 0, 0
4585, 1, 1636424835709, 1636424836157, 448, 0, 448, 0, 0, 0
4586, 1, 1636424836008, 1636424836612, 604, 149, 455, 149, 0, 149
4587, 1, 1636424836973, 1636424837425, 452, 0, 452, 0, 0, 0
4588, 1, 1636424837573, 1636424838025, 452, 0, 452, 0, 0, 0
4589, 1, 1636424837781, 1636424838233, 452, 0, 452, 0, 0, 0
4590, 1, 1636424838125, 1636424838692, 567, 109, 458, 109, 0, 109
4591, 1, 1636424839049, 1636424839501, 452, 0, 452, 0, 0, 0
4592, 1, 1636424839649, 1636424840101, 452, 0, 452, 0, 0, 0
4593, 1, 1636424839889, 1636424840341, 452, 0, 452, 0, 0, 0
4594, 1, 1636424840137, 1636424840797, 660, 205, 455, 204, 1, 205
4595, 1, 1636424841157, 1636424841613, 456, 0, 456, 0, 0, 0
4596, 1, 1636424841725, 1636424842177, 452, 0, 452, 0, 0, 0
4597, 1, 1636424841853, 1636424842305, 452, 0, 452, 0, 0, 0
4598, 1, 1636424842069, 1636424842757, 688, 236, 452, 236, 0, 236
4599, 1, 1636424843149, 1636424843601, 452, 0, 452, 0, 0, 0
4600, 1, 1636424843717, 1636424844169, 452, 0, 452, 0, 0, 0
4601, 2, 1636425034081, 1636425044081, 10000, 0, 10000, 0, 0, 0
4602, 2, 1636425034793, 1636425044793, 10000, 0, 10000, 0, 0, 0
4617, 1, 1636425044389, 1636425044844, 455, 0, 455, 0, 0, 0
4603, 2, 1636425035396, 1636425045397, 10001, 0, 10001, 0, 0, 0
4619, 1, 1636425045101, 1636425045553, 452, 0, 452, 0, 0, 0
4604, 2, 1636425035945, 1636425045945, 10000, 0, 10000, 0, 0, 0
4621, 1, 1636425045705, 1636425046169, 464, 0, 464, 0, 0, 0
4605, 2, 1636425036501, 1636425046501, 10000, 0, 10000, 0, 0, 0
4623, 1, 1636425046253, 1636425046729, 476, 0, 476, 0, 0, 0
4606, 2, 1636425037053, 1636425047053, 10000, 0, 10000, 0, 0, 0
4624, 1, 1636425046808, 1636425047281, 473, 1, 472, 0, 0, 0
4607, 2, 1636425037633, 1636425047633, 10000, 0, 10000, 0, 0, 0
4625, 1, 1636425047361, 1636425047861, 500, 0, 500, 0, 0, 0
4608, 2, 1636425038225, 1636425048225, 10000, 0, 10000, 0, 0, 0
4626, 1, 1636425047945, 1636425048400, 455, 0, 455, 0, 0, 0
4627, 1, 1636425048104, 1636425048556, 452, 1, 451, 0, 0, 0
4609, 2, 1636425038801, 1636425048801, 10000, 0, 10000, 0, 0, 0
4628, 1, 1636425048529, 1636425048977, 448, 0, 448, 0, 0, 0
4610, 2, 1636425039365, 1636425049365, 10000, 0, 10000, 0, 0, 0
4629, 1, 1636425048937, 1636425049385, 448, 0, 448, 0, 0, 0
4630, 1, 1636425049104, 1636425049585, 481, 1, 480, 1, 0, 1
4631, 1, 1636425049457, 1636425049909, 452, 0, 452, 0, 0, 0
4632, 1, 1636425049669, 1636425050121, 452, 0, 452, 0, 0, 0
4633, 1, 1636425049861, 1636425050361, 500, 48, 452, 48, 0, 48
4611, 2, 1636425040941, 1636425050941, 10000, 0, 10000, 0, 0, 0
4634, 1, 1636425050553, 1636425051005, 452, 0, 452, 0, 0, 0
4612, 2, 1636425041417, 1636425051416, 9999, 0, 9999, 0, 0, 0
4636, 1, 1636425051261, 1636425051728, 467, 0, 467, 0, 0, 0
4635, 1, 1636425051248, 1636425051728, 480, 1, 479, 0, 0, 0
4637, 1, 1636425051725, 1636425052169, 444, 4, 440, 4, 0, 4
4638, 1, 1636425051772, 1636425052221, 449, 0, 449, 0, 0, 0
4613, 2, 1636425042257, 1636425052256, 9999, 0, 9999, 0, 0, 0
4614, 2, 1636425042497, 1636425052497, 10000, 0, 10000, 0, 0, 0
4639, 1, 1636425052249, 1636425052729, 480, 0, 480, 0, 0, 0
4641, 1, 1636425052589, 1636425053041, 452, 0, 452, 0, 0, 0
4615, 2, 1636425043285, 1636425053285, 10000, 0, 10000, 0, 0, 0
4643, 1, 1636425052853, 1636425053305, 452, 0, 452, 0, 0, 0
4642, 1, 1636425052801, 1636425053517, 716, 240, 476, 240, 0, 240
4616, 2, 1636425043649, 1636425053649, 10000, 0, 10000, 0, 0, 0
4646, 1, 1636425053501, 1636425053965, 464, 0, 464, 0, 0, 0
4647, 1, 1636425053589, 1636425054053, 464, 0, 464, 0, 0, 0
4648, 1, 1636425053957, 1636425054509, 552, 97, 455, 96, 0, 96
4618, 2, 1636425044665, 1636425054665, 10000, 0, 10000, 0, 0, 0
4620, 2, 1636425045265, 1636425055265, 10000, 0, 10000, 0, 0, 0
4651, 1, 1636425054853, 1636425055305, 452, 0, 452, 0, 0, 0
4652, 1, 1636425054973, 1636425055425, 452, 0, 452, 0, 0, 0
4654, 1, 1636425055493, 1636425055944, 451, 0, 451, 0, 0, 0
4622, 2, 1636425045988, 1636425055992, 10004, 0, 10004, 0, 0, 0
4655, 1, 1636425055569, 1636425056021, 452, 0, 452, 0, 0, 0
4657, 1, 1636425056297, 1636425056753, 456, 0, 456, 0, 0, 0
4658, 1, 1636425056309, 1636425056761, 452, 0, 452, 0, 0, 0
4660, 1, 1636425056665, 1636425057213, 548, 96, 452, 96, 0, 96
4662, 1, 1636425057309, 1636425057765, 456, 0, 456, 0, 0, 0
4663, 1, 1636425057653, 1636425058221, 568, 112, 456, 112, 0, 112
4665, 1, 1636425058801, 1636425059257, 456, 0, 456, 0, 0, 0
4667, 1, 1636425059401, 1636425059857, 456, 0, 456, 0, 0, 0
4669, 1, 1636425060012, 1636425060465, 453, 1, 452, 0, 1, 1
4640, 2, 1636425052300, 1636425062301, 10001, 0, 10001, 0, 0, 0
4644, 2, 1636425053129, 1636425063129, 10000, 0, 10000, 0, 0, 0
4645, 2, 1636425053465, 1636425063465, 10000, 0, 10000, 0, 0, 0
4649, 2, 1636425054145, 1636425064144, 9999, 0, 9999, 0, 0, 0
4650, 2, 1636425054757, 1636425064757, 10000, 0, 10000, 0, 0, 0
4653, 2, 1636425055452, 1636425065452, 10000, 0, 10000, 0, 0, 0
4656, 2, 1636425055960, 1636425065961, 10001, 0, 10001, 0, 0, 0
4659, 2, 1636425056313, 1636425066312, 9999, 0, 9999, 0, 0, 0
4661, 2, 1636425057041, 1636425067041, 10000, 0, 10000, 0, 0, 0
4664, 2, 1636425057693, 1636425067692, 9999, 0, 9999, 0, 0, 0
4666, 2, 1636425059041, 1636425069041, 10000, 0, 10000, 0, 0, 0
4668, 2, 1636425059776, 1636425069777, 10001, 0, 10001, 0, 0, 0
4670, 2, 1636425060496, 1636425070497, 10001, 0, 10001, 0, 0, 0
4671, 2, 1636425060688, 1636425070689, 10001, 0, 10001, 0, 0, 0
4672, 2, 1636425061509, 1636425071508, 9999, 0, 9999, 0, 0, 0
4673, 2, 1636425061813, 1636425071812, 9999, 0, 9999, 0, 0, 0
4674, 2, 1636425062605, 1636425072605, 10000, 0, 10000, 0, 0, 0
4675, 2, 1636425063001, 1636425073001, 10000, 0, 10000, 0, 0, 0
4693, 1, 1636425072909, 1636425073365, 456, 0, 456, 0, 0, 0
4676, 2, 1636425063437, 1636425073437, 10000, 0, 10000, 0, 0, 0
4677, 2, 1636425063600, 1636425073601, 10001, 0, 10001, 0, 0, 0
4678, 2, 1636425063773, 1636425073773, 10000, 0, 10000, 0, 0, 0
4679, 2, 1636425064236, 1636425074237, 10001, 0, 10001, 0, 0, 0
4695, 1, 1636425073816, 1636425074269, 453, 1, 452, 0, 0, 0
4680, 2, 1636425064448, 1636425074453, 10005, 0, 10005, 0, 0, 0
4697, 1, 1636425074081, 1636425074773, 692, 189, 503, 188, 0, 188
4681, 2, 1636425065065, 1636425075065, 10000, 0, 10000, 0, 0, 0
4699, 1, 1636425074756, 1636425075233, 477, 17, 460, 17, 0, 17
4682, 2, 1636425065761, 1636425075761, 10000, 0, 10000, 0, 0, 0
4700, 1, 1636425075365, 1636425075813, 448, 0, 448, 0, 0, 0
4683, 2, 1636425066268, 1636425076268, 10000, 0, 10000, 0, 0, 0
4701, 1, 1636425076068, 1636425076517, 449, 1, 448, 1, 0, 1
4684, 2, 1636425066617, 1636425076616, 9999, 0, 9999, 0, 0, 0
4702, 1, 1636425076577, 1636425077024, 447, 0, 447, 0, 0, 0
4703, 1, 1636425076857, 1636425077289, 432, 0, 432, 0, 0, 0
4685, 2, 1636425067345, 1636425077348, 10003, 0, 10003, 0, 0, 0
4704, 1, 1636425076920, 1636425077473, 553, 105, 448, 105, 0, 105
4686, 2, 1636425067997, 1636425077997, 10000, 0, 10000, 0, 0, 0
4706, 1, 1636425077660, 1636425078108, 448, 1, 447, 1, 0, 1
4705, 1, 1636425077653, 1636425078108, 455, 0, 455, 0, 0, 0
4708, 1, 1636425078268, 1636425078725, 457, 0, 457, 0, 0, 0
4707, 1, 1636425078297, 1636425078752, 455, 0, 455, 0, 0, 0
4709, 1, 1636425078701, 1636425079173, 472, 24, 448, 24, 0, 24
4687, 2, 1636425069349, 1636425079349, 10000, 0, 10000, 0, 0, 0
4710, 1, 1636425079396, 1636425079848, 452, 0, 452, 0, 0, 0
4688, 2, 1636425070085, 1636425080085, 10000, 0, 10000, 0, 0, 0
4711, 1, 1636425079657, 1636425080108, 451, 0, 451, 0, 0, 0
4712, 1, 1636425080176, 1636425080629, 453, 1, 452, 0, 1, 1
4689, 2, 1636425070805, 1636425080805, 10000, 0, 10000, 0, 0, 0
4713, 1, 1636425080393, 1636425080845, 452, 0, 452, 0, 0, 0
4690, 2, 1636425070997, 1636425080997, 10000, 0, 10000, 0, 0, 0
4714, 1, 1636425080684, 1636425081136, 452, 1, 451, 1, 0, 1
4717, 1, 1636425081113, 1636425081569, 456, 0, 456, 0, 0, 0
4691, 2, 1636425071856, 1636425081861, 10005, 0, 10005, 0, 0, 0
4718, 1, 1636425081297, 1636425082025, 728, 273, 455, 272, 1, 273
4692, 2, 1636425072121, 1636425082121, 10000, 0, 10000, 0, 0, 0
4721, 1, 1636425082169, 1636425082621, 452, 0, 452, 0, 0, 0
4723, 1, 1636425082429, 1636425083077, 648, 193, 455, 192, 1, 193
4694, 2, 1636425073309, 1636425083309, 10000, 0, 10000, 0, 0, 0
4696, 2, 1636425073897, 1636425083900, 10003, 0, 10003, 0, 0, 0
4727, 1, 1636425083617, 1636425084069, 452, 0, 452, 0, 0, 0
4698, 2, 1636425074545, 1636425084545, 10000, 0, 10000, 0, 0, 0
4730, 1, 1636425084209, 1636425084664, 455, 0, 455, 0, 0, 0
4733, 1, 1636425084853, 1636425085305, 452, 0, 452, 0, 0, 0
4715, 2, 1636425080848, 1636425090853, 10005, 0, 10005, 289, 0, 289
4716, 2, 1636425081085, 1636425091089, 10004, 0, 10004, 52, 0, 52
4719, 2, 1636425081624, 1636425091625, 10001, 0, 10001, 1, 0, 1
4720, 2, 1636425081765, 1636425091769, 10004, 0, 10004, 0, 0, 0
4742, 1, 1636425091448, 1636425091937, 489, 1, 488, 0, 1, 1
4741, 1, 1636425091448, 1636425091941, 493, 1, 492, 0, 0, 0
4722, 2, 1636425082272, 1636425092273, 10001, 0, 10001, 0, 0, 0
4743, 1, 1636425091948, 1636425092401, 453, 0, 453, 0, 0, 0
4724, 2, 1636425082413, 1636425092413, 10000, 0, 10000, 0, 0, 0
4744, 1, 1636425092069, 1636425092517, 448, 0, 448, 0, 0, 0
4725, 2, 1636425082685, 1636425092684, 9999, 0, 9999, 0, 0, 0
4745, 1, 1636425092593, 1636425093049, 456, 0, 456, 0, 0, 0
4746, 1, 1636425092728, 1636425093177, 449, 1, 448, 0, 0, 0
4726, 2, 1636425083352, 1636425093356, 10004, 0, 10004, 0, 0, 0
4747, 1, 1636425092993, 1636425093497, 504, 56, 448, 56, 0, 56
4728, 2, 1636425083761, 1636425093764, 10003, 0, 10003, 0, 0, 0
4748, 1, 1636425093661, 1636425094112, 451, 0, 451, 0, 0, 0
4729, 2, 1636425084145, 1636425094145, 10000, 0, 10000, 0, 0, 0
4749, 1, 1636425094068, 1636425094553, 485, 1, 484, 0, 0, 0
4731, 2, 1636425084680, 1636425094681, 10001, 0, 10001, 0, 0, 0
4732, 2, 1636425084761, 1636425094764, 10003, 0, 10003, 0, 0, 0
4750, 1, 1636425094453, 1636425094909, 456, 0, 456, 0, 0, 0
4734, 2, 1636425085221, 1636425095221, 10000, 0, 10000, 0, 0, 0
4735, 2, 1636425085336, 1636425095337, 10001, 0, 10001, 0, 0, 0
4751, 1, 1636425095033, 1636425095480, 447, 0, 447, 0, 0, 0
4752, 1, 1636425095069, 1636425095560, 491, 0, 491, 0, 0, 0
4754, 1, 1636425095264, 1636425095753, 489, 0, 489, 0, 0, 0
4753, 1, 1636425095264, 1636425095933, 669, 217, 452, 217, 0, 217
4755, 1, 1636425095524, 1636425096013, 489, 37, 452, 37, 0, 37
4757, 1, 1636425095604, 1636425096204, 600, 149, 451, 149, 0, 149
4736, 2, 1636425086277, 1636425096277, 10000, 0, 10000, 0, 0, 0
4758, 1, 1636425095684, 1636425096380, 696, 249, 447, 248, 0, 248
4756, 1, 1636425095637, 1636425096500, 863, 376, 487, 376, 0, 376
4737, 2, 1636425086549, 1636425096548, 9999, 0, 9999, 0, 0, 0
4759, 1, 1636425096252, 1636425096700, 448, 1, 447, 0, 0, 0
4760, 1, 1636425096368, 1636425096860, 492, 13, 479, 13, 0, 13
4761, 1, 1636425096592, 1636425097045, 453, 1, 452, 1, 0, 1
4762, 1, 1636425096592, 1636425097149, 557, 109, 448, 109, 0, 109
4763, 1, 1636425096852, 1636425097501, 649, 193, 456, 193, 0, 193
4738, 2, 1636425087725, 1636425097725, 10000, 0, 10000, 0, 0, 0
4764, 1, 1636425097333, 1636425097784, 451, 0, 451, 0, 0, 0
4765, 1, 1636425097861, 1636425098304, 443, 0, 443, 0, 0, 0
4739, 2, 1636425088321, 1636425098321, 10000, 0, 10000, 0, 0, 0
4766, 1, 1636425098033, 1636425098485, 452, 0, 452, 0, 0, 0
4767, 1, 1636425098121, 1636425098569, 448, 0, 448, 0, 0, 0
4740, 1, 1636425088956, 1636425098769, 9813, 9365, 448, 0, 9365, 9365
4768, 1, 1636425098621, 1636425099073, 452, 0, 452, 0, 0, 0
4769, 1, 1636425098697, 1636425099148, 451, 0, 451, 0, 0, 0
4771, 1, 1636425099017, 1636425099465, 448, 0, 448, 0, 0, 0
4770, 1, 1636425098988, 1636425099520, 532, 85, 447, 84, 0, 84
4773, 1, 1636425099113, 1636425099556, 443, 0, 443, 0, 0, 0
4772, 1, 1636425099024, 1636425099604, 580, 125, 455, 124, 0, 124
4776, 1, 1636425099401, 1636425099917, 516, 64, 452, 64, 0, 64
4777, 1, 1636425099468, 1636425100057, 589, 137, 452, 137, 0, 137
4778, 1, 1636425100048, 1636425100509, 461, 8, 453, 8, 0, 8
4779, 1, 1636425100157, 1636425100609, 452, 0, 452, 0, 0, 0
4780, 1, 1636425100376, 1636425101065, 689, 234, 455, 233, 0, 233
4783, 1, 1636425101241, 1636425101684, 443, 0, 443, 0, 0, 0
4784, 1, 1636425101641, 1636425102081, 440, 0, 440, 0, 0, 0
4786, 1, 1636425102025, 1636425102481, 456, 0, 456, 0, 0, 0
4788, 1, 1636425102601, 1636425103045, 444, 0, 444, 0, 0, 0
4789, 1, 1636425102693, 1636425103141, 448, 0, 448, 0, 0, 0
4791, 1, 1636425102816, 1636425103501, 685, 230, 455, 230, 0, 230
4792, 1, 1636425103253, 1636425103709, 456, 0, 456, 0, 0, 0
4794, 1, 1636425103349, 1636425103801, 452, 0, 452, 0, 0, 0
4793, 1, 1636425103293, 1636425103961, 668, 209, 459, 208, 0, 208
4795, 1, 1636425103833, 1636425104276, 443, 0, 443, 0, 0, 0
4796, 1, 1636425103956, 1636425104409, 453, 5, 448, 4, 0, 4
4797, 1, 1636425104237, 1636425104729, 492, 40, 452, 40, 0, 40
4798, 1, 1636425105213, 1636425105665, 452, 0, 452, 0, 0, 0
4799, 1, 1636425105377, 1636425105829, 452, 0, 452, 0, 0, 0
4800, 1, 1636425105861, 1636425106313, 452, 0, 452, 0, 0, 0
4801, 1, 1636425106277, 1636425106765, 488, 36, 452, 36, 0, 36
4803, 1, 1636425106681, 1636425107225, 544, 85, 459, 85, 0, 85
4804, 1, 1636425107109, 1636425107681, 572, 117, 455, 116, 1, 117
4806, 1, 1636425107353, 1636425107809, 456, 0, 456, 0, 0, 0
4807, 1, 1636425107633, 1636425108133, 500, 48, 452, 48, 0, 48
4774, 2, 1636425099281, 1636425109281, 10000, 0, 10000, 276, 0, 276
4775, 2, 1636425099317, 1636425109329, 10012, 0, 10012, 240, 0, 240
4810, 1, 1636425109053, 1636425109557, 504, 0, 504, 0, 0, 0
4812, 1, 1636425109856, 1636425110309, 453, 0, 453, 0, 0, 0
4781, 2, 1636425100381, 1636425110381, 10000, 0, 10000, 0, 0, 0
4782, 2, 1636425100505, 1636425110505, 10000, 0, 10000, 0, 0, 0
4814, 1, 1636425109856, 1636425110829, 973, 453, 520, 453, 0, 453
4818, 1, 1636425110809, 1636425111281, 472, 20, 452, 20, 0, 20
4785, 2, 1636425101668, 1636425111669, 10001, 0, 10001, 0, 0, 0
4817, 1, 1636425110688, 1636425111733, 1045, 593, 452, 593, 0, 593
4820, 1, 1636425111373, 1636425111825, 452, 0, 452, 0, 0, 0
4787, 2, 1636425102237, 1636425112237, 10000, 0, 10000, 0, 0, 0
4822, 1, 1636425111977, 1636425112464, 487, 0, 487, 0, 0, 0
4790, 2, 1636425102776, 1636425112777, 10001, 0, 10001, 0, 0, 0
4823, 1, 1636425112541, 1636425113008, 467, 0, 467, 0, 0, 0
4825, 1, 1636425113085, 1636425113537, 452, 0, 452, 0, 0, 0
4826, 1, 1636425113612, 1636425114069, 457, 1, 456, 0, 0, 0
4827, 1, 1636425113632, 1636425114525, 893, 438, 455, 437, 0, 437
4828, 1, 1636425114541, 1636425114997, 456, 0, 456, 0, 0, 0
4829, 1, 1636425114565, 1636425115453, 888, 433, 455, 433, 0, 433
4831, 1, 1636425115589, 1636425116041, 452, 0, 452, 0, 0, 0
4802, 2, 1636425106648, 1636425116649, 10001, 0, 10001, 0, 0, 0
4832, 1, 1636425116385, 1636425116877, 492, 0, 492, 0, 0, 0
4805, 2, 1636425107165, 1636425117165, 10000, 0, 10000, 0, 0, 0
4833, 1, 1636425116813, 1636425117329, 516, 64, 452, 64, 0, 64
4834, 1, 1636425116953, 1636425117400, 447, 0, 447, 0, 0, 0
4808, 2, 1636425107792, 1636425117793, 10001, 0, 10001, 0, 0, 0
4835, 1, 1636425117473, 1636425117925, 452, 0, 452, 0, 0, 0
4809, 2, 1636425107945, 1636425117944, 9999, 0, 9999, 0, 0, 0
4836, 1, 1636425117540, 1636425118021, 481, 0, 481, 0, 0, 0
4837, 1, 1636425117605, 1636425118468, 863, 416, 447, 416, 0, 416
4838, 1, 1636425118125, 1636425118577, 452, 0, 452, 0, 0, 0
4840, 1, 1636425118468, 1636425118921, 453, 1, 452, 1, 0, 1
4839, 1, 1636425118253, 1636425119032, 779, 324, 455, 324, 0, 324
4811, 2, 1636425109173, 1636425119173, 10000, 0, 10000, 0, 0, 0
4841, 1, 1636425118496, 1636425119396, 900, 426, 474, 425, 1, 426
4813, 2, 1636425109820, 1636425119820, 10000, 0, 10000, 0, 0, 0
4842, 1, 1636425119477, 1636425119929, 452, 0, 452, 0, 0, 0
4815, 2, 1636425109981, 1636425119981, 10000, 0, 10000, 0, 0, 0
4843, 1, 1636425119557, 1636425120044, 487, 0, 487, 0, 0, 0
4816, 2, 1636425110548, 1636425120552, 10004, 0, 10004, 0, 0, 0
4844, 1, 1636425120120, 1636425120576, 456, 1, 455, 0, 1, 1
4845, 1, 1636425120160, 1636425120613, 453, 1, 452, 0, 1, 1
4819, 2, 1636425110812, 1636425120812, 10000, 0, 10000, 0, 0, 0
4846, 1, 1636425120288, 1636425121064, 776, 325, 451, 325, 0, 325
4847, 1, 1636425120788, 1636425121245, 457, 1, 456, 0, 0, 0
4821, 2, 1636425111441, 1636425121440, 9999, 0, 9999, 0, 0, 0
4848, 1, 1636425120860, 1636425121524, 664, 205, 459, 204, 0, 204
4850, 1, 1636425121105, 1636425121561, 456, 0, 456, 0, 0, 0
4851, 1, 1636425121357, 1636425121849, 492, 0, 492, 0, 0, 0
4849, 1, 1636425121116, 1636425121977, 861, 409, 452, 408, 0, 408
4853, 1, 1636425121645, 1636425122092, 447, 0, 447, 0, 0, 0
4852, 1, 1636425121429, 1636425122304, 875, 421, 454, 420, 0, 420
4854, 1, 1636425121749, 1636425122433, 684, 228, 456, 228, 0, 228
4855, 1, 1636425122221, 1636425122681, 460, 0, 460, 0, 0, 0
4856, 1, 1636425122293, 1636425122756, 463, 12, 451, 12, 0, 12
4824, 2, 1636425112913, 1636425122913, 10000, 0, 10000, 0, 0, 0
4857, 1, 1636425122388, 1636425123136, 748, 293, 455, 293, 0, 293
4858, 1, 1636425122485, 1636425123229, 744, 272, 472, 272, 0, 272
4830, 1, 1636425115401, 1636425123361, 7960, 7512, 448, 0, 7512, 7512
4859, 1, 1636425123221, 1636425123677, 456, 0, 456, 0, 0, 0
4860, 1, 1636425123276, 1636425123729, 453, 1, 452, 0, 0, 0
4862, 1, 1636425123657, 1636425124109, 452, 0, 452, 0, 0, 0
4861, 1, 1636425123580, 1636425124133, 553, 97, 456, 97, 0, 97
4863, 1, 1636425123912, 1636425124361, 449, 0, 449, 0, 0, 0
4864, 1, 1636425124253, 1636425124700, 447, 0, 447, 0, 0, 0
4865, 1, 1636425124424, 1636425125153, 729, 277, 452, 276, 0, 276
4866, 1, 1636425124700, 1636425125156, 456, 1, 455, 0, 0, 0
4869, 1, 1636425125352, 1636425125805, 453, 1, 452, 0, 0, 0
4870, 1, 1636425125536, 1636425125980, 444, 1, 443, 1, 0, 1
4872, 1, 1636425125768, 1636425126265, 497, 37, 460, 36, 0, 36
4871, 1, 1636425125596, 1636425126417, 821, 385, 436, 384, 0, 384
4874, 1, 1636425126288, 1636425126737, 449, 1, 448, 0, 0, 0
4875, 1, 1636425126396, 1636425126864, 468, 21, 447, 21, 0, 21
4877, 1, 1636425126653, 1636425127189, 536, 84, 452, 84, 0, 84
4876, 1, 1636425126605, 1636425127313, 708, 260, 448, 260, 0, 260
4879, 1, 1636425127437, 1636425127889, 452, 0, 452, 0, 0, 0
4881, 1, 1636425127781, 1636425128233, 452, 0, 452, 0, 0, 0
4882, 1, 1636425128072, 1636425128525, 453, 1, 452, 0, 0, 0
4883, 1, 1636425128372, 1636425128825, 453, 1, 452, 1, 0, 1
4885, 1, 1636425128793, 1636425129245, 452, 0, 452, 0, 0, 0
4884, 1, 1636425128469, 1636425129277, 808, 356, 452, 356, 0, 356
4886, 1, 1636425129417, 1636425129869, 452, 0, 452, 0, 0, 0
4889, 1, 1636425130017, 1636425130469, 452, 0, 452, 0, 0, 0
4890, 1, 1636425130352, 1636425130929, 577, 118, 459, 116, 0, 116
4892, 1, 1636425130692, 1636425131388, 696, 238, 458, 237, 0, 237
4895, 1, 1636425131845, 1636425132297, 452, 0, 452, 0, 0, 0
4897, 1, 1636425132437, 1636425132892, 455, 0, 455, 0, 0, 0
4898, 1, 1636425132561, 1636425133345, 784, 332, 452, 332, 0, 332
4900, 1, 1636425133405, 1636425133857, 452, 0, 452, 0, 0, 0
4901, 1, 1636425133957, 1636425134409, 452, 0, 452, 0, 0, 0
4902, 1, 1636425134317, 1636425134861, 544, 92, 452, 92, 0, 92
4867, 2, 1636425124996, 1636425134997, 10001, 0, 10001, 157, 0, 157
4868, 2, 1636425125041, 1636425135045, 10004, 0, 10004, 112, 0, 112
4903, 1, 1636425134660, 1636425135365, 705, 201, 504, 201, 0, 201
4873, 2, 1636425125820, 1636425135821, 10001, 0, 10001, 0, 0, 0
4904, 1, 1636425135461, 1636425135912, 451, 0, 451, 0, 0, 0
4906, 1, 1636425135868, 1636425136309, 441, 0, 441, 0, 0, 0
4905, 1, 1636425135461, 1636425136357, 896, 452, 444, 452, 0, 452
4907, 1, 1636425136125, 1636425136809, 684, 232, 452, 232, 0, 232
4908, 1, 1636425136425, 1636425136872, 447, 0, 447, 0, 0, 0
4878, 2, 1636425127236, 1636425137237, 10001, 0, 10001, 0, 0, 0
4909, 1, 1636425136496, 1636425137320, 824, 377, 447, 376, 0, 376
4910, 1, 1636425137073, 1636425137556, 483, 0, 483, 0, 0, 0
4880, 2, 1636425127741, 1636425137741, 10000, 0, 10000, 0, 0, 0
4911, 1, 1636425137545, 1636425138001, 456, 0, 456, 0, 0, 0
4912, 1, 1636425137629, 1636425138077, 448, 0, 448, 0, 0, 0
4913, 1, 1636425138052, 1636425138501, 449, 1, 448, 1, 0, 1
4914, 1, 1636425138153, 1636425138605, 452, 0, 452, 0, 0, 0
4915, 1, 1636425138368, 1636425139061, 693, 238, 455, 237, 0, 237
4916, 1, 1636425139073, 1636425139524, 451, 0, 451, 0, 0, 0
4887, 2, 1636425129733, 1636425139733, 10000, 0, 10000, 0, 0, 0
4888, 2, 1636425129781, 1636425139780, 9999, 0, 9999, 0, 0, 0
4917, 1, 1636425139272, 1636425140008, 736, 253, 483, 252, 0, 252
4918, 1, 1636425139540, 1636425140008, 468, 0, 468, 0, 0, 0
4920, 1, 1636425140036, 1636425140492, 456, 0, 456, 0, 0, 0
4919, 1, 1636425140040, 1636425140492, 452, 0, 452, 0, 0, 0
4922, 1, 1636425140096, 1636425140536, 440, 1, 439, 0, 0, 0
4891, 2, 1636425130537, 1636425140537, 10000, 0, 10000, 0, 0, 0
4893, 2, 1636425130905, 1636425140905, 10000, 0, 10000, 0, 0, 0
4921, 1, 1636425140084, 1636425140940, 856, 409, 447, 409, 0, 409
4923, 1, 1636425140305, 1636425140984, 679, 232, 447, 232, 0, 232
4924, 1, 1636425140845, 1636425141393, 548, 96, 452, 96, 0, 96
4926, 1, 1636425141184, 1636425141636, 452, 1, 451, 0, 0, 0
4894, 2, 1636425131637, 1636425141637, 10000, 0, 10000, 0, 0, 0
4927, 1, 1636425141201, 1636425141657, 456, 0, 456, 0, 0, 0
4925, 1, 1636425141209, 1636425141857, 648, 185, 463, 184, 0, 184
4928, 1, 1636425141772, 1636425142221, 449, 0, 449, 0, 0, 0
4896, 2, 1636425132269, 1636425142269, 10000, 0, 10000, 0, 0, 0
4929, 1, 1636425141941, 1636425142385, 444, 0, 444, 0, 0, 0
4930, 1, 1636425142068, 1636425142521, 453, 1, 452, 0, 1, 1
4899, 1, 1636425132993, 1636425142720, 9727, 9276, 451, 0, 9276, 9276
4931, 1, 1636425142316, 1636425142765, 449, 1, 448, 0, 0, 0
4933, 1, 1636425142573, 1636425143025, 452, 0, 452, 0, 0, 0
4932, 1, 1636425142409, 1636425143217, 808, 356, 452, 356, 0, 356
4934, 1, 1636425142941, 1636425143477, 536, 84, 452, 84, 0, 84
4935, 1, 1636425143244, 1636425143696, 452, 1, 451, 0, 0, 0
4937, 1, 1636425143652, 1636425144097, 445, 0, 445, 0, 0, 0
4936, 1, 1636425143384, 1636425144145, 761, 313, 448, 312, 0, 312
4939, 1, 1636425143801, 1636425144248, 447, 0, 447, 0, 0, 0
4938, 1, 1636425143740, 1636425144541, 801, 357, 444, 357, 0, 357
4940, 1, 1636425144204, 1636425144657, 453, 0, 453, 0, 0, 0
4941, 1, 1636425144409, 1636425144861, 452, 0, 452, 0, 0, 0
4943, 1, 1636425144640, 1636425145093, 453, 1, 452, 1, 0, 1
4942, 1, 1636425144557, 1636425145317, 760, 305, 455, 304, 0, 304
4944, 1, 1636425145096, 1636425145545, 449, 1, 448, 0, 1, 1
4945, 1, 1636425145124, 1636425145577, 453, 0, 453, 0, 0, 0
4946, 1, 1636425145369, 1636425145825, 456, 0, 456, 0, 0, 0
4947, 1, 1636425145461, 1636425146041, 580, 116, 464, 116, 0, 116
4948, 1, 1636425145833, 1636425146285, 452, 0, 452, 0, 0, 0
4949, 1, 1636425146128, 1636425146585, 457, 1, 456, 1, 0, 1
4952, 1, 1636425146261, 1636425146713, 452, 0, 452, 0, 0, 0
4951, 1, 1636425146184, 1636425146737, 553, 101, 452, 101, 0, 101
4950, 1, 1636425146180, 1636425147036, 856, 405, 451, 404, 0, 404
4953, 1, 1636425146741, 1636425147192, 451, 0, 451, 0, 0, 0
4954, 1, 1636425147005, 1636425147457, 452, 0, 452, 0, 0, 0
4955, 1, 1636425147113, 1636425147913, 800, 345, 455, 344, 1, 345
4956, 1, 1636425147637, 1636425148084, 447, 0, 447, 0, 0, 0
4957, 1, 1636425147761, 1636425148213, 452, 0, 452, 0, 0, 0
4958, 1, 1636425147872, 1636425148369, 497, 41, 456, 40, 0, 40
4959, 1, 1636425147904, 1636425148669, 765, 310, 455, 308, 0, 308
4960, 1, 1636425148349, 1636425148805, 456, 0, 456, 0, 0, 0
4962, 1, 1636425148749, 1636425149200, 451, 0, 451, 0, 0, 0
4961, 1, 1636425148489, 1636425149261, 772, 316, 456, 316, 0, 316
4963, 1, 1636425148953, 1636425149412, 459, 0, 459, 0, 0, 0
4964, 1, 1636425149133, 1636425149585, 452, 0, 452, 0, 0, 0
4965, 1, 1636425149200, 1636425149653, 453, 1, 452, 1, 0, 1
4966, 1, 1636425149456, 1636425149909, 453, 1, 452, 0, 0, 0
4967, 1, 1636425149941, 1636425150392, 451, 0, 451, 0, 0, 0
4969, 1, 1636425150005, 1636425150452, 447, 0, 447, 0, 0, 0
4970, 1, 1636425150232, 1636425150693, 461, 1, 460, 1, 0, 1
4968, 1, 1636425149960, 1636425150845, 885, 433, 452, 432, 0, 432
4971, 1, 1636425150496, 1636425150948, 452, 1, 451, 0, 0, 0
4972, 1, 1636425150849, 1636425151400, 551, 100, 451, 100, 0, 100
4973, 1, 1636425151133, 1636425151588, 455, 0, 455, 0, 0, 0
4975, 1, 1636425151520, 1636425151965, 445, 0, 445, 0, 0, 0
4974, 1, 1636425151168, 1636425152033, 865, 421, 444, 420, 1, 421
4976, 1, 1636425151620, 1636425152060, 440, 0, 440, 0, 0, 0
4977, 1, 1636425151644, 1636425152417, 773, 322, 451, 321, 0, 321
4978, 1, 1636425152060, 1636425152509, 449, 0, 449, 0, 0, 0
4979, 1, 1636425152177, 1636425152620, 443, 0, 443, 0, 0, 0
4981, 1, 1636425152509, 1636425152957, 448, 0, 448, 0, 0, 0
4980, 1, 1636425152361, 1636425153073, 712, 260, 452, 260, 0, 260
4982, 1, 1636425152868, 1636425153409, 541, 90, 451, 89, 0, 89
4983, 1, 1636425153037, 1636425153485, 448, 0, 448, 0, 0, 0
4984, 1, 1636425153297, 1636425153749, 452, 0, 452, 0, 0, 0
4985, 1, 1636425153677, 1636425154124, 447, 0, 447, 0, 0, 0
4986, 1, 1636425153761, 1636425154208, 447, 0, 447, 0, 0, 0
4987, 1, 1636425154140, 1636425154593, 453, 1, 452, 1, 0, 1
4989, 1, 1636425154160, 1636425154657, 497, 49, 448, 48, 0, 48
4990, 1, 1636425154509, 1636425154952, 443, 0, 443, 0, 0, 0
4988, 1, 1636425154160, 1636425155049, 889, 433, 456, 432, 0, 432
4991, 1, 1636425154572, 1636425155109, 537, 86, 451, 85, 0, 85
4992, 1, 1636425154996, 1636425155449, 453, 0, 453, 0, 0, 0
4993, 1, 1636425155064, 1636425155904, 840, 386, 454, 384, 1, 385
4994, 1, 1636425155685, 1636425156136, 451, 0, 451, 0, 0, 0
4995, 1, 1636425155765, 1636425156356, 591, 140, 451, 140, 0, 140
4997, 1, 1636425155904, 1636425156357, 453, 1, 452, 0, 0, 0
4996, 1, 1636425155849, 1636425156585, 736, 288, 448, 288, 0, 288
4998, 1, 1636425156380, 1636425156833, 453, 0, 453, 0, 0, 0
5000, 1, 1636425156673, 1636425157125, 452, 0, 452, 0, 0, 0
4999, 1, 1636425156396, 1636425157289, 893, 437, 456, 437, 0, 437
5002, 1, 1636425157001, 1636425157452, 451, 0, 451, 0, 0, 0
5001, 1, 1636425156905, 1636425157581, 676, 221, 455, 220, 0, 220
5003, 1, 1636425157160, 1636425157621, 461, 0, 461, 0, 0, 0
5004, 1, 1636425157797, 1636425158252, 455, 0, 455, 0, 0, 0
5005, 1, 1636425157929, 1636425158381, 452, 0, 452, 0, 0, 0
5006, 1, 1636425158264, 1636425158709, 445, 0, 445, 0, 0, 0
5008, 1, 1636425158352, 1636425158833, 481, 29, 452, 29, 0, 29
5010, 1, 1636425158625, 1636425159081, 456, 0, 456, 0, 0, 0
5007, 1, 1636425158296, 1636425159165, 869, 414, 455, 414, 0, 414
5009, 1, 1636425158612, 1636425159293, 681, 222, 459, 220, 0, 220
5011, 1, 1636425158929, 1636425159377, 448, 0, 448, 0, 0, 0
5012, 1, 1636425158960, 1636425159832, 872, 417, 455, 417, 0, 417
5013, 1, 1636425159384, 1636425159832, 448, 0, 448, 0, 0, 0
5014, 1, 1636425159661, 1636425160281, 620, 172, 448, 172, 0, 172
5015, 1, 1636425159737, 1636425160281, 544, 96, 448, 96, 0, 96
5016, 1, 1636425160024, 1636425160481, 457, 0, 457, 0, 0, 0
5017, 1, 1636425160377, 1636425160828, 451, 0, 451, 0, 0, 0
5018, 1, 1636425160500, 1636425160953, 453, 1, 452, 1, 0, 1
5020, 1, 1636425160728, 1636425161268, 540, 101, 439, 101, 0, 101
5021, 1, 1636425160912, 1636425161357, 445, 1, 444, 0, 0, 0
5019, 1, 1636425160533, 1636425161404, 871, 420, 451, 420, 0, 420
5022, 1, 1636425160960, 1636425161417, 457, 1, 456, 0, 0, 0
5023, 1, 1636425161789, 1636425162240, 451, 0, 451, 0, 0, 0
5024, 1, 1636425161797, 1636425162245, 448, 0, 448, 0, 0, 0
5025, 1, 1636425162124, 1636425162693, 569, 121, 448, 121, 0, 121
5027, 1, 1636425162309, 1636425162761, 452, 0, 452, 0, 0, 0
5029, 1, 1636425162637, 1636425163089, 452, 0, 452, 0, 0, 0
5026, 1, 1636425162252, 1636425163149, 897, 441, 456, 440, 0, 440
5028, 1, 1636425162433, 1636425163212, 779, 328, 451, 328, 0, 328
5030, 1, 1636425163113, 1636425163565, 452, 0, 452, 0, 0, 0
5032, 1, 1636425163349, 1636425163801, 452, 0, 452, 0, 0, 0
5031, 1, 1636425163249, 1636425164021, 772, 317, 455, 316, 0, 316
5033, 1, 1636425163432, 1636425164261, 829, 369, 460, 368, 0, 368
5034, 1, 1636425163841, 1636425164472, 631, 181, 450, 180, 0, 180
5035, 1, 1636425164028, 1636425164485, 457, 0, 457, 0, 0, 0
5037, 1, 1636425164336, 1636425164789, 453, 1, 452, 0, 0, 0
5036, 1, 1636425164277, 1636425164941, 664, 208, 456, 208, 0, 208
5038, 1, 1636425164424, 1636425165245, 821, 366, 455, 365, 0, 365
5040, 1, 1636425164877, 1636425165328, 451, 0, 451, 0, 0, 0
5039, 1, 1636425164501, 1636425165389, 888, 440, 448, 440, 0, 440
5041, 1, 1636425165284, 1636425165737, 453, 0, 453, 0, 0, 0
5042, 1, 1636425165748, 1636425166196, 448, 1, 447, 0, 0, 0
5043, 1, 1636425165757, 1636425166208, 451, 0, 451, 0, 0, 0
5046, 1, 1636425166204, 1636425166657, 453, 0, 453, 0, 0, 0
5047, 1, 1636425166428, 1636425167117, 689, 230, 459, 228, 0, 228
5048, 1, 1636425166929, 1636425167381, 452, 0, 452, 0, 0, 0
5049, 1, 1636425167189, 1636425167641, 452, 0, 452, 0, 0, 0
5051, 1, 1636425167636, 1636425168089, 453, 1, 452, 0, 1, 1
5050, 1, 1636425167528, 1636425168096, 568, 113, 455, 113, 0, 113
5052, 1, 1636425167672, 1636425168545, 873, 418, 455, 417, 0, 417
5054, 1, 1636425167997, 1636425168553, 556, 100, 456, 99, 0, 99
5057, 1, 1636425168604, 1636425169061, 457, 1, 456, 1, 0, 1
5058, 1, 1636425168664, 1636425169517, 853, 397, 456, 397, 0, 397
5059, 1, 1636425169137, 1636425169589, 452, 0, 452, 0, 0, 0
5060, 1, 1636425169361, 1636425169813, 452, 0, 452, 0, 0, 0
5061, 1, 1636425169941, 1636425170396, 455, 0, 455, 0, 0, 0
5062, 1, 1636425170077, 1636425170525, 448, 0, 448, 0, 0, 0
5063, 1, 1636425170525, 1636425170984, 459, 1, 458, 0, 1, 1
5065, 1, 1636425170941, 1636425171381, 440, 0, 440, 0, 0, 0
5064, 1, 1636425170657, 1636425171424, 767, 328, 439, 328, 0, 328
5066, 1, 1636425171276, 1636425171729, 453, 1, 452, 0, 0, 0
5067, 1, 1636425171384, 1636425171841, 457, 0, 457, 0, 0, 0
5068, 1, 1636425171809, 1636425172297, 488, 32, 456, 32, 0, 32
5069, 1, 1636425171904, 1636425172353, 449, 1, 448, 0, 0, 0
5070, 1, 1636425171920, 1636425172812, 892, 433, 459, 433, 0, 433
5071, 1, 1636425172893, 1636425173340, 447, 0, 447, 0, 0, 0
5073, 1, 1636425173113, 1636425173565, 452, 0, 452, 0, 0, 0
5072, 1, 1636425172956, 1636425173793, 837, 385, 452, 384, 0, 384
5074, 1, 1636425173380, 1636425173833, 453, 0, 453, 0, 0, 0
5075, 1, 1636425174148, 1636425174597, 449, 1, 448, 0, 0, 0
5076, 1, 1636425174189, 1636425174633, 444, 0, 444, 0, 0, 0
5077, 1, 1636425174757, 1636425175208, 451, 0, 451, 0, 0, 0
5078, 1, 1636425174813, 1636425175261, 448, 0, 448, 0, 0, 0
5080, 1, 1636425175208, 1636425175657, 449, 1, 448, 1, 0, 1
5079, 1, 1636425174933, 1636425175704, 771, 328, 443, 328, 0, 328
5081, 1, 1636425175308, 1636425175748, 440, 1, 439, 1, 0, 1
5044, 2, 1636425165976, 1636425175977, 10001, 0, 10001, 233, 0, 233
5045, 2, 1636425166068, 1636425176068, 10000, 0, 10000, 141, 0, 141
5082, 1, 1636425175481, 1636425176113, 632, 177, 455, 176, 0, 176
5089, 1, 1636425176793, 1636425177249, 456, 0, 456, 0, 0, 0
5090, 1, 1636425177165, 1636425177617, 452, 0, 452, 0, 0, 0
5053, 2, 1636425167941, 1636425177941, 10000, 0, 10000, 0, 0, 0
5055, 2, 1636425168005, 1636425178005, 10000, 0, 10000, 0, 0, 0
5092, 1, 1636425177988, 1636425178441, 453, 1, 452, 1, 0, 1
5056, 1, 1636425168277, 1636425178457, 10180, 9728, 452, 0, 9728, 9728
5101, 1, 1636425179409, 1636425179861, 452, 0, 452, 0, 0, 0
5103, 1, 1636425181341, 1636425181793, 452, 0, 452, 0, 0, 0
5104, 1, 1636425182181, 1636425182633, 452, 0, 452, 0, 0, 0
5083, 2, 1636425175637, 1636425185637, 10000, 0, 10000, 112, 0, 112
5084, 2, 1636425175657, 1636425185685, 10028, 0, 10028, 92, 0, 92
5106, 1, 1636425185621, 1636425186092, 471, 0, 471, 0, 0, 0
5107, 1, 1636425186048, 1636425186500, 452, 0, 452, 0, 0, 0
5086, 2, 1636425176521, 1636425186520, 9999, 0, 9999, 0, 0, 0
5085, 2, 1636425176520, 1636425186565, 10045, 0, 10045, 0, 0, 0
5087, 2, 1636425176640, 1636425186641, 10001, 0, 10001, 0, 0, 0
5088, 2, 1636425176732, 1636425186733, 10001, 0, 10001, 0, 0, 0
5109, 1, 1636425186248, 1636425186796, 548, 1, 547, 0, 0, 0
5108, 1, 1636425186052, 1636425186977, 925, 449, 476, 449, 0, 449
5110, 1, 1636425186832, 1636425187289, 457, 0, 457, 0, 0, 0
5112, 1, 1636425186945, 1636425187424, 479, 32, 447, 32, 0, 32
5111, 1, 1636425186840, 1636425187749, 909, 450, 459, 449, 1, 450
5113, 1, 1636425187040, 1636425187877, 837, 385, 452, 384, 0, 384
5091, 2, 1636425177901, 1636425187901, 10000, 0, 10000, 0, 0, 0
5093, 2, 1636425178269, 1636425188265, 9996, 0, 9996, 0, 0, 0
5094, 2, 1636425178317, 1636425188317, 10000, 0, 10000, 0, 0, 0
5095, 2, 1636425178565, 1636425188564, 9999, 0, 9999, 0, 0, 0
5096, 2, 1636425178585, 1636425188608, 10023, 0, 10023, 0, 0, 0
5114, 1, 1636425188209, 1636425188677, 468, 0, 468, 0, 0, 0
5097, 2, 1636425178689, 1636425188688, 9999, 0, 9999, 0, 0, 0
5098, 1, 1636425178761, 1636425189017, 10256, 9804, 452, 0, 9804, 9804
5099, 2, 1636425179033, 1636425189033, 10000, 0, 10000, 0, 0, 0
5115, 1, 1636425188653, 1636425189109, 456, 0, 456, 0, 0, 0
5100, 2, 1636425179257, 1636425189256, 9999, 0, 9999, 0, 0, 0
5117, 1, 1636425188869, 1636425189348, 479, 0, 479, 0, 0, 0
5122, 1, 1636425189304, 1636425189761, 457, 0, 457, 0, 0, 0
5120, 1, 1636425189240, 1636425189793, 553, 109, 444, 109, 0, 109
5124, 1, 1636425189764, 1636425190217, 453, 1, 452, 0, 1, 1
5126, 1, 1636425190169, 1636425190616, 447, 0, 447, 0, 0, 0
5125, 1, 1636425189797, 1636425190661, 864, 420, 444, 420, 0, 420
5102, 2, 1636425180729, 1636425190728, 9999, 0, 9999, 0, 0, 0
5127, 1, 1636425190680, 1636425191132, 452, 1, 451, 1, 0, 1
5105, 1, 1636425183552, 1636425191176, 7624, 7177, 447, 0, 7176, 7176
5128, 1, 1636425190820, 1636425191273, 453, 0, 453, 0, 0, 0
5129, 1, 1636425190864, 1636425191577, 713, 268, 445, 268, 0, 268
5131, 1, 1636425191017, 1636425191721, 704, 256, 448, 256, 0, 256
5133, 1, 1636425191941, 1636425192393, 452, 0, 452, 0, 0, 0
5134, 1, 1636425192564, 1636425193008, 444, 0, 444, 0, 0, 0
5135, 1, 1636425192608, 1636425193052, 444, 0, 444, 0, 0, 0
5137, 1, 1636425193024, 1636425193477, 453, 0, 453, 0, 0, 0
5136, 1, 1636425192937, 1636425193505, 568, 116, 452, 116, 0, 116
5140, 1, 1636425193841, 1636425194301, 460, 0, 460, 0, 0, 0
5142, 1, 1636425194745, 1636425195197, 452, 0, 452, 0, 0, 0
5144, 1, 1636425194841, 1636425195657, 816, 357, 459, 357, 0, 357
5147, 1, 1636425196473, 1636425196925, 452, 0, 452, 0, 0, 0
5149, 1, 1636425197329, 1636425197777, 448, 0, 448, 0, 0, 0
5150, 1, 1636425197965, 1636425198417, 452, 0, 452, 0, 0, 0
5116, 2, 1636425188656, 1636425198657, 10001, 0, 10001, 453, 0, 453
5118, 2, 1636425188893, 1636425198893, 10000, 0, 10000, 216, 0, 216
5151, 1, 1636425198545, 1636425198993, 448, 0, 448, 0, 0, 0
5119, 2, 1636425188996, 1636425198997, 10001, 0, 10001, 112, 0, 112
5121, 2, 1636425189348, 1636425199349, 10001, 0, 10001, 0, 0, 0
5152, 1, 1636425198837, 1636425199441, 604, 156, 448, 156, 0, 156
5123, 2, 1636425189561, 1636425199560, 9999, 0, 9999, 0, 0, 0
5158, 1, 1636425200421, 1636425200873, 452, 0, 452, 0, 0, 0
5130, 2, 1636425191041, 1636425201041, 10000, 0, 10000, 0, 0, 0
5132, 2, 1636425191397, 1636425201396, 9999, 0, 9999, 0, 0, 0
5160, 1, 1636425201532, 1636425201989, 457, 0, 457, 0, 0, 0
5162, 1, 1636425202141, 1636425202597, 456, 0, 456, 0, 0, 0
5163, 1, 1636425202456, 1636425202909, 453, 0, 453, 0, 0, 0
5164, 1, 1636425202805, 1636425203365, 560, 104, 456, 104, 0, 104
5138, 2, 1636425193565, 1636425203565, 10000, 0, 10000, 0, 0, 0
5139, 2, 1636425193629, 1636425203629, 10000, 0, 10000, 0, 0, 0
5141, 2, 1636425194545, 1636425204545, 10000, 0, 10000, 0, 0, 0
5167, 1, 1636425204337, 1636425204789, 452, 0, 452, 0, 0, 0
5143, 2, 1636425194792, 1636425204793, 10001, 0, 10001, 0, 0, 0
5170, 1, 1636425205225, 1636425205677, 452, 0, 452, 0, 0, 0
5145, 2, 1636425195805, 1636425205809, 10004, 0, 10004, 0, 0, 0
5171, 1, 1636425206013, 1636425206465, 452, 0, 452, 0, 0, 0
5146, 2, 1636425196468, 1636425206469, 10001, 0, 10001, 0, 0, 0
5173, 1, 1636425206180, 1636425206632, 452, 1, 451, 0, 0, 0
5148, 1, 1636425196837, 1636425206921, 10084, 9632, 452, 0, 9632, 9632
5175, 1, 1636425206792, 1636425207249, 457, 0, 457, 0, 0, 0
5177, 1, 1636425208061, 1636425208513, 452, 0, 452, 0, 0, 0
5154, 2, 1636425199441, 1636425209441, 10000, 0, 10000, 0, 0, 0
5153, 2, 1636425199441, 1636425209484, 10043, 0, 10043, 0, 0, 0
5155, 2, 1636425199441, 1636425209528, 10087, 0, 10087, 0, 0, 0
5156, 2, 1636425199653, 1636425209653, 10000, 0, 10000, 0, 0, 0
5178, 1, 1636425209177, 1636425209753, 576, 0, 576, 0, 0, 0
5157, 2, 1636425199865, 1636425209865, 10000, 0, 10000, 0, 0, 0
5180, 1, 1636425209829, 1636425210293, 464, 0, 464, 0, 0, 0
5182, 1, 1636425209848, 1636425210296, 448, 1, 447, 0, 0, 0
5185, 1, 1636425210205, 1636425210661, 456, 0, 456, 0, 0, 0
5186, 1, 1636425210793, 1636425211245, 452, 0, 452, 0, 0, 0
5159, 2, 1636425201348, 1636425211349, 10001, 0, 10001, 0, 0, 0
5161, 2, 1636425201705, 1636425211705, 10000, 0, 10000, 0, 0, 0
5189, 1, 1636425212084, 1636425212541, 457, 1, 456, 0, 0, 0
5190, 1, 1636425213105, 1636425213557, 452, 0, 452, 0, 0, 0
5165, 2, 1636425203888, 1636425213889, 10001, 0, 10001, 0, 0, 0
5166, 2, 1636425203933, 1636425213932, 9999, 0, 9999, 0, 0, 0
5191, 1, 1636425213549, 1636425214005, 456, 8, 448, 8, 0, 8
5192, 1, 1636425213881, 1636425214348, 467, 0, 467, 0, 0, 0
5193, 1, 1636425214025, 1636425214477, 452, 0, 452, 0, 0, 0
5168, 2, 1636425204885, 1636425214885, 10000, 0, 10000, 0, 0, 0
5196, 1, 1636425214612, 1636425215057, 445, 0, 445, 0, 0, 0
5169, 2, 1636425205101, 1636425215100, 9999, 0, 9999, 0, 0, 0
5172, 2, 1636425206116, 1636425216117, 10001, 0, 10001, 0, 0, 0
5199, 1, 1636425215761, 1636425216213, 452, 0, 452, 0, 0, 0
5174, 2, 1636425206768, 1636425216769, 10001, 0, 10001, 0, 0, 0
5176, 1, 1636425207141, 1636425217216, 10075, 9628, 447, 0, 9628, 9628
5202, 1, 1636425217080, 1636425217537, 457, 1, 456, 0, 0, 0
5203, 1, 1636425217381, 1636425217985, 604, 156, 448, 156, 0, 156
5205, 1, 1636425217552, 1636425218009, 457, 0, 457, 0, 0, 0
5206, 1, 1636425218249, 1636425218701, 452, 0, 452, 0, 0, 0
5207, 1, 1636425218400, 1636425218853, 453, 0, 453, 0, 0, 0
5179, 2, 1636425209832, 1636425219833, 10001, 0, 10001, 462, 0, 462
5181, 2, 1636425209832, 1636425219881, 10049, 0, 10049, 462, 0, 462
5183, 2, 1636425209952, 1636425219957, 10005, 0, 10005, 341, 0, 341
5208, 1, 1636425219557, 1636425220009, 452, 0, 452, 0, 0, 0
5184, 2, 1636425210173, 1636425220173, 10000, 0, 10000, 120, 0, 120
5213, 1, 1636425220857, 1636425221309, 452, 0, 452, 0, 0, 0
5187, 2, 1636425211656, 1636425221657, 10001, 0, 10001, 0, 0, 0
5214, 1, 1636425221257, 1636425221760, 503, 53, 450, 52, 0, 52
5188, 2, 1636425212013, 1636425222013, 10000, 0, 10000, 0, 0, 0
5215, 1, 1636425221621, 1636425222076, 455, 0, 455, 0, 0, 0
5217, 1, 1636425222060, 1636425222513, 453, 1, 452, 0, 0, 0
5219, 1, 1636425222549, 1636425223001, 452, 0, 452, 0, 0, 0
5221, 1, 1636425223625, 1636425224077, 452, 0, 452, 0, 0, 0
5194, 2, 1636425214192, 1636425224193, 10001, 0, 10001, 0, 0, 0
5195, 2, 1636425214237, 1636425224241, 10004, 0, 10004, 0, 0, 0
5224, 1, 1636425224541, 1636425224989, 448, 0, 448, 0, 0, 0
5197, 2, 1636425215193, 1636425225193, 10000, 0, 10000, 0, 0, 0
5198, 2, 1636425215409, 1636425225409, 10000, 0, 10000, 0, 0, 0
5225, 1, 1636425225125, 1636425225632, 507, 0, 507, 0, 0, 0
5227, 1, 1636425225544, 1636425225993, 449, 0, 449, 0, 0, 0
5200, 2, 1636425216424, 1636425226425, 10001, 0, 10001, 0, 0, 0
5229, 1, 1636425225969, 1636425226425, 456, 0, 456, 0, 0, 0
5230, 1, 1636425226516, 1636425226969, 453, 0, 453, 0, 0, 0
5201, 2, 1636425217072, 1636425227073, 10001, 0, 10001, 0, 0, 0
5204, 1, 1636425217437, 1636425227529, 10092, 9636, 456, 0, 9636, 9636
5233, 1, 1636425227521, 1636425227973, 452, 0, 452, 0, 0, 0
5235, 1, 1636425228769, 1636425229221, 452, 0, 452, 0, 0, 0
5236, 1, 1636425229169, 1636425229681, 512, 53, 459, 52, 1, 53
5237, 1, 1636425229493, 1636425229945, 452, 0, 452, 0, 0, 0
5210, 2, 1636425220600, 1636425230601, 10001, 0, 10001, 0, 0, 0
5238, 1, 1636425230164, 1636425230616, 452, 1, 451, 0, 1, 1
5209, 2, 1636425220604, 1636425230652, 10048, 0, 10048, 0, 0, 0
5239, 1, 1636425230241, 1636425230693, 452, 0, 452, 0, 0, 0
5212, 2, 1636425220604, 1636425230697, 10093, 0, 10093, 0, 0, 0
5211, 2, 1636425220600, 1636425230741, 10141, 0, 10141, 0, 0, 0
5243, 1, 1636425231008, 1636425231461, 453, 1, 452, 0, 0, 0
5244, 1, 1636425231185, 1636425231637, 452, 0, 452, 0, 0, 0
5216, 2, 1636425221965, 1636425231965, 10000, 0, 10000, 0, 0, 0
5218, 2, 1636425222321, 1636425232321, 10000, 0, 10000, 0, 0, 0
5220, 2, 1636425222977, 1636425232977, 10000, 0, 10000, 0, 0, 0
5247, 1, 1636425232645, 1636425233101, 456, 0, 456, 0, 0, 0
5248, 1, 1636425232892, 1636425233556, 664, 210, 454, 210, 0, 210
5249, 1, 1636425233281, 1636425233733, 452, 0, 452, 0, 0, 0
5222, 2, 1636425224500, 1636425234501, 10001, 0, 10001, 0, 0, 0
5223, 2, 1636425224545, 1636425234544, 9999, 0, 9999, 0, 0, 0
5252, 1, 1636425234373, 1636425234865, 492, 0, 492, 0, 0, 0
5253, 1, 1636425234685, 1636425235137, 452, 0, 452, 0, 0, 0
5226, 2, 1636425225500, 1636425235501, 10001, 0, 10001, 0, 0, 0
5228, 2, 1636425225716, 1636425235716, 10000, 0, 10000, 0, 0, 0
5231, 2, 1636425226732, 1636425236733, 10001, 0, 10001, 0, 0, 0
5259, 1, 1636425236641, 1636425237097, 456, 0, 456, 0, 0, 0
5232, 2, 1636425227376, 1636425237373, 9997, 0, 9997, 0, 0, 0
5260, 1, 1636425236692, 1636425237544, 852, 405, 447, 404, 0, 404
5262, 1, 1636425237112, 1636425237592, 480, 0, 480, 0, 0, 0
5234, 1, 1636425227749, 1636425237813, 10064, 9624, 440, 0, 9624, 9624
5265, 1, 1636425238213, 1636425238669, 456, 0, 456, 0, 0, 0
5266, 1, 1636425238801, 1636425239253, 452, 0, 452, 0, 0, 0
5267, 1, 1636425240413, 1636425240869, 456, 0, 456, 0, 0, 0
5241, 2, 1636425231008, 1636425241009, 10001, 0, 10001, 453, 0, 453
5242, 2, 1636425231012, 1636425241053, 10041, 0, 10041, 449, 0, 449
5240, 2, 1636425231012, 1636425241101, 10089, 0, 10089, 449, 0, 449
5268, 1, 1636425240585, 1636425241425, 840, 284, 556, 284, 0, 284
5270, 1, 1636425241769, 1636425242225, 456, 0, 456, 0, 0, 0
5245, 2, 1636425232273, 1636425242269, 9996, 0, 9996, 0, 0, 0
5273, 1, 1636425242021, 1636425242496, 475, 0, 475, 0, 0, 0
5246, 2, 1636425232629, 1636425242629, 10000, 0, 10000, 0, 0, 0
5271, 1, 1636425241773, 1636425242672, 899, 453, 446, 452, 0, 452
5275, 1, 1636425242868, 1636425243313, 445, 0, 445, 0, 0, 0
5250, 2, 1636425233605, 1636425243605, 10000, 0, 10000, 0, 0, 0
5277, 1, 1636425243913, 1636425244365, 452, 0, 452, 0, 0, 0
5251, 2, 1636425234369, 1636425244369, 10000, 0, 10000, 0, 0, 0
5254, 2, 1636425234804, 1636425244804, 10000, 0, 10000, 0, 0, 0
5255, 2, 1636425234849, 1636425244848, 9999, 0, 9999, 0, 0, 0
5278, 1, 1636425244625, 1636425245164, 539, 0, 539, 0, 0, 0
5279, 1, 1636425244676, 1636425245168, 492, 0, 492, 0, 0, 0
5256, 2, 1636425235297, 1636425245297, 10000, 0, 10000, 0, 0, 0
5280, 1, 1636425244644, 1636425245617, 973, 521, 452, 521, 0, 521
5257, 2, 1636425235809, 1636425245809, 10000, 0, 10000, 0, 0, 0
5258, 2, 1636425236025, 1636425246025, 10000, 0, 10000, 0, 0, 0
5283, 1, 1636425245605, 1636425246056, 451, 0, 451, 0, 0, 0
5284, 1, 1636425245789, 1636425246253, 464, 0, 464, 0, 0, 0
5286, 1, 1636425246012, 1636425246464, 452, 0, 452, 0, 0, 0
5285, 1, 1636425245852, 1636425246712, 860, 402, 458, 401, 0, 401
5261, 2, 1636425237041, 1636425247041, 10000, 0, 10000, 0, 0, 0
5289, 1, 1636425246697, 1636425247149, 452, 0, 452, 0, 0, 0
5263, 2, 1636425237676, 1636425247677, 10001, 0, 10001, 0, 0, 0
5264, 1, 1636425238032, 1636425248128, 10096, 9645, 451, 0, 9644, 9644
5291, 1, 1636425247724, 1636425248173, 449, 1, 448, 0, 0, 0
5294, 1, 1636425248473, 1636425248925, 452, 0, 452, 0, 0, 0
5295, 1, 1636425248896, 1636425249353, 457, 1, 456, 0, 0, 0
5296, 1, 1636425248901, 1636425249805, 904, 452, 452, 452, 0, 452
5297, 1, 1636425249425, 1636425249877, 452, 0, 452, 0, 0, 0
5298, 1, 1636425249573, 1636425250021, 448, 0, 448, 0, 0, 0
5299, 1, 1636425249817, 1636425250481, 664, 204, 460, 204, 0, 204
5300, 1, 1636425250157, 1636425250601, 444, 0, 444, 0, 0, 0
5301, 1, 1636425250417, 1636425250933, 516, 64, 452, 64, 0, 64
5269, 2, 1636425241193, 1636425251193, 10000, 0, 10000, 0, 0, 0
5272, 2, 1636425241773, 1636425251773, 10000, 0, 10000, 900, 0, 900
5302, 1, 1636425251409, 1636425251861, 452, 0, 452, 0, 0, 0
5274, 2, 1636425242581, 1636425252581, 10000, 0, 10000, 92, 0, 92
5304, 1, 1636425252153, 1636425252605, 452, 0, 452, 0, 0, 0
5276, 2, 1636425242937, 1636425252936, 9999, 0, 9999, 0, 0, 0
5307, 1, 1636425253104, 1636425253557, 453, 0, 453, 0, 0, 0
5308, 1, 1636425253152, 1636425253605, 453, 0, 453, 0, 0, 0
5311, 1, 1636425253345, 1636425253797, 452, 0, 452, 0, 0, 0
5309, 1, 1636425253169, 1636425254057, 888, 436, 452, 436, 0, 436
5312, 1, 1636425253793, 1636425254245, 452, 4, 448, 4, 0, 4
5313, 1, 1636425254157, 1636425254605, 448, 0, 448, 0, 0, 0
5314, 1, 1636425254540, 1636425254997, 457, 0, 457, 0, 0, 0
5281, 2, 1636425245108, 1636425255109, 10001, 0, 10001, 0, 0, 0
5282, 2, 1636425245153, 1636425255156, 10003, 0, 10003, 0, 0, 0
5316, 1, 1636425255408, 1636425255861, 453, 0, 453, 0, 0, 0
5287, 2, 1636425246117, 1636425256117, 10000, 0, 10000, 0, 0, 0
5288, 2, 1636425246332, 1636425256332, 10000, 0, 10000, 0, 0, 0
5318, 1, 1636425256160, 1636425256653, 493, 0, 493, 0, 0, 0
5290, 2, 1636425247349, 1636425257349, 10000, 0, 10000, 0, 0, 0
5323, 1, 1636425257337, 1636425257793, 456, 0, 456, 0, 0, 0
5324, 1, 1636425257484, 1636425257937, 453, 1, 452, 0, 0, 0
5292, 2, 1636425247976, 1636425257977, 10001, 0, 10001, 0, 0, 0
5326, 1, 1636425257929, 1636425258393, 464, 8, 456, 8, 0, 8
5293, 1, 1636425248349, 1636425258433, 10084, 9628, 456, 0, 9628, 9628
5327, 1, 1636425258201, 1636425258652, 451, 0, 451, 0, 0, 0
5330, 1, 1636425258721, 1636425259173, 452, 0, 452, 0, 0, 0
5331, 1, 1636425259321, 1636425259773, 452, 0, 452, 0, 0, 0
5332, 1, 1636425259936, 1636425260385, 449, 1, 448, 0, 0, 0
5303, 2, 1636425251497, 1636425261497, 10000, 0, 10000, 0, 0, 0
5333, 1, 1636425261213, 1636425261664, 451, 0, 451, 0, 0, 0
5334, 1, 1636425261632, 1636425262085, 453, 0, 453, 0, 0, 0
5335, 1, 1636425261805, 1636425262257, 452, 0, 452, 0, 0, 0
5336, 1, 1636425262041, 1636425262540, 499, 44, 455, 44, 0, 44
5337, 1, 1636425262124, 1636425262572, 448, 0, 448, 0, 0, 0
5306, 2, 1636425252984, 1636425262985, 10001, 0, 10001, 0, 0, 0
5305, 2, 1636425252984, 1636425263028, 10044, 0, 10044, 1, 0, 1
5338, 1, 1636425262613, 1636425263061, 448, 0, 448, 0, 0, 0
5310, 2, 1636425253245, 1636425263245, 10000, 0, 10000, 0, 0, 0
5341, 1, 1636425263292, 1636425263749, 457, 1, 456, 0, 0, 0
5339, 1, 1636425263292, 1636425263749, 457, 1, 456, 1, 0, 1
5343, 1, 1636425263905, 1636425264357, 452, 0, 452, 0, 0, 0
5315, 2, 1636425255421, 1636425265420, 9999, 0, 9999, 0, 0, 0
5317, 2, 1636425255456, 1636425265464, 10008, 0, 10008, 0, 0, 0
5344, 1, 1636425265209, 1636425265692, 483, 0, 483, 0, 0, 0
5345, 1, 1636425265464, 1636425265916, 452, 1, 451, 1, 0, 1
5349, 1, 1636425265841, 1636425266289, 448, 0, 448, 0, 0, 0
5350, 1, 1636425265912, 1636425266361, 449, 0, 449, 0, 0, 0
5348, 1, 1636425265776, 1636425266369, 593, 141, 452, 141, 0, 141
5319, 2, 1636425256424, 1636425266425, 10001, 0, 10001, 0, 0, 0
5320, 2, 1636425256640, 1636425266641, 10001, 0, 10001, 0, 0, 0
5321, 2, 1636425256825, 1636425266824, 9999, 0, 9999, 0, 0, 0
5351, 1, 1636425266472, 1636425266961, 489, 0, 489, 0, 0, 0
5322, 2, 1636425257161, 1636425267160, 9999, 0, 9999, 0, 0, 0
5354, 1, 1636425267133, 1636425267581, 448, 0, 448, 0, 0, 0
5325, 2, 1636425257657, 1636425267657, 10000, 0, 10000, 0, 0, 0
5355, 1, 1636425267252, 1636425267713, 461, 0, 461, 0, 0, 0
5356, 1, 1636425267372, 1636425268069, 697, 210, 487, 209, 0, 209
5328, 2, 1636425258284, 1636425268285, 10001, 0, 10001, 0, 0, 0
5358, 1, 1636425267848, 1636425268301, 453, 1, 452, 0, 0, 0
5357, 1, 1636425267465, 1636425268521, 1056, 604, 452, 604, 0, 604
5329, 1, 1636425258652, 1636425268737, 10085, 9633, 452, 0, 9633, 9633
5362, 1, 1636425269113, 1636425269565, 452, 0, 452, 0, 0, 0
5363, 1, 1636425269268, 1636425269725, 457, 1, 456, 0, 0, 0
5364, 1, 1636425269541, 1636425270181, 640, 185, 455, 184, 1, 185
5365, 1, 1636425269897, 1636425270349, 452, 0, 452, 0, 0, 0
5366, 1, 1636425270141, 1636425270597, 456, 0, 456, 0, 0, 0
5367, 1, 1636425270337, 1636425270789, 452, 0, 452, 0, 0, 0
5368, 1, 1636425271197, 1636425271649, 452, 0, 452, 0, 0, 0
5369, 1, 1636425271389, 1636425271849, 460, 0, 460, 0, 0, 0
5371, 1, 1636425271636, 1636425272089, 453, 1, 452, 0, 0, 0
5370, 1, 1636425271617, 1636425272100, 483, 32, 451, 32, 0, 32
5372, 1, 1636425272061, 1636425272513, 452, 0, 452, 0, 0, 0
5340, 2, 1636425263336, 1636425273337, 10001, 0, 10001, 414, 0, 414
5342, 2, 1636425263552, 1636425273553, 10001, 0, 10001, 198, 0, 198
5373, 1, 1636425273149, 1636425273597, 448, 0, 448, 0, 0, 0
5374, 1, 1636425273225, 1636425273673, 448, 0, 448, 0, 0, 0
5375, 1, 1636425273333, 1636425274049, 716, 264, 452, 264, 0, 264
5379, 1, 1636425274293, 1636425274745, 452, 0, 452, 0, 0, 0
5380, 1, 1636425274313, 1636425274765, 452, 0, 452, 0, 0, 0
5346, 2, 1636425265724, 1636425275725, 10001, 0, 10001, 0, 0, 0
5347, 2, 1636425265760, 1636425275768, 10008, 0, 10008, 0, 0, 0
5381, 1, 1636425275401, 1636425275844, 443, 0, 443, 0, 0, 0
5382, 1, 1636425275413, 1636425275856, 443, 0, 443, 0, 0, 0
5383, 1, 1636425275441, 1636425275888, 447, 0, 447, 0, 0, 0
5384, 1, 1636425275816, 1636425276309, 493, 41, 452, 41, 0, 41
5387, 1, 1636425276073, 1636425276525, 452, 0, 452, 0, 0, 0
5352, 2, 1636425266732, 1636425276733, 10001, 0, 10001, 1, 0, 1
5353, 2, 1636425266949, 1636425276949, 10000, 0, 10000, 0, 0, 0
5390, 1, 1636425277304, 1636425277761, 457, 0, 457, 0, 0, 0
5392, 1, 1636425277500, 1636425277953, 453, 1, 452, 0, 1, 1
5359, 2, 1636425267964, 1636425277965, 10001, 0, 10001, 0, 0, 0
5391, 1, 1636425277376, 1636425278213, 837, 385, 452, 384, 0, 384
5393, 1, 1636425278100, 1636425278553, 453, 1, 452, 1, 0, 1
5360, 2, 1636425268589, 1636425278588, 9999, 0, 9999, 0, 0, 0
5395, 1, 1636425278577, 1636425279033, 456, 0, 456, 0, 0, 0
5361, 1, 1636425268957, 1636425279045, 10088, 9632, 456, 0, 9631, 9631
5397, 1, 1636425279112, 1636425279565, 453, 1, 452, 0, 0, 0
5399, 1, 1636425279301, 1636425279757, 456, 0, 456, 0, 0, 0
5400, 1, 1636425279417, 1636425279869, 452, 0, 452, 0, 0, 0
5401, 1, 1636425279641, 1636425280213, 572, 117, 455, 116, 0, 116
5402, 1, 1636425280089, 1636425280545, 456, 0, 456, 0, 0, 0
5403, 1, 1636425281188, 1636425281640, 452, 1, 451, 0, 1, 1
5405, 1, 1636425281516, 1636425281965, 449, 1, 448, 0, 0, 0
5404, 1, 1636425281213, 1636425282092, 879, 428, 451, 428, 0, 428
5406, 1, 1636425281965, 1636425282417, 452, 0, 452, 0, 0, 0
5407, 1, 1636425282353, 1636425282801, 448, 0, 448, 0, 0, 0
5409, 1, 1636425283165, 1636425283617, 452, 0, 452, 0, 0, 0
5411, 1, 1636425283417, 1636425283869, 452, 0, 452, 0, 0, 0
5378, 2, 1636425274020, 1636425284021, 10001, 0, 10001, 0, 0, 0
5377, 2, 1636425274060, 1636425284064, 10004, 0, 10004, 0, 0, 0
5410, 1, 1636425283401, 1636425284068, 667, 216, 451, 216, 0, 216
5376, 2, 1636425274060, 1636425284108, 10048, 0, 10048, 0, 0, 0
5413, 1, 1636425284368, 1636425284821, 453, 0, 453, 0, 0, 0
5414, 1, 1636425284377, 1636425284829, 452, 0, 452, 0, 0, 0
5415, 1, 1636425284377, 1636425285285, 908, 452, 456, 452, 0, 452
5417, 1, 1636425285229, 1636425285681, 452, 0, 452, 0, 0, 0
5385, 2, 1636425276028, 1636425286029, 10001, 0, 10001, 0, 0, 0
5386, 2, 1636425276065, 1636425286072, 10007, 0, 10007, 0, 0, 0
5418, 1, 1636425285465, 1636425286132, 667, 217, 450, 216, 0, 216
5419, 1, 1636425285965, 1636425286477, 512, 0, 512, 0, 0, 0
5420, 1, 1636425286217, 1636425286669, 452, 0, 452, 0, 0, 0
5421, 1, 1636425286333, 1636425286785, 452, 0, 452, 0, 0, 0
5388, 2, 1636425277040, 1636425287041, 10001, 0, 10001, 0, 0, 0
5389, 2, 1636425277256, 1636425287257, 10001, 0, 10001, 1, 0, 1
5422, 1, 1636425286368, 1636425287265, 897, 418, 479, 417, 1, 418
5423, 1, 1636425287349, 1636425287801, 452, 0, 452, 0, 0, 0
5424, 1, 1636425287405, 1636425287856, 451, 0, 451, 0, 0, 0
5427, 1, 1636425287596, 1636425288045, 449, 1, 448, 0, 0, 0
5426, 1, 1636425287565, 1636425288252, 687, 237, 450, 236, 0, 236
5394, 2, 1636425278273, 1636425288273, 10000, 0, 10000, 0, 0, 0
5425, 1, 1636425287477, 1636425288304, 827, 380, 447, 380, 0, 380
5429, 1, 1636425288025, 1636425288500, 475, 0, 475, 0, 0, 0
5428, 1, 1636425288016, 1636425288500, 484, 1, 483, 0, 0, 0
5396, 2, 1636425278888, 1636425288889, 10001, 0, 10001, 0, 0, 0
5430, 1, 1636425288364, 1636425288957, 593, 137, 456, 137, 0, 137
5431, 1, 1636425288585, 1636425289037, 452, 0, 452, 0, 0, 0
5398, 1, 1636425279269, 1636425289337, 10068, 9620, 448, 0, 9620, 9620
5433, 1, 1636425289157, 1636425289609, 452, 0, 452, 0, 0, 0
5432, 1, 1636425289193, 1636425289644, 451, 0, 451, 0, 0, 0
5434, 1, 1636425289445, 1636425290061, 616, 164, 452, 164, 0, 164
5435, 1, 1636425289557, 1636425290092, 535, 88, 447, 88, 0, 88
5436, 1, 1636425289696, 1636425290140, 444, 0, 444, 0, 0, 0
5437, 1, 1636425290180, 1636425290629, 449, 1, 448, 0, 1, 1
5439, 1, 1636425290325, 1636425290772, 447, 0, 447, 0, 0, 0
5438, 1, 1636425290217, 1636425291081, 864, 412, 452, 412, 0, 412
5440, 1, 1636425291025, 1636425291529, 504, 57, 447, 56, 1, 57
5442, 1, 1636425291444, 1636425291901, 457, 0, 457, 0, 0, 0
5443, 1, 1636425291488, 1636425291932, 444, 1, 443, 0, 0, 0
5441, 1, 1636425291413, 1636425291981, 568, 117, 451, 116, 0, 116
5445, 1, 1636425291761, 1636425292209, 448, 0, 448, 0, 0, 0
5446, 1, 1636425291904, 1636425292357, 453, 0, 453, 0, 0, 0
5444, 1, 1636425291620, 1636425292357, 737, 281, 456, 281, 0, 281
5447, 1, 1636425292180, 1636425292629, 449, 1, 448, 0, 0, 0
5448, 1, 1636425292209, 1636425292660, 451, 0, 451, 0, 0, 0
5408, 2, 1636425283089, 1636425293089, 10000, 0, 10000, 0, 0, 0
5449, 1, 1636425292873, 1636425293325, 452, 0, 452, 0, 0, 0
5450, 1, 1636425293081, 1636425293529, 448, 0, 448, 0, 0, 0
5451, 1, 1636425293132, 1636425293781, 649, 194, 455, 193, 0, 193
5412, 2, 1636425283849, 1636425293849, 10000, 0, 10000, 0, 0, 0
5452, 1, 1636425293401, 1636425293849, 448, 0, 448, 0, 0, 0
5453, 1, 1636425293384, 1636425293977, 593, 146, 447, 144, 0, 144
5454, 1, 1636425293660, 1636425294113, 453, 1, 452, 0, 0, 0
5455, 1, 1636425293896, 1636425294349, 453, 0, 453, 0, 0, 0
5456, 1, 1636425294160, 1636425294613, 453, 0, 453, 0, 0, 0
5457, 1, 1636425294204, 1636425294805, 601, 146, 455, 145, 1, 146
5458, 1, 1636425294581, 1636425295033, 452, 0, 452, 0, 0, 0
5416, 2, 1636425285189, 1636425295189, 10000, 0, 10000, 0, 0, 0
5459, 1, 1636425294704, 1636425295256, 552, 102, 450, 101, 0, 101
5460, 1, 1636425295324, 1636425295777, 453, 0, 453, 0, 0, 0
5461, 1, 1636425295404, 1636425295853, 449, 1, 448, 0, 0, 0
5462, 1, 1636425295497, 1636425295948, 451, 0, 451, 0, 0, 0
5463, 1, 1636425295764, 1636425296217, 453, 1, 452, 0, 0, 0
5464, 1, 1636425295784, 1636425296241, 457, 1, 456, 1, 0, 1
5466, 1, 1636425295864, 1636425296308, 444, 1, 443, 1, 0, 1
5467, 1, 1636425295905, 1636425296348, 443, 0, 443, 0, 0, 0
5465, 1, 1636425295801, 1636425296672, 871, 417, 454, 416, 1, 417
5468, 1, 1636425296617, 1636425297069, 452, 0, 452, 0, 0, 0
5469, 1, 1636425296797, 1636425297249, 452, 0, 452, 0, 0, 0
5471, 1, 1636425297173, 1636425297625, 452, 0, 452, 0, 0, 0
5470, 1, 1636425297149, 1636425297713, 564, 101, 463, 100, 1, 101
5473, 1, 1636425297548, 1636425298009, 461, 1, 460, 1, 0, 1
5474, 1, 1636425297605, 1636425298056, 451, 0, 451, 0, 0, 0
5472, 1, 1636425297273, 1636425298077, 804, 352, 452, 352, 0, 352
5475, 1, 1636425297929, 1636425298385, 456, 0, 456, 0, 0, 0
5476, 1, 1636425298313, 1636425298764, 451, 0, 451, 0, 0, 0
5477, 1, 1636425298333, 1636425298785, 452, 0, 452, 0, 0, 0
5478, 1, 1636425298461, 1636425298917, 456, 0, 456, 0, 0, 0
5479, 1, 1636425298985, 1636425299429, 444, 0, 444, 0, 0, 0
5480, 1, 1636425299032, 1636425299472, 440, 1, 439, 0, 0, 0
5481, 1, 1636425299429, 1636425299877, 448, 0, 448, 0, 0, 0
5482, 1, 1636425299460, 1636425299912, 452, 0, 452, 0, 0, 0
5483, 1, 1636425299536, 1636425299989, 453, 0, 453, 0, 0, 0
5484, 1, 1636425299652, 1636425300093, 441, 0, 441, 0, 0, 0
5486, 1, 1636425299928, 1636425300373, 445, 1, 444, 1, 0, 1
5485, 1, 1636425299725, 1636425300433, 708, 264, 444, 264, 0, 264
5487, 1, 1636425300149, 1636425300601, 452, 0, 452, 0, 0, 0
5488, 1, 1636425300569, 1636425301021, 452, 0, 452, 0, 0, 0
5489, 1, 1636425300829, 1636425301281, 452, 0, 452, 0, 0, 0
5490, 1, 1636425301328, 1636425301785, 457, 1, 456, 1, 0, 1
5492, 1, 1636425301401, 1636425301849, 448, 0, 448, 0, 0, 0
5493, 1, 1636425301605, 1636425302061, 456, 0, 456, 0, 0, 0
5494, 1, 1636425301733, 1636425302184, 451, 0, 451, 0, 0, 0
5491, 1, 1636425301397, 1636425302225, 828, 388, 440, 388, 0, 388
5495, 1, 1636425301816, 1636425302261, 445, 1, 444, 0, 0, 0
5496, 1, 1636425302133, 1636425302585, 452, 0, 452, 0, 0, 0
5497, 1, 1636425302528, 1636425302981, 453, 1, 452, 0, 0, 0
5498, 1, 1636425302557, 1636425303009, 452, 0, 452, 0, 0, 0
5499, 1, 1636425302801, 1636425303257, 456, 0, 456, 0, 0, 0
5500, 1, 1636425302873, 1636425303316, 443, 0, 443, 0, 0, 0
5502, 1, 1636425303257, 1636425303709, 452, 0, 452, 0, 0, 0
5501, 1, 1636425303244, 1636425303709, 465, 13, 452, 13, 0, 13
5503, 1, 1636425303724, 1636425304177, 453, 0, 453, 0, 0, 0
5504, 1, 1636425303745, 1636425304197, 452, 0, 452, 0, 0, 0
5505, 1, 1636425303780, 1636425304232, 452, 1, 451, 1, 0, 1
5507, 1, 1636425304172, 1636425304625, 453, 1, 452, 0, 0, 0
5506, 1, 1636425303909, 1636425304629, 720, 268, 452, 268, 0, 268
5508, 1, 1636425304644, 1636425305096, 452, 1, 451, 0, 0, 0
5509, 1, 1636425304713, 1636425305161, 448, 0, 448, 0, 0, 0
5510, 1, 1636425305217, 1636425305668, 451, 0, 451, 0, 0, 0
5511, 1, 1636425305361, 1636425305809, 448, 0, 448, 0, 0, 0
5513, 1, 1636425305589, 1636425306033, 444, 0, 444, 0, 0, 0
5514, 1, 1636425305624, 1636425306084, 460, 0, 460, 0, 0, 0
5512, 1, 1636425305501, 1636425306265, 764, 308, 456, 308, 0, 308
5515, 1, 1636425305929, 1636425306489, 560, 104, 456, 104, 0, 104
5516, 1, 1636425306097, 1636425306549, 452, 0, 452, 0, 0, 0
5517, 1, 1636425306304, 1636425306757, 453, 1, 452, 0, 0, 0
5518, 1, 1636425306581, 1636425307033, 452, 0, 452, 0, 0, 0
5519, 1, 1636425306773, 1636425307225, 452, 0, 452, 0, 0, 0
5520, 1, 1636425306784, 1636425307240, 456, 0, 456, 0, 0, 0
5521, 1, 1636425306920, 1636425307689, 769, 321, 448, 320, 0, 320
5522, 1, 1636425307401, 1636425307852, 451, 0, 451, 0, 0, 0
5524, 1, 1636425307560, 1636425308013, 453, 1, 452, 1, 0, 1
5523, 1, 1636425307540, 1636425308145, 605, 150, 455, 148, 0, 148
5525, 1, 1636425307785, 1636425308237, 452, 0, 452, 0, 0, 0
5526, 1, 1636425307977, 1636425308693, 716, 261, 455, 260, 0, 260
5527, 1, 1636425308445, 1636425308897, 452, 0, 452, 0, 0, 0
5528, 1, 1636425308472, 1636425308925, 453, 1, 452, 0, 0, 0
5529, 1, 1636425309013, 1636425309465, 452, 0, 452, 0, 0, 0
5530, 1, 1636425309073, 1636425309529, 456, 0, 456, 0, 0, 0
5531, 1, 1636425309197, 1636425309645, 448, 0, 448, 0, 0, 0
5533, 1, 1636425309489, 1636425309941, 452, 0, 452, 0, 0, 0
5532, 1, 1636425309212, 1636425310097, 885, 433, 452, 432, 0, 432
5534, 1, 1636425309728, 1636425310177, 449, 1, 448, 0, 0, 0
5535, 1, 1636425310061, 1636425310513, 452, 0, 452, 0, 0, 0
5536, 1, 1636425310249, 1636425310704, 455, 0, 455, 0, 0, 0
5537, 1, 1636425310264, 1636425310716, 452, 1, 451, 1, 0, 1
5538, 1, 1636425310353, 1636425310800, 447, 0, 447, 0, 0, 0
5539, 1, 1636425310552, 1636425311013, 461, 1, 460, 0, 1, 1
5540, 1, 1636425310856, 1636425311313, 457, 1, 456, 0, 0, 0
5541, 1, 1636425310989, 1636425311761, 772, 324, 448, 324, 0, 324
5542, 1, 1636425311313, 1636425311764, 451, 0, 451, 0, 0, 0
5543, 1, 1636425311332, 1636425311789, 457, 0, 457, 0, 0, 0
5544, 1, 1636425311737, 1636425312213, 476, 24, 452, 24, 0, 24
5545, 1, 1636425311909, 1636425312361, 452, 0, 452, 0, 0, 0
5546, 1, 1636425312181, 1636425312817, 636, 180, 456, 180, 0, 180
5547, 1, 1636425312504, 1636425312961, 457, 1, 456, 0, 0, 0
5548, 1, 1636425312785, 1636425313232, 447, 0, 447, 0, 0, 0
5549, 1, 1636425313057, 1636425313513, 456, 0, 456, 0, 0, 0
5551, 1, 1636425313161, 1636425313609, 448, 0, 448, 0, 0, 0
5552, 1, 1636425313188, 1636425313636, 448, 1, 447, 0, 0, 0
5550, 1, 1636425313069, 1636425313969, 900, 445, 455, 444, 1, 445
5553, 1, 1636425313660, 1636425314117, 457, 1, 456, 0, 0, 0
5554, 1, 1636425313729, 1636425314181, 452, 0, 452, 0, 0, 0
5556, 1, 1636425314145, 1636425314593, 448, 0, 448, 0, 0, 0
5557, 1, 1636425314293, 1636425314744, 451, 0, 451, 0, 0, 0
5558, 1, 1636425314413, 1636425314860, 447, 0, 447, 0, 0, 0
5559, 1, 1636425314497, 1636425314949, 452, 0, 452, 0, 0, 0
5560, 1, 1636425314700, 1636425315149, 449, 0, 449, 0, 0, 0
5562, 1, 1636425315016, 1636425315460, 444, 1, 443, 0, 1, 1
5561, 1, 1636425314752, 1636425315593, 841, 397, 444, 397, 0, 397
5564, 1, 1636425315553, 1636425316004, 451, 0, 451, 0, 0, 0
5563, 1, 1636425315453, 1636425316049, 596, 141, 455, 140, 1, 141
5565, 1, 1636425315672, 1636425316125, 453, 1, 452, 0, 0, 0
5566, 1, 1636425315885, 1636425316577, 692, 240, 452, 240, 0, 240
5567, 1, 1636425316409, 1636425316853, 444, 0, 444, 0, 0, 0
5568, 1, 1636425316753, 1636425317193, 440, 0, 440, 0, 0, 0
5569, 1, 1636425317041, 1636425317489, 448, 0, 448, 0, 0, 0
5570, 1, 1636425317089, 1636425317545, 456, 0, 456, 0, 0, 0
5571, 1, 1636425317156, 1636425317609, 453, 1, 452, 0, 0, 0
5573, 1, 1636425317341, 1636425317941, 600, 148, 452, 148, 0, 148
5572, 1, 1636425317168, 1636425318061, 893, 442, 451, 440, 0, 440
5575, 1, 1636425317844, 1636425318297, 453, 0, 453, 0, 0, 0
5574, 1, 1636425317812, 1636425318397, 585, 130, 455, 129, 0, 129
5577, 1, 1636425318368, 1636425318816, 448, 0, 448, 0, 0, 0
5576, 1, 1636425318365, 1636425318849, 484, 32, 452, 32, 0, 32
5578, 1, 1636425318412, 1636425318861, 449, 1, 448, 0, 0, 0
5580, 1, 1636425318661, 1636425319301, 640, 188, 452, 188, 0, 188
5579, 1, 1636425318653, 1636425319313, 660, 208, 452, 208, 0, 208
5582, 1, 1636425319392, 1636425319845, 453, 1, 452, 0, 1, 1
5583, 1, 1636425319668, 1636425320121, 453, 1, 452, 0, 1, 1
5584, 1, 1636425319852, 1636425320305, 453, 1, 452, 0, 0, 0
5586, 1, 1636425320073, 1636425320524, 451, 0, 451, 0, 0, 0
5585, 1, 1636425319949, 1636425320757, 808, 356, 452, 356, 0, 356
5587, 1, 1636425320505, 1636425320957, 452, 0, 452, 0, 0, 0
5588, 1, 1636425320769, 1636425321221, 452, 0, 452, 0, 0, 0
5589, 1, 1636425321349, 1636425321801, 452, 0, 452, 0, 0, 0
5591, 1, 1636425321400, 1636425322257, 857, 402, 455, 400, 0, 400
5594, 1, 1636425322141, 1636425322593, 452, 0, 452, 0, 0, 0
5595, 1, 1636425322337, 1636425322789, 452, 0, 452, 0, 0, 0
5598, 1, 1636425322705, 1636425323157, 452, 0, 452, 0, 0, 0
5599, 1, 1636425322909, 1636425323361, 452, 0, 452, 0, 0, 0
5555, 2, 1636425314057, 1636425324056, 9999, 0, 9999, 0, 0, 0
5601, 1, 1636425323961, 1636425324412, 451, 0, 451, 0, 0, 0
5604, 1, 1636425324149, 1636425324601, 452, 0, 452, 0, 0, 0
5605, 1, 1636425324361, 1636425324813, 452, 0, 452, 0, 0, 0
5606, 1, 1636425324569, 1636425325025, 456, 0, 456, 0, 0, 0
5602, 1, 1636425324148, 1636425325057, 909, 452, 457, 452, 0, 452
5608, 1, 1636425325105, 1636425325557, 452, 0, 452, 0, 0, 0
5609, 1, 1636425325380, 1636425326013, 633, 177, 456, 176, 0, 176
5610, 1, 1636425326005, 1636425326457, 452, 0, 452, 0, 0, 0
5611, 1, 1636425326277, 1636425326729, 452, 0, 452, 0, 0, 0
5612, 1, 1636425326473, 1636425326925, 452, 0, 452, 0, 0, 0
5613, 1, 1636425327201, 1636425327653, 452, 0, 452, 0, 0, 0
5614, 1, 1636425327728, 1636425328185, 457, 1, 456, 0, 0, 0
5615, 1, 1636425328313, 1636425328769, 456, 0, 456, 0, 0, 0
5617, 1, 1636425328521, 1636425328973, 452, 0, 452, 0, 0, 0
5581, 2, 1636425319124, 1636425329125, 10001, 0, 10001, 0, 0, 0
5618, 1, 1636425328741, 1636425329193, 452, 0, 452, 0, 0, 0
5616, 1, 1636425328429, 1636425329225, 796, 341, 455, 340, 1, 341
5619, 1, 1636425329333, 1636425329785, 452, 0, 452, 0, 0, 0
5620, 1, 1636425329433, 1636425329885, 452, 0, 452, 0, 0, 0
5621, 1, 1636425329689, 1636425330241, 552, 97, 455, 96, 1, 97
5622, 1, 1636425330225, 1636425330681, 456, 0, 456, 0, 0, 0
5623, 1, 1636425330389, 1636425330841, 452, 0, 452, 0, 0, 0
5624, 1, 1636425330665, 1636425331133, 468, 16, 452, 16, 0, 16
5590, 2, 1636425321384, 1636425331385, 10001, 0, 10001, 0, 0, 0
5625, 1, 1636425330968, 1636425331425, 457, 1, 456, 1, 0, 1
5592, 2, 1636425321429, 1636425331428, 9999, 0, 9999, 0, 0, 0
5593, 2, 1636425321913, 1636425331913, 10000, 0, 10000, 0, 0, 0
5626, 1, 1636425331697, 1636425332149, 452, 0, 452, 0, 0, 0
5628, 1, 1636425331956, 1636425332409, 453, 1, 452, 0, 0, 0
5596, 2, 1636425322441, 1636425332441, 10000, 0, 10000, 0, 0, 0
5627, 1, 1636425331737, 1636425332600, 863, 412, 451, 412, 0, 412
5597, 2, 1636425322685, 1636425332684, 9999, 0, 9999, 0, 0, 0
5630, 1, 1636425332640, 1636425333096, 456, 0, 456, 0, 0, 0
5629, 1, 1636425332216, 1636425333096, 880, 385, 495, 385, 0, 385
5632, 1, 1636425332732, 1636425333181, 449, 1, 448, 0, 1, 1
5634, 1, 1636425332896, 1636425333349, 453, 0, 453, 0, 0, 0
5600, 2, 1636425323445, 1636425333444, 9999, 0, 9999, 0, 0, 0
5631, 1, 1636425332732, 1636425333545, 813, 365, 448, 365, 0, 365
5636, 1, 1636425333249, 1636425333701, 452, 0, 452, 0, 0, 0
5637, 1, 1636425333585, 1636425334041, 456, 0, 456, 0, 0, 0
5603, 2, 1636425324152, 1636425334153, 10001, 0, 10001, 0, 0, 0
5639, 1, 1636425333769, 1636425334488, 719, 272, 447, 272, 0, 272
5640, 1, 1636425334288, 1636425334741, 453, 0, 453, 0, 0, 0
5607, 2, 1636425324880, 1636425334880, 10000, 0, 10000, 0, 0, 0
5642, 1, 1636425334668, 1636425335124, 456, 1, 455, 0, 0, 0
5643, 1, 1636425334924, 1636425335376, 452, 0, 452, 0, 0, 0
5645, 1, 1636425335161, 1636425335613, 452, 0, 452, 0, 0, 0
5646, 1, 1636425335376, 1636425335833, 457, 1, 456, 0, 1, 1
5647, 1, 1636425335456, 1636425336297, 841, 378, 463, 378, 0, 378
5648, 1, 1636425335997, 1636425336453, 456, 0, 456, 0, 0, 0
5649, 1, 1636425336004, 1636425336745, 741, 294, 447, 293, 0, 293
5650, 1, 1636425336381, 1636425336821, 440, 0, 440, 0, 0, 0
5651, 1, 1636425336569, 1636425337025, 456, 0, 456, 0, 0, 0
5652, 1, 1636425336569, 1636425337025, 456, 0, 456, 0, 0, 0
5654, 1, 1636425336929, 1636425337380, 451, 0, 451, 0, 0, 0
5653, 1, 1636425336580, 1636425337481, 901, 446, 455, 446, 0, 446
5655, 1, 1636425337229, 1636425337681, 452, 0, 452, 0, 0, 0
5656, 1, 1636425337573, 1636425338137, 564, 109, 455, 108, 1, 109
5657, 1, 1636425338413, 1636425338869, 456, 0, 456, 0, 0, 0
5658, 1, 1636425338936, 1636425339393, 457, 0, 457, 0, 0, 0
5659, 1, 1636425339053, 1636425339496, 443, 0, 443, 0, 0, 0
5660, 1, 1636425339125, 1636425339577, 452, 0, 452, 0, 0, 0
5661, 1, 1636425339192, 1636425339637, 445, 1, 444, 0, 0, 0
5662, 1, 1636425339341, 1636425340029, 688, 236, 452, 236, 0, 236
5663, 1, 1636425339929, 1636425340481, 552, 101, 451, 100, 0, 100
5664, 1, 1636425340108, 1636425340561, 453, 0, 453, 0, 0, 0
5665, 1, 1636425340120, 1636425340581, 461, 0, 461, 0, 0, 0
5666, 1, 1636425340401, 1636425340856, 455, 0, 455, 0, 0, 0
5667, 1, 1636425340628, 1636425341081, 453, 1, 452, 0, 0, 0
5669, 1, 1636425340933, 1636425341380, 447, 0, 447, 0, 0, 0
5670, 1, 1636425340984, 1636425341437, 453, 1, 452, 0, 0, 0
5668, 1, 1636425340729, 1636425341541, 812, 353, 459, 352, 0, 352
5671, 1, 1636425341281, 1636425341889, 608, 156, 452, 156, 0, 156
5672, 1, 1636425342093, 1636425342545, 452, 0, 452, 0, 0, 0
5633, 2, 1636425332776, 1636425342776, 10000, 0, 10000, 321, 0, 321
5635, 2, 1636425332992, 1636425342993, 10001, 0, 10001, 104, 0, 104
5674, 1, 1636425342821, 1636425343308, 487, 0, 487, 0, 0, 0
5675, 1, 1636425343128, 1636425343572, 444, 0, 444, 0, 0, 0
5676, 1, 1636425343244, 1636425343692, 448, 0, 448, 0, 0, 0
5638, 2, 1636425333753, 1636425343752, 9999, 0, 9999, 0, 0, 0
5677, 1, 1636425343409, 1636425343856, 447, 0, 447, 0, 0, 0
5679, 1, 1636425343648, 1636425344101, 453, 0, 453, 0, 0, 0
5680, 1, 1636425343844, 1636425344292, 448, 0, 448, 0, 0, 0
5678, 1, 1636425343409, 1636425344312, 903, 448, 455, 448, 0, 448
5641, 2, 1636425334452, 1636425344453, 10001, 0, 10001, 0, 0, 0
5683, 1, 1636425344085, 1636425344536, 451, 0, 451, 0, 0, 0
5681, 1, 1636425344008, 1636425344544, 536, 93, 443, 93, 0, 93
5682, 1, 1636425344065, 1636425344772, 707, 248, 459, 248, 0, 248
5684, 1, 1636425344348, 1636425344796, 448, 1, 447, 0, 0, 0
5644, 1, 1636425335189, 1636425344905, 9716, 9264, 452, 0, 9264, 9264
5686, 1, 1636425344740, 1636425345192, 452, 1, 451, 0, 0, 0
5685, 1, 1636425344752, 1636425345220, 468, 21, 447, 21, 0, 21
5687, 1, 1636425344840, 1636425345293, 453, 1, 452, 0, 0, 0
5688, 1, 1636425344865, 1636425345640, 775, 328, 447, 328, 0, 328
5690, 1, 1636425345220, 1636425345673, 453, 0, 453, 0, 0, 0
5689, 1, 1636425345129, 1636425345673, 544, 92, 452, 92, 0, 92
5691, 1, 1636425345293, 1636425346133, 840, 381, 459, 380, 0, 380
5692, 1, 1636425346277, 1636425346729, 452, 0, 452, 0, 0, 0
5693, 1, 1636425346948, 1636425347401, 453, 0, 453, 0, 0, 0
5694, 1, 1636425346976, 1636425347424, 448, 0, 448, 0, 0, 0
5695, 1, 1636425347045, 1636425347501, 456, 0, 456, 0, 0, 0
5696, 1, 1636425347192, 1636425347645, 453, 1, 452, 0, 0, 0
5698, 1, 1636425347561, 1636425348013, 452, 0, 452, 0, 0, 0
5697, 1, 1636425347312, 1636425348096, 784, 333, 451, 333, 0, 333
5700, 1, 1636425347945, 1636425348393, 448, 0, 448, 0, 0, 0
5699, 1, 1636425347713, 1636425348460, 747, 301, 446, 300, 0, 300
5702, 1, 1636425348052, 1636425348504, 452, 0, 452, 0, 0, 0
5701, 1, 1636425347957, 1636425348545, 588, 140, 448, 140, 0, 140
5703, 1, 1636425348464, 1636425348917, 453, 0, 453, 0, 0, 0
5704, 1, 1636425348504, 1636425349000, 496, 42, 454, 41, 1, 42
5705, 1, 1636425348809, 1636425349265, 456, 0, 456, 0, 0, 0
5706, 1, 1636425349004, 1636425349457, 453, 1, 452, 0, 0, 0
5707, 1, 1636425349061, 1636425349513, 452, 0, 452, 0, 0, 0
5709, 1, 1636425349337, 1636425349792, 455, 0, 455, 0, 0, 0
5708, 1, 1636425349072, 1636425349969, 897, 440, 457, 440, 0, 440
5710, 1, 1636425349436, 1636425350245, 809, 357, 452, 357, 0, 357
5711, 1, 1636425350528, 1636425350984, 456, 1, 455, 1, 0, 1
5712, 1, 1636425350909, 1636425351356, 447, 0, 447, 0, 0, 0
5713, 1, 1636425351013, 1636425351468, 455, 0, 455, 0, 0, 0
5714, 1, 1636425351033, 1636425351476, 443, 0, 443, 0, 0, 0
5715, 1, 1636425351196, 1636425351805, 609, 161, 448, 161, 0, 161
5716, 1, 1636425351265, 1636425351925, 660, 204, 456, 204, 0, 204
5717, 1, 1636425351476, 1636425351925, 449, 1, 448, 1, 0, 1
5719, 1, 1636425351848, 1636425352301, 453, 1, 452, 0, 0, 0
5718, 1, 1636425351476, 1636425352377, 901, 450, 451, 450, 0, 450
5720, 1, 1636425352217, 1636425352664, 447, 0, 447, 0, 0, 0
5673, 2, 1636425342693, 1636425352692, 9999, 0, 9999, 0, 0, 0
5721, 1, 1636425352301, 1636425352752, 451, 0, 451, 0, 0, 0
5722, 1, 1636425352384, 1636425352832, 448, 1, 447, 0, 0, 0
5724, 1, 1636425352740, 1636425353188, 448, 1, 447, 0, 1, 1
5726, 1, 1636425352784, 1636425353232, 448, 1, 447, 0, 0, 0
5725, 1, 1636425352784, 1636425353232, 448, 1, 447, 0, 1, 1
5723, 1, 1636425352740, 1636425353276, 536, 93, 443, 93, 0, 93
5728, 1, 1636425353004, 1636425353457, 453, 0, 453, 0, 0, 0
5727, 1, 1636425352828, 1636425353637, 809, 361, 448, 361, 0, 361
5729, 1, 1636425353520, 1636425353973, 453, 1, 452, 0, 0, 0
5730, 1, 1636425353660, 1636425354421, 761, 313, 448, 313, 0, 313
5731, 1, 1636425354821, 1636425355281, 460, 0, 460, 0, 0, 0
5732, 1, 1636425354925, 1636425355380, 455, 0, 455, 0, 0, 0
5733, 1, 1636425355205, 1636425355649, 444, 0, 444, 0, 0, 0
5734, 1, 1636425355265, 1636425355717, 452, 0, 452, 0, 0, 0
5736, 1, 1636425355416, 1636425355865, 449, 0, 449, 0, 0, 0
5738, 1, 1636425355437, 1636425355888, 451, 0, 451, 0, 0, 0
5735, 1, 1636425355272, 1636425356101, 829, 377, 452, 376, 0, 376
5737, 1, 1636425355437, 1636425356313, 876, 428, 448, 428, 0, 428
5739, 1, 1636425356129, 1636425356581, 452, 0, 452, 0, 0, 0
5740, 1, 1636425356153, 1636425356600, 447, 0, 447, 0, 0, 0
5741, 1, 1636425356389, 1636425356840, 451, 0, 451, 0, 0, 0
5742, 1, 1636425356517, 1636425356973, 456, 0, 456, 0, 0, 0
5743, 1, 1636425356633, 1636425357084, 451, 0, 451, 0, 0, 0
5744, 1, 1636425356685, 1636425357128, 443, 0, 443, 0, 0, 0
5747, 1, 1636425356908, 1636425357365, 457, 1, 456, 1, 0, 1
5745, 1, 1636425356732, 1636425357528, 796, 353, 443, 353, 0, 353
5746, 1, 1636425356777, 1636425357573, 796, 352, 444, 352, 0, 352
5748, 1, 1636425357153, 1636425357601, 448, 0, 448, 0, 0, 0
5749, 1, 1636425357289, 1636425357741, 452, 0, 452, 0, 0, 0
5750, 1, 1636425357509, 1636425358193, 684, 232, 452, 232, 0, 232
5751, 1, 1636425359136, 1636425359580, 444, 1, 443, 1, 0, 1
5752, 1, 1636425359149, 1636425359596, 447, 0, 447, 0, 0, 0
5753, 1, 1636425359301, 1636425359753, 452, 0, 452, 0, 0, 0
5755, 1, 1636425359348, 1636425359804, 456, 1, 455, 1, 0, 1
5756, 1, 1636425359532, 1636425360041, 509, 49, 460, 49, 0, 49
5758, 1, 1636425359753, 1636425360200, 447, 0, 447, 0, 0, 0
5754, 1, 1636425359341, 1636425360200, 859, 413, 446, 412, 0, 412
5759, 1, 1636425359921, 1636425360377, 456, 0, 456, 0, 0, 0
5757, 1, 1636425359617, 1636425360488, 871, 424, 447, 424, 0, 424
5760, 1, 1636425360309, 1636425360765, 456, 0, 456, 0, 0, 0
5761, 1, 1636425360532, 1636425360985, 453, 1, 452, 0, 0, 0
5763, 1, 1636425360708, 1636425361161, 453, 1, 452, 0, 1, 1
5764, 1, 1636425360725, 1636425361177, 452, 0, 452, 0, 0, 0
5765, 1, 1636425360777, 1636425361225, 448, 0, 448, 0, 0, 0
5766, 1, 1636425360925, 1636425361380, 455, 0, 455, 0, 0, 0
5762, 1, 1636425360633, 1636425361433, 800, 352, 448, 352, 0, 352
5767, 1, 1636425361044, 1636425361673, 629, 181, 448, 181, 0, 181
5768, 1, 1636425361364, 1636425361812, 448, 1, 447, 0, 0, 0
5769, 1, 1636425361508, 1636425361960, 452, 0, 452, 0, 0, 0
5770, 1, 1636425361616, 1636425362413, 797, 345, 452, 345, 0, 345
5771, 1, 1636425363089, 1636425363540, 451, 0, 451, 0, 0, 0
5772, 1, 1636425363413, 1636425363861, 448, 0, 448, 0, 0, 0
5773, 1, 1636425363513, 1636425363965, 452, 0, 452, 0, 0, 0
5776, 1, 1636425363681, 1636425364137, 456, 0, 456, 0, 0, 0
5777, 1, 1636425363688, 1636425364149, 461, 0, 461, 0, 0, 0
5778, 1, 1636425363840, 1636425364293, 453, 1, 452, 0, 0, 0
5774, 1, 1636425363552, 1636425364316, 764, 309, 455, 309, 0, 309
5775, 1, 1636425363584, 1636425364412, 828, 382, 446, 381, 0, 381
5779, 1, 1636425364069, 1636425364773, 704, 248, 456, 248, 0, 248
5781, 1, 1636425364396, 1636425364845, 449, 0, 449, 0, 0, 0
5780, 1, 1636425364340, 1636425364869, 529, 73, 456, 73, 0, 73
5783, 1, 1636425364665, 1636425365117, 452, 0, 452, 0, 0, 0
5784, 1, 1636425364769, 1636425365221, 452, 0, 452, 0, 0, 0
5782, 1, 1636425364625, 1636425365301, 676, 220, 456, 220, 0, 220
5785, 1, 1636425365061, 1636425365513, 452, 0, 452, 0, 0, 0
5787, 1, 1636425365192, 1636425365649, 457, 1, 456, 0, 0, 0
5788, 1, 1636425365260, 1636425365717, 457, 1, 456, 1, 0, 1
5786, 1, 1636425365092, 1636425365969, 877, 422, 455, 420, 0, 420
5789, 1, 1636425365569, 1636425366017, 448, 0, 448, 0, 0, 0
5790, 1, 1636425365865, 1636425366469, 604, 152, 452, 152, 0, 152
5791, 1, 1636425367285, 1636425367737, 452, 0, 452, 0, 0, 0
5792, 1, 1636425367397, 1636425367841, 444, 0, 444, 0, 0, 0
5795, 1, 1636425367564, 1636425368016, 452, 0, 452, 0, 0, 0
5796, 1, 1636425367621, 1636425368068, 447, 0, 447, 0, 0, 0
5793, 1, 1636425367424, 1636425368185, 761, 313, 448, 313, 0, 313
5798, 1, 1636425367796, 1636425368293, 497, 46, 451, 45, 0, 45
5799, 1, 1636425368016, 1636425368637, 621, 169, 452, 169, 0, 169
5794, 1, 1636425367428, 1636425368749, 1321, 866, 455, 865, 1, 866
5801, 1, 1636425368533, 1636425368985, 452, 0, 452, 0, 0, 0
5804, 1, 1636425368893, 1636425369345, 452, 0, 452, 0, 0, 0
5805, 1, 1636425368901, 1636425369356, 455, 0, 455, 0, 0, 0
5802, 1, 1636425368649, 1636425369437, 788, 337, 451, 336, 0, 336
5808, 1, 1636425369124, 1636425369577, 453, 1, 452, 0, 0, 0
5806, 1, 1636425368909, 1636425369817, 908, 448, 460, 448, 0, 448
5809, 1, 1636425369620, 1636425370073, 453, 1, 452, 0, 0, 0
5810, 1, 1636425369884, 1636425370524, 640, 189, 451, 188, 0, 188
5811, 1, 1636425371141, 1636425371592, 451, 0, 451, 0, 0, 0
5812, 1, 1636425371197, 1636425372036, 839, 396, 443, 396, 0, 396
5814, 1, 1636425371588, 1636425372040, 452, 0, 452, 0, 0, 0
5815, 1, 1636425371632, 1636425372080, 448, 1, 447, 0, 0, 0
5818, 1, 1636425372013, 1636425372493, 480, 24, 456, 24, 0, 24
5819, 1, 1636425372233, 1636425372689, 456, 0, 456, 0, 0, 0
5821, 1, 1636425372637, 1636425373089, 452, 0, 452, 0, 0, 0
5822, 1, 1636425372661, 1636425373113, 452, 0, 452, 0, 0, 0
5820, 1, 1636425372477, 1636425373136, 659, 212, 447, 212, 0, 212
5823, 1, 1636425372837, 1636425373541, 704, 252, 452, 252, 0, 252
5824, 1, 1636425373361, 1636425373813, 452, 0, 452, 0, 0, 0
5825, 1, 1636425373385, 1636425373833, 448, 0, 448, 0, 0, 0
5826, 1, 1636425373685, 1636425374293, 608, 148, 460, 148, 0, 148
5827, 1, 1636425375149, 1636425375601, 452, 0, 452, 0, 0, 0
5829, 1, 1636425375409, 1636425375861, 452, 0, 452, 0, 0, 0
5828, 1, 1636425375345, 1636425376053, 708, 257, 451, 256, 0, 256
5830, 1, 1636425375965, 1636425376421, 456, 0, 456, 0, 0, 0
5831, 1, 1636425376033, 1636425376485, 452, 0, 452, 0, 0, 0
5832, 1, 1636425376340, 1636425376793, 453, 1, 452, 0, 0, 0
5833, 1, 1636425376352, 1636425376937, 585, 133, 452, 132, 0, 132
5835, 1, 1636425376720, 1636425377177, 457, 1, 456, 0, 0, 0
5834, 1, 1636425376645, 1636425377253, 608, 148, 460, 148, 0, 148
5836, 1, 1636425376853, 1636425377704, 851, 400, 451, 400, 0, 400
5797, 2, 1636425367749, 1636425377749, 10000, 0, 10000, 1000, 0, 1000
5837, 1, 1636425377401, 1636425377861, 460, 0, 460, 0, 0, 0
5838, 1, 1636425377561, 1636425378017, 456, 0, 456, 0, 0, 0
5839, 1, 1636425377948, 1636425378477, 529, 70, 459, 68, 1, 69
5800, 2, 1636425368481, 1636425378481, 10000, 0, 10000, 268, 0, 268
5803, 2, 1636425368721, 1636425378721, 10000, 0, 10000, 28, 0, 28
5807, 2, 1636425368948, 1636425378948, 10000, 0, 10000, 0, 0, 0
5817, 1, 1636425371929, 1636425379177, 7248, 6792, 456, 0, 6792, 6792
5842, 1, 1636425379056, 1636425379508, 452, 0, 452, 0, 0, 0
5840, 1, 1636425379065, 1636425379517, 452, 0, 452, 0, 0, 0
5843, 1, 1636425379261, 1636425379705, 444, 0, 444, 0, 0, 0
5845, 1, 1636425379389, 1636425379845, 456, 0, 456, 0, 0, 0
5846, 1, 1636425379404, 1636425379968, 564, 113, 451, 113, 0, 113
5848, 1, 1636425379945, 1636425380397, 452, 0, 452, 0, 0, 0
5847, 1, 1636425379573, 1636425380425, 852, 396, 456, 396, 0, 396
5849, 1, 1636425380065, 1636425380517, 452, 0, 452, 0, 0, 0
5850, 1, 1636425380545, 1636425380993, 448, 0, 448, 0, 0, 0
5851, 1, 1636425380596, 1636425381036, 440, 1, 439, 0, 0, 0
5813, 2, 1636425371249, 1636425381249, 10000, 0, 10000, 0, 0, 0
5854, 1, 1636425380977, 1636425381473, 496, 0, 496, 0, 0, 0
5853, 1, 1636425380932, 1636425381493, 561, 105, 456, 105, 0, 105
5816, 2, 1636425371636, 1636425381636, 10000, 0, 10000, 0, 0, 0
5852, 1, 1636425380889, 1636425381956, 1067, 604, 463, 604, 0, 604
5855, 1, 1636425381556, 1636425382041, 485, 1, 484, 0, 1, 1
5856, 1, 1636425381728, 1636425382173, 445, 0, 445, 0, 0, 0
5857, 1, 1636425381816, 1636425382269, 453, 0, 453, 0, 0, 0
5858, 1, 1636425381940, 1636425382489, 549, 101, 448, 100, 0, 100
5859, 1, 1636425382056, 1636425382717, 661, 213, 448, 212, 0, 212
5860, 1, 1636425383089, 1636425383545, 456, 0, 456, 0, 0, 0
5861, 1, 1636425383164, 1636425383616, 452, 0, 452, 0, 0, 0
5864, 1, 1636425383457, 1636425383913, 456, 0, 456, 0, 0, 0
5865, 1, 1636425383497, 1636425383948, 451, 0, 451, 0, 0, 0
5866, 1, 1636425383840, 1636425384293, 453, 1, 452, 0, 1, 1
5867, 1, 1636425383865, 1636425384321, 456, 0, 456, 0, 0, 0
5869, 1, 1636425384384, 1636425384837, 453, 1, 452, 0, 0, 0
5872, 1, 1636425385101, 1636425385549, 448, 0, 448, 0, 0, 0
5873, 1, 1636425385488, 1636425385937, 449, 1, 448, 1, 0, 1
5874, 1, 1636425385620, 1636425386077, 457, 1, 456, 0, 0, 0
5875, 1, 1636425385900, 1636425386349, 449, 1, 448, 1, 0, 1
5876, 1, 1636425386036, 1636425386533, 497, 42, 455, 41, 0, 41
5877, 1, 1636425386245, 1636425386800, 555, 104, 451, 104, 0, 104
5878, 1, 1636425386900, 1636425387353, 453, 1, 452, 0, 0, 0
5879, 1, 1636425387356, 1636425387809, 453, 1, 452, 0, 0, 0
5880, 1, 1636425387421, 1636425387873, 452, 0, 452, 0, 0, 0
5881, 1, 1636425387697, 1636425388149, 452, 0, 452, 0, 0, 0
5882, 1, 1636425387708, 1636425388160, 452, 1, 451, 0, 1, 1
5883, 1, 1636425387841, 1636425388285, 444, 0, 444, 0, 0, 0
5884, 1, 1636425388209, 1636425388665, 456, 0, 456, 0, 0, 0
5841, 2, 1636425379065, 1636425389065, 10000, 0, 10000, 444, 0, 444
5844, 2, 1636425379400, 1636425389400, 10000, 0, 10000, 108, 0, 108
5885, 1, 1636425389444, 1636425389893, 449, 1, 448, 0, 0, 0
5887, 1, 1636425389705, 1636425390157, 452, 0, 452, 0, 0, 0
5886, 1, 1636425389708, 1636425390161, 453, 1, 452, 0, 0, 0
5889, 1, 1636425389804, 1636425390256, 452, 0, 452, 0, 0, 0
5888, 1, 1636425389816, 1636425390613, 797, 345, 452, 345, 0, 345
5890, 1, 1636425390212, 1636425390656, 444, 1, 443, 0, 0, 0
5891, 1, 1636425390341, 1636425390789, 448, 0, 448, 0, 0, 0
5892, 1, 1636425390480, 1636425391109, 629, 177, 452, 177, 0, 177
5893, 1, 1636425390721, 1636425391180, 459, 0, 459, 0, 0, 0
5894, 1, 1636425391021, 1636425391477, 456, 0, 456, 0, 0, 0
5895, 1, 1636425391605, 1636425392053, 448, 0, 448, 0, 0, 0
5896, 1, 1636425391693, 1636425392153, 460, 0, 460, 0, 0, 0
5897, 1, 1636425391705, 1636425392153, 448, 0, 448, 0, 0, 0
5898, 1, 1636425391845, 1636425392284, 439, 0, 439, 0, 0, 0
5899, 1, 1636425391896, 1636425392601, 705, 257, 448, 256, 0, 256
5862, 2, 1636425383321, 1636425393321, 10000, 0, 10000, 224, 0, 224
5863, 2, 1636425383389, 1636425393388, 9999, 0, 9999, 156, 0, 156
5900, 1, 1636425393265, 1636425393732, 467, 0, 467, 0, 0, 0
5901, 1, 1636425393688, 1636425394140, 452, 0, 452, 0, 0, 0
5902, 1, 1636425393704, 1636425394153, 449, 0, 449, 0, 0, 0
5903, 1, 1636425393740, 1636425394184, 444, 0, 444, 0, 0, 0
5868, 2, 1636425384293, 1636425394280, 9987, 0, 9987, 0, 0, 0
5904, 1, 1636425393856, 1636425394309, 453, 1, 452, 0, 0, 0
5906, 1, 1636425393888, 1636425394600, 712, 253, 459, 252, 0, 252
5907, 1, 1636425394148, 1636425394600, 452, 0, 452, 0, 0, 0
5909, 1, 1636425394236, 1636425394688, 452, 0, 452, 0, 0, 0
5905, 1, 1636425393864, 1636425394761, 897, 445, 452, 445, 0, 445
5870, 2, 1636425384833, 1636425394833, 10000, 0, 10000, 0, 0, 0
5871, 2, 1636425384917, 1636425394917, 10000, 9916, 84, 0, 9916, 9916
5910, 1, 1636425394540, 1636425394988, 448, 0, 448, 0, 0, 0
5908, 1, 1636425394212, 1636425395061, 849, 389, 460, 389, 0, 389
5911, 1, 1636425394604, 1636425395245, 641, 157, 484, 157, 0, 157
5915, 1, 1636425395357, 1636425395809, 452, 0, 452, 0, 0, 0
5916, 1, 1636425395661, 1636425396117, 456, 0, 456, 0, 0, 0
5917, 1, 1636425395841, 1636425396293, 452, 0, 452, 0, 0, 0
5918, 1, 1636425395904, 1636425396361, 457, 1, 456, 0, 0, 0
5919, 1, 1636425396136, 1636425396817, 681, 225, 456, 225, 0, 225
5920, 1, 1636425397265, 1636425397717, 452, 0, 452, 0, 0, 0
5921, 1, 1636425397453, 1636425397900, 447, 0, 447, 0, 0, 0
5922, 1, 1636425397788, 1636425398241, 453, 1, 452, 0, 0, 0
5923, 1, 1636425397944, 1636425398397, 453, 1, 452, 0, 1, 1
5926, 1, 1636425397993, 1636425398445, 452, 0, 452, 0, 0, 0
5925, 1, 1636425397993, 1636425398448, 455, 0, 455, 0, 0, 0
5928, 1, 1636425398244, 1636425398693, 449, 1, 448, 0, 1, 1
5924, 1, 1636425397981, 1636425398844, 863, 416, 447, 416, 0, 416
5929, 1, 1636425398424, 1636425398876, 452, 1, 451, 1, 0, 1
5927, 1, 1636425398029, 1636425398888, 859, 416, 443, 416, 0, 416
5930, 1, 1636425398460, 1636425399145, 685, 233, 452, 232, 0, 232
5931, 1, 1636425398789, 1636425399341, 552, 100, 452, 100, 0, 100
5932, 1, 1636425399573, 1636425400028, 455, 0, 455, 0, 0, 0
5933, 1, 1636425399593, 1636425400040, 447, 0, 447, 0, 0, 0
5934, 1, 1636425399649, 1636425400097, 448, 0, 448, 0, 0, 0
5935, 1, 1636425400072, 1636425400525, 453, 1, 452, 0, 0, 0
5936, 1, 1636425400157, 1636425400981, 824, 368, 456, 368, 0, 368
5937, 1, 1636425401501, 1636425401949, 448, 0, 448, 0, 0, 0
5938, 1, 1636425401552, 1636425402009, 457, 1, 456, 0, 0, 0
5939, 1, 1636425401693, 1636425402141, 448, 0, 448, 0, 0, 0
5941, 1, 1636425401840, 1636425402293, 453, 1, 452, 1, 0, 1
5942, 1, 1636425401901, 1636425402461, 560, 108, 452, 108, 0, 108
5944, 1, 1636425402225, 1636425402677, 452, 0, 452, 0, 0, 0
5943, 1, 1636425401933, 1636425402741, 808, 360, 448, 360, 0, 360
5945, 1, 1636425402440, 1636425402885, 445, 0, 445, 0, 0, 0
5940, 1, 1636425401789, 1636425402904, 1115, 672, 443, 672, 0, 672
5946, 1, 1636425402484, 1636425402928, 444, 1, 443, 0, 0, 0
5947, 1, 1636425402557, 1636425403352, 795, 348, 447, 348, 0, 348
5948, 1, 1636425402608, 1636425403376, 768, 321, 447, 321, 0, 321
5949, 1, 1636425403432, 1636425403885, 453, 0, 453, 0, 0, 0
5950, 1, 1636425403709, 1636425404160, 451, 0, 451, 0, 0, 0
5951, 1, 1636425404049, 1636425404617, 568, 112, 456, 112, 0, 112
5952, 1, 1636425404184, 1636425404637, 453, 0, 453, 0, 0, 0
5912, 2, 1636425395081, 1636425405081, 10000, 0, 10000, 0, 0, 0
5953, 1, 1636425404349, 1636425405092, 743, 288, 455, 288, 0, 288
5913, 2, 1636425395176, 1636425405177, 10001, 0, 10001, 69, 0, 69
5914, 2, 1636425395185, 1636425405221, 10036, 9992, 44, 60, 9932, 9992
5954, 1, 1636425405396, 1636425405848, 452, 1, 451, 0, 0, 0
5955, 1, 1636425405488, 1636425405945, 457, 1, 456, 0, 0, 0
5957, 1, 1636425405617, 1636425406069, 452, 0, 452, 0, 0, 0
5958, 1, 1636425405812, 1636425406257, 445, 1, 444, 1, 0, 1
5959, 1, 1636425405833, 1636425406285, 452, 0, 452, 0, 0, 0
5960, 1, 1636425405944, 1636425406397, 453, 1, 452, 0, 0, 0
5956, 1, 1636425405524, 1636425406397, 873, 421, 452, 420, 0, 420
5961, 1, 1636425406029, 1636425406481, 452, 0, 452, 0, 0, 0
5964, 1, 1636425406341, 1636425406792, 451, 0, 451, 0, 0, 0
5963, 1, 1636425406145, 1636425406845, 700, 252, 448, 252, 0, 252
5962, 1, 1636425406084, 1636425406929, 845, 397, 448, 397, 0, 397
5965, 1, 1636425406481, 1636425406932, 451, 0, 451, 0, 0, 0
5967, 1, 1636425406813, 1636425407261, 448, 0, 448, 0, 0, 0
5966, 1, 1636425406584, 1636425407301, 717, 261, 456, 261, 0, 261
5968, 1, 1636425406852, 1636425407717, 865, 409, 456, 409, 0, 409
5969, 1, 1636425407461, 1636425407917, 456, 0, 456, 0, 0, 0
5970, 1, 1636425407856, 1636425408313, 457, 1, 456, 1, 0, 1
5971, 1, 1636425408005, 1636425408449, 444, 0, 444, 0, 0, 0
5972, 1, 1636425408121, 1636425408769, 648, 193, 455, 192, 0, 192
5973, 1, 1636425408420, 1636425408873, 453, 1, 452, 0, 0, 0
5974, 1, 1636425409237, 1636425409680, 443, 0, 443, 0, 0, 0
5975, 1, 1636425409505, 1636425409953, 448, 0, 448, 0, 0, 0
5976, 1, 1636425409604, 1636425410049, 445, 1, 444, 0, 0, 0
5978, 1, 1636425409868, 1636425410324, 456, 1, 455, 0, 0, 0
5977, 1, 1636425409640, 1636425410500, 860, 409, 451, 409, 0, 409
5979, 1, 1636425410100, 1636425410549, 449, 1, 448, 0, 0, 0
5980, 1, 1636425410176, 1636425410633, 457, 0, 457, 0, 0, 0
5982, 1, 1636425410269, 1636425410716, 447, 0, 447, 0, 0, 0
5985, 1, 1636425410488, 1636425410941, 453, 1, 452, 0, 0, 0
5984, 1, 1636425410320, 1636425411085, 765, 313, 452, 312, 0, 312
5986, 1, 1636425410632, 1636425411085, 453, 1, 452, 0, 0, 0
5983, 1, 1636425410296, 1636425411165, 869, 421, 448, 420, 1, 421
5987, 1, 1636425410821, 1636425411389, 568, 120, 448, 120, 0, 120
5988, 1, 1636425410829, 1636425411617, 788, 336, 452, 336, 0, 336
5989, 1, 1636425411265, 1636425411717, 452, 0, 452, 0, 0, 0
5990, 1, 1636425411773, 1636425412225, 452, 0, 452, 0, 0, 0
5991, 1, 1636425411885, 1636425412340, 455, 0, 455, 0, 0, 0
5992, 1, 1636425412336, 1636425412788, 452, 5, 447, 4, 0, 4
5993, 1, 1636425412729, 1636425413185, 456, 0, 456, 0, 0, 0
5994, 1, 1636425412917, 1636425413368, 451, 0, 451, 0, 0, 0
5995, 1, 1636425413412, 1636425413865, 453, 0, 453, 0, 0, 0
5996, 1, 1636425413721, 1636425414173, 452, 0, 452, 0, 0, 0
5998, 1, 1636425413869, 1636425414324, 455, 0, 455, 0, 0, 0
5999, 1, 1636425414141, 1636425414596, 455, 0, 455, 0, 0, 0
6000, 1, 1636425414161, 1636425414612, 451, 0, 451, 0, 0, 0
5997, 1, 1636425413837, 1636425414621, 784, 336, 448, 336, 0, 336
6001, 1, 1636425414192, 1636425414640, 448, 0, 448, 0, 0, 0
6004, 1, 1636425414392, 1636425414849, 457, 1, 456, 0, 0, 0
6005, 1, 1636425414497, 1636425414949, 452, 0, 452, 0, 0, 0
6003, 1, 1636425414249, 1636425415041, 792, 348, 444, 348, 0, 348
6006, 1, 1636425414596, 1636425415089, 493, 45, 448, 45, 0, 45
6007, 1, 1636425414701, 1636425415297, 596, 148, 448, 148, 0, 148
6002, 1, 1636425414220, 1636425415540, 1320, 869, 451, 869, 0, 869
6008, 1, 1636425415125, 1636425415577, 452, 0, 452, 0, 0, 0
6009, 1, 1636425415656, 1636425416104, 448, 1, 447, 0, 0, 0
6010, 1, 1636425415965, 1636425416417, 452, 0, 452, 0, 0, 0
6011, 1, 1636425416060, 1636425416557, 497, 45, 452, 45, 0, 45
6012, 1, 1636425416625, 1636425417081, 456, 0, 456, 0, 0, 0
6013, 1, 1636425416917, 1636425417373, 456, 0, 456, 0, 0, 0
6014, 1, 1636425417245, 1636425417697, 452, 0, 452, 0, 0, 0
6015, 1, 1636425417533, 1636425417981, 448, 0, 448, 0, 0, 0
6016, 1, 1636425417629, 1636425418436, 807, 352, 455, 352, 0, 352
6017, 1, 1636425418061, 1636425418513, 452, 0, 452, 0, 0, 0
6018, 1, 1636425418225, 1636425418677, 452, 0, 452, 0, 0, 0
6020, 1, 1636425418249, 1636425418701, 452, 0, 452, 0, 0, 0
6023, 1, 1636425418496, 1636425418949, 453, 1, 452, 0, 0, 0
6024, 1, 1636425418617, 1636425419128, 511, 60, 451, 60, 0, 60
6022, 1, 1636425418449, 1636425419157, 708, 252, 456, 252, 0, 252
6025, 1, 1636425418716, 1636425419177, 461, 1, 460, 0, 0, 0
6027, 1, 1636425419121, 1636425419577, 456, 0, 456, 0, 0, 0
6026, 1, 1636425418820, 1636425419609, 789, 337, 452, 337, 0, 337
6028, 1, 1636425419785, 1636425420233, 448, 0, 448, 0, 0, 0
5981, 2, 1636425410248, 1636425420248, 10000, 0, 10000, 0, 0, 0
6029, 1, 1636425419993, 1636425420476, 483, 0, 483, 0, 0, 0
6030, 1, 1636425420292, 1636425420745, 453, 0, 453, 0, 0, 0
6031, 1, 1636425420552, 1636425421009, 457, 0, 457, 0, 0, 0
6032, 1, 1636425420792, 1636425421244, 452, 1, 451, 0, 0, 0
6033, 1, 1636425420812, 1636425421261, 449, 1, 448, 0, 0, 0
6034, 1, 1636425421109, 1636425421561, 452, 0, 452, 0, 0, 0
6035, 1, 1636425421716, 1636425422169, 453, 1, 452, 1, 0, 1
6038, 1, 1636425422093, 1636425422537, 444, 0, 444, 0, 0, 0
6037, 1, 1636425422089, 1636425422545, 456, 0, 456, 0, 0, 0
6036, 1, 1636425421785, 1636425422617, 832, 384, 448, 384, 0, 384
6039, 1, 1636425422437, 1636425422881, 444, 0, 444, 0, 0, 0
6040, 1, 1636425422453, 1636425422897, 444, 0, 444, 0, 0, 0
6041, 1, 1636425422577, 1636425423028, 451, 0, 451, 0, 0, 0
6043, 1, 1636425422777, 1636425423233, 456, 0, 456, 0, 0, 0
6042, 1, 1636425422732, 1636425423344, 612, 165, 447, 165, 0, 165
6045, 1, 1636425423328, 1636425423773, 445, 1, 444, 0, 0, 0
6044, 1, 1636425423024, 1636425423793, 769, 321, 448, 320, 0, 320
6046, 1, 1636425423725, 1636425424173, 448, 0, 448, 0, 0, 0
6048, 1, 1636425424169, 1636425424625, 456, 0, 456, 0, 0, 0
6047, 1, 1636425424009, 1636425424625, 616, 164, 452, 164, 0, 164
6049, 1, 1636425424628, 1636425425076, 448, 0, 448, 0, 0, 0
6050, 1, 1636425424761, 1636425425213, 452, 0, 452, 0, 0, 0
6051, 1, 1636425425120, 1636425425573, 453, 1, 452, 0, 0, 0
6052, 1, 1636425425245, 1636425425701, 456, 0, 456, 0, 0, 0
6053, 1, 1636425425781, 1636425426240, 459, 0, 459, 0, 0, 0
6055, 1, 1636425426145, 1636425426605, 460, 0, 460, 0, 0, 0
6056, 1, 1636425426209, 1636425426657, 448, 0, 448, 0, 0, 0
6054, 1, 1636425425805, 1636425426692, 887, 436, 451, 436, 0, 436
6057, 1, 1636425426284, 1636425426724, 440, 0, 440, 0, 0, 0
6059, 1, 1636425426717, 1636425427169, 452, 0, 452, 0, 0, 0
6058, 1, 1636425426708, 1636425427181, 473, 17, 456, 16, 0, 16
6060, 1, 1636425426744, 1636425427197, 453, 1, 452, 1, 0, 1
6062, 1, 1636425426904, 1636425427356, 452, 1, 451, 0, 0, 0
6061, 1, 1636425426768, 1636425427637, 869, 413, 456, 413, 0, 413
6063, 1, 1636425427505, 1636425427948, 443, 0, 443, 0, 0, 0
6019, 2, 1636425418249, 1636425428249, 10000, 0, 10000, 0, 0, 0
6021, 2, 1636425418264, 1636425428293, 10029, 0, 10029, 0, 0, 0
6065, 1, 1636425427852, 1636425428296, 444, 0, 444, 0, 0, 0
6064, 1, 1636425427852, 1636425428304, 452, 0, 452, 0, 0, 0
6066, 1, 1636425428069, 1636425428753, 684, 236, 448, 236, 0, 236
6067, 1, 1636425428561, 1636425429009, 448, 0, 448, 0, 0, 0
6069, 1, 1636425428740, 1636425429189, 449, 1, 448, 0, 0, 0
6070, 1, 1636425428756, 1636425429213, 457, 0, 457, 0, 0, 0
6068, 1, 1636425428568, 1636425429461, 893, 441, 452, 440, 0, 440
6071, 1, 1636425429056, 1636425429913, 857, 405, 452, 405, 0, 405
6072, 1, 1636425429517, 1636425429969, 452, 0, 452, 0, 0, 0
6073, 1, 1636425429613, 1636425430068, 455, 0, 455, 0, 0, 0
6075, 1, 1636425429829, 1636425430277, 448, 0, 448, 0, 0, 0
6076, 1, 1636425430017, 1636425430465, 448, 0, 448, 0, 0, 0
6074, 1, 1636425429769, 1636425430521, 752, 300, 452, 300, 0, 300
6077, 1, 1636425430488, 1636425430936, 448, 1, 447, 0, 0, 0
6078, 1, 1636425430521, 1636425430973, 452, 0, 452, 0, 0, 0
6079, 1, 1636425430668, 1636425431117, 449, 0, 449, 0, 0, 0
6080, 1, 1636425430980, 1636425431436, 456, 0, 456, 0, 0, 0
6081, 1, 1636425431001, 1636425431448, 447, 0, 447, 0, 0, 0
6082, 1, 1636425431008, 1636425431897, 889, 441, 448, 441, 0, 441
6083, 1, 1636425431772, 1636425432229, 457, 1, 456, 0, 0, 0
6084, 1, 1636425432033, 1636425432480, 447, 0, 447, 0, 0, 0
6085, 1, 1636425432057, 1636425432504, 447, 0, 447, 0, 0, 0
6087, 1, 1636425432424, 1636425432877, 453, 0, 453, 0, 0, 0
6086, 1, 1636425432184, 1636425432956, 772, 321, 451, 321, 0, 321
6089, 1, 1636425432677, 1636425433129, 452, 0, 452, 0, 0, 0
6088, 1, 1636425432469, 1636425433329, 860, 408, 452, 408, 0, 408
6091, 1, 1636425432968, 1636425433413, 445, 0, 445, 0, 0, 0
6090, 1, 1636425432912, 1636425433772, 860, 417, 443, 417, 0, 417
6092, 1, 1636425433608, 1636425434056, 448, 1, 447, 0, 1, 1
6093, 1, 1636425433709, 1636425434152, 443, 0, 443, 0, 0, 0
6094, 1, 1636425433797, 1636425434252, 455, 0, 455, 0, 0, 0
6096, 1, 1636425434012, 1636425434457, 445, 0, 445, 0, 0, 0
6095, 1, 1636425433804, 1636425434601, 797, 349, 448, 349, 0, 349
6097, 1, 1636425434220, 1636425434657, 437, 0, 437, 0, 0, 0
6098, 1, 1636425434304, 1636425434741, 437, 1, 436, 0, 1, 1
6099, 1, 1636425434741, 1636425435193, 452, 0, 452, 0, 0, 0
6101, 1, 1636425434849, 1636425435301, 452, 0, 452, 0, 0, 0
6102, 1, 1636425435049, 1636425435501, 452, 0, 452, 0, 0, 0
6100, 1, 1636425434829, 1636425435637, 808, 364, 444, 364, 0, 364
6103, 1, 1636425435580, 1636425436029, 449, 1, 448, 1, 0, 1
6104, 1, 1636425435753, 1636425436201, 448, 0, 448, 0, 0, 0
6105, 1, 1636425436153, 1636425436653, 500, 48, 452, 48, 0, 48
6106, 1, 1636425436317, 1636425436760, 443, 0, 443, 0, 0, 0
6107, 1, 1636425436452, 1636425436892, 440, 1, 439, 1, 0, 1
6109, 1, 1636425436753, 1636425437213, 460, 0, 460, 0, 0, 0
6108, 1, 1636425436621, 1636425437341, 720, 272, 448, 272, 0, 272
6111, 1, 1636425437245, 1636425437701, 456, 0, 456, 0, 0, 0
6110, 1, 1636425437061, 1636425437805, 744, 280, 464, 280, 0, 280
6112, 1, 1636425437792, 1636425438245, 453, 1, 452, 1, 0, 1
6113, 1, 1636425437829, 1636425438281, 452, 0, 452, 0, 0, 0
6114, 1, 1636425437905, 1636425438353, 448, 0, 448, 0, 0, 0
6115, 1, 1636425437944, 1636425438393, 449, 1, 448, 0, 0, 0
6117, 1, 1636425438293, 1636425438749, 456, 0, 456, 0, 0, 0
6118, 1, 1636425438329, 1636425438777, 448, 0, 448, 0, 0, 0
6116, 1, 1636425438093, 1636425438849, 756, 301, 455, 301, 0, 301
6119, 1, 1636425438421, 1636425438873, 452, 0, 452, 0, 0, 0
6120, 1, 1636425438581, 1636425439325, 744, 292, 452, 292, 0, 292
6121, 1, 1636425439025, 1636425439477, 452, 0, 452, 0, 0, 0
6122, 1, 1636425439133, 1636425439585, 452, 0, 452, 0, 0, 0
6123, 1, 1636425439701, 1636425440153, 452, 0, 452, 0, 0, 0
6124, 1, 1636425439849, 1636425440305, 456, 0, 456, 0, 0, 0
6125, 1, 1636425440061, 1636425440604, 543, 92, 451, 92, 0, 92
6126, 1, 1636425440189, 1636425440640, 451, 0, 451, 0, 0, 0
6128, 1, 1636425440400, 1636425440853, 453, 1, 452, 1, 0, 1
6127, 1, 1636425440324, 1636425441093, 769, 317, 452, 317, 0, 317
6130, 1, 1636425440949, 1636425441401, 452, 0, 452, 0, 0, 0
6129, 1, 1636425440864, 1636425441545, 681, 229, 452, 229, 0, 229
6131, 1, 1636425441513, 1636425441961, 448, 0, 448, 0, 0, 0
6132, 1, 1636425441665, 1636425442121, 456, 0, 456, 0, 0, 0
6133, 1, 1636425441789, 1636425442241, 452, 0, 452, 0, 0, 0
6134, 1, 1636425441845, 1636425442301, 456, 0, 456, 0, 0, 0
6137, 1, 1636425442109, 1636425442556, 447, 0, 447, 0, 0, 0
6136, 1, 1636425442069, 1636425442573, 504, 52, 452, 52, 0, 52
6135, 1, 1636425441953, 1636425442689, 736, 288, 448, 288, 0, 288
6138, 1, 1636425442336, 1636425442789, 453, 1, 452, 0, 0, 0
6140, 1, 1636425442585, 1636425443041, 456, 0, 456, 0, 0, 0
6139, 1, 1636425442357, 1636425443237, 880, 432, 448, 432, 0, 432
6141, 1, 1636425442929, 1636425443377, 448, 0, 448, 0, 0, 0
6142, 1, 1636425443217, 1636425443664, 447, 0, 447, 0, 0, 0
6143, 1, 1636425443405, 1636425443853, 448, 0, 448, 0, 0, 0
6144, 1, 1636425443620, 1636425444077, 457, 0, 457, 0, 0, 0
6145, 1, 1636425444025, 1636425444477, 452, 0, 452, 0, 0, 0
6146, 1, 1636425444049, 1636425444505, 456, 0, 456, 0, 0, 0
6147, 1, 1636425444313, 1636425444957, 644, 192, 452, 192, 0, 192
6148, 1, 1636425444712, 1636425445165, 453, 1, 452, 1, 0, 1
6149, 1, 1636425444785, 1636425445412, 627, 173, 454, 172, 0, 172
6152, 1, 1636425445493, 1636425445949, 456, 0, 456, 0, 0, 0
6154, 1, 1636425445757, 1636425446209, 452, 0, 452, 0, 0, 0
6153, 1, 1636425445741, 1636425446401, 660, 208, 452, 208, 0, 208
6155, 1, 1636425446089, 1636425446537, 448, 0, 448, 0, 0, 0
6157, 1, 1636425446249, 1636425446701, 452, 0, 452, 0, 0, 0
6159, 1, 1636425446320, 1636425446773, 453, 1, 452, 0, 0, 0
6156, 1, 1636425446217, 1636425446989, 772, 320, 452, 320, 0, 320
6158, 1, 1636425446320, 1636425447153, 833, 381, 452, 381, 0, 381
6160, 1, 1636425446917, 1636425447365, 448, 0, 448, 0, 0, 0
6161, 1, 1636425446933, 1636425447381, 448, 0, 448, 0, 0, 0
6162, 1, 1636425447173, 1636425447629, 456, 0, 456, 0, 0, 0
6163, 1, 1636425447529, 1636425447985, 456, 0, 456, 0, 0, 0
6164, 1, 1636425447640, 1636425448085, 445, 1, 444, 0, 0, 0
6165, 1, 1636425447729, 1636425448177, 448, 0, 448, 0, 0, 0
6166, 1, 1636425447925, 1636425448381, 456, 0, 456, 0, 0, 0
6167, 1, 1636425448181, 1636425448637, 456, 0, 456, 0, 0, 0
6168, 1, 1636425448653, 1636425449109, 456, 0, 456, 0, 0, 0
6169, 1, 1636425448737, 1636425449193, 456, 0, 456, 0, 0, 0
6170, 1, 1636425449177, 1636425449649, 472, 17, 455, 16, 0, 16
6171, 1, 1636425449556, 1636425450105, 549, 93, 456, 93, 0, 93
6172, 1, 1636425449676, 1636425450125, 449, 0, 449, 0, 0, 0
6174, 1, 1636425449925, 1636425450377, 452, 0, 452, 0, 0, 0
6173, 1, 1636425449921, 1636425450573, 652, 204, 448, 204, 0, 204
6175, 1, 1636425450073, 1636425450829, 756, 304, 452, 304, 0, 304
6176, 1, 1636425450157, 1636425451029, 872, 416, 456, 416, 0, 416
6177, 1, 1636425450657, 1636425451109, 452, 0, 452, 0, 0, 0
6178, 1, 1636425450792, 1636425451249, 457, 1, 456, 0, 0, 0
6179, 1, 1636425450853, 1636425451301, 448, 0, 448, 0, 0, 0
6180, 1, 1636425451129, 1636425451576, 447, 0, 447, 0, 0, 0
6181, 1, 1636425451468, 1636425451921, 453, 0, 453, 0, 0, 0
6182, 1, 1636425451581, 1636425452033, 452, 0, 452, 0, 0, 0
6183, 1, 1636425451833, 1636425452285, 452, 0, 452, 0, 0, 0
6184, 1, 1636425451885, 1636425452337, 452, 0, 452, 0, 0, 0
6185, 1, 1636425452389, 1636425452845, 456, 0, 456, 0, 0, 0
6186, 1, 1636425452713, 1636425453165, 452, 0, 452, 0, 0, 0
6187, 1, 1636425452941, 1636425453389, 448, 0, 448, 0, 0, 0
6188, 1, 1636425453224, 1636425453833, 609, 164, 445, 164, 0, 164
6189, 1, 1636425453476, 1636425453928, 452, 0, 452, 0, 0, 0
6191, 1, 1636425453701, 1636425454152, 451, 0, 451, 0, 0, 0
6190, 1, 1636425453589, 1636425454285, 696, 244, 452, 244, 0, 244
6193, 1, 1636425453889, 1636425454380, 491, 40, 451, 40, 0, 40
6194, 1, 1636425454017, 1636425454605, 588, 136, 452, 136, 0, 136
6192, 1, 1636425453861, 1636425454833, 972, 520, 452, 520, 0, 520
6150, 2, 1636425444845, 1636425454845, 10000, 0, 10000, 0, 0, 0
6195, 1, 1636425454557, 1636425455009, 452, 0, 452, 0, 0, 0
6151, 2, 1636425445185, 1636425455185, 10000, 0, 10000, 0, 0, 0
6196, 1, 1636425454937, 1636425455413, 476, 0, 476, 0, 0, 0
6197, 1, 1636425455149, 1636425455601, 452, 0, 452, 0, 0, 0
6198, 1, 1636425455169, 1636425455621, 452, 0, 452, 0, 0, 0
6199, 1, 1636425455337, 1636425455784, 447, 0, 447, 0, 0, 0
6200, 1, 1636425455493, 1636425455948, 455, 0, 455, 0, 0, 0
6201, 1, 1636425455777, 1636425456233, 456, 0, 456, 0, 0, 0
6202, 1, 1636425455865, 1636425456313, 448, 0, 448, 0, 0, 0
6203, 1, 1636425455897, 1636425456349, 452, 0, 452, 0, 0, 0
6204, 1, 1636425456000, 1636425456449, 449, 1, 448, 0, 1, 1
6205, 1, 1636425456565, 1636425457017, 452, 0, 452, 0, 0, 0
6206, 1, 1636425456813, 1636425457265, 452, 0, 452, 0, 0, 0
6207, 1, 1636425457109, 1636425457556, 447, 0, 447, 0, 0, 0
6209, 1, 1636425457381, 1636425457829, 448, 0, 448, 0, 0, 0
6208, 1, 1636425457321, 1636425458009, 688, 236, 452, 236, 0, 236
6212, 1, 1636425457677, 1636425458129, 452, 0, 452, 0, 0, 0
6210, 1, 1636425457596, 1636425458461, 865, 413, 452, 412, 0, 412
6214, 1, 1636425457989, 1636425458585, 596, 141, 455, 140, 0, 140
6215, 1, 1636425458769, 1636425459220, 451, 0, 451, 0, 0, 0
6216, 1, 1636425459041, 1636425459493, 452, 0, 452, 0, 0, 0
6217, 1, 1636425459264, 1636425459717, 453, 1, 452, 0, 0, 0
6218, 1, 1636425459277, 1636425459729, 452, 0, 452, 0, 0, 0
6219, 1, 1636425459293, 1636425459744, 451, 0, 451, 0, 0, 0
6220, 1, 1636425459608, 1636425460057, 449, 0, 449, 0, 0, 0
6221, 1, 1636425459857, 1636425460305, 448, 0, 448, 0, 0, 0
6222, 1, 1636425459885, 1636425460333, 448, 0, 448, 0, 0, 0
6223, 1, 1636425460069, 1636425460528, 459, 0, 459, 0, 0, 0
6224, 1, 1636425460277, 1636425460732, 455, 0, 455, 0, 0, 0
6225, 1, 1636425460832, 1636425461284, 452, 0, 452, 0, 0, 0
6226, 1, 1636425461145, 1636425461600, 455, 0, 455, 0, 0, 0
6227, 1, 1636425461276, 1636425461733, 457, 1, 456, 0, 0, 0
6228, 1, 1636425461384, 1636425461837, 453, 0, 453, 0, 0, 0
6231, 1, 1636425461753, 1636425462205, 452, 0, 452, 0, 0, 0
6230, 1, 1636425461681, 1636425462293, 612, 156, 456, 156, 0, 156
6232, 1, 1636425462117, 1636425462661, 544, 88, 456, 88, 0, 88
6229, 1, 1636425461497, 1636425462745, 1248, 796, 452, 796, 0, 796
6233, 1, 1636425462553, 1636425463008, 455, 0, 455, 0, 0, 0
6234, 1, 1636425463081, 1636425463533, 452, 0, 452, 0, 0, 0
6235, 1, 1636425463308, 1636425463761, 453, 0, 453, 0, 0, 0
6236, 1, 1636425463352, 1636425463801, 449, 0, 449, 0, 0, 0
6237, 1, 1636425463597, 1636425464049, 452, 0, 452, 0, 0, 0
6238, 1, 1636425463781, 1636425464233, 452, 0, 452, 0, 0, 0
6239, 1, 1636425463817, 1636425464265, 448, 0, 448, 0, 0, 0
6240, 1, 1636425463869, 1636425464312, 443, 0, 443, 0, 0, 0
6241, 1, 1636425464085, 1636425464537, 452, 0, 452, 0, 0, 0
6242, 1, 1636425464213, 1636425464665, 452, 0, 452, 0, 0, 0
6243, 1, 1636425464637, 1636425465093, 456, 0, 456, 0, 0, 0
6244, 1, 1636425465053, 1636425465545, 492, 40, 452, 40, 0, 40
6246, 1, 1636425465125, 1636425465581, 456, 0, 456, 0, 0, 0
6247, 1, 1636425465264, 1636425466001, 737, 281, 456, 281, 0, 281
6249, 1, 1636425465705, 1636425466153, 448, 0, 448, 0, 0, 0
6248, 1, 1636425465641, 1636425466461, 820, 361, 459, 361, 0, 361
6250, 1, 1636425466113, 1636425466608, 495, 40, 455, 40, 0, 40
6251, 1, 1636425466580, 1636425467040, 460, 0, 460, 0, 0, 0
6211, 2, 1636425457605, 1636425467605, 10000, 0, 10000, 224, 0, 224
6252, 1, 1636425467273, 1636425467720, 447, 0, 447, 0, 0, 0
6253, 1, 1636425467313, 1636425467764, 451, 0, 451, 0, 0, 0
6254, 1, 1636425467349, 1636425467836, 487, 0, 487, 0, 0, 0
6213, 1, 1636425457749, 1636425468057, 10308, 9856, 452, 80, 9776, 9856
6255, 1, 1636425467704, 1636425468149, 445, 1, 444, 0, 0, 0
6257, 1, 1636425467748, 1636425468196, 448, 1, 447, 0, 1, 1
6256, 1, 1636425467748, 1636425468197, 449, 1, 448, 1, 0, 1
6258, 1, 1636425467936, 1636425468389, 453, 0, 453, 0, 0, 0
6259, 1, 1636425468141, 1636425468588, 447, 0, 447, 0, 0, 0
6260, 1, 1636425468188, 1636425468632, 444, 1, 443, 1, 0, 1
6262, 1, 1636425468353, 1636425468805, 452, 0, 452, 0, 0, 0
6261, 1, 1636425468277, 1636425469041, 764, 312, 452, 312, 0, 312
6263, 1, 1636425468669, 1636425469261, 592, 136, 456, 136, 0, 136
6264, 1, 1636425469021, 1636425469477, 456, 0, 456, 0, 0, 0
6265, 1, 1636425469365, 1636425469821, 456, 0, 456, 0, 0, 0
6267, 1, 1636425469537, 1636425469993, 456, 0, 456, 0, 0, 0
6266, 1, 1636425469517, 1636425470277, 760, 304, 456, 304, 0, 304
6269, 1, 1636425470017, 1636425470469, 452, 0, 452, 0, 0, 0
6268, 1, 1636425469849, 1636425470729, 880, 428, 452, 428, 0, 428
6270, 1, 1636425470385, 1636425470841, 456, 0, 456, 0, 0, 0
6271, 1, 1636425471177, 1636425471629, 452, 0, 452, 0, 0, 0
6272, 1, 1636425471297, 1636425471748, 451, 0, 451, 0, 0, 0
6273, 1, 1636425471545, 1636425471993, 448, 0, 448, 0, 0, 0
6274, 1, 1636425471693, 1636425472145, 452, 0, 452, 0, 0, 0
6275, 1, 1636425471704, 1636425472149, 445, 0, 445, 0, 0, 0
6276, 1, 1636425472073, 1636425472524, 451, 0, 451, 0, 0, 0
6277, 1, 1636425472093, 1636425472548, 455, 0, 455, 0, 0, 0
6278, 1, 1636425472145, 1636425472588, 443, 0, 443, 0, 0, 0
6280, 1, 1636425472564, 1636425473017, 453, 0, 453, 0, 0, 0
6279, 1, 1636425472420, 1636425473041, 621, 169, 452, 169, 0, 169
6281, 1, 1636425472853, 1636425473309, 456, 0, 456, 0, 0, 0
6282, 1, 1636425473137, 1636425473593, 456, 0, 456, 0, 0, 0
6284, 1, 1636425473557, 1636425474009, 452, 0, 452, 0, 0, 0
6283, 1, 1636425473285, 1636425474045, 760, 308, 452, 308, 0, 308
6286, 1, 1636425474037, 1636425474489, 452, 0, 452, 0, 0, 0
6285, 1, 1636425473665, 1636425474497, 832, 380, 452, 380, 0, 380
6287, 1, 1636425474213, 1636425474665, 452, 0, 452, 0, 0, 0
6245, 2, 1636425465105, 1636425475105, 10000, 0, 10000, 0, 0, 0
6288, 1, 1636425475197, 1636425475652, 455, 0, 455, 0, 0, 0
6289, 1, 1636425475309, 1636425475761, 452, 0, 452, 0, 0, 0
6290, 1, 1636425475412, 1636425475861, 449, 1, 448, 1, 0, 1
6291, 1, 1636425475424, 1636425475873, 449, 0, 449, 0, 0, 0
6292, 1, 1636425475548, 1636425475996, 448, 0, 448, 0, 0, 0
6295, 1, 1636425475936, 1636425476381, 445, 0, 445, 0, 0, 0
6293, 1, 1636425475929, 1636425476381, 452, 0, 452, 0, 0, 0
6294, 1, 1636425475929, 1636425476381, 452, 0, 452, 0, 0, 0
6296, 1, 1636425476201, 1636425476653, 452, 0, 452, 0, 0, 0
6297, 1, 1636425476285, 1636425476829, 544, 96, 448, 96, 0, 96
6298, 1, 1636425476693, 1636425477145, 452, 0, 452, 0, 0, 0
6299, 1, 1636425476713, 1636425477165, 452, 0, 452, 0, 0, 0
6300, 1, 1636425477157, 1636425477613, 456, 0, 456, 0, 0, 0
6301, 1, 1636425477353, 1636425477805, 452, 0, 452, 0, 0, 0
6302, 1, 1636425477361, 1636425478065, 704, 252, 452, 252, 0, 252
6303, 1, 1636425477833, 1636425478289, 456, 0, 456, 0, 0, 0
6304, 1, 1636425477873, 1636425478517, 644, 192, 452, 192, 0, 192
6305, 1, 1636425478209, 1636425478669, 460, 0, 460, 0, 0, 0
6306, 1, 1636425479153, 1636425479605, 452, 0, 452, 0, 0, 0
6307, 1, 1636425479161, 1636425479613, 452, 0, 452, 0, 0, 0
6308, 1, 1636425479365, 1636425479812, 447, 0, 447, 0, 0, 0
6309, 1, 1636425479393, 1636425479841, 448, 0, 448, 0, 0, 0
6310, 1, 1636425479637, 1636425480084, 447, 0, 447, 0, 0, 0
6311, 1, 1636425479785, 1636425480232, 447, 0, 447, 0, 0, 0
6312, 1, 1636425479969, 1636425480417, 448, 0, 448, 0, 0, 0
6313, 1, 1636425479997, 1636425480449, 452, 0, 452, 0, 0, 0
6314, 1, 1636425480136, 1636425480581, 445, 0, 445, 0, 0, 0
6315, 1, 1636425480509, 1636425480961, 452, 0, 452, 0, 0, 0
6316, 1, 1636425480633, 1636425481089, 456, 0, 456, 0, 0, 0
6317, 1, 1636425480829, 1636425481285, 456, 0, 456, 0, 0, 0
6318, 1, 1636425481137, 1636425481589, 452, 0, 452, 0, 0, 0
6320, 1, 1636425481413, 1636425481865, 452, 0, 452, 0, 0, 0
6319, 1, 1636425481345, 1636425482045, 700, 244, 456, 244, 0, 244
6321, 1, 1636425481637, 1636425482497, 860, 409, 451, 408, 0, 408
6322, 1, 1636425482109, 1636425482561, 452, 0, 452, 0, 0, 0
6323, 1, 1636425482417, 1636425482873, 456, 0, 456, 0, 0, 0
6324, 1, 1636425483289, 1636425483741, 452, 0, 452, 0, 0, 0
6325, 1, 1636425483365, 1636425483817, 452, 0, 452, 0, 0, 0
6326, 1, 1636425483493, 1636425483945, 452, 0, 452, 0, 0, 0
6327, 1, 1636425483605, 1636425484052, 447, 0, 447, 0, 0, 0
6328, 1, 1636425483613, 1636425484065, 452, 0, 452, 0, 0, 0
6329, 1, 1636425483917, 1636425484369, 452, 0, 452, 0, 0, 0
6330, 1, 1636425484216, 1636425484660, 444, 0, 444, 0, 0, 0
6331, 1, 1636425484260, 1636425484704, 444, 0, 444, 0, 0, 0
6332, 1, 1636425484273, 1636425484725, 452, 0, 452, 0, 0, 0
6333, 1, 1636425484641, 1636425485093, 452, 0, 452, 0, 0, 0
6334, 1, 1636425484725, 1636425485181, 456, 0, 456, 0, 0, 0
6335, 1, 1636425484917, 1636425485369, 452, 0, 452, 0, 0, 0
6336, 1, 1636425485421, 1636425485877, 456, 0, 456, 0, 0, 0
6338, 1, 1636425485637, 1636425486092, 455, 0, 455, 0, 0, 0
6339, 1, 1636425485632, 1636425486337, 705, 245, 460, 245, 0, 245
6340, 1, 1636425486329, 1636425486785, 456, 0, 456, 0, 0, 0
6337, 1, 1636425485557, 1636425486789, 1232, 780, 452, 780, 0, 780
6341, 1, 1636425486589, 1636425487045, 456, 0, 456, 0, 0, 0
6342, 1, 1636425486989, 1636425487445, 456, 0, 456, 0, 0, 0
6343, 1, 1636425487325, 1636425487773, 448, 0, 448, 0, 0, 0
6344, 1, 1636425487509, 1636425487957, 448, 0, 448, 0, 0, 0
6345, 1, 1636425487621, 1636425488064, 443, 0, 443, 0, 0, 0
6346, 1, 1636425487697, 1636425488148, 451, 0, 451, 0, 0, 0
6347, 1, 1636425487897, 1636425488341, 444, 0, 444, 0, 0, 0
6348, 1, 1636425488024, 1636425488473, 449, 0, 449, 0, 0, 0
6349, 1, 1636425488104, 1636425488557, 453, 1, 452, 0, 0, 0
6350, 1, 1636425488441, 1636425488889, 448, 0, 448, 0, 0, 0
6351, 1, 1636425488477, 1636425488925, 448, 0, 448, 0, 0, 0
6352, 1, 1636425488625, 1636425489081, 456, 0, 456, 0, 0, 0
6353, 1, 1636425489121, 1636425489573, 452, 0, 452, 0, 0, 0
6354, 1, 1636425489357, 1636425489809, 452, 0, 452, 0, 0, 0
6355, 1, 1636425489517, 1636425490025, 508, 56, 452, 56, 0, 56
6357, 1, 1636425489925, 1636425490473, 548, 100, 448, 100, 0, 100
6358, 1, 1636425490053, 1636425490496, 443, 0, 443, 0, 0, 0
6356, 1, 1636425489769, 1636425490921, 1152, 704, 448, 704, 0, 704
6359, 1, 1636425490788, 1636425491241, 453, 0, 453, 0, 0, 0
6360, 1, 1636425490857, 1636425491312, 455, 0, 455, 0, 0, 0
6361, 1, 1636425491393, 1636425491845, 452, 0, 452, 0, 0, 0
6362, 1, 1636425491401, 1636425491857, 456, 0, 456, 0, 0, 0
6363, 1, 1636425491753, 1636425492308, 555, 105, 450, 104, 0, 104
6364, 1, 1636425491861, 1636425492317, 456, 0, 456, 0, 0, 0
6365, 1, 1636425492177, 1636425492629, 452, 0, 452, 0, 0, 0
6366, 1, 1636425492245, 1636425492697, 452, 0, 452, 0, 0, 0
6367, 1, 1636425492353, 1636425492805, 452, 0, 452, 0, 0, 0
6368, 1, 1636425492473, 1636425492924, 451, 0, 451, 0, 0, 0
6369, 1, 1636425492817, 1636425493269, 452, 0, 452, 0, 0, 0
6370, 1, 1636425492869, 1636425493321, 452, 0, 452, 0, 0, 0
6371, 1, 1636425493349, 1636425493801, 452, 0, 452, 0, 0, 0
6374, 1, 1636425493601, 1636425494053, 452, 0, 452, 0, 0, 0
6373, 1, 1636425493601, 1636425494253, 652, 200, 452, 200, 0, 200
6372, 1, 1636425493553, 1636425494705, 1152, 700, 452, 700, 0, 700
6375, 1, 1636425494333, 1636425494785, 452, 0, 452, 0, 0, 0
6376, 1, 1636425494665, 1636425495117, 452, 0, 452, 0, 0, 0
6377, 1, 1636425494821, 1636425495277, 456, 0, 456, 0, 0, 0
6378, 1, 1636425495341, 1636425495789, 448, 0, 448, 0, 0, 0
6379, 1, 1636425495433, 1636425495884, 451, 0, 451, 0, 0, 0
6380, 1, 1636425495840, 1636425496292, 452, 0, 452, 0, 0, 0
6381, 1, 1636425495848, 1636425496301, 453, 0, 453, 0, 0, 0
6382, 1, 1636425496125, 1636425496585, 460, 0, 460, 0, 0, 0
6384, 1, 1636425496277, 1636425496729, 452, 0, 452, 0, 0, 0
6383, 1, 1636425496277, 1636425496729, 452, 0, 452, 0, 0, 0
6385, 1, 1636425496589, 1636425497041, 452, 0, 452, 0, 0, 0
6386, 1, 1636425496764, 1636425497217, 453, 0, 453, 0, 0, 0
6387, 1, 1636425497105, 1636425497557, 452, 0, 452, 0, 0, 0
6388, 1, 1636425497297, 1636425497748, 451, 0, 451, 0, 0, 0
6391, 1, 1636425497837, 1636425498293, 456, 0, 456, 0, 0, 0
6392, 1, 1636425498569, 1636425499021, 452, 0, 452, 0, 0, 0
6393, 1, 1636425498620, 1636425499073, 453, 1, 452, 0, 0, 0
6394, 1, 1636425498932, 1636425499473, 541, 89, 452, 89, 0, 89
6395, 1, 1636425499045, 1636425499493, 448, 0, 448, 0, 0, 0
6396, 1, 1636425499268, 1636425499721, 453, 1, 452, 0, 1, 1
6397, 1, 1636425499813, 1636425500265, 452, 0, 452, 0, 0, 0
6398, 1, 1636425499889, 1636425500337, 448, 0, 448, 0, 0, 0
6399, 1, 1636425500105, 1636425500553, 448, 0, 448, 0, 0, 0
6400, 1, 1636425500305, 1636425500761, 456, 0, 456, 0, 0, 0
6401, 1, 1636425500329, 1636425500784, 455, 0, 455, 0, 0, 0
6402, 1, 1636425500465, 1636425500917, 452, 0, 452, 0, 0, 0
6403, 1, 1636425500577, 1636425501029, 452, 0, 452, 0, 0, 0
6404, 1, 1636425501057, 1636425501509, 452, 0, 452, 0, 0, 0
6405, 1, 1636425501093, 1636425501541, 448, 0, 448, 0, 0, 0
6406, 1, 1636425501805, 1636425502261, 456, 0, 456, 0, 0, 0
6407, 1, 1636425502480, 1636425502933, 453, 0, 453, 0, 0, 0
6408, 1, 1636425502557, 1636425503005, 448, 0, 448, 0, 0, 0
6409, 1, 1636425502725, 1636425503173, 448, 0, 448, 0, 0, 0
6410, 1, 1636425502813, 1636425503264, 451, 0, 451, 0, 0, 0
6411, 1, 1636425503097, 1636425503553, 456, 0, 456, 0, 0, 0
6412, 1, 1636425503653, 1636425504109, 456, 0, 456, 0, 0, 0
6414, 1, 1636425504013, 1636425504457, 444, 0, 444, 0, 0, 0
6415, 1, 1636425504101, 1636425504549, 448, 0, 448, 0, 0, 0
6416, 1, 1636425504236, 1636425504689, 453, 1, 452, 0, 0, 0
6417, 1, 1636425504365, 1636425504817, 452, 0, 452, 0, 0, 0
6419, 1, 1636425504829, 1636425505281, 452, 0, 452, 0, 0, 0
6422, 1, 1636425506476, 1636425506925, 449, 1, 448, 1, 0, 1
6423, 1, 1636425506661, 1636425507117, 456, 0, 456, 0, 0, 0
6426, 1, 1636425506848, 1636425507301, 453, 1, 452, 0, 0, 0
6425, 1, 1636425506777, 1636425507381, 604, 148, 456, 148, 0, 148
6389, 2, 1636425497445, 1636425507445, 10000, 0, 10000, 304, 0, 304
6390, 2, 1636425497481, 1636425507493, 10012, 9964, 48, 268, 9696, 9964
6427, 1, 1636425507628, 1636425508081, 453, 1, 452, 0, 1, 1
6428, 1, 1636425507761, 1636425508212, 451, 0, 451, 0, 0, 0
6430, 1, 1636425508085, 1636425508536, 451, 0, 451, 0, 0, 0
6431, 1, 1636425508193, 1636425508645, 452, 0, 452, 0, 0, 0
6432, 1, 1636425508201, 1636425508652, 451, 0, 451, 0, 0, 0
6429, 1, 1636425507801, 1636425508660, 859, 412, 447, 412, 0, 412
6433, 1, 1636425508356, 1636425508809, 453, 0, 453, 0, 0, 0
6434, 1, 1636425508785, 1636425509241, 456, 0, 456, 0, 0, 0
6435, 1, 1636425510581, 1636425511037, 456, 0, 456, 0, 0, 0
6436, 1, 1636425510789, 1636425511241, 452, 0, 452, 0, 0, 0
6437, 1, 1636425510941, 1636425511497, 556, 97, 459, 96, 1, 97
6438, 1, 1636425511549, 1636425512001, 452, 0, 452, 0, 0, 0
6439, 1, 1636425511709, 1636425512449, 740, 292, 448, 292, 0, 292
6441, 1, 1636425512369, 1636425512816, 447, 0, 447, 0, 0, 0
6440, 1, 1636425512364, 1636425512817, 453, 1, 452, 1, 0, 1
6442, 1, 1636425512449, 1636425512897, 448, 0, 448, 0, 0, 0
6413, 2, 1636425503917, 1636425513917, 10000, 0, 10000, 0, 0, 0
6443, 1, 1636425514224, 1636425514676, 452, 1, 451, 0, 0, 0
6418, 2, 1636425504793, 1636425514793, 10000, 0, 10000, 0, 0, 0
6444, 1, 1636425514757, 1636425515209, 452, 0, 452, 0, 0, 0
6420, 2, 1636425505309, 1636425515308, 9999, 0, 9999, 0, 0, 0
6445, 1, 1636425514928, 1636425515381, 453, 1, 452, 0, 0, 0
6446, 1, 1636425515101, 1636425515557, 456, 0, 456, 0, 0, 0
6447, 1, 1636425515121, 1636425515660, 539, 88, 451, 88, 0, 88
6421, 2, 1636425505913, 1636425515913, 10000, 0, 10000, 0, 0, 0
6448, 1, 1636425515477, 1636425515928, 451, 0, 451, 0, 0, 0
6449, 1, 1636425515616, 1636425516069, 453, 0, 453, 0, 0, 0
6450, 1, 1636425515581, 1636425516381, 800, 348, 452, 348, 0, 348
6451, 1, 1636425516221, 1636425516677, 456, 0, 456, 0, 0, 0
6424, 2, 1636425506773, 1636425516773, 10000, 0, 10000, 0, 0, 0
6452, 1, 1636425516533, 1636425516997, 464, 0, 464, 0, 0, 0
6454, 1, 1636425516645, 1636425517097, 452, 0, 452, 0, 0, 0
6453, 1, 1636425516613, 1636425517100, 487, 0, 487, 0, 0, 0
6455, 1, 1636425517077, 1636425517528, 451, 0, 451, 0, 0, 0
6456, 1, 1636425518093, 1636425518545, 452, 0, 452, 0, 0, 0
6457, 1, 1636425518969, 1636425519417, 448, 0, 448, 0, 0, 0
6458, 1, 1636425519017, 1636425519465, 448, 0, 448, 0, 0, 0
6459, 1, 1636425519024, 1636425519477, 453, 1, 452, 0, 1, 1
6460, 1, 1636425519277, 1636425519929, 652, 200, 452, 200, 0, 200
6461, 1, 1636425519480, 1636425519933, 453, 1, 452, 0, 1, 1
6462, 1, 1636425519809, 1636425520385, 576, 124, 452, 124, 0, 124
6463, 1, 1636425520317, 1636425520768, 451, 0, 451, 0, 0, 0
6464, 1, 1636425520573, 1636425521025, 452, 0, 452, 0, 0, 0
6465, 1, 1636425520745, 1636425521197, 452, 0, 452, 0, 0, 0
6466, 1, 1636425520897, 1636425521353, 456, 0, 456, 0, 0, 0
6467, 1, 1636425522125, 1636425522577, 452, 0, 452, 0, 0, 0
6468, 1, 1636425522717, 1636425523169, 452, 0, 452, 0, 0, 0
6469, 1, 1636425522829, 1636425523281, 452, 0, 452, 0, 0, 0
6470, 1, 1636425522997, 1636425523457, 460, 0, 460, 0, 0, 0
6471, 1, 1636425523257, 1636425523733, 476, 24, 452, 24, 0, 24
6472, 1, 1636425523512, 1636425523969, 457, 1, 456, 1, 0, 1
6473, 1, 1636425523957, 1636425524421, 464, 12, 452, 12, 0, 12
6474, 1, 1636425524345, 1636425524797, 452, 0, 452, 0, 0, 0
6475, 1, 1636425524509, 1636425524965, 456, 0, 456, 0, 0, 0
6476, 1, 1636425524777, 1636425525233, 456, 0, 456, 0, 0, 0
6477, 1, 1636425525297, 1636425525749, 452, 0, 452, 0, 0, 0
6478, 1, 1636425525925, 1636425526381, 456, 0, 456, 0, 0, 0
6479, 1, 1636425526417, 1636425526873, 456, 0, 456, 0, 0, 0
6480, 1, 1636425526801, 1636425527253, 452, 0, 452, 0, 0, 0
6481, 1, 1636425527097, 1636425527549, 452, 0, 452, 0, 0, 0
6482, 1, 1636425527313, 1636425527765, 452, 0, 452, 0, 0, 0
6483, 1, 1636425527540, 1636425528001, 461, 9, 452, 9, 0, 9
6484, 1, 1636425527761, 1636425528221, 460, 4, 456, 4, 0, 4
6485, 1, 1636425528061, 1636425528513, 452, 0, 452, 0, 0, 0
6486, 1, 1636425528569, 1636425529024, 455, 0, 455, 0, 0, 0
6487, 1, 1636425528581, 1636425529037, 456, 0, 456, 0, 0, 0
6488, 1, 1636425529284, 1636425529740, 456, 1, 455, 0, 1, 1
6489, 1, 1636425529756, 1636425530208, 452, 1, 451, 0, 1, 1
6490, 1, 1636425530176, 1636425530629, 453, 1, 452, 0, 0, 0
6491, 1, 1636425530628, 1636425531085, 457, 1, 456, 1, 0, 1
6492, 1, 1636425530817, 1636425531269, 452, 0, 452, 0, 0, 0
6493, 1, 1636425531172, 1636425531629, 457, 1, 456, 0, 0, 0
6494, 1, 1636425531317, 1636425531769, 452, 0, 452, 0, 0, 0
6495, 1, 1636425531593, 1636425532081, 488, 37, 451, 36, 0, 36
6496, 1, 1636425532193, 1636425532644, 451, 0, 451, 0, 0, 0
6497, 1, 1636425532409, 1636425532865, 456, 0, 456, 0, 0, 0
6498, 1, 1636425532673, 1636425533129, 456, 0, 456, 0, 0, 0
6499, 1, 1636425533721, 1636425534173, 452, 0, 452, 0, 0, 0
6500, 1, 1636425533753, 1636425534209, 456, 0, 456, 0, 0, 0
6501, 1, 1636425534309, 1636425534761, 452, 0, 452, 0, 0, 0
6502, 1, 1636425534857, 1636425535305, 448, 0, 448, 0, 0, 0
6503, 1, 1636425534945, 1636425535401, 456, 0, 456, 0, 0, 0
6504, 1, 1636425535333, 1636425535860, 527, 69, 458, 68, 1, 69
6505, 1, 1636425535420, 1636425535872, 452, 0, 452, 0, 0, 0
6506, 1, 1636425536093, 1636425536545, 452, 0, 452, 0, 0, 0
6507, 1, 1636425536173, 1636425536629, 456, 0, 456, 0, 0, 0
6508, 1, 1636425536741, 1636425537197, 456, 0, 456, 0, 0, 0
6509, 1, 1636425537665, 1636425538117, 452, 0, 452, 0, 0, 0
6510, 1, 1636425537957, 1636425538409, 452, 0, 452, 0, 0, 0
6511, 1, 1636425538413, 1636425538869, 456, 0, 456, 0, 0, 0
6512, 1, 1636425538925, 1636425539376, 451, 0, 451, 0, 0, 0
6513, 1, 1636425538961, 1636425539417, 456, 0, 456, 0, 0, 0
6514, 1, 1636425539153, 1636425539829, 676, 224, 452, 224, 0, 224
6515, 1, 1636425539625, 1636425540077, 452, 0, 452, 0, 0, 0
6516, 1, 1636425540297, 1636425540749, 452, 0, 452, 0, 0, 0
6517, 1, 1636425540457, 1636425540913, 456, 0, 456, 0, 0, 0
6518, 1, 1636425540717, 1636425541169, 452, 0, 452, 0, 0, 0
6519, 1, 1636425541985, 1636425542437, 452, 0, 452, 0, 0, 0
6520, 1, 1636425542125, 1636425542573, 448, 0, 448, 0, 0, 0
6521, 1, 1636425542589, 1636425543041, 452, 0, 452, 0, 0, 0
6522, 1, 1636425543053, 1636425543505, 452, 0, 452, 0, 0, 0
6523, 1, 1636425543133, 1636425543581, 448, 0, 448, 0, 0, 0
6524, 1, 1636425543165, 1636425543957, 792, 340, 452, 340, 0, 340
6525, 1, 1636425543793, 1636425544249, 456, 0, 456, 0, 0, 0
6526, 1, 1636425544469, 1636425544909, 440, 0, 440, 0, 0, 0
6527, 1, 1636425544553, 1636425545001, 448, 0, 448, 0, 0, 0
6528, 1, 1636425544621, 1636425545069, 448, 0, 448, 0, 0, 0
6529, 1, 1636425546113, 1636425546561, 448, 0, 448, 0, 0, 0
6530, 1, 1636425546401, 1636425546852, 451, 0, 451, 0, 0, 0
6531, 1, 1636425546852, 1636425547301, 449, 1, 448, 1, 0, 1
6532, 1, 1636425547185, 1636425547637, 452, 0, 452, 0, 0, 0
6534, 1, 1636425547409, 1636425547861, 452, 0, 452, 0, 0, 0
6533, 1, 1636425547256, 1636425548100, 844, 381, 463, 381, 0, 381
6535, 1, 1636425548061, 1636425548513, 452, 0, 452, 0, 0, 0
6536, 1, 1636425548253, 1636425548705, 452, 0, 452, 0, 0, 0
6537, 1, 1636425548624, 1636425549065, 441, 1, 440, 0, 0, 0
6538, 1, 1636425548668, 1636425549112, 444, 0, 444, 0, 0, 0
6539, 1, 1636425550072, 1636425550508, 436, 0, 436, 0, 0, 0
6540, 1, 1636425550464, 1636425550913, 449, 0, 449, 0, 0, 0
6541, 1, 1636425550517, 1636425550961, 444, 0, 444, 0, 0, 0
6542, 1, 1636425550885, 1636425551325, 440, 0, 440, 0, 0, 0
6543, 1, 1636425551077, 1636425551524, 447, 0, 447, 0, 0, 0
6544, 1, 1636425551196, 1636425551773, 577, 129, 448, 129, 0, 129
6545, 1, 1636425551865, 1636425552317, 452, 0, 452, 0, 0, 0
6546, 1, 1636425552332, 1636425552781, 449, 1, 448, 0, 0, 0
6547, 1, 1636425552485, 1636425552941, 456, 0, 456, 0, 0, 0
6548, 1, 1636425554252, 1636425554704, 452, 1, 451, 1, 0, 1
6549, 1, 1636425554704, 1636425555165, 461, 1, 460, 1, 0, 1
6550, 1, 1636425554965, 1636425555417, 452, 0, 452, 0, 0, 0
6551, 1, 1636425555349, 1636425555801, 452, 0, 452, 0, 0, 0
6552, 1, 1636425556137, 1636425556588, 451, 0, 451, 0, 0, 0
6553, 1, 1636425556601, 1636425557056, 455, 0, 455, 0, 0, 0
6554, 1, 1636425556601, 1636425557056, 455, 0, 455, 0, 0, 0
6555, 1, 1636425557972, 1636425558429, 457, 0, 457, 0, 0, 0
6556, 1, 1636425558477, 1636425558933, 456, 0, 456, 0, 0, 0
6557, 1, 1636425558993, 1636425559449, 456, 0, 456, 0, 0, 0
6558, 1, 1636425559121, 1636425559900, 779, 328, 451, 328, 0, 328
6559, 1, 1636425559857, 1636425560353, 496, 44, 452, 44, 0, 44
6560, 1, 1636425560377, 1636425560829, 452, 0, 452, 0, 0, 0
6561, 1, 1636425560412, 1636425560861, 449, 1, 448, 0, 0, 0
6562, 1, 1636425561993, 1636425562445, 452, 0, 452, 0, 0, 0
6563, 1, 1636425562496, 1636425562949, 453, 1, 452, 0, 0, 0
6564, 1, 1636425563297, 1636425563753, 456, 0, 456, 0, 0, 0
6565, 1, 1636425564068, 1636425564521, 453, 1, 452, 0, 1, 1
6566, 1, 1636425564193, 1636425564641, 448, 0, 448, 0, 0, 0
6567, 1, 1636425564393, 1636425564973, 580, 128, 452, 128, 0, 128
6568, 1, 1636425565968, 1636425566425, 457, 1, 456, 1, 0, 1
6569, 1, 1636425566477, 1636425566929, 452, 0, 452, 0, 0, 0
6570, 1, 1636425567277, 1636425567729, 452, 0, 452, 0, 0, 0
6571, 1, 1636425568008, 1636425568460, 452, 0, 452, 0, 0, 0
6572, 1, 1636425568225, 1636425568673, 448, 0, 448, 0, 0, 0
6573, 1, 1636425568228, 1636425568913, 685, 233, 452, 232, 0, 232
6574, 1, 1636425570253, 1636425570705, 452, 0, 452, 0, 0, 0
6575, 1, 1636425570761, 1636425571213, 452, 0, 452, 0, 0, 0
6576, 1, 1636425571405, 1636425571861, 456, 0, 456, 0, 0, 0
6577, 1, 1636425572061, 1636425572513, 452, 0, 452, 0, 0, 0
6578, 1, 1636425572293, 1636425572745, 452, 0, 452, 0, 0, 0
6579, 1, 1636425572445, 1636425573197, 752, 300, 452, 300, 0, 300
6580, 1, 1636425575889, 1636425576345, 456, 0, 456, 0, 0, 0
6581, 1, 1636425579569, 1636425580025, 456, 0, 456, 0, 0, 0
6582, 1, 1636425583777, 1636425584233, 456, 0, 456, 0, 0, 0
6583, 1, 1636425587952, 1636425588405, 453, 1, 452, 1, 0, 1
6584, 1, 1636425592220, 1636425592676, 456, 0, 456, 0, 0, 0
6585, 1, 1636425596025, 1636425596481, 456, 0, 456, 0, 0, 0
6586, 1, 1636425600053, 1636425600501, 448, 0, 448, 0, 0, 0
6587, 1, 1636425603773, 1636425604225, 452, 0, 452, 0, 0, 0
6588, 1, 1636425607788, 1636425608241, 453, 1, 452, 1, 0, 1
6589, 1, 1636425611729, 1636425612181, 452, 0, 452, 0, 0, 0
6590, 1, 1636425616013, 1636425616465, 452, 0, 452, 0, 0, 0
6591, 1, 1636425620113, 1636425620565, 452, 0, 452, 0, 0, 0
6592, 1, 1636425623825, 1636425624281, 456, 0, 456, 0, 0, 0
6593, 1, 1636425627525, 1636425627981, 456, 0, 456, 0, 0, 0
6594, 1, 1636425631289, 1636425631745, 456, 0, 456, 0, 0, 0
6595, 1, 1636425635189, 1636425635641, 452, 0, 452, 0, 0, 0
6596, 1, 1636425639041, 1636425639497, 456, 0, 456, 0, 0, 0
6597, 1, 1636425643053, 1636425643505, 452, 0, 452, 0, 0, 0
6598, 1, 1636425647013, 1636425647469, 456, 0, 456, 0, 0, 0
6599, 1, 1636425651085, 1636425651537, 452, 0, 452, 0, 0, 0
6600, 1, 1636425655157, 1636425655609, 452, 0, 452, 0, 0, 0
