Xid, State, StartTime, EndTime, TransactionTime, ExecuteTime, CommunicationTime, ReadTime, WriteTime, DBTime
1, 1, 1636426201303, 1636426201799, 496, 71, 425, 26, 6, 32
2, 1, 1636426202173, 1636426202582, 409, 3, 406, 0, 1, 1
3, 1, 1636426202898, 1636426203305, 407, 3, 404, 1, 1, 2
4, 1, 1636426203621, 1636426204029, 408, 4, 404, 2, 0, 2
5, 1, 1636426204341, 1636426204750, 409, 4, 405, 0, 1, 1
6, 1, 1636426205069, 1636426205478, 409, 2, 407, 0, 0, 0
7, 1, 1636426205789, 1636426206202, 413, 4, 409, 0, 0, 0
8, 1, 1636426206513, 1636426206922, 409, 4, 405, 1, 0, 1
9, 1, 1636426207233, 1636426207653, 420, 4, 416, 1, 0, 1
10, 1, 1636426207965, 1636426208373, 408, 4, 404, 0, 1, 1
11, 1, 1636426208685, 1636426209093, 408, 4, 404, 1, 0, 1
12, 1, 1636426209401, 1636426209806, 405, 3, 402, 1, 0, 1
13, 1, 1636426210117, 1636426210517, 400, 1, 399, 0, 0, 0
14, 1, 1636426210829, 1636426211229, 400, 3, 397, 0, 0, 0
15, 1, 1636426211541, 1636426211950, 409, 3, 406, 1, 1, 2
16, 1, 1636426212261, 1636426212670, 409, 5, 404, 0, 1, 1
17, 1, 1636426212981, 1636426213381, 400, 2, 398, 1, 0, 1
18, 1, 1636426213653, 1636426214009, 356, 2, 354, 1, 0, 1
19, 1, 1636426214285, 1636426214641, 356, 2, 354, 0, 0, 0
21, 1, 1636426214909, 1636426215269, 360, 2, 358, 1, 1, 2
23, 1, 1636426215541, 1636426215897, 356, 2, 354, 1, 0, 1
25, 1, 1636426216170, 1636426216525, 355, 1, 354, 0, 0, 0
27, 1, 1636426216801, 1636426217156, 355, 3, 352, 1, 0, 1
29, 1, 1636426217421, 1636426217785, 364, 3, 361, 1, 0, 1
31, 1, 1636426218057, 1636426218413, 356, 2, 354, 1, 0, 1
33, 1, 1636426218681, 1636426219037, 356, 2, 354, 1, 0, 1
35, 1, 1636426219309, 1636426219669, 360, 2, 358, 1, 1, 2
37, 1, 1636426219941, 1636426220305, 364, 3, 361, 2, 0, 2
38, 1, 1636426220577, 1636426220933, 356, 2, 354, 0, 0, 0
40, 1, 1636426221205, 1636426221557, 352, 1, 351, 0, 0, 0
42, 1, 1636426221829, 1636426222185, 356, 2, 354, 0, 1, 1
44, 1, 1636426222453, 1636426222805, 352, 1, 351, 0, 0, 0
46, 1, 1636426223077, 1636426223433, 356, 2, 354, 1, 0, 1
48, 1, 1636426223697, 1636426224053, 356, 2, 354, 1, 1, 2
50, 1, 1636426224325, 1636426224685, 360, 2, 358, 0, 1, 1
52, 1, 1636426224953, 1636426225305, 352, 2, 350, 0, 0, 0
54, 1, 1636426225577, 1636426225933, 356, 1, 355, 0, 0, 0
57, 1, 1636426226205, 1636426226557, 352, 1, 351, 0, 0, 0
60, 1, 1636426226825, 1636426227181, 356, 2, 354, 0, 0, 0
63, 1, 1636426227445, 1636426227797, 352, 1, 351, 0, 0, 0
66, 1, 1636426228069, 1636426228425, 356, 2, 354, 0, 1, 1
69, 1, 1636426228693, 1636426229049, 356, 2, 354, 0, 1, 1
72, 1, 1636426229321, 1636426229677, 356, 2, 354, 0, 0, 0
74, 1, 1636426229945, 1636426230301, 356, 2, 354, 0, 1, 1
77, 1, 1636426230569, 1636426230925, 356, 2, 354, 0, 1, 1
80, 1, 1636426231193, 1636426231549, 356, 1, 355, 0, 0, 0
83, 1, 1636426231813, 1636426232168, 355, 2, 353, 0, 0, 0
86, 1, 1636426232432, 1636426232785, 353, 1, 352, 0, 1, 1
89, 1, 1636426233049, 1636426233409, 360, 1, 359, 0, 1, 1
92, 1, 1636426233677, 1636426234029, 352, 0, 352, 0, 0, 0
95, 1, 1636426234297, 1636426234649, 352, 1, 351, 0, 1, 1
98, 1, 1636426234921, 1636426235277, 356, 1, 355, 0, 0, 0
101, 1, 1636426235545, 1636426235901, 356, 0, 356, 0, 0, 0
104, 1, 1636426236173, 1636426236529, 356, 1, 355, 0, 1, 1
107, 1, 1636426236801, 1636426237157, 356, 2, 354, 1, 0, 1
110, 1, 1636426237424, 1636426237777, 353, 2, 351, 0, 0, 0
113, 1, 1636426238049, 1636426238413, 364, 1, 363, 0, 0, 0
116, 1, 1636426238677, 1636426239029, 352, 0, 352, 0, 0, 0
119, 1, 1636426239300, 1636426239653, 353, 1, 352, 0, 0, 0
122, 1, 1636426239917, 1636426240273, 356, 1, 355, 0, 1, 1
125, 1, 1636426240549, 1636426240901, 352, 0, 352, 0, 0, 0
128, 1, 1636426241169, 1636426241529, 360, 2, 358, 1, 1, 2
131, 1, 1636426241797, 1636426242157, 360, 1, 359, 0, 0, 0
134, 1, 1636426242421, 1636426242777, 356, 2, 354, 0, 0, 0
136, 1, 1636426243041, 1636426243401, 360, 3, 357, 0, 1, 1
139, 1, 1636426243673, 1636426244025, 352, 3, 349, 0, 0, 0
142, 1, 1636426244289, 1636426244641, 352, 0, 352, 0, 0, 0
145, 1, 1636426244913, 1636426245264, 351, 0, 351, 0, 0, 0
148, 1, 1636426245533, 1636426245889, 356, 1, 355, 0, 1, 1
151, 1, 1636426246153, 1636426246505, 352, 1, 351, 0, 0, 0
153, 1, 1636426246777, 1636426247129, 352, 1, 351, 0, 0, 0
156, 1, 1636426247397, 1636426247749, 352, 0, 352, 0, 0, 0
159, 1, 1636426248013, 1636426248365, 352, 0, 352, 0, 0, 0
162, 1, 1636426248637, 1636426248989, 352, 0, 352, 0, 0, 0
165, 1, 1636426249257, 1636426249608, 351, 2, 349, 1, 0, 1
168, 1, 1636426249873, 1636426250229, 356, 1, 355, 0, 1, 1
171, 1, 1636426250497, 1636426250848, 351, 2, 349, 1, 0, 1
174, 1, 1636426251113, 1636426251465, 352, 1, 351, 0, 0, 0
177, 1, 1636426251729, 1636426252081, 352, 0, 352, 0, 0, 0
180, 1, 1636426252345, 1636426252700, 355, 1, 354, 0, 1, 1
183, 1, 1636426252965, 1636426253316, 351, 0, 351, 0, 0, 0
186, 1, 1636426253581, 1636426253933, 352, 0, 352, 0, 0, 0
189, 1, 1636426254197, 1636426254557, 360, 1, 359, 0, 0, 0
192, 1, 1636426254824, 1636426255177, 353, 2, 351, 0, 0, 0
195, 1, 1636426255448, 1636426255801, 353, 1, 352, 0, 0, 0
198, 1, 1636426256069, 1636426256421, 352, 1, 351, 0, 0, 0
201, 1, 1636426256689, 1636426257041, 352, 0, 352, 0, 0, 0
204, 1, 1636426257305, 1636426257657, 352, 2, 350, 0, 0, 0
207, 1, 1636426257925, 1636426258277, 352, 0, 352, 0, 0, 0
210, 1, 1636426258541, 1636426258893, 352, 0, 352, 0, 0, 0
213, 1, 1636426259161, 1636426259513, 352, 1, 351, 1, 0, 1
216, 1, 1636426259777, 1636426260133, 356, 1, 355, 1, 0, 1
219, 1, 1636426260401, 1636426260753, 352, 0, 352, 0, 0, 0
222, 1, 1636426261020, 1636426261372, 352, 1, 351, 0, 0, 0
225, 1, 1636426261637, 1636426261989, 352, 1, 351, 0, 0, 0
228, 1, 1636426262252, 1636426262605, 353, 1, 352, 0, 0, 0
231, 1, 1636426262869, 1636426263221, 352, 1, 351, 0, 0, 0
234, 1, 1636426263485, 1636426263841, 356, 0, 356, 0, 0, 0
237, 1, 1636426264105, 1636426264457, 352, 0, 352, 0, 0, 0
240, 1, 1636426264724, 1636426265077, 353, 1, 352, 0, 0, 0
243, 1, 1636426265341, 1636426265693, 352, 0, 352, 0, 0, 0
246, 1, 1636426265957, 1636426266309, 352, 0, 352, 0, 0, 0
249, 1, 1636426266573, 1636426266925, 352, 0, 352, 0, 0, 0
252, 1, 1636426267193, 1636426267545, 352, 1, 351, 0, 0, 0
255, 1, 1636426267809, 1636426268161, 352, 0, 352, 0, 0, 0
258, 1, 1636426268425, 1636426268777, 352, 0, 352, 0, 0, 0
261, 1, 1636426269045, 1636426269397, 352, 0, 352, 0, 0, 0
264, 1, 1636426269665, 1636426270017, 352, 2, 350, 1, 0, 1
267, 1, 1636426270281, 1636426270632, 351, 0, 351, 0, 0, 0
270, 1, 1636426270896, 1636426271249, 353, 1, 352, 0, 0, 0
273, 1, 1636426271521, 1636426271873, 352, 0, 352, 0, 0, 0
276, 1, 1636426272141, 1636426272493, 352, 1, 351, 0, 0, 0
279, 1, 1636426272757, 1636426273109, 352, 0, 352, 0, 0, 0
281, 1, 1636426273376, 1636426273729, 353, 0, 353, 0, 0, 0
284, 1, 1636426273993, 1636426274345, 352, 0, 352, 0, 0, 0
287, 1, 1636426274609, 1636426274961, 352, 1, 351, 0, 0, 0
290, 1, 1636426275225, 1636426275581, 356, 0, 356, 0, 0, 0
293, 1, 1636426275845, 1636426276201, 356, 2, 354, 2, 0, 2
296, 1, 1636426276465, 1636426276821, 356, 2, 354, 1, 1, 2
299, 1, 1636426277085, 1636426277437, 352, 0, 352, 0, 0, 0
302, 1, 1636426277709, 1636426278061, 352, 0, 352, 0, 0, 0
305, 1, 1636426278325, 1636426278677, 352, 0, 352, 0, 0, 0
308, 1, 1636426278941, 1636426279293, 352, 1, 351, 0, 0, 0
311, 1, 1636426279557, 1636426279909, 352, 0, 352, 0, 0, 0
314, 1, 1636426280173, 1636426280525, 352, 0, 352, 0, 0, 0
317, 1, 1636426280788, 1636426281141, 353, 1, 352, 0, 0, 0
320, 1, 1636426281408, 1636426281761, 353, 2, 351, 1, 1, 2
323, 1, 1636426282025, 1636426282377, 352, 1, 351, 1, 0, 1
326, 1, 1636426282640, 1636426282993, 353, 1, 352, 0, 0, 0
329, 1, 1636426283257, 1636426283609, 352, 0, 352, 0, 0, 0
332, 1, 1636426283877, 1636426284229, 352, 0, 352, 0, 0, 0
335, 1, 1636426284493, 1636426284845, 352, 0, 352, 0, 0, 0
338, 1, 1636426285113, 1636426285464, 351, 0, 351, 0, 0, 0
340, 1, 1636426285729, 1636426286081, 352, 0, 352, 0, 0, 0
343, 1, 1636426286345, 1636426286697, 352, 1, 351, 0, 0, 0
346, 1, 1636426286961, 1636426287313, 352, 0, 352, 0, 0, 0
349, 1, 1636426287585, 1636426287937, 352, 0, 352, 0, 0, 0
352, 1, 1636426288201, 1636426288557, 356, 0, 356, 0, 0, 0
355, 1, 1636426288821, 1636426289172, 351, 0, 351, 0, 0, 0
358, 1, 1636426289437, 1636426289789, 352, 0, 352, 0, 0, 0
361, 1, 1636426290057, 1636426290409, 352, 1, 351, 0, 0, 0
364, 1, 1636426290673, 1636426291025, 352, 1, 351, 0, 0, 0
367, 1, 1636426291289, 1636426291641, 352, 1, 351, 1, 0, 1
370, 1, 1636426291905, 1636426292261, 356, 0, 356, 0, 0, 0
373, 1, 1636426292525, 1636426292877, 352, 1, 351, 0, 0, 0
376, 1, 1636426293141, 1636426293492, 351, 0, 351, 0, 0, 0
379, 1, 1636426293757, 1636426294109, 352, 0, 352, 0, 0, 0
382, 1, 1636426294377, 1636426294729, 352, 0, 352, 0, 0, 0
385, 1, 1636426294993, 1636426295345, 352, 0, 352, 0, 0, 0
388, 1, 1636426295617, 1636426295973, 356, 1, 355, 0, 1, 1
391, 1, 1636426296241, 1636426296597, 356, 1, 355, 0, 1, 1
394, 1, 1636426296865, 1636426297216, 351, 1, 350, 0, 0, 0
397, 1, 1636426297484, 1636426297837, 353, 2, 351, 1, 0, 1
400, 1, 1636426298101, 1636426298453, 352, 0, 352, 0, 0, 0
403, 1, 1636426298721, 1636426299077, 356, 0, 356, 0, 0, 0
406, 1, 1636426299341, 1636426299693, 352, 0, 352, 0, 0, 0
409, 1, 1636426299957, 1636426300309, 352, 0, 352, 0, 0, 0
412, 1, 1636426300573, 1636426300925, 352, 0, 352, 0, 0, 0
415, 1, 1636426301189, 1636426301540, 351, 0, 351, 0, 0, 0
418, 1, 1636426301805, 1636426302157, 352, 0, 352, 0, 0, 0
421, 1, 1636426302425, 1636426302777, 352, 0, 352, 0, 0, 0
423, 1, 1636426303041, 1636426303393, 352, 0, 352, 0, 0, 0
426, 1, 1636426303661, 1636426304013, 352, 0, 352, 0, 0, 0
429, 1, 1636426304277, 1636426304633, 356, 0, 356, 0, 0, 0
432, 1, 1636426304897, 1636426305249, 352, 0, 352, 0, 0, 0
435, 1, 1636426305521, 1636426305877, 356, 0, 356, 0, 0, 0
438, 1, 1636426306141, 1636426306493, 352, 0, 352, 0, 0, 0
441, 1, 1636426306757, 1636426307113, 356, 1, 355, 0, 0, 0
444, 1, 1636426307381, 1636426307736, 355, 1, 354, 0, 0, 0
447, 1, 1636426308005, 1636426308365, 360, 0, 360, 0, 0, 0
450, 1, 1636426308629, 1636426308981, 352, 0, 352, 0, 0, 0
453, 1, 1636426309245, 1636426309597, 352, 0, 352, 0, 0, 0
456, 1, 1636426309861, 1636426310217, 356, 0, 356, 0, 0, 0
459, 1, 1636426310485, 1636426310837, 352, 0, 352, 0, 0, 0
462, 1, 1636426311105, 1636426311457, 352, 0, 352, 0, 0, 0
465, 1, 1636426311729, 1636426312085, 356, 0, 356, 0, 0, 0
468, 1, 1636426312349, 1636426312701, 352, 0, 352, 0, 0, 0
471, 1, 1636426312965, 1636426313317, 352, 0, 352, 0, 0, 0
474, 1, 1636426313580, 1636426313937, 357, 1, 356, 0, 0, 0
477, 1, 1636426314201, 1636426314553, 352, 0, 352, 0, 0, 0
480, 1, 1636426314821, 1636426315173, 352, 0, 352, 0, 0, 0
483, 1, 1636426315437, 1636426315793, 356, 2, 354, 0, 0, 0
486, 1, 1636426316057, 1636426316409, 352, 0, 352, 0, 0, 0
489, 1, 1636426316677, 1636426317029, 352, 0, 352, 0, 0, 0
492, 1, 1636426317293, 1636426317645, 352, 0, 352, 0, 0, 0
495, 1, 1636426317909, 1636426318261, 352, 0, 352, 0, 0, 0
498, 1, 1636426318525, 1636426318877, 352, 0, 352, 0, 0, 0
501, 1, 1636426319141, 1636426319493, 352, 1, 351, 1, 0, 1
504, 1, 1636426319757, 1636426320109, 352, 0, 352, 0, 0, 0
507, 1, 1636426320373, 1636426320729, 356, 0, 356, 0, 0, 0
510, 1, 1636426320993, 1636426321345, 352, 0, 352, 0, 0, 0
513, 1, 1636426321617, 1636426321973, 356, 0, 356, 0, 0, 0
516, 1, 1636426322237, 1636426322589, 352, 0, 352, 0, 0, 0
518, 1, 1636426322853, 1636426323205, 352, 0, 352, 0, 0, 0
521, 1, 1636426323469, 1636426323821, 352, 0, 352, 0, 0, 0
524, 1, 1636426324089, 1636426324441, 352, 0, 352, 0, 0, 0
527, 1, 1636426324705, 1636426325057, 352, 0, 352, 0, 0, 0
530, 1, 1636426325321, 1636426325677, 356, 0, 356, 0, 0, 0
533, 1, 1636426325941, 1636426326293, 352, 0, 352, 0, 0, 0
536, 1, 1636426326561, 1636426326913, 352, 1, 351, 0, 0, 0
1, 1, 1636426901545, 1636426902201, 656, 10, 646, 0, 0, 0
2, 1, 1636426902993, 1636426903585, 592, 0, 592, 0, 0, 0
3, 1, 1636426903601, 1636426904196, 595, 2, 593, 1, 1, 2
4, 1, 1636426904385, 1636426904981, 596, 1, 595, 0, 0, 0
5, 1, 1636426905041, 1636426905641, 600, 1, 599, 1, 0, 1
6, 1, 1636426905181, 1636426905765, 584, 0, 584, 0, 0, 0
7, 1, 1636426905705, 1636426906305, 600, 1, 599, 0, 0, 0
8, 1, 1636426906349, 1636426906937, 588, 1, 587, 0, 0, 0
9, 1, 1636426906892, 1636426907480, 588, 1, 587, 0, 1, 1
10, 1, 1636426906904, 1636426907525, 621, 34, 587, 34, 0, 34
12, 1, 1636426907465, 1636426908065, 600, 17, 583, 17, 0, 17
11, 1, 1636426907448, 1636426908117, 669, 77, 592, 76, 0, 76
13, 1, 1636426908001, 1636426908697, 696, 117, 579, 117, 0, 117
14, 1, 1636426908241, 1636426908833, 592, 0, 592, 0, 0, 0
15, 1, 1636426908901, 1636426909493, 592, 0, 592, 0, 0, 0
16, 1, 1636426909109, 1636426909705, 596, 2, 594, 0, 0, 0
17, 1, 1636426909617, 1636426910121, 504, 0, 504, 0, 0, 0
18, 1, 1636426909653, 1636426910157, 504, 0, 504, 0, 0, 0
19, 1, 1636426910160, 1636426910661, 501, 1, 500, 0, 0, 0
20, 1, 1636426910245, 1636426910740, 495, 0, 495, 0, 0, 0
21, 1, 1636426910649, 1636426911153, 504, 1, 503, 0, 0, 0
23, 1, 1636426910784, 1636426911277, 493, 1, 492, 0, 0, 0
22, 1, 1636426910777, 1636426911280, 503, 0, 503, 0, 0, 0
24, 1, 1636426911261, 1636426911773, 512, 17, 495, 17, 0, 17
25, 1, 1636426911296, 1636426911796, 500, 1, 499, 1, 0, 1
26, 1, 1636426911308, 1636426911813, 505, 1, 504, 0, 0, 0
27, 1, 1636426911745, 1636426912285, 540, 29, 511, 29, 0, 29
28, 1, 1636426911893, 1636426912389, 496, 0, 496, 0, 0, 0
29, 1, 1636426912001, 1636426912497, 496, 0, 496, 0, 0, 0
30, 1, 1636426912416, 1636426912913, 497, 1, 496, 0, 0, 0
31, 1, 1636426912665, 1636426913161, 496, 0, 496, 0, 0, 0
32, 1, 1636426912953, 1636426913453, 500, 0, 500, 0, 0, 0
33, 1, 1636426913220, 1636426913713, 493, 0, 493, 0, 0, 0
34, 1, 1636426913437, 1636426913888, 451, 0, 451, 0, 0, 0
35, 1, 1636426913477, 1636426913973, 496, 0, 496, 0, 0, 0
36, 1, 1636426913605, 1636426914057, 452, 0, 452, 0, 0, 0
37, 1, 1636426913932, 1636426914385, 453, 1, 452, 0, 1, 1
38, 1, 1636426913941, 1636426914509, 568, 117, 451, 117, 0, 117
39, 1, 1636426914020, 1636426914512, 492, 1, 491, 0, 0, 0
40, 1, 1636426914472, 1636426914920, 448, 0, 448, 0, 0, 0
41, 1, 1636426914556, 1636426915048, 492, 1, 491, 0, 1, 1
42, 1, 1636426914725, 1636426915176, 451, 0, 451, 0, 0, 0
43, 1, 1636426914817, 1636426915272, 455, 0, 455, 0, 0, 0
44, 1, 1636426914965, 1636426915412, 447, 0, 447, 0, 0, 0
45, 1, 1636426915256, 1636426915709, 453, 1, 452, 0, 0, 0
46, 1, 1636426915428, 1636426915885, 457, 1, 456, 1, 0, 1
47, 1, 1636426915444, 1636426915897, 453, 0, 453, 0, 0, 0
48, 1, 1636426915681, 1636426916164, 483, 29, 454, 29, 0, 29
49, 1, 1636426916129, 1636426916581, 452, 0, 452, 0, 0, 0
50, 1, 1636426916152, 1636426916616, 464, 13, 451, 13, 0, 13
51, 1, 1636426916693, 1636426917149, 456, 0, 456, 0, 0, 0
52, 1, 1636426916789, 1636426917245, 456, 0, 456, 0, 0, 0
53, 1, 1636426917421, 1636426917873, 452, 0, 452, 0, 0, 0
54, 1, 1636426917429, 1636426917881, 452, 0, 452, 0, 0, 0
55, 1, 1636426917516, 1636426917965, 449, 1, 448, 0, 0, 0
56, 1, 1636426917617, 1636426918069, 452, 0, 452, 0, 0, 0
58, 1, 1636426917832, 1636426918341, 509, 50, 459, 49, 1, 50
57, 1, 1636426917728, 1636426918421, 693, 238, 455, 237, 0, 237
59, 1, 1636426918108, 1636426918569, 461, 1, 460, 0, 0, 0
60, 1, 1636426918289, 1636426918801, 512, 52, 460, 52, 0, 52
61, 1, 1636426918641, 1636426919089, 448, 0, 448, 0, 0, 0
62, 1, 1636426918653, 1636426919105, 452, 0, 452, 0, 0, 0
63, 1, 1636426918988, 1636426919440, 452, 1, 451, 0, 0, 0
64, 1, 1636426918985, 1636426919549, 564, 105, 459, 104, 0, 104
65, 1, 1636426919269, 1636426919717, 448, 0, 448, 0, 0, 0
66, 1, 1636426919396, 1636426920008, 612, 154, 458, 154, 0, 154
67, 1, 1636426919601, 1636426920053, 452, 0, 452, 0, 0, 0
68, 1, 1636426919617, 1636426920177, 560, 101, 459, 100, 1, 101
69, 1, 1636426920069, 1636426920521, 452, 0, 452, 0, 0, 0
70, 1, 1636426920300, 1636426920757, 457, 1, 456, 0, 0, 0
71, 1, 1636426920601, 1636426921049, 448, 0, 448, 0, 0, 0
72, 1, 1636426920961, 1636426921409, 448, 0, 448, 0, 0, 0
73, 1, 1636426921141, 1636426921594, 453, 0, 453, 0, 0, 0
74, 1, 1636426921345, 1636426921797, 452, 0, 452, 0, 0, 0
76, 1, 1636426921700, 1636426922157, 457, 1, 456, 0, 0, 0
77, 1, 1636426921789, 1636426922241, 452, 0, 452, 0, 0, 0
75, 1, 1636426921649, 1636426922257, 608, 149, 459, 148, 1, 149
79, 1, 1636426922021, 1636426922613, 592, 137, 455, 137, 0, 137
78, 1, 1636426921993, 1636426922717, 724, 265, 459, 264, 0, 264
80, 1, 1636426922280, 1636426922733, 453, 1, 452, 0, 1, 1
81, 1, 1636426922825, 1636426923281, 456, 0, 456, 0, 0, 0
82, 1, 1636426922900, 1636426923349, 449, 1, 448, 0, 0, 0
83, 1, 1636426922941, 1636426923397, 456, 0, 456, 0, 0, 0
84, 1, 1636426923197, 1636426923853, 656, 200, 456, 200, 0, 200
86, 1, 1636426923513, 1636426923965, 452, 0, 452, 0, 0, 0
87, 1, 1636426923589, 1636426924045, 456, 0, 456, 0, 0, 0
85, 1, 1636426923497, 1636426924300, 803, 356, 447, 356, 0, 356
88, 1, 1636426923620, 1636426924501, 881, 426, 455, 424, 0, 424
90, 1, 1636426924256, 1636426924708, 452, 1, 451, 0, 1, 1
89, 1, 1636426924245, 1636426924752, 507, 56, 451, 56, 0, 56
91, 1, 1636426924680, 1636426925161, 481, 29, 452, 29, 0, 29
92, 1, 1636426924905, 1636426925357, 452, 0, 452, 0, 0, 0
93, 1, 1636426925173, 1636426925625, 452, 0, 452, 0, 0, 0
94, 1, 1636426925521, 1636426925973, 452, 0, 452, 0, 0, 0
95, 1, 1636426925700, 1636426926152, 452, 1, 451, 0, 1, 1
96, 1, 1636426925744, 1636426926197, 453, 1, 452, 0, 1, 1
97, 1, 1636426925917, 1636426926425, 508, 56, 452, 56, 0, 56
99, 1, 1636426926197, 1636426926649, 452, 0, 452, 0, 0, 0
98, 1, 1636426926085, 1636426926657, 572, 113, 459, 112, 0, 112
100, 1, 1636426926257, 1636426926881, 624, 169, 455, 169, 0, 169
101, 1, 1636426926737, 1636426927193, 456, 0, 456, 0, 0, 0
102, 1, 1636426926933, 1636426927385, 452, 0, 452, 0, 0, 0
103, 1, 1636426927113, 1636426927564, 451, 0, 451, 0, 0, 0
105, 1, 1636426927425, 1636426927876, 451, 0, 451, 0, 0, 0
108, 1, 1636426927545, 1636426927996, 451, 0, 451, 0, 0, 0
106, 1, 1636426927537, 1636426928337, 800, 340, 460, 340, 0, 340
109, 1, 1636426928289, 1636426928741, 452, 0, 452, 0, 0, 0
111, 1, 1636426928957, 1636426929409, 452, 0, 452, 0, 0, 0
113, 1, 1636426929233, 1636426929685, 452, 0, 452, 0, 0, 0
114, 1, 1636426929661, 1636426930117, 456, 0, 456, 0, 0, 0
116, 1, 1636426929732, 1636426930188, 456, 1, 455, 0, 0, 0
117, 1, 1636426929921, 1636426930576, 655, 197, 458, 196, 1, 197
119, 1, 1636426930228, 1636426930681, 453, 1, 452, 1, 0, 1
121, 1, 1636426930989, 1636426931433, 444, 0, 444, 0, 0, 0
122, 1, 1636426931029, 1636426931485, 456, 0, 456, 0, 0, 0
123, 1, 1636426931049, 1636426931493, 444, 0, 444, 0, 0, 0
124, 1, 1636426931456, 1636426931953, 497, 38, 459, 36, 0, 36
125, 1, 1636426931601, 1636426932053, 452, 0, 452, 0, 0, 0
126, 1, 1636426931785, 1636426932409, 624, 169, 455, 169, 0, 169
127, 1, 1636426932568, 1636426933029, 461, 0, 461, 0, 0, 0
128, 1, 1636426933029, 1636426933485, 456, 1, 455, 0, 0, 0
129, 1, 1636426933309, 1636426933765, 456, 0, 456, 0, 0, 0
130, 1, 1636426933785, 1636426934237, 452, 0, 452, 0, 0, 0
131, 1, 1636426933969, 1636426934429, 460, 0, 460, 0, 0, 0
133, 1, 1636426934289, 1636426934741, 452, 0, 452, 0, 0, 0
132, 1, 1636426934221, 1636426934885, 664, 209, 455, 209, 0, 209
134, 1, 1636426935061, 1636426935509, 448, 0, 448, 0, 0, 0
135, 1, 1636426935089, 1636426935541, 452, 0, 452, 0, 0, 0
136, 1, 1636426935204, 1636426935657, 453, 1, 452, 0, 0, 0
137, 1, 1636426935464, 1636426936001, 537, 78, 459, 78, 0, 78
138, 1, 1636426935677, 1636426936133, 456, 0, 456, 0, 0, 0
139, 1, 1636426935793, 1636426936461, 668, 209, 459, 209, 0, 209
140, 1, 1636426936701, 1636426937153, 452, 0, 452, 0, 0, 0
104, 2, 1636426927217, 1636426937225, 10008, 0, 10008, 348, 0, 348
107, 2, 1636426927545, 1636426937545, 10000, 0, 10000, 20, 0, 20
141, 1, 1636426937149, 1636426937632, 483, 5, 478, 5, 0, 5
142, 1, 1636426937604, 1636426938045, 441, 0, 441, 0, 0, 0
143, 1, 1636426937857, 1636426938309, 452, 0, 452, 0, 0, 0
145, 1, 1636426937997, 1636426938453, 456, 0, 456, 0, 0, 0
110, 2, 1636426928473, 1636426938473, 10000, 0, 10000, 0, 0, 0
146, 1, 1636426938253, 1636426938705, 452, 1, 451, 0, 0, 0
147, 1, 1636426938357, 1636426938809, 452, 0, 452, 0, 0, 0
144, 1, 1636426938000, 1636426938909, 909, 454, 455, 453, 1, 454
112, 2, 1636426929081, 1636426939081, 10000, 0, 10000, 0, 0, 0
148, 1, 1636426938516, 1636426939165, 649, 190, 459, 190, 0, 190
149, 1, 1636426938877, 1636426939397, 520, 33, 487, 32, 0, 32
150, 1, 1636426939128, 1636426939609, 481, 38, 443, 38, 0, 38
151, 1, 1636426939165, 1636426939612, 447, 1, 446, 0, 0, 0
115, 2, 1636426929692, 1636426939693, 10001, 0, 10001, 1, 0, 1
152, 1, 1636426939429, 1636426939917, 488, 0, 488, 0, 0, 0
153, 1, 1636426939477, 1636426939925, 448, 0, 448, 0, 0, 0
154, 1, 1636426939593, 1636426940096, 503, 20, 483, 20, 0, 20
118, 2, 1636426930153, 1636426940153, 10000, 0, 10000, 0, 0, 0
155, 1, 1636426939972, 1636426940468, 496, 1, 495, 0, 0, 0
157, 1, 1636426940096, 1636426940565, 469, 1, 468, 0, 0, 0
156, 1, 1636426939985, 1636426940568, 583, 112, 471, 112, 0, 112
120, 1, 1636426930540, 1636426940608, 10068, 9613, 455, 0, 9612, 9612
158, 1, 1636426940549, 1636426941021, 472, 17, 455, 16, 1, 17
159, 1, 1636426940749, 1636426941201, 452, 0, 452, 0, 0, 0
160, 1, 1636426940896, 1636426941477, 581, 126, 455, 125, 1, 126
161, 1, 1636426941193, 1636426941653, 460, 9, 451, 9, 0, 9
162, 1, 1636426941277, 1636426941725, 448, 0, 448, 0, 0, 0
163, 1, 1636426941744, 1636426942201, 457, 1, 456, 0, 0, 0
165, 1, 1636426942081, 1636426942536, 455, 0, 455, 0, 0, 0
164, 1, 1636426941848, 1636426942657, 809, 354, 455, 354, 0, 354
166, 1, 1636426942329, 1636426942772, 443, 0, 443, 0, 0, 0
167, 1, 1636426942580, 1636426943033, 453, 1, 452, 0, 0, 0
168, 1, 1636426942684, 1636426943133, 449, 1, 448, 1, 0, 1
169, 1, 1636426942820, 1636426943273, 453, 1, 452, 0, 0, 0
170, 1, 1636426943129, 1636426943581, 452, 0, 452, 0, 0, 0
171, 1, 1636426943209, 1636426943657, 448, 0, 448, 0, 0, 0
172, 1, 1636426943233, 1636426943685, 452, 0, 452, 0, 0, 0
173, 1, 1636426943240, 1636426943725, 485, 34, 451, 32, 0, 32
174, 1, 1636426943796, 1636426944252, 456, 1, 455, 0, 0, 0
175, 1, 1636426943832, 1636426944277, 445, 1, 444, 0, 0, 0
176, 1, 1636426943876, 1636426944329, 453, 1, 452, 0, 0, 0
177, 1, 1636426944220, 1636426944705, 485, 33, 452, 33, 0, 33
178, 1, 1636426944296, 1636426944756, 460, 1, 459, 1, 0, 1
179, 1, 1636426944481, 1636426944936, 455, 0, 455, 0, 0, 0
180, 1, 1636426944768, 1636426945221, 453, 1, 452, 0, 0, 0
181, 1, 1636426944929, 1636426945388, 459, 7, 452, 7, 0, 7
182, 1, 1636426945065, 1636426945517, 452, 0, 452, 0, 0, 0
183, 1, 1636426945433, 1636426945885, 452, 0, 452, 0, 0, 0
185, 1, 1636426945821, 1636426946277, 456, 0, 456, 0, 0, 0
184, 1, 1636426945601, 1636426946349, 748, 285, 463, 284, 0, 284
186, 1, 1636426946317, 1636426946769, 452, 0, 452, 0, 0, 0
187, 1, 1636426946517, 1636426946964, 447, 0, 447, 0, 0, 0
188, 1, 1636426946553, 1636426947008, 455, 0, 455, 0, 0, 0
189, 1, 1636426946885, 1636426947332, 447, 0, 447, 0, 0, 0
191, 1, 1636426946924, 1636426947376, 452, 1, 451, 0, 0, 0
190, 1, 1636426946920, 1636426947416, 496, 45, 451, 45, 0, 45
192, 1, 1636426947041, 1636426947497, 456, 0, 456, 0, 0, 0
193, 1, 1636426947285, 1636426947953, 668, 213, 455, 213, 0, 213
194, 1, 1636426947532, 1636426947989, 457, 1, 456, 0, 0, 0
196, 1, 1636426947664, 1636426948117, 453, 1, 452, 0, 0, 0
195, 1, 1636426947661, 1636426948117, 456, 0, 456, 0, 0, 0
197, 1, 1636426947917, 1636426948444, 527, 73, 454, 73, 0, 73
198, 1, 1636426947996, 1636426948572, 576, 122, 454, 122, 0, 122
199, 1, 1636426948272, 1636426948729, 457, 1, 456, 0, 1, 1
200, 1, 1636426948456, 1636426949024, 568, 117, 451, 116, 0, 116
201, 1, 1636426948716, 1636426949185, 469, 14, 455, 12, 1, 13
202, 1, 1636426948913, 1636426949369, 456, 0, 456, 0, 0, 0
203, 1, 1636426949341, 1636426949789, 448, 0, 448, 0, 0, 0
205, 1, 1636426949609, 1636426950060, 451, 0, 451, 0, 0, 0
204, 1, 1636426949349, 1636426950249, 900, 441, 459, 441, 0, 441
206, 1, 1636426950104, 1636426950557, 453, 1, 452, 0, 0, 0
207, 1, 1636426950284, 1636426950737, 453, 1, 452, 0, 0, 0
208, 1, 1636426950385, 1636426950841, 456, 0, 456, 0, 0, 0
211, 1, 1636426950761, 1636426951209, 448, 0, 448, 0, 0, 0
210, 1, 1636426950769, 1636426951217, 448, 0, 448, 0, 0, 0
209, 1, 1636426950621, 1636426951293, 672, 221, 451, 220, 0, 220
214, 1, 1636426951325, 1636426951793, 468, 0, 468, 0, 0, 0
215, 1, 1636426951433, 1636426951885, 452, 0, 452, 0, 0, 0
217, 1, 1636426951601, 1636426952249, 648, 193, 455, 193, 0, 193
218, 1, 1636426951985, 1636426952441, 456, 0, 456, 0, 0, 0
220, 1, 1636426952445, 1636426952897, 452, 0, 452, 0, 0, 0
222, 1, 1636426952965, 1636426953416, 451, 0, 451, 0, 0, 0
223, 1, 1636426953040, 1636426953493, 453, 1, 452, 0, 0, 0
224, 1, 1636426953281, 1636426953948, 667, 213, 454, 213, 0, 213
227, 1, 1636426954077, 1636426954529, 452, 0, 452, 0, 0, 0
228, 1, 1636426954089, 1636426954541, 452, 0, 452, 0, 0, 0
229, 1, 1636426954512, 1636426954997, 485, 30, 455, 29, 0, 29
231, 1, 1636426954821, 1636426955272, 451, 0, 451, 0, 0, 0
232, 1, 1636426955133, 1636426955585, 452, 0, 452, 0, 0, 0
235, 1, 1636426955685, 1636426956141, 456, 0, 456, 0, 0, 0
236, 1, 1636426956144, 1636426956601, 457, 1, 456, 0, 1, 1
237, 1, 1636426956749, 1636426957201, 452, 0, 452, 0, 0, 0
238, 1, 1636426956852, 1636426957304, 452, 1, 451, 0, 0, 0
239, 1, 1636426957084, 1636426957752, 668, 221, 447, 221, 0, 221
240, 1, 1636426957913, 1636426958365, 452, 0, 452, 0, 0, 0
242, 1, 1636426958485, 1636426958937, 452, 0, 452, 0, 0, 0
243, 1, 1636426958605, 1636426959061, 456, 0, 456, 0, 0, 0
244, 1, 1636426958941, 1636426959384, 443, 0, 443, 0, 0, 0
245, 1, 1636426959493, 1636426959945, 452, 0, 452, 0, 0, 0
246, 1, 1636426959973, 1636426960429, 456, 0, 456, 0, 0, 0
212, 2, 1636426950772, 1636426960777, 10005, 0, 10005, 446, 0, 446
213, 2, 1636426951165, 1636426961165, 10000, 0, 10000, 52, 0, 52
247, 1, 1636426960957, 1636426961413, 456, 0, 456, 0, 0, 0
248, 1, 1636426961044, 1636426961493, 449, 1, 448, 0, 0, 0
216, 2, 1636426951512, 1636426961513, 10001, 0, 10001, 1, 0, 1
249, 1, 1636426961212, 1636426961944, 732, 282, 450, 280, 0, 280
219, 2, 1636426952117, 1636426962117, 10000, 0, 10000, 0, 0, 0
252, 1, 1636426961912, 1636426962369, 457, 1, 456, 1, 0, 1
221, 2, 1636426952712, 1636426962709, 9997, 0, 9997, 0, 0, 0
254, 1, 1636426962525, 1636426962977, 452, 0, 452, 0, 0, 0
255, 1, 1636426962621, 1636426963121, 500, 0, 500, 0, 0, 0
225, 2, 1636426953457, 1636426963456, 9999, 0, 9999, 0, 0, 0
257, 1, 1636426963105, 1636426963556, 451, 0, 451, 0, 0, 0
226, 2, 1636426953952, 1636426963953, 10001, 0, 10001, 0, 0, 0
260, 1, 1636426963865, 1636426964365, 500, 0, 500, 0, 0, 0
230, 2, 1636426954581, 1636426964581, 10000, 0, 10000, 0, 0, 0
262, 1, 1636426964357, 1636426964824, 467, 9, 458, 9, 0, 9
263, 1, 1636426964805, 1636426965256, 451, 0, 451, 0, 0, 0
233, 2, 1636426955317, 1636426965317, 10000, 0, 10000, 0, 0, 0
264, 1, 1636426964985, 1636426965437, 452, 0, 452, 0, 0, 0
234, 2, 1636426955533, 1636426965534, 10001, 0, 10001, 0, 0, 0
265, 1, 1636426965077, 1636426965544, 467, 0, 467, 0, 0, 0
241, 1, 1636426957925, 1636426965989, 8064, 7609, 455, 0, 7609, 7609
266, 1, 1636426965281, 1636426965992, 711, 264, 447, 264, 0, 264
267, 1, 1636426965752, 1636426966209, 457, 0, 457, 0, 0, 0
269, 1, 1636426965984, 1636426966437, 453, 1, 452, 0, 0, 0
268, 1, 1636426965936, 1636426966661, 725, 274, 451, 274, 0, 274
271, 1, 1636426966529, 1636426966985, 456, 0, 456, 0, 0, 0
272, 1, 1636426966597, 1636426967053, 456, 0, 456, 0, 0, 0
270, 1, 1636426966276, 1636426967113, 837, 385, 452, 384, 0, 384
273, 1, 1636426967337, 1636426967797, 460, 1, 459, 1, 0, 1
274, 1, 1636426968009, 1636426968465, 456, 0, 456, 0, 0, 0
275, 1, 1636426968537, 1636426968989, 452, 0, 452, 0, 0, 0
276, 1, 1636426968589, 1636426969041, 452, 0, 452, 0, 0, 0
277, 1, 1636426969217, 1636426969669, 452, 0, 452, 0, 0, 0
278, 1, 1636426969249, 1636426969701, 452, 0, 452, 0, 0, 0
279, 1, 1636426969285, 1636426970161, 876, 417, 459, 416, 0, 416
280, 1, 1636426969864, 1636426970321, 457, 1, 456, 0, 0, 0
281, 1, 1636426969945, 1636426970392, 447, 0, 447, 0, 0, 0
283, 1, 1636426970308, 1636426970760, 452, 1, 451, 0, 0, 0
282, 1, 1636426970141, 1636426970772, 631, 181, 450, 181, 0, 181
285, 1, 1636426970444, 1636426970896, 452, 1, 451, 0, 0, 0
284, 1, 1636426970340, 1636426971224, 884, 433, 451, 433, 0, 433
286, 1, 1636426971180, 1636426971633, 453, 1, 452, 0, 0, 0
250, 2, 1636426961648, 1636426971649, 10001, 0, 10001, 297, 0, 297
251, 2, 1636426961648, 1636426971697, 10049, 0, 10049, 297, 0, 297
253, 2, 1636426962113, 1636426972109, 9996, 0, 9996, 0, 0, 0
287, 1, 1636426971973, 1636426972424, 451, 0, 451, 0, 0, 0
256, 2, 1636426962685, 1636426972685, 10000, 0, 10000, 0, 0, 0
291, 1, 1636426972497, 1636426972953, 456, 0, 456, 0, 0, 0
258, 2, 1636426963121, 1636426973121, 10000, 0, 10000, 0, 0, 0
292, 1, 1636426972881, 1636426973349, 468, 0, 468, 0, 0, 0
294, 1, 1636426973176, 1636426973633, 457, 1, 456, 0, 0, 0
259, 2, 1636426963689, 1636426973689, 10000, 0, 10000, 0, 0, 0
296, 1, 1636426973461, 1636426973912, 451, 0, 451, 0, 0, 0
261, 1, 1636426964236, 1636426974140, 9904, 9453, 451, 0, 9453, 9453
298, 1, 1636426973825, 1636426974277, 452, 0, 452, 0, 0, 0
299, 1, 1636426973872, 1636426974324, 452, 1, 451, 0, 0, 0
297, 1, 1636426973529, 1636426974360, 831, 384, 447, 384, 0, 384
302, 1, 1636426974132, 1636426974736, 604, 146, 458, 145, 1, 146
303, 1, 1636426974288, 1636426974780, 492, 37, 455, 37, 0, 37
305, 1, 1636426974605, 1636426975056, 451, 0, 451, 0, 0, 0
301, 1, 1636426974077, 1636426975189, 1112, 660, 452, 660, 0, 660
306, 1, 1636426974985, 1636426975437, 452, 0, 452, 0, 0, 0
307, 1, 1636426975817, 1636426976269, 452, 0, 452, 0, 0, 0
308, 1, 1636426976353, 1636426976804, 451, 0, 451, 0, 0, 0
309, 1, 1636426976996, 1636426977449, 453, 1, 452, 0, 0, 0
310, 1, 1636426977037, 1636426977489, 452, 0, 452, 0, 0, 0
311, 1, 1636426977169, 1636426977621, 452, 0, 452, 0, 0, 0
312, 1, 1636426977337, 1636426978085, 748, 285, 463, 284, 1, 285
313, 1, 1636426977748, 1636426978201, 453, 1, 452, 1, 0, 1
316, 1, 1636426978141, 1636426978596, 455, 0, 455, 0, 0, 0
315, 1, 1636426977997, 1636426978656, 659, 205, 454, 205, 0, 205
317, 1, 1636426978500, 1636426979049, 549, 97, 452, 97, 0, 97
318, 1, 1636426978644, 1636426979093, 449, 1, 448, 0, 1, 1
314, 1, 1636426977880, 1636426979109, 1229, 777, 452, 777, 0, 777
319, 1, 1636426979253, 1636426979709, 456, 0, 456, 0, 0, 0
320, 1, 1636426980089, 1636426980541, 452, 0, 452, 0, 0, 0
321, 1, 1636426980621, 1636426981073, 452, 0, 452, 0, 0, 0
322, 1, 1636426980772, 1636426981225, 453, 1, 452, 0, 0, 0
323, 1, 1636426981097, 1636426981549, 452, 0, 452, 0, 0, 0
324, 1, 1636426981305, 1636426981761, 456, 0, 456, 0, 0, 0
325, 1, 1636426981321, 1636426982005, 684, 229, 455, 229, 0, 229
289, 2, 1636426972328, 1636426982329, 10001, 0, 10001, 0, 0, 0
288, 2, 1636426972328, 1636426982377, 10049, 0, 10049, 1, 0, 1
326, 1, 1636426981989, 1636426982436, 447, 0, 447, 0, 0, 0
290, 2, 1636426972468, 1636426982468, 10000, 0, 10000, 1, 0, 1
329, 1, 1636426982424, 1636426982881, 457, 0, 457, 0, 0, 0
330, 1, 1636426982512, 1636426982964, 452, 0, 452, 0, 0, 0
293, 2, 1636426973045, 1636426983045, 10000, 0, 10000, 0, 0, 0
331, 1, 1636426982688, 1636426983141, 453, 1, 452, 0, 0, 0
333, 1, 1636426982701, 1636426983361, 660, 181, 479, 180, 0, 180
295, 2, 1636426973473, 1636426983473, 10000, 0, 10000, 0, 0, 0
336, 1, 1636426983516, 1636426983969, 453, 0, 453, 0, 0, 0
300, 2, 1636426974037, 1636426984037, 10000, 0, 10000, 0, 0, 0
304, 1, 1636426974413, 1636426984493, 10080, 9625, 455, 0, 9625, 9625
338, 1, 1636426984344, 1636426984796, 452, 0, 452, 0, 0, 0
341, 1, 1636426984769, 1636426985225, 456, 0, 456, 0, 0, 0
342, 1, 1636426984881, 1636426985333, 452, 0, 452, 0, 0, 0
344, 1, 1636426985561, 1636426986017, 456, 0, 456, 0, 0, 0
346, 1, 1636426986152, 1636426986604, 452, 1, 451, 0, 0, 0
347, 1, 1636426986249, 1636426986692, 443, 0, 443, 0, 0, 0
348, 1, 1636426986424, 1636426986881, 457, 1, 456, 0, 0, 0
353, 1, 1636426988689, 1636426989141, 452, 0, 452, 0, 0, 0
356, 1, 1636426990076, 1636426990528, 452, 1, 451, 0, 0, 0
358, 1, 1636426990384, 1636426990841, 457, 1, 456, 1, 0, 1
327, 2, 1636426982020, 1636426992025, 10005, 0, 10005, 416, 0, 416
328, 2, 1636426982157, 1636426992157, 10000, 0, 10000, 280, 0, 280
332, 2, 1636426982692, 1636426992692, 10000, 0, 10000, 449, 0, 449
334, 2, 1636426982820, 1636426992821, 10001, 0, 10001, 321, 0, 321
359, 1, 1636426992640, 1636426993144, 504, 1, 503, 0, 1, 1
335, 2, 1636426983400, 1636426993400, 10000, 0, 10000, 0, 0, 0
337, 2, 1636426983829, 1636426993829, 10000, 0, 10000, 0, 0, 0
339, 2, 1636426984381, 1636426994385, 10004, 0, 10004, 0, 0, 0
365, 1, 1636426994037, 1636426994488, 451, 0, 451, 0, 0, 0
367, 1, 1636426994377, 1636426994832, 455, 0, 455, 0, 0, 0
340, 1, 1636426984756, 1636426994833, 10077, 9629, 448, 1, 9628, 9629
343, 2, 1636426985361, 1636426995361, 10000, 0, 10000, 0, 0, 0
345, 1, 1636426985585, 1636426995817, 10232, 9776, 456, 0, 9776, 9776
349, 2, 1636426986444, 1636426996445, 10001, 0, 10001, 436, 0, 436
350, 2, 1636426986836, 1636426996837, 10001, 0, 10001, 45, 0, 45
372, 1, 1636426996713, 1636426997169, 456, 0, 456, 0, 0, 0
351, 2, 1636426987541, 1636426997541, 10000, 0, 10000, 0, 0, 0
374, 1, 1636426997237, 1636426997684, 447, 0, 447, 0, 0, 0
373, 1, 1636426997237, 1636426997684, 447, 0, 447, 0, 0, 0
375, 1, 1636426997893, 1636426998344, 451, 0, 451, 0, 0, 0
352, 2, 1636426988421, 1636426998421, 10000, 0, 10000, 0, 0, 0
376, 1, 1636426998133, 1636426998585, 452, 0, 452, 0, 0, 0
377, 1, 1636426998337, 1636426998829, 492, 0, 492, 0, 0, 0
354, 2, 1636426988961, 1636426998961, 10000, 0, 10000, 0, 0, 0
378, 1, 1636426998773, 1636426999229, 456, 0, 456, 0, 0, 0
355, 2, 1636426989645, 1636426999645, 10000, 0, 10000, 0, 0, 0
379, 1, 1636426999317, 1636426999769, 452, 0, 452, 0, 0, 0
357, 1, 1636426990372, 1636427000101, 9729, 9273, 456, 0, 9272, 9272
380, 1, 1636426999988, 1636427000441, 453, 1, 452, 1, 0, 1
381, 1, 1636427000365, 1636427000896, 531, 77, 454, 76, 0, 76
382, 1, 1636427000849, 1636427001301, 452, 0, 452, 0, 0, 0
383, 1, 1636427001437, 1636427001889, 452, 0, 452, 0, 0, 0
384, 1, 1636427001469, 1636427001921, 452, 0, 452, 0, 0, 0
385, 1, 1636427001825, 1636427002344, 519, 65, 454, 64, 1, 65
386, 1, 1636427002300, 1636427002752, 452, 1, 451, 0, 0, 0
387, 1, 1636427002333, 1636427002781, 448, 0, 448, 0, 0, 0
361, 2, 1636426992785, 1636427002785, 10000, 0, 10000, 0, 0, 0
360, 2, 1636426992785, 1636427002828, 10043, 0, 10043, 0, 0, 0
388, 1, 1636427002692, 1636427003144, 452, 1, 451, 0, 1, 1
362, 2, 1636426993493, 1636427003493, 10000, 0, 10000, 0, 0, 0
363, 2, 1636426993493, 1636427003540, 10047, 0, 10047, 0, 0, 0
364, 2, 1636426993748, 1636427003748, 10000, 0, 10000, 0, 0, 0
391, 1, 1636427003229, 1636427003761, 532, 0, 532, 0, 0, 0
366, 2, 1636426994185, 1636427004185, 10000, 0, 10000, 0, 0, 0
393, 1, 1636427003881, 1636427004337, 456, 0, 456, 0, 0, 0
395, 1, 1636427004173, 1636427004625, 452, 0, 452, 0, 0, 0
368, 2, 1636426994729, 1636427004729, 10000, 0, 10000, 0, 0, 0
394, 1, 1636427004105, 1636427004793, 688, 233, 455, 233, 0, 233
398, 1, 1636427004529, 1636427004981, 452, 0, 452, 0, 0, 0
396, 1, 1636427004429, 1636427005085, 656, 197, 459, 196, 0, 196
369, 1, 1636426995097, 1636427005181, 10084, 9632, 452, 0, 9632, 9632
370, 2, 1636426995713, 1636427005713, 10000, 0, 10000, 0, 0, 0
400, 1, 1636427005341, 1636427005792, 451, 0, 451, 0, 0, 0
402, 1, 1636427005429, 1636427005877, 448, 0, 448, 0, 0, 0
371, 1, 1636426996104, 1636427006165, 10061, 9609, 452, 0, 9608, 9608
403, 1, 1636427005617, 1636427006245, 628, 176, 452, 176, 0, 176
404, 1, 1636427006021, 1636427006469, 448, 0, 448, 0, 0, 0
407, 1, 1636427006597, 1636427007049, 452, 0, 452, 0, 0, 0
408, 1, 1636427006617, 1636427007073, 456, 0, 456, 0, 0, 0
409, 1, 1636427007120, 1636427007573, 453, 1, 452, 1, 0, 1
410, 1, 1636427007992, 1636427008440, 448, 0, 448, 0, 0, 0
412, 1, 1636427008177, 1636427008641, 464, 0, 464, 0, 0, 0
414, 1, 1636427008285, 1636427008745, 460, 0, 460, 0, 0, 0
411, 1, 1636427008141, 1636427008889, 748, 300, 448, 300, 0, 300
413, 1, 1636427008216, 1636427009097, 881, 426, 455, 424, 0, 424
415, 1, 1636427009225, 1636427009677, 452, 0, 452, 0, 0, 0
417, 1, 1636427009352, 1636427009805, 453, 1, 452, 1, 0, 1
416, 1, 1636427009341, 1636427010133, 792, 337, 455, 337, 0, 337
418, 1, 1636427009769, 1636427010221, 452, 0, 452, 0, 0, 0
419, 1, 1636427010325, 1636427010777, 452, 0, 452, 0, 0, 0
420, 1, 1636427010481, 1636427010933, 452, 0, 452, 0, 0, 0
421, 1, 1636427011008, 1636427011461, 453, 1, 452, 0, 0, 0
422, 1, 1636427011805, 1636427012256, 451, 0, 451, 0, 0, 0
423, 1, 1636427011873, 1636427012329, 456, 0, 456, 0, 0, 0
424, 1, 1636427011924, 1636427012709, 785, 333, 452, 333, 0, 333
425, 1, 1636427012212, 1636427012789, 577, 118, 459, 117, 0, 117
426, 1, 1636427012497, 1636427012949, 452, 0, 452, 0, 0, 0
390, 2, 1636427003129, 1636427013129, 10000, 0, 10000, 0, 0, 0
389, 2, 1636427003129, 1636427013172, 10043, 0, 10043, 0, 0, 0
427, 1, 1636427013420, 1636427013873, 453, 1, 452, 0, 0, 0
392, 2, 1636427003885, 1636427013889, 10004, 0, 10004, 908, 0, 908
428, 1, 1636427013476, 1636427013925, 449, 1, 448, 0, 0, 0
431, 1, 1636427013621, 1636427014124, 503, 0, 503, 0, 0, 0
430, 1, 1636427013517, 1636427014333, 816, 357, 459, 356, 0, 356
429, 1, 1636427013481, 1636427014376, 895, 444, 451, 444, 0, 444
432, 1, 1636427013980, 1636427014437, 457, 1, 456, 0, 0, 0
397, 2, 1636427004545, 1636427014545, 10000, 0, 10000, 248, 0, 248
433, 1, 1636427014172, 1636427014629, 457, 1, 456, 1, 0, 1
399, 2, 1636427005077, 1636427015072, 9995, 0, 9995, 0, 0, 0
434, 1, 1636427014776, 1636427015229, 453, 1, 452, 0, 0, 0
401, 1, 1636427005453, 1636427015521, 10068, 9619, 449, 0, 9619, 9619
435, 1, 1636427015064, 1636427015685, 621, 165, 456, 165, 0, 165
405, 2, 1636427006068, 1636427016069, 10001, 0, 10001, 0, 0, 0
440, 1, 1636427015777, 1636427016232, 455, 0, 455, 0, 0, 0
406, 1, 1636427006429, 1636427016517, 10088, 9640, 448, 0, 9640, 9640
442, 1, 1636427016201, 1636427016657, 456, 0, 456, 0, 0, 0
441, 1, 1636427015829, 1636427016681, 852, 404, 448, 404, 0, 404
443, 1, 1636427016417, 1636427016873, 456, 0, 456, 0, 0, 0
445, 1, 1636427016569, 1636427017021, 452, 0, 452, 0, 0, 0
444, 1, 1636427016477, 1636427017109, 632, 180, 452, 180, 0, 180
446, 1, 1636427016781, 1636427017333, 552, 93, 459, 92, 1, 93
448, 1, 1636427017561, 1636427018013, 452, 0, 452, 0, 0, 0
450, 1, 1636427017657, 1636427018109, 452, 0, 452, 0, 0, 0
452, 1, 1636427018016, 1636427018464, 448, 0, 448, 0, 0, 0
451, 1, 1636427017725, 1636427018468, 743, 288, 455, 288, 0, 288
453, 1, 1636427018060, 1636427018508, 448, 1, 447, 0, 0, 0
454, 1, 1636427018917, 1636427019369, 452, 0, 452, 0, 0, 0
455, 1, 1636427019377, 1636427019833, 456, 0, 456, 0, 0, 0
456, 1, 1636427020097, 1636427020544, 447, 0, 447, 0, 0, 0
458, 1, 1636427020320, 1636427020772, 452, 1, 451, 0, 0, 0
460, 1, 1636427020412, 1636427020861, 449, 0, 449, 0, 0, 0
457, 1, 1636427020105, 1636427020996, 891, 440, 451, 440, 0, 440
461, 1, 1636427020768, 1636427021221, 453, 5, 448, 5, 0, 5
463, 1, 1636427021361, 1636427021817, 456, 0, 456, 0, 0, 0
466, 1, 1636427021749, 1636427022201, 452, 0, 452, 0, 0, 0
464, 1, 1636427021429, 1636427022273, 844, 389, 455, 389, 0, 389
467, 1, 1636427021897, 1636427022349, 452, 0, 452, 0, 0, 0
468, 1, 1636427022684, 1636427023137, 453, 1, 452, 0, 0, 0
469, 1, 1636427023145, 1636427023601, 456, 0, 456, 0, 0, 0
470, 1, 1636427023952, 1636427024404, 452, 1, 451, 0, 0, 0
472, 1, 1636427024121, 1636427024577, 456, 0, 456, 0, 0, 0
473, 1, 1636427024360, 1636427024813, 453, 1, 452, 0, 0, 0
471, 1, 1636427023996, 1636427024861, 865, 409, 456, 409, 0, 409
474, 1, 1636427024532, 1636427025033, 501, 46, 455, 45, 1, 46
436, 2, 1636427015149, 1636427025145, 9996, 0, 9996, 0, 0, 0
437, 2, 1636427015149, 1636427025192, 10043, 0, 10043, 0, 0, 0
438, 2, 1636427015425, 1636427025425, 10000, 0, 10000, 0, 0, 0
439, 2, 1636427015784, 1636427025785, 10001, 0, 10001, 0, 0, 0
478, 1, 1636427025560, 1636427026012, 452, 0, 452, 0, 0, 0
480, 1, 1636427025848, 1636427026309, 461, 0, 461, 0, 0, 0
481, 1, 1636427025920, 1636427026373, 453, 1, 452, 0, 0, 0
477, 1, 1636427025609, 1636427026465, 856, 404, 452, 404, 0, 404
483, 1, 1636427026881, 1636427027333, 452, 0, 452, 0, 0, 0
447, 2, 1636427017529, 1636427027529, 10000, 0, 10000, 0, 0, 0
449, 2, 1636427017596, 1636427027597, 10001, 0, 10001, 0, 0, 0
484, 1, 1636427027341, 1636427027825, 484, 0, 484, 0, 0, 0
485, 1, 1636427027773, 1636427028229, 456, 0, 456, 0, 0, 0
487, 1, 1636427027901, 1636427028356, 455, 0, 455, 0, 0, 0
489, 1, 1636427028149, 1636427028605, 456, 0, 456, 0, 0, 0
486, 1, 1636427027837, 1636427028685, 848, 393, 455, 392, 1, 393
490, 1, 1636427028312, 1636427028757, 445, 1, 444, 0, 0, 0
488, 1, 1636427027941, 1636427028801, 860, 416, 444, 416, 0, 416
491, 1, 1636427028656, 1636427029213, 557, 102, 455, 101, 0, 101
492, 1, 1636427029537, 1636427029989, 452, 0, 452, 0, 0, 0
493, 1, 1636427029821, 1636427030273, 452, 0, 452, 0, 0, 0
494, 1, 1636427029844, 1636427030297, 453, 1, 452, 0, 0, 0
459, 2, 1636427020361, 1636427030361, 10000, 0, 10000, 0, 0, 0
495, 1, 1636427029872, 1636427030769, 897, 425, 472, 424, 0, 424
462, 2, 1636427020853, 1636427030853, 10000, 0, 10000, 0, 0, 0
496, 1, 1636427030709, 1636427031173, 464, 0, 464, 0, 0, 0
465, 1, 1636427021737, 1636427031300, 9563, 9116, 447, 0, 9116, 9116
498, 1, 1636427031197, 1636427031648, 451, 0, 451, 0, 0, 0
497, 1, 1636427031205, 1636427031664, 459, 0, 459, 0, 0, 0
499, 1, 1636427031425, 1636427032092, 667, 224, 443, 224, 0, 224
500, 1, 1636427031589, 1636427032113, 524, 76, 448, 76, 0, 76
503, 1, 1636427032081, 1636427032532, 451, 0, 451, 0, 0, 0
502, 1, 1636427031965, 1636427032569, 604, 149, 455, 148, 0, 148
505, 1, 1636427032305, 1636427032761, 456, 0, 456, 0, 0, 0
504, 1, 1636427032108, 1636427032985, 877, 425, 452, 425, 0, 425
501, 1, 1636427031896, 1636427033020, 1124, 673, 451, 672, 0, 672
506, 1, 1636427032645, 1636427033101, 456, 0, 456, 0, 0, 0
507, 1, 1636427032929, 1636427033557, 628, 173, 455, 172, 0, 172
508, 1, 1636427033693, 1636427034145, 452, 0, 452, 0, 0, 0
509, 1, 1636427033753, 1636427034205, 452, 0, 452, 0, 0, 0
510, 1, 1636427033761, 1636427034213, 452, 0, 452, 0, 0, 0
511, 1, 1636427033836, 1636427034669, 833, 378, 455, 376, 0, 376
512, 1, 1636427034629, 1636427035077, 448, 0, 448, 0, 0, 0
476, 2, 1636427025504, 1636427035505, 10001, 0, 10001, 0, 0, 0
513, 1, 1636427035108, 1636427035552, 444, 1, 443, 0, 0, 0
475, 2, 1636427025504, 1636427035553, 10049, 0, 10049, 0, 0, 0
514, 1, 1636427035117, 1636427035560, 443, 0, 443, 0, 0, 0
479, 2, 1636427025773, 1636427035773, 10000, 0, 10000, 0, 0, 0
515, 1, 1636427035148, 1636427036008, 860, 405, 455, 405, 0, 405
516, 1, 1636427035596, 1636427036088, 492, 0, 492, 0, 0, 0
482, 1, 1636427026193, 1636427036229, 10036, 9580, 456, 0, 9580, 9580
519, 1, 1636427035984, 1636427036437, 453, 1, 452, 1, 0, 1
520, 1, 1636427035984, 1636427036544, 560, 105, 455, 105, 0, 105
523, 1, 1636427036108, 1636427036556, 448, 0, 448, 0, 0, 0
522, 1, 1636427036084, 1636427036893, 809, 354, 455, 352, 1, 353
524, 1, 1636427036176, 1636427036993, 817, 369, 448, 368, 0, 368
526, 1, 1636427036556, 1636427037009, 453, 1, 452, 0, 1, 1
527, 1, 1636427036692, 1636427037461, 769, 317, 452, 317, 0, 317
528, 1, 1636427037492, 1636427037949, 457, 1, 456, 0, 0, 0
529, 1, 1636427037609, 1636427038065, 456, 0, 456, 0, 0, 0
531, 1, 1636427037937, 1636427038385, 448, 0, 448, 0, 0, 0
530, 1, 1636427037805, 1636427038517, 712, 260, 452, 260, 0, 260
532, 1, 1636427038629, 1636427039085, 456, 0, 456, 0, 0, 0
533, 1, 1636427038881, 1636427039333, 452, 0, 452, 0, 0, 0
535, 1, 1636427039117, 1636427039569, 452, 0, 452, 0, 0, 0
534, 1, 1636427038961, 1636427039785, 824, 372, 452, 372, 0, 372
536, 1, 1636427039453, 1636427040024, 571, 117, 454, 117, 0, 117
538, 1, 1636427039860, 1636427040317, 457, 1, 456, 1, 0, 1
537, 1, 1636427039841, 1636427040477, 636, 184, 452, 184, 0, 184
540, 1, 1636427040145, 1636427040597, 452, 0, 452, 0, 0, 0
539, 1, 1636427039989, 1636427040773, 784, 329, 455, 328, 1, 329
542, 1, 1636427040404, 1636427040857, 453, 1, 452, 0, 1, 1
541, 1, 1636427040177, 1636427040929, 752, 301, 451, 300, 1, 301
543, 1, 1636427040508, 1636427041313, 805, 350, 455, 349, 1, 350
544, 1, 1636427041533, 1636427041985, 452, 0, 452, 0, 0, 0
545, 1, 1636427041660, 1636427042113, 453, 0, 453, 0, 0, 0
546, 1, 1636427041672, 1636427042121, 449, 0, 449, 0, 0, 0
547, 1, 1636427042076, 1636427042581, 505, 45, 460, 45, 0, 45
548, 1, 1636427042513, 1636427042965, 452, 0, 452, 0, 0, 0
549, 1, 1636427042937, 1636427043389, 452, 0, 452, 0, 0, 0
550, 1, 1636427043001, 1636427043453, 452, 0, 452, 0, 0, 0
552, 1, 1636427043205, 1636427043849, 644, 185, 459, 184, 0, 184
551, 1, 1636427043145, 1636427043900, 755, 308, 447, 308, 0, 308
553, 1, 1636427043825, 1636427044349, 524, 76, 448, 76, 0, 76
555, 1, 1636427043953, 1636427044401, 448, 0, 448, 0, 0, 0
556, 1, 1636427044068, 1636427044521, 453, 1, 452, 0, 0, 0
554, 1, 1636427043941, 1636427044805, 864, 409, 455, 408, 0, 408
557, 1, 1636427044156, 1636427044977, 821, 365, 456, 365, 0, 365
558, 1, 1636427044625, 1636427045077, 452, 0, 452, 0, 0, 0
559, 1, 1636427044760, 1636427045528, 768, 317, 451, 317, 0, 317
518, 2, 1636427035865, 1636427045864, 9999, 0, 9999, 0, 0, 0
561, 1, 1636427045417, 1636427045868, 451, 0, 451, 0, 0, 0
560, 1, 1636427045417, 1636427045868, 451, 1, 450, 0, 0, 0
517, 2, 1636427035865, 1636427045908, 10043, 0, 10043, 0, 0, 0
521, 2, 1636427036124, 1636427046125, 10001, 0, 10001, 0, 0, 0
562, 1, 1636427045824, 1636427046348, 524, 1, 523, 0, 0, 0
525, 1, 1636427036493, 1636427046585, 10092, 9632, 460, 0, 9632, 9632
564, 1, 1636427046260, 1636427046709, 449, 1, 448, 1, 0, 1
565, 1, 1636427046260, 1636427046801, 541, 89, 452, 89, 0, 89
567, 1, 1636427046645, 1636427047097, 452, 0, 452, 0, 0, 0
569, 1, 1636427047097, 1636427047545, 448, 0, 448, 0, 0, 0
570, 1, 1636427047181, 1636427047636, 455, 0, 455, 0, 0, 0
572, 1, 1636427047497, 1636427048004, 507, 49, 458, 49, 0, 49
571, 1, 1636427047297, 1636427048089, 792, 340, 452, 340, 0, 340
573, 1, 1636427047801, 1636427048253, 452, 0, 452, 0, 0, 0
574, 1, 1636427048092, 1636427048561, 469, 0, 469, 0, 0, 0
575, 1, 1636427048120, 1636427048564, 444, 0, 444, 0, 0, 0
577, 1, 1636427048372, 1636427049017, 645, 190, 455, 188, 0, 188
576, 1, 1636427048205, 1636427049025, 820, 360, 460, 360, 0, 360
578, 1, 1636427048780, 1636427049233, 453, 1, 452, 0, 0, 0
579, 1, 1636427049025, 1636427049689, 664, 208, 456, 208, 0, 208
580, 1, 1636427049293, 1636427049745, 452, 0, 452, 0, 0, 0
581, 1, 1636427049561, 1636427050013, 452, 0, 452, 0, 0, 0
582, 1, 1636427049581, 1636427050037, 456, 0, 456, 0, 0, 0
583, 1, 1636427049933, 1636427050393, 460, 0, 460, 0, 0, 0
584, 1, 1636427050249, 1636427050704, 455, 0, 455, 0, 0, 0
585, 1, 1636427050665, 1636427051116, 451, 0, 451, 0, 0, 0
586, 1, 1636427050905, 1636427051357, 452, 0, 452, 0, 0, 0
587, 1, 1636427051321, 1636427051772, 451, 0, 451, 0, 0, 0
588, 1, 1636427051440, 1636427051893, 453, 1, 452, 1, 0, 1
589, 1, 1636427051589, 1636427052220, 631, 184, 447, 184, 0, 184
590, 1, 1636427051796, 1636427052249, 453, 1, 452, 1, 0, 1
591, 1, 1636427051816, 1636427052273, 457, 1, 456, 0, 1, 1
592, 1, 1636427052145, 1636427052669, 524, 76, 448, 76, 0, 76
593, 1, 1636427052249, 1636427052704, 455, 1, 454, 0, 1, 1
595, 1, 1636427052505, 1636427052965, 460, 0, 460, 0, 0, 0
594, 1, 1636427052413, 1636427053124, 711, 257, 454, 256, 1, 257
596, 1, 1636427052716, 1636427053421, 705, 250, 455, 250, 0, 250
597, 1, 1636427053305, 1636427053753, 448, 0, 448, 0, 0, 0
598, 1, 1636427053553, 1636427054008, 455, 0, 455, 0, 0, 0
599, 1, 1636427053729, 1636427054181, 452, 0, 452, 0, 0, 0
600, 1, 1636427053944, 1636427054393, 449, 1, 448, 0, 0, 0
601, 1, 1636427054028, 1636427054481, 453, 1, 452, 0, 0, 0
602, 1, 1636427054461, 1636427054913, 452, 0, 452, 0, 0, 0
603, 1, 1636427054685, 1636427055132, 447, 0, 447, 0, 0, 0
604, 1, 1636427055089, 1636427055541, 452, 0, 452, 0, 0, 0
605, 1, 1636427055220, 1636427055673, 453, 1, 452, 1, 0, 1
606, 1, 1636427055569, 1636427056020, 451, 0, 451, 0, 0, 0
563, 2, 1636427046260, 1636427056261, 10001, 0, 10001, 449, 0, 449
566, 2, 1636427046473, 1636427056473, 10000, 0, 10000, 236, 0, 236
607, 1, 1636427055993, 1636427056489, 496, 0, 496, 0, 0, 0
608, 1, 1636427056044, 1636427056501, 457, 1, 456, 0, 0, 0
609, 1, 1636427056096, 1636427056577, 481, 1, 480, 0, 0, 0
611, 1, 1636427056245, 1636427056705, 460, 0, 460, 0, 0, 0
568, 1, 1636427046857, 1636427056920, 10063, 9616, 447, 0, 9616, 9616
612, 1, 1636427056441, 1636427056944, 503, 48, 455, 48, 0, 48
610, 1, 1636427056228, 1636427056948, 720, 273, 447, 272, 0, 272
613, 1, 1636427056653, 1636427057157, 504, 52, 452, 52, 0, 52
614, 1, 1636427057060, 1636427057513, 453, 1, 452, 0, 0, 0
617, 1, 1636427057265, 1636427057712, 447, 0, 447, 0, 0, 0
618, 1, 1636427057316, 1636427057761, 445, 1, 444, 0, 0, 0
615, 1, 1636427057065, 1636427057965, 900, 448, 452, 448, 0, 448
619, 1, 1636427057741, 1636427058193, 452, 0, 452, 0, 0, 0
620, 1, 1636427057796, 1636427058249, 453, 1, 452, 0, 0, 0
621, 1, 1636427057905, 1636427058357, 452, 0, 452, 0, 0, 0
616, 1, 1636427057181, 1636427058421, 1240, 785, 455, 784, 1, 785
622, 1, 1636427058404, 1636427058857, 453, 1, 452, 0, 0, 0
623, 1, 1636427058613, 1636427059065, 452, 0, 452, 0, 0, 0
624, 1, 1636427058937, 1636427059389, 452, 0, 452, 0, 0, 0
625, 1, 1636427059281, 1636427059733, 452, 0, 452, 0, 0, 0
626, 1, 1636427059765, 1636427060216, 451, 0, 451, 0, 0, 0
627, 1, 1636427059957, 1636427060409, 452, 0, 452, 0, 0, 0
628, 1, 1636427060172, 1636427060625, 453, 0, 453, 0, 0, 0
629, 1, 1636427060241, 1636427060689, 448, 0, 448, 0, 0, 0
630, 1, 1636427060253, 1636427060704, 451, 0, 451, 0, 0, 0
632, 1, 1636427060557, 1636427061004, 447, 0, 447, 0, 0, 0
631, 1, 1636427060529, 1636427061149, 620, 160, 460, 160, 0, 160
633, 1, 1636427060709, 1636427061161, 452, 0, 452, 0, 0, 0
634, 1, 1636427060869, 1636427061321, 452, 0, 452, 0, 0, 0
636, 1, 1636427060936, 1636427061389, 453, 1, 452, 1, 0, 1
638, 1, 1636427061332, 1636427061784, 452, 1, 451, 0, 1, 1
639, 1, 1636427061629, 1636427062081, 452, 0, 452, 0, 0, 0
640, 1, 1636427061737, 1636427062189, 452, 0, 452, 0, 0, 0
641, 1, 1636427061833, 1636427062285, 452, 0, 452, 0, 0, 0
642, 1, 1636427062397, 1636427062853, 456, 0, 456, 0, 0, 0
644, 1, 1636427062933, 1636427063377, 444, 0, 444, 0, 0, 0
643, 1, 1636427062929, 1636427063380, 451, 0, 451, 0, 0, 0
645, 1, 1636427063601, 1636427064053, 452, 0, 452, 0, 0, 0
646, 1, 1636427063629, 1636427064076, 447, 0, 447, 0, 0, 0
647, 1, 1636427064049, 1636427064501, 452, 0, 452, 0, 0, 0
648, 1, 1636427064052, 1636427064504, 452, 1, 451, 0, 0, 0
649, 1, 1636427064088, 1636427064541, 453, 0, 453, 0, 0, 0
650, 1, 1636427064229, 1636427064680, 451, 0, 451, 0, 0, 0
651, 1, 1636427064569, 1636427065021, 452, 0, 452, 0, 0, 0
652, 1, 1636427064620, 1636427065068, 448, 1, 447, 0, 0, 0
654, 1, 1636427064676, 1636427065124, 448, 1, 447, 0, 0, 0
655, 1, 1636427064712, 1636427065168, 456, 1, 455, 0, 0, 0
653, 1, 1636427064645, 1636427065477, 832, 377, 455, 377, 0, 377
656, 1, 1636427065216, 1636427065669, 453, 0, 453, 0, 0, 0
657, 1, 1636427065629, 1636427066081, 452, 0, 452, 0, 0, 0
658, 1, 1636427065925, 1636427066373, 448, 0, 448, 0, 0, 0
659, 1, 1636427066057, 1636427066509, 452, 0, 452, 0, 0, 0
660, 1, 1636427066284, 1636427066737, 453, 1, 452, 1, 0, 1
661, 1, 1636427066733, 1636427067184, 451, 0, 451, 0, 0, 0
662, 1, 1636427066821, 1636427067269, 448, 0, 448, 0, 0, 0
663, 1, 1636427067373, 1636427067829, 456, 0, 456, 0, 0, 0
664, 1, 1636427067513, 1636427067965, 452, 0, 452, 0, 0, 0
665, 1, 1636427067749, 1636427068205, 456, 0, 456, 0, 0, 0
666, 1, 1636427067905, 1636427068361, 456, 0, 456, 0, 0, 0
667, 1, 1636427067996, 1636427068448, 452, 1, 451, 0, 0, 0
668, 1, 1636427068120, 1636427068573, 453, 1, 452, 0, 0, 0
669, 1, 1636427068444, 1636427068897, 453, 1, 452, 0, 0, 0
670, 1, 1636427068464, 1636427068921, 457, 0, 457, 0, 0, 0
671, 1, 1636427068468, 1636427068924, 456, 0, 456, 0, 0, 0
673, 1, 1636427068913, 1636427069365, 452, 0, 452, 0, 0, 0
672, 1, 1636427068492, 1636427069376, 884, 429, 455, 429, 0, 429
674, 1, 1636427068981, 1636427069425, 444, 0, 444, 0, 0, 0
675, 1, 1636427069537, 1636427069989, 452, 0, 452, 0, 0, 0
676, 1, 1636427069969, 1636427070421, 452, 0, 452, 0, 0, 0
677, 1, 1636427070197, 1636427070649, 452, 0, 452, 0, 0, 0
678, 1, 1636427070225, 1636427070676, 451, 0, 451, 0, 0, 0
635, 2, 1636427060888, 1636427070889, 10001, 0, 10001, 433, 0, 433
679, 1, 1636427070581, 1636427071033, 452, 0, 452, 0, 0, 0
637, 2, 1636427061048, 1636427071049, 10001, 0, 10001, 273, 0, 273
680, 1, 1636427070589, 1636427071117, 528, 61, 467, 60, 1, 61
681, 1, 1636427071277, 1636427071729, 452, 0, 452, 0, 0, 0
683, 1, 1636427071368, 1636427071821, 453, 1, 452, 0, 0, 0
682, 1, 1636427071401, 1636427071853, 452, 0, 452, 0, 0, 0
685, 1, 1636427071853, 1636427072304, 451, 0, 451, 0, 0, 0
684, 1, 1636427071677, 1636427072313, 636, 177, 459, 177, 0, 177
686, 1, 1636427071960, 1636427072417, 457, 0, 457, 0, 0, 0
687, 1, 1636427072028, 1636427072481, 453, 0, 453, 0, 0, 0
688, 1, 1636427072044, 1636427072501, 457, 1, 456, 0, 1, 1
689, 1, 1636427072204, 1636427072757, 553, 101, 452, 100, 0, 100
691, 1, 1636427072524, 1636427072977, 453, 1, 452, 0, 1, 1
690, 1, 1636427072316, 1636427073216, 900, 442, 458, 441, 1, 442
692, 1, 1636427072605, 1636427073433, 828, 373, 455, 372, 0, 372
693, 1, 1636427073077, 1636427073529, 452, 0, 452, 0, 0, 0
694, 1, 1636427073133, 1636427073585, 452, 0, 452, 0, 0, 0
695, 1, 1636427073609, 1636427074061, 452, 0, 452, 0, 0, 0
696, 1, 1636427073744, 1636427074197, 453, 1, 452, 0, 0, 0
697, 1, 1636427074265, 1636427074717, 452, 0, 452, 0, 0, 0
698, 1, 1636427074457, 1636427074913, 456, 0, 456, 0, 0, 0
699, 1, 1636427074777, 1636427075229, 452, 0, 452, 0, 0, 0
700, 1, 1636427074800, 1636427075677, 877, 429, 448, 429, 0, 429
701, 1, 1636427075320, 1636427075769, 449, 1, 448, 0, 0, 0
704, 1, 1636427075673, 1636427076224, 551, 96, 455, 96, 0, 96
707, 1, 1636427076121, 1636427076568, 447, 0, 447, 0, 0, 0
708, 1, 1636427076193, 1636427076645, 452, 0, 452, 0, 0, 0
711, 1, 1636427076488, 1636427076941, 453, 0, 453, 0, 0, 0
712, 1, 1636427076641, 1636427077093, 452, 0, 452, 0, 0, 0
713, 1, 1636427077093, 1636427077549, 456, 0, 456, 0, 0, 0
714, 1, 1636427077212, 1636427077673, 461, 0, 461, 0, 0, 0
715, 1, 1636427077392, 1636427077845, 453, 1, 452, 0, 0, 0
716, 1, 1636427077740, 1636427078193, 453, 1, 452, 0, 0, 0
717, 1, 1636427078049, 1636427078501, 452, 0, 452, 0, 0, 0
718, 1, 1636427078557, 1636427079008, 451, 0, 451, 0, 0, 0
719, 1, 1636427078697, 1636427079149, 452, 0, 452, 0, 0, 0
720, 1, 1636427079084, 1636427079545, 461, 1, 460, 0, 1, 1
721, 1, 1636427079177, 1636427079637, 460, 0, 460, 0, 0, 0
722, 1, 1636427079533, 1636427080093, 560, 105, 455, 104, 1, 105
723, 1, 1636427079841, 1636427080293, 452, 0, 452, 0, 0, 0
724, 1, 1636427080165, 1636427080617, 452, 0, 452, 0, 0, 0
725, 1, 1636427080273, 1636427080729, 456, 0, 456, 0, 0, 0
726, 1, 1636427080453, 1636427080909, 456, 0, 456, 0, 0, 0
727, 1, 1636427081061, 1636427081509, 448, 0, 448, 0, 0, 0
728, 1, 1636427081176, 1636427081625, 449, 1, 448, 1, 0, 1
729, 1, 1636427081260, 1636427081717, 457, 0, 457, 0, 0, 0
730, 1, 1636427081661, 1636427082113, 452, 0, 452, 0, 0, 0
731, 1, 1636427081921, 1636427082377, 456, 0, 456, 0, 0, 0
732, 1, 1636427082345, 1636427082833, 488, 33, 455, 32, 1, 33
733, 1, 1636427082853, 1636427083309, 456, 0, 456, 0, 0, 0
734, 1, 1636427082892, 1636427083345, 453, 1, 452, 0, 0, 0
735, 1, 1636427082904, 1636427083361, 457, 0, 457, 0, 0, 0
736, 1, 1636427083273, 1636427083761, 488, 36, 452, 36, 0, 36
737, 1, 1636427083833, 1636427084285, 452, 0, 452, 0, 0, 0
738, 1, 1636427084197, 1636427084649, 452, 0, 452, 0, 0, 0
739, 1, 1636427084233, 1636427084741, 508, 52, 456, 52, 0, 52
740, 1, 1636427084321, 1636427084773, 452, 0, 452, 0, 0, 0
702, 2, 1636427075424, 1636427085425, 10001, 0, 10001, 253, 0, 253
703, 2, 1636427075437, 1636427085473, 10036, 0, 10036, 240, 0, 240
741, 1, 1636427085037, 1636427085493, 456, 0, 456, 0, 0, 0
742, 1, 1636427085129, 1636427085585, 456, 0, 456, 0, 0, 0
743, 1, 1636427085188, 1636427085704, 516, 1, 515, 0, 0, 0
705, 2, 1636427075908, 1636427085909, 10001, 0, 10001, 0, 0, 0
706, 2, 1636427076097, 1636427086096, 9999, 0, 9999, 0, 0, 0
744, 1, 1636427085653, 1636427086137, 484, 0, 484, 0, 0, 0
745, 1, 1636427085844, 1636427086329, 485, 1, 484, 0, 0, 0
709, 2, 1636427076481, 1636427086481, 10000, 0, 10000, 0, 0, 0
746, 1, 1636427086044, 1636427086508, 464, 1, 463, 0, 0, 0
747, 1, 1636427086040, 1636427086508, 468, 0, 468, 0, 0, 0
710, 2, 1636427076481, 1636427086528, 10047, 0, 10047, 0, 0, 0
749, 1, 1636427086284, 1636427086841, 557, 45, 512, 45, 0, 45
748, 1, 1636427086261, 1636427086957, 696, 247, 449, 247, 0, 247
750, 1, 1636427086573, 1636427087021, 448, 0, 448, 0, 0, 0
753, 1, 1636427086816, 1636427087268, 452, 1, 451, 0, 0, 0
754, 1, 1636427086888, 1636427087337, 449, 1, 448, 0, 0, 0
752, 1, 1636427086841, 1636427087412, 571, 117, 454, 116, 0, 116
755, 1, 1636427087052, 1636427087500, 448, 1, 447, 0, 0, 0
751, 1, 1636427086837, 1636427087857, 1020, 576, 444, 576, 0, 576
756, 1, 1636427087320, 1636427087941, 621, 181, 440, 181, 0, 181
757, 1, 1636427087544, 1636427087989, 445, 1, 444, 0, 1, 1
758, 1, 1636427088181, 1636427088633, 452, 0, 452, 0, 0, 0
759, 1, 1636427088437, 1636427088889, 452, 0, 452, 0, 0, 0
760, 1, 1636427088629, 1636427089081, 452, 0, 452, 0, 0, 0
761, 1, 1636427089001, 1636427089456, 455, 0, 455, 0, 0, 0
762, 1, 1636427089293, 1636427089745, 452, 0, 452, 0, 0, 0
763, 1, 1636427089437, 1636427089889, 452, 0, 452, 0, 0, 0
764, 1, 1636427089704, 1636427090157, 453, 1, 452, 0, 0, 0
765, 1, 1636427089785, 1636427090233, 448, 0, 448, 0, 0, 0
767, 1, 1636427089977, 1636427090429, 452, 0, 452, 0, 0, 0
768, 1, 1636427090057, 1636427090505, 448, 0, 448, 0, 0, 0
766, 1, 1636427089973, 1636427090613, 640, 185, 455, 184, 0, 184
769, 1, 1636427090361, 1636427090881, 520, 68, 452, 68, 0, 68
770, 1, 1636427090424, 1636427090965, 541, 82, 459, 81, 0, 81
771, 1, 1636427090532, 1636427090993, 461, 1, 460, 0, 0, 0
773, 1, 1636427090601, 1636427091057, 456, 0, 456, 0, 0, 0
772, 1, 1636427090560, 1636427091065, 505, 53, 452, 53, 0, 53
774, 1, 1636427090676, 1636427091525, 849, 390, 459, 388, 0, 388
775, 1, 1636427091269, 1636427091725, 456, 0, 456, 0, 0, 0
776, 1, 1636427091509, 1636427091960, 451, 0, 451, 0, 0, 0
777, 1, 1636427091517, 1636427092181, 664, 209, 455, 208, 1, 209
778, 1, 1636427091853, 1636427092413, 560, 108, 452, 108, 0, 108
779, 1, 1636427092313, 1636427092768, 455, 0, 455, 0, 0, 0
780, 1, 1636427092469, 1636427092917, 448, 0, 448, 0, 0, 0
781, 1, 1636427092693, 1636427093145, 452, 0, 452, 0, 0, 0
782, 1, 1636427093125, 1636427093577, 452, 0, 452, 0, 0, 0
783, 1, 1636427093369, 1636427093821, 452, 0, 452, 0, 0, 0
784, 1, 1636427093497, 1636427093953, 456, 0, 456, 0, 0, 0
785, 1, 1636427093789, 1636427094408, 619, 165, 454, 164, 0, 164
786, 1, 1636427094024, 1636427094472, 448, 1, 447, 0, 0, 0
787, 1, 1636427094052, 1636427094512, 460, 1, 459, 0, 0, 0
788, 1, 1636427094076, 1636427094528, 452, 0, 452, 0, 0, 0
789, 1, 1636427094404, 1636427094861, 457, 5, 452, 4, 0, 4
790, 1, 1636427094445, 1636427094897, 452, 0, 452, 0, 0, 0
791, 1, 1636427094452, 1636427094985, 533, 77, 456, 77, 0, 77
793, 1, 1636427094564, 1636427095013, 449, 1, 448, 1, 0, 1
794, 1, 1636427094597, 1636427095053, 456, 0, 456, 0, 0, 0
792, 1, 1636427094556, 1636427095320, 764, 305, 459, 305, 0, 305
795, 1, 1636427095173, 1636427095629, 456, 0, 456, 0, 0, 0
796, 1, 1636427095249, 1636427095697, 448, 0, 448, 0, 0, 0
797, 1, 1636427095316, 1636427096080, 764, 314, 450, 313, 0, 313
798, 1, 1636427095613, 1636427096144, 531, 84, 447, 84, 0, 84
799, 1, 1636427096012, 1636427096461, 449, 0, 449, 0, 0, 0
800, 1, 1636427096481, 1636427096933, 452, 0, 452, 0, 0, 0
801, 1, 1636427096825, 1636427097277, 452, 0, 452, 0, 0, 0
802, 1, 1636427096856, 1636427097309, 453, 1, 452, 0, 0, 0
803, 1, 1636427097528, 1636427097981, 453, 1, 452, 1, 0, 1
804, 1, 1636427097657, 1636427098105, 448, 0, 448, 0, 0, 0
806, 1, 1636427097957, 1636427098404, 447, 0, 447, 0, 0, 0
807, 1, 1636427097952, 1636427098408, 456, 1, 455, 0, 0, 0
805, 1, 1636427097876, 1636427098560, 684, 229, 455, 229, 0, 229
808, 1, 1636427098269, 1636427098717, 448, 0, 448, 0, 0, 0
809, 1, 1636427098433, 1636427098885, 452, 0, 452, 0, 0, 0
810, 1, 1636427098480, 1636427098941, 461, 1, 460, 1, 0, 1
811, 1, 1636427098560, 1636427099012, 452, 0, 452, 0, 0, 0
813, 1, 1636427098704, 1636427099152, 448, 1, 447, 0, 1, 1
812, 1, 1636427098572, 1636427099164, 592, 145, 447, 145, 0, 145
814, 1, 1636427098808, 1636427099460, 652, 205, 447, 205, 0, 205
815, 1, 1636427099016, 1636427099464, 448, 0, 448, 0, 0, 0
816, 1, 1636427099044, 1636427099488, 444, 1, 443, 1, 0, 1
818, 1, 1636427099296, 1636427099917, 621, 169, 452, 168, 0, 168
817, 1, 1636427099048, 1636427099941, 893, 441, 452, 441, 0, 441
819, 1, 1636427100236, 1636427100689, 453, 1, 452, 1, 0, 1
820, 1, 1636427100321, 1636427100773, 452, 0, 452, 0, 0, 0
821, 1, 1636427100841, 1636427101293, 452, 0, 452, 0, 0, 0
822, 1, 1636427100921, 1636427101373, 452, 0, 452, 0, 0, 0
823, 1, 1636427101373, 1636427101828, 455, 0, 455, 0, 0, 0
824, 1, 1636427101457, 1636427101909, 452, 0, 452, 0, 0, 0
825, 1, 1636427101648, 1636427102100, 452, 0, 452, 0, 0, 0
827, 1, 1636427101897, 1636427102345, 448, 0, 448, 0, 0, 0
826, 1, 1636427101864, 1636427102356, 492, 45, 447, 45, 0, 45
828, 1, 1636427102128, 1636427102577, 449, 1, 448, 0, 0, 0
829, 1, 1636427102269, 1636427102716, 447, 0, 447, 0, 0, 0
830, 1, 1636427102364, 1636427102816, 452, 0, 452, 0, 0, 0
831, 1, 1636427102392, 1636427102845, 453, 1, 452, 0, 0, 0
833, 1, 1636427102577, 1636427103037, 460, 1, 459, 1, 0, 1
832, 1, 1636427102408, 1636427103169, 761, 309, 452, 309, 0, 309
834, 1, 1636427102577, 1636427103261, 684, 240, 444, 240, 0, 240
835, 1, 1636427103177, 1636427103628, 451, 0, 451, 0, 0, 0
836, 1, 1636427103177, 1636427103628, 451, 0, 451, 0, 0, 0
837, 1, 1636427103236, 1636427104072, 836, 393, 443, 392, 0, 392
838, 1, 1636427103464, 1636427104076, 612, 165, 447, 164, 0, 164
839, 1, 1636427104416, 1636427104872, 456, 1, 455, 0, 1, 1
840, 1, 1636427104496, 1636427104949, 453, 0, 453, 0, 0, 0
841, 1, 1636427104684, 1636427105141, 457, 1, 456, 0, 0, 0
842, 1, 1636427105101, 1636427105553, 452, 0, 452, 0, 0, 0
843, 1, 1636427105409, 1636427105857, 448, 0, 448, 0, 0, 0
844, 1, 1636427105497, 1636427105941, 444, 0, 444, 0, 0, 0
845, 1, 1636427105769, 1636427106221, 452, 0, 452, 0, 0, 0
846, 1, 1636427105917, 1636427106392, 475, 25, 450, 24, 0, 24
847, 1, 1636427105948, 1636427106400, 452, 1, 451, 0, 0, 0
848, 1, 1636427106292, 1636427106745, 453, 1, 452, 1, 0, 1
849, 1, 1636427106408, 1636427106868, 460, 0, 460, 0, 0, 0
850, 1, 1636427106444, 1636427106893, 449, 1, 448, 0, 1, 1
851, 1, 1636427106460, 1636427106912, 452, 1, 451, 0, 0, 0
854, 1, 1636427106805, 1636427107261, 456, 0, 456, 0, 0, 0
852, 1, 1636427106616, 1636427107325, 709, 253, 456, 253, 0, 253
853, 1, 1636427106713, 1636427107344, 631, 180, 451, 180, 0, 180
855, 1, 1636427107133, 1636427107585, 452, 0, 452, 0, 0, 0
856, 1, 1636427107201, 1636427107653, 452, 0, 452, 0, 0, 0
857, 1, 1636427107229, 1636427108041, 812, 357, 455, 356, 0, 356
858, 1, 1636427107400, 1636427108105, 705, 253, 452, 253, 0, 253
859, 1, 1636427108533, 1636427108985, 452, 0, 452, 0, 0, 0
860, 1, 1636427108556, 1636427109009, 453, 1, 452, 0, 0, 0
861, 1, 1636427108584, 1636427109037, 453, 1, 452, 0, 0, 0
862, 1, 1636427109245, 1636427109697, 452, 0, 452, 0, 0, 0
863, 1, 1636427109301, 1636427109757, 456, 0, 456, 0, 0, 0
864, 1, 1636427109496, 1636427109945, 449, 1, 448, 0, 0, 0
865, 1, 1636427109700, 1636427110209, 509, 58, 451, 57, 1, 58
866, 1, 1636427109857, 1636427110309, 452, 0, 452, 0, 0, 0
867, 1, 1636427110029, 1636427110480, 451, 0, 451, 0, 0, 0
868, 1, 1636427110320, 1636427110773, 453, 1, 452, 0, 0, 0
869, 1, 1636427110377, 1636427110832, 455, 0, 455, 0, 0, 0
870, 1, 1636427110416, 1636427110865, 449, 0, 449, 0, 0, 0
872, 1, 1636427110537, 1636427110993, 456, 0, 456, 0, 0, 0
871, 1, 1636427110440, 1636427111229, 789, 333, 456, 333, 0, 333
874, 1, 1636427110937, 1636427111384, 447, 0, 447, 0, 0, 0
875, 1, 1636427110972, 1636427111424, 452, 1, 451, 0, 0, 0
876, 1, 1636427110996, 1636427111445, 449, 0, 449, 0, 0, 0
873, 1, 1636427110865, 1636427111448, 583, 128, 455, 128, 0, 128
878, 1, 1636427111197, 1636427111881, 684, 228, 456, 228, 0, 228
877, 1, 1636427111044, 1636427111901, 857, 401, 456, 400, 0, 400
879, 1, 1636427112309, 1636427112757, 448, 0, 448, 0, 0, 0
880, 1, 1636427112465, 1636427112917, 452, 0, 452, 0, 0, 0
881, 1, 1636427112705, 1636427113149, 444, 0, 444, 0, 0, 0
882, 1, 1636427113149, 1636427113601, 452, 0, 452, 0, 0, 0
883, 1, 1636427113184, 1636427113632, 448, 1, 447, 0, 1, 1
884, 1, 1636427113617, 1636427114069, 452, 0, 452, 0, 0, 0
885, 1, 1636427113640, 1636427114093, 453, 1, 452, 1, 0, 1
886, 1, 1636427113761, 1636427114212, 451, 0, 451, 0, 0, 0
887, 1, 1636427113821, 1636427114269, 448, 0, 448, 0, 0, 0
888, 1, 1636427114200, 1636427114657, 457, 1, 456, 0, 0, 0
889, 1, 1636427114205, 1636427114657, 452, 0, 452, 0, 0, 0
890, 1, 1636427114345, 1636427114788, 443, 0, 443, 0, 0, 0
892, 1, 1636427114632, 1636427115085, 453, 1, 452, 0, 0, 0
891, 1, 1636427114372, 1636427115109, 737, 285, 452, 284, 0, 284
894, 1, 1636427114772, 1636427115229, 457, 1, 456, 0, 0, 0
893, 1, 1636427114772, 1636427115233, 461, 1, 460, 0, 0, 0
897, 1, 1636427115161, 1636427115613, 452, 0, 452, 0, 0, 0
895, 1, 1636427114904, 1636427115681, 777, 325, 452, 325, 0, 325
896, 1, 1636427115048, 1636427115689, 641, 185, 456, 185, 0, 185
898, 1, 1636427115489, 1636427116069, 580, 124, 456, 124, 0, 124
899, 1, 1636427116352, 1636427116809, 457, 1, 456, 0, 0, 0
900, 1, 1636427116629, 1636427117085, 456, 0, 456, 0, 0, 0
901, 1, 1636427116789, 1636427117237, 448, 0, 448, 0, 0, 0
902, 1, 1636427117197, 1636427117645, 448, 0, 448, 0, 0, 0
903, 1, 1636427117393, 1636427117848, 455, 0, 455, 0, 0, 0
904, 1, 1636427117468, 1636427117921, 453, 1, 452, 1, 0, 1
905, 1, 1636427117645, 1636427118101, 456, 1, 455, 0, 0, 0
906, 1, 1636427117708, 1636427118161, 453, 1, 452, 0, 0, 0
907, 1, 1636427117892, 1636427118345, 453, 1, 452, 0, 0, 0
908, 1, 1636427118124, 1636427118569, 445, 1, 444, 0, 0, 0
909, 1, 1636427118209, 1636427118661, 452, 0, 452, 0, 0, 0
910, 1, 1636427118413, 1636427118864, 451, 0, 451, 0, 0, 0
911, 1, 1636427118537, 1636427118989, 452, 0, 452, 0, 0, 0
913, 1, 1636427118664, 1636427119116, 452, 1, 451, 0, 0, 0
912, 1, 1636427118640, 1636427119116, 476, 21, 455, 21, 0, 21
915, 1, 1636427118888, 1636427119341, 453, 1, 452, 0, 1, 1
914, 1, 1636427118888, 1636427119432, 544, 101, 443, 101, 0, 101
916, 1, 1636427118912, 1636427119801, 889, 430, 459, 429, 1, 430
917, 1, 1636427119480, 1636427119933, 453, 0, 453, 0, 0, 0
918, 1, 1636427119597, 1636427120389, 792, 337, 455, 337, 0, 337
919, 1, 1636427120257, 1636427120709, 452, 0, 452, 0, 0, 0
920, 1, 1636427120720, 1636427121177, 457, 1, 456, 1, 0, 1
921, 1, 1636427120945, 1636427121401, 456, 0, 456, 0, 0, 0
922, 1, 1636427121217, 1636427121665, 448, 0, 448, 0, 0, 0
923, 1, 1636427121485, 1636427121937, 452, 0, 452, 0, 0, 0
924, 1, 1636427121500, 1636427121949, 449, 0, 449, 0, 0, 0
925, 1, 1636427121544, 1636427122001, 457, 1, 456, 0, 1, 1
926, 1, 1636427121669, 1636427122120, 451, 0, 451, 0, 0, 0
927, 1, 1636427122164, 1636427122617, 453, 1, 452, 0, 0, 0
928, 1, 1636427122221, 1636427122673, 452, 0, 452, 0, 0, 0
929, 1, 1636427122360, 1636427122808, 448, 0, 448, 0, 0, 0
930, 1, 1636427122633, 1636427123080, 447, 0, 447, 0, 0, 0
931, 1, 1636427122724, 1636427123173, 449, 1, 448, 1, 0, 1
932, 1, 1636427122757, 1636427123209, 452, 0, 452, 0, 0, 0
933, 1, 1636427122904, 1636427123353, 449, 1, 448, 0, 0, 0
934, 1, 1636427122964, 1636427123413, 449, 1, 448, 0, 0, 0
935, 1, 1636427123092, 1636427123541, 449, 1, 448, 0, 1, 1
937, 1, 1636427123401, 1636427123857, 456, 0, 456, 0, 0, 0
936, 1, 1636427123148, 1636427123869, 721, 265, 456, 264, 0, 264
938, 1, 1636427123472, 1636427124312, 840, 386, 454, 384, 1, 385
939, 1, 1636427124185, 1636427124637, 452, 0, 452, 0, 0, 0
940, 1, 1636427125041, 1636427125492, 451, 0, 451, 0, 0, 0
941, 1, 1636427125141, 1636427125593, 452, 0, 452, 0, 0, 0
942, 1, 1636427125237, 1636427125689, 452, 0, 452, 0, 0, 0
943, 1, 1636427125652, 1636427126101, 449, 1, 448, 0, 0, 0
944, 1, 1636427125741, 1636427126189, 448, 0, 448, 0, 0, 0
945, 1, 1636427125804, 1636427126253, 449, 0, 449, 0, 0, 0
946, 1, 1636427125848, 1636427126304, 456, 1, 455, 0, 1, 1
947, 1, 1636427125856, 1636427126305, 449, 1, 448, 0, 0, 0
948, 1, 1636427126388, 1636427126841, 453, 1, 452, 1, 0, 1
949, 1, 1636427126408, 1636427126861, 453, 1, 452, 0, 0, 0
950, 1, 1636427126416, 1636427126869, 453, 0, 453, 0, 0, 0
951, 1, 1636427126636, 1636427127080, 444, 0, 444, 0, 0, 0
952, 1, 1636427126916, 1636427127365, 449, 1, 448, 1, 0, 1
953, 1, 1636427126945, 1636427127396, 451, 0, 451, 0, 0, 0
954, 1, 1636427126972, 1636427127429, 457, 1, 456, 0, 0, 0
955, 1, 1636427127388, 1636427127840, 452, 0, 452, 0, 0, 0
957, 1, 1636427127404, 1636427127857, 453, 0, 453, 0, 0, 0
956, 1, 1636427127396, 1636427127884, 488, 33, 455, 33, 0, 33
958, 1, 1636427127452, 1636427128293, 841, 389, 452, 389, 0, 389
959, 1, 1636427128369, 1636427128821, 452, 0, 452, 0, 0, 0
960, 1, 1636427129001, 1636427129453, 452, 0, 452, 0, 0, 0
961, 1, 1636427129012, 1636427129465, 453, 1, 452, 1, 0, 1
962, 1, 1636427129116, 1636427129569, 453, 1, 452, 0, 0, 0
963, 1, 1636427129548, 1636427130005, 457, 0, 457, 0, 0, 0
965, 1, 1636427129569, 1636427130021, 452, 0, 452, 0, 0, 0
964, 1, 1636427129569, 1636427130029, 460, 1, 459, 0, 0, 0
966, 1, 1636427129604, 1636427130061, 457, 1, 456, 0, 0, 0
967, 1, 1636427129765, 1636427130217, 452, 0, 452, 0, 0, 0
968, 1, 1636427130109, 1636427130561, 452, 0, 452, 0, 0, 0
969, 1, 1636427130297, 1636427130749, 452, 0, 452, 0, 0, 0
970, 1, 1636427130405, 1636427130852, 447, 0, 447, 0, 0, 0
971, 1, 1636427130636, 1636427131205, 569, 114, 455, 114, 0, 114
972, 1, 1636427130817, 1636427131269, 452, 0, 452, 0, 0, 0
973, 1, 1636427130904, 1636427131349, 445, 1, 444, 0, 0, 0
974, 1, 1636427130945, 1636427131396, 451, 0, 451, 0, 0, 0
975, 1, 1636427131153, 1636427131725, 572, 116, 456, 116, 0, 116
976, 1, 1636427131368, 1636427131829, 461, 1, 460, 0, 0, 0
977, 1, 1636427131440, 1636427131889, 449, 1, 448, 1, 0, 1
978, 1, 1636427131596, 1636427132345, 749, 293, 456, 293, 0, 293
979, 1, 1636427132093, 1636427132545, 452, 0, 452, 0, 0, 0
980, 1, 1636427132873, 1636427133320, 447, 0, 447, 0, 0, 0
981, 1, 1636427133153, 1636427133605, 452, 0, 452, 0, 0, 0
982, 1, 1636427133169, 1636427133625, 456, 0, 456, 0, 0, 0
983, 1, 1636427133325, 1636427133776, 451, 0, 451, 0, 0, 0
984, 1, 1636427133612, 1636427134065, 453, 1, 452, 0, 1, 1
985, 1, 1636427133644, 1636427134101, 457, 1, 456, 0, 0, 0
986, 1, 1636427133769, 1636427134220, 451, 0, 451, 0, 0, 0
987, 1, 1636427133909, 1636427134360, 451, 0, 451, 0, 0, 0
988, 1, 1636427134049, 1636427134505, 456, 0, 456, 0, 0, 0
989, 1, 1636427134208, 1636427134661, 453, 1, 452, 0, 0, 0
990, 1, 1636427134404, 1636427134853, 449, 1, 448, 0, 0, 0
991, 1, 1636427134625, 1636427135076, 451, 0, 451, 0, 0, 0
992, 1, 1636427134776, 1636427135228, 452, 1, 451, 0, 0, 0
993, 1, 1636427134989, 1636427135436, 447, 0, 447, 0, 0, 0
994, 1, 1636427134992, 1636427135436, 444, 1, 443, 0, 0, 0
995, 1, 1636427135240, 1636427135892, 652, 197, 455, 196, 0, 196
996, 1, 1636427135480, 1636427135933, 453, 1, 452, 0, 0, 0
997, 1, 1636427135557, 1636427136008, 451, 0, 451, 0, 0, 0
999, 1, 1636427135852, 1636427136305, 453, 0, 453, 0, 0, 0
998, 1, 1636427135780, 1636427136461, 681, 229, 452, 228, 0, 228
1000, 1, 1636427137037, 1636427137489, 452, 0, 452, 0, 0, 0
1001, 1, 1636427137229, 1636427137680, 451, 0, 451, 0, 0, 0
1002, 1, 1636427137437, 1636427137884, 447, 0, 447, 0, 0, 0
1004, 1, 1636427137489, 1636427137937, 448, 0, 448, 0, 0, 0
1003, 1, 1636427137488, 1636427137949, 461, 1, 460, 0, 0, 0
1005, 1, 1636427137824, 1636427138281, 457, 1, 456, 0, 0, 0
1006, 1, 1636427138081, 1636427138529, 448, 0, 448, 0, 0, 0
1007, 1, 1636427138193, 1636427138645, 452, 0, 452, 0, 0, 0
1008, 1, 1636427138353, 1636427138805, 452, 0, 452, 0, 0, 0
1009, 1, 1636427138389, 1636427138845, 456, 0, 456, 0, 0, 0
1010, 1, 1636427138549, 1636427139005, 456, 0, 456, 0, 0, 0
1011, 1, 1636427138585, 1636427139037, 452, 0, 452, 0, 0, 0
1012, 1, 1636427138757, 1636427139257, 500, 48, 452, 48, 0, 48
1013, 1, 1636427139128, 1636427139576, 448, 1, 447, 0, 0, 0
1014, 1, 1636427139148, 1636427139601, 453, 1, 452, 0, 0, 0
1015, 1, 1636427139365, 1636427139821, 456, 0, 456, 0, 0, 0
1017, 1, 1636427139549, 1636427140060, 511, 52, 459, 52, 0, 52
1018, 1, 1636427139761, 1636427140213, 452, 0, 452, 0, 0, 0
1016, 1, 1636427139497, 1636427140269, 772, 324, 448, 324, 0, 324
1019, 1, 1636427140017, 1636427140469, 452, 0, 452, 0, 0, 0
1020, 1, 1636427141057, 1636427141508, 451, 0, 451, 0, 0, 0
1021, 1, 1636427141305, 1636427141761, 456, 0, 456, 0, 0, 0
1022, 1, 1636427141332, 1636427141781, 449, 1, 448, 0, 1, 1
1023, 1, 1636427141357, 1636427141813, 456, 0, 456, 0, 0, 0
1024, 1, 1636427141508, 1636427141961, 453, 1, 452, 1, 0, 1
1025, 1, 1636427141969, 1636427142433, 464, 0, 464, 0, 0, 0
1026, 1, 1636427142008, 1636427142461, 453, 1, 452, 0, 1, 1
1027, 1, 1636427142124, 1636427142576, 452, 1, 451, 0, 0, 0
1028, 1, 1636427142357, 1636427142809, 452, 0, 452, 0, 0, 0
1029, 1, 1636427142437, 1636427142889, 452, 0, 452, 0, 0, 0
1030, 1, 1636427142532, 1636427142984, 452, 1, 451, 0, 0, 0
1031, 1, 1636427142668, 1636427143120, 452, 1, 451, 0, 1, 1
1032, 1, 1636427142996, 1636427143448, 452, 0, 452, 0, 0, 0
1033, 1, 1636427143028, 1636427143477, 449, 0, 449, 0, 0, 0
1034, 1, 1636427143109, 1636427143560, 451, 0, 451, 0, 0, 0
1035, 1, 1636427143269, 1636427143724, 455, 0, 455, 0, 0, 0
1036, 1, 1636427143321, 1636427144017, 696, 240, 456, 240, 0, 240
1038, 1, 1636427143701, 1636427144153, 452, 0, 452, 0, 0, 0
1037, 1, 1636427143680, 1636427144173, 493, 45, 448, 45, 0, 45
1039, 1, 1636427144072, 1636427144525, 453, 1, 452, 0, 0, 0
1040, 1, 1636427145025, 1636427145472, 447, 0, 447, 0, 0, 0
1041, 1, 1636427145345, 1636427145797, 452, 0, 452, 0, 0, 0
1042, 1, 1636427145365, 1636427145820, 455, 0, 455, 0, 0, 0
1043, 1, 1636427145448, 1636427145901, 453, 0, 453, 0, 0, 0
1044, 1, 1636427145476, 1636427145933, 457, 0, 457, 0, 0, 0
1045, 1, 1636427145776, 1636427146229, 453, 0, 453, 0, 0, 0
1046, 1, 1636427146033, 1636427146480, 447, 0, 447, 0, 0, 0
1047, 1, 1636427146153, 1636427146605, 452, 0, 452, 0, 0, 0
1048, 1, 1636427146381, 1636427146832, 451, 0, 451, 0, 0, 0
1049, 1, 1636427146405, 1636427146856, 451, 0, 451, 0, 0, 0
1050, 1, 1636427146433, 1636427146880, 447, 0, 447, 0, 0, 0
1051, 1, 1636427146788, 1636427147237, 449, 0, 449, 0, 0, 0
1052, 1, 1636427146816, 1636427147269, 453, 0, 453, 0, 0, 0
1053, 1, 1636427147013, 1636427147464, 451, 0, 451, 0, 0, 0
1054, 1, 1636427147045, 1636427147497, 452, 0, 452, 0, 0, 0
1055, 1, 1636427147141, 1636427147588, 447, 0, 447, 0, 0, 0
1056, 1, 1636427147260, 1636427147729, 469, 9, 460, 8, 0, 8
1057, 1, 1636427147361, 1636427147961, 600, 137, 463, 136, 0, 136
1058, 1, 1636427147845, 1636427148297, 452, 0, 452, 0, 0, 0
1059, 1, 1636427148144, 1636427148597, 453, 1, 452, 0, 0, 0
1060, 1, 1636427149096, 1636427149544, 448, 0, 448, 0, 0, 0
1061, 1, 1636427149140, 1636427149592, 452, 1, 451, 0, 0, 0
1062, 1, 1636427149301, 1636427149757, 456, 0, 456, 0, 0, 0
1063, 1, 1636427149364, 1636427149820, 456, 1, 455, 0, 0, 0
1064, 1, 1636427149633, 1636427150085, 452, 0, 452, 0, 0, 0
1065, 1, 1636427149864, 1636427150317, 453, 1, 452, 1, 0, 1
1066, 1, 1636427150009, 1636427150461, 452, 0, 452, 0, 0, 0
1067, 1, 1636427150100, 1636427150557, 457, 1, 456, 0, 0, 0
1068, 1, 1636427150161, 1636427150612, 451, 0, 451, 0, 0, 0
1069, 1, 1636427150568, 1636427151025, 457, 0, 457, 0, 0, 0
1070, 1, 1636427150709, 1636427151161, 452, 0, 452, 0, 0, 0
1071, 1, 1636427150764, 1636427151212, 448, 1, 447, 0, 0, 0
1072, 1, 1636427150812, 1636427151264, 452, 1, 451, 0, 0, 0
1073, 1, 1636427150985, 1636427151441, 456, 0, 456, 0, 0, 0
1075, 1, 1636427151109, 1636427151560, 451, 0, 451, 0, 0, 0
1076, 1, 1636427151161, 1636427151608, 447, 0, 447, 0, 0, 0
1074, 1, 1636427151072, 1636427151721, 649, 193, 456, 191, 0, 191
1077, 1, 1636427151377, 1636427152009, 632, 183, 449, 183, 0, 183
1078, 1, 1636427151696, 1636427152149, 453, 1, 452, 1, 0, 1
1079, 1, 1636427152181, 1636427152633, 452, 0, 452, 0, 0, 0
1080, 1, 1636427153164, 1636427153612, 448, 0, 448, 0, 0, 0
1081, 1, 1636427153208, 1636427153661, 453, 1, 452, 0, 0, 0
1082, 1, 1636427153405, 1636427153848, 443, 0, 443, 0, 0, 0
1083, 1, 1636427153557, 1636427154008, 451, 0, 451, 0, 0, 0
1084, 1, 1636427153681, 1636427154145, 464, 0, 464, 0, 0, 0
1085, 1, 1636427153824, 1636427154272, 448, 1, 447, 0, 1, 1
1086, 1, 1636427153940, 1636427154393, 453, 1, 452, 0, 0, 0
1087, 1, 1636427154225, 1636427154677, 452, 0, 452, 0, 0, 0
1088, 1, 1636427154256, 1636427154709, 453, 1, 452, 1, 0, 1
1089, 1, 1636427154660, 1636427155116, 456, 0, 456, 0, 0, 0
1090, 1, 1636427154704, 1636427155161, 457, 1, 456, 0, 1, 1
1091, 1, 1636427154732, 1636427155180, 448, 1, 447, 0, 0, 0
1092, 1, 1636427154773, 1636427155221, 448, 0, 448, 0, 0, 0
1093, 1, 1636427154914, 1636427155369, 455, 0, 455, 0, 0, 0
1094, 1, 1636427155045, 1636427155616, 571, 117, 454, 116, 0, 116
1095, 1, 1636427155409, 1636427155860, 451, 0, 451, 0, 0, 0
1096, 1, 1636427155433, 1636427155880, 447, 0, 447, 0, 0, 0
1098, 1, 1636427155556, 1636427156009, 453, 0, 453, 0, 0, 0
1097, 1, 1636427155493, 1636427156313, 820, 368, 452, 368, 0, 368
1099, 1, 1636427156405, 1636427156861, 456, 0, 456, 0, 0, 0
1100, 1, 1636427157093, 1636427157541, 448, 0, 448, 0, 0, 0
1101, 1, 1636427157140, 1636427157592, 452, 1, 451, 0, 0, 0
1102, 1, 1636427157389, 1636427157840, 451, 0, 451, 0, 0, 0
1103, 1, 1636427157441, 1636427157893, 452, 0, 452, 0, 0, 0
1104, 1, 1636427157505, 1636427157965, 460, 0, 460, 0, 0, 0
1105, 1, 1636427157576, 1636427158025, 449, 1, 448, 0, 0, 0
1106, 1, 1636427157628, 1636427158081, 453, 1, 452, 0, 0, 0
1107, 1, 1636427158408, 1636427158856, 448, 1, 447, 0, 0, 0
1108, 1, 1636427158416, 1636427158860, 444, 1, 443, 0, 0, 0
1109, 1, 1636427158448, 1636427158900, 452, 0, 452, 0, 0, 0
1110, 1, 1636427158552, 1636427159005, 453, 0, 453, 0, 0, 0
1111, 1, 1636427158612, 1636427159064, 452, 0, 452, 0, 0, 0
1112, 1, 1636427158969, 1636427159512, 543, 96, 447, 96, 0, 96
1113, 1, 1636427159072, 1636427159512, 440, 1, 439, 0, 0, 0
1114, 1, 1636427159108, 1636427159565, 457, 1, 456, 0, 0, 0
1115, 1, 1636427159173, 1636427159625, 452, 0, 452, 0, 0, 0
1116, 1, 1636427159365, 1636427159817, 452, 0, 452, 0, 0, 0
1118, 1, 1636427159493, 1636427159945, 452, 0, 452, 0, 0, 0
1117, 1, 1636427159380, 1636427160277, 897, 437, 460, 436, 0, 436
1119, 1, 1636427160573, 1636427161029, 456, 0, 456, 0, 0, 0
1120, 1, 1636427160841, 1636427161289, 448, 0, 448, 0, 0, 0
1121, 1, 1636427161101, 1636427161549, 448, 0, 448, 0, 0, 0
1122, 1, 1636427161192, 1636427161632, 440, 1, 439, 0, 1, 1
1123, 1, 1636427161216, 1636427161673, 457, 0, 457, 0, 0, 0
1124, 1, 1636427161324, 1636427161765, 441, 1, 440, 0, 0, 0
1125, 1, 1636427161429, 1636427161877, 448, 0, 448, 0, 0, 0
1126, 1, 1636427161585, 1636427162041, 456, 0, 456, 0, 0, 0
1127, 1, 1636427162113, 1636427162565, 452, 0, 452, 0, 0, 0
1128, 1, 1636427162297, 1636427162749, 452, 0, 452, 0, 0, 0
1129, 1, 1636427162441, 1636427162888, 447, 0, 447, 0, 0, 0
1130, 1, 1636427162569, 1636427163017, 448, 0, 448, 0, 0, 0
1131, 1, 1636427162681, 1636427163137, 456, 0, 456, 0, 0, 0
1132, 1, 1636427162868, 1636427163325, 457, 1, 456, 1, 0, 1
1133, 1, 1636427162977, 1636427163424, 447, 0, 447, 0, 0, 0
1134, 1, 1636427163016, 1636427163469, 453, 1, 452, 0, 0, 0
1135, 1, 1636427163208, 1636427163656, 448, 1, 447, 0, 0, 0
1136, 1, 1636427163448, 1636427163900, 452, 1, 451, 0, 0, 0
1138, 1, 1636427163504, 1636427163961, 457, 1, 456, 0, 0, 0
1137, 1, 1636427163472, 1636427164353, 881, 429, 452, 429, 0, 429
1139, 1, 1636427164725, 1636427165177, 452, 0, 452, 0, 0, 0
1140, 1, 1636427164796, 1636427165249, 453, 1, 452, 0, 0, 0
1141, 1, 1636427164936, 1636427165385, 449, 1, 448, 0, 0, 0
1142, 1, 1636427165197, 1636427165648, 451, 0, 451, 0, 0, 0
1143, 1, 1636427165300, 1636427165753, 453, 1, 452, 1, 0, 1
1144, 1, 1636427165308, 1636427165756, 448, 1, 447, 0, 0, 0
1145, 1, 1636427165316, 1636427165764, 448, 1, 447, 0, 0, 0
1146, 1, 1636427165628, 1636427166081, 453, 0, 453, 0, 0, 0
1147, 1, 1636427166213, 1636427166661, 448, 0, 448, 0, 0, 0
1148, 1, 1636427166332, 1636427166789, 457, 1, 456, 0, 0, 0
1149, 1, 1636427166336, 1636427166789, 453, 1, 452, 0, 0, 0
1150, 1, 1636427166468, 1636427166925, 457, 1, 456, 0, 0, 0
1151, 1, 1636427166564, 1636427167012, 448, 1, 447, 1, 0, 1
1152, 1, 1636427166965, 1636427167421, 456, 0, 456, 0, 0, 0
1153, 1, 1636427166985, 1636427167441, 456, 0, 456, 0, 0, 0
1154, 1, 1636427167136, 1636427167589, 453, 0, 453, 0, 0, 0
1155, 1, 1636427167160, 1636427167612, 452, 0, 452, 0, 0, 0
1156, 1, 1636427167509, 1636427167961, 452, 0, 452, 0, 0, 0
1157, 1, 1636427167588, 1636427168041, 453, 1, 452, 0, 0, 0
1158, 1, 1636427167705, 1636427168505, 800, 336, 464, 336, 0, 336
1159, 1, 1636427168697, 1636427169152, 455, 0, 455, 0, 0, 0
1160, 1, 1636427168956, 1636427169421, 465, 0, 465, 0, 0, 0
1161, 1, 1636427169045, 1636427169505, 460, 0, 460, 0, 0, 0
1162, 1, 1636427169133, 1636427169589, 456, 0, 456, 0, 0, 0
1163, 1, 1636427169204, 1636427169657, 453, 0, 453, 0, 0, 0
1164, 1, 1636427169345, 1636427169797, 452, 0, 452, 0, 0, 0
1165, 1, 1636427169397, 1636427169845, 448, 0, 448, 0, 0, 0
1166, 1, 1636427169809, 1636427170261, 452, 0, 452, 0, 0, 0
1167, 1, 1636427170248, 1636427170696, 448, 1, 447, 0, 1, 1
1168, 1, 1636427170289, 1636427170740, 451, 0, 451, 0, 0, 0
1169, 1, 1636427170320, 1636427170768, 448, 0, 448, 0, 0, 0
1170, 1, 1636427170461, 1636427170904, 443, 0, 443, 0, 0, 0
1171, 1, 1636427170640, 1636427171092, 452, 1, 451, 1, 0, 1
1172, 1, 1636427170856, 1636427171305, 449, 0, 449, 0, 0, 0
1173, 1, 1636427171144, 1636427171613, 469, 1, 468, 0, 0, 0
1174, 1, 1636427171405, 1636427171857, 452, 0, 452, 0, 0, 0
1175, 1, 1636427171440, 1636427171893, 453, 1, 452, 0, 0, 0
1176, 1, 1636427171456, 1636427171905, 449, 1, 448, 0, 0, 0
1177, 1, 1636427171456, 1636427171913, 457, 1, 456, 0, 0, 0
1178, 1, 1636427171565, 1636427172369, 804, 348, 456, 348, 0, 348
1179, 1, 1636427172936, 1636427173380, 444, 0, 444, 0, 0, 0
1180, 1, 1636427172980, 1636427173424, 444, 1, 443, 1, 0, 1
1181, 1, 1636427173101, 1636427173553, 452, 0, 452, 0, 0, 0
1182, 1, 1636427173188, 1636427173641, 453, 0, 453, 0, 0, 0
1183, 1, 1636427173252, 1636427173700, 448, 1, 447, 1, 0, 1
1184, 1, 1636427173376, 1636427173829, 453, 1, 452, 0, 0, 0
1185, 1, 1636427173445, 1636427173904, 459, 0, 459, 0, 0, 0
1186, 1, 1636427173948, 1636427174397, 449, 1, 448, 0, 0, 0
1187, 1, 1636427174049, 1636427174501, 452, 0, 452, 0, 0, 0
1188, 1, 1636427174212, 1636427174665, 453, 1, 452, 0, 0, 0
1189, 1, 1636427174345, 1636427174848, 503, 53, 450, 52, 0, 52
1190, 1, 1636427174536, 1636427174989, 453, 1, 452, 0, 0, 0
1191, 1, 1636427174680, 1636427175133, 453, 1, 452, 0, 0, 0
1192, 1, 1636427174757, 1636427175208, 451, 0, 451, 0, 0, 0
1193, 1, 1636427175317, 1636427175769, 452, 0, 452, 0, 0, 0
1194, 1, 1636427175356, 1636427175809, 453, 1, 452, 0, 1, 1
1195, 1, 1636427175572, 1636427176025, 453, 0, 453, 0, 0, 0
1196, 1, 1636427175601, 1636427176053, 452, 0, 452, 0, 0, 0
1198, 1, 1636427175652, 1636427176100, 448, 1, 447, 0, 0, 0
1197, 1, 1636427175628, 1636427176509, 881, 425, 456, 424, 0, 424
1199, 1, 1636427176716, 1636427177169, 453, 1, 452, 0, 0, 0
1200, 1, 1636427176737, 1636427177181, 444, 0, 444, 0, 0, 0
1201, 1, 1636427177057, 1636427177509, 452, 0, 452, 0, 0, 0
1202, 1, 1636427177089, 1636427177541, 452, 0, 452, 0, 0, 0
1203, 1, 1636427177220, 1636427177672, 452, 1, 451, 0, 0, 0
1204, 1, 1636427177240, 1636427177692, 452, 1, 451, 0, 0, 0
1205, 1, 1636427177448, 1636427177900, 452, 1, 451, 0, 1, 1
1206, 1, 1636427177853, 1636427178305, 452, 0, 452, 0, 0, 0
1207, 1, 1636427178025, 1636427178477, 452, 0, 452, 0, 0, 0
1208, 1, 1636427178320, 1636427178769, 449, 1, 448, 0, 0, 0
1209, 1, 1636427178328, 1636427178776, 448, 1, 447, 0, 0, 0
1210, 1, 1636427178537, 1636427178989, 452, 0, 452, 0, 0, 0
1211, 1, 1636427178937, 1636427179389, 452, 0, 452, 0, 0, 0
1212, 1, 1636427178997, 1636427179449, 452, 0, 452, 0, 0, 0
1213, 1, 1636427179261, 1636427179712, 451, 0, 451, 0, 0, 0
1214, 1, 1636427179441, 1636427179892, 451, 0, 451, 0, 0, 0
1216, 1, 1636427179449, 1636427179900, 451, 0, 451, 0, 0, 0
1217, 1, 1636427179648, 1636427180101, 453, 0, 453, 0, 0, 0
1218, 1, 1636427179829, 1636427180285, 456, 0, 456, 0, 0, 0
1215, 1, 1636427179449, 1636427180345, 896, 444, 452, 444, 0, 444
1219, 1, 1636427180681, 1636427181133, 452, 0, 452, 0, 0, 0
1220, 1, 1636427180793, 1636427181249, 456, 0, 456, 0, 0, 0
1221, 1, 1636427180957, 1636427181412, 455, 0, 455, 0, 0, 0
1222, 1, 1636427181105, 1636427181552, 447, 0, 447, 0, 0, 0
1223, 1, 1636427181300, 1636427181753, 453, 1, 452, 1, 0, 1
1224, 1, 1636427181412, 1636427181865, 453, 1, 452, 0, 0, 0
1225, 1, 1636427181753, 1636427182205, 452, 0, 452, 0, 0, 0
1226, 1, 1636427182045, 1636427182496, 451, 0, 451, 0, 0, 0
1227, 1, 1636427182177, 1636427182628, 451, 0, 451, 0, 0, 0
1228, 1, 1636427182357, 1636427182804, 447, 0, 447, 0, 0, 0
1229, 1, 1636427182617, 1636427183069, 452, 0, 452, 0, 0, 0
1230, 1, 1636427182641, 1636427183097, 456, 0, 456, 0, 0, 0
1231, 1, 1636427182672, 1636427183125, 453, 1, 452, 0, 1, 1
1232, 1, 1636427183037, 1636427183485, 448, 0, 448, 0, 0, 0
1233, 1, 1636427183296, 1636427183748, 452, 1, 451, 0, 0, 0
1234, 1, 1636427183321, 1636427183772, 451, 0, 451, 0, 0, 0
1236, 1, 1636427183585, 1636427184037, 452, 0, 452, 0, 0, 0
1237, 1, 1636427183609, 1636427184061, 452, 0, 452, 0, 0, 0
1238, 1, 1636427183728, 1636427184173, 445, 0, 445, 0, 0, 0
1235, 1, 1636427183441, 1636427184233, 792, 332, 460, 332, 0, 332
1239, 1, 1636427184473, 1636427184925, 452, 0, 452, 0, 0, 0
1240, 1, 1636427184749, 1636427185201, 452, 0, 452, 0, 0, 0
1241, 1, 1636427184848, 1636427185305, 457, 1, 456, 0, 0, 0
1242, 1, 1636427185061, 1636427185517, 456, 0, 456, 0, 0, 0
1243, 1, 1636427185493, 1636427185948, 455, 0, 455, 0, 0, 0
1244, 1, 1636427185568, 1636427186021, 453, 1, 452, 1, 0, 1
1245, 1, 1636427185568, 1636427186021, 453, 1, 452, 0, 0, 0
1246, 1, 1636427185904, 1636427186357, 453, 1, 452, 0, 0, 0
1247, 1, 1636427186332, 1636427186785, 453, 1, 452, 0, 0, 0
1248, 1, 1636427186373, 1636427186825, 452, 0, 452, 0, 0, 0
1249, 1, 1636427186744, 1636427187197, 453, 1, 452, 0, 0, 0
1250, 1, 1636427186801, 1636427187265, 464, 0, 464, 0, 0, 0
1251, 1, 1636427186885, 1636427187337, 452, 0, 452, 0, 0, 0
1252, 1, 1636427187192, 1636427187645, 453, 1, 452, 0, 0, 0
1253, 1, 1636427187252, 1636427187700, 448, 0, 448, 0, 0, 0
1254, 1, 1636427187296, 1636427187741, 445, 1, 444, 0, 1, 1
1256, 1, 1636427187677, 1636427188129, 452, 0, 452, 0, 0, 0
1255, 1, 1636427187397, 1636427188157, 760, 303, 457, 303, 0, 303
1257, 1, 1636427187741, 1636427188189, 448, 0, 448, 0, 0, 0
1258, 1, 1636427187784, 1636427188241, 457, 0, 457, 0, 0, 0
1259, 1, 1636427188541, 1636427188989, 448, 0, 448, 0, 0, 0
1260, 1, 1636427188728, 1636427189181, 453, 1, 452, 0, 1, 1
1261, 1, 1636427188748, 1636427189201, 453, 0, 453, 0, 0, 0
1262, 1, 1636427189016, 1636427189465, 449, 1, 448, 1, 0, 1
1263, 1, 1636427189193, 1636427189649, 456, 0, 456, 0, 0, 0
1264, 1, 1636427189521, 1636427189973, 452, 0, 452, 0, 0, 0
1265, 1, 1636427189600, 1636427190053, 453, 1, 452, 0, 0, 0
1266, 1, 1636427189764, 1636427190213, 449, 0, 449, 0, 0, 0
1267, 1, 1636427190213, 1636427190664, 451, 0, 451, 0, 0, 0
1268, 1, 1636427190529, 1636427190985, 456, 0, 456, 0, 0, 0
1269, 1, 1636427190837, 1636427191285, 448, 0, 448, 0, 0, 0
1270, 1, 1636427190925, 1636427191377, 452, 0, 452, 0, 0, 0
1271, 1, 1636427191033, 1636427191488, 455, 0, 455, 0, 0, 0
1272, 1, 1636427191049, 1636427191501, 452, 0, 452, 0, 0, 0
1273, 1, 1636427191225, 1636427191677, 452, 0, 452, 0, 0, 0
1274, 1, 1636427191264, 1636427191717, 453, 1, 452, 0, 0, 0
1275, 1, 1636427191629, 1636427192173, 544, 89, 455, 88, 0, 88
1276, 1, 1636427191744, 1636427192197, 453, 0, 453, 0, 0, 0
1277, 1, 1636427191861, 1636427192321, 460, 0, 460, 0, 0, 0
1278, 1, 1636427191981, 1636427192437, 456, 0, 456, 0, 0, 0
1279, 1, 1636427192601, 1636427193053, 452, 0, 452, 0, 0, 0
1280, 1, 1636427192697, 1636427193149, 452, 0, 452, 0, 0, 0
1281, 1, 1636427192865, 1636427193317, 452, 0, 452, 0, 0, 0
1282, 1, 1636427193265, 1636427193717, 452, 0, 452, 0, 0, 0
1283, 1, 1636427193297, 1636427193748, 451, 0, 451, 0, 0, 0
1284, 1, 1636427193609, 1636427194065, 456, 0, 456, 0, 0, 0
1285, 1, 1636427193768, 1636427194221, 453, 0, 453, 0, 0, 0
1286, 1, 1636427193877, 1636427194328, 451, 0, 451, 0, 0, 0
1287, 1, 1636427194253, 1636427194705, 452, 0, 452, 0, 0, 0
1288, 1, 1636427194392, 1636427194844, 452, 1, 451, 1, 0, 1
1289, 1, 1636427194912, 1636427195365, 453, 0, 453, 0, 0, 0
1290, 1, 1636427194940, 1636427195393, 453, 0, 453, 0, 0, 0
1291, 1, 1636427194956, 1636427195413, 457, 0, 457, 0, 0, 0
1292, 1, 1636427195068, 1636427195525, 457, 1, 456, 0, 0, 0
1293, 1, 1636427195228, 1636427195681, 453, 1, 452, 0, 0, 0
1294, 1, 1636427195264, 1636427195721, 457, 0, 457, 0, 0, 0
1295, 1, 1636427195593, 1636427196169, 576, 128, 448, 128, 0, 128
1296, 1, 1636427195845, 1636427196297, 452, 0, 452, 0, 0, 0
1297, 1, 1636427195989, 1636427196437, 448, 0, 448, 0, 0, 0
1298, 1, 1636427196173, 1636427196625, 452, 0, 452, 0, 0, 0
1299, 1, 1636427196457, 1636427196909, 452, 0, 452, 0, 0, 0
1300, 1, 1636427196645, 1636427197097, 452, 0, 452, 0, 0, 0
1301, 1, 1636427196652, 1636427197105, 453, 1, 452, 0, 0, 0
1302, 1, 1636427197473, 1636427197920, 447, 0, 447, 0, 0, 0
1303, 1, 1636427197592, 1636427198041, 449, 1, 448, 0, 1, 1
1304, 1, 1636427197636, 1636427198084, 448, 0, 448, 0, 0, 0
1305, 1, 1636427197772, 1636427198221, 449, 0, 449, 0, 0, 0
1306, 1, 1636427198100, 1636427198553, 453, 1, 452, 0, 0, 0
1307, 1, 1636427198341, 1636427198793, 452, 0, 452, 0, 0, 0
1308, 1, 1636427198556, 1636427199009, 453, 1, 452, 1, 0, 1
1309, 1, 1636427198844, 1636427199297, 453, 1, 452, 0, 0, 0
1310, 1, 1636427198929, 1636427199381, 452, 0, 452, 0, 0, 0
1311, 1, 1636427198953, 1636427199409, 456, 0, 456, 0, 0, 0
1312, 1, 1636427199076, 1636427199533, 457, 1, 456, 1, 0, 1
1314, 1, 1636427199168, 1636427199616, 448, 1, 447, 0, 0, 0
1313, 1, 1636427199160, 1636427199620, 460, 1, 459, 1, 0, 1
1315, 1, 1636427199304, 1636427200069, 765, 313, 452, 312, 0, 312
1316, 1, 1636427199881, 1636427200329, 448, 0, 448, 0, 0, 0
1317, 1, 1636427200000, 1636427200453, 453, 1, 452, 0, 0, 0
1318, 1, 1636427200061, 1636427200513, 452, 0, 452, 0, 0, 0
1319, 1, 1636427200205, 1636427200656, 451, 0, 451, 0, 0, 0
1320, 1, 1636427200508, 1636427200965, 457, 1, 456, 0, 0, 0
1321, 1, 1636427200777, 1636427201241, 464, 0, 464, 0, 0, 0
1322, 1, 1636427201385, 1636427201840, 455, 0, 455, 0, 0, 0
1323, 1, 1636427201497, 1636427201948, 451, 0, 451, 0, 0, 0
1324, 1, 1636427201525, 1636427201977, 452, 0, 452, 0, 0, 0
1326, 1, 1636427201973, 1636427202425, 452, 0, 452, 0, 0, 0
1325, 1, 1636427201808, 1636427202429, 621, 169, 452, 169, 0, 169
1327, 1, 1636427202581, 1636427203033, 452, 0, 452, 0, 0, 0
1329, 1, 1636427202665, 1636427203117, 452, 0, 452, 0, 0, 0
1328, 1, 1636427202665, 1636427203120, 455, 0, 455, 0, 0, 0
1330, 1, 1636427202824, 1636427203277, 453, 0, 453, 0, 0, 0
1331, 1, 1636427202868, 1636427203325, 457, 0, 457, 0, 0, 0
1332, 1, 1636427203241, 1636427203693, 452, 0, 452, 0, 0, 0
1333, 1, 1636427203393, 1636427203837, 444, 0, 444, 0, 0, 0
1334, 1, 1636427203397, 1636427203837, 440, 0, 440, 0, 0, 0
1335, 1, 1636427203485, 1636427204153, 668, 209, 459, 208, 0, 208
1336, 1, 1636427203713, 1636427204165, 452, 0, 452, 0, 0, 0
1337, 1, 1636427203901, 1636427204349, 448, 0, 448, 0, 0, 0
1338, 1, 1636427203988, 1636427204441, 453, 1, 452, 0, 0, 0
1339, 1, 1636427204193, 1636427204645, 452, 0, 452, 0, 0, 0
1340, 1, 1636427204216, 1636427204669, 453, 1, 452, 0, 1, 1
1341, 1, 1636427204681, 1636427205133, 452, 0, 452, 0, 0, 0
1342, 1, 1636427205165, 1636427205620, 455, 0, 455, 0, 0, 0
1343, 1, 1636427205404, 1636427205852, 448, 1, 447, 0, 0, 0
1344, 1, 1636427205576, 1636427206029, 453, 1, 452, 0, 1, 1
1345, 1, 1636427206065, 1636427206516, 451, 0, 451, 0, 0, 0
1346, 1, 1636427206101, 1636427206553, 452, 0, 452, 0, 0, 0
1347, 1, 1636427206357, 1636427206813, 456, 0, 456, 0, 0, 0
1348, 1, 1636427206465, 1636427206925, 460, 0, 460, 0, 0, 0
1349, 1, 1636427206821, 1636427207265, 444, 0, 444, 0, 0, 0
1350, 1, 1636427206905, 1636427207353, 448, 0, 448, 0, 0, 0
1351, 1, 1636427206993, 1636427207441, 448, 0, 448, 0, 0, 0
1352, 1, 1636427207025, 1636427207477, 452, 0, 452, 0, 0, 0
1353, 1, 1636427207320, 1636427207769, 449, 1, 448, 0, 0, 0
1354, 1, 1636427207436, 1636427207892, 456, 5, 451, 5, 0, 5
1355, 1, 1636427207481, 1636427207933, 452, 0, 452, 0, 0, 0
1356, 1, 1636427207701, 1636427208152, 451, 0, 451, 0, 0, 0
1357, 1, 1636427207769, 1636427208217, 448, 0, 448, 0, 0, 0
1358, 1, 1636427208193, 1636427208645, 452, 0, 452, 0, 0, 0
1359, 1, 1636427208196, 1636427208649, 453, 1, 452, 0, 1, 1
1360, 1, 1636427208317, 1636427208769, 452, 0, 452, 0, 0, 0
1361, 1, 1636427208713, 1636427209169, 456, 0, 456, 0, 0, 0
1362, 1, 1636427209373, 1636427209820, 447, 0, 447, 0, 0, 0
1363, 1, 1636427209445, 1636427209897, 452, 0, 452, 0, 0, 0
1364, 1, 1636427209733, 1636427210185, 452, 0, 452, 0, 0, 0
1365, 1, 1636427209780, 1636427210348, 568, 117, 451, 117, 0, 117
1366, 1, 1636427210109, 1636427210561, 452, 0, 452, 0, 0, 0
1367, 1, 1636427210380, 1636427210833, 453, 1, 452, 0, 0, 0
1368, 1, 1636427210436, 1636427210885, 449, 1, 448, 0, 0, 0
1370, 1, 1636427210684, 1636427211137, 453, 1, 452, 0, 1, 1
1369, 1, 1636427210684, 1636427211137, 453, 1, 452, 0, 0, 0
1372, 1, 1636427211100, 1636427211553, 453, 1, 452, 0, 0, 0
1371, 1, 1636427211105, 1636427211561, 456, 0, 456, 0, 0, 0
1373, 1, 1636427211409, 1636427211864, 455, 0, 455, 0, 0, 0
1374, 1, 1636427211449, 1636427212017, 568, 112, 456, 112, 0, 112
1375, 1, 1636427211577, 1636427212029, 452, 0, 452, 0, 0, 0
1376, 1, 1636427211637, 1636427212089, 452, 0, 452, 0, 0, 0
1377, 1, 1636427211673, 1636427212125, 452, 0, 452, 0, 0, 0
1378, 1, 1636427212157, 1636427212609, 452, 0, 452, 0, 0, 0
1379, 1, 1636427212341, 1636427212793, 452, 0, 452, 0, 0, 0
1380, 1, 1636427212569, 1636427213020, 451, 0, 451, 0, 0, 0
1381, 1, 1636427212976, 1636427213433, 457, 0, 457, 0, 0, 0
1382, 1, 1636427213676, 1636427214125, 449, 0, 449, 0, 0, 0
1383, 1, 1636427213720, 1636427214181, 461, 1, 460, 0, 1, 1
1384, 1, 1636427213736, 1636427214184, 448, 0, 448, 0, 0, 0
1385, 1, 1636427213884, 1636427214341, 457, 0, 457, 0, 0, 0
1386, 1, 1636427214089, 1636427214637, 548, 92, 456, 92, 0, 92
1387, 1, 1636427214505, 1636427214957, 452, 0, 452, 0, 0, 0
1388, 1, 1636427214705, 1636427215160, 455, 0, 455, 0, 0, 0
1389, 1, 1636427214761, 1636427215208, 447, 0, 447, 0, 0, 0
1390, 1, 1636427214901, 1636427215341, 440, 0, 440, 0, 0, 0
1391, 1, 1636427214985, 1636427215429, 444, 0, 444, 0, 0, 0
1392, 1, 1636427215160, 1636427215613, 453, 1, 452, 0, 0, 0
1393, 1, 1636427215220, 1636427215797, 577, 122, 455, 121, 1, 122
1394, 1, 1636427215645, 1636427216101, 456, 0, 456, 0, 0, 0
1395, 1, 1636427215721, 1636427216169, 448, 0, 448, 0, 0, 0
1396, 1, 1636427215728, 1636427216176, 448, 1, 447, 0, 0, 0
1397, 1, 1636427215941, 1636427216389, 448, 0, 448, 0, 0, 0
1398, 1, 1636427216353, 1636427216805, 452, 0, 452, 0, 0, 0
1399, 1, 1636427216469, 1636427216920, 451, 0, 451, 0, 0, 0
1400, 1, 1636427216553, 1636427217005, 452, 0, 452, 0, 0, 0
1401, 1, 1636427216861, 1636427217313, 452, 0, 452, 0, 0, 0
1402, 1, 1636427217829, 1636427218277, 448, 0, 448, 0, 0, 0
1403, 1, 1636427217957, 1636427218404, 447, 0, 447, 0, 0, 0
1404, 1, 1636427217984, 1636427218433, 449, 1, 448, 0, 1, 1
1405, 1, 1636427218021, 1636427218465, 444, 0, 444, 0, 0, 0
1407, 1, 1636427218360, 1636427218813, 453, 0, 453, 0, 0, 0
1406, 1, 1636427218161, 1636427218921, 760, 304, 456, 304, 0, 304
1408, 1, 1636427218673, 1636427219125, 452, 0, 452, 0, 0, 0
1409, 1, 1636427218824, 1636427219277, 453, 1, 452, 0, 0, 0
1410, 1, 1636427219149, 1636427219596, 447, 0, 447, 0, 0, 0
1411, 1, 1636427219221, 1636427219669, 448, 0, 448, 0, 0, 0
1412, 1, 1636427219284, 1636427219736, 452, 1, 451, 0, 0, 0
1413, 1, 1636427219468, 1636427219917, 449, 0, 449, 0, 0, 0
1415, 1, 1636427219476, 1636427220049, 573, 121, 452, 121, 0, 121
1414, 1, 1636427219476, 1636427220120, 644, 193, 451, 193, 0, 193
1416, 1, 1636427219689, 1636427220141, 452, 0, 452, 0, 0, 0
1417, 1, 1636427220237, 1636427220693, 456, 0, 456, 0, 0, 0
1418, 1, 1636427220305, 1636427220757, 452, 0, 452, 0, 0, 0
1419, 1, 1636427220413, 1636427220869, 456, 0, 456, 0, 0, 0
1420, 1, 1636427220493, 1636427220945, 452, 0, 452, 0, 0, 0
1421, 1, 1636427221049, 1636427221501, 452, 0, 452, 0, 0, 0
1422, 1, 1636427221765, 1636427222220, 455, 0, 455, 0, 0, 0
1423, 1, 1636427221845, 1636427222301, 456, 0, 456, 0, 0, 0
1424, 1, 1636427221848, 1636427222305, 457, 1, 456, 0, 1, 1
1425, 1, 1636427222033, 1636427222485, 452, 0, 452, 0, 0, 0
1427, 1, 1636427222264, 1636427222717, 453, 1, 452, 0, 1, 1
1426, 1, 1636427222137, 1636427222757, 620, 168, 452, 168, 0, 168
1428, 1, 1636427222813, 1636427223264, 451, 0, 451, 0, 0, 0
1429, 1, 1636427222817, 1636427223268, 451, 0, 451, 0, 0, 0
1430, 1, 1636427223097, 1636427223549, 452, 0, 452, 0, 0, 0
1431, 1, 1636427223160, 1636427223609, 449, 1, 448, 0, 1, 1
1434, 1, 1636427223532, 1636427223985, 453, 1, 452, 0, 0, 0
1433, 1, 1636427223528, 1636427224064, 536, 81, 455, 80, 0, 80
1436, 1, 1636427223772, 1636427224220, 448, 1, 447, 0, 1, 1
1435, 1, 1636427223620, 1636427224437, 817, 366, 451, 365, 1, 366
1437, 1, 1636427224044, 1636427224480, 436, 1, 435, 0, 1, 1
1432, 1, 1636427223260, 1636427224508, 1248, 805, 443, 805, 0, 805
1438, 1, 1636427224400, 1636427224853, 453, 0, 453, 0, 0, 0
1439, 1, 1636427224565, 1636427225013, 448, 0, 448, 0, 0, 0
1440, 1, 1636427224596, 1636427225049, 453, 1, 452, 0, 0, 0
1441, 1, 1636427224881, 1636427225333, 452, 0, 452, 0, 0, 0
1442, 1, 1636427225833, 1636427226281, 448, 0, 448, 0, 0, 0
1443, 1, 1636427226009, 1636427226461, 452, 0, 452, 0, 0, 0
1444, 1, 1636427226149, 1636427226601, 452, 0, 452, 0, 0, 0
1445, 1, 1636427226185, 1636427226637, 452, 0, 452, 0, 0, 0
1447, 1, 1636427226317, 1636427226769, 452, 0, 452, 0, 0, 0
1446, 1, 1636427226296, 1636427227057, 761, 305, 456, 304, 0, 304
1448, 1, 1636427227061, 1636427227509, 448, 0, 448, 0, 0, 0
1449, 1, 1636427227096, 1636427227549, 453, 0, 453, 0, 0, 0
1450, 1, 1636427227285, 1636427227737, 452, 0, 452, 0, 0, 0
1451, 1, 1636427227312, 1636427227764, 452, 1, 451, 0, 0, 0
1452, 1, 1636427227401, 1636427227848, 447, 0, 447, 0, 0, 0
1453, 1, 1636427227585, 1636427228033, 448, 0, 448, 0, 0, 0
1454, 1, 1636427227677, 1636427228185, 508, 60, 448, 60, 0, 60
1456, 1, 1636427227912, 1636427228361, 449, 0, 449, 0, 0, 0
1455, 1, 1636427227836, 1636427228492, 656, 198, 458, 197, 1, 198
1457, 1, 1636427228333, 1636427228785, 452, 0, 452, 0, 0, 0
1458, 1, 1636427228453, 1636427228905, 452, 0, 452, 0, 0, 0
1459, 1, 1636427228632, 1636427229085, 453, 1, 452, 0, 0, 0
1460, 1, 1636427228653, 1636427229105, 452, 0, 452, 0, 0, 0
1461, 1, 1636427228705, 1636427229148, 443, 0, 443, 0, 0, 0
1462, 1, 1636427229781, 1636427230233, 452, 0, 452, 0, 0, 0
1463, 1, 1636427230145, 1636427230588, 443, 0, 443, 0, 0, 0
1464, 1, 1636427230184, 1636427230636, 452, 1, 451, 1, 0, 1
1465, 1, 1636427230204, 1636427230657, 453, 1, 452, 0, 1, 1
1466, 1, 1636427230329, 1636427230784, 455, 0, 455, 0, 0, 0
1467, 1, 1636427230408, 1636427231092, 684, 229, 455, 229, 0, 229
1468, 1, 1636427230992, 1636427231448, 456, 0, 456, 0, 0, 0
1469, 1, 1636427231036, 1636427231492, 456, 1, 455, 0, 0, 0
1471, 1, 1636427231072, 1636427231521, 449, 0, 449, 0, 0, 0
1470, 1, 1636427231069, 1636427231521, 452, 0, 452, 0, 0, 0
1473, 1, 1636427231436, 1636427231885, 449, 0, 449, 0, 0, 0
1472, 1, 1636427231380, 1636427231901, 521, 69, 452, 69, 0, 69
1474, 1, 1636427231468, 1636427231921, 453, 1, 452, 0, 0, 0
1476, 1, 1636427231849, 1636427232301, 452, 0, 452, 0, 0, 0
1475, 1, 1636427231821, 1636427232373, 552, 100, 452, 100, 0, 100
1477, 1, 1636427232441, 1636427232893, 452, 0, 452, 0, 0, 0
1478, 1, 1636427232460, 1636427232913, 453, 1, 452, 0, 0, 0
1479, 1, 1636427232476, 1636427232929, 453, 1, 452, 0, 0, 0
1480, 1, 1636427232521, 1636427232969, 448, 0, 448, 0, 0, 0
1481, 1, 1636427232664, 1636427233113, 449, 0, 449, 0, 0, 0
1482, 1, 1636427233960, 1636427234416, 456, 0, 456, 0, 0, 0
1483, 1, 1636427233988, 1636427234428, 440, 1, 439, 0, 1, 1
1484, 1, 1636427234040, 1636427234484, 444, 1, 443, 0, 1, 1
1485, 1, 1636427234128, 1636427234576, 448, 0, 448, 0, 0, 0
1487, 1, 1636427234340, 1636427234789, 449, 1, 448, 0, 0, 0
1486, 1, 1636427234140, 1636427234864, 724, 277, 447, 277, 0, 277
1488, 1, 1636427234776, 1636427235224, 448, 0, 448, 0, 0, 0
1489, 1, 1636427234820, 1636427235268, 448, 1, 447, 1, 0, 1
1490, 1, 1636427235052, 1636427235509, 457, 0, 457, 0, 0, 0
1491, 1, 1636427235180, 1636427235633, 453, 0, 453, 0, 0, 0
1492, 1, 1636427235212, 1636427235664, 452, 0, 452, 0, 0, 0
1493, 1, 1636427235312, 1636427235765, 453, 0, 453, 0, 0, 0
1494, 1, 1636427235684, 1636427236145, 461, 1, 460, 1, 0, 1
1495, 1, 1636427235717, 1636427236220, 503, 48, 455, 48, 0, 48
1496, 1, 1636427235993, 1636427236440, 447, 0, 447, 0, 0, 0
1497, 1, 1636427236137, 1636427236585, 448, 0, 448, 0, 0, 0
1498, 1, 1636427236272, 1636427236721, 449, 1, 448, 1, 0, 1
1499, 1, 1636427236300, 1636427236744, 444, 0, 444, 0, 0, 0
1500, 1, 1636427236344, 1636427236789, 445, 1, 444, 0, 0, 0
1501, 1, 1636427236549, 1636427236997, 448, 0, 448, 0, 0, 0
1502, 1, 1636427237732, 1636427238181, 449, 1, 448, 0, 0, 0
1503, 1, 1636427237824, 1636427238276, 452, 1, 451, 0, 0, 0
1504, 1, 1636427237952, 1636427238397, 445, 0, 445, 0, 0, 0
1505, 1, 1636427238041, 1636427238485, 444, 0, 444, 0, 0, 0
1506, 1, 1636427238057, 1636427238728, 671, 220, 451, 220, 0, 220
1507, 1, 1636427238453, 1636427238901, 448, 0, 448, 0, 0, 0
1508, 1, 1636427238649, 1636427239105, 456, 0, 456, 0, 0, 0
1509, 1, 1636427238765, 1636427239225, 460, 0, 460, 0, 0, 0
1510, 1, 1636427238788, 1636427239237, 449, 1, 448, 0, 0, 0
1511, 1, 1636427239033, 1636427239481, 448, 0, 448, 0, 0, 0
1512, 1, 1636427239072, 1636427239529, 457, 1, 456, 1, 0, 1
1513, 1, 1636427239276, 1636427239732, 456, 1, 455, 0, 0, 0
1514, 1, 1636427239397, 1636427239848, 451, 0, 451, 0, 0, 0
1515, 1, 1636427239473, 1636427240180, 707, 260, 447, 260, 0, 260
1516, 1, 1636427239837, 1636427240289, 452, 0, 452, 0, 0, 0
1517, 1, 1636427239964, 1636427240413, 449, 0, 449, 0, 0, 0
1518, 1, 1636427240145, 1636427240601, 456, 0, 456, 0, 0, 0
1519, 1, 1636427240145, 1636427240636, 491, 36, 455, 36, 0, 36
1520, 1, 1636427240592, 1636427241044, 452, 0, 452, 0, 0, 0
1521, 1, 1636427240817, 1636427241269, 452, 0, 452, 0, 0, 0
1522, 1, 1636427241849, 1636427242300, 451, 0, 451, 0, 0, 0
1523, 1, 1636427241852, 1636427242305, 453, 1, 452, 1, 0, 1
1524, 1, 1636427241984, 1636427242440, 456, 0, 456, 0, 0, 0
1526, 1, 1636427242181, 1636427242633, 452, 0, 452, 0, 0, 0
1527, 1, 1636427242188, 1636427242637, 449, 0, 449, 0, 0, 0
1525, 1, 1636427242181, 1636427242752, 571, 120, 451, 120, 0, 120
1528, 1, 1636427242657, 1636427243109, 452, 0, 452, 0, 0, 0
1529, 1, 1636427242852, 1636427243309, 457, 0, 457, 0, 0, 0
1530, 1, 1636427242896, 1636427243349, 453, 1, 452, 0, 0, 0
1531, 1, 1636427243068, 1636427243517, 449, 1, 448, 0, 0, 0
1532, 1, 1636427243101, 1636427243553, 452, 0, 452, 0, 0, 0
1533, 1, 1636427243245, 1636427243689, 444, 0, 444, 0, 0, 0
1535, 1, 1636427243673, 1636427244124, 451, 0, 451, 0, 0, 0
1536, 1, 1636427243700, 1636427244149, 449, 0, 449, 0, 0, 0
1534, 1, 1636427243273, 1636427244149, 876, 416, 460, 416, 0, 416
1538, 1, 1636427243940, 1636427244393, 453, 1, 452, 0, 0, 0
1537, 1, 1636427243869, 1636427244601, 732, 281, 451, 281, 0, 281
1539, 1, 1636427244181, 1636427244633, 452, 0, 452, 0, 0, 0
1540, 1, 1636427244369, 1636427244821, 452, 0, 452, 0, 0, 0
1541, 1, 1636427245073, 1636427245529, 456, 0, 456, 0, 0, 0
1542, 1, 1636427245657, 1636427246108, 451, 0, 451, 0, 0, 0
1543, 1, 1636427245905, 1636427246352, 447, 0, 447, 0, 0, 0
1544, 1, 1636427246176, 1636427246629, 453, 1, 452, 0, 0, 0
1545, 1, 1636427246244, 1636427246697, 453, 1, 452, 0, 0, 0
1546, 1, 1636427246324, 1636427246773, 449, 0, 449, 0, 0, 0
1547, 1, 1636427246509, 1636427246961, 452, 0, 452, 0, 0, 0
1548, 1, 1636427246589, 1636427247041, 452, 0, 452, 0, 0, 0
1549, 1, 1636427246961, 1636427247405, 444, 0, 444, 0, 0, 0
1550, 1, 1636427247000, 1636427247449, 449, 0, 449, 0, 0, 0
1551, 1, 1636427247061, 1636427247517, 456, 0, 456, 0, 0, 0
1552, 1, 1636427247305, 1636427247757, 452, 0, 452, 0, 0, 0
1554, 1, 1636427247365, 1636427247809, 444, 0, 444, 0, 0, 0
1555, 1, 1636427247628, 1636427248080, 452, 1, 451, 0, 0, 0
1553, 1, 1636427247317, 1636427248220, 903, 441, 462, 441, 0, 441
1556, 1, 1636427247804, 1636427248256, 452, 1, 451, 0, 1, 1
1557, 1, 1636427247969, 1636427248420, 451, 0, 451, 0, 0, 0
1559, 1, 1636427248141, 1636427248588, 447, 0, 447, 0, 0, 0
1558, 1, 1636427248056, 1636427248669, 613, 165, 448, 165, 0, 165
1560, 1, 1636427248256, 1636427248709, 453, 0, 453, 0, 0, 0
1561, 1, 1636427248757, 1636427249209, 452, 0, 452, 0, 0, 0
1562, 1, 1636427249757, 1636427250217, 460, 0, 460, 0, 0, 0
1563, 1, 1636427249932, 1636427250381, 449, 1, 448, 0, 1, 1
1564, 1, 1636427249976, 1636427250429, 453, 1, 452, 0, 0, 0
1565, 1, 1636427250237, 1636427250881, 644, 192, 452, 192, 0, 192
1566, 1, 1636427250472, 1636427250928, 456, 1, 455, 0, 1, 1
1567, 1, 1636427250601, 1636427251053, 452, 0, 452, 0, 0, 0
1568, 1, 1636427250689, 1636427251136, 447, 0, 447, 0, 0, 0
1569, 1, 1636427251093, 1636427251545, 452, 0, 452, 0, 0, 0
1570, 1, 1636427251153, 1636427251609, 456, 0, 456, 0, 0, 0
1572, 1, 1636427251193, 1636427251641, 448, 0, 448, 0, 0, 0
1573, 1, 1636427251257, 1636427251709, 452, 0, 452, 0, 0, 0
1574, 1, 1636427251265, 1636427251716, 451, 0, 451, 0, 0, 0
1571, 1, 1636427251164, 1636427251997, 833, 382, 451, 381, 1, 382
1575, 1, 1636427251617, 1636427252060, 443, 0, 443, 0, 0, 0
1576, 1, 1636427251637, 1636427252088, 451, 0, 451, 0, 0, 0
1577, 1, 1636427251801, 1636427252248, 447, 0, 447, 0, 0, 0
1578, 1, 1636427252032, 1636427252489, 457, 0, 457, 0, 0, 0
1579, 1, 1636427252425, 1636427252877, 452, 0, 452, 0, 0, 0
1580, 1, 1636427252461, 1636427252913, 452, 0, 452, 0, 0, 0
1581, 1, 1636427252637, 1636427253089, 452, 0, 452, 0, 0, 0
1582, 1, 1636427253457, 1636427253909, 452, 0, 452, 0, 0, 0
1583, 1, 1636427253808, 1636427254256, 448, 1, 447, 0, 0, 0
1584, 1, 1636427253925, 1636427254377, 452, 0, 452, 0, 0, 0
1586, 1, 1636427254300, 1636427254748, 448, 1, 447, 0, 1, 1
1585, 1, 1636427254125, 1636427254832, 707, 253, 454, 252, 0, 252
1587, 1, 1636427254601, 1636427255053, 452, 0, 452, 0, 0, 0
1588, 1, 1636427254725, 1636427255172, 447, 0, 447, 0, 0, 0
1589, 1, 1636427254788, 1636427255240, 452, 1, 451, 0, 0, 0
1590, 1, 1636427254977, 1636427255428, 451, 0, 451, 0, 0, 0
1591, 1, 1636427255080, 1636427255541, 461, 1, 460, 0, 0, 0
1593, 1, 1636427255216, 1636427255669, 453, 1, 452, 0, 1, 1
1594, 1, 1636427255237, 1636427255689, 452, 0, 452, 0, 0, 0
1592, 1, 1636427255093, 1636427255697, 604, 148, 456, 148, 0, 148
1595, 1, 1636427255433, 1636427255893, 460, 0, 460, 0, 0, 0
1596, 1, 1636427255633, 1636427256084, 451, 0, 451, 0, 0, 0
1597, 1, 1636427255728, 1636427256177, 449, 0, 449, 0, 0, 0
1598, 1, 1636427256101, 1636427256549, 448, 0, 448, 0, 0, 0
1599, 1, 1636427256417, 1636427256877, 460, 0, 460, 0, 0, 0
1600, 1, 1636427256497, 1636427256945, 448, 0, 448, 0, 0, 0
1601, 1, 1636427256581, 1636427257029, 448, 0, 448, 0, 0, 0
1602, 1, 1636427257516, 1636427257969, 453, 1, 452, 0, 0, 0
1603, 1, 1636427257729, 1636427258181, 452, 0, 452, 0, 0, 0
1604, 1, 1636427257977, 1636427258429, 452, 0, 452, 0, 0, 0
1605, 1, 1636427258136, 1636427258885, 749, 293, 456, 293, 0, 293
1606, 1, 1636427258505, 1636427258957, 452, 0, 452, 0, 0, 0
1607, 1, 1636427258613, 1636427259065, 452, 0, 452, 0, 0, 0
1608, 1, 1636427258621, 1636427259072, 451, 0, 451, 0, 0, 0
1609, 1, 1636427259044, 1636427259513, 469, 21, 448, 20, 0, 20
1610, 1, 1636427259065, 1636427259517, 452, 0, 452, 0, 0, 0
1611, 1, 1636427259248, 1636427259701, 453, 0, 453, 0, 0, 0
1612, 1, 1636427259272, 1636427259729, 457, 0, 457, 0, 0, 0
1614, 1, 1636427259417, 1636427259873, 456, 0, 456, 0, 0, 0
1613, 1, 1636427259405, 1636427259973, 568, 112, 456, 112, 0, 112
1615, 1, 1636427259528, 1636427259976, 448, 1, 447, 0, 0, 0
1616, 1, 1636427259661, 1636427260104, 443, 0, 443, 0, 0, 0
1617, 1, 1636427259885, 1636427260425, 540, 88, 452, 88, 0, 88
1618, 1, 1636427260137, 1636427260592, 455, 0, 455, 0, 0, 0
1619, 1, 1636427260285, 1636427260740, 455, 0, 455, 0, 0, 0
1620, 1, 1636427260629, 1636427261081, 452, 0, 452, 0, 0, 0
1621, 1, 1636427260744, 1636427261197, 453, 1, 452, 1, 0, 1
1622, 1, 1636427261221, 1636427261673, 452, 0, 452, 0, 0, 0
1623, 1, 1636427261693, 1636427262145, 452, 0, 452, 0, 0, 0
1624, 1, 1636427262265, 1636427262717, 452, 0, 452, 0, 0, 0
1626, 1, 1636427262457, 1636427262904, 447, 0, 447, 0, 0, 0
1627, 1, 1636427262497, 1636427262945, 448, 0, 448, 0, 0, 0
1625, 1, 1636427262349, 1636427263173, 824, 368, 456, 368, 0, 368
1628, 1, 1636427262748, 1636427263197, 449, 0, 449, 0, 0, 0
1629, 1, 1636427262829, 1636427263281, 452, 0, 452, 0, 0, 0
1630, 1, 1636427262925, 1636427263396, 471, 20, 451, 20, 0, 20
1631, 1, 1636427263104, 1636427263552, 448, 1, 447, 1, 0, 1
1632, 1, 1636427263124, 1636427263733, 609, 156, 453, 156, 0, 156
1633, 1, 1636427263352, 1636427263797, 445, 1, 444, 0, 0, 0
1634, 1, 1636427263373, 1636427263821, 448, 0, 448, 0, 0, 0
1635, 1, 1636427263521, 1636427263969, 448, 0, 448, 0, 0, 0
1636, 1, 1636427263600, 1636427264049, 449, 1, 448, 0, 0, 0
1637, 1, 1636427263620, 1636427264177, 557, 113, 444, 113, 0, 113
1638, 1, 1636427263964, 1636427264421, 457, 0, 457, 0, 0, 0
1639, 1, 1636427264196, 1636427264653, 457, 1, 456, 1, 0, 1
1640, 1, 1636427264625, 1636427265077, 452, 0, 452, 0, 0, 0
1641, 1, 1636427264737, 1636427265193, 456, 0, 456, 0, 0, 0
1642, 1, 1636427265133, 1636427265585, 452, 0, 452, 0, 0, 0
1643, 1, 1636427265441, 1636427265897, 456, 0, 456, 0, 0, 0
1644, 1, 1636427266241, 1636427266689, 448, 0, 448, 0, 0, 0
1645, 1, 1636427266260, 1636427266717, 457, 0, 457, 0, 0, 0
1647, 1, 1636427266573, 1636427267024, 451, 0, 451, 0, 0, 0
1646, 1, 1636427266304, 1636427267144, 840, 385, 455, 385, 0, 385
1648, 1, 1636427266728, 1636427267177, 449, 1, 448, 0, 0, 0
1649, 1, 1636427266744, 1636427267197, 453, 1, 452, 0, 0, 0
1650, 1, 1636427266980, 1636427267429, 449, 0, 449, 0, 0, 0
1651, 1, 1636427267100, 1636427267548, 448, 1, 447, 0, 0, 0
1652, 1, 1636427267188, 1636427267640, 452, 1, 451, 0, 0, 0
1653, 1, 1636427267297, 1636427267745, 448, 0, 448, 0, 0, 0
1654, 1, 1636427267332, 1636427267780, 448, 1, 447, 0, 0, 0
1655, 1, 1636427267344, 1636427267801, 457, 0, 457, 0, 0, 0
1656, 1, 1636427267505, 1636427267953, 448, 0, 448, 0, 0, 0
1657, 1, 1636427267592, 1636427268041, 449, 1, 448, 0, 0, 0
1658, 1, 1636427267824, 1636427268277, 453, 1, 452, 0, 0, 0
1659, 1, 1636427268284, 1636427268733, 449, 1, 448, 0, 0, 0
1660, 1, 1636427268293, 1636427268736, 443, 0, 443, 0, 0, 0
1661, 1, 1636427268553, 1636427269005, 452, 0, 452, 0, 0, 0
1662, 1, 1636427269220, 1636427269673, 453, 1, 452, 0, 0, 0
1663, 1, 1636427269225, 1636427269677, 452, 0, 452, 0, 0, 0
1664, 1, 1636427269929, 1636427270381, 452, 0, 452, 0, 0, 0
1666, 1, 1636427270212, 1636427270660, 448, 1, 447, 0, 0, 0
1667, 1, 1636427270352, 1636427270805, 453, 1, 452, 0, 0, 0
1665, 1, 1636427270084, 1636427270837, 753, 298, 455, 297, 1, 298
1668, 1, 1636427270601, 1636427271049, 448, 0, 448, 0, 0, 0
1669, 1, 1636427270824, 1636427271281, 457, 1, 456, 0, 1, 1
1670, 1, 1636427270925, 1636427271376, 451, 0, 451, 0, 0, 0
1671, 1, 1636427271056, 1636427271505, 449, 1, 448, 0, 0, 0
1672, 1, 1636427271073, 1636427271529, 456, 0, 456, 0, 0, 0
1673, 1, 1636427271120, 1636427271569, 449, 1, 448, 0, 0, 0
1674, 1, 1636427271172, 1636427271625, 453, 1, 452, 0, 0, 0
1675, 1, 1636427271296, 1636427271745, 449, 1, 448, 0, 0, 0
1676, 1, 1636427271420, 1636427271869, 449, 0, 449, 0, 0, 0
1677, 1, 1636427271601, 1636427272045, 444, 0, 444, 0, 0, 0
1678, 1, 1636427272132, 1636427272580, 448, 0, 448, 0, 0, 0
1679, 1, 1636427272149, 1636427272597, 448, 0, 448, 0, 0, 0
1680, 1, 1636427272173, 1636427272621, 448, 0, 448, 0, 0, 0
1681, 1, 1636427272345, 1636427272797, 452, 0, 452, 0, 0, 0
1682, 1, 1636427273061, 1636427273513, 452, 0, 452, 0, 0, 0
1683, 1, 1636427273433, 1636427273885, 452, 0, 452, 0, 0, 0
1684, 1, 1636427274169, 1636427274621, 452, 0, 452, 0, 0, 0
1686, 1, 1636427274285, 1636427274741, 456, 0, 456, 0, 0, 0
1687, 1, 1636427274561, 1636427275008, 447, 0, 447, 0, 0, 0
1685, 1, 1636427274257, 1636427275072, 815, 364, 451, 364, 0, 364
1688, 1, 1636427274753, 1636427275200, 447, 0, 447, 0, 0, 0
1689, 1, 1636427274856, 1636427275313, 457, 0, 457, 0, 0, 0
1690, 1, 1636427275088, 1636427275540, 452, 0, 452, 0, 0, 0
1691, 1, 1636427275100, 1636427275557, 457, 0, 457, 0, 0, 0
1692, 1, 1636427275132, 1636427275585, 453, 0, 453, 0, 0, 0
1693, 1, 1636427275192, 1636427275641, 449, 0, 449, 0, 0, 0
1694, 1, 1636427275192, 1636427275644, 452, 0, 452, 0, 0, 0
1695, 1, 1636427275340, 1636427275793, 453, 1, 452, 0, 0, 0
1696, 1, 1636427275644, 1636427276096, 452, 1, 451, 1, 0, 1
1697, 1, 1636427275668, 1636427276125, 457, 0, 457, 0, 0, 0
1698, 1, 1636427276112, 1636427276565, 453, 0, 453, 0, 0, 0
1699, 1, 1636427276133, 1636427276581, 448, 0, 448, 0, 0, 0
1700, 1, 1636427276273, 1636427276721, 448, 0, 448, 0, 0, 0
1701, 1, 1636427276589, 1636427277041, 452, 0, 452, 0, 0, 0
1702, 1, 1636427277209, 1636427277665, 456, 0, 456, 0, 0, 0
1703, 1, 1636427277577, 1636427278028, 451, 0, 451, 0, 0, 0
1704, 1, 1636427277973, 1636427278429, 456, 0, 456, 0, 0, 0
1706, 1, 1636427278141, 1636427278593, 452, 0, 452, 0, 0, 0
1705, 1, 1636427278072, 1636427278885, 813, 358, 455, 357, 0, 357
1707, 1, 1636427278868, 1636427279312, 444, 1, 443, 0, 0, 0
1708, 1, 1636427278885, 1636427279336, 451, 0, 451, 0, 0, 0
1709, 1, 1636427279004, 1636427279449, 445, 1, 444, 0, 0, 0
1710, 1, 1636427279085, 1636427279533, 448, 0, 448, 0, 0, 0
1711, 1, 1636427279096, 1636427279536, 440, 1, 439, 1, 0, 1
1712, 1, 1636427279112, 1636427279569, 457, 0, 457, 0, 0, 0
1713, 1, 1636427279156, 1636427279609, 453, 1, 452, 0, 0, 0
1714, 1, 1636427279281, 1636427279769, 488, 32, 456, 32, 0, 32
1715, 1, 1636427279597, 1636427280044, 447, 0, 447, 0, 0, 0
1716, 1, 1636427279620, 1636427280064, 444, 1, 443, 0, 1, 1
1717, 1, 1636427279785, 1636427280237, 452, 0, 452, 0, 0, 0
1718, 1, 1636427279824, 1636427280272, 448, 1, 447, 0, 0, 0
1719, 1, 1636427280164, 1636427280617, 453, 0, 453, 0, 0, 0
1720, 1, 1636427280316, 1636427280765, 449, 1, 448, 0, 0, 0
1721, 1, 1636427280537, 1636427280993, 456, 0, 456, 0, 0, 0
1722, 1, 1636427281329, 1636427281785, 456, 0, 456, 0, 0, 0
1723, 1, 1636427281797, 1636427282244, 447, 0, 447, 0, 0, 0
1724, 1, 1636427281837, 1636427282289, 452, 0, 452, 0, 0, 0
1725, 1, 1636427282113, 1636427282565, 452, 0, 452, 0, 0, 0
1726, 1, 1636427282160, 1636427283020, 860, 406, 454, 405, 0, 405
1727, 1, 1636427282801, 1636427283253, 452, 0, 452, 0, 0, 0
1728, 1, 1636427282893, 1636427283345, 452, 0, 452, 0, 0, 0
1729, 1, 1636427283017, 1636427283472, 455, 0, 455, 0, 0, 0
1730, 1, 1636427283173, 1636427283629, 456, 0, 456, 0, 0, 0
1731, 1, 1636427283316, 1636427283764, 448, 1, 447, 0, 0, 0
1732, 1, 1636427283328, 1636427283781, 453, 1, 452, 0, 0, 0
1733, 1, 1636427283365, 1636427283808, 443, 0, 443, 0, 0, 0
1734, 1, 1636427283408, 1636427283852, 444, 1, 443, 0, 0, 0
1735, 1, 1636427283485, 1636427283933, 448, 0, 448, 0, 0, 0
1736, 1, 1636427283532, 1636427283976, 444, 1, 443, 0, 0, 0
1737, 1, 1636427283729, 1636427284237, 508, 52, 456, 52, 0, 52
1738, 1, 1636427283892, 1636427284340, 448, 0, 448, 0, 0, 0
1739, 1, 1636427283936, 1636427284384, 448, 0, 448, 0, 0, 0
1740, 1, 1636427284541, 1636427284993, 452, 0, 452, 0, 0, 0
1741, 1, 1636427284729, 1636427285181, 452, 0, 452, 0, 0, 0
1742, 1, 1636427285497, 1636427285952, 455, 0, 455, 0, 0, 0
1743, 1, 1636427285729, 1636427286184, 455, 0, 455, 0, 0, 0
1744, 1, 1636427285996, 1636427286449, 453, 1, 452, 0, 0, 0
1746, 1, 1636427286113, 1636427286565, 452, 0, 452, 0, 0, 0
1745, 1, 1636427286097, 1636427286913, 816, 352, 464, 352, 0, 352
1747, 1, 1636427286709, 1636427287161, 452, 0, 452, 0, 0, 0
1748, 1, 1636427286845, 1636427287297, 452, 0, 452, 0, 0, 0
1749, 1, 1636427286928, 1636427287372, 444, 1, 443, 0, 1, 1
1750, 1, 1636427286965, 1636427287416, 451, 0, 451, 0, 0, 0
1751, 1, 1636427287045, 1636427287497, 452, 0, 452, 0, 0, 0
1752, 1, 1636427287149, 1636427287601, 452, 0, 452, 0, 0, 0
1753, 1, 1636427287241, 1636427287696, 455, 0, 455, 0, 0, 0
1754, 1, 1636427287420, 1636427287872, 452, 1, 451, 0, 1, 1
1755, 1, 1636427287480, 1636427287933, 453, 1, 452, 1, 0, 1
1756, 1, 1636427287653, 1636427288105, 452, 0, 452, 0, 0, 0
1758, 1, 1636427287872, 1636427288325, 453, 1, 452, 1, 0, 1
1759, 1, 1636427287941, 1636427288393, 452, 0, 452, 0, 0, 0
1757, 1, 1636427287729, 1636427288561, 832, 377, 455, 377, 0, 377
1760, 1, 1636427288713, 1636427289169, 456, 0, 456, 0, 0, 0
1761, 1, 1636427288825, 1636427289281, 456, 0, 456, 0, 0, 0
1763, 1, 1636427289797, 1636427290240, 443, 0, 443, 0, 0, 0
1762, 1, 1636427289789, 1636427290240, 451, 0, 451, 0, 0, 0
1764, 1, 1636427289873, 1636427290321, 448, 0, 448, 0, 0, 0
1765, 1, 1636427290105, 1636427290556, 451, 0, 451, 0, 0, 0
1767, 1, 1636427290417, 1636427290864, 447, 0, 447, 0, 0, 0
1766, 1, 1636427290281, 1636427291005, 724, 276, 448, 276, 0, 276
1768, 1, 1636427290817, 1636427291264, 447, 0, 447, 0, 0, 0
1769, 1, 1636427290908, 1636427291356, 448, 1, 447, 1, 0, 1
1770, 1, 1636427291097, 1636427291549, 452, 0, 452, 0, 0, 0
1771, 1, 1636427291180, 1636427291636, 456, 1, 455, 0, 0, 0
1772, 1, 1636427291208, 1636427291661, 453, 1, 452, 0, 0, 0
1773, 1, 1636427291208, 1636427291661, 453, 1, 452, 1, 0, 1
1774, 1, 1636427291364, 1636427291821, 457, 0, 457, 0, 0, 0
1775, 1, 1636427291436, 1636427291884, 448, 0, 448, 0, 0, 0
1776, 1, 1636427291484, 1636427291928, 444, 1, 443, 0, 0, 0
1777, 1, 1636427291616, 1636427292272, 656, 206, 450, 205, 0, 205
1778, 1, 1636427291940, 1636427292397, 457, 0, 457, 0, 0, 0
1779, 1, 1636427292045, 1636427292497, 452, 0, 452, 0, 0, 0
1781, 1, 1636427293005, 1636427293452, 447, 0, 447, 0, 0, 0
1780, 1, 1636427293001, 1636427293452, 451, 0, 451, 0, 0, 0
1782, 1, 1636427293745, 1636427294196, 451, 0, 451, 0, 0, 0
1783, 1, 1636427293857, 1636427294305, 448, 0, 448, 0, 0, 0
1784, 1, 1636427293965, 1636427294424, 459, 0, 459, 0, 0, 0
1785, 1, 1636427294372, 1636427294825, 453, 1, 452, 0, 0, 0
1786, 1, 1636427294396, 1636427294841, 445, 1, 444, 1, 0, 1
1787, 1, 1636427294573, 1636427295021, 448, 0, 448, 0, 0, 0
1788, 1, 1636427294573, 1636427295288, 715, 268, 447, 268, 0, 268
1789, 1, 1636427294856, 1636427295304, 448, 1, 447, 0, 0, 0
1790, 1, 1636427294888, 1636427295336, 448, 1, 447, 1, 0, 1
1791, 1, 1636427294936, 1636427295385, 449, 0, 449, 0, 0, 0
1792, 1, 1636427295205, 1636427295661, 456, 0, 456, 0, 0, 0
1793, 1, 1636427295213, 1636427295757, 544, 92, 452, 92, 0, 92
1794, 1, 1636427295425, 1636427295876, 451, 0, 451, 0, 0, 0
1795, 1, 1636427295537, 1636427295988, 451, 0, 451, 0, 0, 0
1796, 1, 1636427295729, 1636427296181, 452, 0, 452, 0, 0, 0
1798, 1, 1636427295829, 1636427296272, 443, 0, 443, 0, 0, 0
1797, 1, 1636427295821, 1636427296329, 508, 56, 452, 56, 0, 56
1799, 1, 1636427296020, 1636427296473, 453, 1, 452, 0, 0, 0
1800, 1, 1636427297237, 1636427297684, 447, 0, 447, 0, 0, 0
1801, 1, 1636427297301, 1636427297748, 447, 0, 447, 0, 0, 0
1802, 1, 1636427297684, 1636427298137, 453, 0, 453, 0, 0, 0
1803, 1, 1636427297961, 1636427298401, 440, 0, 440, 0, 0, 0
1804, 1, 1636427298144, 1636427298593, 449, 1, 448, 0, 1, 1
1805, 1, 1636427298156, 1636427298617, 461, 1, 460, 0, 0, 0
1807, 1, 1636427298309, 1636427298757, 448, 0, 448, 0, 0, 0
1808, 1, 1636427298400, 1636427298849, 449, 1, 448, 0, 0, 0
1806, 1, 1636427298288, 1636427299073, 785, 329, 456, 329, 0, 329
1809, 1, 1636427298628, 1636427299073, 445, 1, 444, 0, 0, 0
1810, 1, 1636427298832, 1636427299280, 448, 1, 447, 0, 0, 0
1811, 1, 1636427298924, 1636427299368, 444, 1, 443, 0, 0, 0
1812, 1, 1636427299088, 1636427299541, 453, 0, 453, 0, 0, 0
1813, 1, 1636427299136, 1636427299584, 448, 0, 448, 0, 0, 0
1814, 1, 1636427299408, 1636427299989, 581, 133, 448, 133, 0, 133
1815, 1, 1636427299520, 1636427300032, 512, 65, 447, 64, 0, 64
1816, 1, 1636427299613, 1636427300064, 451, 0, 451, 0, 0, 0
1817, 1, 1636427299768, 1636427300224, 456, 0, 456, 0, 0, 0
1818, 1, 1636427299812, 1636427300261, 449, 0, 449, 0, 0, 0
1819, 1, 1636427300060, 1636427300513, 453, 1, 452, 0, 1, 1
1820, 1, 1636427300993, 1636427301445, 452, 0, 452, 0, 0, 0
1821, 1, 1636427301828, 1636427302277, 449, 1, 448, 0, 1, 1
1822, 1, 1636427301889, 1636427302337, 448, 0, 448, 0, 0, 0
1823, 1, 1636427302013, 1636427302465, 452, 0, 452, 0, 0, 0
1825, 1, 1636427302361, 1636427302804, 443, 0, 443, 0, 0, 0
1824, 1, 1636427302045, 1636427302925, 880, 420, 460, 420, 0, 420
1826, 1, 1636427302592, 1636427303045, 453, 0, 453, 0, 0, 0
1827, 1, 1636427302612, 1636427303061, 449, 1, 448, 0, 0, 0
1828, 1, 1636427302705, 1636427303153, 448, 0, 448, 0, 0, 0
1830, 1, 1636427302973, 1636427303424, 451, 0, 451, 0, 0, 0
1829, 1, 1636427302869, 1636427303501, 632, 176, 456, 176, 0, 176
1832, 1, 1636427303417, 1636427303869, 452, 0, 452, 0, 0, 0
1831, 1, 1636427303281, 1636427303877, 596, 144, 452, 144, 0, 144
1833, 1, 1636427303468, 1636427303920, 452, 1, 451, 1, 0, 1
1835, 1, 1636427303736, 1636427304188, 452, 1, 451, 1, 0, 1
1834, 1, 1636427303556, 1636427304317, 761, 313, 448, 313, 0, 313
1836, 1, 1636427303888, 1636427304337, 449, 0, 449, 0, 0, 0
1837, 1, 1636427303932, 1636427304388, 456, 1, 455, 0, 0, 0
1838, 1, 1636427304849, 1636427305301, 452, 0, 452, 0, 0, 0
1839, 1, 1636427305720, 1636427306169, 449, 0, 449, 0, 0, 0
1841, 1, 1636427306080, 1636427306528, 448, 1, 447, 0, 0, 0
1840, 1, 1636427306020, 1636427306621, 601, 149, 452, 148, 0, 148
1842, 1, 1636427306196, 1636427306644, 448, 0, 448, 0, 0, 0
1843, 1, 1636427306312, 1636427306765, 453, 0, 453, 0, 0, 0
1844, 1, 1636427306504, 1636427306945, 441, 1, 440, 0, 0, 0
1845, 1, 1636427306601, 1636427307049, 448, 0, 448, 0, 0, 0
1847, 1, 1636427306688, 1636427307132, 444, 1, 443, 0, 1, 1
1846, 1, 1636427306633, 1636427307220, 587, 133, 454, 132, 0, 132
1848, 1, 1636427307176, 1636427307629, 453, 0, 453, 0, 0, 0
1849, 1, 1636427307240, 1636427307697, 457, 1, 456, 0, 0, 0
1850, 1, 1636427307465, 1636427307916, 451, 0, 451, 0, 0, 0
1851, 1, 1636427307593, 1636427308149, 556, 104, 452, 104, 0, 104
1853, 1, 1636427307785, 1636427308233, 448, 0, 448, 0, 0, 0
1852, 1, 1636427307620, 1636427308369, 749, 297, 452, 296, 0, 296
1854, 1, 1636427308204, 1636427308653, 449, 1, 448, 1, 0, 1
1855, 1, 1636427308556, 1636427309013, 457, 1, 456, 0, 0, 0
1856, 1, 1636427309897, 1636427310336, 439, 0, 439, 0, 0, 0
1857, 1, 1636427310029, 1636427310784, 755, 308, 447, 307, 0, 307
1858, 1, 1636427310344, 1636427310797, 453, 0, 453, 0, 0, 0
1859, 1, 1636427310372, 1636427310821, 449, 1, 448, 0, 0, 0
1860, 1, 1636427310380, 1636427310829, 449, 0, 449, 0, 0, 0
1861, 1, 1636427310533, 1636427310981, 448, 0, 448, 0, 0, 0
1862, 1, 1636427310588, 1636427311037, 449, 1, 448, 1, 0, 1
1864, 1, 1636427310717, 1636427311173, 456, 0, 456, 0, 0, 0
1863, 1, 1636427310672, 1636427311437, 765, 310, 455, 309, 0, 309
1865, 1, 1636427311276, 1636427311733, 457, 1, 456, 0, 0, 0
1866, 1, 1636427311465, 1636427311909, 444, 0, 444, 0, 0, 0
1867, 1, 1636427311501, 1636427311952, 451, 0, 451, 0, 0, 0
1868, 1, 1636427311568, 1636427312185, 617, 165, 452, 165, 0, 165
1870, 1, 1636427311905, 1636427312357, 452, 0, 452, 0, 0, 0
1869, 1, 1636427311748, 1636427312405, 657, 205, 452, 205, 0, 205
1871, 1, 1636427312457, 1636427312905, 448, 0, 448, 0, 0, 0
1872, 1, 1636427312849, 1636427313301, 452, 0, 452, 0, 0, 0
1873, 1, 1636427313833, 1636427314284, 451, 0, 451, 0, 0, 0
1875, 1, 1636427314053, 1636427314505, 452, 0, 452, 0, 0, 0
1876, 1, 1636427314169, 1636427314616, 447, 0, 447, 0, 0, 0
1874, 1, 1636427313941, 1636427314736, 795, 344, 451, 344, 0, 344
1877, 1, 1636427314440, 1636427314897, 457, 1, 456, 0, 0, 0
1878, 1, 1636427314581, 1636427315024, 443, 0, 443, 0, 0, 0
1880, 1, 1636427314704, 1636427315152, 448, 1, 447, 0, 0, 0
1879, 1, 1636427314701, 1636427315152, 451, 0, 451, 0, 0, 0
1881, 1, 1636427314756, 1636427315481, 725, 269, 456, 269, 0, 269
1882, 1, 1636427315181, 1636427315637, 456, 0, 456, 0, 0, 0
1883, 1, 1636427315196, 1636427315649, 453, 1, 452, 0, 1, 1
1885, 1, 1636427315585, 1636427316037, 452, 0, 452, 0, 0, 0
1884, 1, 1636427315557, 1636427316089, 532, 80, 452, 80, 0, 80
1886, 1, 1636427315640, 1636427316092, 452, 0, 452, 0, 0, 0
1887, 1, 1636427315740, 1636427316493, 753, 298, 455, 297, 0, 297
1888, 1, 1636427316225, 1636427316677, 452, 0, 452, 0, 0, 0
1889, 1, 1636427316624, 1636427317077, 453, 1, 452, 0, 0, 0
1890, 1, 1636427317928, 1636427318377, 449, 1, 448, 0, 0, 0
1891, 1, 1636427318436, 1636427318888, 452, 0, 452, 0, 0, 0
1892, 1, 1636427318480, 1636427318929, 449, 1, 448, 0, 0, 0
1893, 1, 1636427318748, 1636427319201, 453, 0, 453, 0, 0, 0
1894, 1, 1636427318781, 1636427319229, 448, 0, 448, 0, 0, 0
1895, 1, 1636427318796, 1636427319244, 448, 1, 447, 1, 0, 1
1897, 1, 1636427319093, 1636427319545, 452, 0, 452, 0, 0, 0
1896, 1, 1636427319017, 1636427319693, 676, 228, 448, 228, 0, 228
1898, 1, 1636427319489, 1636427320001, 512, 57, 455, 56, 1, 57
1899, 1, 1636427319608, 1636427320061, 453, 1, 452, 0, 0, 0
1900, 1, 1636427319725, 1636427320177, 452, 0, 452, 0, 0, 0
1901, 1, 1636427319813, 1636427320517, 704, 249, 455, 248, 0, 248
1902, 1, 1636427320101, 1636427320553, 452, 0, 452, 0, 0, 0
1903, 1, 1636427321637, 1636427322093, 456, 0, 456, 0, 0, 0
1904, 1, 1636427322368, 1636427322817, 449, 0, 449, 0, 0, 0
1905, 1, 1636427322473, 1636427322925, 452, 0, 452, 0, 0, 0
1906, 1, 1636427322524, 1636427322981, 457, 1, 456, 0, 1, 1
1907, 1, 1636427323040, 1636427323492, 452, 1, 451, 0, 0, 0
1908, 1, 1636427323077, 1636427323529, 452, 0, 452, 0, 0, 0
1909, 1, 1636427323077, 1636427323532, 455, 0, 455, 0, 0, 0
1912, 1, 1636427323441, 1636427323901, 460, 0, 460, 0, 0, 0
1911, 1, 1636427323345, 1636427323945, 600, 148, 452, 148, 0, 148
1910, 1, 1636427323256, 1636427323981, 725, 273, 452, 273, 0, 273
1913, 1, 1636427323613, 1636427324369, 756, 289, 467, 288, 0, 288
1914, 1, 1636427323808, 1636427324397, 589, 137, 452, 137, 0, 137
1915, 1, 1636427324017, 1636427324477, 460, 0, 460, 0, 0, 0
1916, 1, 1636427325341, 1636427325793, 452, 0, 452, 0, 0, 0
1917, 1, 1636427326296, 1636427326748, 452, 1, 451, 0, 0, 0
1918, 1, 1636427326600, 1636427327044, 444, 0, 444, 0, 0, 0
1919, 1, 1636427326741, 1636427327192, 451, 0, 451, 0, 0, 0
1920, 1, 1636427326760, 1636427327213, 453, 1, 452, 0, 0, 0
1921, 1, 1636427326961, 1636427327413, 452, 0, 452, 0, 0, 0
1922, 1, 1636427327132, 1636427327641, 509, 61, 448, 61, 0, 61
1923, 1, 1636427327236, 1636427327685, 449, 0, 449, 0, 0, 0
1925, 1, 1636427327525, 1636427328093, 568, 117, 451, 116, 1, 117
1924, 1, 1636427327485, 1636427328141, 656, 201, 455, 200, 0, 200
1926, 1, 1636427327901, 1636427328352, 451, 0, 451, 0, 0, 0
1927, 1, 1636427329252, 1636427329705, 453, 1, 452, 0, 0, 0
1928, 1, 1636427330468, 1636427330925, 457, 1, 456, 0, 1, 1
1929, 1, 1636427330489, 1636427330941, 452, 0, 452, 0, 0, 0
1930, 1, 1636427330641, 1636427331093, 452, 0, 452, 0, 0, 0
1931, 1, 1636427330657, 1636427331109, 452, 0, 452, 0, 0, 0
1932, 1, 1636427330817, 1636427331269, 452, 0, 452, 0, 0, 0
1933, 1, 1636427331116, 1636427331569, 453, 1, 452, 0, 0, 0
1934, 1, 1636427331257, 1636427331713, 456, 0, 456, 0, 0, 0
1935, 1, 1636427331497, 1636427332025, 528, 72, 456, 72, 0, 72
1937, 1, 1636427331693, 1636427332145, 452, 0, 452, 0, 0, 0
1936, 1, 1636427331584, 1636427332168, 584, 129, 455, 129, 0, 129
1938, 1, 1636427333341, 1636427333793, 452, 0, 452, 0, 0, 0
1939, 1, 1636427334268, 1636427334716, 448, 1, 447, 0, 0, 0
1940, 1, 1636427334433, 1636427334881, 448, 0, 448, 0, 0, 0
1941, 1, 1636427334741, 1636427335193, 452, 0, 452, 0, 0, 0
1942, 1, 1636427334741, 1636427335197, 456, 0, 456, 0, 0, 0
1943, 1, 1636427334792, 1636427335241, 449, 0, 449, 0, 0, 0
1944, 1, 1636427335197, 1636427335653, 456, 1, 455, 0, 0, 0
1945, 1, 1636427335221, 1636427335676, 455, 0, 455, 0, 0, 0
1947, 1, 1636427335557, 1636427336108, 551, 97, 454, 96, 0, 96
1948, 1, 1636427335665, 1636427336116, 451, 0, 451, 0, 0, 0
1946, 1, 1636427335453, 1636427336124, 671, 224, 447, 224, 0, 224
1949, 1, 1636427337181, 1636427337633, 452, 0, 452, 0, 0, 0
1950, 1, 1636427338109, 1636427338561, 452, 0, 452, 0, 0, 0
1951, 1, 1636427338405, 1636427338857, 452, 0, 452, 0, 0, 0
1952, 1, 1636427338585, 1636427339037, 452, 0, 452, 0, 0, 0
1953, 1, 1636427338996, 1636427339445, 449, 0, 449, 0, 0, 0
1954, 1, 1636427339040, 1636427339488, 448, 0, 448, 0, 0, 0
1955, 1, 1636427339277, 1636427339729, 452, 0, 452, 0, 0, 0
1956, 1, 1636427339388, 1636427339941, 553, 100, 453, 100, 0, 100
1957, 1, 1636427339745, 1636427340196, 451, 0, 451, 0, 0, 0
1958, 1, 1636427341329, 1636427341781, 452, 0, 452, 0, 0, 0
1959, 1, 1636427342281, 1636427342737, 456, 0, 456, 0, 0, 0
1960, 1, 1636427342729, 1636427343181, 452, 0, 452, 0, 0, 0
1961, 1, 1636427342764, 1636427343216, 452, 1, 451, 0, 0, 0
1962, 1, 1636427343229, 1636427343685, 456, 0, 456, 0, 0, 0
1963, 1, 1636427343257, 1636427343708, 451, 0, 451, 0, 0, 0
1964, 1, 1636427343472, 1636427344137, 665, 214, 451, 212, 0, 212
1965, 1, 1636427343577, 1636427344161, 584, 132, 452, 132, 0, 132
1966, 1, 1636427345372, 1636427345829, 457, 1, 456, 0, 0, 0
1967, 1, 1636427346585, 1636427347036, 451, 0, 451, 0, 0, 0
1968, 1, 1636427346673, 1636427347125, 452, 0, 452, 0, 0, 0
1969, 1, 1636427346776, 1636427347233, 457, 1, 456, 0, 0, 0
1970, 1, 1636427347301, 1636427347757, 456, 0, 456, 0, 0, 0
1971, 1, 1636427347441, 1636427347897, 456, 0, 456, 0, 0, 0
1973, 1, 1636427347856, 1636427348305, 449, 1, 448, 0, 0, 0
1972, 1, 1636427347741, 1636427348357, 616, 156, 460, 156, 0, 156
1974, 1, 1636427350621, 1636427351073, 452, 0, 452, 0, 0, 0
1975, 1, 1636427350832, 1636427351285, 453, 1, 452, 0, 1, 1
1976, 1, 1636427351549, 1636427352009, 460, 0, 460, 0, 0, 0
1977, 1, 1636427351861, 1636427352465, 604, 149, 455, 148, 1, 149
1978, 1, 1636427354325, 1636427354781, 456, 0, 456, 0, 0, 0
1979, 1, 1636427354717, 1636427355169, 452, 0, 452, 0, 0, 0
1980, 1, 1636427355365, 1636427355817, 452, 0, 452, 0, 0, 0
1981, 1, 1636427355609, 1636427356273, 664, 209, 455, 208, 0, 208
1982, 1, 1636427358236, 1636427358689, 453, 1, 452, 0, 0, 0
1983, 1, 1636427358385, 1636427358837, 452, 0, 452, 0, 0, 0
1984, 1, 1636427359161, 1636427359613, 452, 0, 452, 0, 0, 0
1985, 1, 1636427359393, 1636427360069, 676, 221, 455, 221, 0, 221
1986, 1, 1636427362245, 1636427362701, 456, 0, 456, 0, 0, 0
1987, 1, 1636427362321, 1636427362773, 452, 0, 452, 0, 0, 0
1988, 1, 1636427363405, 1636427363853, 448, 0, 448, 0, 0, 0
1989, 1, 1636427363521, 1636427364309, 788, 333, 455, 332, 0, 332
1990, 1, 1636427366164, 1636427366612, 448, 1, 447, 1, 0, 1
1991, 1, 1636427366217, 1636427366669, 452, 0, 452, 0, 0, 0
1992, 1, 1636427367357, 1636427367817, 460, 0, 460, 0, 0, 0
1993, 1, 1636427367509, 1636427368269, 760, 309, 451, 308, 0, 308
1994, 1, 1636427369977, 1636427370429, 452, 0, 452, 0, 0, 0
1995, 1, 1636427371545, 1636427371997, 452, 0, 452, 0, 0, 0
1996, 1, 1636427371596, 1636427372453, 857, 401, 456, 400, 0, 400
1997, 1, 1636427375309, 1636427375765, 456, 0, 456, 0, 0, 0
1998, 1, 1636427375529, 1636427376221, 692, 236, 456, 236, 0, 236
1999, 1, 1636427379597, 1636427380048, 451, 0, 451, 0, 0, 0
2000, 1, 1636427379669, 1636427380501, 832, 380, 452, 380, 0, 380
2001, 1, 1636427507097, 1636427507553, 456, 0, 456, 0, 0, 0
2002, 1, 1636427510965, 1636427511421, 456, 0, 456, 0, 0, 0
2003, 1, 1636427514881, 1636427515333, 452, 0, 452, 0, 0, 0
2004, 1, 1636427519061, 1636427519513, 452, 0, 452, 0, 0, 0
2005, 1, 1636427523233, 1636427523685, 452, 0, 452, 0, 0, 0
2006, 1, 1636427527145, 1636427527597, 452, 0, 452, 0, 0, 0
2007, 1, 1636427531180, 1636427531632, 452, 1, 451, 1, 0, 1
2008, 1, 1636427535233, 1636427535689, 456, 0, 456, 0, 0, 0
2009, 1, 1636427539309, 1636427539761, 452, 0, 452, 0, 0, 0
2010, 1, 1636427543529, 1636427543985, 456, 0, 456, 0, 0, 0
2011, 1, 1636427547264, 1636427547717, 453, 1, 452, 0, 0, 0
2012, 1, 1636427551057, 1636427551509, 452, 0, 452, 0, 0, 0
2013, 1, 1636427554901, 1636427555360, 459, 0, 459, 0, 0, 0
2014, 1, 1636427559229, 1636427559681, 452, 0, 452, 0, 0, 0
2015, 1, 1636427563017, 1636427563469, 452, 0, 452, 0, 0, 0
2016, 1, 1636427567209, 1636427567665, 456, 0, 456, 0, 0, 0
2017, 1, 1636427571045, 1636427571501, 456, 0, 456, 0, 0, 0
2018, 1, 1636427574941, 1636427575397, 456, 0, 456, 0, 0, 0
2019, 1, 1636427579265, 1636427579713, 448, 0, 448, 0, 0, 0
2020, 1, 1636427583340, 1636427583792, 452, 1, 451, 0, 0, 0
2021, 1, 1636427587029, 1636427587485, 456, 0, 456, 0, 0, 0
2022, 1, 1636427590856, 1636427591312, 456, 1, 455, 0, 1, 1
2023, 1, 1636427605497, 1636427605953, 456, 0, 456, 0, 0, 0
2024, 1, 1636427606493, 1636427606945, 452, 0, 452, 0, 0, 0
2025, 1, 1636427607473, 1636427607929, 456, 0, 456, 0, 0, 0
2026, 1, 1636427608500, 1636427608953, 453, 1, 452, 0, 0, 0
2027, 1, 1636427609533, 1636427609985, 452, 0, 452, 0, 0, 0
2028, 1, 1636427610533, 1636427610981, 448, 0, 448, 0, 0, 0
2029, 1, 1636427611541, 1636427611997, 456, 0, 456, 0, 0, 0
2030, 1, 1636427612565, 1636427613017, 452, 0, 452, 0, 0, 0
2031, 1, 1636427613597, 1636427614049, 452, 0, 452, 0, 0, 0
2032, 1, 1636427614597, 1636427615057, 460, 0, 460, 0, 0, 0
2033, 1, 1636427615569, 1636427616029, 460, 0, 460, 0, 0, 0
2034, 1, 1636427616541, 1636427616993, 452, 0, 452, 0, 0, 0
2035, 1, 1636427617528, 1636427617981, 453, 1, 452, 0, 0, 0
2036, 1, 1636427618537, 1636427618993, 456, 0, 456, 0, 0, 0
2037, 1, 1636427619517, 1636427619973, 456, 0, 456, 0, 0, 0
2038, 1, 1636427620553, 1636427621005, 452, 0, 452, 0, 0, 0
2039, 1, 1636427621549, 1636427622001, 452, 0, 452, 0, 0, 0
2040, 1, 1636427622537, 1636427622989, 452, 0, 452, 0, 0, 0
2041, 1, 1636427623537, 1636427623993, 456, 0, 456, 0, 0, 0
2042, 1, 1636427624549, 1636427625001, 452, 0, 452, 0, 0, 0
2043, 1, 1636427625536, 1636427625993, 457, 1, 456, 1, 0, 1
2044, 1, 1636427626505, 1636427626961, 456, 0, 456, 0, 0, 0
2045, 1, 1636427627493, 1636427627949, 456, 0, 456, 0, 0, 0
2046, 1, 1636427628477, 1636427628929, 452, 0, 452, 0, 0, 0
2047, 1, 1636427629489, 1636427629945, 456, 0, 456, 0, 0, 0
2048, 1, 1636427630501, 1636427630961, 460, 0, 460, 0, 0, 0
2049, 1, 1636427631489, 1636427631941, 452, 0, 452, 0, 0, 0
2050, 1, 1636427632465, 1636427632917, 452, 0, 452, 0, 0, 0
2051, 1, 1636427633473, 1636427633925, 452, 0, 452, 0, 0, 0
2052, 1, 1636427634497, 1636427634953, 456, 0, 456, 0, 0, 0
2053, 1, 1636427635481, 1636427635937, 456, 0, 456, 0, 0, 0
2054, 1, 1636427636469, 1636427636921, 452, 0, 452, 0, 0, 0
2055, 1, 1636427637441, 1636427637897, 456, 0, 456, 0, 0, 0
2056, 1, 1636427638449, 1636427638905, 456, 0, 456, 0, 0, 0
2057, 1, 1636427639421, 1636427639877, 456, 0, 456, 0, 0, 0
2058, 1, 1636427640425, 1636427640877, 452, 0, 452, 0, 0, 0
2059, 1, 1636427641405, 1636427641860, 455, 0, 455, 0, 0, 0
2060, 1, 1636427642401, 1636427642857, 456, 0, 456, 0, 0, 0
2061, 1, 1636427643437, 1636427643893, 456, 0, 456, 0, 0, 0
2062, 1, 1636427644445, 1636427644900, 455, 0, 455, 0, 0, 0
2063, 1, 1636427645465, 1636427645917, 452, 0, 452, 0, 0, 0
2064, 1, 1636427646445, 1636427646897, 452, 0, 452, 0, 0, 0
2065, 1, 1636427647428, 1636427647877, 449, 1, 448, 1, 0, 1
2066, 1, 1636427648429, 1636427648885, 456, 0, 456, 0, 0, 0
2067, 1, 1636427649437, 1636427649893, 456, 0, 456, 0, 0, 0
2068, 1, 1636427650417, 1636427650873, 456, 0, 456, 0, 0, 0
2069, 1, 1636427651433, 1636427651889, 456, 0, 456, 0, 0, 0
2070, 1, 1636427652465, 1636427652921, 456, 0, 456, 0, 0, 0
2071, 1, 1636427653461, 1636427653917, 456, 0, 456, 0, 0, 0
2072, 1, 1636427654437, 1636427654889, 452, 0, 452, 0, 0, 0
2073, 1, 1636427655449, 1636427655901, 452, 0, 452, 0, 0, 0
2074, 1, 1636427656477, 1636427656933, 456, 0, 456, 0, 0, 0
2075, 1, 1636427657509, 1636427657965, 456, 0, 456, 0, 0, 0
2076, 1, 1636427658481, 1636427658937, 456, 0, 456, 0, 0, 0
2077, 1, 1636427659504, 1636427659957, 453, 0, 453, 0, 0, 0
2078, 1, 1636427660509, 1636427660961, 452, 0, 452, 0, 0, 0
2079, 1, 1636427661525, 1636427661977, 452, 0, 452, 0, 0, 0
2080, 1, 1636427662521, 1636427662977, 456, 0, 456, 0, 0, 0
2081, 1, 1636427663533, 1636427663985, 452, 0, 452, 0, 0, 0
2082, 1, 1636427664561, 1636427665017, 456, 0, 456, 0, 0, 0
2083, 1, 1636427665577, 1636427666037, 460, 0, 460, 0, 0, 0
2084, 1, 1636427666597, 1636427667049, 452, 0, 452, 0, 0, 0
2085, 1, 1636427667585, 1636427668041, 456, 0, 456, 0, 0, 0
2086, 1, 1636427668609, 1636427669065, 456, 0, 456, 0, 0, 0
2087, 1, 1636427669641, 1636427670093, 452, 0, 452, 0, 0, 0
2088, 1, 1636427670649, 1636427671105, 456, 0, 456, 0, 0, 0
2089, 1, 1636427671628, 1636427672080, 452, 0, 452, 0, 0, 0
2090, 1, 1636427672608, 1636427673065, 457, 1, 456, 0, 1, 1
2091, 1, 1636427673592, 1636427674045, 453, 1, 452, 0, 1, 1
2092, 1, 1636427674597, 1636427675049, 452, 0, 452, 0, 0, 0
2093, 1, 1636427675633, 1636427676089, 456, 0, 456, 0, 0, 0
2094, 1, 1636427676613, 1636427677069, 456, 0, 456, 0, 0, 0
2095, 1, 1636427677577, 1636427678025, 448, 0, 448, 0, 0, 0
2096, 1, 1636427678581, 1636427679033, 452, 0, 452, 0, 0, 0
2097, 1, 1636427679577, 1636427680033, 456, 0, 456, 0, 0, 0
2098, 1, 1636427680565, 1636427681017, 452, 0, 452, 0, 0, 0
2099, 1, 1636427681533, 1636427681985, 452, 0, 452, 0, 0, 0
2100, 1, 1636427682536, 1636427682989, 453, 1, 452, 0, 0, 0
2101, 1, 1636427683557, 1636427684009, 452, 0, 452, 0, 0, 0
2102, 1, 1636427684569, 1636427685021, 452, 0, 452, 0, 0, 0
2103, 1, 1636427685561, 1636427686017, 456, 0, 456, 0, 0, 0
2104, 1, 1636427686565, 1636427687017, 452, 0, 452, 0, 0, 0
2105, 1, 1636427687529, 1636427687985, 456, 0, 456, 0, 0, 0
2106, 1, 1636427688537, 1636427688989, 452, 0, 452, 0, 0, 0
2107, 1, 1636427689517, 1636427689969, 452, 0, 452, 0, 0, 0
2108, 1, 1636427690537, 1636427690993, 456, 0, 456, 0, 0, 0
2109, 1, 1636427691549, 1636427692009, 460, 0, 460, 0, 0, 0
2110, 1, 1636427692513, 1636427692960, 447, 0, 447, 0, 0, 0
2111, 1, 1636427693501, 1636427693957, 456, 0, 456, 0, 0, 0
2112, 1, 1636427694481, 1636427694933, 452, 0, 452, 0, 0, 0
2113, 1, 1636427695453, 1636427695905, 452, 0, 452, 0, 0, 0
2114, 1, 1636427696425, 1636427696877, 452, 0, 452, 0, 0, 0
2115, 1, 1636427697449, 1636427697905, 456, 0, 456, 0, 0, 0
2116, 1, 1636427698421, 1636427698873, 452, 0, 452, 0, 0, 0
2117, 1, 1636427699449, 1636427699901, 452, 0, 452, 0, 0, 0
2118, 1, 1636427700469, 1636427700929, 460, 0, 460, 0, 0, 0
2119, 1, 1636427701477, 1636427701933, 456, 0, 456, 0, 0, 0
2120, 1, 1636427702480, 1636427702933, 453, 1, 452, 0, 0, 0
2121, 1, 1636427703481, 1636427703933, 452, 0, 452, 0, 0, 0
2122, 1, 1636427704488, 1636427704940, 452, 1, 451, 1, 0, 1
2123, 1, 1636427742661, 1636427743113, 452, 0, 452, 0, 0, 0
2124, 1, 1636427743589, 1636427744041, 452, 0, 452, 0, 0, 0
2125, 1, 1636427744564, 1636427745017, 453, 1, 452, 0, 0, 0
2126, 1, 1636427745597, 1636427746045, 448, 0, 448, 0, 0, 0
2127, 1, 1636427746620, 1636427747073, 453, 1, 452, 0, 0, 0
2128, 1, 1636427747625, 1636427748077, 452, 0, 452, 0, 0, 0
2129, 1, 1636427748633, 1636427749085, 452, 0, 452, 0, 0, 0
2130, 1, 1636427749652, 1636427750101, 449, 1, 448, 1, 0, 1
2131, 1, 1636427750684, 1636427751136, 452, 1, 451, 1, 0, 1
2132, 1, 1636427751685, 1636427752137, 452, 0, 452, 0, 0, 0
2133, 1, 1636427752657, 1636427753101, 444, 0, 444, 0, 0, 0
2134, 1, 1636427753649, 1636427754101, 452, 0, 452, 0, 0, 0
2135, 1, 1636427754637, 1636427755089, 452, 0, 452, 0, 0, 0
2136, 1, 1636427755649, 1636427756101, 452, 0, 452, 0, 0, 0
2137, 1, 1636427756625, 1636427757077, 452, 0, 452, 0, 0, 0
2138, 1, 1636427757661, 1636427758113, 452, 0, 452, 0, 0, 0
2139, 1, 1636427758657, 1636427759109, 452, 0, 452, 0, 0, 0
2140, 1, 1636427759633, 1636427760085, 452, 0, 452, 0, 0, 0
2141, 1, 1636427760633, 1636427761085, 452, 0, 452, 0, 0, 0
2142, 1, 1636427761645, 1636427762097, 452, 0, 452, 0, 0, 0
2143, 1, 1636427762609, 1636427763065, 456, 0, 456, 0, 0, 0
2144, 1, 1636427763581, 1636427764033, 452, 0, 452, 0, 0, 0
2145, 1, 1636427764565, 1636427765017, 452, 0, 452, 0, 0, 0
2146, 1, 1636427765553, 1636427766009, 456, 0, 456, 0, 0, 0
2147, 1, 1636427766561, 1636427767013, 452, 0, 452, 0, 0, 0
2148, 1, 1636427767577, 1636427768033, 456, 0, 456, 0, 0, 0
2149, 1, 1636427768561, 1636427769013, 452, 0, 452, 0, 0, 0
2150, 1, 1636427769537, 1636427769997, 460, 0, 460, 0, 0, 0
2151, 1, 1636427770573, 1636427771025, 452, 0, 452, 0, 0, 0
2152, 1, 1636427771597, 1636427772049, 452, 0, 452, 0, 0, 0
2153, 1, 1636427772585, 1636427773041, 456, 0, 456, 0, 0, 0
2154, 1, 1636427773573, 1636427774029, 456, 0, 456, 0, 0, 0
2155, 1, 1636427774545, 1636427775001, 456, 0, 456, 0, 0, 0
2156, 1, 1636427775553, 1636427776009, 456, 0, 456, 0, 0, 0
2157, 1, 1636427776525, 1636427776977, 452, 0, 452, 0, 0, 0
2158, 1, 1636427777529, 1636427777985, 456, 0, 456, 0, 0, 0
2159, 1, 1636427778505, 1636427778953, 448, 0, 448, 0, 0, 0
2160, 1, 1636427779497, 1636427779953, 456, 0, 456, 0, 0, 0
2161, 1, 1636427780533, 1636427780985, 452, 0, 452, 0, 0, 0
2162, 1, 1636427781545, 1636427781997, 452, 0, 452, 0, 0, 0
2163, 1, 1636427782561, 1636427783013, 452, 0, 452, 0, 0, 0
2164, 1, 1636427783541, 1636427783993, 452, 0, 452, 0, 0, 0
2165, 1, 1636427784533, 1636427784985, 452, 0, 452, 0, 0, 0
2166, 1, 1636427785537, 1636427785993, 456, 0, 456, 0, 0, 0
2167, 1, 1636427786549, 1636427787001, 452, 0, 452, 0, 0, 0
2168, 1, 1636427787525, 1636427787981, 456, 0, 456, 0, 0, 0
2169, 1, 1636427788541, 1636427788993, 452, 0, 452, 0, 0, 0
2170, 1, 1636427789569, 1636427790021, 452, 0, 452, 0, 0, 0
2171, 1, 1636427790565, 1636427791017, 452, 0, 452, 0, 0, 0
2172, 1, 1636427791537, 1636427791997, 460, 0, 460, 0, 0, 0
2173, 1, 1636427792549, 1636427793001, 452, 0, 452, 0, 0, 0
2174, 1, 1636427793577, 1636427794032, 455, 0, 455, 0, 0, 0
2175, 1, 1636427794613, 1636427795065, 452, 0, 452, 0, 0, 0
2176, 1, 1636427795585, 1636427796041, 456, 0, 456, 0, 0, 0
2177, 1, 1636427796609, 1636427797060, 451, 0, 451, 0, 0, 0
2178, 1, 1636427797644, 1636427798101, 457, 1, 456, 0, 1, 1
2179, 1, 1636427798665, 1636427799117, 452, 0, 452, 0, 0, 0
2180, 1, 1636427799637, 1636427800093, 456, 0, 456, 0, 0, 0
2181, 1, 1636427800649, 1636427801101, 452, 0, 452, 0, 0, 0
2182, 1, 1636427801661, 1636427802113, 452, 0, 452, 0, 0, 0
2183, 1, 1636427802669, 1636427803125, 456, 0, 456, 0, 0, 0
2184, 1, 1636427803689, 1636427804141, 452, 0, 452, 0, 0, 0
2185, 1, 1636427804677, 1636427805129, 452, 0, 452, 0, 0, 0
2186, 1, 1636427805701, 1636427806157, 456, 0, 456, 0, 0, 0
2187, 1, 1636427806729, 1636427807181, 452, 0, 452, 0, 0, 0
2188, 1, 1636427807765, 1636427808217, 452, 0, 452, 0, 0, 0
2189, 1, 1636427808745, 1636427809197, 452, 0, 452, 0, 0, 0
2190, 1, 1636427809725, 1636427810181, 456, 0, 456, 0, 0, 0
2191, 1, 1636427810709, 1636427811161, 452, 0, 452, 0, 0, 0
2192, 1, 1636427811717, 1636427812173, 456, 0, 456, 0, 0, 0
2193, 1, 1636427812741, 1636427813193, 452, 0, 452, 0, 0, 0
2194, 1, 1636427813721, 1636427814173, 452, 0, 452, 0, 0, 0
2195, 1, 1636427814689, 1636427815141, 452, 0, 452, 0, 0, 0
2196, 1, 1636427815693, 1636427816149, 456, 0, 456, 0, 0, 0
2197, 1, 1636427816685, 1636427817137, 452, 0, 452, 0, 0, 0
2198, 1, 1636427817673, 1636427818133, 460, 0, 460, 0, 0, 0
2199, 1, 1636427818664, 1636427819117, 453, 1, 452, 0, 0, 0
2200, 1, 1636427819689, 1636427820145, 456, 0, 456, 0, 0, 0
2201, 1, 1636427820709, 1636427821161, 452, 0, 452, 0, 0, 0
2202, 1, 1636427821725, 1636427822173, 448, 0, 448, 0, 0, 0
2203, 1, 1636427822713, 1636427823165, 452, 0, 452, 0, 0, 0
2204, 1, 1636427823717, 1636427824165, 448, 0, 448, 0, 0, 0
2205, 1, 1636427824681, 1636427825129, 448, 0, 448, 0, 0, 0
2206, 1, 1636427825689, 1636427826145, 456, 0, 456, 0, 0, 0
2207, 1, 1636427826668, 1636427827125, 457, 1, 456, 0, 0, 0
2208, 1, 1636427827689, 1636427828145, 456, 0, 456, 0, 0, 0
2209, 1, 1636427828705, 1636427829157, 452, 0, 452, 0, 0, 0
2210, 1, 1636427829693, 1636427830149, 456, 0, 456, 0, 0, 0
2211, 1, 1636427830661, 1636427831116, 455, 0, 455, 0, 0, 0
2212, 1, 1636427831637, 1636427832088, 451, 0, 451, 0, 0, 0
2213, 1, 1636427832629, 1636427833081, 452, 0, 452, 0, 0, 0
2214, 1, 1636427833597, 1636427834053, 456, 0, 456, 0, 0, 0
2215, 1, 1636427834625, 1636427835081, 456, 0, 456, 0, 0, 0
2216, 1, 1636427835597, 1636427836053, 456, 0, 456, 0, 0, 0
2217, 1, 1636427836621, 1636427837077, 456, 0, 456, 0, 0, 0
2218, 1, 1636427837653, 1636427838105, 452, 0, 452, 0, 0, 0
2219, 1, 1636427838689, 1636427839145, 456, 0, 456, 0, 0, 0
2220, 1, 1636427839689, 1636427840141, 452, 0, 452, 0, 0, 0
2221, 1, 1636427840724, 1636427841177, 453, 1, 452, 0, 1, 1
2222, 1, 1636427841729, 1636427842181, 452, 0, 452, 0, 0, 0
