Xid, State, StartTime, EndTime, TransactionTime, ExecuteTime, CommunicationTime, ReadTime, WriteTime, DBTime
1, 1, 1636410873396, 1636410873920, 524, 76, 448, 33, 6, 39
2, 1, 1636410874343, 1636410874755, 412, 4, 408, 2, 1, 3
3, 1, 1636410875071, 1636410875487, 416, 4, 412, 2, 1, 3
4, 1, 1636410875803, 1636410876211, 408, 4, 404, 1, 0, 1
5, 1, 1636410876519, 1636410876931, 412, 3, 409, 2, 0, 2
6, 1, 1636410877247, 1636410877647, 400, 3, 397, 1, 0, 1
7, 1, 1636410877963, 1636410878375, 412, 4, 408, 2, 0, 2
8, 1, 1636410878691, 1636410879095, 404, 3, 401, 2, 0, 2
9, 1, 1636410879407, 1636410879822, 415, 2, 413, 0, 0, 0
10, 1, 1636410880131, 1636410880543, 412, 3, 409, 2, 0, 2
11, 1, 1636410880854, 1636410881259, 405, 3, 402, 0, 0, 0
12, 1, 1636410881567, 1636410881975, 408, 3, 405, 0, 1, 1
13, 1, 1636410882283, 1636410882683, 400, 2, 398, 1, 1, 2
14, 1, 1636410882991, 1636410883391, 400, 3, 397, 0, 1, 1
15, 1, 1636410883699, 1636410884103, 404, 3, 401, 0, 1, 1
17, 1, 1636410884415, 1636410884836, 421, 6, 415, 0, 0, 0
19, 1, 1636410885146, 1636410885511, 365, 2, 363, 0, 0, 0
21, 1, 1636410885775, 1636410886135, 360, 2, 358, 0, 1, 1
23, 1, 1636410886399, 1636410886763, 364, 2, 362, 0, 1, 1
24, 1, 1636410887027, 1636410887391, 364, 1, 363, 0, 0, 0
26, 1, 1636410887655, 1636410888015, 360, 2, 358, 1, 0, 1
28, 1, 1636410888279, 1636410888635, 356, 2, 354, 0, 1, 1
30, 1, 1636410888898, 1636410889259, 361, 1, 360, 0, 0, 0
32, 1, 1636410889523, 1636410889883, 360, 0, 360, 0, 0, 0
34, 1, 1636410890151, 1636410890515, 364, 0, 364, 0, 0, 0
36, 1, 1636410890779, 1636410891143, 364, 1, 363, 0, 0, 0
38, 1, 1636410891411, 1636410891771, 360, 1, 359, 0, 0, 0
40, 1, 1636410892039, 1636410892398, 359, 0, 359, 0, 0, 0
42, 1, 1636410892663, 1636410893023, 360, 2, 358, 0, 0, 0
44, 1, 1636410893287, 1636410893647, 360, 1, 359, 0, 0, 0
46, 1, 1636410893911, 1636410894267, 356, 1, 355, 1, 0, 1
48, 1, 1636410894530, 1636410894883, 353, 1, 352, 0, 0, 0
49, 1, 1636410895150, 1636410895507, 357, 2, 355, 1, 0, 1
51, 1, 1636410895771, 1636410896131, 360, 0, 360, 0, 0, 0
53, 1, 1636410896395, 1636410896755, 360, 1, 359, 1, 0, 1
55, 1, 1636410897019, 1636410897375, 356, 0, 356, 0, 0, 0
57, 1, 1636410897639, 1636410897994, 355, 1, 354, 0, 0, 0
59, 1, 1636410898259, 1636410898610, 351, 1, 350, 1, 0, 1
62, 1, 1636410898879, 1636410899231, 352, 0, 352, 0, 0, 0
65, 1, 1636410899495, 1636410899854, 359, 1, 358, 0, 0, 0
67, 1, 1636410900118, 1636410900471, 353, 3, 350, 1, 1, 2
70, 1, 1636410900743, 1636410901094, 351, 1, 350, 1, 0, 1
73, 1, 1636410901358, 1636410901710, 352, 3, 349, 2, 0, 2
76, 1, 1636410901974, 1636410902327, 353, 3, 350, 0, 1, 1
79, 1, 1636410902591, 1636410902946, 355, 1, 354, 0, 0, 0
82, 1, 1636410903211, 1636410903571, 360, 1, 359, 0, 0, 0
85, 1, 1636410903835, 1636410904186, 351, 2, 349, 1, 0, 1
88, 1, 1636410904450, 1636410904810, 360, 1, 359, 0, 0, 0
91, 1, 1636410905074, 1636410905427, 353, 2, 351, 0, 0, 0
94, 1, 1636410905690, 1636410906043, 353, 2, 351, 1, 0, 1
97, 1, 1636410906310, 1636410906663, 353, 3, 350, 2, 0, 2
100, 1, 1636410906927, 1636410907278, 351, 0, 351, 0, 0, 0
103, 1, 1636410907546, 1636410907899, 353, 2, 351, 0, 0, 0
105, 1, 1636410908162, 1636410908518, 356, 2, 354, 0, 0, 0
108, 1, 1636410908787, 1636410909143, 356, 1, 355, 0, 0, 0
111, 1, 1636410909407, 1636410909759, 352, 2, 350, 1, 0, 1
114, 1, 1636410910023, 1636410910379, 356, 0, 356, 0, 0, 0
117, 1, 1636410910642, 1636410910998, 356, 2, 354, 1, 0, 1
120, 1, 1636410911262, 1636410911614, 352, 3, 349, 0, 1, 1
123, 1, 1636410911879, 1636410912231, 352, 0, 352, 0, 0, 0
126, 1, 1636410912495, 1636410912851, 356, 0, 356, 0, 0, 0
129, 1, 1636410913114, 1636410913467, 353, 2, 351, 0, 0, 0
132, 1, 1636410913731, 1636410914083, 352, 0, 352, 0, 0, 0
135, 1, 1636410914351, 1636410914702, 351, 1, 350, 1, 0, 1
138, 1, 1636410914970, 1636410915322, 352, 1, 351, 1, 0, 1
141, 1, 1636410915587, 1636410915943, 356, 1, 355, 0, 0, 0
144, 1, 1636410916207, 1636410916558, 351, 2, 349, 0, 0, 0
147, 1, 1636410916822, 1636410917174, 352, 2, 350, 0, 0, 0
150, 1, 1636410917439, 1636410917791, 352, 0, 352, 0, 0, 0
153, 1, 1636410918054, 1636410918407, 353, 2, 351, 0, 1, 1
156, 1, 1636410918670, 1636410919026, 356, 2, 354, 0, 1, 1
159, 1, 1636410919290, 1636410919642, 352, 1, 351, 0, 0, 0
162, 1, 1636410919906, 1636410920263, 357, 2, 355, 0, 0, 0
165, 1, 1636410920527, 1636410920879, 352, 2, 350, 0, 0, 0
168, 1, 1636410921146, 1636410921503, 357, 3, 354, 1, 0, 1
171, 1, 1636410921767, 1636410922119, 352, 2, 350, 1, 0, 1
174, 1, 1636410922382, 1636410922735, 353, 3, 350, 1, 1, 2
177, 1, 1636410923007, 1636410923359, 352, 1, 351, 0, 0, 0
180, 1, 1636410923626, 1636410923979, 353, 2, 351, 0, 0, 0
183, 1, 1636410924247, 1636410924598, 351, 2, 349, 0, 0, 0
186, 1, 1636410924862, 1636410925215, 353, 2, 351, 0, 0, 0
189, 1, 1636410925478, 1636410925835, 357, 2, 355, 0, 0, 0
192, 1, 1636410926098, 1636410926462, 364, 2, 362, 1, 0, 1
195, 1, 1636410926730, 1636410927082, 352, 3, 349, 0, 0, 0
198, 1, 1636410927347, 1636410927698, 351, 2, 349, 2, 0, 2
201, 1, 1636410927962, 1636410928315, 353, 3, 350, 1, 0, 1
204, 1, 1636410928578, 1636410928931, 353, 1, 352, 0, 0, 0
207, 1, 1636410929194, 1636410929546, 352, 3, 349, 1, 0, 1
210, 1, 1636410929810, 1636410930162, 352, 3, 349, 1, 1, 2
213, 1, 1636410930426, 1636410930779, 353, 3, 350, 2, 0, 2
216, 1, 1636410931046, 1636410931407, 361, 1, 360, 0, 0, 0
219, 1, 1636410931670, 1636410932023, 353, 3, 350, 0, 0, 0
222, 1, 1636410932286, 1636410932639, 353, 3, 350, 0, 0, 0
225, 1, 1636410932906, 1636410933258, 352, 3, 349, 0, 0, 0
228, 1, 1636410933522, 1636410933878, 356, 2, 354, 1, 0, 1
231, 1, 1636410934142, 1636410934498, 356, 2, 354, 0, 0, 0
234, 1, 1636410934762, 1636410935114, 352, 3, 349, 0, 0, 0
237, 1, 1636410935378, 1636410935730, 352, 3, 349, 1, 0, 1
240, 1, 1636410935994, 1636410936354, 360, 2, 358, 1, 0, 1
243, 1, 1636410936618, 1636410936970, 352, 2, 350, 1, 0, 1
301, 1, 1636411076986, 1636411077458, 472, 13, 459, 0, 0, 0
302, 1, 1636411077963, 1636411078367, 404, 0, 404, 0, 0, 0
303, 1, 1636411078039, 1636411078442, 403, 2, 401, 1, 1, 2
304, 1, 1636411078963, 1636411079358, 395, 1, 394, 0, 1, 1
305, 1, 1636411079030, 1636411079439, 409, 1, 408, 0, 1, 1
306, 1, 1636411079370, 1636411079771, 401, 1, 400, 0, 0, 0
307, 1, 1636411079962, 1636411080366, 404, 1, 403, 0, 1, 1
308, 1, 1636411080030, 1636411080434, 404, 0, 404, 0, 0, 0
309, 1, 1636411080370, 1636411080778, 408, 1, 407, 0, 0, 0
310, 1, 1636411080446, 1636411080842, 396, 0, 396, 0, 0, 0
311, 1, 1636411080974, 1636411081370, 396, 1, 395, 0, 1, 1
312, 1, 1636411081050, 1636411081454, 404, 2, 402, 0, 0, 0
313, 1, 1636411081366, 1636411081767, 401, 5, 396, 5, 0, 5
314, 1, 1636411081366, 1636411081767, 401, 2, 399, 1, 1, 2
315, 1, 1636411081386, 1636411081790, 404, 0, 404, 0, 0, 0
316, 1, 1636411081974, 1636411082378, 404, 2, 402, 0, 0, 0
318, 1, 1636411082258, 1636411082539, 281, 1, 280, 0, 0, 0
320, 1, 1636411082342, 1636411082619, 277, 0, 277, 0, 0, 0
319, 1, 1636411082338, 1636411082619, 281, 1, 280, 0, 0, 0
322, 1, 1636411083238, 1636411083514, 276, 0, 276, 0, 0, 0
324, 1, 1636411083370, 1636411083647, 277, 0, 277, 0, 0, 0
325, 1, 1636411084274, 1636411084550, 276, 1, 275, 0, 0, 0
317, 2, 1636411082014, 1636411092474, 10460, 365, 10095, 365, 1, 366
321, 2, 1636411082946, 1636411092943, 9997, 0, 9997, 9527, 0, 9527
328, 1, 1636411092862, 1636411093179, 317, 1, 316, 0, 0, 0
323, 2, 1636411083366, 1636411093366, 10000, 0, 10000, 9108, 0, 9108
329, 1, 1636411093759, 1636411094035, 276, 0, 276, 0, 0, 0
326, 2, 1636411084398, 1636411094399, 10001, 0, 10001, 8077, 0, 8077
330, 1, 1636411094746, 1636411095023, 277, 1, 276, 0, 1, 1
327, 2, 1636411085306, 1636411095307, 10001, 0, 10001, 7167, 0, 7167
331, 1, 1636411095674, 1636411095946, 272, 1, 271, 0, 0, 0
332, 1, 1636411095738, 1636411096014, 276, 1, 275, 0, 0, 0
333, 1, 1636411096338, 1636411096618, 280, 1, 279, 0, 0, 0
334, 1, 1636411096586, 1636411096862, 276, 2, 274, 1, 0, 1
335, 1, 1636411096706, 1636411096978, 272, 1, 271, 0, 0, 0
336, 1, 1636411097242, 1636411097519, 277, 2, 275, 0, 1, 1
337, 1, 1636411097574, 1636411097850, 276, 2, 274, 1, 1, 2
338, 1, 1636411097670, 1636411097946, 276, 1, 275, 0, 0, 0
339, 1, 1636411098230, 1636411098506, 276, 1, 275, 0, 0, 0
341, 1, 1636411098706, 1636411098982, 276, 0, 276, 0, 0, 0
343, 1, 1636411099706, 1636411099982, 276, 1, 275, 1, 0, 1
344, 1, 1636411100722, 1636411100999, 277, 1, 276, 0, 0, 0
345, 1, 1636411101734, 1636411102011, 277, 1, 276, 0, 0, 0
348, 1, 1636411102846, 1636411103122, 276, 1, 275, 0, 0, 0
347, 1, 1636411102847, 1636411103122, 275, 1, 274, 0, 0, 0
349, 1, 1636411103746, 1636411104023, 277, 1, 276, 0, 1, 1
351, 1, 1636411104730, 1636411105007, 277, 1, 276, 0, 0, 0
340, 2, 1636411098546, 1636411108550, 10004, 0, 10004, 0, 0, 0
353, 1, 1636411108858, 1636411109135, 277, 1, 276, 0, 1, 1
342, 2, 1636411099206, 1636411109203, 9997, 0, 9997, 0, 0, 0
354, 1, 1636411109562, 1636411109838, 276, 0, 276, 0, 0, 0
355, 1, 1636411109770, 1636411110114, 344, 70, 274, 68, 1, 69
356, 1, 1636411110454, 1636411110730, 276, 1, 275, 1, 0, 1
357, 1, 1636411110782, 1636411111058, 276, 1, 275, 1, 0, 1
358, 1, 1636411111470, 1636411111746, 276, 0, 276, 0, 0, 0
359, 1, 1636411111782, 1636411112058, 276, 1, 275, 0, 0, 0
346, 2, 1636411102718, 1636411112718, 10000, 0, 10000, 0, 0, 0
360, 1, 1636411112474, 1636411112766, 292, 1, 291, 0, 0, 0
361, 1, 1636411112810, 1636411113082, 272, 0, 272, 0, 0, 0
362, 1, 1636411113034, 1636411113311, 277, 1, 276, 1, 0, 1
350, 2, 1636411103762, 1636411113759, 9997, 0, 9997, 0, 0, 0
363, 1, 1636411113494, 1636411113806, 312, 1, 311, 0, 0, 0
364, 1, 1636411113806, 1636411114078, 272, 1, 271, 1, 0, 1
365, 1, 1636411113942, 1636411114218, 276, 0, 276, 0, 0, 0
366, 1, 1636411114062, 1636411114338, 276, 1, 275, 0, 1, 1
367, 1, 1636411114502, 1636411114778, 276, 1, 275, 0, 0, 0
368, 1, 1636411114806, 1636411115082, 276, 1, 275, 0, 0, 0
369, 1, 1636411114950, 1636411115226, 276, 1, 275, 1, 0, 1
370, 1, 1636411114978, 1636411115254, 276, 0, 276, 0, 0, 0
352, 2, 1636411105707, 1636411115702, 9995, 0, 9995, 0, 0, 0
371, 1, 1636411115466, 1636411115750, 284, 1, 283, 0, 0, 0
372, 1, 1636411115838, 1636411116115, 277, 1, 276, 0, 0, 0
373, 1, 1636411115938, 1636411116214, 276, 1, 275, 0, 1, 1
374, 1, 1636411116014, 1636411116290, 276, 0, 276, 0, 0, 0
375, 1, 1636411115994, 1636411116390, 396, 122, 274, 122, 0, 122
376, 1, 1636411116454, 1636411116730, 276, 1, 275, 0, 0, 0
377, 1, 1636411116810, 1636411117086, 276, 0, 276, 0, 0, 0
378, 1, 1636411116930, 1636411117207, 277, 1, 276, 0, 0, 0
379, 1, 1636411116958, 1636411117227, 269, 1, 268, 1, 0, 1
380, 1, 1636411117002, 1636411117274, 272, 0, 272, 0, 0, 0
381, 1, 1636411117458, 1636411117735, 277, 1, 276, 0, 0, 0
382, 1, 1636411117806, 1636411118082, 276, 1, 275, 0, 0, 0
383, 1, 1636411117946, 1636411118227, 281, 1, 280, 0, 1, 1
385, 1, 1636411118022, 1636411118302, 280, 0, 280, 0, 0, 0
384, 1, 1636411117990, 1636411118362, 372, 93, 279, 93, 0, 93
386, 1, 1636411118454, 1636411118730, 276, 0, 276, 0, 0, 0
387, 1, 1636411118806, 1636411119082, 276, 1, 275, 1, 0, 1
388, 1, 1636411118946, 1636411119222, 276, 1, 275, 1, 0, 1
389, 1, 1636411118978, 1636411119254, 276, 1, 275, 1, 0, 1
390, 1, 1636411119026, 1636411119498, 472, 198, 274, 198, 0, 198
391, 1, 1636411119454, 1636411119731, 277, 0, 277, 0, 0, 0
392, 1, 1636411119818, 1636411120095, 277, 1, 276, 0, 0, 0
394, 1, 1636411119966, 1636411120243, 277, 1, 276, 1, 0, 1
393, 1, 1636411119966, 1636411120243, 277, 1, 276, 0, 1, 1
395, 1, 1636411120026, 1636411120302, 276, 1, 275, 1, 0, 1
396, 1, 1636411120466, 1636411120747, 281, 1, 280, 0, 0, 0
397, 1, 1636411120851, 1636411121122, 271, 0, 271, 0, 0, 0
399, 1, 1636411120998, 1636411121274, 276, 1, 275, 0, 0, 0
400, 1, 1636411121018, 1636411121298, 280, 1, 279, 1, 0, 1
398, 1, 1636411120970, 1636411121394, 424, 153, 271, 153, 0, 153
401, 1, 1636411121482, 1636411121751, 269, 0, 269, 0, 0, 0
402, 1, 1636411121850, 1636411122130, 280, 1, 279, 0, 0, 0
405, 1, 1636411122034, 1636411122310, 276, 0, 276, 0, 0, 0
404, 1, 1636411122034, 1636411122310, 276, 0, 276, 0, 0, 0
403, 1, 1636411121970, 1636411122402, 432, 161, 271, 160, 0, 160
406, 1, 1636411122450, 1636411122727, 277, 0, 277, 0, 0, 0
407, 1, 1636411122842, 1636411123122, 280, 1, 279, 0, 0, 0
408, 1, 1636411122958, 1636411123234, 276, 1, 275, 0, 0, 0
409, 1, 1636411123006, 1636411123282, 276, 0, 276, 0, 0, 0
410, 1, 1636411123030, 1636411123310, 280, 1, 279, 1, 0, 1
411, 1, 1636411123438, 1636411123715, 277, 1, 276, 0, 0, 0
412, 1, 1636411123882, 1636411124158, 276, 0, 276, 0, 0, 0
413, 1, 1636411123958, 1636411124234, 276, 1, 275, 1, 0, 1
415, 1, 1636411124030, 1636411124306, 276, 0, 276, 0, 0, 0
414, 1, 1636411124014, 1636411124510, 496, 221, 275, 221, 0, 221
416, 1, 1636411124470, 1636411124746, 276, 1, 275, 0, 0, 0
417, 1, 1636411124910, 1636411125182, 272, 1, 271, 0, 0, 0
419, 1, 1636411125014, 1636411125290, 276, 0, 276, 0, 0, 0
420, 1, 1636411125042, 1636411125318, 276, 1, 275, 0, 0, 0
418, 1, 1636411124958, 1636411125458, 500, 225, 275, 224, 0, 224
421, 1, 1636411125502, 1636411125783, 281, 0, 281, 0, 0, 0
422, 1, 1636411125886, 1636411126167, 281, 1, 280, 0, 0, 0
423, 1, 1636411125958, 1636411126234, 276, 1, 275, 0, 0, 0
424, 1, 1636411126006, 1636411126274, 268, 1, 267, 0, 0, 0
425, 1, 1636411126082, 1636411126550, 468, 193, 275, 193, 0, 193
426, 1, 1636411126502, 1636411126778, 276, 1, 275, 0, 0, 0
427, 1, 1636411126886, 1636411127163, 277, 1, 276, 0, 0, 0
428, 1, 1636411126974, 1636411127255, 281, 1, 280, 0, 0, 0
430, 1, 1636411127074, 1636411127346, 272, 0, 272, 0, 0, 0
429, 1, 1636411126998, 1636411127530, 532, 257, 275, 257, 0, 257
431, 1, 1636411127510, 1636411127786, 276, 1, 275, 0, 0, 0
432, 1, 1636411127922, 1636411128198, 276, 1, 275, 0, 0, 0
433, 1, 1636411128002, 1636411128278, 276, 1, 275, 0, 0, 0
434, 1, 1636411128014, 1636411128290, 276, 0, 276, 0, 0, 0
435, 1, 1636411128054, 1636411128475, 421, 145, 276, 144, 1, 145
436, 1, 1636411128538, 1636411128814, 276, 1, 275, 0, 1, 1
437, 1, 1636411128910, 1636411129186, 276, 1, 275, 0, 0, 0
438, 1, 1636411129014, 1636411129291, 277, 1, 276, 1, 0, 1
439, 1, 1636411129010, 1636411129462, 452, 177, 275, 177, 0, 177
440, 1, 1636411129074, 1636411129566, 492, 218, 274, 216, 0, 216
441, 1, 1636411129522, 1636411129795, 273, 0, 273, 0, 0, 0
442, 1, 1636411129906, 1636411130178, 272, 1, 271, 0, 0, 0
443, 1, 1636411129994, 1636411130270, 276, 1, 275, 0, 1, 1
444, 1, 1636411130002, 1636411130278, 276, 0, 276, 0, 0, 0
445, 1, 1636411130078, 1636411130354, 276, 0, 276, 0, 0, 0
446, 1, 1636411130494, 1636411130771, 277, 1, 276, 0, 0, 0
447, 1, 1636411130962, 1636411131231, 269, 1, 268, 0, 0, 0
448, 1, 1636411131006, 1636411131278, 272, 0, 272, 0, 0, 0
449, 1, 1636411131014, 1636411131294, 280, 0, 280, 0, 0, 0
450, 1, 1636411131058, 1636411131330, 272, 0, 272, 0, 0, 0
451, 1, 1636411131514, 1636411131795, 281, 1, 280, 0, 0, 0
452, 1, 1636411131966, 1636411132242, 276, 1, 275, 0, 0, 0
453, 1, 1636411131982, 1636411132258, 276, 1, 275, 0, 0, 0
455, 1, 1636411132066, 1636411132342, 276, 0, 276, 0, 0, 0
454, 1, 1636411132046, 1636411132519, 473, 197, 276, 196, 1, 197
456, 1, 1636411132526, 1636411132795, 269, 1, 268, 0, 1, 1
457, 1, 1636411132954, 1636411133230, 276, 1, 275, 0, 1, 1
458, 1, 1636411132966, 1636411133242, 276, 0, 276, 0, 0, 0
459, 1, 1636411133030, 1636411133306, 276, 0, 276, 0, 0, 0
460, 1, 1636411133106, 1636411133382, 276, 0, 276, 0, 0, 0
461, 1, 1636411133506, 1636411133783, 277, 1, 276, 0, 0, 0
462, 1, 1636411133946, 1636411134222, 276, 1, 275, 0, 0, 0
463, 1, 1636411133958, 1636411134230, 272, 1, 271, 0, 0, 0
464, 1, 1636411134038, 1636411134310, 272, 0, 272, 0, 0, 0
465, 1, 1636411134090, 1636411134366, 276, 0, 276, 0, 0, 0
466, 1, 1636411134506, 1636411134782, 276, 1, 275, 0, 0, 0
467, 1, 1636411134910, 1636411135190, 280, 1, 279, 0, 0, 0
468, 1, 1636411134946, 1636411135223, 277, 0, 277, 0, 0, 0
469, 1, 1636411135066, 1636411135342, 276, 1, 275, 0, 1, 1
470, 1, 1636411135074, 1636411135350, 276, 0, 276, 0, 0, 0
471, 1, 1636411135478, 1636411135754, 276, 1, 275, 0, 0, 0
472, 1, 1636411135886, 1636411136166, 280, 1, 279, 0, 0, 0
473, 1, 1636411135962, 1636411136238, 276, 1, 275, 0, 0, 0
474, 1, 1636411136062, 1636411136338, 276, 1, 275, 0, 1, 1
475, 1, 1636411136066, 1636411136510, 444, 173, 271, 173, 0, 173
476, 1, 1636411136447, 1636411136723, 276, 0, 276, 0, 0, 0
477, 1, 1636411136882, 1636411137158, 276, 1, 275, 0, 1, 1
478, 1, 1636411136958, 1636411137234, 276, 1, 275, 0, 0, 0
479, 1, 1636411137058, 1636411137334, 276, 1, 275, 0, 0, 0
480, 1, 1636411137082, 1636411137359, 277, 1, 276, 1, 0, 1
481, 1, 1636411137446, 1636411137723, 277, 1, 276, 0, 1, 1
482, 1, 1636411137858, 1636411138134, 276, 1, 275, 0, 0, 0
484, 1, 1636411138082, 1636411138359, 277, 0, 277, 0, 0, 0
485, 1, 1636411138094, 1636411138371, 277, 0, 277, 0, 0, 0
486, 1, 1636411138442, 1636411138719, 277, 1, 276, 0, 1, 1
487, 1, 1636411138875, 1636411139150, 275, 0, 275, 0, 0, 0
488, 1, 1636411139078, 1636411139354, 276, 1, 275, 0, 0, 0
489, 1, 1636411139094, 1636411139370, 276, 0, 276, 0, 0, 0
490, 1, 1636411139454, 1636411139731, 277, 1, 276, 0, 0, 0
491, 1, 1636411139870, 1636411140138, 268, 1, 267, 0, 0, 0
492, 1, 1636411140046, 1636411140323, 277, 0, 277, 0, 0, 0
493, 1, 1636411140078, 1636411140355, 277, 1, 276, 0, 0, 0
494, 1, 1636411140450, 1636411140722, 272, 1, 271, 0, 0, 0
496, 1, 1636411141022, 1636411141299, 277, 1, 276, 1, 0, 1
497, 1, 1636411141078, 1636411141354, 276, 1, 275, 0, 0, 0
499, 1, 1636411142014, 1636411142291, 277, 1, 276, 0, 0, 0
500, 1, 1636411142042, 1636411142567, 525, 249, 276, 248, 0, 248
501, 1, 1636411143006, 1636411143282, 276, 1, 275, 0, 0, 0
502, 1, 1636411143035, 1636411143310, 275, 0, 275, 0, 0, 0
503, 1, 1636411144022, 1636411144299, 277, 1, 276, 0, 0, 0
504, 1, 1636411144030, 1636411144307, 277, 1, 276, 0, 0, 0
505, 1, 1636411145014, 1636411145295, 281, 1, 280, 1, 0, 1
506, 1, 1636411145022, 1636411145303, 281, 1, 280, 0, 1, 1
508, 1, 1636411146042, 1636411146318, 276, 1, 275, 0, 0, 0
509, 1, 1636411147034, 1636411147310, 276, 0, 276, 0, 0, 0
483, 2, 1636411137926, 1636411147927, 10001, 0, 10001, 0, 0, 0
511, 1, 1636411148238, 1636411148510, 272, 1, 271, 0, 0, 0
512, 1, 1636411149130, 1636411149406, 276, 1, 275, 0, 0, 0
513, 1, 1636411150123, 1636411150398, 275, 0, 275, 0, 0, 0
495, 2, 1636411140843, 1636411150842, 9999, 0, 9999, 0, 0, 0
515, 1, 1636411151126, 1636411151402, 276, 1, 275, 0, 1, 1
498, 2, 1636411141418, 1636411151422, 10004, 0, 10004, 0, 0, 0
514, 1, 1636411151154, 1636411151470, 316, 0, 316, 0, 0, 0
516, 1, 1636411151723, 1636411151999, 276, 0, 276, 0, 0, 0
517, 1, 1636411152070, 1636411152346, 276, 1, 275, 0, 0, 0
518, 1, 1636411152134, 1636411152410, 276, 1, 275, 0, 1, 1
519, 1, 1636411152642, 1636411152919, 277, 1, 276, 0, 0, 0
520, 1, 1636411153058, 1636411153335, 277, 1, 276, 0, 0, 0
521, 1, 1636411153114, 1636411153390, 276, 1, 275, 0, 1, 1
522, 1, 1636411153630, 1636411153907, 277, 0, 277, 0, 0, 0
523, 1, 1636411154067, 1636411154346, 279, 0, 279, 0, 0, 0
524, 1, 1636411154150, 1636411154426, 276, 1, 275, 0, 0, 0
525, 1, 1636411154646, 1636411154923, 277, 1, 276, 0, 1, 1
526, 1, 1636411155090, 1636411155366, 276, 1, 275, 0, 0, 0
527, 1, 1636411155174, 1636411155450, 276, 1, 275, 0, 1, 1
528, 1, 1636411155651, 1636411155927, 276, 0, 276, 0, 0, 0
507, 2, 1636411145991, 1636411155986, 9995, 0, 9995, 0, 0, 0
529, 1, 1636411156078, 1636411156354, 276, 1, 275, 0, 0, 0
530, 1, 1636411156178, 1636411156450, 272, 0, 272, 0, 0, 0
531, 1, 1636411156302, 1636411156578, 276, 0, 276, 0, 0, 0
532, 1, 1636411156630, 1636411156907, 277, 0, 277, 0, 0, 0
533, 1, 1636411157070, 1636411157343, 273, 1, 272, 0, 0, 0
534, 1, 1636411157158, 1636411157435, 277, 1, 276, 0, 0, 0
535, 1, 1636411157218, 1636411157494, 276, 1, 275, 0, 0, 0
536, 1, 1636411157646, 1636411157919, 273, 1, 272, 0, 0, 0
510, 2, 1636411148014, 1636411158015, 10001, 0, 10001, 0, 0, 0
537, 1, 1636411158102, 1636411158378, 276, 1, 275, 0, 1, 1
538, 1, 1636411158190, 1636411158466, 276, 0, 276, 0, 0, 0
539, 1, 1636411158206, 1636411158482, 276, 0, 276, 0, 0, 0
540, 1, 1636411158322, 1636411158762, 440, 160, 280, 160, 0, 160
541, 1, 1636411158674, 1636411158954, 280, 1, 279, 0, 0, 0
542, 1, 1636411159070, 1636411159346, 276, 1, 275, 1, 0, 1
543, 1, 1636411159218, 1636411159495, 277, 1, 276, 0, 0, 0
544, 1, 1636411159218, 1636411159495, 277, 2, 275, 0, 0, 0
545, 1, 1636411159230, 1636411159771, 541, 266, 275, 265, 0, 265
546, 1, 1636411159678, 1636411159955, 277, 0, 277, 0, 0, 0
547, 1, 1636411160042, 1636411160318, 276, 1, 275, 0, 0, 0
548, 1, 1636411160222, 1636411160499, 277, 0, 277, 0, 0, 0
549, 1, 1636411160230, 1636411160502, 272, 0, 272, 0, 0, 0
550, 1, 1636411160250, 1636411160595, 345, 69, 276, 69, 0, 69
551, 1, 1636411160642, 1636411160919, 277, 0, 277, 0, 0, 0
552, 1, 1636411161051, 1636411161322, 271, 0, 271, 0, 0, 0
553, 1, 1636411161198, 1636411161474, 276, 1, 275, 0, 0, 0
554, 1, 1636411161238, 1636411161510, 272, 1, 271, 0, 0, 0
555, 1, 1636411161250, 1636411161526, 276, 0, 276, 0, 0, 0
556, 1, 1636411161678, 1636411161954, 276, 1, 275, 0, 0, 0
557, 1, 1636411162078, 1636411162354, 276, 1, 275, 0, 0, 0
558, 1, 1636411162234, 1636411162514, 280, 0, 280, 0, 0, 0
560, 1, 1636411162270, 1636411162550, 280, 1, 279, 0, 0, 0
561, 1, 1636411162711, 1636411162987, 276, 0, 276, 0, 0, 0
562, 1, 1636411163110, 1636411163386, 276, 1, 275, 0, 0, 0
563, 1, 1636411163262, 1636411163534, 272, 1, 271, 0, 0, 0
564, 1, 1636411163274, 1636411163550, 276, 0, 276, 0, 0, 0
565, 1, 1636411163742, 1636411164019, 277, 1, 276, 0, 0, 0
567, 1, 1636411164258, 1636411164534, 276, 0, 276, 0, 0, 0
570, 1, 1636411165234, 1636411165511, 277, 1, 276, 0, 0, 0
571, 1, 1636411166262, 1636411166539, 277, 0, 277, 0, 0, 0
572, 1, 1636411167294, 1636411167571, 277, 1, 276, 0, 0, 0
573, 1, 1636411168326, 1636411168602, 276, 1, 275, 0, 0, 0
559, 2, 1636411162270, 1636411172697, 10427, 245, 10182, 245, 2, 247
575, 1, 1636411173059, 1636411173334, 275, 0, 275, 0, 0, 0
566, 2, 1636411164090, 1636411174087, 9997, 0, 9997, 8606, 0, 8606
576, 1, 1636411173963, 1636411174238, 275, 0, 275, 0, 0, 0
568, 2, 1636411164290, 1636411174294, 10004, 0, 10004, 8408, 0, 8408
569, 2, 1636411164714, 1636411174719, 10005, 0, 10005, 7984, 0, 7984
577, 1, 1636411174983, 1636411175259, 276, 0, 276, 0, 0, 0
574, 2, 1636411169303, 1636411179303, 10000, 0, 10000, 3394, 0, 3394
578, 1, 1636411175954, 1636411179587, 3633, 3349, 284, 0, 3348, 3348
579, 1, 1636411179894, 1636411180167, 273, 0, 273, 0, 0, 0
580, 1, 1636411180002, 1636411180279, 277, 1, 276, 1, 0, 1
581, 1, 1636411180819, 1636411181095, 276, 0, 276, 0, 0, 0
582, 1, 1636411180939, 1636411181215, 276, 0, 276, 0, 0, 0
583, 1, 1636411181790, 1636411182067, 277, 1, 276, 0, 0, 0
584, 1, 1636411181938, 1636411182215, 277, 1, 276, 0, 0, 0
585, 1, 1636411182750, 1636411183030, 280, 0, 280, 0, 0, 0
588, 1, 1636411183006, 1636411183306, 300, 25, 275, 24, 1, 25
590, 1, 1636411183742, 1636411184019, 277, 1, 276, 1, 0, 1
591, 1, 1636411183918, 1636411184286, 368, 102, 266, 100, 0, 100
592, 1, 1636411184714, 1636411184990, 276, 1, 275, 0, 0, 0
593, 1, 1636411184906, 1636411185266, 360, 85, 275, 84, 0, 84
594, 1, 1636411185718, 1636411185995, 277, 1, 276, 0, 0, 0
595, 1, 1636411185894, 1636411186279, 385, 102, 283, 100, 0, 100
596, 1, 1636411186715, 1636411186990, 275, 0, 275, 0, 0, 0
597, 1, 1636411186882, 1636411187259, 377, 109, 268, 109, 0, 109
598, 1, 1636411187690, 1636411187967, 277, 1, 276, 0, 0, 0
599, 1, 1636411187862, 1636411188242, 380, 106, 274, 105, 0, 105
600, 1, 1636411188674, 1636411188951, 277, 1, 276, 0, 0, 0
601, 1, 1636411188839, 1636411189226, 387, 113, 274, 112, 0, 112
602, 1, 1636411189674, 1636411189951, 277, 1, 276, 0, 0, 0
603, 1, 1636411189811, 1636411190227, 416, 141, 275, 140, 1, 141
604, 1, 1636411190670, 1636411190947, 277, 1, 276, 0, 0, 0
605, 1, 1636411190834, 1636411191223, 389, 113, 276, 113, 0, 113
606, 1, 1636411191639, 1636411191915, 276, 0, 276, 0, 0, 0
607, 1, 1636411191826, 1636411192191, 365, 89, 276, 89, 0, 89
608, 1, 1636411192611, 1636411192887, 276, 0, 276, 0, 0, 0
586, 2, 1636411182958, 1636411192955, 9997, 0, 9997, 0, 0, 0
589, 2, 1636411183010, 1636411193006, 9996, 0, 9996, 0, 0, 0
587, 2, 1636411183010, 1636411193051, 10041, 0, 10041, 1, 0, 1
609, 1, 1636411192802, 1636411193191, 389, 85, 304, 84, 0, 84
610, 1, 1636411193274, 1636411193546, 272, 0, 272, 0, 0, 0
611, 1, 1636411193318, 1636411193590, 272, 1, 271, 0, 0, 0
612, 1, 1636411193318, 1636411193863, 545, 272, 273, 271, 0, 271
615, 1, 1636411194226, 1636411194498, 272, 1, 271, 0, 0, 0
618, 1, 1636411195231, 1636411195502, 271, 0, 271, 0, 0, 0
619, 1, 1636411196206, 1636411196482, 276, 1, 275, 0, 0, 0
620, 1, 1636411197187, 1636411197463, 276, 0, 276, 0, 0, 0
613, 2, 1636411193602, 1636411203606, 10004, 0, 10004, 0, 0, 0
614, 2, 1636411193790, 1636411203794, 10004, 0, 10004, 0, 0, 0
622, 1, 1636411203911, 1636411204182, 271, 0, 271, 0, 0, 0
617, 2, 1636411194246, 1636411204247, 10001, 0, 10001, 253, 0, 253
616, 2, 1636411194274, 1636411204295, 10021, 9973, 48, 225, 9749, 9974
623, 1, 1636411204094, 1636411204530, 436, 89, 347, 89, 0, 89
624, 1, 1636411204554, 1636411204826, 272, 1, 271, 1, 0, 1
626, 1, 1636411204838, 1636411205110, 272, 1, 271, 0, 0, 0
627, 1, 1636411205018, 1636411205386, 368, 93, 275, 92, 0, 92
628, 1, 1636411205482, 1636411205762, 280, 1, 279, 0, 0, 0
629, 1, 1636411205802, 1636411206082, 280, 1, 279, 0, 0, 0
630, 1, 1636411206006, 1636411206355, 349, 77, 272, 75, 0, 75
631, 1, 1636411206454, 1636411206726, 272, 0, 272, 0, 0, 0
632, 1, 1636411206814, 1636411207091, 277, 1, 276, 0, 0, 0
633, 1, 1636411207022, 1636411207366, 344, 69, 275, 69, 0, 69
634, 1, 1636411207471, 1636411207750, 279, 0, 279, 0, 0, 0
635, 1, 1636411207786, 1636411208058, 272, 0, 272, 0, 0, 0
621, 2, 1636411198174, 1636411208174, 10000, 0, 10000, 0, 0, 0
636, 1, 1636411208002, 1636411208334, 332, 57, 275, 57, 0, 57
637, 1, 1636411208486, 1636411208762, 276, 0, 276, 0, 0, 0
638, 1, 1636411208502, 1636411209031, 529, 261, 268, 260, 1, 261
639, 1, 1636411208806, 1636411209074, 268, 1, 267, 0, 0, 0
640, 1, 1636411209030, 1636411209351, 321, 45, 276, 44, 0, 44
643, 1, 1636411209807, 1636411210082, 275, 0, 275, 0, 0, 0
644, 1, 1636411210058, 1636411210359, 301, 25, 276, 24, 0, 24
645, 1, 1636411210779, 1636411211054, 275, 0, 275, 0, 0, 0
647, 1, 1636411211786, 1636411212063, 277, 1, 276, 0, 0, 0
648, 1, 1636411212802, 1636411213078, 276, 1, 275, 0, 0, 0
649, 1, 1636411213779, 1636411214055, 276, 0, 276, 0, 0, 0
625, 2, 1636411204602, 1636411214606, 10004, 0, 10004, 0, 0, 0
650, 1, 1636411214758, 1636411215034, 276, 1, 275, 0, 0, 0
651, 1, 1636411214910, 1636411215182, 272, 1, 271, 0, 1, 1
652, 1, 1636411215771, 1636411216046, 275, 0, 275, 0, 0, 0
641, 2, 1636411209410, 1636411219414, 10004, 0, 10004, 0, 0, 0
642, 2, 1636411209514, 1636411219510, 9996, 0, 9996, 0, 0, 0
655, 1, 1636411219714, 1636411219990, 276, 1, 275, 0, 0, 0
656, 1, 1636411219818, 1636411220267, 449, 173, 276, 173, 0, 173
657, 1, 1636411220622, 1636411220898, 276, 1, 275, 0, 0, 0
646, 2, 1636411211042, 1636411221147, 10105, 13, 10092, 12, 0, 12
658, 1, 1636411220742, 1636411221242, 500, 156, 344, 156, 0, 156
659, 1, 1636411221458, 1636411221734, 276, 1, 275, 0, 0, 0
660, 1, 1636411221606, 1636411221887, 281, 1, 280, 0, 0, 0
661, 1, 1636411221734, 1636411222167, 433, 153, 280, 153, 0, 153
662, 1, 1636411222358, 1636411222634, 276, 1, 275, 1, 0, 1
663, 1, 1636411222598, 1636411222874, 276, 1, 275, 1, 0, 1
664, 1, 1636411222734, 1636411223150, 416, 141, 275, 141, 0, 141
665, 1, 1636411223370, 1636411223642, 272, 1, 271, 0, 0, 0
668, 1, 1636411224390, 1636411224666, 276, 1, 275, 0, 0, 0
669, 1, 1636411225406, 1636411225678, 272, 1, 271, 0, 0, 0
653, 2, 1636411215834, 1636411225830, 9996, 0, 9996, 0, 0, 0
670, 1, 1636411226142, 1636411226418, 276, 1, 275, 0, 0, 0
671, 1, 1636411226386, 1636411226663, 277, 0, 277, 0, 0, 0
654, 2, 1636411216738, 1636411226742, 10004, 0, 10004, 0, 0, 0
672, 1, 1636411227046, 1636411227322, 276, 1, 275, 1, 0, 1
673, 1, 1636411227062, 1636411227338, 276, 0, 276, 0, 0, 0
674, 1, 1636411227398, 1636411227670, 272, 1, 271, 0, 0, 0
675, 1, 1636411227958, 1636411228226, 268, 1, 267, 0, 0, 0
676, 1, 1636411228086, 1636411228363, 277, 1, 276, 0, 0, 0
677, 1, 1636411228362, 1636411228634, 272, 1, 271, 0, 0, 0
678, 1, 1636411228962, 1636411229234, 272, 1, 271, 0, 0, 0
679, 1, 1636411229054, 1636411229330, 276, 1, 275, 0, 1, 1
680, 1, 1636411229370, 1636411229643, 273, 1, 272, 0, 0, 0
681, 1, 1636411229950, 1636411230230, 280, 0, 280, 0, 0, 0
682, 1, 1636411230086, 1636411230362, 276, 1, 275, 0, 0, 0
683, 1, 1636411230350, 1636411230626, 276, 1, 275, 0, 0, 0
684, 1, 1636411230970, 1636411231242, 272, 1, 271, 0, 0, 0
685, 1, 1636411231098, 1636411231370, 272, 1, 271, 0, 0, 0
686, 1, 1636411231370, 1636411231642, 272, 1, 271, 0, 0, 0
687, 1, 1636411231982, 1636411232255, 273, 0, 273, 0, 0, 0
689, 1, 1636411232394, 1636411232662, 268, 1, 267, 1, 0, 1
690, 1, 1636411232950, 1636411233226, 276, 1, 275, 0, 1, 1
666, 2, 1636411223606, 1636411233606, 10000, 0, 10000, 0, 0, 0
691, 1, 1636411233366, 1636411233654, 288, 1, 287, 1, 0, 1
667, 2, 1636411223758, 1636411233758, 10000, 0, 10000, 0, 0, 0
692, 1, 1636411233930, 1636411234202, 272, 0, 272, 0, 0, 0
694, 1, 1636411234066, 1636411234478, 412, 137, 275, 137, 0, 137
696, 1, 1636411234850, 1636411235127, 277, 1, 276, 0, 0, 0
697, 1, 1636411234994, 1636411235395, 401, 133, 268, 133, 0, 133
698, 1, 1636411235831, 1636411236107, 276, 0, 276, 0, 0, 0
699, 1, 1636411235986, 1636411236382, 396, 121, 275, 121, 0, 121
700, 1, 1636411236858, 1636411237135, 277, 1, 276, 0, 0, 0
701, 1, 1636411236990, 1636411237410, 420, 145, 275, 144, 0, 144
702, 1, 1636411237890, 1636411238167, 277, 1, 276, 0, 1, 1
703, 1, 1636411237994, 1636411238442, 448, 173, 275, 173, 0, 173
704, 1, 1636411238882, 1636411239158, 276, 1, 275, 0, 1, 1
705, 1, 1636411238994, 1636411239430, 436, 165, 271, 165, 0, 165
706, 1, 1636411239890, 1636411240163, 273, 1, 272, 1, 0, 1
708, 1, 1636411240862, 1636411241139, 277, 1, 276, 0, 0, 0
688, 2, 1636411232106, 1636411242110, 10004, 0, 10004, 0, 0, 0
709, 1, 1636411241878, 1636411242155, 277, 0, 277, 0, 0, 0
710, 1, 1636411242418, 1636411242694, 276, 1, 275, 0, 0, 0
711, 1, 1636411242886, 1636411243159, 273, 1, 272, 1, 0, 1
712, 1, 1636411243330, 1636411243607, 277, 1, 276, 0, 1, 1
693, 2, 1636411233914, 1636411243918, 10004, 0, 10004, 0, 0, 0
713, 1, 1636411243854, 1636411244151, 297, 1, 296, 0, 0, 0
695, 2, 1636411234330, 1636411244334, 10004, 0, 10004, 0, 0, 0
714, 1, 1636411244226, 1636411244503, 277, 1, 276, 0, 1, 1
715, 1, 1636411244314, 1636411244778, 464, 189, 275, 189, 0, 189
716, 1, 1636411244638, 1636411245054, 416, 141, 275, 141, 0, 141
717, 1, 1636411244874, 1636411245330, 456, 181, 275, 181, 0, 181
707, 2, 1636411240014, 1636411250255, 10241, 149, 10092, 148, 1, 149
722, 1, 1636411250566, 1636411250842, 276, 0, 276, 0, 0, 0
723, 1, 1636411251459, 1636411251731, 272, 0, 272, 0, 0, 0
724, 1, 1636411252467, 1636411252742, 275, 0, 275, 0, 0, 0
725, 1, 1636411253458, 1636411253730, 272, 0, 272, 0, 0, 0
726, 1, 1636411254446, 1636411254722, 276, 1, 275, 0, 0, 0
718, 2, 1636411245126, 1636411255126, 10000, 0, 10000, 0, 0, 0
719, 2, 1636411245298, 1636411255298, 10000, 0, 10000, 4957, 0, 4957
720, 2, 1636411245554, 1636411255554, 10000, 0, 10000, 0, 0, 0
728, 1, 1636411255434, 1636411255706, 272, 0, 272, 0, 0, 0
727, 1, 1636411255470, 1636411255782, 312, 0, 312, 0, 0, 0
721, 2, 1636411245878, 1636411255874, 9996, 0, 9996, 4377, 0, 4377
729, 1, 1636411255862, 1636411256138, 276, 0, 276, 0, 0, 0
730, 1, 1636411256182, 1636411256450, 268, 0, 268, 0, 0, 0
731, 1, 1636411256350, 1636411256622, 272, 0, 272, 0, 0, 0
732, 1, 1636411256458, 1636411256890, 432, 165, 267, 165, 0, 165
736, 1, 1636411257358, 1636411257634, 276, 0, 276, 0, 0, 0
737, 1, 1636411257474, 1636411257751, 277, 1, 276, 1, 0, 1
738, 1, 1636411258394, 1636411258666, 272, 1, 271, 1, 0, 1
739, 1, 1636411258490, 1636411258942, 452, 177, 275, 175, 1, 176
734, 2, 1636411256758, 1636411266762, 10004, 0, 10004, 133, 0, 133
733, 2, 1636411256758, 1636411266807, 10049, 0, 10049, 133, 0, 133
735, 2, 1636411257118, 1636411267114, 9996, 0, 9996, 0, 0, 0
741, 1, 1636411259482, 1636411267390, 7908, 7632, 276, 0, 7631, 7631
743, 1, 1636411267202, 1636411267478, 276, 1, 275, 0, 0, 0
742, 1, 1636411267202, 1636411267478, 276, 1, 275, 0, 0, 0
746, 1, 1636411268122, 1636411268395, 273, 1, 272, 0, 1, 1
740, 2, 1636411259378, 1636411269378, 10000, 0, 10000, 0, 0, 0
744, 2, 1636411267422, 1636411277570, 10148, 57, 10091, 57, 0, 57
745, 2, 1636411267786, 1636411277786, 10000, 0, 10000, 0, 0, 0
747, 2, 1636411268118, 1636411278122, 10004, 0, 10004, 0, 0, 0
749, 1, 1636411277878, 1636411278170, 292, 1, 291, 0, 0, 0
752, 1, 1636411278778, 1636411279054, 276, 0, 276, 0, 0, 0
748, 2, 1636411269126, 1636411279122, 9996, 0, 9996, 0, 0, 0
753, 1, 1636411279434, 1636411279706, 272, 1, 271, 1, 0, 1
750, 2, 1636411278094, 1636411288095, 10001, 0, 10001, 0, 0, 0
751, 2, 1636411278430, 1636411288426, 9996, 0, 9996, 0, 0, 0
756, 1, 1636411288394, 1636411288667, 273, 1, 272, 0, 1, 1
757, 1, 1636411289315, 1636411289586, 271, 0, 271, 0, 0, 0
754, 2, 1636411279774, 1636411289778, 10004, 0, 10004, 0, 0, 0
755, 2, 1636411280338, 1636411290338, 10000, 0, 10000, 0, 0, 0
758, 1, 1636411290082, 1636411290386, 304, 1, 303, 0, 0, 0
759, 1, 1636411290318, 1636411290590, 272, 0, 272, 0, 0, 0
760, 1, 1636411290650, 1636411290923, 273, 0, 273, 0, 0, 0
761, 1, 1636411291018, 1636411291290, 272, 1, 271, 1, 0, 1
762, 1, 1636411291298, 1636411291574, 276, 0, 276, 0, 0, 0
763, 1, 1636411291558, 1636411291830, 272, 1, 271, 1, 0, 1
764, 1, 1636411291990, 1636411292263, 273, 0, 273, 0, 0, 0
765, 1, 1636411292318, 1636411292590, 272, 1, 271, 0, 1, 1
766, 1, 1636411292563, 1636411292862, 299, 28, 271, 28, 0, 28
769, 1, 1636411293534, 1636411293807, 273, 1, 272, 1, 0, 1
770, 1, 1636411294550, 1636411294822, 272, 0, 272, 0, 0, 0
767, 2, 1636411292998, 1636411302998, 10000, 0, 10000, 0, 0, 0
768, 2, 1636411293334, 1636411303330, 9996, 0, 9996, 0, 0, 0
772, 1, 1636411303310, 1636411303587, 277, 0, 277, 0, 0, 0
774, 1, 1636411304202, 1636411304474, 272, 0, 272, 0, 0, 0
775, 1, 1636411305210, 1636411305482, 272, 1, 271, 0, 1, 1
771, 2, 1636411295566, 1636411305566, 10000, 0, 10000, 0, 0, 0
777, 1, 1636411306206, 1636411306478, 272, 1, 271, 1, 0, 1
778, 1, 1636411307186, 1636411307458, 272, 1, 271, 1, 0, 1
779, 1, 1636411308158, 1636411308434, 276, 1, 275, 0, 1, 1
780, 1, 1636411309186, 1636411309458, 272, 1, 271, 0, 1, 1
781, 1, 1636411310206, 1636411310478, 272, 0, 272, 0, 0, 0
782, 1, 1636411311222, 1636411311494, 272, 0, 272, 0, 0, 0
783, 1, 1636411312207, 1636411312478, 271, 0, 271, 0, 0, 0
784, 1, 1636411313214, 1636411313487, 273, 1, 272, 1, 0, 1
773, 2, 1636411303638, 1636411313638, 10000, 0, 10000, 0, 0, 0
785, 1, 1636411313946, 1636411314218, 272, 1, 271, 0, 0, 0
786, 1, 1636411314178, 1636411314446, 268, 1, 267, 0, 0, 0
788, 1, 1636411315178, 1636411315454, 276, 0, 276, 0, 0, 0
776, 2, 1636411305875, 1636411315878, 10003, 0, 10003, 0, 0, 0
790, 1, 1636411316162, 1636411316438, 276, 0, 276, 0, 0, 0
791, 1, 1636411317182, 1636411317455, 273, 1, 272, 0, 0, 0
787, 2, 1636411314875, 1636411324875, 10000, 0, 10000, 0, 0, 0
789, 2, 1636411316182, 1636411326530, 10348, 257, 10091, 257, 0, 257
794, 1, 1636411326838, 1636411327114, 276, 1, 275, 0, 0, 0
792, 2, 1636411318198, 1636411328199, 10001, 0, 10001, 0, 0, 0
793, 2, 1636411325182, 1636411335182, 10000, 0, 10000, 0, 0, 0
797, 1, 1636411335490, 1636411335763, 273, 0, 273, 0, 0, 0
795, 2, 1636411327743, 1636411337743, 10000, 0, 10000, 0, 0, 0
798, 1, 1636411338050, 1636411338318, 268, 0, 268, 0, 0, 0
796, 2, 1636411328506, 1636411338506, 10000, 0, 10000, 0, 0, 0
799, 1, 1636411338814, 1636411339086, 272, 1, 271, 0, 0, 0
800, 2, 1636411339742, 1636411349742, 10000, 0, 10000, 0, 0, 0
801, 2, 1636411649902, 1636411659902, 10000, 0, 10000, 0, 0, 0
802, 2, 1636411650598, 1636411660598, 10000, 0, 10000, 0, 0, 0
803, 2, 1636411651022, 1636411661022, 10000, 0, 10000, 0, 0, 0
804, 2, 1636411652003, 1636411662002, 9999, 0, 9999, 0, 0, 0
805, 2, 1636411652834, 1636411662835, 10001, 0, 10001, 0, 0, 0
806, 2, 1636411660210, 1636411670210, 10000, 0, 10000, 0, 0, 0
807, 2, 1636411660906, 1636411670906, 10000, 0, 10000, 0, 0, 0
808, 2, 1636411661330, 1636411671330, 10000, 0, 10000, 0, 0, 0
809, 2, 1636411662310, 1636411672311, 10001, 0, 10001, 0, 0, 0
810, 2, 1636411663146, 1636411673146, 10000, 0, 10000, 0, 0, 0
811, 2, 1636411670518, 1636411680518, 10000, 0, 10000, 0, 0, 0
812, 2, 1636411671214, 1636411681214, 10000, 0, 10000, 0, 0, 0
813, 2, 1636411671638, 1636411681638, 10000, 0, 10000, 0, 0, 0
814, 2, 1636411672618, 1636411682618, 10000, 0, 10000, 0, 0, 0
815, 2, 1636411673458, 1636411683458, 10000, 0, 10000, 0, 0, 0
816, 2, 1636411680822, 1636411690826, 10004, 0, 10004, 0, 0, 0
821, 1, 1636411691130, 1636411691402, 272, 1, 271, 0, 0, 0
817, 2, 1636411681526, 1636411691526, 10000, 0, 10000, 0, 0, 0
818, 2, 1636411681938, 1636411691938, 10000, 0, 10000, 0, 0, 0
822, 1, 1636411691798, 1636411692074, 276, 1, 275, 0, 0, 0
823, 1, 1636411691835, 1636411692102, 267, 0, 267, 0, 0, 0
824, 1, 1636411692246, 1636411692518, 272, 1, 271, 0, 0, 0
825, 1, 1636411692474, 1636411692746, 272, 1, 271, 1, 0, 1
826, 1, 1636411692506, 1636411692770, 264, 0, 264, 0, 0, 0
819, 2, 1636411682922, 1636411692922, 10000, 0, 10000, 0, 0, 0
827, 1, 1636411692966, 1636411693230, 264, 1, 263, 0, 1, 1
828, 1, 1636411693150, 1636411693418, 268, 0, 268, 0, 0, 0
829, 1, 1636411693182, 1636411693446, 264, 1, 263, 0, 0, 0
830, 1, 1636411693230, 1636411693494, 264, 0, 264, 0, 0, 0
820, 2, 1636411683766, 1636411693767, 10001, 0, 10001, 0, 0, 0
831, 1, 1636411693622, 1636411693902, 280, 1, 279, 0, 1, 1
833, 1, 1636411693858, 1636411694122, 264, 0, 264, 0, 0, 0
834, 1, 1636411693902, 1636411694166, 264, 0, 264, 0, 0, 0
835, 1, 1636411694074, 1636411694338, 264, 0, 264, 0, 0, 0
836, 1, 1636411694298, 1636411694566, 268, 1, 267, 0, 0, 0
838, 1, 1636411694558, 1636411694826, 268, 1, 267, 1, 0, 1
839, 1, 1636411694730, 1636411694994, 264, 0, 264, 0, 0, 0
841, 1, 1636411695226, 1636411695490, 264, 1, 263, 0, 1, 1
842, 1, 1636411695398, 1636411695662, 264, 1, 263, 0, 0, 0
844, 1, 1636411696062, 1636411696326, 264, 1, 263, 0, 0, 0
832, 2, 1636411693858, 1636411703858, 10000, 0, 10000, 0, 0, 0
846, 1, 1636411704162, 1636411704426, 264, 0, 264, 0, 0, 0
837, 2, 1636411694514, 1636411704514, 10000, 0, 10000, 0, 0, 0
840, 2, 1636411694962, 1636411704962, 10000, 0, 10000, 0, 0, 0
847, 1, 1636411704814, 1636411705098, 284, 1, 283, 0, 0, 0
849, 1, 1636411705270, 1636411705542, 272, 1, 271, 1, 0, 1
843, 2, 1636411695894, 1636411705895, 10001, 0, 10001, 0, 0, 0
852, 1, 1636411706202, 1636411706470, 268, 1, 267, 1, 0, 1
845, 2, 1636411696726, 1636411706726, 10000, 0, 10000, 0, 0, 0
854, 1, 1636411707034, 1636411707303, 269, 1, 268, 0, 1, 1
848, 2, 1636411704830, 1636411714830, 10000, 0, 10000, 0, 0, 0
850, 2, 1636411705499, 1636411715502, 10003, 0, 10003, 0, 0, 0
851, 2, 1636411705942, 1636411715942, 10000, 0, 10000, 0, 0, 0
853, 2, 1636411706902, 1636411716903, 10001, 0, 10001, 0, 0, 0
855, 2, 1636411707706, 1636411717707, 10001, 0, 10001, 0, 0, 0
856, 2, 1636411715138, 1636411725138, 10000, 0, 10000, 0, 0, 0
857, 2, 1636411715806, 1636411725807, 10001, 0, 10001, 0, 0, 0
858, 2, 1636411716246, 1636411726246, 10000, 0, 10000, 0, 0, 0
859, 2, 1636411717206, 1636411727207, 10001, 0, 10001, 0, 0, 0
860, 2, 1636411718018, 1636411728018, 10000, 0, 10000, 0, 0, 0
861, 2, 1636411725446, 1636411735446, 10000, 0, 10000, 0, 0, 0
866, 1, 1636411735754, 1636411736018, 264, 0, 264, 0, 0, 0
862, 2, 1636411726114, 1636411736114, 10000, 0, 10000, 0, 0, 0
863, 2, 1636411726550, 1636411736551, 10001, 0, 10001, 0, 0, 0
868, 1, 1636411736422, 1636411736686, 264, 0, 264, 0, 0, 0
869, 1, 1636411736858, 1636411737126, 268, 0, 268, 0, 0, 0
864, 2, 1636411727514, 1636411737514, 10000, 0, 10000, 0, 0, 0
872, 1, 1636411737822, 1636411738091, 269, 1, 268, 0, 0, 0
865, 2, 1636411728330, 1636411738330, 10000, 0, 10000, 0, 0, 0
874, 1, 1636411738642, 1636411738907, 265, 1, 264, 0, 1, 1
867, 2, 1636411736418, 1636411746419, 10001, 0, 10001, 0, 0, 0
870, 2, 1636411737086, 1636411747086, 10000, 0, 10000, 0, 0, 0
871, 2, 1636411737562, 1636411747563, 10001, 0, 10001, 0, 0, 0
873, 2, 1636411738510, 1636411748510, 10000, 0, 10000, 0, 0, 0
875, 2, 1636411739310, 1636411749310, 10000, 0, 10000, 0, 0, 0
876, 2, 1636411746726, 1636411756726, 10000, 0, 10000, 0, 0, 0
881, 1, 1636411757034, 1636411757298, 264, 1, 263, 0, 0, 0
877, 2, 1636411747390, 1636411757386, 9996, 0, 9996, 0, 0, 0
878, 2, 1636411747866, 1636411757866, 10000, 0, 10000, 0, 0, 0
882, 1, 1636411757694, 1636411758002, 308, 1, 307, 0, 1, 1
883, 1, 1636411757698, 1636411758006, 308, 1, 307, 0, 1, 1
884, 1, 1636411758174, 1636411758442, 268, 1, 267, 0, 0, 0
886, 1, 1636411758402, 1636411758670, 268, 1, 267, 0, 0, 0
879, 2, 1636411748818, 1636411758818, 10000, 0, 10000, 0, 0, 0
887, 1, 1636411758862, 1636411759126, 264, 0, 264, 0, 0, 0
889, 1, 1636411759122, 1636411759394, 272, 1, 271, 1, 0, 1
880, 2, 1636411749618, 1636411759618, 10000, 0, 10000, 0, 0, 0
891, 1, 1636411759798, 1636411760070, 272, 0, 272, 0, 0, 0
892, 1, 1636411759934, 1636411760202, 268, 1, 267, 1, 0, 1
894, 1, 1636411760603, 1636411760870, 267, 0, 267, 0, 0, 0
885, 2, 1636411758402, 1636411768402, 10000, 0, 10000, 0, 0, 0
888, 2, 1636411759066, 1636411769067, 10001, 0, 10001, 0, 0, 0
890, 2, 1636411759526, 1636411769526, 10000, 0, 10000, 0, 0, 0
893, 2, 1636411760475, 1636411770474, 9999, 0, 9999, 0, 0, 0
895, 2, 1636411761270, 1636411771270, 10000, 0, 10000, 0, 0, 0
896, 2, 1636411768710, 1636411778711, 10001, 0, 10001, 0, 0, 0
901, 1, 1636411779022, 1636411779294, 272, 1, 271, 1, 0, 1
897, 2, 1636411769370, 1636411779371, 10001, 0, 10001, 0, 0, 0
898, 2, 1636411769830, 1636411779830, 10000, 0, 10000, 0, 0, 0
902, 1, 1636411779678, 1636411779966, 288, 0, 288, 0, 0, 0
903, 1, 1636411779690, 1636411779966, 276, 1, 275, 0, 0, 0
904, 1, 1636411780138, 1636411780402, 264, 0, 264, 0, 0, 0
906, 1, 1636411780366, 1636411780630, 264, 0, 264, 0, 0, 0
899, 2, 1636411770786, 1636411780787, 10001, 0, 10001, 0, 0, 0
907, 1, 1636411780834, 1636411781098, 264, 0, 264, 0, 0, 0
909, 1, 1636411781094, 1636411781358, 264, 1, 263, 0, 0, 0
900, 2, 1636411771578, 1636411781579, 10001, 0, 10001, 0, 0, 0
911, 1, 1636411781762, 1636411782034, 272, 1, 271, 0, 1, 1
912, 1, 1636411781890, 1636411782154, 264, 1, 263, 0, 0, 0
914, 1, 1636411782558, 1636411782830, 272, 1, 271, 0, 0, 0
905, 2, 1636411780366, 1636411790367, 10001, 0, 10001, 0, 0, 0
908, 2, 1636411781030, 1636411791030, 10000, 0, 10000, 0, 0, 0
910, 2, 1636411781502, 1636411791502, 10000, 0, 10000, 0, 0, 0
913, 2, 1636411782438, 1636411792439, 10001, 0, 10001, 0, 0, 0
915, 2, 1636411783230, 1636411793231, 10001, 0, 10001, 0, 0, 0
916, 2, 1636411790678, 1636411800678, 10000, 0, 10000, 0, 0, 0
921, 1, 1636411800986, 1636411801254, 268, 1, 267, 0, 0, 0
917, 2, 1636411791334, 1636411801334, 10000, 0, 10000, 0, 0, 0
918, 2, 1636411791810, 1636411801810, 10000, 0, 10000, 0, 0, 0
922, 1, 1636411801638, 1636411801946, 308, 0, 308, 0, 0, 0
924, 1, 1636411802122, 1636411802386, 264, 1, 263, 0, 0, 0
919, 2, 1636411792746, 1636411802746, 10000, 0, 10000, 0, 0, 0
927, 1, 1636411803050, 1636411803314, 264, 0, 264, 0, 0, 0
920, 2, 1636411793542, 1636411803542, 10000, 0, 10000, 0, 0, 0
929, 1, 1636411803854, 1636411804122, 268, 1, 267, 0, 1, 1
923, 2, 1636411801658, 1636411811659, 10001, 0, 10001, 0, 0, 0
925, 2, 1636411802346, 1636411812346, 10000, 0, 10000, 0, 0, 0
926, 2, 1636411802790, 1636411812794, 10004, 0, 10004, 0, 0, 0
928, 2, 1636411803722, 1636411813723, 10001, 0, 10001, 0, 0, 0
930, 2, 1636411804522, 1636411814522, 10000, 0, 10000, 0, 0, 0
931, 2, 1636411811966, 1636411821967, 10001, 0, 10001, 0, 0, 0
932, 2, 1636411812650, 1636411822651, 10001, 0, 10001, 0, 0, 0
933, 2, 1636411813098, 1636411823099, 10001, 0, 10001, 0, 0, 0
934, 2, 1636411814026, 1636411824026, 10000, 0, 10000, 0, 0, 0
935, 2, 1636411814834, 1636411824835, 10001, 0, 10001, 0, 0, 0
936, 2, 1636411822274, 1636411832274, 10000, 0, 10000, 0, 0, 0
941, 1, 1636411832582, 1636411832850, 268, 1, 267, 1, 0, 1
937, 2, 1636411822958, 1636411832958, 10000, 0, 10000, 0, 0, 0
938, 2, 1636411823402, 1636411833402, 10000, 0, 10000, 0, 0, 0
943, 1, 1636411833266, 1636411833538, 272, 0, 272, 0, 0, 0
942, 1, 1636411833254, 1636411833538, 284, 1, 283, 0, 0, 0
944, 1, 1636411833714, 1636411833978, 264, 0, 264, 0, 0, 0
945, 1, 1636411833938, 1636411834207, 269, 1, 268, 1, 0, 1
939, 2, 1636411824334, 1636411834334, 10000, 0, 10000, 0, 0, 0
947, 1, 1636411834382, 1636411834646, 264, 0, 264, 0, 0, 0
949, 1, 1636411834642, 1636411834910, 268, 0, 268, 0, 0, 0
940, 2, 1636411825146, 1636411835147, 10001, 0, 10001, 0, 0, 0
951, 1, 1636411835326, 1636411835594, 268, 1, 267, 0, 0, 0
952, 1, 1636411835462, 1636411835731, 269, 1, 268, 1, 0, 1
954, 1, 1636411836126, 1636411836394, 268, 1, 267, 1, 0, 1
946, 2, 1636411833938, 1636411843939, 10001, 0, 10001, 0, 0, 0
948, 2, 1636411834610, 1636411844610, 10000, 0, 10000, 0, 0, 0
950, 2, 1636411835042, 1636411845042, 10000, 0, 10000, 0, 0, 0
953, 2, 1636411835990, 1636411845991, 10001, 0, 10001, 0, 0, 0
955, 2, 1636411836794, 1636411846794, 10000, 0, 10000, 0, 0, 0
956, 2, 1636411844246, 1636411854247, 10001, 0, 10001, 0, 0, 0
961, 1, 1636411854554, 1636411854822, 268, 1, 267, 1, 0, 1
957, 2, 1636411844918, 1636411854918, 10000, 0, 10000, 0, 0, 0
958, 2, 1636411845346, 1636411855350, 10004, 0, 10004, 0, 0, 0
962, 1, 1636411855222, 1636411855486, 264, 1, 263, 0, 0, 0
963, 1, 1636411855234, 1636411855498, 264, 0, 264, 0, 0, 0
964, 1, 1636411855650, 1636411855914, 264, 0, 264, 0, 0, 0
965, 1, 1636411855890, 1636411856155, 265, 0, 265, 0, 0, 0
966, 1, 1636411855898, 1636411856162, 264, 1, 263, 0, 0, 0
959, 2, 1636411846302, 1636411856302, 10000, 0, 10000, 0, 0, 0
967, 1, 1636411856350, 1636411856614, 264, 0, 264, 0, 0, 0
968, 1, 1636411856554, 1636411856818, 264, 1, 263, 0, 1, 1
969, 1, 1636411856554, 1636411856826, 272, 0, 272, 0, 0, 0
970, 1, 1636411856606, 1636411856870, 264, 0, 264, 0, 0, 0
960, 2, 1636411847106, 1636411857103, 9997, 0, 9997, 0, 0, 0
971, 1, 1636411857010, 1636411857274, 264, 0, 264, 0, 0, 0
973, 1, 1636411857226, 1636411857490, 264, 1, 263, 1, 0, 1
974, 1, 1636411857282, 1636411857546, 264, 0, 264, 0, 0, 0
975, 1, 1636411857418, 1636411857682, 264, 0, 264, 0, 0, 0
976, 1, 1636411857674, 1636411857938, 264, 0, 264, 0, 0, 0
978, 1, 1636411857938, 1636411858203, 265, 1, 264, 1, 0, 1
979, 1, 1636411858083, 1636411858350, 267, 0, 267, 0, 0, 0
981, 1, 1636411858606, 1636411858870, 264, 1, 263, 0, 1, 1
982, 1, 1636411858750, 1636411859018, 268, 1, 267, 0, 0, 0
984, 1, 1636411859418, 1636411859686, 268, 1, 267, 1, 0, 1
972, 2, 1636411857214, 1636411867214, 10000, 0, 10000, 0, 0, 0
986, 1, 1636411867522, 1636411867794, 272, 1, 271, 1, 0, 1
977, 2, 1636411857886, 1636411867886, 10000, 0, 10000, 0, 0, 0
980, 2, 1636411858338, 1636411868338, 10000, 0, 10000, 0, 0, 0
988, 1, 1636411868194, 1636411868478, 284, 1, 283, 0, 1, 1
987, 1, 1636411868190, 1636411868478, 288, 1, 287, 0, 0, 0
989, 1, 1636411868642, 1636411868914, 272, 1, 271, 0, 0, 0
990, 1, 1636411868874, 1636411869138, 264, 1, 263, 1, 0, 1
983, 2, 1636411859274, 1636411869274, 10000, 0, 10000, 0, 0, 0
992, 1, 1636411869322, 1636411869586, 264, 0, 264, 0, 0, 0
994, 1, 1636411869582, 1636411869846, 264, 1, 263, 0, 1, 1
985, 2, 1636411860086, 1636411870087, 10001, 0, 10001, 0, 0, 0
996, 1, 1636411870262, 1636411870530, 268, 1, 267, 1, 0, 1
997, 1, 1636411870394, 1636411870658, 264, 0, 264, 0, 0, 0
999, 1, 1636411871062, 1636411871331, 269, 0, 269, 0, 0, 0
991, 2, 1636411868874, 1636411878875, 10001, 0, 10001, 0, 0, 0
993, 2, 1636411869538, 1636411879538, 10000, 0, 10000, 0, 0, 0
995, 2, 1636411869990, 1636411879990, 10000, 0, 10000, 0, 0, 0
998, 2, 1636411870926, 1636411880927, 10001, 0, 10001, 0, 0, 0
1000, 2, 1636411871730, 1636411881730, 10000, 0, 10000, 0, 0, 0
1001, 2, 1636411879182, 1636411889182, 10000, 0, 10000, 0, 0, 0
1006, 1, 1636411889490, 1636411889755, 265, 1, 264, 1, 0, 1
1002, 2, 1636411879842, 1636411889842, 10000, 0, 10000, 0, 0, 0
1003, 2, 1636411880294, 1636411890298, 10004, 0, 10004, 0, 0, 0
1007, 1, 1636411890146, 1636411890434, 288, 0, 288, 0, 0, 0
1008, 1, 1636411890162, 1636411890434, 272, 1, 271, 0, 1, 1
1009, 1, 1636411890602, 1636411890866, 264, 0, 264, 0, 0, 0
1011, 1, 1636411890830, 1636411891098, 268, 1, 267, 1, 0, 1
1004, 2, 1636411881238, 1636411891234, 9996, 0, 9996, 0, 0, 0
1012, 1, 1636411891282, 1636411891547, 265, 0, 265, 0, 0, 0
1014, 1, 1636411891546, 1636411891818, 272, 1, 271, 0, 0, 0
1005, 2, 1636411882042, 1636411892042, 10000, 0, 10000, 0, 0, 0
1016, 1, 1636411892218, 1636411892483, 265, 1, 264, 0, 1, 1
1017, 1, 1636411892354, 1636411892618, 264, 1, 263, 0, 0, 0
1019, 1, 1636411893022, 1636411893291, 269, 1, 268, 0, 0, 0
1010, 2, 1636411890830, 1636411900831, 10001, 0, 10001, 0, 0, 0
1021, 1, 1636411901138, 1636411901406, 268, 1, 267, 1, 0, 1
1013, 2, 1636411891494, 1636411901494, 10000, 0, 10000, 0, 0, 0
1015, 2, 1636411891954, 1636411901954, 10000, 0, 10000, 0, 0, 0
1023, 1, 1636411901814, 1636411902090, 276, 1, 275, 1, 0, 1
1022, 1, 1636411901798, 1636411902090, 292, 1, 291, 0, 0, 0
1024, 1, 1636411902266, 1636411902530, 264, 0, 264, 0, 0, 0
1025, 1, 1636411902486, 1636411902754, 268, 1, 267, 0, 0, 0
1018, 2, 1636411892882, 1636411902882, 10000, 0, 10000, 0, 0, 0
1026, 1, 1636411902494, 1636411903026, 532, 261, 271, 261, 0, 261
1027, 1, 1636411902930, 1636411903294, 364, 97, 267, 97, 0, 97
1028, 1, 1636411903158, 1636411903422, 264, 1, 263, 0, 0, 0
1030, 1, 1636411903422, 1636411903686, 264, 1, 263, 0, 0, 0
1020, 2, 1636411893694, 1636411903694, 10000, 0, 10000, 0, 0, 0
1029, 1, 1636411903190, 1636411903742, 552, 233, 319, 233, 0, 233
1031, 1, 1636411903742, 1636411904006, 264, 0, 264, 0, 0, 0
1032, 1, 1636411903874, 1636411904150, 276, 0, 276, 0, 0, 0
1033, 1, 1636411904006, 1636411904274, 268, 0, 268, 0, 0, 0
1035, 1, 1636411904138, 1636411904402, 264, 0, 264, 0, 0, 0
1034, 1, 1636411904086, 1636411904546, 460, 189, 271, 189, 0, 189
1036, 1, 1636411904402, 1636411904822, 420, 145, 275, 145, 0, 145
1038, 1, 1636411904674, 1636411904938, 264, 0, 264, 0, 0, 0
1039, 1, 1636411904802, 1636411905206, 404, 137, 267, 137, 0, 137
1040, 1, 1636411904942, 1636411905210, 268, 0, 268, 0, 0, 0
1041, 1, 1636411905230, 1636411905498, 268, 0, 268, 0, 0, 0
1042, 1, 1636411905330, 1636411905594, 264, 0, 264, 0, 0, 0
1043, 1, 1636411905594, 1636411905862, 268, 1, 267, 0, 1, 1
1046, 1, 1636411905994, 1636411906258, 264, 0, 264, 0, 0, 0
1047, 1, 1636411906258, 1636411906526, 268, 1, 267, 0, 1, 1
1048, 1, 1636411906658, 1636411906926, 268, 1, 267, 1, 0, 1
1037, 2, 1636411904542, 1636411914543, 10001, 0, 10001, 0, 0, 0
1044, 2, 1636411905594, 1636411915595, 10001, 0, 10001, 0, 0, 0
1045, 2, 1636411905898, 1636411915899, 10001, 0, 10001, 0, 0, 0
1049, 2, 1636411906926, 1636411916927, 10001, 0, 10001, 0, 0, 0
1050, 2, 1636411907326, 1636411917327, 10001, 0, 10001, 0, 0, 0
1051, 1, 1636412139787, 1636412140059, 272, 0, 272, 0, 0, 0
1053, 1, 1636412140446, 1636412140714, 268, 1, 267, 1, 0, 1
1054, 1, 1636412141038, 1636412141306, 268, 0, 268, 0, 0, 0
1057, 1, 1636412141722, 1636412141994, 272, 1, 271, 0, 0, 0
1059, 1, 1636412142546, 1636412142815, 269, 1, 268, 1, 0, 1
1052, 2, 1636412140462, 1636412150462, 10000, 0, 10000, 0, 0, 0
1055, 2, 1636412141110, 1636412151114, 10004, 0, 10004, 0, 0, 0
1056, 2, 1636412141710, 1636412151710, 10000, 0, 10000, 0, 0, 0
1058, 2, 1636412142398, 1636412152399, 10001, 0, 10001, 0, 0, 0
1060, 2, 1636412143218, 1636412153218, 10000, 0, 10000, 0, 0, 0
1061, 2, 1636412150770, 1636412160770, 10000, 0, 10000, 0, 0, 0
1062, 2, 1636412151419, 1636412161418, 9999, 0, 9999, 0, 0, 0
1063, 2, 1636412152018, 1636412162018, 10000, 0, 10000, 0, 0, 0
1064, 2, 1636412152706, 1636412162706, 10000, 0, 10000, 0, 0, 0
1065, 2, 1636412153534, 1636412163534, 10000, 0, 10000, 0, 0, 0
1066, 2, 1636412161078, 1636412171079, 10001, 0, 10001, 0, 0, 0
1071, 1, 1636412171386, 1636412171659, 273, 0, 273, 0, 0, 0
1067, 2, 1636412161722, 1636412171722, 10000, 0, 10000, 0, 0, 0
1072, 1, 1636412172026, 1636412172290, 264, 1, 263, 0, 0, 0
1068, 2, 1636412162326, 1636412172326, 10000, 0, 10000, 0, 0, 0
1073, 1, 1636412172062, 1636412172374, 312, 0, 312, 0, 0, 0
1074, 1, 1636412172634, 1636412172906, 272, 1, 271, 1, 0, 1
1075, 1, 1636412172686, 1636412172954, 268, 0, 268, 0, 0, 0
1069, 2, 1636412163006, 1636412173006, 10000, 0, 10000, 0, 0, 0
1076, 1, 1636412172774, 1636412173054, 280, 0, 280, 0, 0, 0
1077, 1, 1636412173306, 1636412173570, 264, 0, 264, 0, 0, 0
1078, 1, 1636412173314, 1636412173582, 268, 1, 267, 0, 1, 1
1079, 1, 1636412173350, 1636412173614, 264, 0, 264, 0, 0, 0
1080, 1, 1636412173446, 1636412173710, 264, 0, 264, 0, 0, 0
1070, 2, 1636412163846, 1636412173846, 10000, 0, 10000, 0, 0, 0
1081, 1, 1636412173970, 1636412174238, 268, 1, 267, 0, 0, 0
1082, 1, 1636412174022, 1636412174290, 268, 1, 267, 0, 1, 1
1083, 1, 1636412174022, 1636412174290, 268, 1, 267, 0, 1, 1
1084, 1, 1636412174110, 1636412174378, 268, 1, 267, 0, 0, 0
1085, 1, 1636412174158, 1636412174422, 264, 0, 264, 0, 0, 0
1086, 1, 1636412174638, 1636412174902, 264, 0, 264, 0, 0, 0
1088, 1, 1636412174690, 1636412174958, 268, 1, 267, 0, 1, 1
1087, 1, 1636412174690, 1636412174958, 268, 1, 267, 0, 1, 1
1089, 1, 1636412174774, 1636412175038, 264, 0, 264, 0, 0, 0
1090, 1, 1636412174810, 1636412175074, 264, 0, 264, 0, 0, 0
1091, 1, 1636412175298, 1636412175562, 264, 0, 264, 0, 0, 0
1092, 1, 1636412175354, 1636412175618, 264, 0, 264, 0, 0, 0
1093, 1, 1636412175362, 1636412175626, 264, 0, 264, 0, 0, 0
1094, 1, 1636412175430, 1636412175694, 264, 0, 264, 0, 0, 0
1095, 1, 1636412175474, 1636412175738, 264, 0, 264, 0, 0, 0
1096, 1, 1636412175958, 1636412176230, 272, 0, 272, 0, 0, 0
1097, 1, 1636412176014, 1636412176278, 264, 0, 264, 0, 0, 0
1098, 1, 1636412176018, 1636412176286, 268, 1, 267, 0, 1, 1
1100, 1, 1636412176130, 1636412176394, 264, 0, 264, 0, 0, 0
1101, 1, 1636412176630, 1636412176894, 264, 0, 264, 0, 0, 0
1102, 1, 1636412176682, 1636412176946, 264, 0, 264, 0, 0, 0
1104, 1, 1636412176794, 1636412177058, 264, 0, 264, 0, 0, 0
1106, 1, 1636412177338, 1636412177602, 264, 1, 263, 0, 0, 0
1107, 1, 1636412177462, 1636412177730, 268, 1, 267, 0, 0, 0
1109, 1, 1636412178130, 1636412178394, 264, 1, 263, 1, 0, 1
1099, 2, 1636412176090, 1636412186091, 10001, 0, 10001, 0, 0, 0
1103, 2, 1636412176686, 1636412186686, 10000, 0, 10000, 0, 0, 0
1105, 2, 1636412177294, 1636412187294, 10000, 0, 10000, 0, 0, 0
1108, 2, 1636412178002, 1636412188002, 10000, 0, 10000, 0, 0, 0
1110, 2, 1636412178794, 1636412188794, 10000, 0, 10000, 0, 0, 0
1111, 2, 1636412186394, 1636412196395, 10001, 0, 10001, 0, 0, 0
1116, 1, 1636412196702, 1636412196974, 272, 1, 271, 1, 0, 1
1112, 2, 1636412186986, 1636412196990, 10004, 0, 10004, 0, 0, 0
1117, 1, 1636412197290, 1636412197562, 272, 0, 272, 0, 0, 0
1113, 2, 1636412187598, 1636412197598, 10000, 0, 10000, 0, 0, 0
1118, 1, 1636412197374, 1636412197646, 272, 0, 272, 0, 0, 0
1119, 1, 1636412197906, 1636412198175, 269, 0, 269, 0, 0, 0
1120, 1, 1636412197962, 1636412198226, 264, 1, 263, 0, 1, 1
1114, 2, 1636412188310, 1636412198310, 10000, 0, 10000, 0, 0, 0
1122, 1, 1636412198578, 1636412198842, 264, 0, 264, 0, 0, 0
1123, 1, 1636412198618, 1636412198886, 268, 1, 267, 0, 1, 1
1115, 2, 1636412189110, 1636412199110, 10000, 0, 10000, 0, 0, 0
1126, 1, 1636412199286, 1636412199550, 264, 1, 263, 0, 0, 0
1127, 1, 1636412199418, 1636412199682, 264, 0, 264, 0, 0, 0
1129, 1, 1636412200078, 1636412200346, 268, 1, 267, 0, 0, 0
1121, 2, 1636412198038, 1636412208038, 10000, 0, 10000, 0, 0, 0
1131, 1, 1636412208346, 1636412208618, 272, 0, 272, 0, 0, 0
1124, 2, 1636412198630, 1636412208626, 9996, 0, 9996, 0, 0, 0
1132, 1, 1636412208938, 1636412209206, 268, 0, 268, 0, 0, 0
1125, 2, 1636412199238, 1636412209238, 10000, 0, 10000, 0, 0, 0
1133, 1, 1636412209018, 1636412209286, 268, 0, 268, 0, 0, 0
1134, 1, 1636412209546, 1636412209814, 268, 0, 268, 0, 0, 0
1135, 1, 1636412209602, 1636412209866, 264, 0, 264, 0, 0, 0
1128, 2, 1636412199946, 1636412209946, 10000, 0, 10000, 0, 0, 0
1136, 1, 1636412209678, 1636412209994, 316, 0, 316, 0, 0, 0
1137, 1, 1636412210214, 1636412210478, 264, 0, 264, 0, 0, 0
1138, 1, 1636412210254, 1636412210518, 264, 0, 264, 0, 0, 0
1139, 1, 1636412210266, 1636412210534, 268, 1, 267, 0, 0, 0
1140, 1, 1636412210390, 1636412210654, 264, 1, 263, 0, 0, 0
1130, 2, 1636412200750, 1636412210750, 10000, 0, 10000, 0, 0, 0
1141, 1, 1636412210874, 1636412211138, 264, 1, 263, 0, 1, 1
1143, 1, 1636412210926, 1636412211194, 268, 1, 267, 1, 0, 1
1142, 1, 1636412210926, 1636412211198, 272, 1, 271, 1, 0, 1
1144, 1, 1636412211050, 1636412211314, 264, 0, 264, 0, 0, 0
1145, 1, 1636412211054, 1636412211318, 264, 0, 264, 0, 0, 0
1146, 1, 1636412211538, 1636412211806, 268, 0, 268, 0, 0, 0
1147, 1, 1636412211582, 1636412211846, 264, 0, 264, 0, 0, 0
1148, 1, 1636412211594, 1636412211866, 272, 0, 272, 0, 0, 0
1149, 1, 1636412211714, 1636412211978, 264, 0, 264, 0, 0, 0
1150, 1, 1636412211714, 1636412211982, 268, 0, 268, 0, 0, 0
1151, 1, 1636412212198, 1636412212466, 268, 1, 267, 0, 1, 1
1152, 1, 1636412212238, 1636412212502, 264, 0, 264, 0, 0, 0
1153, 1, 1636412212258, 1636412212522, 264, 0, 264, 0, 0, 0
1154, 1, 1636412212370, 1636412212634, 264, 0, 264, 0, 0, 0
1155, 1, 1636412212370, 1636412212634, 264, 0, 264, 0, 0, 0
1156, 1, 1636412212874, 1636412213146, 272, 1, 271, 0, 0, 0
1157, 1, 1636412212902, 1636412213166, 264, 0, 264, 0, 0, 0
1158, 1, 1636412212914, 1636412213178, 264, 0, 264, 0, 0, 0
1159, 1, 1636412213030, 1636412213298, 268, 0, 268, 0, 0, 0
1161, 1, 1636412213542, 1636412213806, 264, 1, 263, 1, 0, 1
1162, 1, 1636412213562, 1636412213826, 264, 1, 263, 0, 1, 1
1164, 1, 1636412213702, 1636412213966, 264, 1, 263, 0, 0, 0
1166, 1, 1636412214222, 1636412214490, 268, 1, 267, 0, 1, 1
1167, 1, 1636412214366, 1636412214634, 268, 1, 267, 0, 0, 0
1169, 1, 1636412215034, 1636412215306, 272, 1, 271, 1, 0, 1
1160, 2, 1636412213034, 1636412223034, 10000, 0, 10000, 0, 0, 0
1163, 2, 1636412213582, 1636412223582, 10000, 0, 10000, 0, 0, 0
1171, 1, 1636412223338, 1636412223630, 292, 1, 291, 1, 0, 1
1172, 1, 1636412223890, 1636412224162, 272, 1, 271, 0, 0, 0
1165, 2, 1636412214214, 1636412224214, 10000, 0, 10000, 0, 0, 0
1174, 1, 1636412224522, 1636412224794, 272, 0, 272, 0, 0, 0
1168, 2, 1636412214894, 1636412224894, 10000, 0, 10000, 0, 0, 0
1177, 1, 1636412225202, 1636412225466, 264, 1, 263, 0, 0, 0
1170, 2, 1636412215706, 1636412225706, 10000, 0, 10000, 0, 0, 0
1179, 1, 1636412226018, 1636412226282, 264, 0, 264, 0, 0, 0
1173, 2, 1636412224030, 1636412234039, 10009, 0, 10009, 0, 0, 0
1175, 2, 1636412224566, 1636412234566, 10000, 0, 10000, 0, 0, 0
1181, 1, 1636412234339, 1636412234614, 275, 0, 275, 0, 0, 0
1182, 1, 1636412234870, 1636412235138, 268, 1, 267, 0, 1, 1
1176, 2, 1636412225194, 1636412235194, 10000, 0, 10000, 0, 0, 0
1183, 1, 1636412235014, 1636412235326, 312, 1, 311, 0, 0, 0
1184, 1, 1636412235502, 1636412235766, 264, 0, 264, 0, 0, 0
1185, 1, 1636412235538, 1636412235802, 264, 0, 264, 0, 0, 0
1178, 2, 1636412225882, 1636412235882, 10000, 0, 10000, 0, 0, 0
1186, 1, 1636412235726, 1636412236018, 292, 0, 292, 0, 0, 0
1187, 1, 1636412236170, 1636412236434, 264, 0, 264, 0, 0, 0
1188, 1, 1636412236190, 1636412236454, 264, 0, 264, 0, 0, 0
1189, 1, 1636412236206, 1636412236474, 268, 0, 268, 0, 0, 0
1180, 2, 1636412226678, 1636412236678, 10000, 0, 10000, 0, 0, 0
1190, 1, 1636412236422, 1636412236726, 304, 0, 304, 0, 0, 0
1191, 1, 1636412236854, 1636412237118, 264, 1, 263, 0, 0, 0
1192, 1, 1636412236858, 1636412237122, 264, 0, 264, 0, 0, 0
1193, 1, 1636412236874, 1636412237138, 264, 0, 264, 0, 0, 0
1194, 1, 1636412236990, 1636412237254, 264, 0, 264, 0, 0, 0
1195, 1, 1636412237122, 1636412237390, 268, 0, 268, 0, 0, 0
1196, 1, 1636412237522, 1636412237786, 264, 0, 264, 0, 0, 0
1197, 1, 1636412237522, 1636412237794, 272, 0, 272, 0, 0, 0
1198, 1, 1636412237542, 1636412237806, 264, 0, 264, 0, 0, 0
1199, 1, 1636412237654, 1636412237919, 265, 0, 265, 0, 0, 0
1200, 1, 1636412237802, 1636412238070, 268, 1, 267, 0, 0, 0
1201, 1, 1636412238186, 1636412238450, 264, 1, 263, 0, 1, 1
1202, 1, 1636412238194, 1636412238458, 264, 0, 264, 0, 0, 0
1203, 1, 1636412238214, 1636412238482, 268, 0, 268, 0, 0, 0
1204, 1, 1636412238326, 1636412238598, 272, 0, 272, 0, 0, 0
1205, 1, 1636412238474, 1636412238742, 268, 0, 268, 0, 0, 0
1206, 1, 1636412238846, 1636412239114, 268, 1, 267, 0, 0, 0
1207, 1, 1636412238854, 1636412239122, 268, 0, 268, 0, 0, 0
1208, 1, 1636412238874, 1636412239138, 264, 0, 264, 0, 0, 0
1209, 1, 1636412238998, 1636412239262, 264, 0, 264, 0, 0, 0
1210, 1, 1636412239138, 1636412239402, 264, 0, 264, 0, 0, 0
1211, 1, 1636412239506, 1636412239770, 264, 0, 264, 0, 0, 0
1212, 1, 1636412239510, 1636412239778, 268, 0, 268, 0, 0, 0
1213, 1, 1636412239530, 1636412239794, 264, 0, 264, 0, 0, 0
1214, 1, 1636412239654, 1636412239918, 264, 0, 264, 0, 0, 0
1215, 1, 1636412239806, 1636412240071, 265, 0, 265, 0, 0, 0
1216, 1, 1636412240170, 1636412240434, 264, 1, 263, 0, 1, 1
1217, 1, 1636412240178, 1636412240442, 264, 0, 264, 0, 0, 0
1218, 1, 1636412240198, 1636412240474, 276, 0, 276, 0, 0, 0
1219, 1, 1636412240314, 1636412240582, 268, 0, 268, 0, 0, 0
1220, 1, 1636412240474, 1636412240742, 268, 1, 267, 1, 0, 1
1221, 1, 1636412240830, 1636412241094, 264, 0, 264, 0, 0, 0
1222, 1, 1636412240842, 1636412241110, 268, 0, 268, 0, 0, 0
1223, 1, 1636412240874, 1636412241138, 264, 0, 264, 0, 0, 0
1224, 1, 1636412240978, 1636412241242, 264, 0, 264, 0, 0, 0
1225, 1, 1636412241138, 1636412241406, 268, 0, 268, 0, 0, 0
1227, 1, 1636412241498, 1636412241762, 264, 0, 264, 0, 0, 0
1226, 1, 1636412241502, 1636412241766, 264, 0, 264, 0, 0, 0
1228, 1, 1636412241534, 1636412241798, 264, 0, 264, 0, 0, 0
1229, 1, 1636412241634, 1636412241903, 269, 0, 269, 0, 0, 0
1230, 1, 1636412241806, 1636412242070, 264, 0, 264, 0, 0, 0
1231, 1, 1636412242158, 1636412242422, 264, 0, 264, 0, 0, 0
1232, 1, 1636412242170, 1636412242442, 272, 1, 271, 0, 1, 1
1233, 1, 1636412242198, 1636412242462, 264, 0, 264, 0, 0, 0
1234, 1, 1636412242298, 1636412242562, 264, 0, 264, 0, 0, 0
1235, 1, 1636412242462, 1636412242726, 264, 0, 264, 0, 0, 0
1236, 1, 1636412242822, 1636412243090, 268, 0, 268, 0, 0, 0
1237, 1, 1636412242846, 1636412243110, 264, 0, 264, 0, 0, 0
1238, 1, 1636412242870, 1636412243134, 264, 0, 264, 0, 0, 0
1239, 1, 1636412242958, 1636412243222, 264, 0, 264, 0, 0, 0
1240, 1, 1636412243130, 1636412243394, 264, 1, 263, 0, 0, 0
1241, 1, 1636412243486, 1636412243750, 264, 0, 264, 0, 0, 0
1242, 1, 1636412243502, 1636412243766, 264, 0, 264, 0, 0, 0
1243, 1, 1636412243530, 1636412243794, 264, 0, 264, 0, 0, 0
1244, 1, 1636412243618, 1636412243882, 264, 0, 264, 0, 0, 0
1245, 1, 1636412243802, 1636412244066, 264, 0, 264, 0, 0, 0
1246, 1, 1636412244146, 1636412244414, 268, 1, 267, 1, 0, 1
1247, 1, 1636412244170, 1636412244434, 264, 1, 263, 0, 0, 0
1248, 1, 1636412244198, 1636412244462, 264, 0, 264, 0, 0, 0
1249, 1, 1636412244282, 1636412244546, 264, 0, 264, 0, 0, 0
1250, 1, 1636412244462, 1636412244726, 264, 1, 263, 0, 1, 1
1251, 1, 1636412244810, 1636412245074, 264, 0, 264, 0, 0, 0
1252, 1, 1636412244834, 1636412245098, 264, 0, 264, 0, 0, 0
1253, 1, 1636412244854, 1636412245118, 264, 0, 264, 0, 0, 0
1254, 1, 1636412244950, 1636412245218, 268, 1, 267, 1, 0, 1
1255, 1, 1636412245118, 1636412245382, 264, 0, 264, 0, 0, 0
1256, 1, 1636412245466, 1636412245730, 264, 1, 263, 0, 1, 1
1257, 1, 1636412245494, 1636412245758, 264, 0, 264, 0, 0, 0
1258, 1, 1636412245518, 1636412245782, 264, 0, 264, 0, 0, 0
1259, 1, 1636412245618, 1636412245883, 265, 0, 265, 0, 0, 0
1261, 1, 1636412246130, 1636412246394, 264, 0, 264, 0, 0, 0
1262, 1, 1636412246162, 1636412246430, 268, 1, 267, 0, 1, 1
1264, 1, 1636412246286, 1636412246554, 268, 1, 267, 0, 0, 0
1266, 1, 1636412246834, 1636412247098, 264, 1, 263, 0, 0, 0
1267, 1, 1636412246958, 1636412247226, 268, 1, 267, 0, 0, 0
1269, 1, 1636412247630, 1636412247898, 268, 1, 267, 0, 1, 1
1260, 2, 1636412245786, 1636412255786, 10000, 0, 10000, 0, 0, 0
1263, 2, 1636412246174, 1636412256174, 10000, 0, 10000, 0, 0, 0
1271, 1, 1636412256090, 1636412256398, 308, 1, 307, 0, 0, 0
1272, 1, 1636412256478, 1636412256746, 268, 1, 267, 0, 1, 1
1265, 2, 1636412246802, 1636412256802, 10000, 0, 10000, 0, 0, 0
1273, 1, 1636412256850, 1636412257118, 268, 0, 268, 0, 0, 0
1274, 1, 1636412257110, 1636412257378, 268, 1, 267, 0, 0, 0
1275, 1, 1636412257146, 1636412257418, 272, 1, 271, 0, 0, 0
1268, 2, 1636412247490, 1636412257490, 10000, 0, 10000, 0, 0, 0
1276, 1, 1636412257534, 1636412257798, 264, 1, 263, 0, 0, 0
1277, 1, 1636412257774, 1636412258038, 264, 0, 264, 0, 0, 0
1278, 1, 1636412257798, 1636412258062, 264, 0, 264, 0, 0, 0
1279, 1, 1636412257818, 1636412258082, 264, 0, 264, 0, 0, 0
1270, 2, 1636412248294, 1636412258294, 10000, 0, 10000, 0, 0, 0
1280, 1, 1636412258190, 1636412258454, 264, 0, 264, 0, 0, 0
1283, 1, 1636412258470, 1636412258734, 264, 0, 264, 0, 0, 0
1281, 1, 1636412258470, 1636412258734, 264, 0, 264, 0, 0, 0
1282, 1, 1636412258470, 1636412258746, 276, 0, 276, 0, 0, 0
1284, 1, 1636412258602, 1636412258870, 268, 1, 267, 1, 0, 1
1285, 1, 1636412258854, 1636412259118, 264, 0, 264, 0, 0, 0
1286, 1, 1636412259130, 1636412259394, 264, 0, 264, 0, 0, 0
1287, 1, 1636412259138, 1636412259410, 272, 1, 271, 1, 0, 1
1288, 1, 1636412259138, 1636412259410, 272, 1, 271, 1, 0, 1
1289, 1, 1636412259274, 1636412259538, 264, 1, 263, 1, 0, 1
1290, 1, 1636412259514, 1636412259786, 272, 1, 271, 1, 0, 1
1291, 1, 1636412259794, 1636412260058, 264, 0, 264, 0, 0, 0
1292, 1, 1636412259810, 1636412260078, 268, 0, 268, 0, 0, 0
1293, 1, 1636412259810, 1636412260082, 272, 0, 272, 0, 0, 0
1294, 1, 1636412259942, 1636412260206, 264, 1, 263, 0, 0, 0
1295, 1, 1636412260458, 1636412260726, 268, 1, 267, 0, 1, 1
1296, 1, 1636412260486, 1636412260754, 268, 1, 267, 0, 0, 0
1297, 1, 1636412260610, 1636412260886, 276, 1, 275, 1, 0, 1
1298, 1, 1636412261150, 1636412261414, 264, 1, 263, 1, 0, 1
1299, 1, 1636412261286, 1636412261558, 272, 1, 271, 1, 0, 1
1300, 1, 1636412261962, 1636412262234, 272, 1, 271, 0, 0, 0
1301, 1, 1636412824554, 1636412824822, 268, 1, 267, 0, 0, 0
1302, 1, 1636412825138, 1636412825402, 264, 1, 263, 0, 0, 0
1303, 1, 1636412825218, 1636412825482, 264, 1, 263, 0, 0, 0
1304, 1, 1636412825798, 1636412826062, 264, 1, 263, 0, 1, 1
1305, 1, 1636412825806, 1636412826070, 264, 0, 264, 0, 0, 0
1308, 1, 1636412826478, 1636412826742, 264, 1, 263, 0, 0, 0
1309, 1, 1636412826510, 1636412826774, 264, 1, 263, 0, 1, 1
1311, 1, 1636412827170, 1636412827434, 264, 0, 264, 0, 0, 0
1312, 1, 1636412827214, 1636412827478, 264, 0, 264, 0, 0, 0
1314, 1, 1636412827874, 1636412828138, 264, 1, 263, 0, 1, 1
1306, 2, 1636412825878, 1636412835879, 10001, 0, 10001, 0, 0, 0
1316, 1, 1636412836186, 1636412836450, 264, 1, 263, 0, 0, 0
1307, 2, 1636412826458, 1636412836462, 10004, 0, 10004, 0, 0, 0
1317, 1, 1636412836762, 1636412837030, 268, 0, 268, 0, 0, 0
1318, 1, 1636412836850, 1636412837114, 264, 1, 263, 0, 0, 0
1310, 2, 1636412827138, 1636412837138, 10000, 0, 10000, 0, 0, 0
1319, 1, 1636412837426, 1636412837690, 264, 1, 263, 0, 0, 0
1320, 1, 1636412837446, 1636412837710, 264, 0, 264, 0, 0, 0
1321, 1, 1636412837510, 1636412837774, 264, 0, 264, 0, 0, 0
1313, 2, 1636412827830, 1636412837830, 10000, 0, 10000, 0, 0, 0
1322, 1, 1636412838086, 1636412838350, 264, 1, 263, 1, 0, 1
1323, 1, 1636412838106, 1636412838370, 264, 1, 263, 0, 0, 0
1324, 1, 1636412838134, 1636412838402, 268, 0, 268, 0, 0, 0
1325, 1, 1636412838170, 1636412838434, 264, 0, 264, 0, 0, 0
1315, 2, 1636412828534, 1636412838534, 10000, 0, 10000, 0, 0, 0
1326, 1, 1636412838750, 1636412839018, 268, 0, 268, 0, 0, 0
1327, 1, 1636412838766, 1636412839034, 268, 0, 268, 0, 0, 0
1328, 1, 1636412838798, 1636412839062, 264, 0, 264, 0, 0, 0
1329, 1, 1636412838834, 1636412839098, 264, 0, 264, 0, 0, 0
1330, 1, 1636412838850, 1636412839118, 268, 0, 268, 0, 0, 0
1331, 1, 1636412839414, 1636412839678, 264, 0, 264, 0, 0, 0
1332, 1, 1636412839434, 1636412839698, 264, 1, 263, 0, 0, 0
1333, 1, 1636412839458, 1636412839722, 264, 0, 264, 0, 0, 0
1334, 1, 1636412839494, 1636412839758, 264, 0, 264, 0, 0, 0
1335, 1, 1636412839514, 1636412839778, 264, 0, 264, 0, 0, 0
1336, 1, 1636412840078, 1636412840342, 264, 0, 264, 0, 0, 0
1337, 1, 1636412840098, 1636412840362, 264, 1, 263, 0, 1, 1
1338, 1, 1636412840118, 1636412840390, 272, 0, 272, 0, 0, 0
1339, 1, 1636412840158, 1636412840422, 264, 0, 264, 0, 0, 0
1340, 1, 1636412840174, 1636412840438, 264, 0, 264, 0, 0, 0
1341, 1, 1636412840742, 1636412841007, 265, 0, 265, 0, 0, 0
1342, 1, 1636412840758, 1636412841022, 264, 1, 263, 0, 0, 0
1343, 1, 1636412840786, 1636412841050, 264, 0, 264, 0, 0, 0
1344, 1, 1636412840818, 1636412841082, 264, 0, 264, 0, 0, 0
1345, 1, 1636412840838, 1636412841102, 264, 1, 263, 0, 0, 0
1346, 1, 1636412841406, 1636412841670, 264, 1, 263, 0, 0, 0
1347, 1, 1636412841426, 1636412841690, 264, 0, 264, 0, 0, 0
1348, 1, 1636412841450, 1636412841714, 264, 0, 264, 0, 0, 0
1350, 1, 1636412841502, 1636412841766, 264, 0, 264, 0, 0, 0
1352, 1, 1636412842086, 1636412842350, 264, 0, 264, 0, 0, 0
1353, 1, 1636412842114, 1636412842378, 264, 1, 263, 0, 0, 0
1354, 1, 1636412842162, 1636412842426, 264, 0, 264, 0, 0, 0
1356, 1, 1636412842774, 1636412843038, 264, 1, 263, 0, 0, 0
1357, 1, 1636412842822, 1636412843086, 264, 0, 264, 0, 0, 0
1359, 1, 1636412843482, 1636412843746, 264, 1, 263, 1, 0, 1
1349, 2, 1636412841478, 1636412851478, 10000, 0, 10000, 0, 0, 0
1361, 1, 1636412851786, 1636412852050, 264, 0, 264, 0, 0, 0
1351, 2, 1636412842066, 1636412852066, 10000, 0, 10000, 0, 0, 0
1362, 1, 1636412852374, 1636412852638, 264, 1, 263, 0, 1, 1
1363, 1, 1636412852446, 1636412852710, 264, 0, 264, 0, 0, 0
1355, 2, 1636412842750, 1636412852750, 10000, 0, 10000, 0, 0, 0
1364, 1, 1636412853042, 1636412853306, 264, 0, 264, 0, 0, 0
1365, 1, 1636412853054, 1636412853318, 264, 0, 264, 0, 0, 0
1366, 1, 1636412853106, 1636412853370, 264, 1, 263, 0, 0, 0
1358, 2, 1636412843434, 1636412853434, 10000, 0, 10000, 0, 0, 0
1367, 1, 1636412853702, 1636412853966, 264, 1, 263, 0, 0, 0
1368, 1, 1636412853718, 1636412853982, 264, 0, 264, 0, 0, 0
1369, 1, 1636412853738, 1636412854002, 264, 1, 263, 0, 0, 0
1360, 2, 1636412844142, 1636412854142, 10000, 0, 10000, 0, 0, 0
1370, 1, 1636412853770, 1636412854278, 508, 232, 276, 232, 0, 232
1371, 1, 1636412854362, 1636412854626, 264, 0, 264, 0, 0, 0
1372, 1, 1636412854374, 1636412854638, 264, 0, 264, 0, 0, 0
1373, 1, 1636412854402, 1636412854666, 264, 1, 263, 0, 1, 1
1374, 1, 1636412854450, 1636412854890, 440, 177, 263, 177, 0, 177
1375, 1, 1636412854674, 1636412854946, 272, 1, 271, 0, 0, 0
1376, 1, 1636412855022, 1636412855286, 264, 0, 264, 0, 0, 0
1377, 1, 1636412855034, 1636412855298, 264, 1, 263, 0, 1, 1
1378, 1, 1636412855070, 1636412855334, 264, 0, 264, 0, 0, 0
1379, 1, 1636412855286, 1636412855550, 264, 0, 264, 0, 0, 0
1380, 1, 1636412855342, 1636412855606, 264, 0, 264, 0, 0, 0
1381, 1, 1636412855682, 1636412855946, 264, 0, 264, 0, 0, 0
1382, 1, 1636412855702, 1636412855966, 264, 1, 263, 0, 1, 1
1383, 1, 1636412855734, 1636412855998, 264, 1, 263, 0, 0, 0
1384, 1, 1636412855946, 1636412856210, 264, 0, 264, 0, 0, 0
1385, 1, 1636412856002, 1636412856474, 472, 209, 263, 209, 0, 209
1387, 1, 1636412856362, 1636412856626, 264, 1, 263, 0, 1, 1
1388, 1, 1636412856398, 1636412856662, 264, 1, 263, 1, 0, 1
1386, 1, 1636412856342, 1636412856746, 404, 132, 272, 132, 0, 132
1389, 1, 1636412856606, 1636412856870, 264, 0, 264, 0, 0, 0
1390, 1, 1636412856874, 1636412857138, 264, 0, 264, 0, 0, 0
1391, 1, 1636412857026, 1636412857294, 268, 1, 267, 0, 0, 0
1392, 1, 1636412857058, 1636412857330, 272, 1, 271, 0, 1, 1
1393, 1, 1636412857146, 1636412857410, 264, 0, 264, 0, 0, 0
1394, 1, 1636412857270, 1636412857534, 264, 0, 264, 0, 0, 0
1395, 1, 1636412857534, 1636412857798, 264, 0, 264, 0, 0, 0
1396, 1, 1636412857690, 1636412857954, 264, 1, 263, 0, 1, 1
1397, 1, 1636412857730, 1636412857994, 264, 1, 263, 1, 0, 1
1398, 1, 1636412857806, 1636412858070, 264, 1, 263, 0, 0, 0
1399, 1, 1636412857930, 1636412858194, 264, 0, 264, 0, 0, 0
1400, 1, 1636412858194, 1636412858462, 268, 1, 267, 0, 0, 0
1401, 1, 1636412858354, 1636412858618, 264, 0, 264, 0, 0, 0
1402, 1, 1636412858390, 1636412858654, 264, 0, 264, 0, 0, 0
1403, 1, 1636412858462, 1636412858726, 264, 0, 264, 0, 0, 0
1404, 1, 1636412858594, 1636412858858, 264, 0, 264, 0, 0, 0
1405, 1, 1636412858858, 1636412859122, 264, 0, 264, 0, 0, 0
1406, 1, 1636412859014, 1636412859278, 264, 0, 264, 0, 0, 0
1407, 1, 1636412859050, 1636412859314, 264, 0, 264, 0, 0, 0
1408, 1, 1636412859122, 1636412859390, 268, 1, 267, 1, 0, 1
1409, 1, 1636412859254, 1636412859518, 264, 1, 263, 0, 0, 0
1411, 1, 1636412859674, 1636412859938, 264, 0, 264, 0, 0, 0
1412, 1, 1636412859710, 1636412859974, 264, 1, 263, 0, 0, 0
1414, 1, 1636412859914, 1636412860182, 268, 1, 267, 1, 0, 1
1416, 1, 1636412860370, 1636412860634, 264, 1, 263, 0, 0, 0
1417, 1, 1636412860578, 1636412860842, 264, 0, 264, 0, 0, 0
1419, 1, 1636412861238, 1636412861506, 268, 1, 267, 0, 0, 0
1410, 2, 1636412859526, 1636412869526, 10000, 0, 10000, 0, 0, 0
1413, 2, 1636412859790, 1636412869790, 10000, 0, 10000, 0, 0, 0
1421, 1, 1636412869838, 1636412870102, 264, 0, 264, 0, 0, 0
1415, 2, 1636412860338, 1636412870338, 10000, 0, 10000, 0, 0, 0
1422, 1, 1636412870094, 1636412870386, 292, 9, 283, 8, 0, 8
1424, 1, 1636412870642, 1636412870906, 264, 0, 264, 0, 0, 0
1418, 2, 1636412861030, 1636412871030, 10000, 0, 10000, 0, 0, 0
1427, 1, 1636412871334, 1636412871598, 264, 0, 264, 0, 0, 0
1420, 2, 1636412861902, 1636412871902, 10000, 0, 10000, 0, 0, 0
1429, 1, 1636412872210, 1636412872478, 268, 1, 267, 0, 0, 0
1423, 2, 1636412870518, 1636412880518, 10000, 0, 10000, 0, 0, 0
1425, 2, 1636412870782, 1636412880782, 10000, 0, 10000, 0, 0, 0
1431, 1, 1636412880830, 1636412881094, 264, 0, 264, 0, 0, 0
1426, 2, 1636412871302, 1636412881302, 10000, 0, 10000, 0, 0, 0
1432, 1, 1636412881086, 1636412881358, 272, 8, 264, 8, 0, 8
1433, 1, 1636412881490, 1636412881755, 265, 0, 265, 0, 0, 0
1434, 1, 1636412881606, 1636412881870, 264, 1, 263, 0, 1, 1
1428, 2, 1636412871994, 1636412881994, 10000, 0, 10000, 0, 0, 0
1435, 1, 1636412881754, 1636412882042, 288, 1, 287, 0, 0, 0
1436, 1, 1636412882174, 1636412882438, 264, 0, 264, 0, 0, 0
1437, 1, 1636412882270, 1636412882538, 268, 0, 268, 0, 0, 0
1438, 1, 1636412882298, 1636412882566, 268, 1, 267, 0, 1, 1
1439, 1, 1636412882438, 1636412882702, 264, 1, 263, 1, 0, 1
1430, 2, 1636412872874, 1636412882874, 10000, 0, 10000, 0, 0, 0
1440, 1, 1636412882834, 1636412883098, 264, 1, 263, 0, 0, 0
1441, 1, 1636412882966, 1636412883230, 264, 1, 263, 0, 0, 0
1442, 1, 1636412882966, 1636412883230, 264, 1, 263, 0, 0, 0
1443, 1, 1636412883098, 1636412883374, 276, 0, 276, 0, 0, 0
1444, 1, 1636412883182, 1636412883446, 264, 1, 263, 0, 0, 0
1445, 1, 1636412883498, 1636412883762, 264, 0, 264, 0, 0, 0
1447, 1, 1636412883626, 1636412883890, 264, 1, 263, 0, 1, 1
1446, 1, 1636412883626, 1636412883890, 264, 1, 263, 0, 1, 1
1448, 1, 1636412883770, 1636412884034, 264, 0, 264, 0, 0, 0
1449, 1, 1636412883842, 1636412884106, 264, 0, 264, 0, 0, 0
1450, 1, 1636412884158, 1636412884426, 268, 0, 268, 0, 0, 0
1452, 1, 1636412884290, 1636412884554, 264, 1, 263, 1, 0, 1
1451, 1, 1636412884290, 1636412884554, 264, 1, 263, 1, 0, 1
1453, 1, 1636412884434, 1636412884702, 268, 0, 268, 0, 0, 0
1454, 1, 1636412884506, 1636412884770, 264, 1, 263, 0, 1, 1
1455, 1, 1636412884822, 1636412885086, 264, 0, 264, 0, 0, 0
1456, 1, 1636412884950, 1636412885214, 264, 0, 264, 0, 0, 0
1457, 1, 1636412884950, 1636412885214, 264, 0, 264, 0, 0, 0
1458, 1, 1636412885098, 1636412885362, 264, 0, 264, 0, 0, 0
1459, 1, 1636412885166, 1636412885430, 264, 1, 263, 0, 0, 0
1460, 1, 1636412885490, 1636412885754, 264, 1, 263, 0, 0, 0
1461, 1, 1636412885610, 1636412885874, 264, 0, 264, 0, 0, 0
1462, 1, 1636412885614, 1636412885882, 268, 0, 268, 0, 0, 0
1463, 1, 1636412885766, 1636412886034, 268, 1, 267, 0, 0, 0
1464, 1, 1636412885826, 1636412886090, 264, 1, 263, 0, 0, 0
1465, 1, 1636412886154, 1636412886418, 264, 1, 263, 0, 1, 1
1466, 1, 1636412886270, 1636412886538, 268, 1, 267, 0, 1, 1
1467, 1, 1636412886278, 1636412886542, 264, 1, 263, 0, 0, 0
1468, 1, 1636412886434, 1636412886698, 264, 0, 264, 0, 0, 0
1469, 1, 1636412886486, 1636412886754, 268, 0, 268, 0, 0, 0
1470, 1, 1636412886814, 1636412887078, 264, 0, 264, 0, 0, 0
1472, 1, 1636412886938, 1636412887202, 264, 0, 264, 0, 0, 0
1471, 1, 1636412886938, 1636412887202, 264, 0, 264, 0, 0, 0
1473, 1, 1636412887102, 1636412887366, 264, 1, 263, 0, 0, 0
1474, 1, 1636412887150, 1636412887414, 264, 0, 264, 0, 0, 0
1475, 1, 1636412887474, 1636412887742, 268, 1, 267, 1, 0, 1
1476, 1, 1636412887598, 1636412887862, 264, 1, 263, 0, 1, 1
1477, 1, 1636412887598, 1636412887862, 264, 1, 263, 0, 0, 0
1478, 1, 1636412887762, 1636412888026, 264, 0, 264, 0, 0, 0
1479, 1, 1636412887810, 1636412888074, 264, 1, 263, 0, 0, 0
1480, 1, 1636412888138, 1636412888402, 264, 1, 263, 0, 1, 1
1482, 1, 1636412888258, 1636412888522, 264, 1, 263, 1, 0, 1
1481, 1, 1636412888258, 1636412888522, 264, 1, 263, 0, 0, 0
1483, 1, 1636412888422, 1636412888686, 264, 1, 263, 0, 0, 0
1484, 1, 1636412888474, 1636412888738, 264, 1, 263, 0, 0, 0
1485, 1, 1636412888798, 1636412889062, 264, 0, 264, 0, 0, 0
1486, 1, 1636412888918, 1636412889186, 268, 0, 268, 0, 0, 0
1487, 1, 1636412888918, 1636412889186, 268, 0, 268, 0, 0, 0
1488, 1, 1636412889082, 1636412889350, 268, 0, 268, 0, 0, 0
1489, 1, 1636412889134, 1636412889398, 264, 0, 264, 0, 0, 0
1490, 1, 1636412889466, 1636412889730, 264, 0, 264, 0, 0, 0
1492, 1, 1636412889582, 1636412889850, 268, 0, 268, 0, 0, 0
1491, 1, 1636412889582, 1636412889858, 276, 0, 276, 0, 0, 0
1493, 1, 1636412889746, 1636412890010, 264, 0, 264, 0, 0, 0
1494, 1, 1636412889798, 1636412890070, 272, 0, 272, 0, 0, 0
1495, 1, 1636412890126, 1636412890394, 268, 0, 268, 0, 0, 0
1496, 1, 1636412890246, 1636412890510, 264, 1, 263, 0, 0, 0
1497, 1, 1636412890258, 1636412890526, 268, 1, 267, 0, 0, 0
1498, 1, 1636412890406, 1636412890670, 264, 0, 264, 0, 0, 0
1499, 1, 1636412890466, 1636412890730, 264, 0, 264, 0, 0, 0
1500, 1, 1636412890790, 1636412891054, 264, 0, 264, 0, 0, 0
1501, 1, 1636412890906, 1636412891170, 264, 1, 263, 0, 0, 0
1502, 1, 1636412890926, 1636412891194, 268, 1, 267, 0, 0, 0
1503, 1, 1636412891070, 1636412891334, 264, 0, 264, 0, 0, 0
1504, 1, 1636412891126, 1636412891390, 264, 0, 264, 0, 0, 0
1505, 1, 1636412891450, 1636412891714, 264, 0, 264, 0, 0, 0
1506, 1, 1636412891566, 1636412891830, 264, 1, 263, 0, 0, 0
1507, 1, 1636412891598, 1636412891862, 264, 1, 263, 0, 0, 0
1508, 1, 1636412891730, 1636412892002, 272, 0, 272, 0, 0, 0
1509, 1, 1636412891786, 1636412892050, 264, 0, 264, 0, 0, 0
1511, 1, 1636412892234, 1636412892498, 264, 1, 263, 0, 1, 1
1512, 1, 1636412892258, 1636412892526, 268, 1, 267, 0, 0, 0
1514, 1, 1636412892446, 1636412892714, 268, 1, 267, 0, 0, 0
1515, 1, 1636412892894, 1636412893158, 264, 0, 264, 0, 0, 0
1517, 1, 1636412893110, 1636412893375, 265, 1, 264, 1, 0, 1
1519, 1, 1636412893770, 1636412894035, 265, 0, 265, 0, 0, 0
1510, 2, 1636412892114, 1636412902114, 10000, 0, 10000, 0, 0, 0
1513, 2, 1636412892398, 1636412902398, 10000, 0, 10000, 0, 0, 0
1521, 1, 1636412902446, 1636412902718, 272, 0, 272, 0, 0, 0
1516, 2, 1636412892926, 1636412902926, 10000, 0, 10000, 0, 0, 0
1522, 1, 1636412902702, 1636412902982, 280, 17, 263, 17, 0, 17
1523, 1, 1636412903114, 1636412903379, 265, 1, 264, 1, 0, 1
1524, 1, 1636412903230, 1636412903494, 264, 1, 263, 1, 0, 1
1518, 2, 1636412893554, 1636412903555, 10001, 0, 10001, 0, 0, 0
1525, 1, 1636412903378, 1636412903690, 312, 1, 311, 0, 0, 0
1526, 1, 1636412903778, 1636412904042, 264, 0, 264, 0, 0, 0
1527, 1, 1636412903858, 1636412904126, 268, 1, 267, 0, 1, 1
1528, 1, 1636412903890, 1636412904154, 264, 0, 264, 0, 0, 0
1529, 1, 1636412904086, 1636412904354, 268, 0, 268, 0, 0, 0
1520, 2, 1636412894430, 1636412904430, 10000, 0, 10000, 0, 0, 0
1530, 1, 1636412904474, 1636412904738, 264, 0, 264, 0, 0, 0
1531, 1, 1636412904522, 1636412904786, 264, 0, 264, 0, 0, 0
1532, 1, 1636412904550, 1636412904814, 264, 0, 264, 0, 0, 0
1533, 1, 1636412904738, 1636412905002, 264, 0, 264, 0, 0, 0
1534, 1, 1636412904754, 1636412905022, 268, 0, 268, 0, 0, 0
1535, 1, 1636412905134, 1636412905398, 264, 0, 264, 0, 0, 0
1536, 1, 1636412905182, 1636412905446, 264, 0, 264, 0, 0, 0
1537, 1, 1636412905210, 1636412905474, 264, 1, 263, 0, 1, 1
1538, 1, 1636412905398, 1636412905662, 264, 1, 263, 0, 0, 0
1539, 1, 1636412905422, 1636412905690, 268, 0, 268, 0, 0, 0
1540, 1, 1636412905794, 1636412906062, 268, 1, 267, 0, 0, 0
1541, 1, 1636412905846, 1636412906110, 264, 1, 263, 0, 0, 0
1542, 1, 1636412905874, 1636412906146, 272, 1, 271, 1, 0, 1
1543, 1, 1636412906062, 1636412906326, 264, 1, 263, 0, 0, 0
1544, 1, 1636412906086, 1636412906354, 268, 1, 267, 0, 0, 0
1545, 1, 1636412906462, 1636412906726, 264, 1, 263, 0, 0, 0
1546, 1, 1636412906510, 1636412906774, 264, 0, 264, 0, 0, 0
1547, 1, 1636412906542, 1636412906806, 264, 1, 263, 0, 0, 0
1548, 1, 1636412906722, 1636412906986, 264, 0, 264, 0, 0, 0
1549, 1, 1636412906750, 1636412907014, 264, 0, 264, 0, 0, 0
1550, 1, 1636412907130, 1636412907394, 264, 1, 263, 0, 1, 1
1551, 1, 1636412907174, 1636412907438, 264, 0, 264, 0, 0, 0
1552, 1, 1636412907202, 1636412907466, 264, 0, 264, 0, 0, 0
1553, 1, 1636412907386, 1636412907650, 264, 1, 263, 0, 0, 0
1554, 1, 1636412907410, 1636412907674, 264, 0, 264, 0, 0, 0
1555, 1, 1636412907790, 1636412908054, 264, 0, 264, 0, 0, 0
1556, 1, 1636412907834, 1636412908098, 264, 0, 264, 0, 0, 0
1557, 1, 1636412907862, 1636412908126, 264, 1, 263, 0, 0, 0
1558, 1, 1636412908050, 1636412908314, 264, 0, 264, 0, 0, 0
1559, 1, 1636412908069, 1636412908334, 265, 1, 264, 0, 0, 0
1560, 1, 1636412908450, 1636412908714, 264, 0, 264, 0, 0, 0
1561, 1, 1636412908494, 1636412908758, 264, 0, 264, 0, 0, 0
1562, 1, 1636412908522, 1636412908786, 264, 1, 263, 0, 1, 1
1563, 1, 1636412908710, 1636412908978, 268, 0, 268, 0, 0, 0
1564, 1, 1636412908730, 1636412908994, 264, 0, 264, 0, 0, 0
1565, 1, 1636412909110, 1636412909374, 264, 0, 264, 0, 0, 0
1566, 1, 1636412909158, 1636412909422, 264, 0, 264, 0, 0, 0
1567, 1, 1636412909186, 1636412909450, 264, 0, 264, 0, 0, 0
1568, 1, 1636412909378, 1636412909642, 264, 0, 264, 0, 0, 0
1569, 1, 1636412909390, 1636412909654, 264, 1, 263, 0, 0, 0
1570, 1, 1636412909770, 1636412910034, 264, 1, 263, 0, 0, 0
1571, 1, 1636412909818, 1636412910082, 264, 0, 264, 0, 0, 0
1572, 1, 1636412909846, 1636412910110, 264, 1, 263, 0, 1, 1
1573, 1, 1636412910038, 1636412910306, 268, 0, 268, 0, 0, 0
1574, 1, 1636412910050, 1636412910314, 264, 1, 263, 0, 1, 1
1575, 1, 1636412910430, 1636412910694, 264, 1, 263, 0, 0, 0
1576, 1, 1636412910478, 1636412910742, 264, 0, 264, 0, 0, 0
1577, 1, 1636412910506, 1636412910770, 264, 0, 264, 0, 0, 0
1578, 1, 1636412910710, 1636412910978, 268, 0, 268, 0, 0, 0
1579, 1, 1636412910718, 1636412910986, 268, 0, 268, 0, 0, 0
1580, 1, 1636412911094, 1636412911358, 264, 1, 263, 1, 0, 1
1581, 1, 1636412911142, 1636412911406, 264, 0, 264, 0, 0, 0
1582, 1, 1636412911166, 1636412911434, 268, 0, 268, 0, 0, 0
1583, 1, 1636412911374, 1636412911642, 268, 0, 268, 0, 0, 0
1584, 1, 1636412911382, 1636412911646, 264, 1, 263, 0, 0, 0
1585, 1, 1636412911762, 1636412912026, 264, 0, 264, 0, 0, 0
1586, 1, 1636412911806, 1636412912070, 264, 0, 264, 0, 0, 0
1587, 1, 1636412911830, 1636412912094, 264, 1, 263, 0, 1, 1
1589, 1, 1636412912042, 1636412912306, 264, 1, 263, 0, 0, 0
1588, 1, 1636412912042, 1636412912310, 268, 0, 268, 0, 0, 0
1590, 1, 1636412912422, 1636412912686, 264, 1, 263, 0, 0, 0
1591, 1, 1636412912470, 1636412912734, 264, 0, 264, 0, 0, 0
1592, 1, 1636412912494, 1636412912758, 264, 0, 264, 0, 0, 0
1593, 1, 1636412912710, 1636412912974, 264, 0, 264, 0, 0, 0
1594, 1, 1636412912710, 1636412912974, 264, 0, 264, 0, 0, 0
1595, 1, 1636412913086, 1636412913350, 264, 1, 263, 0, 0, 0
1597, 1, 1636412913158, 1636412913426, 268, 0, 268, 0, 0, 0
1596, 1, 1636412913130, 1636412913614, 484, 220, 264, 220, 0, 220
1599, 1, 1636412913370, 1636412913634, 264, 1, 263, 1, 0, 1
1598, 1, 1636412913370, 1636412913878, 508, 244, 264, 243, 0, 243
1600, 1, 1636412913746, 1636412914010, 264, 1, 263, 0, 1, 1
1601, 1, 1636412913822, 1636412914142, 320, 56, 264, 56, 0, 56
1602, 1, 1636412914010, 1636412914274, 264, 0, 264, 0, 0, 0
1603, 1, 1636412914034, 1636412914406, 372, 108, 264, 108, 0, 108
1604, 1, 1636412914278, 1636412914550, 272, 0, 272, 0, 0, 0
1605, 1, 1636412914406, 1636412914670, 264, 0, 264, 0, 0, 0
1606, 1, 1636412914538, 1636412914814, 276, 13, 263, 13, 0, 13
1607, 1, 1636412914670, 1636412914934, 264, 1, 263, 0, 0, 0
1608, 1, 1636412914802, 1636412915070, 268, 0, 268, 0, 0, 0
1609, 1, 1636412914946, 1636412915211, 265, 0, 265, 0, 0, 0
1611, 1, 1636412915210, 1636412915474, 264, 1, 263, 0, 0, 0
1612, 1, 1636412915330, 1636412915594, 264, 0, 264, 0, 0, 0
1613, 1, 1636412915466, 1636412915730, 264, 0, 264, 0, 0, 0
1616, 1, 1636412915990, 1636412916254, 264, 1, 263, 0, 0, 0
1617, 1, 1636412916126, 1636412916394, 268, 1, 267, 0, 0, 0
1619, 1, 1636412916790, 1636412917054, 264, 0, 264, 0, 0, 0
1610, 2, 1636412915066, 1636412925066, 10000, 0, 10000, 0, 0, 0
1614, 2, 1636412915606, 1636412925606, 10000, 0, 10000, 0, 0, 0
1621, 1, 1636412925374, 1636412925654, 280, 1, 279, 0, 0, 0
1615, 2, 1636412915870, 1636412925870, 10000, 0, 10000, 0, 0, 0
1622, 1, 1636412925918, 1636412926182, 264, 0, 264, 0, 0, 0
1623, 1, 1636412926050, 1636412926314, 264, 1, 263, 1, 0, 1
1624, 1, 1636412926174, 1636412926446, 272, 9, 263, 7, 1, 8
1618, 2, 1636412916650, 1636412926650, 10000, 0, 10000, 0, 0, 0
1625, 1, 1636412926578, 1636412926878, 300, 0, 300, 0, 0, 0
1626, 1, 1636412926743, 1636412927006, 263, 0, 263, 0, 0, 0
1627, 1, 1636412926846, 1636412927142, 296, 33, 263, 33, 0, 33
1628, 1, 1636412926954, 1636412927218, 264, 0, 264, 0, 0, 0
1620, 2, 1636412917450, 1636412927450, 10000, 0, 10000, 0, 0, 0
1629, 1, 1636412927278, 1636412927586, 308, 0, 308, 0, 0, 0
1630, 1, 1636412927402, 1636412927674, 272, 1, 271, 0, 0, 0
1631, 1, 1636412927542, 1636412927850, 308, 45, 263, 44, 1, 45
1632, 1, 1636412927630, 1636412927894, 264, 0, 264, 0, 0, 0
1633, 1, 1636412927758, 1636412928022, 264, 1, 263, 0, 0, 0
1634, 1, 1636412927982, 1636412928250, 268, 0, 268, 0, 0, 0
1635, 1, 1636412928070, 1636412928334, 264, 0, 264, 0, 0, 0
1636, 1, 1636412928246, 1636412928514, 268, 4, 264, 4, 0, 4
1637, 1, 1636412928290, 1636412928554, 264, 0, 264, 0, 0, 0
1638, 1, 1636412928418, 1636412928682, 264, 1, 263, 0, 1, 1
1639, 1, 1636412928646, 1636412928910, 264, 1, 263, 0, 0, 0
1640, 1, 1636412928730, 1636412928998, 268, 1, 267, 0, 0, 0
1641, 1, 1636412928910, 1636412929174, 264, 1, 263, 1, 0, 1
1642, 1, 1636412928950, 1636412929214, 264, 1, 263, 0, 1, 1
1643, 1, 1636412929078, 1636412929342, 264, 1, 263, 0, 0, 0
1644, 1, 1636412929306, 1636412929570, 264, 1, 263, 0, 0, 0
1645, 1, 1636412929394, 1636412929658, 264, 0, 264, 0, 0, 0
1646, 1, 1636412929586, 1636412929850, 264, 1, 263, 0, 0, 0
1647, 1, 1636412929610, 1636412929874, 264, 1, 263, 0, 1, 1
1648, 1, 1636412929738, 1636412930002, 264, 0, 264, 0, 0, 0
1649, 1, 1636412929966, 1636412930230, 264, 0, 264, 0, 0, 0
1650, 1, 1636412930054, 1636412930318, 264, 0, 264, 0, 0, 0
1651, 1, 1636412930246, 1636412930518, 272, 1, 271, 0, 0, 0
1652, 1, 1636412930274, 1636412930546, 272, 0, 272, 0, 0, 0
1653, 1, 1636412930398, 1636412930662, 264, 1, 263, 0, 0, 0
1654, 1, 1636412930626, 1636412930894, 268, 0, 268, 0, 0, 0
1655, 1, 1636412930714, 1636412930982, 268, 0, 268, 0, 0, 0
1656, 1, 1636412930914, 1636412931182, 268, 0, 268, 0, 0, 0
1657, 1, 1636412930942, 1636412931206, 264, 0, 264, 0, 0, 0
1658, 1, 1636412931058, 1636412931322, 264, 0, 264, 0, 0, 0
1659, 1, 1636412931290, 1636412931558, 268, 1, 267, 0, 0, 0
1660, 1, 1636412931386, 1636412931654, 268, 1, 267, 0, 0, 0
1661, 1, 1636412931578, 1636412931842, 264, 0, 264, 0, 0, 0
1662, 1, 1636412931602, 1636412931870, 268, 0, 268, 0, 0, 0
1663, 1, 1636412931718, 1636412931982, 264, 1, 263, 0, 0, 0
1664, 1, 1636412931954, 1636412932218, 264, 1, 263, 0, 1, 1
1665, 1, 1636412932050, 1636412932318, 268, 0, 268, 0, 0, 0
1666, 1, 1636412932238, 1636412932502, 264, 1, 263, 0, 0, 0
1667, 1, 1636412932270, 1636412932534, 264, 1, 263, 0, 0, 0
1668, 1, 1636412932382, 1636412932646, 264, 1, 263, 0, 1, 1
1669, 1, 1636412932614, 1636412932878, 264, 0, 264, 0, 0, 0
1671, 1, 1636412932902, 1636412933166, 264, 0, 264, 0, 0, 0
1672, 1, 1636412932934, 1636412933198, 264, 1, 263, 0, 0, 0
1673, 1, 1636412933042, 1636412933310, 268, 1, 267, 0, 0, 0
1676, 1, 1636412933594, 1636412933858, 264, 1, 263, 0, 0, 0
1677, 1, 1636412933706, 1636412933970, 264, 1, 263, 0, 1, 1
1679, 1, 1636412934366, 1636412934630, 264, 1, 263, 1, 0, 1
1670, 2, 1636412932718, 1636412942718, 10000, 0, 10000, 0, 0, 0
1674, 2, 1636412933274, 1636412943274, 10000, 0, 10000, 0, 0, 0
1681, 1, 1636412943026, 1636412943322, 296, 1, 295, 0, 0, 0
1675, 2, 1636412933562, 1636412943562, 10000, 0, 10000, 0, 0, 0
1682, 1, 1636412943606, 1636412943870, 264, 0, 264, 0, 0, 0
1683, 1, 1636412943742, 1636412944006, 264, 0, 264, 0, 0, 0
1684, 1, 1636412943866, 1636412944134, 268, 5, 263, 5, 0, 5
1678, 2, 1636412934254, 1636412944254, 10000, 0, 10000, 0, 0, 0
1685, 1, 1636412944298, 1636412944566, 268, 0, 268, 0, 0, 0
1686, 1, 1636412944434, 1636412944698, 264, 0, 264, 0, 0, 0
1688, 1, 1636412944562, 1636412944826, 264, 1, 263, 0, 0, 0
1687, 1, 1636412944534, 1636412944830, 296, 33, 263, 33, 0, 33
1680, 2, 1636412935026, 1636412945026, 10000, 0, 10000, 0, 0, 0
1689, 1, 1636412944962, 1636412945250, 288, 0, 288, 0, 0, 0
1690, 1, 1636412945118, 1636412945382, 264, 0, 264, 0, 0, 0
1691, 1, 1636412945222, 1636412945486, 264, 1, 263, 0, 0, 0
1692, 1, 1636412945230, 1636412945514, 284, 21, 263, 21, 0, 21
1693, 1, 1636412945334, 1636412945598, 264, 1, 263, 0, 0, 0
1694, 1, 1636412945646, 1636412945910, 264, 0, 264, 0, 0, 0
1695, 1, 1636412945782, 1636412946046, 264, 1, 263, 0, 0, 0
1696, 1, 1636412945882, 1636412946146, 264, 0, 264, 0, 0, 0
1697, 1, 1636412945914, 1636412946178, 264, 0, 264, 0, 0, 0
1698, 1, 1636412945994, 1636412946258, 264, 1, 263, 0, 0, 0
1699, 1, 1636412946306, 1636412946574, 268, 1, 267, 0, 1, 1
1700, 1, 1636412946442, 1636412946706, 264, 0, 264, 0, 0, 0
1701, 1, 1636412946546, 1636412946811, 265, 0, 265, 0, 0, 0
1703, 1, 1636412946654, 1636412946918, 264, 0, 264, 0, 0, 0
1704, 1, 1636412946974, 1636412947238, 264, 0, 264, 0, 0, 0
1705, 1, 1636412947106, 1636412947370, 264, 0, 264, 0, 0, 0
1707, 1, 1636412947314, 1636412947582, 268, 1, 267, 0, 1, 1
1708, 1, 1636412947634, 1636412947910, 276, 0, 276, 0, 0, 0
1709, 1, 1636412947766, 1636412948030, 264, 1, 263, 0, 0, 0
1711, 1, 1636412948306, 1636412948570, 264, 1, 263, 0, 0, 0
1712, 1, 1636412948426, 1636412948691, 265, 1, 264, 0, 0, 0
1713, 1, 1636412948966, 1636412949235, 269, 0, 269, 0, 0, 0
1714, 1, 1636412949086, 1636412949350, 264, 1, 263, 0, 0, 0
1715, 1, 1636412949638, 1636412949902, 264, 1, 263, 0, 0, 0
1716, 1, 1636412949746, 1636412950011, 265, 0, 265, 0, 0, 0
1717, 1, 1636412950298, 1636412950562, 264, 1, 263, 1, 0, 1
1718, 1, 1636412950410, 1636412950674, 264, 1, 263, 0, 0, 0
1719, 1, 1636412950958, 1636412951226, 268, 0, 268, 0, 0, 0
1720, 1, 1636412951078, 1636412951342, 264, 1, 263, 0, 1, 1
1721, 1, 1636412951622, 1636412951886, 264, 1, 263, 0, 0, 0
1722, 1, 1636412951742, 1636412952007, 265, 1, 264, 0, 1, 1
1723, 1, 1636412952282, 1636412952546, 264, 1, 263, 0, 1, 1
1724, 1, 1636412952406, 1636412952674, 268, 1, 267, 0, 0, 0
1725, 1, 1636412952942, 1636412953206, 264, 0, 264, 0, 0, 0
1726, 1, 1636412953070, 1636412953334, 264, 1, 263, 0, 0, 0
1727, 1, 1636412953602, 1636412953870, 268, 1, 267, 0, 0, 0
1728, 1, 1636412953730, 1636412953994, 264, 0, 264, 0, 0, 0
1729, 1, 1636412954266, 1636412954530, 264, 1, 263, 1, 0, 1
1730, 1, 1636412954390, 1636412954654, 264, 1, 263, 0, 0, 0
1731, 1, 1636412954926, 1636412955194, 268, 0, 268, 0, 0, 0
1732, 1, 1636412955050, 1636412955314, 264, 0, 264, 0, 0, 0
1733, 1, 1636412955590, 1636412955854, 264, 1, 263, 0, 0, 0
1734, 1, 1636412955710, 1636412955979, 269, 1, 268, 0, 0, 0
1735, 1, 1636412956250, 1636412956514, 264, 1, 263, 0, 0, 0
1736, 1, 1636412956374, 1636412956638, 264, 1, 263, 0, 1, 1
1702, 2, 1636412946574, 1636412956751, 10177, 1, 10176, 1, 0, 1
1706, 1, 1636412947206, 1636412957070, 9864, 9545, 319, 9545, 0, 9545
1737, 1, 1636412957018, 1636412957282, 264, 1, 263, 0, 0, 0
1738, 1, 1636412957042, 1636412957306, 264, 1, 263, 0, 1, 1
1710, 1, 1636412947982, 1636412957334, 9352, 9089, 263, 9089, 0, 9089
1739, 1, 1636412957106, 1636412957378, 272, 1, 271, 0, 1, 1
1740, 1, 1636412957466, 1636412957730, 264, 0, 264, 0, 0, 0
1741, 1, 1636412957682, 1636412957946, 264, 0, 264, 0, 0, 0
1742, 1, 1636412957706, 1636412957970, 264, 0, 264, 0, 0, 0
1743, 1, 1636412957734, 1636412957998, 264, 0, 264, 0, 0, 0
1744, 1, 1636412957774, 1636412958038, 264, 0, 264, 0, 0, 0
1745, 1, 1636412958126, 1636412958390, 264, 1, 263, 0, 0, 0
1746, 1, 1636412958342, 1636412958606, 264, 1, 263, 0, 0, 0
1747, 1, 1636412958370, 1636412958634, 264, 0, 264, 0, 0, 0
1748, 1, 1636412958402, 1636412958670, 268, 1, 267, 0, 0, 0
1749, 1, 1636412958438, 1636412958706, 268, 1, 267, 0, 0, 0
1750, 1, 1636412958786, 1636412959050, 264, 0, 264, 0, 0, 0
1751, 1, 1636412959010, 1636412959274, 264, 0, 264, 0, 0, 0
1752, 1, 1636412959066, 1636412959334, 268, 0, 268, 0, 0, 0
1753, 1, 1636412959102, 1636412959366, 264, 0, 264, 0, 0, 0
1754, 1, 1636412959446, 1636412959710, 264, 1, 263, 0, 1, 1
1755, 1, 1636412959730, 1636412959998, 268, 1, 267, 0, 1, 1
1756, 1, 1636412959766, 1636412960030, 264, 1, 263, 0, 0, 0
1757, 1, 1636412960110, 1636412960374, 264, 0, 264, 0, 0, 0
1758, 1, 1636412960394, 1636412960662, 268, 1, 267, 0, 1, 1
1759, 1, 1636412960426, 1636412960690, 264, 1, 263, 0, 0, 0
1760, 1, 1636412960770, 1636412961034, 264, 1, 263, 0, 1, 1
1761, 1, 1636412961058, 1636412961322, 264, 0, 264, 0, 0, 0
1762, 1, 1636412961090, 1636412961354, 264, 0, 264, 0, 0, 0
1763, 1, 1636412961430, 1636412961694, 264, 1, 263, 0, 0, 0
1764, 1, 1636412961718, 1636412961982, 264, 0, 264, 0, 0, 0
1765, 1, 1636412961750, 1636412962014, 264, 1, 263, 0, 0, 0
1766, 1, 1636412962090, 1636412962354, 264, 1, 263, 0, 0, 0
1767, 1, 1636412962378, 1636412962642, 264, 1, 263, 0, 0, 0
1768, 1, 1636412962410, 1636412962674, 264, 0, 264, 0, 0, 0
1769, 1, 1636412962750, 1636412963014, 264, 0, 264, 0, 0, 0
1770, 1, 1636412963042, 1636412963310, 268, 0, 268, 0, 0, 0
1771, 1, 1636412963070, 1636412963334, 264, 0, 264, 0, 0, 0
1772, 1, 1636412963410, 1636412963674, 264, 1, 263, 0, 0, 0
1773, 1, 1636412963706, 1636412963970, 264, 0, 264, 0, 0, 0
1774, 1, 1636412963730, 1636412963994, 264, 1, 263, 0, 0, 0
1775, 1, 1636412964070, 1636412964334, 264, 1, 263, 0, 0, 0
1776, 1, 1636412964366, 1636412964630, 264, 1, 263, 0, 1, 1
1777, 1, 1636412964390, 1636412964654, 264, 1, 263, 0, 0, 0
1778, 1, 1636412964730, 1636412964994, 264, 0, 264, 0, 0, 0
1779, 1, 1636412965026, 1636412965294, 268, 0, 268, 0, 0, 0
1780, 1, 1636412965054, 1636412965318, 264, 0, 264, 0, 0, 0
1781, 1, 1636412965390, 1636412965658, 268, 1, 267, 0, 0, 0
1782, 1, 1636412965690, 1636412965954, 264, 1, 263, 0, 0, 0
1783, 1, 1636412965718, 1636412965983, 265, 1, 264, 0, 1, 1
1784, 1, 1636412966054, 1636412966318, 264, 0, 264, 0, 0, 0
1785, 1, 1636412966350, 1636412966618, 268, 1, 267, 0, 0, 0
1786, 1, 1636412966382, 1636412966646, 264, 1, 263, 0, 0, 0
1787, 1, 1636412966718, 1636412966982, 264, 1, 263, 0, 0, 0
1788, 1, 1636412967014, 1636412967278, 264, 0, 264, 0, 0, 0
1789, 1, 1636412967042, 1636412967306, 264, 0, 264, 0, 0, 0
1790, 1, 1636412967378, 1636412967646, 268, 1, 267, 0, 0, 0
1791, 1, 1636412967674, 1636412967938, 264, 0, 264, 0, 0, 0
1792, 1, 1636412967706, 1636412967970, 264, 1, 263, 0, 0, 0
1793, 1, 1636412968042, 1636412968306, 264, 1, 263, 0, 0, 0
1794, 1, 1636412968334, 1636412968598, 264, 1, 263, 0, 0, 0
1795, 1, 1636412968366, 1636412968630, 264, 0, 264, 0, 0, 0
1796, 1, 1636412968706, 1636412968970, 264, 1, 263, 0, 0, 0
1797, 1, 1636412968994, 1636412969258, 264, 0, 264, 0, 0, 0
1798, 1, 1636412969030, 1636412969294, 264, 0, 264, 0, 0, 0
1799, 1, 1636412969366, 1636412969638, 272, 0, 272, 0, 0, 0
1800, 1, 1636412969658, 1636412969923, 265, 1, 264, 0, 1, 1
