Xid, State, StartTime, EndTime, TransactionTime, ExecuteTime, CommunicationTime, ReadTime, WriteTime, DBTime
1, 1, 1636420148621, 1636420149246, 625, 200, 425, 118, 11, 129
2, 1, 1636420149623, 1636420150031, 408, 3, 405, 2, 0, 2
3, 1, 1636420150347, 1636420150759, 412, 3, 409, 2, 1, 3
4, 1, 1636420151071, 1636420151479, 408, 4, 404, 1, 0, 1
5, 1, 1636420151795, 1636420152207, 412, 4, 408, 2, 0, 2
6, 1, 1636420152515, 1636420152927, 412, 4, 408, 2, 0, 2
7, 1, 1636420153239, 1636420153647, 408, 4, 404, 2, 0, 2
8, 1, 1636420153959, 1636420154358, 399, 2, 397, 1, 1, 2
9, 1, 1636420154671, 1636420155079, 408, 3, 405, 1, 0, 1
10, 1, 1636420155387, 1636420155791, 404, 2, 402, 0, 1, 1
11, 1, 1636420156103, 1636420156503, 400, 3, 397, 0, 1, 1
12, 1, 1636420156811, 1636420157215, 404, 3, 401, 1, 1, 2
13, 1, 1636420157526, 1636420157935, 409, 3, 406, 0, 1, 1
14, 1, 1636420158251, 1636420158654, 403, 3, 400, 0, 1, 1
15, 1, 1636420158967, 1636420159371, 404, 3, 401, 0, 1, 1
16, 1, 1636420159683, 1636420160095, 412, 6, 406, 0, 0, 0
17, 1, 1636420160403, 1636420160807, 404, 2, 402, 0, 0, 0
18, 1, 1636420161071, 1636420161427, 356, 2, 354, 0, 1, 1
19, 1, 1636420161691, 1636420162055, 364, 2, 362, 0, 0, 0
20, 1, 1636420162323, 1636420162674, 351, 3, 348, 0, 0, 0
22, 1, 1636420162939, 1636420163299, 360, 3, 357, 0, 0, 0
23, 1, 1636420163563, 1636420163927, 364, 1, 363, 1, 0, 1
25, 1, 1636420164191, 1636420164555, 364, 1, 363, 1, 0, 1
27, 1, 1636420164819, 1636420165183, 364, 0, 364, 0, 0, 0
29, 1, 1636420165446, 1636420165803, 357, 1, 356, 1, 0, 1
31, 1, 1636420166071, 1636420166427, 356, 2, 354, 0, 0, 0
33, 1, 1636420166691, 1636420167047, 356, 0, 356, 0, 0, 0
35, 1, 1636420167315, 1636420167671, 356, 1, 355, 1, 0, 1
37, 1, 1636420167934, 1636420168294, 360, 3, 357, 2, 0, 2
39, 1, 1636420168562, 1636420168923, 361, 2, 359, 0, 0, 0
41, 1, 1636420169187, 1636420169546, 359, 0, 359, 0, 0, 0
43, 1, 1636420169811, 1636420170167, 356, 1, 355, 0, 0, 0
45, 1, 1636420170435, 1636420170787, 352, 1, 351, 0, 0, 0
46, 1, 1636420171059, 1636420171410, 351, 3, 348, 0, 0, 0
48, 1, 1636420171678, 1636420172034, 356, 3, 353, 0, 0, 0
50, 1, 1636420172299, 1636420172663, 364, 0, 364, 0, 0, 0
52, 1, 1636420172931, 1636420173287, 356, 1, 355, 1, 0, 1
54, 1, 1636420173550, 1636420173907, 357, 0, 357, 0, 0, 0
56, 1, 1636420174175, 1636420174535, 360, 1, 359, 0, 0, 0
58, 1, 1636420174798, 1636420175154, 356, 3, 353, 1, 0, 1
60, 1, 1636420175418, 1636420175775, 357, 3, 354, 0, 0, 0
62, 1, 1636420176038, 1636420176395, 357, 3, 354, 0, 0, 0
64, 1, 1636420176659, 1636420177014, 355, 2, 353, 0, 0, 0
66, 1, 1636420177279, 1636420177634, 355, 1, 354, 0, 0, 0
68, 1, 1636420177898, 1636420178255, 357, 3, 354, 0, 0, 0
70, 1, 1636420178523, 1636420178875, 352, 1, 351, 1, 0, 1
72, 1, 1636420179139, 1636420179499, 360, 1, 359, 0, 0, 0
74, 1, 1636420179762, 1636420180119, 357, 1, 356, 0, 0, 0
76, 1, 1636420180382, 1636420180742, 360, 2, 358, 0, 0, 0
78, 1, 1636420181010, 1636420181370, 360, 1, 359, 0, 0, 0
81, 1, 1636420181638, 1636420181995, 357, 3, 354, 0, 1, 1
84, 1, 1636420182258, 1636420182611, 353, 2, 351, 1, 0, 1
87, 1, 1636420182875, 1636420183231, 356, 1, 355, 0, 0, 0
90, 1, 1636420183494, 1636420183846, 352, 0, 352, 0, 0, 0
93, 1, 1636420184115, 1636420184475, 360, 1, 359, 0, 0, 0
96, 1, 1636420184739, 1636420185095, 356, 1, 355, 1, 0, 1
99, 1, 1636420185359, 1636420185714, 355, 1, 354, 0, 0, 0
102, 1, 1636420185979, 1636420186334, 355, 2, 353, 0, 0, 0
105, 1, 1636420186603, 1636420186955, 352, 1, 351, 0, 0, 0
107, 1, 1636420187218, 1636420187575, 357, 2, 355, 0, 0, 0
110, 1, 1636420187838, 1636420188190, 352, 3, 349, 2, 0, 2
113, 1, 1636420188454, 1636420188811, 357, 2, 355, 0, 0, 0
116, 1, 1636420189075, 1636420189438, 363, 1, 362, 1, 0, 1
119, 1, 1636420189702, 1636420190058, 356, 2, 354, 1, 0, 1
122, 1, 1636420190323, 1636420190675, 352, 3, 349, 0, 0, 0
125, 1, 1636420190939, 1636420191291, 352, 1, 351, 0, 0, 0
128, 1, 1636420191554, 1636420191910, 356, 2, 354, 0, 0, 0
131, 1, 1636420192174, 1636420192539, 365, 1, 364, 0, 0, 0
134, 1, 1636420192806, 1636420193162, 356, 1, 355, 0, 0, 0
137, 1, 1636420193427, 1636420193787, 360, 1, 359, 0, 0, 0
140, 1, 1636420194050, 1636420194411, 361, 1, 360, 0, 0, 0
143, 1, 1636420194675, 1636420195030, 355, 1, 354, 1, 0, 1
146, 1, 1636420195294, 1636420195646, 352, 2, 350, 1, 0, 1
149, 1, 1636420195910, 1636420196267, 357, 3, 354, 0, 1, 1
152, 1, 1636420196530, 1636420196887, 357, 2, 355, 1, 1, 2
155, 1, 1636420197150, 1636420197503, 353, 2, 351, 0, 0, 0
158, 1, 1636420197766, 1636420198119, 353, 2, 351, 1, 0, 1
161, 1, 1636420198383, 1636420198735, 352, 0, 352, 0, 0, 0
164, 1, 1636420198999, 1636420199355, 356, 1, 355, 0, 0, 0
167, 1, 1636420199622, 1636420199974, 352, 3, 349, 0, 0, 0
170, 1, 1636420200239, 1636420200603, 364, 1, 363, 0, 0, 0
173, 1, 1636420200866, 1636420201218, 352, 3, 349, 2, 0, 2
176, 1, 1636420201482, 1636420201838, 356, 0, 356, 0, 0, 0
179, 1, 1636420202102, 1636420202458, 356, 3, 353, 0, 0, 0
182, 1, 1636420202722, 1636420203078, 356, 3, 353, 1, 1, 2
185, 1, 1636420203342, 1636420203694, 352, 2, 350, 0, 1, 1
188, 1, 1636420203958, 1636420204315, 357, 2, 355, 1, 0, 1
191, 1, 1636420204578, 1636420204934, 356, 1, 355, 1, 0, 1
194, 1, 1636420205198, 1636420205554, 356, 3, 353, 0, 0, 0
197, 1, 1636420205818, 1636420206170, 352, 3, 349, 2, 0, 2
200, 1, 1636420206434, 1636420206791, 357, 3, 354, 1, 0, 1
203, 1, 1636420207054, 1636420207407, 353, 3, 350, 1, 0, 1
204, 1, 1636420207670, 1636420208022, 352, 2, 350, 0, 0, 0
207, 1, 1636420208286, 1636420208642, 356, 2, 354, 0, 0, 0
210, 1, 1636420208906, 1636420209259, 353, 3, 350, 0, 0, 0
213, 1, 1636420209523, 1636420209875, 352, 1, 351, 0, 0, 0
216, 1, 1636420210138, 1636420210490, 352, 3, 349, 0, 1, 1
219, 1, 1636420210754, 1636420211107, 353, 2, 351, 0, 1, 1
222, 1, 1636420211370, 1636420211726, 356, 3, 353, 1, 0, 1
225, 1, 1636420211990, 1636420212342, 352, 3, 349, 0, 1, 1
228, 1, 1636420212606, 1636420212958, 352, 3, 349, 1, 0, 1
231, 1, 1636420213222, 1636420213578, 356, 2, 354, 0, 0, 0
234, 1, 1636420213842, 1636420214194, 352, 1, 351, 0, 0, 0
237, 1, 1636420214470, 1636420214826, 356, 3, 353, 1, 1, 2
240, 1, 1636420215098, 1636420215450, 352, 0, 352, 0, 0, 0
243, 1, 1636420215718, 1636420216070, 352, 1, 351, 0, 0, 0
246, 1, 1636420216334, 1636420216690, 356, 3, 353, 0, 0, 0
249, 1, 1636420216955, 1636420217311, 356, 2, 354, 1, 0, 1
252, 1, 1636420217574, 1636420217926, 352, 2, 350, 0, 0, 0
255, 1, 1636420218190, 1636420218542, 352, 3, 349, 0, 0, 0
258, 1, 1636420218806, 1636420219159, 353, 2, 351, 2, 0, 2
261, 1, 1636420219427, 1636420219778, 351, 1, 350, 0, 0, 0
264, 1, 1636420220042, 1636420220394, 352, 3, 349, 2, 1, 3
267, 1, 1636420220663, 1636420221015, 352, 2, 350, 1, 0, 1
270, 1, 1636420221278, 1636420221634, 356, 3, 353, 1, 0, 1
273, 1, 1636420221906, 1636420222258, 352, 3, 349, 1, 0, 1
276, 1, 1636420222522, 1636420222875, 353, 2, 351, 0, 0, 0
279, 1, 1636420223138, 1636420223491, 353, 2, 351, 1, 0, 1
282, 1, 1636420223754, 1636420224106, 352, 2, 350, 1, 1, 2
285, 1, 1636420224370, 1636420224726, 356, 2, 354, 0, 1, 1
288, 1, 1636420224994, 1636420225346, 352, 0, 352, 0, 0, 0
291, 1, 1636420225614, 1636420225970, 356, 0, 356, 0, 0, 0
294, 1, 1636420226238, 1636420226590, 352, 0, 352, 0, 0, 0
297, 1, 1636420226854, 1636420227206, 352, 0, 352, 0, 0, 0
300, 1, 1636420227470, 1636420227822, 352, 1, 351, 0, 0, 0
303, 1, 1636420228090, 1636420228446, 356, 0, 356, 0, 0, 0
306, 1, 1636420228714, 1636420229066, 352, 0, 352, 0, 0, 0
309, 1, 1636420229330, 1636420229686, 356, 0, 356, 0, 0, 0
312, 1, 1636420229954, 1636420230310, 356, 2, 354, 1, 1, 2
315, 1, 1636420230574, 1636420230930, 356, 2, 354, 1, 0, 1
318, 1, 1636420231194, 1636420231546, 352, 1, 351, 0, 0, 0
321, 1, 1636420231810, 1636420232162, 352, 1, 351, 1, 0, 1
324, 1, 1636420232426, 1636420232778, 352, 2, 350, 0, 0, 0
327, 1, 1636420233042, 1636420233394, 352, 2, 350, 1, 0, 1
330, 1, 1636420233662, 1636420234014, 352, 0, 352, 0, 0, 0
333, 1, 1636420234278, 1636420234630, 352, 0, 352, 0, 0, 0
336, 1, 1636420234894, 1636420235246, 352, 1, 351, 0, 0, 0
339, 1, 1636420235510, 1636420235862, 352, 0, 352, 0, 0, 0
342, 1, 1636420236126, 1636420236482, 356, 1, 355, 1, 0, 1
345, 1, 1636420236746, 1636420237098, 352, 0, 352, 0, 0, 0
348, 1, 1636420237362, 1636420237714, 352, 2, 350, 0, 0, 0
351, 1, 1636420237982, 1636420238334, 352, 1, 351, 0, 0, 0
354, 1, 1636420238598, 1636420238950, 352, 0, 352, 0, 0, 0
357, 1, 1636420239214, 1636420239567, 353, 2, 351, 0, 0, 0
360, 1, 1636420239834, 1636420240186, 352, 0, 352, 0, 0, 0
363, 1, 1636420240450, 1636420240802, 352, 1, 351, 1, 0, 1
366, 1, 1636420241070, 1636420241422, 352, 2, 350, 0, 0, 0
369, 1, 1636420241686, 1636420242038, 352, 1, 351, 0, 0, 0
372, 1, 1636420242302, 1636420242654, 352, 2, 350, 0, 0, 0
375, 1, 1636420242918, 1636420243271, 353, 2, 351, 1, 0, 1
378, 1, 1636420243534, 1636420243886, 352, 2, 350, 1, 1, 2
381, 1, 1636420244150, 1636420244502, 352, 2, 350, 0, 0, 0
384, 1, 1636420244766, 1636420245119, 353, 2, 351, 1, 0, 1
387, 1, 1636420245386, 1636420245738, 352, 1, 351, 0, 0, 0
390, 1, 1636420246002, 1636420246358, 356, 3, 353, 0, 1, 1
393, 1, 1636420246623, 1636420246983, 360, 1, 359, 1, 0, 1
396, 1, 1636420247246, 1636420247599, 353, 3, 350, 0, 0, 0
399, 1, 1636420247862, 1636420248214, 352, 0, 352, 0, 0, 0
402, 1, 1636420248482, 1636420248834, 352, 1, 351, 1, 0, 1
405, 1, 1636420249098, 1636420249450, 352, 0, 352, 0, 0, 0
408, 1, 1636420249714, 1636420250066, 352, 2, 350, 1, 1, 2
411, 1, 1636420250331, 1636420250682, 351, 1, 350, 1, 0, 1
414, 1, 1636420250946, 1636420251298, 352, 1, 351, 0, 0, 0
417, 1, 1636420251562, 1636420251914, 352, 3, 349, 0, 0, 0
420, 1, 1636420252178, 1636420252530, 352, 1, 351, 0, 0, 0
423, 1, 1636420252794, 1636420253146, 352, 3, 349, 0, 0, 0
426, 1, 1636420253410, 1636420253762, 352, 2, 350, 0, 0, 0
429, 1, 1636420254026, 1636420254378, 352, 1, 351, 1, 0, 1
432, 1, 1636420254642, 1636420254994, 352, 3, 349, 2, 1, 3
435, 1, 1636420255262, 1636420255618, 356, 2, 354, 0, 0, 0
438, 1, 1636420255882, 1636420256234, 352, 1, 351, 0, 0, 0
441, 1, 1636420256498, 1636420256854, 356, 1, 355, 1, 0, 1
444, 1, 1636420257118, 1636420257470, 352, 0, 352, 0, 0, 0
446, 1, 1636420257738, 1636420258098, 360, 0, 360, 0, 0, 0
450, 1, 1636420258366, 1636420258718, 352, 0, 352, 0, 0, 0
452, 1, 1636420258981, 1636420259334, 353, 1, 352, 0, 0, 0
455, 1, 1636420259598, 1636420259950, 352, 1, 351, 1, 0, 1
458, 1, 1636420260214, 1636420260566, 352, 2, 350, 1, 0, 1
460, 1, 1636420260830, 1636420261186, 356, 2, 354, 1, 0, 1
463, 1, 1636420261450, 1636420261806, 356, 2, 354, 1, 0, 1
466, 1, 1636420262070, 1636420262423, 353, 2, 351, 1, 1, 2
469, 1, 1636420262686, 1636420263039, 353, 1, 352, 0, 0, 0
472, 1, 1636420263302, 1636420263654, 352, 1, 351, 0, 0, 0
475, 1, 1636420263918, 1636420264271, 353, 1, 352, 1, 0, 1
478, 1, 1636420264534, 1636420264886, 352, 0, 352, 0, 0, 0
481, 1, 1636420265150, 1636420265503, 353, 3, 350, 1, 0, 1
484, 1, 1636420265766, 1636420266118, 352, 3, 349, 0, 0, 0
487, 1, 1636420266383, 1636420266734, 351, 2, 349, 2, 0, 2
490, 1, 1636420266998, 1636420267350, 352, 0, 352, 0, 0, 0
493, 1, 1636420267618, 1636420267970, 352, 2, 350, 1, 0, 1
496, 1, 1636420268234, 1636420268586, 352, 1, 351, 0, 0, 0
499, 1, 1636420268850, 1636420269202, 352, 3, 349, 0, 1, 1
502, 1, 1636420269466, 1636420269818, 352, 1, 351, 0, 0, 0
505, 1, 1636420270082, 1636420270435, 353, 0, 353, 0, 0, 0
508, 1, 1636420270698, 1636420271054, 356, 2, 354, 0, 0, 0
511, 1, 1636420271318, 1636420271670, 352, 3, 349, 0, 0, 0
514, 1, 1636420271938, 1636420272291, 353, 2, 351, 1, 0, 1
517, 1, 1636420272554, 1636420272906, 352, 3, 349, 0, 1, 1
520, 1, 1636420273170, 1636420273522, 352, 2, 350, 1, 0, 1
523, 1, 1636420273786, 1636420274138, 352, 2, 350, 1, 0, 1
601, 1, 1636420525662, 1636420526122, 460, 13, 447, 0, 0, 0
602, 1, 1636420526222, 1636420526626, 404, 1, 403, 0, 0, 0
603, 1, 1636420526647, 1636420527046, 399, 2, 397, 1, 1, 2
604, 1, 1636420526722, 1636420527122, 400, 1, 399, 1, 0, 1
605, 1, 1636420527222, 1636420527622, 400, 0, 400, 0, 0, 0
606, 1, 1636420527506, 1636420527914, 408, 0, 408, 0, 0, 0
607, 1, 1636420527642, 1636420528038, 396, 1, 395, 1, 0, 1
608, 1, 1636420527722, 1636420528130, 408, 1, 407, 1, 0, 1
609, 1, 1636420528218, 1636420528622, 404, 1, 403, 1, 0, 1
610, 1, 1636420528426, 1636420528826, 400, 1, 399, 0, 0, 0
611, 1, 1636420528458, 1636420528858, 400, 1, 399, 1, 0, 1
612, 1, 1636420528642, 1636420529046, 404, 1, 403, 1, 0, 1
613, 1, 1636420528722, 1636420529126, 404, 1, 403, 0, 1, 1
614, 1, 1636420529022, 1636420529418, 396, 1, 395, 0, 1, 1
615, 1, 1636420529230, 1636420529638, 408, 1, 407, 0, 0, 0
616, 1, 1636420529362, 1636420529722, 360, 2, 358, 0, 0, 0
617, 1, 1636420529414, 1636420529730, 316, 1, 315, 0, 0, 0
618, 1, 1636420529610, 1636420529879, 269, 0, 269, 0, 0, 0
619, 1, 1636420529694, 1636420529962, 268, 0, 268, 0, 0, 0
620, 1, 1636420529914, 1636420530187, 273, 1, 272, 0, 1, 1
621, 1, 1636420529922, 1636420530187, 265, 0, 265, 0, 0, 0
622, 1, 1636420530198, 1636420530466, 268, 0, 268, 0, 0, 0
623, 1, 1636420530314, 1636420530586, 272, 1, 271, 1, 0, 1
624, 1, 1636420530410, 1636420530682, 272, 1, 271, 0, 0, 0
626, 1, 1636420530586, 1636420530850, 264, 0, 264, 0, 0, 0
625, 1, 1636420530610, 1636420530882, 272, 0, 272, 0, 0, 0
628, 1, 1636420530794, 1636420531066, 272, 1, 271, 0, 1, 1
629, 1, 1636420530906, 1636420531178, 272, 1, 271, 1, 0, 1
632, 1, 1636420531318, 1636420531590, 272, 0, 272, 0, 0, 0
631, 1, 1636420531342, 1636420531618, 276, 1, 275, 0, 0, 0
634, 1, 1636420531498, 1636420531770, 272, 1, 271, 0, 0, 0
635, 1, 1636420531602, 1636420531890, 288, 18, 270, 17, 1, 18
636, 1, 1636420531782, 1636420532050, 268, 0, 268, 0, 0, 0
637, 1, 1636420531914, 1636420532182, 268, 0, 268, 0, 0, 0
638, 1, 1636420532030, 1636420532302, 272, 1, 271, 1, 0, 1
639, 1, 1636420532234, 1636420532506, 272, 1, 271, 0, 0, 0
641, 1, 1636420532486, 1636420532762, 276, 1, 275, 0, 0, 0
642, 1, 1636420532606, 1636420532878, 272, 1, 271, 0, 0, 0
643, 1, 1636420532786, 1636420533054, 268, 1, 267, 0, 0, 0
644, 1, 1636420532922, 1636420533199, 277, 0, 277, 0, 0, 0
646, 1, 1636420533222, 1636420533490, 268, 1, 267, 1, 0, 1
647, 1, 1636420533514, 1636420533794, 280, 0, 280, 0, 0, 0
648, 1, 1636420533626, 1636420533898, 272, 1, 271, 0, 0, 0
649, 1, 1636420533682, 1636420533954, 272, 0, 272, 0, 0, 0
651, 1, 1636420533906, 1636420534182, 276, 1, 275, 0, 1, 1
653, 1, 1636420534226, 1636420534499, 273, 0, 273, 0, 0, 0
652, 1, 1636420534234, 1636420534506, 272, 0, 272, 0, 0, 0
655, 1, 1636420534570, 1636420534847, 277, 0, 277, 0, 0, 0
656, 1, 1636420534630, 1636420534898, 268, 0, 268, 0, 0, 0
658, 1, 1636420534910, 1636420535182, 272, 1, 271, 0, 0, 0
657, 1, 1636420534918, 1636420535194, 276, 1, 275, 0, 1, 1
659, 1, 1636420535118, 1636420535390, 272, 1, 271, 0, 1, 1
662, 1, 1636420535546, 1636420535818, 272, 1, 271, 0, 0, 0
661, 1, 1636420535542, 1636420535818, 276, 1, 275, 1, 0, 1
663, 1, 1636420535594, 1636420535862, 268, 1, 267, 0, 0, 0
664, 1, 1636420535806, 1636420536078, 272, 1, 271, 0, 0, 0
666, 1, 1636420536106, 1636420536379, 273, 0, 273, 0, 0, 0
667, 1, 1636420536194, 1636420536470, 276, 1, 275, 0, 0, 0
668, 1, 1636420536434, 1636420536710, 276, 1, 275, 0, 0, 0
669, 1, 1636420536550, 1636420536818, 268, 0, 268, 0, 0, 0
670, 1, 1636420536586, 1636420536854, 268, 0, 268, 0, 0, 0
672, 1, 1636420536794, 1636420537066, 272, 0, 272, 0, 0, 0
671, 1, 1636420536798, 1636420537070, 272, 1, 271, 0, 1, 1
673, 1, 1636420537086, 1636420537350, 264, 0, 264, 0, 0, 0
674, 1, 1636420537134, 1636420537402, 268, 0, 268, 0, 0, 0
675, 1, 1636420537418, 1636420537690, 272, 1, 271, 0, 0, 0
676, 1, 1636420537478, 1636420537750, 272, 1, 271, 0, 0, 0
677, 1, 1636420537550, 1636420537823, 273, 1, 272, 0, 0, 0
679, 1, 1636420537686, 1636420537954, 268, 0, 268, 0, 0, 0
680, 1, 1636420537822, 1636420538086, 264, 1, 263, 0, 0, 0
681, 1, 1636420538066, 1636420538334, 268, 1, 267, 1, 0, 1
682, 1, 1636420538174, 1636420538443, 269, 0, 269, 0, 0, 0
684, 1, 1636420538370, 1636420538643, 273, 0, 273, 0, 0, 0
685, 1, 1636420538422, 1636420538686, 264, 1, 263, 0, 0, 0
686, 1, 1636420538550, 1636420538822, 272, 1, 271, 0, 0, 0
687, 1, 1636420538674, 1636420538942, 268, 1, 267, 0, 0, 0
689, 1, 1636420539066, 1636420539330, 264, 1, 263, 0, 1, 1
690, 1, 1636420539102, 1636420539366, 264, 1, 263, 0, 1, 1
691, 1, 1636420539306, 1636420539574, 268, 1, 267, 1, 0, 1
692, 1, 1636420539358, 1636420539630, 272, 0, 272, 0, 0, 0
694, 1, 1636420539518, 1636420539787, 269, 1, 268, 0, 1, 1
696, 1, 1636420539678, 1636420539942, 264, 1, 263, 0, 0, 0
695, 1, 1636420539702, 1636420539971, 269, 1, 268, 0, 0, 0
697, 1, 1636420540050, 1636420540322, 272, 1, 271, 0, 1, 1
699, 1, 1636420540186, 1636420540458, 272, 0, 272, 0, 0, 0
700, 1, 1636420540362, 1636420540634, 272, 1, 271, 1, 0, 1
701, 1, 1636420540526, 1636420540798, 272, 1, 271, 0, 0, 0
702, 1, 1636420540590, 1636420540858, 268, 0, 268, 0, 0, 0
627, 2, 1636420530714, 1636420540947, 10233, 138, 10095, 137, 0, 137
630, 2, 1636420531174, 1636420541174, 10000, 0, 10000, 9774, 0, 9774
704, 1, 1636420541086, 1636420541406, 320, 0, 320, 0, 0, 0
633, 2, 1636420531434, 1636420541434, 10000, 0, 10000, 9517, 0, 9517
705, 1, 1636420541170, 1636420541486, 316, 1, 315, 0, 1, 1
706, 1, 1636420541354, 1636420541662, 308, 0, 308, 0, 0, 0
708, 1, 1636420541526, 1636420541790, 264, 1, 263, 0, 0, 0
709, 1, 1636420541574, 1636420541838, 264, 0, 264, 0, 0, 0
640, 2, 1636420532342, 1636420542343, 10001, 0, 10001, 8609, 0, 8609
711, 1, 1636420542202, 1636420542478, 276, 1, 275, 1, 0, 1
712, 1, 1636420542226, 1636420542490, 264, 1, 263, 0, 1, 1
713, 1, 1636420542514, 1636420542790, 276, 1, 275, 0, 0, 0
714, 1, 1636420542610, 1636420542886, 276, 0, 276, 0, 0, 0
645, 2, 1636420532934, 1636420542935, 10001, 0, 10001, 8014, 0, 8014
715, 1, 1636420543214, 1636420543486, 272, 1, 271, 1, 0, 1
650, 2, 1636420533810, 1636420543810, 10000, 0, 10000, 7141, 0, 7141
717, 1, 1636420543546, 1636420543858, 312, 1, 311, 0, 0, 0
719, 1, 1636420544202, 1636420544479, 277, 0, 277, 0, 0, 0
654, 2, 1636420534546, 1636420544546, 10000, 0, 10000, 6404, 0, 6404
720, 1, 1636420544594, 1636420544867, 273, 1, 272, 0, 1, 1
660, 2, 1636420535250, 1636420545251, 10001, 0, 10001, 5698, 0, 5698
721, 1, 1636420545203, 1636420545475, 272, 0, 272, 0, 0, 0
722, 1, 1636420545534, 1636420545810, 276, 1, 275, 0, 0, 0
665, 2, 1636420535938, 1636420545939, 10001, 0, 10001, 5010, 0, 5010
723, 1, 1636420546166, 1636420546439, 273, 1, 272, 0, 0, 0
724, 1, 1636420546502, 1636420546774, 272, 1, 271, 0, 0, 0
725, 1, 1636420547198, 1636420547470, 272, 1, 271, 1, 0, 1
678, 2, 1636420537574, 1636420547574, 10000, 0, 10000, 3377, 0, 3377
726, 1, 1636420547467, 1636420547738, 271, 0, 271, 0, 0, 0
683, 2, 1636420538162, 1636420548163, 10001, 0, 10001, 2789, 0, 2789
727, 1, 1636420548255, 1636420548526, 271, 0, 271, 0, 0, 0
728, 1, 1636420548466, 1636420548742, 276, 1, 275, 0, 0, 0
688, 2, 1636420538830, 1636420548830, 10000, 0, 10000, 2118, 0, 2118
693, 2, 1636420539434, 1636420549435, 10001, 0, 10001, 1514, 0, 1514
729, 1, 1636420549267, 1636420549570, 303, 0, 303, 0, 0, 0
730, 1, 1636420549483, 1636420549750, 267, 0, 267, 0, 0, 0
698, 2, 1636420540110, 1636420550111, 10001, 0, 10001, 838, 0, 838
731, 1, 1636420550283, 1636420550550, 267, 0, 267, 0, 0, 0
703, 2, 1636420540690, 1636420550691, 10001, 0, 10001, 258, 0, 258
732, 1, 1636420550502, 1636420550775, 273, 1, 272, 0, 1, 1
707, 2, 1636420541386, 1636420551387, 10001, 0, 10001, 0, 0, 0
733, 1, 1636420551263, 1636420551530, 267, 0, 267, 0, 0, 0
740, 1, 1636420551337, 1636420551614, 277, 1, 276, 0, 0, 0
737, 1, 1636420551318, 1636420551618, 300, 1, 299, 1, 0, 1
748, 1, 1636420551478, 1636420551746, 268, 0, 268, 0, 0, 0
710, 2, 1636420542078, 1636420552078, 10000, 0, 10000, 1, 0, 1
750, 1, 1636420552227, 1636420552506, 279, 0, 279, 0, 0, 0
751, 1, 1636420552230, 1636420552506, 276, 1, 275, 0, 0, 0
752, 1, 1636420552258, 1636420552531, 273, 1, 272, 0, 0, 0
754, 1, 1636420552442, 1636420552714, 272, 1, 271, 0, 0, 0
716, 2, 1636420543226, 1636420553226, 10000, 0, 10000, 0, 0, 0
755, 1, 1636420553218, 1636420553491, 273, 1, 272, 0, 1, 1
756, 1, 1636420553222, 1636420553498, 276, 0, 276, 0, 0, 0
718, 1, 1636420543634, 1636420553498, 9864, 9592, 272, 0, 9592, 9592
758, 1, 1636420553458, 1636420553726, 268, 0, 268, 0, 0, 0
757, 1, 1636420553314, 1636420553758, 444, 178, 266, 177, 0, 177
761, 1, 1636420554194, 1636420554470, 276, 1, 275, 1, 0, 1
762, 1, 1636420554206, 1636420554474, 268, 1, 267, 0, 0, 0
763, 1, 1636420554298, 1636420554566, 268, 1, 267, 0, 0, 0
764, 1, 1636420554466, 1636420554734, 268, 1, 267, 0, 1, 1
765, 1, 1636420555178, 1636420555450, 272, 0, 272, 0, 0, 0
766, 1, 1636420555190, 1636420555458, 268, 1, 267, 1, 0, 1
767, 1, 1636420555310, 1636420555582, 272, 1, 271, 0, 0, 0
768, 1, 1636420555450, 1636420555722, 272, 1, 271, 0, 0, 0
769, 1, 1636420556150, 1636420556422, 272, 1, 271, 0, 1, 1
770, 1, 1636420556210, 1636420556482, 272, 0, 272, 0, 0, 0
771, 1, 1636420556306, 1636420556578, 272, 1, 271, 0, 1, 1
772, 1, 1636420556422, 1636420556699, 277, 1, 276, 1, 0, 1
773, 1, 1636420557186, 1636420557458, 272, 0, 272, 0, 0, 0
774, 1, 1636420557238, 1636420557510, 272, 1, 271, 0, 0, 0
775, 1, 1636420557278, 1636420557554, 276, 0, 276, 0, 0, 0
776, 1, 1636420557394, 1636420557666, 272, 0, 272, 0, 0, 0
777, 1, 1636420558214, 1636420558482, 268, 1, 267, 0, 0, 0
778, 1, 1636420558250, 1636420558522, 272, 1, 271, 0, 0, 0
779, 1, 1636420558270, 1636420558542, 272, 0, 272, 0, 0, 0
780, 1, 1636420558398, 1636420558675, 277, 0, 277, 0, 0, 0
781, 1, 1636420559226, 1636420559502, 276, 1, 275, 0, 0, 0
782, 1, 1636420559246, 1636420559518, 272, 1, 271, 0, 0, 0
783, 1, 1636420559302, 1636420559574, 272, 0, 272, 0, 0, 0
784, 1, 1636420559370, 1636420559638, 268, 0, 268, 0, 0, 0
785, 1, 1636420560234, 1636420560502, 268, 1, 267, 0, 1, 1
786, 1, 1636420560270, 1636420560538, 268, 1, 267, 0, 1, 1
787, 1, 1636420560274, 1636420560542, 268, 1, 267, 0, 1, 1
788, 1, 1636420560402, 1636420560674, 272, 1, 271, 0, 0, 0
736, 2, 1636420551318, 1636420561318, 10000, 0, 10000, 0, 0, 0
741, 2, 1636420551342, 1636420561366, 10024, 0, 10024, 0, 0, 0
744, 2, 1636420551337, 1636420561410, 10073, 0, 10073, 0, 0, 0
739, 2, 1636420551338, 1636420561454, 10116, 0, 10116, 0, 0, 0
746, 2, 1636420551342, 1636420561502, 10160, 0, 10160, 0, 0, 0
747, 2, 1636420551342, 1636420561550, 10208, 0, 10208, 0, 0, 0
745, 2, 1636420551334, 1636420561598, 10264, 0, 10264, 0, 0, 0
735, 2, 1636420551326, 1636420561646, 10320, 0, 10320, 0, 0, 0
734, 2, 1636420551326, 1636420561695, 10369, 0, 10369, 0, 0, 0
742, 2, 1636420551322, 1636420561743, 10421, 0, 10421, 0, 0, 0
738, 2, 1636420551322, 1636420561791, 10469, 0, 10469, 0, 0, 0
743, 2, 1636420551330, 1636420561839, 10509, 289, 10220, 289, 1, 290
749, 2, 1636420551750, 1636420561983, 10233, 0, 10233, 0, 0, 0
789, 1, 1636420561230, 1636420562130, 900, 0, 900, 0, 0, 0
791, 1, 1636420561270, 1636420562218, 948, 0, 948, 0, 0, 0
790, 1, 1636420561254, 1636420562218, 964, 1, 963, 1, 0, 1
792, 1, 1636420562038, 1636420562310, 272, 0, 272, 0, 0, 0
753, 2, 1636420552438, 1636420562438, 10000, 0, 10000, 9401, 0, 9401
794, 1, 1636420562246, 1636420562514, 268, 1, 267, 0, 0, 0
806, 1, 1636420562529, 1636420562794, 265, 0, 265, 0, 0, 0
807, 1, 1636420562614, 1636420562882, 268, 0, 268, 0, 0, 0
808, 1, 1636420562630, 1636420562898, 268, 0, 268, 0, 0, 0
809, 1, 1636420562706, 1636420562970, 264, 1, 263, 0, 0, 0
810, 1, 1636420563186, 1636420563458, 272, 1, 271, 0, 1, 1
759, 2, 1636420553582, 1636420563583, 10001, 0, 10001, 8257, 0, 8257
812, 1, 1636420563550, 1636420563814, 264, 1, 263, 0, 0, 0
811, 1, 1636420563502, 1636420563814, 312, 0, 312, 0, 0, 0
760, 1, 1636420553918, 1636420563850, 9932, 9665, 267, 7921, 1744, 9665
813, 1, 1636420563634, 1636420563902, 268, 0, 268, 0, 0, 0
814, 1, 1636420563674, 1636420563942, 268, 0, 268, 0, 0, 0
816, 1, 1636420564178, 1636420564451, 273, 1, 272, 0, 0, 0
818, 1, 1636420564506, 1636420564782, 276, 0, 276, 0, 0, 0
819, 1, 1636420564542, 1636420564810, 268, 1, 267, 0, 0, 0
820, 1, 1636420564594, 1636420564866, 272, 1, 271, 0, 0, 0
821, 1, 1636420564702, 1636420564974, 272, 0, 272, 0, 0, 0
822, 1, 1636420565150, 1636420565422, 272, 1, 271, 1, 0, 1
823, 1, 1636420565494, 1636420565770, 276, 1, 275, 0, 0, 0
824, 1, 1636420565558, 1636420565826, 268, 0, 268, 0, 0, 0
825, 1, 1636420565586, 1636420565858, 272, 0, 272, 0, 0, 0
826, 1, 1636420565710, 1636420565978, 268, 1, 267, 0, 0, 0
827, 1, 1636420566126, 1636420566399, 273, 1, 272, 1, 0, 1
828, 1, 1636420566470, 1636420566746, 276, 1, 275, 0, 1, 1
829, 1, 1636420566586, 1636420566854, 268, 0, 268, 0, 0, 0
830, 1, 1636420566610, 1636420566887, 277, 1, 276, 0, 1, 1
831, 1, 1636420566714, 1636420566986, 272, 1, 271, 0, 1, 1
832, 1, 1636420567158, 1636420567430, 272, 1, 271, 1, 0, 1
833, 1, 1636420567470, 1636420567738, 268, 0, 268, 0, 0, 0
834, 1, 1636420567586, 1636420567862, 276, 1, 275, 0, 0, 0
835, 1, 1636420567638, 1636420567906, 268, 0, 268, 0, 0, 0
836, 1, 1636420567738, 1636420568002, 264, 0, 264, 0, 0, 0
837, 1, 1636420568162, 1636420568442, 280, 1, 279, 1, 0, 1
838, 1, 1636420568470, 1636420568742, 272, 0, 272, 0, 0, 0
839, 1, 1636420568574, 1636420568846, 272, 0, 272, 0, 0, 0
840, 1, 1636420568638, 1636420568910, 272, 1, 271, 0, 0, 0
841, 1, 1636420568770, 1636420569042, 272, 0, 272, 0, 0, 0
842, 1, 1636420569186, 1636420569458, 272, 1, 271, 0, 1, 1
843, 1, 1636420569454, 1636420569722, 268, 0, 268, 0, 0, 0
844, 1, 1636420569598, 1636420569866, 268, 0, 268, 0, 0, 0
845, 1, 1636420569626, 1636420569898, 272, 1, 271, 1, 0, 1
846, 1, 1636420569750, 1636420570018, 268, 0, 268, 0, 0, 0
847, 1, 1636420570186, 1636420570454, 268, 0, 268, 0, 0, 0
848, 1, 1636420570442, 1636420570718, 276, 1, 275, 1, 0, 1
849, 1, 1636420570618, 1636420570890, 272, 1, 271, 0, 0, 0
850, 1, 1636420570650, 1636420570927, 277, 1, 276, 0, 0, 0
851, 1, 1636420570730, 1636420571002, 272, 0, 272, 0, 0, 0
852, 1, 1636420571178, 1636420571454, 276, 0, 276, 0, 0, 0
853, 1, 1636420571414, 1636420571686, 272, 1, 271, 0, 0, 0
854, 1, 1636420571598, 1636420571862, 264, 1, 263, 0, 0, 0
855, 1, 1636420571650, 1636420571918, 268, 0, 268, 0, 0, 0
856, 1, 1636420571710, 1636420571986, 276, 1, 275, 0, 0, 0
793, 2, 1636420562246, 1636420572247, 10001, 0, 10001, 271, 0, 271
805, 2, 1636420562266, 1636420572294, 10028, 0, 10028, 249, 0, 249
803, 2, 1636420562266, 1636420572343, 10077, 0, 10077, 250, 0, 250
801, 2, 1636420562266, 1636420572390, 10124, 0, 10124, 249, 0, 249
798, 2, 1636420562266, 1636420572438, 10172, 0, 10172, 250, 0, 250
800, 2, 1636420562266, 1636420572487, 10221, 0, 10221, 250, 0, 250
802, 2, 1636420562266, 1636420572538, 10272, 0, 10272, 249, 0, 249
804, 2, 1636420562266, 1636420572582, 10316, 0, 10316, 249, 0, 249
799, 2, 1636420562266, 1636420572630, 10364, 0, 10364, 250, 0, 250
797, 2, 1636420562254, 1636420572679, 10425, 0, 10425, 261, 0, 261
796, 2, 1636420562254, 1636420572727, 10473, 0, 10473, 262, 0, 262
795, 2, 1636420562250, 1636420572774, 10524, 0, 10524, 267, 0, 267
858, 1, 1636420572162, 1636420573010, 848, 0, 848, 0, 0, 0
859, 1, 1636420572870, 1636420573134, 264, 1, 263, 0, 0, 0
861, 1, 1636420572874, 1636420573138, 264, 1, 263, 0, 1, 1
860, 1, 1636420572874, 1636420573146, 272, 1, 271, 0, 1, 1
862, 1, 1636420572954, 1636420573218, 264, 0, 264, 0, 0, 0
863, 1, 1636420573038, 1636420573306, 268, 1, 267, 0, 0, 0
875, 1, 1636420573426, 1636420573694, 268, 1, 267, 0, 0, 0
876, 1, 1636420573542, 1636420573810, 268, 1, 267, 0, 1, 1
878, 1, 1636420573638, 1636420573906, 268, 0, 268, 0, 0, 0
877, 1, 1636420573638, 1636420573906, 268, 0, 268, 0, 0, 0
815, 2, 1636420564154, 1636420574154, 10000, 0, 10000, 0, 0, 0
817, 2, 1636420564250, 1636420574250, 10000, 0, 10000, 0, 0, 0
881, 1, 1636420574382, 1636420574658, 276, 1, 275, 0, 0, 0
883, 1, 1636420574486, 1636420574754, 268, 1, 267, 0, 1, 1
885, 1, 1636420574630, 1636420574902, 272, 1, 271, 0, 1, 1
886, 1, 1636420574670, 1636420574938, 268, 1, 267, 0, 0, 0
887, 1, 1636420575334, 1636420575606, 272, 1, 271, 1, 0, 1
888, 1, 1636420575478, 1636420575750, 272, 0, 272, 0, 0, 0
889, 1, 1636420575626, 1636420575898, 272, 1, 271, 0, 0, 0
890, 1, 1636420575654, 1636420575926, 272, 1, 271, 0, 1, 1
891, 1, 1636420576362, 1636420576634, 272, 1, 271, 0, 0, 0
892, 1, 1636420576478, 1636420576754, 276, 1, 275, 0, 0, 0
893, 1, 1636420576654, 1636420576930, 276, 1, 275, 0, 1, 1
894, 1, 1636420576662, 1636420576930, 268, 1, 267, 0, 0, 0
895, 1, 1636420577398, 1636420577666, 268, 1, 267, 0, 0, 0
896, 1, 1636420577490, 1636420577758, 268, 0, 268, 0, 0, 0
897, 1, 1636420577658, 1636420577930, 272, 0, 272, 0, 0, 0
898, 1, 1636420577686, 1636420577954, 268, 1, 267, 0, 0, 0
899, 1, 1636420578386, 1636420578658, 272, 1, 271, 1, 0, 1
900, 1, 1636420578506, 1636420578774, 268, 0, 268, 0, 0, 0
901, 1, 1636420578642, 1636420578914, 272, 0, 272, 0, 0, 0
902, 1, 1636420578686, 1636420578954, 268, 0, 268, 0, 0, 0
903, 1, 1636420579354, 1636420579626, 272, 1, 271, 0, 0, 0
904, 1, 1636420579474, 1636420579742, 268, 0, 268, 0, 0, 0
905, 1, 1636420579630, 1636420579902, 272, 0, 272, 0, 0, 0
906, 1, 1636420579682, 1636420579958, 276, 0, 276, 0, 0, 0
907, 1, 1636420580322, 1636420580594, 272, 1, 271, 0, 0, 0
908, 1, 1636420580454, 1636420580722, 268, 1, 267, 0, 1, 1
910, 1, 1636420580674, 1636420580950, 276, 1, 275, 0, 1, 1
909, 1, 1636420580602, 1636420580990, 388, 121, 267, 121, 0, 121
911, 1, 1636420581322, 1636420581590, 268, 1, 267, 0, 0, 0
912, 1, 1636420581466, 1636420581738, 272, 1, 271, 0, 0, 0
913, 1, 1636420581582, 1636420581858, 276, 1, 275, 0, 0, 0
914, 1, 1636420581642, 1636420581910, 268, 0, 268, 0, 0, 0
857, 2, 1636420572150, 1636420582150, 10000, 0, 10000, 0, 0, 0
880, 1, 1636420573962, 1636420582418, 8456, 8189, 267, 0, 8189, 8189
915, 1, 1636420582334, 1636420582606, 272, 1, 271, 1, 0, 1
917, 1, 1636420582498, 1636420582770, 272, 1, 271, 0, 0, 0
918, 1, 1636420582578, 1636420582850, 272, 0, 272, 0, 0, 0
919, 1, 1636420582618, 1636420582898, 280, 0, 280, 0, 0, 0
864, 2, 1636420573042, 1636420583043, 10001, 0, 10001, 266, 0, 266
867, 2, 1636420573050, 1636420583090, 10040, 0, 10040, 258, 0, 258
868, 2, 1636420573050, 1636420583138, 10088, 0, 10088, 259, 0, 259
870, 2, 1636420573050, 1636420583186, 10136, 0, 10136, 257, 0, 257
873, 2, 1636420573046, 1636420583234, 10188, 0, 10188, 262, 0, 262
872, 2, 1636420573046, 1636420583279, 10233, 0, 10233, 262, 0, 262
874, 2, 1636420573046, 1636420583326, 10280, 0, 10280, 263, 0, 263
866, 2, 1636420573042, 1636420583370, 10328, 0, 10328, 266, 0, 266
871, 2, 1636420573042, 1636420583414, 10372, 0, 10372, 265, 0, 265
865, 2, 1636420573042, 1636420583462, 10420, 0, 10420, 266, 0, 266
869, 2, 1636420573042, 1636420583511, 10469, 0, 10469, 266, 0, 266
920, 1, 1636420582842, 1636420583562, 720, 1, 719, 0, 0, 0
921, 1, 1636420583606, 1636420583878, 272, 1, 271, 0, 1, 1
922, 1, 1636420583606, 1636420583878, 272, 1, 271, 0, 0, 0
879, 2, 1636420573926, 1636420583926, 10000, 0, 10000, 0, 0, 0
923, 1, 1636420583694, 1636420583974, 280, 0, 280, 0, 0, 0
924, 1, 1636420583694, 1636420583974, 280, 1, 279, 0, 0, 0
925, 1, 1636420583770, 1636420584062, 292, 1, 291, 0, 0, 0
936, 1, 1636420583974, 1636420584238, 264, 0, 264, 0, 0, 0
930, 1, 1636420583782, 1636420584326, 544, 281, 263, 281, 0, 281
882, 2, 1636420574458, 1636420584458, 10000, 0, 10000, 1, 0, 1
937, 1, 1636420584282, 1636420584594, 312, 0, 312, 0, 0, 0
884, 2, 1636420574614, 1636420584614, 10000, 0, 10000, 0, 0, 0
938, 1, 1636420584350, 1636420584661, 311, 0, 311, 0, 0, 0
939, 1, 1636420584501, 1636420584770, 269, 1, 268, 0, 0, 0
916, 1, 1636420582458, 1636420584886, 2428, 2156, 272, 0, 2156, 2156
940, 1, 1636420584661, 1636420584926, 265, 1, 264, 0, 0, 0
941, 1, 1636420584661, 1636420584934, 273, 1, 272, 0, 0, 0
946, 1, 1636420584918, 1636420585182, 264, 1, 263, 0, 0, 0
947, 1, 1636420585198, 1636420585478, 280, 1, 279, 0, 0, 0
949, 1, 1636420585326, 1636420585594, 268, 0, 268, 0, 0, 0
950, 1, 1636420585526, 1636420585798, 272, 0, 272, 0, 0, 0
952, 1, 1636420585642, 1636420585914, 272, 1, 271, 0, 0, 0
953, 1, 1636420585886, 1636420586162, 276, 1, 275, 0, 0, 0
954, 1, 1636420586166, 1636420586434, 268, 0, 268, 0, 0, 0
955, 1, 1636420586342, 1636420586610, 268, 1, 267, 0, 0, 0
956, 1, 1636420586518, 1636420586786, 268, 1, 267, 1, 0, 1
957, 1, 1636420586650, 1636420586922, 272, 1, 271, 1, 0, 1
958, 1, 1636420586918, 1636420587186, 268, 0, 268, 0, 0, 0
960, 1, 1636420587350, 1636420587619, 269, 1, 268, 0, 0, 0
961, 1, 1636420587502, 1636420587778, 276, 1, 275, 0, 1, 1
962, 1, 1636420587670, 1636420587934, 264, 0, 264, 0, 0, 0
963, 1, 1636420587926, 1636420588194, 268, 1, 267, 0, 0, 0
964, 1, 1636420588334, 1636420588606, 272, 1, 271, 0, 0, 0
966, 1, 1636420588638, 1636420588914, 276, 0, 276, 0, 0, 0
967, 1, 1636420588942, 1636420589219, 277, 1, 276, 0, 0, 0
968, 1, 1636420589302, 1636420589574, 272, 1, 271, 0, 0, 0
969, 1, 1636420589618, 1636420589894, 276, 0, 276, 0, 0, 0
970, 1, 1636420589946, 1636420590218, 272, 1, 271, 0, 0, 0
971, 1, 1636420590270, 1636420590534, 264, 1, 263, 0, 0, 0
972, 1, 1636420590630, 1636420590906, 276, 1, 275, 0, 0, 0
973, 1, 1636420590942, 1636420591206, 264, 1, 263, 0, 0, 0
974, 1, 1636420591306, 1636420591574, 268, 1, 267, 1, 0, 1
975, 1, 1636420591638, 1636420591910, 272, 1, 271, 0, 0, 0
976, 1, 1636420591922, 1636420592194, 272, 1, 271, 0, 0, 0
977, 1, 1636420592302, 1636420592570, 268, 0, 268, 0, 0, 0
978, 1, 1636420592618, 1636420592894, 276, 0, 276, 0, 0, 0
979, 1, 1636420592958, 1636420593230, 272, 1, 271, 0, 0, 0
980, 1, 1636420593330, 1636420593602, 272, 1, 271, 1, 0, 1
928, 2, 1636420583774, 1636420593774, 10000, 0, 10000, 553, 0, 553
935, 2, 1636420583790, 1636420593823, 10033, 0, 10033, 538, 0, 538
933, 2, 1636420583790, 1636420593871, 10081, 0, 10081, 538, 0, 538
929, 2, 1636420583782, 1636420593919, 10137, 0, 10137, 545, 0, 545
934, 2, 1636420583782, 1636420593966, 10184, 0, 10184, 545, 0, 545
932, 2, 1636420583782, 1636420594015, 10233, 0, 10233, 544, 0, 544
926, 2, 1636420583782, 1636420594062, 10280, 0, 10280, 544, 0, 544
927, 2, 1636420583782, 1636420594111, 10329, 0, 10329, 545, 0, 545
931, 2, 1636420583782, 1636420594159, 10377, 0, 10377, 545, 0, 545
981, 1, 1636420593634, 1636420594294, 660, 0, 660, 0, 0, 0
982, 1, 1636420594250, 1636420594522, 272, 1, 271, 0, 0, 0
983, 1, 1636420594370, 1636420594642, 272, 0, 272, 0, 0, 0
942, 2, 1636420584705, 1636420594706, 10001, 0, 10001, 221, 0, 221
943, 2, 1636420584734, 1636420594754, 10020, 0, 10020, 193, 0, 193
944, 2, 1636420584790, 1636420594802, 10012, 0, 10012, 0, 0, 0
945, 2, 1636420584934, 1636420594934, 10000, 0, 10000, 0, 0, 0
993, 1, 1636420594690, 1636420595070, 380, 1, 379, 0, 0, 0
987, 1, 1636420594634, 1636420595074, 440, 0, 440, 0, 0, 0
951, 1, 1636420585602, 1636420595074, 9472, 9153, 319, 0, 9152, 9152
994, 1, 1636420594982, 1636420595254, 272, 1, 271, 0, 0, 0
948, 2, 1636420585298, 1636420595298, 10000, 0, 10000, 0, 0, 0
996, 1, 1636420595230, 1636420595526, 296, 1, 295, 0, 0, 0
999, 1, 1636420595346, 1636420595610, 264, 0, 264, 0, 0, 0
1000, 1, 1636420595474, 1636420595742, 268, 1, 267, 0, 0, 0
997, 1, 1636420595234, 1636420595794, 560, 293, 267, 293, 0, 293
1003, 1, 1636420595630, 1636420595902, 272, 1, 271, 0, 0, 0
1001, 1, 1636420595538, 1636420596058, 520, 257, 263, 257, 0, 257
1004, 1, 1636420595942, 1636420596210, 268, 1, 267, 0, 1, 1
1005, 1, 1636420596134, 1636420596402, 268, 0, 268, 0, 0, 0
1007, 1, 1636420596362, 1636420596626, 264, 1, 263, 0, 0, 0
1008, 1, 1636420596450, 1636420596718, 268, 0, 268, 0, 0, 0
1009, 1, 1636420596530, 1636420596802, 272, 0, 272, 0, 0, 0
1010, 1, 1636420596634, 1636420596906, 272, 0, 272, 0, 0, 0
959, 2, 1636420587166, 1636420597166, 10000, 0, 10000, 0, 0, 0
1011, 1, 1636420596942, 1636420597214, 272, 1, 271, 0, 0, 0
1012, 1, 1636420597110, 1636420597394, 284, 0, 284, 0, 0, 0
1013, 1, 1636420597374, 1636420597650, 276, 1, 275, 0, 1, 1
1015, 1, 1636420597454, 1636420597726, 272, 1, 271, 0, 0, 0
1014, 1, 1636420597478, 1636420597746, 268, 0, 268, 0, 0, 0
1016, 1, 1636420597510, 1636420597782, 272, 0, 272, 0, 0, 0
1017, 1, 1636420597642, 1636420597914, 272, 0, 272, 0, 0, 0
1018, 1, 1636420597942, 1636420598214, 272, 1, 271, 0, 0, 0
1019, 1, 1636420598126, 1636420598398, 272, 0, 272, 0, 0, 0
965, 2, 1636420588530, 1636420598530, 10000, 0, 10000, 0, 0, 0
1020, 1, 1636420598390, 1636420598666, 276, 0, 276, 0, 0, 0
1021, 1, 1636420598406, 1636420598670, 264, 0, 264, 0, 0, 0
1022, 1, 1636420598458, 1636420598758, 300, 0, 300, 0, 0, 0
1023, 1, 1636420598522, 1636420598790, 268, 1, 267, 0, 0, 0
1006, 1, 1636420596190, 1636420598798, 2608, 2341, 267, 0, 2340, 2340
1024, 1, 1636420598666, 1636420598930, 264, 1, 263, 0, 0, 0
1025, 1, 1636420598838, 1636420599194, 356, 93, 263, 93, 0, 93
1026, 1, 1636420598934, 1636420599198, 264, 0, 264, 0, 0, 0
1027, 1, 1636420599130, 1636420599398, 268, 1, 267, 0, 1, 1
1028, 1, 1636420599210, 1636420599482, 272, 0, 272, 0, 0, 0
1029, 1, 1636420599358, 1636420599626, 268, 0, 268, 0, 0, 0
1030, 1, 1636420599422, 1636420599690, 268, 0, 268, 0, 0, 0
1031, 1, 1636420599466, 1636420599730, 264, 0, 264, 0, 0, 0
1032, 1, 1636420599530, 1636420599794, 264, 0, 264, 0, 0, 0
1033, 1, 1636420599658, 1636420599930, 272, 1, 271, 0, 0, 0
1034, 1, 1636420599762, 1636420600202, 440, 169, 271, 169, 0, 169
1035, 1, 1636420599954, 1636420600218, 264, 1, 263, 0, 1, 1
1036, 1, 1636420600138, 1636420600402, 264, 0, 264, 0, 0, 0
1037, 1, 1636420600154, 1636420600422, 268, 1, 267, 0, 0, 0
1038, 1, 1636420600338, 1636420600606, 268, 0, 268, 0, 0, 0
1039, 1, 1636420600414, 1636420600686, 272, 1, 271, 0, 0, 0
1040, 1, 1636420600498, 1636420600762, 264, 0, 264, 0, 0, 0
1041, 1, 1636420600542, 1636420600806, 264, 0, 264, 0, 0, 0
1042, 1, 1636420600674, 1636420600946, 272, 0, 272, 0, 0, 0
1043, 1, 1636420600770, 1636420601214, 444, 177, 267, 177, 0, 177
1044, 1, 1636420600974, 1636420601242, 268, 1, 267, 1, 0, 1
1045, 1, 1636420601122, 1636420601386, 264, 0, 264, 0, 0, 0
1046, 1, 1636420601158, 1636420601422, 264, 0, 264, 0, 0, 0
1047, 1, 1636420601346, 1636420601610, 264, 1, 263, 0, 0, 0
1048, 1, 1636420601422, 1636420601686, 264, 1, 263, 0, 0, 0
1050, 1, 1636420601542, 1636420601810, 268, 1, 267, 0, 0, 0
1051, 1, 1636420601670, 1636420601942, 272, 1, 271, 0, 1, 1
1052, 1, 1636420601766, 1636420602214, 448, 177, 271, 177, 0, 177
1053, 1, 1636420601958, 1636420602226, 268, 0, 268, 0, 0, 0
1054, 1, 1636420602118, 1636420602390, 272, 0, 272, 0, 0, 0
1055, 1, 1636420602150, 1636420602414, 264, 1, 263, 0, 0, 0
1056, 1, 1636420602382, 1636420602646, 264, 0, 264, 0, 0, 0
1057, 1, 1636420602398, 1636420602666, 268, 0, 268, 0, 0, 0
1058, 1, 1636420602542, 1636420602810, 268, 1, 267, 1, 0, 1
1059, 1, 1636420602678, 1636420602950, 272, 0, 272, 0, 0, 0
1060, 1, 1636420602778, 1636420603222, 444, 173, 271, 173, 0, 173
1061, 1, 1636420602958, 1636420603230, 272, 0, 272, 0, 0, 0
1062, 1, 1636420603134, 1636420603402, 268, 0, 268, 0, 0, 0
1063, 1, 1636420603150, 1636420603418, 268, 1, 267, 0, 0, 0
1064, 1, 1636420603366, 1636420603638, 272, 0, 272, 0, 0, 0
1065, 1, 1636420603386, 1636420603662, 276, 0, 276, 0, 0, 0
1066, 1, 1636420603522, 1636420603790, 268, 0, 268, 0, 0, 0
1067, 1, 1636420603654, 1636420603926, 272, 0, 272, 0, 0, 0
1068, 1, 1636420603774, 1636420604194, 420, 153, 267, 153, 0, 153
1069, 1, 1636420603994, 1636420604266, 272, 1, 271, 1, 0, 1
1070, 1, 1636420604162, 1636420604425, 263, 1, 262, 0, 0, 0
1071, 1, 1636420604186, 1636420604454, 268, 1, 267, 0, 1, 1
984, 2, 1636420594638, 1636420604634, 9996, 0, 9996, 437, 0, 437
991, 2, 1636420594646, 1636420604682, 10036, 0, 10036, 429, 0, 429
990, 2, 1636420594646, 1636420604730, 10084, 0, 10084, 429, 0, 429
989, 2, 1636420594646, 1636420604775, 10129, 0, 10129, 429, 0, 429
992, 2, 1636420594642, 1636420604818, 10176, 0, 10176, 433, 0, 433
988, 2, 1636420594638, 1636420604863, 10225, 0, 10225, 437, 0, 437
985, 2, 1636420594642, 1636420604911, 10269, 0, 10269, 433, 0, 433
986, 2, 1636420594642, 1636420604959, 10317, 0, 10317, 433, 0, 433
1072, 1, 1636420604382, 1636420605006, 624, 0, 624, 0, 0, 0
995, 2, 1636420595110, 1636420605110, 10000, 0, 10000, 0, 0, 0
1074, 1, 1636420604546, 1636420605190, 644, 1, 643, 1, 0, 1
998, 2, 1636420595242, 1636420605242, 10000, 0, 10000, 0, 0, 0
1075, 1, 1636420605006, 1636420605290, 284, 0, 284, 0, 0, 0
1073, 1, 1636420604394, 1636420605294, 900, 613, 287, 613, 0, 613
1077, 1, 1636420605050, 1636420605386, 336, 0, 336, 0, 0, 0
1079, 1, 1636420605206, 1636420605478, 272, 0, 272, 0, 0, 0
1078, 1, 1636420605158, 1636420605478, 320, 0, 320, 0, 0, 0
1076, 1, 1636420605006, 1636420605554, 548, 284, 264, 284, 0, 284
1002, 2, 1636420595606, 1636420605610, 10004, 0, 10004, 0, 0, 0
1089, 1, 1636420605434, 1636420605746, 312, 0, 312, 0, 0, 0
1091, 1, 1636420605590, 1636420605866, 276, 1, 275, 0, 1, 1
1049, 1, 1636420601478, 1636420605886, 4408, 4132, 276, 0, 4132, 4132
1092, 1, 1636420605706, 1636420605974, 268, 1, 267, 0, 1, 1
1093, 1, 1636420605706, 1636420605978, 272, 1, 271, 0, 0, 0
1096, 1, 1636420605958, 1636420606222, 264, 0, 264, 0, 0, 0
1095, 1, 1636420605950, 1636420606242, 292, 25, 267, 25, 0, 25
1097, 1, 1636420606150, 1636420606418, 268, 1, 267, 0, 1, 1
1098, 1, 1636420606158, 1636420606422, 264, 0, 264, 0, 0, 0
1099, 1, 1636420606285, 1636420606554, 269, 1, 268, 0, 0, 0
1100, 1, 1636420606358, 1636420606630, 272, 0, 272, 0, 0, 0
1101, 1, 1636420606546, 1636420606810, 264, 0, 264, 0, 0, 0
1102, 1, 1636420606626, 1636420606902, 276, 1, 275, 0, 0, 0
1103, 1, 1636420606646, 1636420606914, 268, 0, 268, 0, 0, 0
1104, 1, 1636420606906, 1636420607178, 272, 8, 264, 8, 0, 8
1105, 1, 1636420606978, 1636420607242, 264, 0, 264, 0, 0, 0
1106, 1, 1636420607154, 1636420607422, 268, 1, 267, 1, 0, 1
1107, 1, 1636420607166, 1636420607430, 264, 0, 264, 0, 0, 0
1108, 1, 1636420607222, 1636420607486, 264, 0, 264, 0, 0, 0
1109, 1, 1636420607362, 1636420607626, 264, 0, 264, 0, 0, 0
1110, 1, 1636420607574, 1636420607842, 268, 0, 268, 0, 0, 0
1111, 1, 1636420607606, 1636420607874, 268, 0, 268, 0, 0, 0
1112, 1, 1636420607638, 1636420607906, 268, 0, 268, 0, 0, 0
1113, 1, 1636420607874, 1636420608142, 268, 1, 267, 1, 0, 1
1114, 1, 1636420607998, 1636420608266, 268, 1, 267, 1, 0, 1
1116, 1, 1636420608174, 1636420608442, 268, 1, 267, 0, 1, 1
1117, 1, 1636420608242, 1636420608510, 268, 0, 268, 0, 0, 0
1115, 1, 1636420608166, 1636420608530, 364, 101, 263, 101, 0, 101
1118, 1, 1636420608330, 1636420608602, 272, 0, 272, 0, 0, 0
1119, 1, 1636420608610, 1636420608878, 268, 0, 268, 0, 0, 0
1120, 1, 1636420608626, 1636420608894, 268, 0, 268, 0, 0, 0
1121, 1, 1636420608646, 1636420608918, 272, 0, 272, 0, 0, 0
1122, 1, 1636420608882, 1636420609158, 276, 13, 263, 13, 0, 13
1123, 1, 1636420608978, 1636420609246, 268, 1, 267, 0, 1, 1
1124, 1, 1636420609166, 1636420609434, 268, 0, 268, 0, 0, 0
1125, 1, 1636420609186, 1636420609450, 264, 1, 263, 0, 0, 0
1126, 1, 1636420609254, 1636420609522, 268, 0, 268, 0, 0, 0
1128, 1, 1636420609598, 1636420609870, 272, 1, 271, 1, 0, 1
1129, 1, 1636420609598, 1636420609870, 272, 1, 271, 0, 1, 1
1130, 1, 1636420609638, 1636420609906, 268, 0, 268, 0, 0, 0
1131, 1, 1636420609846, 1636420610142, 296, 25, 271, 25, 0, 25
1132, 1, 1636420609966, 1636420610230, 264, 1, 263, 0, 1, 1
1133, 1, 1636420610154, 1636420610426, 272, 0, 272, 0, 0, 0
1134, 1, 1636420610198, 1636420610466, 268, 0, 268, 0, 0, 0
1135, 1, 1636420610262, 1636420610534, 272, 1, 271, 0, 0, 0
1136, 1, 1636420610566, 1636420610838, 272, 1, 271, 0, 0, 0
1138, 1, 1636420610662, 1636420610934, 272, 1, 271, 1, 0, 1
1140, 1, 1636420610966, 1636420611230, 264, 0, 264, 0, 0, 0
1141, 1, 1636420611174, 1636420611442, 268, 0, 268, 0, 0, 0
1142, 1, 1636420611186, 1636420611502, 316, 45, 271, 45, 0, 45
1143, 1, 1636420611254, 1636420611526, 272, 0, 272, 0, 0, 0
1144, 1, 1636420611530, 1636420611798, 268, 0, 268, 0, 0, 0
1145, 1, 1636420611678, 1636420611946, 268, 0, 268, 0, 0, 0
1146, 1, 1636420611958, 1636420612226, 268, 1, 267, 0, 0, 0
1147, 1, 1636420612178, 1636420612446, 268, 1, 267, 0, 0, 0
1148, 1, 1636420612210, 1636420612474, 264, 1, 263, 0, 1, 1
1149, 1, 1636420612282, 1636420612546, 264, 0, 264, 0, 0, 0
1150, 1, 1636420612498, 1636420612766, 268, 1, 267, 0, 1, 1
1151, 1, 1636420612662, 1636420612934, 272, 1, 271, 0, 0, 0
1152, 1, 1636420612954, 1636420613226, 272, 0, 272, 0, 0, 0
1154, 1, 1636420613182, 1636420613446, 264, 1, 263, 0, 1, 1
1153, 1, 1636420613174, 1636420613446, 272, 1, 271, 1, 0, 1
1155, 1, 1636420613286, 1636420613554, 268, 0, 268, 0, 0, 0
1156, 1, 1636420613522, 1636420613787, 265, 1, 264, 0, 1, 1
1157, 1, 1636420613670, 1636420613938, 268, 0, 268, 0, 0, 0
1158, 1, 1636420613942, 1636420614214, 272, 1, 271, 0, 1, 1
1159, 1, 1636420614146, 1636420614414, 268, 1, 267, 0, 1, 1
1160, 1, 1636420614210, 1636420614478, 268, 0, 268, 0, 0, 0
1161, 1, 1636420614278, 1636420614546, 268, 1, 267, 0, 0, 0
1162, 1, 1636420614542, 1636420614815, 273, 0, 273, 0, 0, 0
1163, 1, 1636420614638, 1636420614906, 268, 1, 267, 0, 1, 1
1164, 1, 1636420614954, 1636420615222, 268, 0, 268, 0, 0, 0
1087, 2, 1636420605378, 1636420615378, 10000, 0, 10000, 0, 0, 0
1083, 2, 1636420605422, 1636420615422, 10000, 0, 10000, 0, 0, 0
1084, 2, 1636420605422, 1636420615466, 10044, 0, 10044, 1, 0, 1
1085, 2, 1636420605422, 1636420615510, 10088, 0, 10088, 1, 0, 1
1082, 2, 1636420605422, 1636420615558, 10136, 0, 10136, 0, 0, 0
1081, 2, 1636420605422, 1636420615602, 10180, 0, 10180, 0, 0, 0
1080, 2, 1636420605418, 1636420615646, 10228, 0, 10228, 0, 0, 0
1086, 2, 1636420605378, 1636420615690, 10312, 0, 10312, 0, 0, 0
1088, 2, 1636420605378, 1636420615734, 10356, 0, 10356, 0, 0, 0
1090, 2, 1636420605550, 1636420615783, 10233, 0, 10233, 0, 0, 0
1090, 2, 1636420605550, 1636420615783, 10233, 0, 10233, 0, 0, 0
1165, 1, 1636420615166, 1636420615834, 668, 1, 667, 0, 1, 1
1166, 1, 1636420615214, 1636420615918, 704, 0, 704, 0, 0, 0
1167, 1, 1636420615310, 1636420615962, 652, 0, 652, 0, 0, 0
1094, 1, 1636420605914, 1636420616050, 10136, 9869, 267, 0, 9869, 9869
1168, 1, 1636420615834, 1636420616106, 272, 0, 272, 0, 0, 0
1169, 1, 1636420615874, 1636420616138, 264, 0, 264, 0, 0, 0
1170, 1, 1636420615994, 1636420616266, 272, 0, 272, 0, 0, 0
1181, 1, 1636420616242, 1636420616514, 272, 1, 271, 0, 1, 1
1182, 1, 1636420616342, 1636420616610, 268, 0, 268, 0, 0, 0
1183, 1, 1636420616358, 1636420616630, 272, 0, 272, 0, 0, 0
1185, 1, 1636420616546, 1636420616882, 336, 65, 271, 65, 0, 65
1186, 1, 1636420616634, 1636420617150, 516, 249, 267, 249, 0, 249
1187, 1, 1636420616938, 1636420617206, 268, 1, 267, 0, 1, 1
1188, 1, 1636420617182, 1636420617454, 272, 1, 271, 0, 1, 1
1189, 1, 1636420617322, 1636420617590, 268, 1, 267, 0, 0, 0
1190, 1, 1636420617342, 1636420617614, 272, 1, 271, 0, 0, 0
1191, 1, 1636420617530, 1636420617862, 332, 60, 272, 60, 0, 60
1192, 1, 1636420617626, 1636420617890, 264, 1, 263, 0, 1, 1
1193, 1, 1636420617918, 1636420618187, 269, 0, 269, 0, 0, 0
1194, 1, 1636420618186, 1636420618450, 264, 1, 263, 0, 0, 0
1195, 1, 1636420618358, 1636420618626, 268, 0, 268, 0, 0, 0
1196, 1, 1636420618382, 1636420618650, 268, 1, 267, 0, 1, 1
1198, 1, 1636420618598, 1636420618870, 272, 0, 272, 0, 0, 0
1197, 1, 1636420618550, 1636420618894, 344, 77, 267, 77, 0, 77
1199, 1, 1636420618934, 1636420619206, 272, 1, 271, 0, 1, 1
1127, 2, 1636420609306, 1636420619306, 10000, 0, 10000, 0, 0, 0
1200, 1, 1636420619186, 1636420619458, 272, 1, 271, 0, 1, 1
1201, 1, 1636420619354, 1636420619630, 276, 0, 276, 0, 0, 0
1202, 1, 1636420619398, 1636420619670, 272, 0, 272, 0, 0, 0
1205, 1, 1636420619586, 1636420619854, 268, 0, 268, 0, 0, 0
1204, 1, 1636420619614, 1636420619890, 276, 1, 275, 0, 0, 0
1203, 1, 1636420619546, 1636420619894, 348, 84, 264, 84, 0, 84
1206, 1, 1636420619966, 1636420620230, 264, 0, 264, 0, 0, 0
1207, 1, 1636420620174, 1636420620446, 272, 0, 272, 0, 0, 0
1137, 2, 1636420610586, 1636420620586, 10000, 0, 10000, 0, 0, 0
1208, 1, 1636420620314, 1636420620634, 320, 0, 320, 0, 0, 0
1209, 1, 1636420620394, 1636420620658, 264, 1, 263, 0, 1, 1
1210, 1, 1636420620530, 1636420620818, 288, 0, 288, 0, 0, 0
1212, 1, 1636420620554, 1636420620822, 268, 0, 268, 0, 0, 0
1139, 2, 1636420610842, 1636420620842, 10000, 0, 10000, 0, 0, 0
1211, 1, 1636420620546, 1636420620902, 356, 89, 267, 89, 0, 89
1213, 1, 1636420620934, 1636420621206, 272, 0, 272, 0, 0, 0
1214, 1, 1636420620986, 1636420621250, 264, 0, 264, 0, 0, 0
1216, 1, 1636420621170, 1636420621434, 264, 0, 264, 0, 0, 0
1217, 1, 1636420621282, 1636420621546, 264, 0, 264, 0, 0, 0
1218, 1, 1636420621426, 1636420621694, 268, 1, 267, 0, 0, 0
1219, 1, 1636420621514, 1636420621786, 272, 0, 272, 0, 0, 0
1220, 1, 1636420621522, 1636420621822, 300, 25, 275, 25, 0, 25
1221, 1, 1636420621562, 1636420621834, 272, 0, 272, 0, 0, 0
1222, 1, 1636420621834, 1636420622098, 264, 1, 263, 1, 0, 1
1223, 1, 1636420621950, 1636420622222, 272, 1, 271, 0, 1, 1
1224, 1, 1636420622190, 1636420622458, 268, 1, 267, 0, 0, 0
1225, 1, 1636420622290, 1636420622554, 264, 0, 264, 0, 0, 0
1226, 1, 1636420622438, 1636420622706, 268, 0, 268, 0, 0, 0
1227, 1, 1636420622482, 1636420622750, 268, 0, 268, 0, 0, 0
1228, 1, 1636420622562, 1636420622834, 272, 0, 272, 0, 0, 0
1229, 1, 1636420622602, 1636420622874, 272, 1, 271, 0, 1, 1
1230, 1, 1636420622846, 1636420623118, 272, 0, 272, 0, 0, 0
1231, 1, 1636420622978, 1636420623246, 268, 1, 267, 0, 1, 1
1232, 1, 1636420623190, 1636420623462, 272, 1, 271, 0, 0, 0
1233, 1, 1636420623254, 1636420623518, 264, 0, 264, 0, 0, 0
1234, 1, 1636420623466, 1636420623734, 268, 0, 268, 0, 0, 0
1235, 1, 1636420623514, 1636420623778, 264, 0, 264, 0, 0, 0
1236, 1, 1636420623526, 1636420623794, 268, 0, 268, 0, 0, 0
1237, 1, 1636420623598, 1636420623866, 268, 0, 268, 0, 0, 0
1238, 1, 1636420623854, 1636420624126, 272, 1, 271, 0, 1, 1
1239, 1, 1636420623986, 1636420624262, 276, 0, 276, 0, 0, 0
1240, 1, 1636420624170, 1636420624438, 268, 0, 268, 0, 0, 0
1241, 1, 1636420624266, 1636420624530, 264, 0, 264, 0, 0, 0
1242, 1, 1636420624490, 1636420624754, 264, 0, 264, 0, 0, 0
1243, 1, 1636420624502, 1636420624774, 272, 0, 272, 0, 0, 0
1244, 1, 1636420624542, 1636420624814, 272, 0, 272, 0, 0, 0
1245, 1, 1636420624566, 1636420624830, 264, 0, 264, 0, 0, 0
1246, 1, 1636420624850, 1636420625122, 272, 1, 271, 0, 0, 0
1247, 1, 1636420624994, 1636420625266, 272, 1, 271, 0, 1, 1
1248, 1, 1636420625162, 1636420625435, 273, 0, 273, 0, 0, 0
1249, 1, 1636420625238, 1636420625510, 272, 1, 271, 0, 0, 0
1250, 1, 1636420625486, 1636420625754, 268, 0, 268, 0, 0, 0
1252, 1, 1636420625526, 1636420625794, 268, 1, 267, 0, 1, 1
1253, 1, 1636420625562, 1636420625830, 268, 0, 268, 0, 0, 0
1171, 2, 1636420616046, 1636420626046, 10000, 0, 10000, 0, 0, 0
1180, 2, 1636420616066, 1636420626094, 10028, 0, 10028, 1, 0, 1
1174, 2, 1636420616066, 1636420626138, 10072, 0, 10072, 1, 0, 1
1178, 2, 1636420616066, 1636420626186, 10120, 0, 10120, 0, 0, 0
1175, 2, 1636420616066, 1636420626234, 10168, 0, 10168, 2, 0, 2
1172, 2, 1636420616066, 1636420626282, 10216, 0, 10216, 1, 0, 1
1173, 2, 1636420616066, 1636420626330, 10264, 0, 10264, 0, 0, 0
1179, 2, 1636420616066, 1636420626374, 10308, 0, 10308, 1, 0, 1
1176, 2, 1636420616058, 1636420626423, 10365, 0, 10365, 0, 0, 0
1177, 2, 1636420616046, 1636420626470, 10424, 0, 10424, 0, 0, 0
1184, 2, 1636420616454, 1636420626518, 10064, 0, 10064, 0, 0, 0
1254, 1, 1636420625818, 1636420626566, 748, 0, 748, 0, 0, 0
1255, 1, 1636420625990, 1636420626754, 764, 1, 763, 0, 1, 1
1256, 1, 1636420626570, 1636420626842, 272, 0, 272, 0, 0, 0
1258, 1, 1636420626614, 1636420626882, 268, 0, 268, 0, 0, 0
1259, 1, 1636420626614, 1636420626882, 268, 0, 268, 0, 0, 0
1257, 1, 1636420626646, 1636420626914, 268, 0, 268, 0, 0, 0
1272, 1, 1636420626962, 1636420627230, 268, 0, 268, 0, 0, 0
1273, 1, 1636420627146, 1636420627410, 264, 1, 263, 0, 1, 1
1274, 1, 1636420627238, 1636420627506, 268, 0, 268, 0, 0, 0
1275, 1, 1636420627278, 1636420627542, 264, 0, 264, 0, 0, 0
1277, 1, 1636420627582, 1636420627854, 272, 0, 272, 0, 0, 0
1279, 1, 1636420628110, 1636420628374, 264, 0, 264, 0, 0, 0
1280, 1, 1636420628194, 1636420628458, 264, 0, 264, 0, 0, 0
1281, 1, 1636420628250, 1636420628514, 264, 0, 264, 0, 0, 0
1282, 1, 1636420628610, 1636420628882, 272, 1, 271, 0, 1, 1
1283, 1, 1636420629130, 1636420629398, 268, 0, 268, 0, 0, 0
1284, 1, 1636420629170, 1636420629438, 268, 1, 267, 0, 0, 0
1285, 1, 1636420629254, 1636420629518, 264, 1, 263, 0, 1, 1
1286, 1, 1636420629614, 1636420629883, 269, 1, 268, 0, 0, 0
1287, 1, 1636420630154, 1636420630422, 268, 1, 267, 0, 1, 1
1288, 1, 1636420630162, 1636420630430, 268, 1, 267, 0, 1, 1
1289, 1, 1636420630278, 1636420630542, 264, 0, 264, 0, 0, 0
1290, 1, 1636420630634, 1636420630911, 277, 0, 277, 0, 0, 0
1215, 2, 1636420621150, 1636420631294, 10144, 57, 10087, 57, 0, 57
1292, 1, 1636420631198, 1636420631474, 276, 1, 275, 0, 1, 1
1291, 1, 1636420631134, 1636420631474, 340, 0, 340, 0, 0, 0
1278, 1, 1636420627910, 1636420631562, 3652, 3385, 267, 3385, 0, 3385
1293, 1, 1636420631382, 1636420631646, 264, 0, 264, 0, 0, 0
1294, 1, 1636420631602, 1636420631866, 264, 0, 264, 0, 0, 0
1295, 1, 1636420631662, 1636420631926, 264, 1, 263, 0, 0, 0
1296, 1, 1636420631958, 1636420632226, 268, 1, 267, 1, 0, 1
1298, 1, 1636420632206, 1636420632482, 276, 1, 275, 0, 0, 0
1297, 1, 1636420632154, 1636420632490, 336, 73, 263, 72, 0, 72
1299, 1, 1636420632306, 1636420632570, 264, 1, 263, 0, 1, 1
1300, 1, 1636420632494, 1636420632758, 264, 1, 263, 0, 0, 0
1301, 1, 1636420632694, 1636420632966, 272, 1, 271, 1, 0, 1
1302, 1, 1636420632882, 1636420633154, 272, 1, 271, 0, 1, 1
1303, 1, 1636420633174, 1636420633438, 264, 0, 264, 0, 0, 0
1304, 1, 1636420633226, 1636420633498, 272, 1, 271, 0, 1, 1
1305, 1, 1636420633294, 1636420633562, 268, 0, 268, 0, 0, 0
1306, 1, 1636420633530, 1636420633798, 268, 1, 267, 0, 0, 0
1307, 1, 1636420633674, 1636420633942, 268, 0, 268, 0, 0, 0
1308, 1, 1636420633894, 1636420634158, 264, 0, 264, 0, 0, 0
1310, 1, 1636420634194, 1636420634462, 268, 1, 267, 0, 1, 1
1309, 1, 1636420634190, 1636420634470, 280, 1, 279, 0, 0, 0
1311, 1, 1636420634274, 1636420634542, 268, 0, 268, 0, 0, 0
1312, 1, 1636420634530, 1636420634794, 264, 0, 264, 0, 0, 0
1313, 1, 1636420634654, 1636420634926, 272, 1, 271, 0, 0, 0
1314, 1, 1636420634866, 1636420635138, 272, 0, 272, 0, 0, 0
1315, 1, 1636420635162, 1636420635426, 264, 0, 264, 0, 0, 0
1316, 1, 1636420635178, 1636420635446, 268, 0, 268, 0, 0, 0
1251, 2, 1636420625498, 1636420635498, 10000, 0, 10000, 6064, 0, 6064
1317, 1, 1636420635254, 1636420635546, 292, 1, 291, 0, 0, 0
1318, 1, 1636420635546, 1636420635810, 264, 0, 264, 0, 0, 0
1319, 1, 1636420635634, 1636420635898, 264, 1, 263, 0, 1, 1
1320, 1, 1636420635886, 1636420636154, 268, 1, 267, 0, 1, 1
1321, 1, 1636420636178, 1636420636450, 272, 0, 272, 0, 0, 0
1322, 1, 1636420636190, 1636420636462, 272, 1, 271, 0, 1, 1
1323, 1, 1636420636270, 1636420636538, 268, 0, 268, 0, 0, 0
1260, 2, 1636420626706, 1636420636706, 10000, 0, 10000, 4856, 0, 4856
1324, 1, 1636420636514, 1636420636778, 264, 0, 264, 0, 0, 0
1261, 2, 1636420626790, 1636420636786, 9996, 0, 9996, 0, 0, 0
1271, 2, 1636420626794, 1636420636834, 10040, 0, 10040, 0, 0, 0
1269, 2, 1636420626794, 1636420636878, 10084, 0, 10084, 0, 0, 0
1266, 2, 1636420626790, 1636420636927, 10137, 0, 10137, 0, 0, 0
1268, 2, 1636420626790, 1636420636971, 10181, 0, 10181, 0, 0, 0
1270, 2, 1636420626790, 1636420637019, 10229, 0, 10229, 1, 0, 1
1267, 2, 1636420626790, 1636420637066, 10276, 0, 10276, 0, 0, 0
1265, 2, 1636420626790, 1636420637111, 10321, 0, 10321, 1, 0, 1
1264, 2, 1636420626786, 1636420637158, 10372, 0, 10372, 0, 0, 0
1262, 2, 1636420626786, 1636420637202, 10416, 0, 10416, 0, 0, 0
1263, 2, 1636420626786, 1636420637247, 10461, 0, 10461, 0, 0, 0
1325, 1, 1636420636662, 1636420637386, 724, 1, 723, 0, 0, 0
1276, 1, 1636420627438, 1636420637482, 10044, 9268, 776, 4125, 5143, 9268
1326, 1, 1636420637298, 1636420637570, 272, 0, 272, 0, 0, 0
1328, 1, 1636420637338, 1636420637606, 268, 0, 268, 0, 0, 0
1329, 1, 1636420637342, 1636420637606, 264, 1, 263, 0, 1, 1
1327, 1, 1636420637342, 1636420637606, 264, 1, 263, 0, 1, 1
1342, 1, 1636420637786, 1636420638058, 272, 0, 272, 0, 0, 0
1343, 1, 1636420637790, 1636420638066, 276, 0, 276, 0, 0, 0
1345, 1, 1636420637966, 1636420638230, 264, 1, 263, 0, 0, 0
1344, 1, 1636420637882, 1636420638330, 448, 185, 263, 185, 0, 185
1346, 1, 1636420638178, 1636420638454, 276, 0, 276, 0, 0, 0
1347, 1, 1636420638206, 1636420638470, 264, 0, 264, 0, 0, 0
1348, 1, 1636420638266, 1636420638530, 264, 0, 264, 0, 0, 0
1349, 1, 1636420638698, 1636420638966, 268, 0, 268, 0, 0, 0
1350, 1, 1636420638754, 1636420639030, 276, 0, 276, 0, 0, 0
1352, 1, 1636420638918, 1636420639190, 272, 1, 271, 0, 1, 1
1351, 1, 1636420638822, 1636420639234, 412, 145, 267, 145, 0, 145
1353, 1, 1636420639198, 1636420639470, 272, 0, 272, 0, 0, 0
1354, 1, 1636420639242, 1636420639506, 264, 0, 264, 0, 0, 0
1355, 1, 1636420639278, 1636420639542, 264, 0, 264, 0, 0, 0
1356, 1, 1636420639714, 1636420639982, 268, 0, 268, 0, 0, 0
1357, 1, 1636420639750, 1636420640018, 268, 1, 267, 1, 0, 1
1359, 1, 1636420639890, 1636420640162, 272, 1, 271, 0, 1, 1
1358, 1, 1636420639842, 1636420640246, 404, 141, 263, 141, 0, 141
1360, 1, 1636420640222, 1636420640494, 272, 1, 271, 0, 0, 0
1362, 1, 1636420640266, 1636420640542, 276, 0, 276, 0, 0, 0
1363, 1, 1636420640686, 1636420640962, 276, 1, 275, 0, 1, 1
1364, 1, 1636420640774, 1636420641050, 276, 1, 275, 0, 1, 1
1366, 1, 1636420640894, 1636420641166, 272, 1, 271, 0, 1, 1
1365, 1, 1636420640830, 1636420641226, 396, 133, 263, 133, 0, 133
1367, 1, 1636420641218, 1636420641486, 268, 0, 268, 0, 0, 0
1368, 1, 1636420641270, 1636420641534, 264, 0, 264, 0, 0, 0
1369, 1, 1636420641690, 1636420641962, 272, 1, 271, 1, 0, 1
1370, 1, 1636420641777, 1636420642046, 269, 1, 268, 1, 0, 1
1371, 1, 1636420641866, 1636420642138, 272, 0, 272, 0, 0, 0
1373, 1, 1636420641906, 1636420642174, 268, 1, 267, 0, 1, 1
1374, 1, 1636420642198, 1636420642466, 268, 0, 268, 0, 0, 0
1375, 1, 1636420642286, 1636420642550, 264, 1, 263, 0, 0, 0
1376, 1, 1636420642690, 1636420642958, 268, 1, 267, 0, 0, 0
1377, 1, 1636420642762, 1636420643034, 272, 1, 271, 1, 0, 1
1378, 1, 1636420642770, 1636420643042, 272, 0, 272, 0, 0, 0
1379, 1, 1636420642906, 1636420643174, 268, 0, 268, 0, 0, 0
1381, 1, 1636420643282, 1636420643550, 268, 1, 267, 0, 1, 1
1383, 1, 1636420643778, 1636420644054, 276, 1, 275, 0, 0, 0
1384, 1, 1636420643798, 1636420644070, 272, 0, 272, 0, 0, 0
1385, 1, 1636420643878, 1636420644142, 264, 1, 263, 0, 1, 1
1386, 1, 1636420644290, 1636420644558, 268, 1, 267, 0, 0, 0
1387, 1, 1636420644762, 1636420645034, 272, 0, 272, 0, 0, 0
1388, 1, 1636420644810, 1636420645074, 264, 0, 264, 0, 0, 0
1389, 1, 1636420644890, 1636420645162, 272, 1, 271, 1, 0, 1
1390, 1, 1636420645262, 1636420645526, 264, 1, 263, 1, 0, 1
1391, 1, 1636420645734, 1636420646010, 276, 0, 276, 0, 0, 0
1392, 1, 1636420645794, 1636420646066, 272, 0, 272, 0, 0, 0
1393, 1, 1636420645874, 1636420646142, 268, 0, 268, 0, 0, 0
1394, 1, 1636420646254, 1636420646526, 272, 1, 271, 0, 1, 1
1395, 1, 1636420646702, 1636420646974, 272, 1, 271, 0, 1, 1
1396, 1, 1636420646814, 1636420647082, 268, 0, 268, 0, 0, 0
1397, 1, 1636420646902, 1636420647174, 272, 1, 271, 0, 1, 1
1331, 2, 1636420637510, 1636420647511, 10001, 0, 10001, 0, 0, 0
1339, 2, 1636420637534, 1636420647554, 10020, 0, 10020, 1, 0, 1
1340, 2, 1636420637534, 1636420647598, 10064, 0, 10064, 0, 0, 0
1335, 2, 1636420637534, 1636420647642, 10108, 0, 10108, 0, 0, 0
1336, 2, 1636420637534, 1636420647691, 10157, 0, 10157, 0, 0, 0
1338, 2, 1636420637521, 1636420647739, 10218, 0, 10218, 0, 0, 0
1337, 2, 1636420637514, 1636420647787, 10273, 0, 10273, 1, 0, 1
1334, 2, 1636420637514, 1636420647834, 10320, 0, 10320, 0, 0, 0
1332, 2, 1636420637514, 1636420647879, 10365, 0, 10365, 0, 0, 0
1333, 2, 1636420637514, 1636420647927, 10413, 0, 10413, 1, 0, 1
1341, 2, 1636420637514, 1636420647975, 10461, 0, 10461, 0, 0, 0
1330, 2, 1636420637510, 1636420648022, 10512, 0, 10512, 0, 0, 0
1398, 1, 1636420647246, 1636420648070, 824, 1, 823, 0, 0, 0
1380, 1, 1636420643198, 1636420648286, 5088, 4825, 263, 0, 4825, 4825
1399, 1, 1636420648118, 1636420648382, 264, 0, 264, 0, 0, 0
1400, 1, 1636420648114, 1636420648382, 268, 0, 268, 0, 0, 0
1405, 1, 1636420648298, 1636420648570, 272, 2, 270, 1, 1, 2
1414, 1, 1636420648470, 1636420648734, 264, 0, 264, 0, 0, 0
1415, 1, 1636420648682, 1636420648954, 272, 0, 272, 0, 0, 0
1416, 1, 1636420648802, 1636420649070, 268, 1, 267, 0, 1, 1
1417, 1, 1636420648886, 1636420649158, 272, 1, 271, 0, 1, 1
1418, 1, 1636420649186, 1636420649458, 272, 0, 272, 0, 0, 0
1419, 1, 1636420649406, 1636420649675, 269, 0, 269, 0, 0, 0
1420, 1, 1636420649650, 1636420649918, 268, 1, 267, 0, 0, 0
1421, 1, 1636420649766, 1636420650034, 268, 1, 267, 0, 0, 0
1422, 1, 1636420649914, 1636420650186, 272, 0, 272, 0, 0, 0
1361, 2, 1636420640234, 1636420650234, 10000, 0, 10000, 0, 0, 0
1423, 1, 1636420650198, 1636420650462, 264, 1, 263, 0, 1, 1
1424, 1, 1636420650414, 1636420650678, 264, 1, 263, 0, 1, 1
1425, 1, 1636420650538, 1636420650802, 264, 0, 264, 0, 0, 0
1426, 1, 1636420650662, 1636420650934, 272, 1, 271, 0, 1, 1
1427, 1, 1636420650786, 1636420651062, 276, 0, 276, 0, 0, 0
1428, 1, 1636420650902, 1636420651166, 264, 0, 264, 0, 0, 0
1429, 1, 1636420651174, 1636420651446, 272, 1, 271, 0, 0, 0
1430, 1, 1636420651406, 1636420651670, 264, 0, 264, 0, 0, 0
1431, 1, 1636420651454, 1636420651722, 268, 1, 267, 0, 0, 0
1432, 1, 1636420651662, 1636420651934, 272, 1, 271, 0, 1, 1
1433, 1, 1636420651778, 1636420652042, 264, 1, 263, 0, 1, 1
1372, 2, 1636420641846, 1636420652051, 10205, 117, 10088, 117, 0, 117
1434, 1, 1636420651886, 1636420652234, 348, 0, 348, 0, 0, 0
1382, 1, 1636420643666, 1636420652322, 8656, 8385, 271, 8385, 0, 8385
1435, 1, 1636420652186, 1636420652590, 404, 137, 267, 137, 0, 137
1436, 1, 1636420652358, 1636420652626, 268, 0, 268, 0, 0, 0
1438, 1, 1636420652490, 1636420652754, 264, 0, 264, 0, 0, 0
1439, 1, 1636420652674, 1636420652938, 264, 0, 264, 0, 0, 0
1440, 1, 1636420652718, 1636420652986, 268, 0, 268, 0, 0, 0
1442, 1, 1636420652870, 1636420653142, 272, 1, 271, 0, 1, 1
1443, 1, 1636420653210, 1636420653482, 272, 1, 271, 0, 0, 0
1444, 1, 1636420653274, 1636420653538, 264, 0, 264, 0, 0, 0
1445, 1, 1636420653462, 1636420653730, 268, 1, 267, 1, 0, 1
1446, 1, 1636420653638, 1636420653902, 264, 0, 264, 0, 0, 0
1447, 1, 1636420653646, 1636420653914, 268, 0, 268, 0, 0, 0
1448, 1, 1636420653866, 1636420654138, 272, 0, 272, 0, 0, 0
1449, 1, 1636420654190, 1636420654454, 264, 0, 264, 0, 0, 0
1450, 1, 1636420654270, 1636420654534, 264, 0, 264, 0, 0, 0
1451, 1, 1636420654438, 1636420654702, 264, 1, 263, 0, 1, 1
1452, 1, 1636420654630, 1636420654894, 264, 0, 264, 0, 0, 0
1453, 1, 1636420654654, 1636420654926, 272, 1, 271, 0, 1, 1
1454, 1, 1636420654846, 1636420655114, 268, 1, 267, 0, 0, 0
1455, 1, 1636420655190, 1636420655458, 268, 1, 267, 0, 1, 1
1456, 1, 1636420655238, 1636420655502, 264, 0, 264, 0, 0, 0
1457, 1, 1636420655398, 1636420655662, 264, 1, 263, 1, 0, 1
1458, 1, 1636420655602, 1636420655870, 268, 1, 267, 0, 0, 0
1459, 1, 1636420655666, 1636420655938, 272, 0, 272, 0, 0, 0
1460, 1, 1636420655874, 1636420656138, 264, 0, 264, 0, 0, 0
1461, 1, 1636420656226, 1636420656494, 268, 0, 268, 0, 0, 0
1462, 1, 1636420656258, 1636420656526, 268, 1, 267, 0, 1, 1
1464, 1, 1636420656602, 1636420656879, 277, 0, 277, 0, 0, 0
1465, 1, 1636420656670, 1636420656934, 264, 1, 263, 0, 1, 1
1466, 1, 1636420656846, 1636420657114, 268, 1, 267, 0, 1, 1
1467, 1, 1636420657198, 1636420657466, 268, 0, 268, 0, 0, 0
1468, 1, 1636420657270, 1636420657542, 272, 1, 271, 0, 1, 1
1469, 1, 1636420657582, 1636420657854, 272, 0, 272, 0, 0, 0
1470, 1, 1636420657650, 1636420657914, 264, 0, 264, 0, 0, 0
1401, 2, 1636420648122, 1636420658122, 10000, 0, 10000, 0, 0, 0
1404, 2, 1636420648290, 1636420658290, 10000, 0, 10000, 1, 0, 1
1407, 2, 1636420648306, 1636420658334, 10028, 0, 10028, 0, 0, 0
1411, 2, 1636420648302, 1636420658378, 10076, 0, 10076, 0, 0, 0
1408, 2, 1636420648298, 1636420658422, 10124, 0, 10124, 1, 0, 1
1413, 2, 1636420648298, 1636420658466, 10168, 0, 10168, 2, 0, 2
1409, 2, 1636420648298, 1636420658514, 10216, 0, 10216, 1, 0, 1
1410, 2, 1636420648298, 1636420658562, 10264, 0, 10264, 1, 0, 1
1412, 2, 1636420648298, 1636420658606, 10308, 0, 10308, 1, 0, 1
1406, 2, 1636420648298, 1636420658655, 10357, 0, 10357, 2, 0, 2
1402, 2, 1636420648290, 1636420658702, 10412, 0, 10412, 0, 0, 0
1403, 2, 1636420648290, 1636420658751, 10461, 0, 10461, 0, 0, 0
1471, 1, 1636420658218, 1636420658982, 764, 1, 763, 1, 0, 1
1472, 1, 1636420658270, 1636420658982, 712, 1, 711, 0, 0, 0
1473, 1, 1636420658802, 1636420659074, 272, 0, 272, 0, 0, 0
1475, 1, 1636420658842, 1636420659106, 264, 0, 264, 0, 0, 0
1477, 1, 1636420659018, 1636420659286, 268, 0, 268, 0, 0, 0
1474, 1, 1636420658846, 1636420659346, 500, 229, 271, 228, 0, 228
1487, 1, 1636420659378, 1636420659646, 268, 1, 267, 0, 1, 1
1488, 1, 1636420659378, 1636420659646, 268, 1, 267, 1, 0, 1
1490, 1, 1636420659562, 1636420659830, 268, 0, 268, 0, 0, 0
1489, 1, 1636420659474, 1636420659914, 440, 173, 267, 173, 0, 173
1491, 1, 1636420659746, 1636420660014, 268, 0, 268, 0, 0, 0
1492, 1, 1636420659926, 1636420660190, 264, 0, 264, 0, 0, 0
1494, 1, 1636420660318, 1636420660586, 268, 0, 268, 0, 0, 0
1495, 1, 1636420660442, 1636420660714, 272, 1, 271, 1, 0, 1
1496, 1, 1636420660526, 1636420660794, 268, 0, 268, 0, 0, 0
1497, 1, 1636420660702, 1636420660970, 268, 0, 268, 0, 0, 0
1498, 1, 1636420660930, 1636420661202, 272, 0, 272, 0, 0, 0
1499, 1, 1636420661334, 1636420661602, 268, 1, 267, 0, 1, 1
1500, 1, 1636420661410, 1636420661678, 268, 1, 267, 1, 0, 1
1501, 1, 1636420661490, 1636420661758, 268, 1, 267, 1, 0, 1
1502, 1, 1636420661682, 1636420661946, 264, 0, 264, 0, 0, 0
1503, 1, 1636420661934, 1636420662202, 268, 0, 268, 0, 0, 0
1437, 2, 1636420652390, 1636420662390, 10000, 0, 10000, 0, 0, 0
1504, 1, 1636420662314, 1636420662614, 300, 0, 300, 0, 0, 0
1505, 1, 1636420662374, 1636420662650, 276, 0, 276, 0, 0, 0
1441, 2, 1636420652766, 1636420662766, 10000, 0, 10000, 0, 0, 0
1506, 1, 1636420662522, 1636420662814, 292, 0, 292, 0, 0, 0
1508, 1, 1636420662662, 1636420662938, 276, 0, 276, 0, 0, 0
1509, 1, 1636420662942, 1636420663214, 272, 0, 272, 0, 0, 0
1511, 1, 1636420663326, 1636420663590, 264, 1, 263, 1, 0, 1
1512, 1, 1636420663382, 1636420663650, 268, 0, 268, 0, 0, 0
1513, 1, 1636420663506, 1636420663774, 268, 1, 267, 1, 0, 1
1514, 1, 1636420663662, 1636420663930, 268, 1, 267, 0, 1, 1
1515, 1, 1636420663946, 1636420664219, 273, 0, 273, 0, 0, 0
1516, 1, 1636420664310, 1636420664574, 264, 1, 263, 1, 0, 1
1517, 1, 1636420664378, 1636420664654, 276, 1, 275, 0, 1, 1
1518, 1, 1636420664474, 1636420664742, 268, 1, 267, 0, 0, 0
1519, 1, 1636420664674, 1636420664946, 272, 0, 272, 0, 0, 0
1520, 1, 1636420664942, 1636420665210, 268, 0, 268, 0, 0, 0
1521, 1, 1636420665342, 1636420665606, 264, 0, 264, 0, 0, 0
1522, 1, 1636420665362, 1636420665626, 264, 1, 263, 0, 1, 1
1523, 1, 1636420665454, 1636420665722, 268, 1, 267, 0, 0, 0
1524, 1, 1636420665702, 1636420665974, 272, 0, 272, 0, 0, 0
1525, 1, 1636420665922, 1636420666190, 268, 0, 268, 0, 0, 0
1463, 2, 1636420656390, 1636420666390, 10000, 0, 10000, 0, 0, 0
1526, 1, 1636420666330, 1636420666618, 288, 1, 287, 0, 1, 1
1527, 1, 1636420666366, 1636420666638, 272, 0, 272, 0, 0, 0
1530, 1, 1636420666674, 1636420666942, 268, 1, 267, 0, 1, 1
1529, 1, 1636420666698, 1636420666966, 268, 0, 268, 0, 0, 0
1531, 1, 1636420666958, 1636420667226, 268, 0, 268, 0, 0, 0
1533, 1, 1636420667358, 1636420667622, 264, 0, 264, 0, 0, 0
1532, 1, 1636420667354, 1636420667622, 268, 0, 268, 0, 0, 0
1534, 1, 1636420667610, 1636420667878, 268, 0, 268, 0, 0, 0
1535, 1, 1636420667658, 1636420667926, 268, 0, 268, 0, 0, 0
1536, 1, 1636420667926, 1636420668194, 268, 1, 267, 1, 0, 1
1537, 1, 1636420668342, 1636420668610, 268, 1, 267, 0, 1, 1
1538, 1, 1636420668366, 1636420668638, 272, 0, 272, 0, 0, 0
1539, 1, 1636420668618, 1636420668890, 272, 0, 272, 0, 0, 0
1540, 1, 1636420668650, 1636420668918, 268, 0, 268, 0, 0, 0
1476, 2, 1636420659026, 1636420669027, 10001, 0, 10001, 261, 0, 261
1486, 2, 1636420659030, 1636420669074, 10044, 0, 10044, 258, 0, 258
1479, 2, 1636420659026, 1636420669118, 10092, 0, 10092, 262, 0, 262
1480, 2, 1636420659026, 1636420669162, 10136, 0, 10136, 261, 0, 261
1485, 2, 1636420659026, 1636420669206, 10180, 0, 10180, 261, 0, 261
1478, 2, 1636420659026, 1636420669251, 10225, 0, 10225, 262, 0, 262
1482, 2, 1636420659026, 1636420669298, 10272, 0, 10272, 262, 0, 262
1483, 2, 1636420659026, 1636420669342, 10316, 0, 10316, 261, 0, 261
1481, 2, 1636420659026, 1636420669386, 10360, 0, 10360, 261, 0, 261
1484, 2, 1636420659026, 1636420669431, 10405, 0, 10405, 262, 0, 262
1541, 1, 1636420668910, 1636420669574, 664, 0, 664, 0, 0, 0
1493, 1, 1636420660314, 1636420669694, 9380, 9117, 263, 0, 9117, 9117
1542, 1, 1636420669522, 1636420669790, 268, 1, 267, 0, 0, 0
1543, 1, 1636420669522, 1636420669794, 272, 1, 271, 0, 1, 1
1544, 1, 1636420669626, 1636420669890, 264, 0, 264, 0, 0, 0
1545, 1, 1636420669646, 1636420669922, 276, 0, 276, 0, 0, 0
1547, 1, 1636420669694, 1636420669958, 264, 0, 264, 0, 0, 0
1556, 1, 1636420669990, 1636420670258, 268, 0, 268, 0, 0, 0
1557, 1, 1636420670090, 1636420670354, 264, 0, 264, 0, 0, 0
1558, 1, 1636420670294, 1636420670562, 268, 0, 268, 0, 0, 0
1559, 1, 1636420670354, 1636420670622, 268, 1, 267, 0, 0, 0
1560, 1, 1636420670610, 1636420670874, 264, 0, 264, 0, 0, 0
1562, 1, 1636420670634, 1636420670906, 272, 1, 271, 0, 1, 1
1561, 1, 1636420670634, 1636420670906, 272, 1, 271, 0, 1, 1
1563, 1, 1636420670950, 1636420671215, 265, 0, 265, 0, 0, 0
1564, 1, 1636420671050, 1636420671314, 264, 0, 264, 0, 0, 0
1565, 1, 1636420671278, 1636420671546, 268, 0, 268, 0, 0, 0
1566, 1, 1636420671366, 1636420671638, 272, 0, 272, 0, 0, 0
1567, 1, 1636420671578, 1636420671847, 269, 0, 269, 0, 0, 0
1568, 1, 1636420671634, 1636420671898, 264, 0, 264, 0, 0, 0
1569, 1, 1636420671938, 1636420672202, 264, 0, 264, 0, 0, 0
1570, 1, 1636420672034, 1636420672298, 264, 1, 263, 0, 0, 0
1571, 1, 1636420672310, 1636420672578, 268, 0, 268, 0, 0, 0
1572, 1, 1636420672350, 1636420672618, 268, 1, 267, 0, 0, 0
1507, 2, 1636420662698, 1636420672698, 10000, 0, 10000, 0, 0, 0
1573, 1, 1636420672570, 1636420672846, 276, 0, 276, 0, 0, 0
1574, 1, 1636420672626, 1636420672922, 296, 0, 296, 0, 0, 0
1510, 2, 1636420663074, 1636420673074, 10000, 0, 10000, 0, 0, 0
1575, 1, 1636420672914, 1636420673210, 296, 1, 295, 0, 1, 1
1576, 1, 1636420673006, 1636420673302, 296, 1, 295, 0, 0, 0
1577, 1, 1636420673050, 1636420673318, 268, 0, 268, 0, 0, 0
1578, 1, 1636420673286, 1636420673554, 268, 0, 268, 0, 0, 0
1580, 1, 1636420673354, 1636420673618, 264, 0, 264, 0, 0, 0
1579, 1, 1636420673382, 1636420673646, 264, 0, 264, 0, 0, 0
1581, 1, 1636420673554, 1636420673818, 264, 1, 263, 0, 0, 0
1582, 1, 1636420673650, 1636420673914, 264, 0, 264, 0, 0, 0
1584, 1, 1636420673914, 1636420674178, 264, 0, 264, 0, 0, 0
1583, 1, 1636420673914, 1636420674178, 264, 1, 263, 0, 1, 1
1585, 1, 1636420674078, 1636420674346, 268, 0, 268, 0, 0, 0
1586, 1, 1636420674274, 1636420674542, 268, 0, 268, 0, 0, 0
1587, 1, 1636420674318, 1636420674586, 268, 0, 268, 0, 0, 0
1588, 1, 1636420674586, 1636420674854, 268, 0, 268, 0, 0, 0
1589, 1, 1636420674662, 1636420674930, 268, 1, 267, 0, 1, 1
1590, 1, 1636420674882, 1636420675154, 272, 1, 271, 0, 0, 0
1591, 1, 1636420674950, 1636420675222, 272, 1, 271, 1, 0, 1
1592, 1, 1636420675050, 1636420675318, 268, 1, 267, 0, 1, 1
1593, 1, 1636420675310, 1636420675578, 268, 0, 268, 0, 0, 0
1594, 1, 1636420675350, 1636420675622, 272, 1, 271, 0, 1, 1
1595, 1, 1636420675554, 1636420675818, 264, 1, 263, 0, 1, 1
1596, 1, 1636420675662, 1636420675930, 268, 1, 267, 0, 1, 1
1598, 1, 1636420675922, 1636420676186, 264, 0, 264, 0, 0, 0
1599, 1, 1636420676030, 1636420676294, 264, 0, 264, 0, 0, 0
1528, 2, 1636420666478, 1636420676478, 10000, 0, 10000, 0, 0, 0
1600, 1, 1636420676282, 1636420676550, 268, 0, 268, 0, 0, 0
1601, 1, 1636420676374, 1636420676642, 268, 1, 267, 1, 0, 1
1602, 1, 1636420676570, 1636420676842, 272, 0, 272, 0, 0, 0
1603, 1, 1636420676646, 1636420676910, 264, 0, 264, 0, 0, 0
1604, 1, 1636420676786, 1636420677054, 268, 1, 267, 1, 0, 1
1605, 1, 1636420676914, 1636420677186, 272, 0, 272, 0, 0, 0
1606, 1, 1636420677058, 1636420677322, 264, 0, 264, 0, 0, 0
1607, 1, 1636420677258, 1636420677530, 272, 0, 272, 0, 0, 0
1608, 1, 1636420677346, 1636420677614, 268, 0, 268, 0, 0, 0
1609, 1, 1636420677566, 1636420677830, 264, 1, 263, 0, 0, 0
1610, 1, 1636420677646, 1636420677914, 268, 1, 267, 0, 1, 1
1611, 1, 1636420677702, 1636420677970, 268, 0, 268, 0, 0, 0
1612, 1, 1636420677882, 1636420678150, 268, 0, 268, 0, 0, 0
1613, 1, 1636420678030, 1636420678302, 272, 0, 272, 0, 0, 0
1614, 1, 1636420678250, 1636420678522, 272, 1, 271, 1, 0, 1
1615, 1, 1636420678330, 1636420678786, 456, 193, 263, 193, 0, 193
1616, 1, 1636420678558, 1636420678826, 268, 0, 268, 0, 0, 0
1617, 1, 1636420678642, 1636420678910, 268, 1, 267, 0, 1, 1
1618, 1, 1636420678714, 1636420678990, 276, 0, 276, 0, 0, 0
1620, 1, 1636420679034, 1636420679302, 268, 0, 268, 0, 0, 0
1622, 1, 1636420679318, 1636420679586, 268, 1, 267, 0, 0, 0
1551, 2, 1636420669698, 1636420679699, 10001, 0, 10001, 262, 0, 262
1552, 2, 1636420669702, 1636420679742, 10040, 0, 10040, 258, 0, 258
1555, 2, 1636420669702, 1636420679791, 10089, 0, 10089, 258, 0, 258
1554, 2, 1636420669702, 1636420679834, 10132, 0, 10132, 258, 0, 258
1549, 2, 1636420669702, 1636420679878, 10176, 0, 10176, 258, 0, 258
1550, 2, 1636420669698, 1636420679926, 10228, 0, 10228, 261, 0, 261
1548, 2, 1636420669702, 1636420679973, 10271, 0, 10271, 258, 0, 258
1546, 2, 1636420669698, 1636420680018, 10320, 0, 10320, 262, 0, 262
1553, 2, 1636420669698, 1636420680067, 10369, 0, 10369, 261, 0, 261
1623, 1, 1636420679586, 1636420680206, 620, 1, 619, 0, 0, 0
1624, 1, 1636420679658, 1636420680298, 640, 0, 640, 0, 0, 0
1625, 1, 1636420679690, 1636420680302, 612, 0, 612, 0, 0, 0
1626, 1, 1636420680162, 1636420680430, 268, 1, 267, 0, 1, 1
1636, 1, 1636420680314, 1636420680586, 272, 0, 272, 0, 0, 0
1637, 1, 1636420680626, 1636420680894, 268, 1, 267, 1, 0, 1
1638, 1, 1636420680698, 1636420680966, 268, 0, 268, 0, 0, 0
1639, 1, 1636420680734, 1636420681006, 272, 0, 272, 0, 0, 0
1640, 1, 1636420681046, 1636420681318, 272, 0, 272, 0, 0, 0
1641, 1, 1636420681290, 1636420681562, 272, 0, 272, 0, 0, 0
1642, 1, 1636420681562, 1636420681826, 264, 0, 264, 0, 0, 0
1644, 1, 1636420681714, 1636420681986, 272, 0, 272, 0, 0, 0
1643, 1, 1636420681690, 1636420682098, 408, 137, 271, 136, 1, 137
1645, 1, 1636420682078, 1636420682342, 264, 0, 264, 0, 0, 0
1646, 1, 1636420682326, 1636420682598, 272, 1, 271, 0, 1, 1
1647, 1, 1636420682534, 1636420682798, 264, 1, 263, 0, 1, 1
1648, 1, 1636420682686, 1636420682954, 268, 1, 267, 0, 1, 1
1649, 1, 1636420682686, 1636420682954, 268, 1, 267, 1, 0, 1
1650, 1, 1636420683046, 1636420683310, 264, 0, 264, 0, 0, 0
1651, 1, 1636420683302, 1636420683574, 272, 0, 272, 0, 0, 0
1652, 1, 1636420683514, 1636420683786, 272, 0, 272, 0, 0, 0
1653, 1, 1636420683690, 1636420683962, 272, 1, 271, 0, 0, 0
1654, 1, 1636420683722, 1636420683990, 268, 0, 268, 0, 0, 0
1655, 1, 1636420684514, 1636420684782, 268, 1, 267, 1, 0, 1
1656, 1, 1636420684718, 1636420684990, 272, 0, 272, 0, 0, 0
1657, 1, 1636420684738, 1636420685010, 272, 0, 272, 0, 0, 0
1597, 2, 1636420675898, 1636420685894, 9996, 0, 9996, 0, 0, 0
1659, 1, 1636420685706, 1636420685982, 276, 1, 275, 0, 1, 1
1660, 1, 1636420685738, 1636420686029, 291, 1, 290, 0, 1, 1
1661, 1, 1636420686202, 1636420686474, 272, 0, 272, 0, 0, 0
1662, 1, 1636420686694, 1636420686966, 272, 0, 272, 0, 0, 0
1663, 1, 1636420686714, 1636420686990, 276, 1, 275, 0, 0, 0
1664, 1, 1636420687110, 1636420687378, 268, 0, 268, 0, 0, 0
1665, 1, 1636420687658, 1636420687926, 268, 1, 267, 0, 0, 0
1666, 1, 1636420687726, 1636420688002, 276, 0, 276, 0, 0, 0
1667, 1, 1636420688086, 1636420688354, 268, 0, 268, 0, 0, 0
1619, 2, 1636420678874, 1636420688875, 10001, 0, 10001, 0, 0, 0
1668, 1, 1636420688654, 1636420688926, 272, 1, 271, 1, 0, 1
1669, 1, 1636420688718, 1636420689010, 292, 1, 291, 0, 0, 0
1621, 2, 1636420679246, 1636420689246, 10000, 0, 10000, 0, 0, 0
1670, 1, 1636420689062, 1636420689326, 264, 0, 264, 0, 0, 0
1671, 1, 1636420689182, 1636420689474, 292, 1, 291, 1, 0, 1
1672, 1, 1636420689554, 1636420689818, 264, 0, 264, 0, 0, 0
1673, 1, 1636420689634, 1636420689898, 264, 0, 264, 0, 0, 0
1674, 1, 1636420689718, 1636420689990, 272, 0, 272, 0, 0, 0
1630, 2, 1636420680342, 1636420690338, 9996, 0, 9996, 0, 0, 0
1632, 2, 1636420680342, 1636420690382, 10040, 0, 10040, 0, 0, 0
1631, 2, 1636420680342, 1636420690426, 10084, 0, 10084, 1, 0, 1
1627, 2, 1636420680342, 1636420690470, 10128, 0, 10128, 2, 0, 2
1635, 2, 1636420680342, 1636420690518, 10176, 0, 10176, 0, 0, 0
1634, 2, 1636420680342, 1636420690562, 10220, 0, 10220, 2, 0, 2
1633, 2, 1636420680342, 1636420690606, 10264, 0, 10264, 0, 0, 0
1629, 2, 1636420680342, 1636420690654, 10312, 0, 10312, 2, 0, 2
1628, 2, 1636420680342, 1636420690702, 10360, 0, 10360, 0, 0, 0
1675, 1, 1636420690082, 1636420690750, 668, 0, 668, 0, 0, 0
1676, 1, 1636420690102, 1636420690750, 648, 0, 648, 0, 0, 0
1677, 1, 1636420690754, 1636420691018, 264, 0, 264, 0, 0, 0
1678, 1, 1636420690794, 1636420691062, 268, 0, 268, 0, 0, 0
1679, 1, 1636420690794, 1636420691062, 268, 0, 268, 0, 0, 0
1683, 1, 1636420690966, 1636420691230, 264, 0, 264, 0, 0, 0
1689, 1, 1636420691146, 1636420691414, 268, 1, 267, 0, 0, 0
1690, 1, 1636420691146, 1636420691414, 268, 1, 267, 1, 0, 1
1691, 1, 1636420691466, 1636420691738, 272, 0, 272, 0, 0, 0
1692, 1, 1636420691646, 1636420691922, 276, 1, 275, 0, 0, 0
1693, 1, 1636420691714, 1636420691986, 272, 0, 272, 0, 0, 0
1694, 1, 1636420691894, 1636420692166, 272, 1, 271, 0, 0, 0
1695, 1, 1636420692102, 1636420692370, 268, 0, 268, 0, 0, 0
1696, 1, 1636420692126, 1636420692394, 268, 0, 268, 0, 0, 0
1697, 1, 1636420692442, 1636420692714, 272, 0, 272, 0, 0, 0
1698, 1, 1636420692742, 1636420693010, 268, 0, 268, 0, 0, 0
1699, 1, 1636420692898, 1636420693170, 272, 1, 271, 0, 1, 1
1700, 1, 1636420693066, 1636420693330, 264, 0, 264, 0, 0, 0
1701, 1, 1636420693126, 1636420693438, 312, 45, 267, 45, 0, 45
1702, 1, 1636420693458, 1636420693726, 268, 0, 268, 0, 0, 0
1703, 1, 1636420693722, 1636420693990, 268, 0, 268, 0, 0, 0
1704, 1, 1636420693914, 1636420694182, 268, 1, 267, 0, 0, 0
1705, 1, 1636420694078, 1636420694346, 268, 0, 268, 0, 0, 0
1706, 1, 1636420694122, 1636420694390, 268, 0, 268, 0, 0, 0
1707, 1, 1636420694494, 1636420694766, 272, 0, 272, 0, 0, 0
1708, 1, 1636420694702, 1636420694974, 272, 1, 271, 0, 0, 0
1709, 1, 1636420694918, 1636420695190, 272, 1, 271, 0, 1, 1
1710, 1, 1636420695074, 1636420695342, 268, 0, 268, 0, 0, 0
1711, 1, 1636420695090, 1636420695358, 268, 0, 268, 0, 0, 0
1658, 2, 1636420685530, 1636420695531, 10001, 0, 10001, 0, 0, 0
1712, 1, 1636420695462, 1636420695758, 296, 1, 295, 0, 0, 0
1713, 1, 1636420695710, 1636420695982, 272, 0, 272, 0, 0, 0
1714, 1, 1636420695838, 1636420696106, 268, 1, 267, 0, 0, 0
1715, 1, 1636420695914, 1636420696182, 268, 1, 267, 0, 0, 0
1716, 1, 1636420696062, 1636420696330, 268, 0, 268, 0, 0, 0
1717, 1, 1636420696090, 1636420696362, 272, 0, 272, 0, 0, 0
1718, 1, 1636420696486, 1636420696758, 272, 1, 271, 0, 1, 1
1719, 1, 1636420696706, 1636420696974, 268, 1, 267, 0, 1, 1
1720, 1, 1636420696742, 1636420697014, 272, 1, 271, 0, 1, 1
1721, 1, 1636420696902, 1636420697170, 268, 0, 268, 0, 0, 0
1722, 1, 1636420697034, 1636420697302, 268, 0, 268, 0, 0, 0
1723, 1, 1636420697062, 1636420697326, 264, 0, 264, 0, 0, 0
1724, 1, 1636420697522, 1636420697794, 272, 1, 271, 0, 0, 0
1725, 1, 1636420697710, 1636420697978, 268, 0, 268, 0, 0, 0
1726, 1, 1636420697722, 1636420697990, 268, 0, 268, 0, 0, 0
1727, 1, 1636420697938, 1636420698210, 272, 0, 272, 0, 0, 0
1728, 1, 1636420698034, 1636420698302, 268, 0, 268, 0, 0, 0
1729, 1, 1636420698054, 1636420698334, 280, 0, 280, 0, 0, 0
1730, 1, 1636420698518, 1636420698786, 268, 1, 267, 0, 0, 0
1731, 1, 1636420698702, 1636420698970, 268, 1, 267, 0, 0, 0
1732, 1, 1636420698710, 1636420698978, 268, 1, 267, 0, 1, 1
1733, 1, 1636420698902, 1636420699242, 340, 69, 271, 69, 0, 69
1734, 1, 1636420699030, 1636420699294, 264, 1, 263, 0, 0, 0
1735, 1, 1636420699042, 1636420699306, 264, 0, 264, 0, 0, 0
1736, 1, 1636420699502, 1636420699770, 268, 0, 268, 0, 0, 0
1737, 1, 1636420699710, 1636420699982, 272, 0, 272, 0, 0, 0
1738, 1, 1636420699718, 1636420699986, 268, 0, 268, 0, 0, 0
1739, 1, 1636420699882, 1636420700154, 272, 1, 271, 0, 0, 0
1740, 1, 1636420700034, 1636420700298, 264, 0, 264, 0, 0, 0
1741, 1, 1636420700066, 1636420700330, 264, 0, 264, 0, 0, 0
1742, 1, 1636420700502, 1636420700775, 273, 0, 273, 0, 0, 0
1686, 2, 1636420690974, 1636420700971, 9997, 0, 9997, 257, 0, 257
1687, 2, 1636420690974, 1636420701019, 10045, 0, 10045, 255, 0, 255
1682, 2, 1636420690974, 1636420701066, 10092, 0, 10092, 257, 0, 257
1680, 2, 1636420690974, 1636420701115, 10141, 0, 10141, 257, 0, 257
1684, 2, 1636420690974, 1636420701162, 10188, 0, 10188, 257, 0, 257
1685, 2, 1636420690974, 1636420701211, 10237, 0, 10237, 255, 0, 255
1688, 2, 1636420690974, 1636420701258, 10284, 0, 10284, 257, 0, 257
1681, 2, 1636420690974, 1636420701302, 10328, 0, 10328, 257, 0, 257
1743, 1, 1636420700702, 1636420701350, 648, 0, 648, 0, 0, 0
1744, 1, 1636420700902, 1636420701530, 628, 1, 627, 0, 0, 0
1746, 1, 1636420701350, 1636420701622, 272, 1, 271, 0, 0, 0
1745, 1, 1636420701350, 1636420701622, 272, 1, 271, 1, 0, 1
1747, 1, 1636420701502, 1636420701770, 268, 1, 267, 0, 1, 1
1756, 1, 1636420701770, 1636420702038, 268, 1, 267, 0, 0, 0
1757, 1, 1636420701938, 1636420702214, 276, 1, 275, 0, 0, 0
1759, 1, 1636420702042, 1636420702310, 268, 0, 268, 0, 0, 0
1758, 1, 1636420702050, 1636420702318, 268, 0, 268, 0, 0, 0
1760, 1, 1636420702534, 1636420702806, 272, 0, 272, 0, 0, 0
1761, 1, 1636420702742, 1636420703018, 276, 0, 276, 0, 0, 0
1762, 1, 1636420702882, 1636420703154, 272, 0, 272, 0, 0, 0
1763, 1, 1636420703002, 1636420703274, 272, 1, 271, 0, 0, 0
1764, 1, 1636420703026, 1636420703546, 520, 249, 271, 249, 0, 249
1765, 1, 1636420703518, 1636420703790, 272, 0, 272, 0, 0, 0
1766, 1, 1636420703726, 1636420704002, 276, 1, 275, 0, 1, 1
1767, 1, 1636420703854, 1636420704126, 272, 1, 271, 0, 0, 0
1768, 1, 1636420704018, 1636420704286, 268, 0, 268, 0, 0, 0
1769, 1, 1636420704030, 1636420704294, 264, 1, 263, 0, 0, 0
1770, 1, 1636420704534, 1636420704806, 272, 1, 271, 0, 0, 0
1772, 1, 1636420704834, 1636420705106, 272, 1, 271, 0, 0, 0
1773, 1, 1636420704994, 1636420705270, 276, 1, 275, 0, 0, 0
1774, 1, 1636420705054, 1636420705326, 272, 1, 271, 0, 0, 0
1775, 1, 1636420705562, 1636420705835, 273, 0, 273, 0, 0, 0
1776, 1, 1636420705834, 1636420706106, 272, 1, 271, 0, 0, 0
1777, 1, 1636420706026, 1636420706294, 268, 0, 268, 0, 0, 0
1779, 1, 1636420706534, 1636420706806, 272, 0, 272, 0, 0, 0
1781, 1, 1636420707050, 1636420707326, 276, 1, 275, 1, 0, 1
1782, 1, 1636420707522, 1636420707794, 272, 1, 271, 0, 0, 0
1783, 1, 1636420708042, 1636420708314, 272, 1, 271, 1, 0, 1
1784, 1, 1636420708522, 1636420708794, 272, 1, 271, 0, 0, 0
1785, 1, 1636420709030, 1636420709302, 272, 1, 271, 1, 0, 1
1786, 1, 1636420709498, 1636420709766, 268, 1, 267, 0, 0, 0
1787, 1, 1636420709994, 1636420710266, 272, 1, 271, 0, 0, 0
1788, 1, 1636420710502, 1636420710770, 268, 1, 267, 0, 1, 1
1789, 1, 1636420710990, 1636420711267, 277, 0, 277, 0, 0, 0
1753, 2, 1636420701578, 1636420711574, 9996, 0, 9996, 1, 0, 1
1750, 2, 1636420701578, 1636420711618, 10040, 0, 10040, 1, 0, 1
1752, 2, 1636420701578, 1636420711662, 10084, 0, 10084, 2, 0, 2
1755, 2, 1636420701578, 1636420711706, 10128, 0, 10128, 1, 0, 1
1754, 2, 1636420701578, 1636420711754, 10176, 0, 10176, 0, 0, 0
1748, 2, 1636420701578, 1636420711803, 10225, 0, 10225, 1, 0, 1
1751, 2, 1636420701578, 1636420711850, 10272, 0, 10272, 0, 0, 0
1749, 2, 1636420701578, 1636420711894, 10316, 0, 10316, 2, 0, 2
1790, 1, 1636420711494, 1636420712126, 632, 1, 631, 0, 1, 1
1791, 1, 1636420711986, 1636420712254, 268, 0, 268, 0, 0, 0
1800, 1, 1636420712538, 1636420712815, 277, 0, 277, 0, 0, 0
1771, 2, 1636420704714, 1636420714714, 10000, 0, 10000, 0, 0, 0
1778, 1, 1636420706062, 1636420714986, 8924, 8653, 271, 0, 8653, 8653
1801, 1, 1636420715022, 1636420715294, 272, 1, 271, 1, 0, 1
1802, 1, 1636420715382, 1636420715650, 268, 0, 268, 0, 0, 0
1803, 1, 1636420715930, 1636420716194, 264, 0, 264, 0, 0, 0
1804, 1, 1636420716318, 1636420716590, 272, 1, 271, 0, 1, 1
1780, 2, 1636420706846, 1636420716846, 10000, 0, 10000, 0, 0, 0
1805, 1, 1636420716982, 1636420717250, 268, 0, 268, 0, 0, 0
1806, 1, 1636420717158, 1636420717426, 268, 1, 267, 0, 0, 0
1807, 1, 1636420717338, 1636420717602, 264, 1, 263, 1, 0, 1
1808, 1, 1636420717942, 1636420718214, 272, 1, 271, 0, 0, 0
1809, 1, 1636420718066, 1636420718338, 272, 1, 271, 1, 0, 1
1810, 1, 1636420718354, 1636420718622, 268, 0, 268, 0, 0, 0
1811, 1, 1636420718934, 1636420719202, 268, 1, 267, 1, 0, 1
1812, 1, 1636420719042, 1636420719314, 272, 1, 271, 0, 0, 0
1813, 1, 1636420719350, 1636420719622, 272, 1, 271, 0, 1, 1
1814, 1, 1636420719970, 1636420720234, 264, 1, 263, 0, 0, 0
1815, 1, 1636420720030, 1636420720306, 276, 0, 276, 0, 0, 0
1816, 1, 1636420720330, 1636420720594, 264, 0, 264, 0, 0, 0
1817, 1, 1636420720982, 1636420721250, 268, 1, 267, 0, 1, 1
1818, 1, 1636420721046, 1636420721318, 272, 1, 271, 0, 1, 1
1796, 2, 1636420712158, 1636420722158, 10000, 0, 10000, 0, 0, 0
1794, 2, 1636420712173, 1636420722202, 10029, 0, 10029, 1, 0, 1
1799, 2, 1636420712174, 1636420722246, 10072, 0, 10072, 0, 0, 0
1795, 2, 1636420712173, 1636420722290, 10117, 0, 10117, 1, 0, 1
1793, 2, 1636420712174, 1636420722338, 10164, 0, 10164, 0, 0, 0
1798, 2, 1636420712166, 1636420722387, 10221, 0, 10221, 0, 0, 0
1797, 2, 1636420712162, 1636420722435, 10273, 0, 10273, 0, 0, 0
1792, 2, 1636420712158, 1636420722483, 10325, 0, 10325, 0, 0, 0
1821, 1, 1636420722014, 1636420722622, 608, 1, 607, 0, 0, 0
1820, 1, 1636420721998, 1636420722622, 624, 1, 623, 0, 0, 0
1819, 1, 1636420721334, 1636420722754, 1420, 1149, 271, 0, 1149, 1149
1824, 1, 1636420722746, 1636420723022, 276, 0, 276, 0, 0, 0
1830, 1, 1636420723038, 1636420723302, 264, 0, 264, 0, 0, 0
1831, 1, 1636420723058, 1636420723334, 276, 0, 276, 0, 0, 0
1832, 1, 1636420723150, 1636420723418, 268, 1, 267, 1, 0, 1
1833, 1, 1636420723666, 1636420723938, 272, 0, 272, 0, 0, 0
1834, 1, 1636420723978, 1636420724246, 268, 1, 267, 1, 0, 1
1835, 1, 1636420724038, 1636420724306, 268, 1, 267, 0, 0, 0
1836, 1, 1636420724118, 1636420724390, 272, 0, 272, 0, 0, 0
1837, 1, 1636420724682, 1636420724954, 272, 1, 271, 0, 0, 0
1838, 1, 1636420724990, 1636420725258, 268, 1, 267, 1, 0, 1
1839, 1, 1636420725038, 1636420725306, 268, 1, 267, 0, 0, 0
1840, 1, 1636420725130, 1636420725398, 268, 0, 268, 0, 0, 0
1841, 1, 1636420725686, 1636420725954, 268, 0, 268, 0, 0, 0
1842, 1, 1636420726018, 1636420726286, 268, 1, 267, 1, 0, 1
1843, 1, 1636420726018, 1636420726286, 268, 1, 267, 1, 0, 1
1844, 1, 1636420726126, 1636420726390, 264, 1, 263, 0, 1, 1
1845, 1, 1636420726682, 1636420726950, 268, 0, 268, 0, 0, 0
1846, 1, 1636420727010, 1636420727282, 272, 0, 272, 0, 0, 0
1847, 1, 1636420727022, 1636420727294, 272, 0, 272, 0, 0, 0
1848, 1, 1636420727158, 1636420727426, 268, 1, 267, 0, 1, 1
1849, 1, 1636420727670, 1636420727942, 272, 1, 271, 0, 0, 0
1851, 1, 1636420728042, 1636420728318, 276, 1, 275, 0, 1, 1
1850, 1, 1636420728042, 1636420728318, 276, 0, 276, 0, 0, 0
1852, 1, 1636420728130, 1636420728394, 264, 0, 264, 0, 0, 0
1855, 1, 1636420729054, 1636420729326, 272, 1, 271, 0, 0, 0
1854, 1, 1636420729054, 1636420729326, 272, 1, 271, 0, 1, 1
1856, 1, 1636420729122, 1636420729386, 264, 1, 263, 0, 0, 0
1857, 1, 1636420730054, 1636420730326, 272, 0, 272, 0, 0, 0
1858, 1, 1636420730070, 1636420730334, 264, 0, 264, 0, 0, 0
1859, 1, 1636420730094, 1636420730362, 268, 0, 268, 0, 0, 0
1860, 1, 1636420731030, 1636420731302, 272, 1, 271, 0, 0, 0
1861, 1, 1636420731066, 1636420731330, 264, 0, 264, 0, 0, 0
1862, 1, 1636420731086, 1636420731358, 272, 0, 272, 0, 0, 0
1863, 1, 1636420732030, 1636420732298, 268, 1, 267, 0, 1, 1
1864, 1, 1636420732038, 1636420732306, 268, 0, 268, 0, 0, 0
1865, 1, 1636420732094, 1636420732366, 272, 0, 272, 0, 0, 0
1828, 2, 1636420722750, 1636420732751, 10001, 0, 10001, 273, 0, 273
1823, 2, 1636420722754, 1636420732795, 10041, 0, 10041, 269, 0, 269
1829, 2, 1636420722758, 1636420732843, 10085, 0, 10085, 266, 0, 266
1825, 2, 1636420722754, 1636420732891, 10137, 0, 10137, 269, 0, 269
1822, 2, 1636420722758, 1636420732938, 10180, 0, 10180, 265, 0, 265
1826, 2, 1636420722754, 1636420732987, 10233, 0, 10233, 269, 0, 269
1827, 2, 1636420722750, 1636420733034, 10284, 0, 10284, 273, 0, 273
1853, 1, 1636420728706, 1636420733306, 4600, 4328, 272, 0, 4328, 4328
1866, 1, 1636420733126, 1636420733390, 264, 1, 263, 1, 0, 1
1868, 1, 1636420733126, 1636420733398, 272, 1, 271, 0, 1, 1
1867, 1, 1636420733126, 1636420733662, 536, 272, 264, 272, 0, 272
1876, 1, 1636420733718, 1636420733990, 272, 1, 271, 0, 0, 0
1877, 1, 1636420733998, 1636420734270, 272, 0, 272, 0, 0, 0
1878, 1, 1636420734090, 1636420734362, 272, 0, 272, 0, 0, 0
1879, 1, 1636420734130, 1636420734402, 272, 1, 271, 0, 0, 0
1880, 1, 1636420734650, 1636420734918, 268, 1, 267, 1, 0, 1
1881, 1, 1636420734962, 1636420735226, 264, 0, 264, 0, 0, 0
1882, 1, 1636420735034, 1636420735302, 268, 0, 268, 0, 0, 0
1883, 1, 1636420735158, 1636420735426, 268, 0, 268, 0, 0, 0
1884, 1, 1636420735682, 1636420735955, 273, 1, 272, 0, 0, 0
1885, 1, 1636420735962, 1636420736230, 268, 1, 267, 0, 0, 0
1886, 1, 1636420736058, 1636420736322, 264, 0, 264, 0, 0, 0
1887, 1, 1636420736138, 1636420736406, 268, 0, 268, 0, 0, 0
1888, 1, 1636420736718, 1636420736994, 276, 1, 275, 0, 0, 0
1889, 1, 1636420736994, 1636420737262, 268, 1, 267, 0, 0, 0
1890, 1, 1636420737066, 1636420737338, 272, 0, 272, 0, 0, 0
1891, 1, 1636420737118, 1636420737386, 268, 1, 267, 0, 0, 0
1892, 1, 1636420737682, 1636420737954, 272, 1, 271, 1, 0, 1
1893, 1, 1636420737966, 1636420738234, 268, 0, 268, 0, 0, 0
1894, 1, 1636420738086, 1636420738350, 264, 0, 264, 0, 0, 0
1895, 1, 1636420738098, 1636420738370, 272, 0, 272, 0, 0, 0
1896, 1, 1636420738654, 1636420738926, 272, 0, 272, 0, 0, 0
1897, 1, 1636420738938, 1636420739210, 272, 1, 271, 0, 0, 0
1898, 1, 1636420739078, 1636420739346, 268, 0, 268, 0, 0, 0
1899, 1, 1636420739106, 1636420739378, 272, 0, 272, 0, 0, 0
1900, 1, 1636420739618, 1636420739894, 276, 1, 275, 0, 1, 1
1901, 1, 1636420739906, 1636420740178, 272, 0, 272, 0, 0, 0
1902, 1, 1636420740078, 1636420740346, 268, 0, 268, 0, 0, 0
1903, 1, 1636420740110, 1636420740374, 264, 1, 263, 0, 0, 0
1904, 1, 1636420740618, 1636420740895, 277, 1, 276, 0, 1, 1
1906, 1, 1636420741102, 1636420741374, 272, 1, 271, 0, 1, 1
1907, 1, 1636420741122, 1636420741386, 264, 0, 264, 0, 0, 0
1910, 1, 1636420742122, 1636420742387, 265, 0, 265, 0, 0, 0
1909, 1, 1636420742114, 1636420742387, 273, 0, 273, 0, 0, 0
1869, 2, 1636420733326, 1636420743326, 10000, 0, 10000, 0, 0, 0
1874, 2, 1636420733338, 1636420743374, 10036, 0, 10036, 0, 0, 0
1875, 2, 1636420733338, 1636420743418, 10080, 0, 10080, 0, 0, 0
1872, 2, 1636420733334, 1636420743462, 10128, 0, 10128, 0, 0, 0
1873, 2, 1636420733334, 1636420743506, 10172, 0, 10172, 0, 0, 0
1871, 2, 1636420733330, 1636420743555, 10225, 0, 10225, 0, 0, 0
1870, 2, 1636420733326, 1636420743602, 10276, 0, 10276, 0, 0, 0
1912, 1, 1636420743130, 1636420743650, 520, 0, 520, 0, 0, 0
1911, 1, 1636420743106, 1636420743650, 544, 1, 543, 1, 0, 1
1913, 1, 1636420743870, 1636420744138, 268, 0, 268, 0, 0, 0
1920, 1, 1636420744114, 1636420744382, 268, 0, 268, 0, 0, 0
1922, 1, 1636420744810, 1636420745082, 272, 1, 271, 0, 0, 0
1923, 1, 1636420745130, 1636420745402, 272, 0, 272, 0, 0, 0
1924, 1, 1636420745842, 1636420746110, 268, 1, 267, 0, 0, 0
1925, 1, 1636420746126, 1636420746398, 272, 1, 271, 0, 1, 1
1926, 1, 1636420746870, 1636420747134, 264, 1, 263, 0, 0, 0
1927, 1, 1636420747134, 1636420747406, 272, 0, 272, 0, 0, 0
1928, 1, 1636420747846, 1636420748122, 276, 1, 275, 0, 0, 0
1929, 1, 1636420748106, 1636420748378, 272, 1, 271, 0, 0, 0
1930, 1, 1636420748846, 1636420749118, 272, 1, 271, 1, 0, 1
1931, 1, 1636420749094, 1636420749374, 280, 1, 279, 0, 1, 1
1932, 1, 1636420749870, 1636420750142, 272, 1, 271, 0, 0, 0
1905, 2, 1636420740894, 1636420750894, 10000, 0, 10000, 0, 0, 0
1934, 1, 1636420750874, 1636420751146, 272, 1, 271, 1, 0, 1
1935, 1, 1636420751198, 1636420751470, 272, 0, 272, 0, 0, 0
1908, 2, 1636420741634, 1636420751634, 10000, 0, 10000, 0, 0, 0
1936, 1, 1636420751886, 1636420752150, 264, 0, 264, 0, 0, 0
1937, 1, 1636420751942, 1636420752210, 268, 0, 268, 0, 0, 0
1938, 1, 1636420752114, 1636420752386, 272, 0, 272, 0, 0, 0
1939, 1, 1636420752854, 1636420753126, 272, 0, 272, 0, 0, 0
1940, 1, 1636420752870, 1636420753138, 268, 1, 267, 0, 1, 1
1941, 1, 1636420753126, 1636420753390, 264, 1, 263, 0, 0, 0
1915, 2, 1636420743874, 1636420753874, 10000, 0, 10000, 266, 0, 266
1918, 2, 1636420743878, 1636420753918, 10040, 0, 10040, 261, 0, 261
1919, 2, 1636420743878, 1636420753966, 10088, 0, 10088, 260, 0, 260
1914, 2, 1636420743878, 1636420754011, 10133, 0, 10133, 260, 0, 260
1916, 2, 1636420743878, 1636420754054, 10176, 0, 10176, 261, 0, 261
1917, 2, 1636420743878, 1636420754098, 10220, 0, 10220, 262, 0, 262
1921, 2, 1636420744130, 1636420754142, 10012, 0, 10012, 0, 0, 0
1943, 1, 1636420753842, 1636420754370, 528, 1, 527, 0, 1, 1
1933, 1, 1636420750082, 1636420754370, 4288, 4017, 271, 0, 4016, 4016
1942, 1, 1636420753830, 1636420754378, 548, 0, 548, 0, 0, 0
1944, 1, 1636420754234, 1636420754498, 264, 0, 264, 0, 0, 0
1945, 1, 1636420754434, 1636420754698, 264, 0, 264, 0, 0, 0
1952, 1, 1636420754782, 1636420755054, 272, 1, 271, 0, 0, 0
1953, 1, 1636420754834, 1636420755106, 272, 0, 272, 0, 0, 0
1954, 1, 1636420754846, 1636420755110, 264, 1, 263, 0, 0, 0
1955, 1, 1636420755118, 1636420755382, 264, 0, 264, 0, 0, 0
1956, 1, 1636420755326, 1636420755598, 272, 1, 271, 0, 1, 1
1957, 1, 1636420755730, 1636420756002, 272, 0, 272, 0, 0, 0
1958, 1, 1636420755806, 1636420756078, 272, 0, 272, 0, 0, 0
1959, 1, 1636420755838, 1636420756106, 268, 1, 267, 0, 0, 0
1960, 1, 1636420756150, 1636420756414, 264, 1, 263, 0, 1, 1
1961, 1, 1636420756366, 1636420756638, 272, 0, 272, 0, 0, 0
1962, 1, 1636420756738, 1636420757006, 268, 1, 267, 1, 0, 1
1963, 1, 1636420756818, 1636420757090, 272, 0, 272, 0, 0, 0
1964, 1, 1636420756826, 1636420757094, 268, 1, 267, 0, 1, 1
1965, 1, 1636420757146, 1636420757410, 264, 1, 263, 0, 0, 0
1966, 1, 1636420757334, 1636420757606, 272, 1, 271, 0, 0, 0
1967, 1, 1636420757730, 1636420758006, 276, 1, 275, 1, 0, 1
1968, 1, 1636420757802, 1636420758074, 272, 0, 272, 0, 0, 0
1969, 1, 1636420757826, 1636420758098, 272, 1, 271, 0, 0, 0
1970, 1, 1636420758150, 1636420758418, 268, 0, 268, 0, 0, 0
1971, 1, 1636420758306, 1636420758682, 376, 112, 264, 112, 0, 112
1974, 1, 1636420758814, 1636420759082, 268, 0, 268, 0, 0, 0
1973, 1, 1636420758806, 1636420759086, 280, 1, 279, 0, 0, 0
1975, 1, 1636420759182, 1636420759458, 276, 1, 275, 0, 1, 1
1976, 1, 1636420759294, 1636420759566, 272, 1, 271, 0, 0, 0
1977, 1, 1636420759790, 1636420760062, 272, 1, 271, 0, 0, 0
1978, 1, 1636420759790, 1636420760062, 272, 0, 272, 0, 0, 0
1979, 1, 1636420760182, 1636420760450, 268, 1, 267, 1, 0, 1
1981, 1, 1636420760770, 1636420761042, 272, 1, 271, 0, 0, 0
1982, 1, 1636420760782, 1636420761054, 272, 1, 271, 0, 0, 0
1983, 1, 1636420761170, 1636420761442, 272, 1, 271, 0, 1, 1
1984, 1, 1636420761774, 1636420762046, 272, 1, 271, 0, 1, 1
1985, 1, 1636420761790, 1636420762066, 276, 1, 275, 1, 0, 1
1986, 1, 1636420762190, 1636420762462, 272, 0, 272, 0, 0, 0
1987, 1, 1636420762762, 1636420763030, 268, 1, 267, 1, 0, 1
1988, 1, 1636420762794, 1636420763066, 272, 1, 271, 0, 1, 1
1989, 1, 1636420763186, 1636420763463, 277, 1, 276, 1, 0, 1
1990, 1, 1636420763746, 1636420764022, 276, 1, 275, 0, 0, 0
1991, 1, 1636420763806, 1636420764078, 272, 1, 271, 0, 0, 0
1950, 2, 1636420754446, 1636420764446, 10000, 0, 10000, 1, 0, 1
1948, 2, 1636420754454, 1636420764490, 10036, 0, 10036, 1, 0, 1
1949, 2, 1636420754454, 1636420764534, 10080, 0, 10080, 1, 0, 1
1951, 2, 1636420754454, 1636420764582, 10128, 0, 10128, 1, 0, 1
1947, 2, 1636420754454, 1636420764631, 10177, 0, 10177, 0, 0, 0
1946, 2, 1636420754446, 1636420764678, 10232, 0, 10232, 1, 0, 1
1992, 1, 1636420764202, 1636420764726, 524, 1, 523, 0, 0, 0
1993, 1, 1636420764774, 1636420765042, 268, 0, 268, 0, 0, 0
1994, 1, 1636420764826, 1636420765094, 268, 0, 268, 0, 0, 0
2001, 1, 1636420765202, 1636420765483, 281, 1, 280, 0, 1, 1
2002, 1, 1636420765742, 1636420766014, 272, 1, 271, 1, 0, 1
2003, 1, 1636420765854, 1636420766126, 272, 1, 271, 1, 0, 1
2004, 1, 1636420766218, 1636420766486, 268, 0, 268, 0, 0, 0
2005, 1, 1636420766722, 1636420766998, 276, 0, 276, 0, 0, 0
2006, 1, 1636420766858, 1636420767130, 272, 1, 271, 0, 1, 1
2007, 1, 1636420767246, 1636420767519, 273, 1, 272, 0, 1, 1
2008, 1, 1636420767722, 1636420767994, 272, 0, 272, 0, 0, 0
2009, 1, 1636420767866, 1636420768138, 272, 1, 271, 1, 0, 1
2010, 1, 1636420768218, 1636420768490, 272, 1, 271, 0, 1, 1
1972, 2, 1636420758702, 1636420768702, 10000, 0, 10000, 0, 0, 0
2011, 1, 1636420768746, 1636420769010, 264, 0, 264, 0, 0, 0
2012, 1, 1636420768890, 1636420769158, 268, 1, 267, 0, 0, 0
2014, 1, 1636420769202, 1636420769471, 269, 0, 269, 0, 0, 0
2015, 1, 1636420769758, 1636420770030, 272, 1, 271, 1, 0, 1
2016, 1, 1636420769922, 1636420770194, 272, 1, 271, 1, 0, 1
1980, 2, 1636420760286, 1636420770286, 10000, 0, 10000, 0, 0, 0
2017, 1, 1636420770234, 1636420770514, 280, 0, 280, 0, 0, 0
2018, 1, 1636420770590, 1636420770858, 268, 1, 267, 0, 0, 0
2020, 1, 1636420770902, 1636420771171, 269, 0, 269, 0, 0, 0
2021, 1, 1636420771506, 1636420771774, 268, 1, 267, 1, 0, 1
2022, 1, 1636420771882, 1636420772154, 272, 1, 271, 0, 1, 1
2023, 1, 1636420772514, 1636420772786, 272, 0, 272, 0, 0, 0
2024, 1, 1636420772858, 1636420773126, 268, 0, 268, 0, 0, 0
2025, 1, 1636420773490, 1636420773762, 272, 0, 272, 0, 0, 0
2026, 1, 1636420773890, 1636420774162, 272, 1, 271, 1, 0, 1
2027, 1, 1636420774506, 1636420774778, 272, 0, 272, 0, 0, 0
1997, 2, 1636420764954, 1636420774950, 9996, 0, 9996, 140, 0, 140
1995, 2, 1636420764954, 1636420774998, 10044, 0, 10044, 141, 0, 141
1998, 2, 1636420764954, 1636420775043, 10089, 0, 10089, 140, 0, 140
2000, 2, 1636420764954, 1636420775090, 10136, 0, 10136, 141, 0, 141
1999, 2, 1636420764954, 1636420775134, 10180, 0, 10180, 141, 0, 141
1996, 2, 1636420764954, 1636420775179, 10225, 0, 10225, 141, 0, 141
2028, 1, 1636420774870, 1636420775406, 536, 1, 535, 1, 0, 1
2019, 1, 1636420770770, 1636420775450, 4680, 4409, 271, 0, 4409, 4409
2033, 1, 1636420775446, 1636420775714, 268, 0, 268, 0, 0, 0
2035, 1, 1636420775522, 1636420775790, 268, 0, 268, 0, 0, 0
2036, 1, 1636420775846, 1636420776110, 264, 0, 264, 0, 0, 0
2037, 1, 1636420775874, 1636420776142, 268, 0, 268, 0, 0, 0
2038, 1, 1636420776374, 1636420776646, 272, 1, 271, 0, 0, 0
2039, 1, 1636420776494, 1636420776762, 268, 0, 268, 0, 0, 0
2040, 1, 1636420776778, 1636420777046, 268, 0, 268, 0, 0, 0
2041, 1, 1636420776886, 1636420777162, 276, 1, 275, 1, 0, 1
2042, 1, 1636420777402, 1636420777670, 268, 1, 267, 0, 0, 0
2043, 1, 1636420777530, 1636420777798, 268, 1, 267, 0, 0, 0
2044, 1, 1636420777746, 1636420778018, 272, 1, 271, 0, 1, 1
2045, 1, 1636420777866, 1636420778130, 264, 1, 263, 0, 1, 1
2046, 1, 1636420778374, 1636420778642, 268, 1, 267, 0, 1, 1
2047, 1, 1636420778566, 1636420778830, 264, 0, 264, 0, 0, 0
2048, 1, 1636420778726, 1636420778994, 268, 1, 267, 0, 0, 0
2013, 2, 1636420769006, 1636420779006, 10000, 0, 10000, 0, 0, 0
2049, 1, 1636420778886, 1636420779154, 268, 0, 268, 0, 0, 0
2050, 1, 1636420779314, 1636420779586, 272, 1, 271, 0, 0, 0
2051, 1, 1636420779370, 1636420779638, 268, 1, 267, 0, 0, 0
2052, 1, 1636420779538, 1636420779810, 272, 1, 271, 0, 1, 1
2053, 1, 1636420779734, 1636420780007, 273, 0, 273, 0, 0, 0
2054, 1, 1636420779898, 1636420780162, 264, 0, 264, 0, 0, 0
2055, 1, 1636420780222, 1636420780490, 268, 1, 267, 0, 0, 0
2056, 1, 1636420780394, 1636420780666, 272, 0, 272, 0, 0, 0
2057, 1, 1636420780518, 1636420780786, 268, 0, 268, 0, 0, 0
2058, 1, 1636420780746, 1636420781014, 268, 0, 268, 0, 0, 0
2059, 1, 1636420780878, 1636420781150, 272, 0, 272, 0, 0, 0
2060, 1, 1636420781262, 1636420781530, 268, 1, 267, 0, 1, 1
2061, 1, 1636420781402, 1636420781666, 264, 0, 264, 0, 0, 0
2062, 1, 1636420781518, 1636420781782, 264, 1, 263, 0, 0, 0
2063, 1, 1636420781754, 1636420782022, 268, 0, 268, 0, 0, 0
2064, 1, 1636420781890, 1636420782166, 276, 0, 276, 0, 0, 0
2065, 1, 1636420782234, 1636420782506, 272, 1, 271, 0, 0, 0
2066, 1, 1636420782410, 1636420782678, 268, 0, 268, 0, 0, 0
2067, 1, 1636420782498, 1636420782766, 268, 0, 268, 0, 0, 0
2068, 1, 1636420782754, 1636420783022, 268, 0, 268, 0, 0, 0
2069, 1, 1636420782886, 1636420783158, 272, 0, 272, 0, 0, 0
2070, 1, 1636420783202, 1636420783466, 264, 0, 264, 0, 0, 0
2071, 1, 1636420783394, 1636420783662, 268, 0, 268, 0, 0, 0
2072, 1, 1636420783522, 1636420783790, 268, 0, 268, 0, 0, 0
2073, 1, 1636420783782, 1636420784046, 264, 0, 264, 0, 0, 0
2074, 1, 1636420783874, 1636420784142, 268, 1, 267, 0, 0, 0
2075, 1, 1636420784186, 1636420784454, 268, 0, 268, 0, 0, 0
2076, 1, 1636420784370, 1636420784634, 264, 1, 263, 0, 1, 1
2077, 1, 1636420784506, 1636420784774, 268, 0, 268, 0, 0, 0
2078, 1, 1636420784790, 1636420785066, 276, 0, 276, 0, 0, 0
2079, 1, 1636420784870, 1636420785138, 268, 0, 268, 0, 0, 0
2029, 2, 1636420775454, 1636420785452, 9998, 0, 9998, 261, 0, 261
2031, 2, 1636420775458, 1636420785498, 10040, 0, 10040, 257, 0, 257
2034, 2, 1636420775450, 1636420785546, 10096, 0, 10096, 265, 0, 265
2032, 2, 1636420775454, 1636420785594, 10140, 0, 10140, 261, 0, 261
2030, 2, 1636420775454, 1636420785643, 10189, 10141, 48, 261, 9880, 10141
2081, 1, 1636420785350, 1636420785782, 432, 1, 431, 1, 0, 1
2082, 1, 1636420785690, 1636420785954, 264, 0, 264, 0, 0, 0
2083, 1, 1636420785818, 1636420786082, 264, 1, 263, 0, 0, 0
2085, 1, 1636420785870, 1636420786134, 264, 0, 264, 0, 0, 0
2084, 1, 1636420785910, 1636420786182, 272, 0, 272, 0, 0, 0
2090, 1, 1636420786342, 1636420786614, 272, 0, 272, 0, 0, 0
2091, 1, 1636420786534, 1636420786798, 264, 0, 264, 0, 0, 0
2092, 1, 1636420786818, 1636420787082, 264, 0, 264, 0, 0, 0
2093, 1, 1636420786842, 1636420787110, 268, 0, 268, 0, 0, 0
2094, 1, 1636420786846, 1636420787114, 268, 0, 268, 0, 0, 0
2095, 1, 1636420787362, 1636420787634, 272, 1, 271, 0, 1, 1
2096, 1, 1636420787514, 1636420787783, 269, 0, 269, 0, 0, 0
2097, 1, 1636420787826, 1636420788094, 268, 0, 268, 0, 0, 0
2099, 1, 1636420787842, 1636420788114, 272, 0, 272, 0, 0, 0
2098, 1, 1636420787838, 1636420788114, 276, 1, 275, 0, 0, 0
2100, 1, 1636420788358, 1636420788626, 268, 1, 267, 1, 0, 1
2101, 1, 1636420788498, 1636420788774, 276, 1, 275, 0, 1, 1
2102, 1, 1636420788798, 1636420789066, 268, 1, 267, 0, 0, 0
2103, 1, 1636420788830, 1636420789098, 268, 1, 267, 0, 0, 0
2104, 1, 1636420788846, 1636420789110, 264, 0, 264, 0, 0, 0
2105, 1, 1636420789346, 1636420789618, 272, 1, 271, 0, 0, 0
2106, 1, 1636420789502, 1636420789770, 268, 1, 267, 0, 0, 0
2107, 1, 1636420789762, 1636420790034, 272, 0, 272, 0, 0, 0
2108, 1, 1636420789838, 1636420790110, 272, 0, 272, 0, 0, 0
2109, 1, 1636420789866, 1636420790134, 268, 1, 267, 0, 1, 1
2110, 1, 1636420790326, 1636420790594, 268, 1, 267, 0, 0, 0
2111, 1, 1636420790730, 1636420791006, 276, 0, 276, 0, 0, 0
2112, 1, 1636420790830, 1636420791098, 268, 0, 268, 0, 0, 0
2113, 1, 1636420790850, 1636420791114, 264, 1, 263, 0, 1, 1
2114, 1, 1636420791314, 1636420791586, 272, 1, 271, 0, 0, 0
2115, 1, 1636420791730, 1636420792002, 272, 0, 272, 0, 0, 0
2116, 1, 1636420791818, 1636420792090, 272, 0, 272, 0, 0, 0
2117, 1, 1636420791882, 1636420792146, 264, 0, 264, 0, 0, 0
2118, 1, 1636420792322, 1636420792594, 272, 1, 271, 0, 0, 0
2119, 1, 1636420792702, 1636420792974, 272, 0, 272, 0, 0, 0
2120, 1, 1636420792834, 1636420793106, 272, 0, 272, 0, 0, 0
2121, 1, 1636420792870, 1636420793142, 272, 0, 272, 0, 0, 0
2122, 1, 1636420793302, 1636420793574, 272, 1, 271, 0, 0, 0
2123, 1, 1636420793674, 1636420793950, 276, 0, 276, 0, 0, 0
2124, 1, 1636420793866, 1636420794134, 268, 1, 267, 0, 1, 1
2125, 1, 1636420793886, 1636420794150, 264, 0, 264, 0, 0, 0
2126, 1, 1636420794282, 1636420794554, 272, 0, 272, 0, 0, 0
2127, 1, 1636420794642, 1636420794910, 268, 0, 268, 0, 0, 0
2128, 1, 1636420794862, 1636420795134, 272, 1, 271, 0, 1, 1
2129, 1, 1636420794866, 1636420795134, 268, 0, 268, 0, 0, 0
2080, 2, 1636420785174, 1636420795174, 10000, 0, 10000, 0, 0, 0
2130, 1, 1636420795314, 1636420795578, 264, 0, 264, 0, 0, 0
2131, 1, 1636420795478, 1636420795750, 272, 0, 272, 0, 0, 0
2086, 2, 1636420785950, 1636420795950, 10000, 0, 10000, 233, 0, 233
2087, 2, 1636420786022, 1636420796023, 10001, 0, 10001, 161, 0, 161
2088, 2, 1636420786030, 1636420796066, 10036, 0, 10036, 153, 0, 153
2089, 2, 1636420786022, 1636420796110, 10088, 0, 10088, 161, 0, 161
2133, 1, 1636420795850, 1636420796246, 396, 0, 396, 0, 0, 0
2134, 1, 1636420795870, 1636420796246, 376, 1, 375, 0, 0, 0
2135, 1, 1636420796278, 1636420796546, 268, 0, 268, 0, 0, 0
2137, 1, 1636420796394, 1636420796666, 272, 0, 272, 0, 0, 0
2136, 1, 1636420796418, 1636420796690, 272, 0, 272, 0, 0, 0
2140, 1, 1636420796490, 1636420796954, 464, 200, 264, 200, 0, 200
2141, 1, 1636420796858, 1636420797122, 264, 1, 263, 0, 0, 0
2142, 1, 1636420796870, 1636420797134, 264, 1, 263, 0, 1, 1
2139, 1, 1636420796490, 1636420797218, 728, 465, 263, 465, 0, 465
2138, 1, 1636420796490, 1636420797482, 992, 729, 263, 729, 0, 729
2143, 1, 1636420797258, 1636420797526, 268, 0, 268, 0, 0, 0
2144, 1, 1636420797330, 1636420797602, 272, 1, 271, 0, 0, 0
2145, 1, 1636420797406, 1636420797670, 264, 0, 264, 0, 0, 0
2146, 1, 1636420797410, 1636420797866, 456, 193, 263, 193, 0, 193
2147, 1, 1636420797630, 1636420797902, 272, 0, 272, 0, 0, 0
2149, 1, 1636420797878, 1636420798146, 268, 0, 268, 0, 0, 0
2148, 1, 1636420797894, 1636420798166, 272, 9, 263, 9, 0, 9
2150, 1, 1636420797902, 1636420798170, 268, 1, 267, 0, 1, 1
2151, 1, 1636420798266, 1636420798534, 268, 0, 268, 0, 0, 0
2152, 1, 1636420798298, 1636420798562, 264, 0, 264, 0, 0, 0
2153, 1, 1636420798382, 1636420798650, 268, 0, 268, 0, 0, 0
2154, 1, 1636420798410, 1636420798826, 416, 153, 263, 153, 0, 153
2155, 1, 1636420798614, 1636420798878, 264, 0, 264, 0, 0, 0
2157, 1, 1636420798870, 1636420799134, 264, 0, 264, 0, 0, 0
2156, 1, 1636420798866, 1636420799142, 276, 13, 263, 13, 0, 13
2158, 1, 1636420798878, 1636420799150, 272, 1, 271, 1, 0, 1
2159, 1, 1636420799290, 1636420799558, 268, 1, 267, 0, 1, 1
2160, 1, 1636420799314, 1636420799582, 268, 1, 267, 1, 0, 1
2161, 1, 1636420799398, 1636420799662, 264, 1, 263, 0, 1, 1
2162, 1, 1636420799426, 1636420799846, 420, 157, 263, 157, 0, 157
2163, 1, 1636420799590, 1636420799866, 276, 0, 276, 0, 0, 0
2164, 1, 1636420799838, 1636420800138, 300, 29, 271, 29, 0, 29
2166, 1, 1636420799882, 1636420800150, 268, 0, 268, 0, 0, 0
2167, 1, 1636420800298, 1636420800570, 272, 0, 272, 0, 0, 0
2168, 1, 1636420800302, 1636420800570, 268, 0, 268, 0, 0, 0
2170, 1, 1636420800430, 1636420800702, 272, 1, 271, 1, 0, 1
2169, 1, 1636420800406, 1636420800838, 432, 165, 267, 165, 0, 165
2171, 1, 1636420800590, 1636420800866, 276, 0, 276, 0, 0, 0
2172, 1, 1636420800806, 1636420801134, 328, 61, 267, 61, 0, 61
2174, 1, 1636420801286, 1636420801558, 272, 0, 272, 0, 0, 0
2175, 1, 1636420801318, 1636420801586, 268, 0, 268, 0, 0, 0
2177, 1, 1636420801406, 1636420801678, 272, 0, 272, 0, 0, 0
2176, 1, 1636420801386, 1636420801822, 436, 173, 263, 173, 0, 173
2178, 1, 1636420801618, 1636420801886, 268, 1, 267, 0, 1, 1
2179, 1, 1636420801818, 1636420802158, 340, 70, 270, 69, 1, 70
2180, 1, 1636420802318, 1636420802590, 272, 1, 271, 0, 1, 1
2181, 1, 1636420802350, 1636420802622, 272, 1, 271, 0, 1, 1
2183, 1, 1636420802410, 1636420802686, 276, 0, 276, 0, 0, 0
2182, 1, 1636420802386, 1636420802854, 468, 205, 263, 204, 1, 205
2184, 1, 1636420802622, 1636420802894, 272, 0, 272, 0, 0, 0
2185, 1, 1636420802846, 1636420803162, 316, 49, 267, 49, 0, 49
2187, 1, 1636420803354, 1636420803618, 264, 0, 264, 0, 0, 0
2186, 1, 1636420803350, 1636420803618, 268, 0, 268, 0, 0, 0
2189, 1, 1636420803430, 1636420803702, 272, 0, 272, 0, 0, 0
2188, 1, 1636420803394, 1636420803890, 496, 225, 271, 225, 0, 225
2190, 1, 1636420803634, 1636420803898, 264, 0, 264, 0, 0, 0
2191, 1, 1636420803874, 1636420804162, 288, 25, 263, 25, 0, 25
2192, 1, 1636420804338, 1636420804614, 276, 1, 275, 0, 0, 0
2193, 1, 1636420804374, 1636420804642, 268, 0, 268, 0, 0, 0
2195, 1, 1636420804430, 1636420804702, 272, 0, 272, 0, 0, 0
2194, 1, 1636420804390, 1636420804882, 492, 225, 267, 225, 0, 225
2198, 1, 1636420805306, 1636420805578, 272, 1, 271, 0, 0, 0
2132, 2, 1636420795630, 1636420805630, 10000, 0, 10000, 0, 0, 0
2200, 1, 1636420805398, 1636420805674, 276, 0, 276, 0, 0, 0
2201, 1, 1636420805414, 1636420805682, 268, 1, 267, 0, 0, 0
2199, 1, 1636420805382, 1636420805854, 472, 197, 275, 197, 0, 197
2202, 1, 1636420805942, 1636420806214, 272, 1, 271, 0, 1, 1
2203, 1, 1636420806274, 1636420806538, 264, 0, 264, 0, 0, 0
2205, 1, 1636420806430, 1636420806702, 272, 0, 272, 0, 0, 0
2206, 1, 1636420806438, 1636420806710, 272, 0, 272, 0, 0, 0
2204, 1, 1636420806378, 1636420806810, 432, 161, 271, 161, 0, 161
2207, 1, 1636420806854, 1636420807126, 272, 0, 272, 0, 0, 0
2208, 1, 1636420807242, 1636420807510, 268, 1, 267, 0, 1, 1
2210, 1, 1636420807406, 1636420807678, 272, 0, 272, 0, 0, 0
2211, 1, 1636420807414, 1636420807678, 264, 0, 264, 0, 0, 0
2209, 1, 1636420807378, 1636420807774, 396, 133, 263, 133, 0, 133
2212, 1, 1636420807862, 1636420808134, 272, 1, 271, 0, 1, 1
2214, 1, 1636420808386, 1636420808658, 272, 0, 272, 0, 0, 0
2216, 1, 1636420808426, 1636420808694, 268, 0, 268, 0, 0, 0
2217, 1, 1636420808838, 1636420809110, 272, 1, 271, 0, 0, 0
2218, 1, 1636420809366, 1636420809634, 268, 0, 268, 0, 0, 0
2219, 1, 1636420809410, 1636420809678, 268, 0, 268, 0, 0, 0
2165, 2, 1636420799854, 1636420809854, 10000, 0, 10000, 0, 0, 0
2220, 1, 1636420809898, 1636420810170, 272, 0, 272, 0, 0, 0
2222, 1, 1636420810374, 1636420810646, 272, 1, 271, 0, 0, 0
2223, 1, 1636420810446, 1636420810714, 268, 1, 267, 1, 0, 1
2173, 2, 1636420800914, 1636420810914, 10000, 0, 10000, 0, 0, 0
2224, 1, 1636420810878, 1636420811150, 272, 1, 271, 0, 0, 0
2225, 1, 1636420811226, 1636420811498, 272, 1, 271, 0, 1, 1
2226, 1, 1636420811354, 1636420811626, 272, 0, 272, 0, 0, 0
2227, 1, 1636420811474, 1636420811747, 273, 1, 272, 0, 1, 1
2228, 1, 1636420811850, 1636420812126, 276, 0, 276, 0, 0, 0
2229, 1, 1636420812158, 1636420812422, 264, 1, 263, 0, 0, 0
2230, 1, 1636420812358, 1636420812626, 268, 0, 268, 0, 0, 0
2231, 1, 1636420812446, 1636420812718, 272, 0, 272, 0, 0, 0
2232, 1, 1636420812858, 1636420813130, 272, 1, 271, 0, 0, 0
2233, 1, 1636420813190, 1636420813462, 272, 0, 272, 0, 0, 0
2234, 1, 1636420813374, 1636420813646, 272, 0, 272, 0, 0, 0
2235, 1, 1636420813894, 1636420814170, 276, 1, 275, 0, 0, 0
2236, 1, 1636420814174, 1636420814438, 264, 0, 264, 0, 0, 0
2196, 2, 1636420804622, 1636420814623, 10001, 0, 10001, 261, 0, 261
2237, 1, 1636420814362, 1636420814670, 308, 0, 308, 0, 0, 0
2197, 2, 1636420804846, 1636420814846, 10000, 0, 10000, 37, 0, 37
2238, 1, 1636420814894, 1636420815162, 268, 0, 268, 0, 0, 0
2239, 1, 1636420815154, 1636420815426, 272, 0, 272, 0, 0, 0
2241, 1, 1636420815170, 1636420815438, 268, 0, 268, 0, 0, 0
2242, 1, 1636420815386, 1636420815650, 264, 0, 264, 0, 0, 0
2240, 1, 1636420815190, 1636420815698, 508, 237, 271, 237, 0, 237
2243, 1, 1636420815878, 1636420816150, 272, 1, 271, 0, 0, 0
2244, 1, 1636420816070, 1636420816346, 276, 0, 276, 0, 0, 0
2246, 1, 1636420816134, 1636420816406, 272, 1, 271, 0, 0, 0
2245, 1, 1636420816102, 1636420816610, 508, 245, 263, 245, 0, 245
2247, 1, 1636420816398, 1636420816662, 264, 1, 263, 0, 0, 0
2248, 1, 1636420816902, 1636420817170, 268, 1, 267, 1, 0, 1
2249, 1, 1636420817054, 1636420817322, 268, 0, 268, 0, 0, 0
2251, 1, 1636420817138, 1636420817410, 272, 0, 272, 0, 0, 0
2250, 1, 1636420817094, 1636420817590, 496, 229, 267, 229, 0, 229
2252, 1, 1636420817378, 1636420817642, 264, 0, 264, 0, 0, 0
2253, 1, 1636420817894, 1636420818166, 272, 1, 271, 0, 1, 1
2213, 2, 1636420808266, 1636420818266, 10000, 0, 10000, 0, 0, 0
2254, 1, 1636420818078, 1636420818350, 272, 1, 271, 0, 0, 0
2215, 2, 1636420808398, 1636420818398, 10000, 0, 10000, 0, 0, 0
2256, 1, 1636420818130, 1636420818446, 316, 0, 316, 0, 0, 0
2255, 1, 1636420818102, 1636420818626, 524, 249, 275, 249, 0, 249
2257, 1, 1636420818446, 1636420818710, 264, 0, 264, 0, 0, 0
2258, 1, 1636420818578, 1636420818858, 280, 0, 280, 0, 0, 0
2259, 1, 1636420818706, 1636420819130, 424, 153, 271, 153, 0, 153
2260, 1, 1636420818914, 1636420819182, 268, 0, 268, 0, 0, 0
2261, 1, 1636420819102, 1636420819370, 268, 1, 267, 0, 0, 0
2263, 1, 1636420819146, 1636420819418, 272, 0, 272, 0, 0, 0
2262, 1, 1636420819110, 1636420819646, 536, 261, 275, 261, 0, 261
2264, 1, 1636420819398, 1636420819662, 264, 0, 264, 0, 0, 0
2265, 1, 1636420819482, 1636420819746, 264, 0, 264, 0, 0, 0
2266, 1, 1636420819614, 1636420820010, 396, 133, 263, 133, 0, 133
2221, 2, 1636420810162, 1636420820162, 10000, 0, 10000, 0, 0, 0
2267, 1, 1636420819902, 1636420820210, 308, 1, 307, 0, 1, 1
2268, 1, 1636420820082, 1636420820390, 308, 1, 307, 0, 1, 1
2270, 1, 1636420820134, 1636420820406, 272, 0, 272, 0, 0, 0
2271, 1, 1636420820394, 1636420820662, 268, 0, 268, 0, 0, 0
2273, 1, 1636420820462, 1636420820730, 268, 0, 268, 0, 0, 0
2272, 1, 1636420820474, 1636420820742, 268, 1, 267, 0, 0, 0
2274, 1, 1636420820606, 1636420820994, 388, 124, 264, 124, 0, 124
2275, 1, 1636420820910, 1636420821178, 268, 1, 267, 0, 0, 0
2276, 1, 1636420821102, 1636420821374, 272, 1, 271, 0, 0, 0
2277, 1, 1636420821130, 1636420821402, 272, 1, 271, 0, 0, 0
2278, 1, 1636420821378, 1636420821646, 268, 0, 268, 0, 0, 0
2279, 1, 1636420821390, 1636420821654, 264, 1, 263, 0, 0, 0
2280, 1, 1636420821442, 1636420821714, 272, 0, 272, 0, 0, 0
2281, 1, 1636420821598, 1636420821978, 380, 117, 263, 117, 0, 117
2282, 1, 1636420821942, 1636420822214, 272, 1, 271, 0, 1, 1
2283, 1, 1636420822130, 1636420822398, 268, 0, 268, 0, 0, 0
2285, 1, 1636420822386, 1636420822658, 272, 1, 271, 0, 0, 0
2286, 1, 1636420822422, 1636420822690, 268, 0, 268, 0, 0, 0
2287, 1, 1636420822454, 1636420822726, 272, 0, 272, 0, 0, 0
2288, 1, 1636420822598, 1636420822990, 392, 128, 264, 128, 0, 128
2289, 1, 1636420822914, 1636420823186, 272, 0, 272, 0, 0, 0
2290, 1, 1636420823138, 1636420823454, 316, 49, 267, 49, 0, 49
2291, 1, 1636420823362, 1636420823630, 268, 0, 268, 0, 0, 0
2292, 1, 1636420823390, 1636420823662, 272, 1, 271, 0, 0, 0
2293, 1, 1636420823430, 1636420823702, 272, 0, 272, 0, 0, 0
2294, 1, 1636420823594, 1636420823970, 376, 109, 267, 109, 0, 109
2295, 1, 1636420824142, 1636420824418, 276, 0, 276, 0, 0, 0
2297, 1, 1636420824362, 1636420824630, 268, 1, 267, 0, 0, 0
2296, 1, 1636420824358, 1636420824630, 272, 1, 271, 1, 0, 1
2298, 1, 1636420824414, 1636420824678, 264, 0, 264, 0, 0, 0
2299, 1, 1636420824574, 1636420824946, 372, 105, 267, 104, 0, 104
2301, 1, 1636420825326, 1636420825594, 268, 0, 268, 0, 0, 0
2302, 1, 1636420825338, 1636420825602, 264, 1, 263, 0, 1, 1
2303, 1, 1636420825422, 1636420825686, 264, 1, 263, 0, 1, 1
2305, 1, 1636420826302, 1636420826578, 276, 0, 276, 0, 0, 0
2307, 1, 1636420826418, 1636420826690, 272, 1, 271, 1, 0, 1
2308, 1, 1636420827294, 1636420827562, 268, 1, 267, 0, 0, 0
2310, 1, 1636420828334, 1636420828602, 268, 0, 268, 0, 0, 0
2311, 1, 1636420829306, 1636420829574, 268, 0, 268, 0, 0, 0
2269, 2, 1636420820102, 1636420830487, 10385, 289, 10096, 289, 0, 289
2312, 1, 1636420830274, 1636420830582, 308, 1, 307, 1, 0, 1
2300, 1, 1636420825122, 1636420830762, 5640, 5365, 275, 5365, 0, 5365
2313, 1, 1636420830798, 1636420831074, 276, 0, 276, 0, 0, 0
2314, 1, 1636420831158, 1636420831426, 268, 0, 268, 0, 0, 0
2315, 1, 1636420831242, 1636420831514, 272, 1, 271, 1, 0, 1
2316, 1, 1636420831690, 1636420831962, 272, 0, 272, 0, 0, 0
2284, 2, 1636420822138, 1636420832138, 10000, 0, 10000, 0, 0, 0
2317, 1, 1636420832122, 1636420832394, 272, 0, 272, 0, 0, 0
2319, 1, 1636420832446, 1636420832710, 264, 1, 263, 0, 0, 0
2321, 1, 1636420833098, 1636420833374, 276, 1, 275, 0, 1, 1
2322, 1, 1636420833362, 1636420833642, 280, 13, 267, 13, 0, 13
2323, 1, 1636420834094, 1636420834374, 280, 0, 280, 0, 0, 0
2324, 1, 1636420834386, 1636420834662, 276, 1, 275, 0, 1, 1
2325, 1, 1636420835082, 1636420835354, 272, 1, 271, 0, 1, 1
2326, 1, 1636420835374, 1636420835654, 280, 1, 279, 0, 1, 1
2304, 2, 1636420825594, 1636420835867, 10273, 93, 10180, 93, 0, 93
2306, 2, 1636420826318, 1636420836318, 10000, 0, 10000, 0, 0, 0
2327, 1, 1636420836090, 1636420836366, 276, 0, 276, 0, 0, 0
2329, 1, 1636420836366, 1636420836634, 268, 1, 267, 0, 0, 0
2330, 1, 1636420836626, 1636420836898, 272, 1, 271, 1, 0, 1
2331, 1, 1636420837062, 1636420837334, 272, 0, 272, 0, 0, 0
2309, 2, 1636420827402, 1636420837402, 10000, 0, 10000, 0, 0, 0
2332, 1, 1636420837330, 1636420837630, 300, 1, 299, 0, 1, 1
2333, 1, 1636420837534, 1636420837806, 272, 1, 271, 0, 1, 1
2335, 1, 1636420838070, 1636420838342, 272, 0, 272, 0, 0, 0
2336, 1, 1636420838366, 1636420838642, 276, 0, 276, 0, 0, 0
2337, 1, 1636420838546, 1636420838818, 272, 1, 271, 1, 0, 1
2338, 1, 1636420839082, 1636420839354, 272, 1, 271, 0, 0, 0
2339, 1, 1636420839334, 1636420839606, 272, 0, 272, 0, 0, 0
2340, 1, 1636420839522, 1636420839794, 272, 1, 271, 0, 0, 0
2341, 1, 1636420840074, 1636420840346, 272, 0, 272, 0, 0, 0
2342, 1, 1636420840366, 1636420840638, 272, 0, 272, 0, 0, 0
2343, 1, 1636420840538, 1636420840802, 264, 1, 263, 1, 0, 1
2344, 1, 1636420841074, 1636420841346, 272, 0, 272, 0, 0, 0
2345, 1, 1636420841358, 1636420841630, 272, 0, 272, 0, 0, 0
2346, 1, 1636420841570, 1636420841838, 268, 0, 268, 0, 0, 0
2318, 2, 1636420832270, 1636420842270, 10000, 0, 10000, 0, 0, 0
2347, 1, 1636420842090, 1636420842406, 316, 0, 316, 0, 0, 0
2348, 1, 1636420842366, 1636420842638, 272, 0, 272, 0, 0, 0
2320, 2, 1636420832666, 1636420842798, 10132, 45, 10087, 45, 0, 45
2350, 1, 1636420842562, 1636420842890, 328, 0, 328, 0, 0, 0
2349, 1, 1636420842578, 1636420842890, 312, 0, 312, 0, 0, 0
2328, 1, 1636420836222, 1636420843070, 6848, 6576, 272, 6576, 0, 6576
2352, 1, 1636420843082, 1636420843350, 268, 0, 268, 0, 0, 0
2351, 1, 1636420843106, 1636420843378, 272, 0, 272, 0, 0, 0
2353, 1, 1636420843386, 1636420843658, 272, 1, 271, 0, 1, 1
2355, 1, 1636420843482, 1636420843746, 264, 0, 264, 0, 0, 0
2354, 1, 1636420843502, 1636420843770, 268, 0, 268, 0, 0, 0
2356, 1, 1636420843586, 1636420843854, 268, 0, 268, 0, 0, 0
2357, 1, 1636420844018, 1636420844286, 268, 1, 267, 0, 0, 0
2358, 1, 1636420844090, 1636420844362, 272, 0, 272, 0, 0, 0
2359, 1, 1636420844398, 1636420844670, 272, 1, 271, 0, 0, 0
2360, 1, 1636420844466, 1636420844738, 272, 0, 272, 0, 0, 0
2361, 1, 1636420844506, 1636420844782, 276, 0, 276, 0, 0, 0
2362, 1, 1636420844602, 1636420844870, 268, 0, 268, 0, 0, 0
2363, 1, 1636420844986, 1636420845258, 272, 0, 272, 0, 0, 0
2364, 1, 1636420845066, 1636420845342, 276, 0, 276, 0, 0, 0
2365, 1, 1636420845414, 1636420845686, 272, 0, 272, 0, 0, 0
2366, 1, 1636420845458, 1636420845730, 272, 0, 272, 0, 0, 0
2367, 1, 1636420845482, 1636420845758, 276, 1, 275, 0, 1, 1
2368, 1, 1636420845602, 1636420845870, 268, 1, 267, 0, 0, 0
2369, 1, 1636420845970, 1636420846251, 281, 0, 281, 0, 0, 0
2370, 1, 1636420846026, 1636420846298, 272, 0, 272, 0, 0, 0
2371, 1, 1636420846386, 1636420846654, 268, 0, 268, 0, 0, 0
2372, 1, 1636420846490, 1636420846758, 268, 1, 267, 0, 1, 1
2373, 1, 1636420846490, 1636420846758, 268, 1, 267, 0, 1, 1
2374, 1, 1636420846582, 1636420846850, 268, 1, 267, 0, 0, 0
2375, 1, 1636420846994, 1636420847262, 268, 0, 268, 0, 0, 0
2376, 1, 1636420847022, 1636420847290, 268, 0, 268, 0, 0, 0
2334, 2, 1636420837710, 1636420847710, 10000, 0, 10000, 0, 0, 0
2378, 1, 1636420847478, 1636420847758, 280, 0, 280, 0, 0, 0
2379, 1, 1636420847490, 1636420847758, 268, 0, 268, 0, 0, 0
2380, 1, 1636420847582, 1636420847846, 264, 0, 264, 0, 0, 0
2382, 1, 1636420847978, 1636420848246, 268, 0, 268, 0, 0, 0
2381, 1, 1636420848018, 1636420848286, 268, 0, 268, 0, 0, 0
2383, 1, 1636420848026, 1636420848290, 264, 0, 264, 0, 0, 0
2385, 1, 1636420848482, 1636420848750, 268, 0, 268, 0, 0, 0
2384, 1, 1636420848478, 1636420848750, 272, 0, 272, 0, 0, 0
2386, 1, 1636420848562, 1636420848830, 268, 0, 268, 0, 0, 0
2387, 1, 1636420848938, 1636420849210, 272, 0, 272, 0, 0, 0
2389, 1, 1636420848998, 1636420849270, 272, 0, 272, 0, 0, 0
2390, 1, 1636420849478, 1636420849746, 268, 0, 268, 0, 0, 0
2391, 1, 1636420849494, 1636420849762, 268, 1, 267, 0, 0, 0
2392, 1, 1636420849590, 1636420849854, 264, 0, 264, 0, 0, 0
2393, 1, 1636420849930, 1636420850198, 268, 0, 268, 0, 0, 0
2394, 1, 1636420849978, 1636420850250, 272, 0, 272, 0, 0, 0
2395, 1, 1636420850490, 1636420850762, 272, 0, 272, 0, 0, 0
2396, 1, 1636420850522, 1636420850790, 268, 1, 267, 0, 0, 0
2397, 1, 1636420850570, 1636420850834, 264, 0, 264, 0, 0, 0
2398, 1, 1636420850922, 1636420851190, 268, 0, 268, 0, 0, 0
2399, 1, 1636420850950, 1636420851222, 272, 0, 272, 0, 0, 0
2400, 1, 1636420851494, 1636420851762, 268, 0, 268, 0, 0, 0
2401, 1, 1636420851510, 1636420851786, 276, 0, 276, 0, 0, 0
2402, 1, 1636420851602, 1636420851870, 268, 0, 268, 0, 0, 0
2403, 1, 1636420851914, 1636420852182, 268, 0, 268, 0, 0, 0
2404, 1, 1636420851958, 1636420852230, 272, 0, 272, 0, 0, 0
2405, 1, 1636420852478, 1636420852746, 268, 0, 268, 0, 0, 0
2406, 1, 1636420852490, 1636420852766, 276, 0, 276, 0, 0, 0
2407, 1, 1636420852914, 1636420853190, 276, 0, 276, 0, 0, 0
2408, 1, 1636420852970, 1636420853242, 272, 0, 272, 0, 0, 0
2410, 1, 1636420853502, 1636420853774, 272, 1, 271, 0, 1, 1
2411, 1, 1636420853914, 1636420854194, 280, 1, 279, 0, 0, 0
2412, 1, 1636420853986, 1636420854258, 272, 1, 271, 0, 1, 1
2413, 1, 1636420854494, 1636420854766, 272, 0, 272, 0, 0, 0
2414, 1, 1636420854878, 1636420855158, 280, 0, 280, 0, 0, 0
2415, 1, 1636420854966, 1636420855238, 272, 1, 271, 0, 1, 1
2416, 1, 1636420855514, 1636420855787, 273, 1, 272, 1, 0, 1
2417, 1, 1636420855850, 1636420856122, 272, 1, 271, 0, 0, 0
2419, 1, 1636420856502, 1636420856774, 272, 0, 272, 0, 0, 0
2420, 1, 1636420856818, 1636420857090, 272, 0, 272, 0, 0, 0
2377, 2, 1636420847362, 1636420857362, 10000, 0, 10000, 0, 0, 0
2421, 1, 1636420857514, 1636420857786, 272, 1, 271, 0, 0, 0
2422, 1, 1636420857670, 1636420857942, 272, 0, 272, 0, 0, 0
2424, 1, 1636420858582, 1636420858858, 276, 1, 275, 0, 1, 1
2388, 2, 1636420848970, 1636420858970, 10000, 0, 10000, 0, 0, 0
2426, 1, 1636420859578, 1636420859854, 276, 0, 276, 0, 0, 0
2427, 1, 1636420860558, 1636420860834, 276, 0, 276, 0, 0, 0
2428, 1, 1636420861566, 1636420861838, 272, 1, 271, 1, 0, 1
2429, 1, 1636420862546, 1636420862822, 276, 1, 275, 0, 0, 0
2409, 2, 1636420853478, 1636420863478, 10000, 0, 10000, 0, 0, 0
2430, 1, 1636420863566, 1636420863838, 272, 1, 271, 0, 1, 1
2431, 1, 1636420863786, 1636420864058, 272, 1, 271, 0, 1, 1
2432, 1, 1636420864566, 1636420864838, 272, 1, 271, 0, 0, 0
2433, 1, 1636420864694, 1636420864966, 272, 0, 272, 0, 0, 0
2434, 1, 1636420865558, 1636420865834, 276, 0, 276, 0, 0, 0
2418, 2, 1636420855946, 1636420865946, 10000, 0, 10000, 0, 0, 0
2435, 1, 1636420865674, 1636420865994, 320, 0, 320, 0, 0, 0
2436, 1, 1636420866254, 1636420866531, 277, 0, 277, 0, 0, 0
2437, 1, 1636420866574, 1636420866846, 272, 0, 272, 0, 0, 0
2438, 1, 1636420866666, 1636420866938, 272, 0, 272, 0, 0, 0
2439, 1, 1636420867162, 1636420867431, 269, 0, 269, 0, 0, 0
2423, 2, 1636420857806, 1636420867806, 10000, 0, 10000, 0, 0, 0
2440, 1, 1636420867582, 1636420867854, 272, 1, 271, 0, 0, 0
2441, 1, 1636420867674, 1636420867946, 272, 0, 272, 0, 0, 0
2442, 1, 1636420868114, 1636420868386, 272, 1, 271, 0, 1, 1
2443, 1, 1636420868134, 1636420868402, 268, 0, 268, 0, 0, 0
2444, 1, 1636420868582, 1636420868858, 276, 0, 276, 0, 0, 0
2445, 1, 1636420868654, 1636420868926, 272, 0, 272, 0, 0, 0
2425, 2, 1636420859278, 1636420869278, 10000, 0, 10000, 0, 0, 0
2446, 1, 1636420869026, 1636420869326, 300, 0, 300, 0, 0, 0
2447, 1, 1636420869102, 1636420869414, 312, 0, 312, 0, 0, 0
2448, 1, 1636420869586, 1636420869858, 272, 0, 272, 0, 0, 0
2449, 1, 1636420869598, 1636420869866, 268, 0, 268, 0, 0, 0
2450, 1, 1636420869662, 1636420869938, 276, 0, 276, 0, 0, 0
2451, 1, 1636420870026, 1636420870294, 268, 0, 268, 0, 0, 0
2452, 1, 1636420870110, 1636420870382, 272, 0, 272, 0, 0, 0
2453, 1, 1636420870526, 1636420870794, 268, 0, 268, 0, 0, 0
2454, 1, 1636420870570, 1636420870838, 268, 0, 268, 0, 0, 0
2455, 1, 1636420870674, 1636420870946, 272, 0, 272, 0, 0, 0
2456, 1, 1636420870998, 1636420871266, 268, 0, 268, 0, 0, 0
2457, 1, 1636420871086, 1636420871358, 272, 0, 272, 0, 0, 0
2458, 1, 1636420871510, 1636420871778, 268, 0, 268, 0, 0, 0
2459, 1, 1636420871558, 1636420871830, 272, 0, 272, 0, 0, 0
2460, 1, 1636420871654, 1636420871922, 268, 1, 267, 0, 0, 0
2461, 1, 1636420872026, 1636420872298, 272, 1, 271, 0, 0, 0
2462, 1, 1636420872094, 1636420872358, 264, 1, 263, 0, 0, 0
2463, 1, 1636420872506, 1636420872774, 268, 0, 268, 0, 0, 0
2464, 1, 1636420872554, 1636420872822, 268, 0, 268, 0, 0, 0
2465, 1, 1636420872674, 1636420872942, 268, 0, 268, 0, 0, 0
2466, 1, 1636420873030, 1636420873306, 276, 0, 276, 0, 0, 0
2467, 1, 1636420873110, 1636420873378, 268, 0, 268, 0, 0, 0
2468, 1, 1636420873506, 1636420873778, 272, 1, 271, 0, 0, 0
2469, 1, 1636420873554, 1636420873822, 268, 0, 268, 0, 0, 0
2470, 1, 1636420873686, 1636420873958, 272, 0, 272, 0, 0, 0
2471, 1, 1636420873998, 1636420874274, 276, 0, 276, 0, 0, 0
2472, 1, 1636420874098, 1636420874366, 268, 1, 267, 1, 0, 1
2473, 1, 1636420874518, 1636420874786, 268, 1, 267, 0, 0, 0
2474, 1, 1636420874530, 1636420874802, 272, 1, 271, 0, 0, 0
2475, 1, 1636420874686, 1636420874958, 272, 0, 272, 0, 0, 0
2476, 1, 1636420875006, 1636420875278, 272, 0, 272, 0, 0, 0
2477, 1, 1636420875102, 1636420875374, 272, 1, 271, 0, 0, 0
2478, 1, 1636420875510, 1636420875778, 268, 0, 268, 0, 0, 0
2479, 1, 1636420875534, 1636420875806, 272, 0, 272, 0, 0, 0
2480, 1, 1636420875690, 1636420875958, 268, 0, 268, 0, 0, 0
2481, 1, 1636420876042, 1636420876314, 272, 1, 271, 0, 0, 0
2482, 1, 1636420876118, 1636420876390, 272, 0, 272, 0, 0, 0
2483, 1, 1636420876482, 1636420876746, 264, 1, 263, 0, 0, 0
2484, 1, 1636420876502, 1636420876770, 268, 1, 267, 1, 0, 1
2485, 1, 1636420876666, 1636420876934, 268, 0, 268, 0, 0, 0
2486, 1, 1636420877046, 1636420877310, 264, 1, 263, 0, 1, 1
2487, 1, 1636420877118, 1636420877382, 264, 1, 263, 0, 0, 0
2488, 1, 1636420877458, 1636420877730, 272, 0, 272, 0, 0, 0
2490, 1, 1636420877654, 1636420877930, 276, 1, 275, 0, 0, 0
2491, 1, 1636420878026, 1636420878294, 268, 0, 268, 0, 0, 0
2492, 1, 1636420878146, 1636420878418, 272, 1, 271, 0, 0, 0
2493, 1, 1636420878426, 1636420878698, 272, 0, 272, 0, 0, 0
2494, 1, 1636420878650, 1636420878922, 272, 0, 272, 0, 0, 0
2495, 1, 1636420879050, 1636420879326, 276, 1, 275, 0, 0, 0
2496, 1, 1636420879118, 1636420879394, 276, 1, 275, 0, 0, 0
2497, 1, 1636420879422, 1636420879694, 272, 1, 271, 0, 1, 1
2498, 1, 1636420879626, 1636420879894, 268, 1, 267, 0, 1, 1
2499, 1, 1636420880042, 1636420880314, 272, 1, 271, 1, 0, 1
2500, 1, 1636420880106, 1636420880378, 272, 0, 272, 0, 0, 0
2501, 1, 1636420880394, 1636420880666, 272, 1, 271, 0, 0, 0
2502, 1, 1636420880598, 1636420880862, 264, 0, 264, 0, 0, 0
2503, 1, 1636420881066, 1636420881338, 272, 1, 271, 0, 0, 0
2504, 1, 1636420881102, 1636420881374, 272, 0, 272, 0, 0, 0
2505, 1, 1636420881366, 1636420881638, 272, 1, 271, 0, 0, 0
2506, 1, 1636420881598, 1636420881867, 269, 0, 269, 0, 0, 0
2507, 1, 1636420882074, 1636420882342, 268, 1, 267, 0, 0, 0
2508, 1, 1636420882334, 1636420882606, 272, 1, 271, 0, 1, 1
2509, 1, 1636420882570, 1636420882834, 264, 1, 263, 0, 1, 1
2510, 1, 1636420883054, 1636420883326, 272, 0, 272, 0, 0, 0
2512, 1, 1636420883542, 1636420883814, 272, 1, 271, 0, 1, 1
2513, 1, 1636420884034, 1636420884310, 276, 0, 276, 0, 0, 0
2514, 1, 1636420884510, 1636420884783, 273, 0, 273, 0, 0, 0
2515, 1, 1636420885006, 1636420885278, 272, 0, 272, 0, 0, 0
2516, 1, 1636420885542, 1636420885814, 272, 1, 271, 1, 0, 1
2517, 1, 1636420885970, 1636420886242, 272, 1, 271, 0, 0, 0
2518, 1, 1636420886518, 1636420886782, 264, 0, 264, 0, 0, 0
2519, 1, 1636420886934, 1636420887202, 268, 1, 267, 0, 0, 0
2489, 2, 1636420877482, 1636420887482, 10000, 0, 10000, 0, 0, 0
2520, 1, 1636420887526, 1636420887790, 264, 0, 264, 0, 0, 0
2521, 1, 1636420887790, 1636420888054, 264, 0, 264, 0, 0, 0
2522, 1, 1636420887970, 1636420888234, 264, 0, 264, 0, 0, 0
2523, 1, 1636420888454, 1636420888726, 272, 1, 271, 0, 1, 1
2524, 1, 1636420888698, 1636420888962, 264, 0, 264, 0, 0, 0
2525, 1, 1636420888970, 1636420889234, 264, 0, 264, 0, 0, 0
2527, 1, 1636420889670, 1636420889934, 264, 0, 264, 0, 0, 0
2528, 1, 1636420889962, 1636420890226, 264, 1, 263, 0, 1, 1
2529, 1, 1636420890634, 1636420890898, 264, 0, 264, 0, 0, 0
2530, 1, 1636420890942, 1636420891210, 268, 0, 268, 0, 0, 0
2531, 1, 1636420891666, 1636420891930, 264, 0, 264, 0, 0, 0
2533, 1, 1636420892650, 1636420892926, 276, 0, 276, 0, 0, 0
2511, 2, 1636420883322, 1636420893322, 10000, 0, 10000, 0, 0, 0
2534, 1, 1636420893630, 1636420893898, 268, 0, 268, 0, 0, 0
2535, 1, 1636420893658, 1636420893926, 268, 0, 268, 0, 0, 0
2536, 1, 1636420894542, 1636420894810, 268, 1, 267, 0, 0, 0
2537, 1, 1636420894670, 1636420894938, 268, 1, 267, 0, 0, 0
2538, 1, 1636420895570, 1636420895846, 276, 1, 275, 0, 0, 0
2539, 1, 1636420895666, 1636420895934, 268, 0, 268, 0, 0, 0
2540, 1, 1636420896542, 1636420896818, 276, 1, 275, 0, 1, 1
2541, 1, 1636420896666, 1636420896938, 272, 0, 272, 0, 0, 0
2542, 1, 1636420897547, 1636420897818, 271, 0, 271, 0, 0, 0
2543, 1, 1636420897678, 1636420897954, 276, 0, 276, 0, 0, 0
2544, 1, 1636420898546, 1636420898823, 277, 0, 277, 0, 0, 0
2545, 1, 1636420898678, 1636420899090, 412, 145, 267, 145, 0, 145
2526, 2, 1636420889446, 1636420899446, 10000, 0, 10000, 0, 0, 0
2546, 1, 1636420899546, 1636420899822, 276, 0, 276, 0, 0, 0
2547, 1, 1636420899698, 1636420899970, 272, 0, 272, 0, 0, 0
2548, 1, 1636420899758, 1636420900026, 268, 0, 268, 0, 0, 0
2549, 1, 1636420900542, 1636420900810, 268, 1, 267, 0, 0, 0
2550, 1, 1636420900662, 1636420900930, 268, 0, 268, 0, 0, 0
2551, 1, 1636420900670, 1636420900934, 264, 0, 264, 0, 0, 0
2552, 1, 1636420901578, 1636420901854, 276, 1, 275, 0, 0, 0
2532, 2, 1636420891930, 1636420901930, 10000, 0, 10000, 0, 0, 0
2553, 1, 1636420901658, 1636420901978, 320, 0, 320, 0, 0, 0
2554, 1, 1636420901690, 1636420901978, 288, 1, 287, 0, 0, 0
2555, 1, 1636420902238, 1636420902506, 268, 0, 268, 0, 0, 0
2556, 1, 1636420902554, 1636420902826, 272, 0, 272, 0, 0, 0
2557, 1, 1636420902630, 1636420902902, 272, 1, 271, 0, 0, 0
2558, 1, 1636420902686, 1636420902954, 268, 0, 268, 0, 0, 0
2559, 1, 1636420903150, 1636420903422, 272, 0, 272, 0, 0, 0
2560, 1, 1636420903534, 1636420903802, 268, 0, 268, 0, 0, 0
2561, 1, 1636420903598, 1636420903866, 268, 0, 268, 0, 0, 0
2562, 1, 1636420903706, 1636420903970, 264, 0, 264, 0, 0, 0
2563, 1, 1636420904162, 1636420904438, 276, 0, 276, 0, 0, 0
2564, 1, 1636420904534, 1636420904814, 280, 0, 280, 0, 0, 0
2565, 1, 1636420904574, 1636420904850, 276, 0, 276, 0, 0, 0
2566, 1, 1636420904702, 1636420904974, 272, 1, 271, 0, 0, 0
2567, 1, 1636420905138, 1636420905414, 276, 0, 276, 0, 0, 0
2568, 1, 1636420905574, 1636420905842, 268, 0, 268, 0, 0, 0
2569, 1, 1636420905678, 1636420905946, 268, 0, 268, 0, 0, 0
2570, 1, 1636420906142, 1636420906414, 272, 0, 272, 0, 0, 0
2571, 1, 1636420906546, 1636420906814, 268, 0, 268, 0, 0, 0
2572, 1, 1636420906682, 1636420906954, 272, 0, 272, 0, 0, 0
2573, 1, 1636420907146, 1636420907422, 276, 0, 276, 0, 0, 0
2574, 1, 1636420907530, 1636420907802, 272, 1, 271, 0, 1, 1
2575, 1, 1636420907718, 1636420907990, 272, 1, 271, 0, 0, 0
2576, 1, 1636420908114, 1636420908386, 272, 1, 271, 0, 0, 0
2577, 1, 1636420908494, 1636420908766, 272, 1, 271, 0, 1, 1
2578, 1, 1636420908718, 1636420908990, 272, 1, 271, 0, 0, 0
2579, 1, 1636420909122, 1636420909395, 273, 0, 273, 0, 0, 0
2580, 1, 1636420909526, 1636420909798, 272, 0, 272, 0, 0, 0
2581, 1, 1636420909702, 1636420909974, 272, 0, 272, 0, 0, 0
2582, 1, 1636420910158, 1636420910430, 272, 0, 272, 0, 0, 0
2583, 1, 1636420910502, 1636420910774, 272, 1, 271, 0, 0, 0
2584, 1, 1636420910730, 1636420910999, 269, 0, 269, 0, 0, 0
2585, 1, 1636420911158, 1636420911431, 273, 0, 273, 0, 0, 0
2586, 1, 1636420911474, 1636420911742, 268, 0, 268, 0, 0, 0
2587, 1, 1636420912138, 1636420912410, 272, 1, 271, 1, 0, 1
2588, 1, 1636420912438, 1636420912714, 276, 1, 275, 0, 1, 1
2589, 1, 1636420913166, 1636420913438, 272, 0, 272, 0, 0, 0
2590, 2, 1636420913430, 1636420923434, 10004, 0, 10004, 0, 0, 0
2591, 1, 1636420923738, 1636420924014, 276, 1, 275, 0, 0, 0
2592, 1, 1636420924650, 1636420924922, 272, 1, 271, 0, 0, 0
2593, 1, 1636420925658, 1636420925930, 272, 0, 272, 0, 0, 0
2594, 1, 1636420926634, 1636420926906, 272, 1, 271, 0, 0, 0
2595, 1, 1636420927650, 1636420927926, 276, 1, 275, 0, 0, 0
2596, 1, 1636420928654, 1636420928926, 272, 1, 271, 0, 1, 1
2597, 1, 1636420929626, 1636420929902, 276, 1, 275, 1, 0, 1
2598, 1, 1636420930634, 1636420930906, 272, 1, 271, 0, 0, 0
2599, 1, 1636420931670, 1636420931947, 277, 0, 277, 0, 0, 0
2600, 1, 1636420932670, 1636420932942, 272, 0, 272, 0, 0, 0
2601, 1, 1636421195446, 1636421195718, 272, 1, 271, 0, 0, 0
2602, 1, 1636421196114, 1636421196382, 268, 0, 268, 0, 0, 0
2603, 1, 1636421196290, 1636421196562, 272, 1, 271, 0, 1, 1
2604, 1, 1636421196778, 1636421197050, 272, 1, 271, 0, 0, 0
2605, 1, 1636421196958, 1636421197230, 272, 0, 272, 0, 0, 0
2606, 1, 1636421197014, 1636421197278, 264, 1, 263, 0, 0, 0
2607, 1, 1636421197446, 1636421197718, 272, 1, 271, 0, 1, 1
2609, 1, 1636421197626, 1636421197898, 272, 1, 271, 1, 0, 1
2608, 1, 1636421197626, 1636421197902, 276, 1, 275, 1, 0, 1
2610, 1, 1636421197674, 1636421197938, 264, 0, 264, 0, 0, 0
2611, 1, 1636421198114, 1636421198386, 272, 0, 272, 0, 0, 0
2613, 1, 1636421198258, 1636421198526, 268, 0, 268, 0, 0, 0
2612, 1, 1636421198298, 1636421198566, 268, 1, 267, 0, 0, 0
2614, 1, 1636421198302, 1636421198574, 272, 0, 272, 0, 0, 0
2615, 1, 1636421198334, 1636421198598, 264, 1, 263, 0, 1, 1
2616, 1, 1636421198786, 1636421199058, 272, 0, 272, 0, 0, 0
2617, 1, 1636421198806, 1636421199082, 276, 0, 276, 0, 0, 0
2618, 1, 1636421198926, 1636421199194, 268, 1, 267, 0, 0, 0
2619, 1, 1636421198962, 1636421199234, 272, 0, 272, 0, 0, 0
2620, 1, 1636421198974, 1636421199238, 264, 0, 264, 0, 0, 0
2621, 1, 1636421198998, 1636421199270, 272, 1, 271, 0, 0, 0
2623, 1, 1636421199450, 1636421199722, 272, 0, 272, 0, 0, 0
2622, 1, 1636421199458, 1636421199730, 272, 0, 272, 0, 0, 0
2624, 1, 1636421199494, 1636421199766, 272, 0, 272, 0, 0, 0
2625, 1, 1636421199586, 1636421199858, 272, 0, 272, 0, 0, 0
2626, 1, 1636421199630, 1636421199902, 272, 0, 272, 0, 0, 0
2627, 1, 1636421199634, 1636421199902, 268, 0, 268, 0, 0, 0
2628, 1, 1636421199670, 1636421199942, 272, 0, 272, 0, 0, 0
2631, 1, 1636421200106, 1636421200382, 276, 0, 276, 0, 0, 0
2629, 1, 1636421200122, 1636421200390, 268, 0, 268, 0, 0, 0
2630, 1, 1636421200130, 1636421200402, 272, 0, 272, 0, 0, 0
2632, 1, 1636421200162, 1636421200434, 272, 0, 272, 0, 0, 0
2633, 1, 1636421200254, 1636421200526, 272, 0, 272, 0, 0, 0
2634, 1, 1636421200298, 1636421200566, 268, 0, 268, 0, 0, 0
2635, 1, 1636421200298, 1636421200566, 268, 0, 268, 0, 0, 0
2636, 1, 1636421200338, 1636421200602, 264, 0, 264, 0, 0, 0
2637, 1, 1636421200678, 1636421200950, 272, 0, 272, 0, 0, 0
2639, 1, 1636421200786, 1636421201058, 272, 0, 272, 0, 0, 0
2638, 1, 1636421200778, 1636421201062, 284, 0, 284, 0, 0, 0
2641, 1, 1636421200830, 1636421201098, 268, 0, 268, 0, 0, 0
2642, 1, 1636421200922, 1636421201190, 268, 0, 268, 0, 0, 0
2640, 1, 1636421200802, 1636421201222, 420, 149, 271, 148, 1, 149
2643, 1, 1636421200966, 1636421201242, 276, 0, 276, 0, 0, 0
2644, 1, 1636421200970, 1636421201242, 272, 0, 272, 0, 0, 0
2645, 1, 1636421201002, 1636421201274, 272, 1, 271, 0, 0, 0
2646, 1, 1636421201206, 1636421201494, 288, 17, 271, 17, 0, 17
2647, 1, 1636421201346, 1636421201618, 272, 0, 272, 0, 0, 0
2648, 1, 1636421201454, 1636421201726, 272, 0, 272, 0, 0, 0
2649, 1, 1636421201458, 1636421201730, 272, 0, 272, 0, 0, 0
2650, 1, 1636421201494, 1636421201770, 276, 1, 275, 1, 0, 1
2651, 1, 1636421201586, 1636421201858, 272, 0, 272, 0, 0, 0
2652, 1, 1636421201618, 1636421201882, 264, 0, 264, 0, 0, 0
2654, 1, 1636421201642, 1636421201910, 268, 1, 267, 0, 1, 1
2653, 1, 1636421201642, 1636421201910, 268, 1, 267, 0, 1, 1
2655, 1, 1636421201678, 1636421201950, 272, 0, 272, 0, 0, 0
2656, 1, 1636421201890, 1636421202158, 268, 0, 268, 0, 0, 0
2657, 1, 1636421202022, 1636421202294, 272, 0, 272, 0, 0, 0
2659, 1, 1636421202122, 1636421202394, 272, 1, 271, 1, 0, 1
2658, 1, 1636421202122, 1636421202394, 272, 1, 271, 0, 1, 1
2660, 1, 1636421202166, 1636421202438, 272, 0, 272, 0, 0, 0
2661, 1, 1636421202254, 1636421202522, 268, 0, 268, 0, 0, 0
2662, 1, 1636421202278, 1636421202546, 268, 0, 268, 0, 0, 0
2664, 1, 1636421202306, 1636421202574, 268, 1, 267, 1, 0, 1
2663, 1, 1636421202306, 1636421202574, 268, 1, 267, 0, 1, 1
2665, 1, 1636421202350, 1636421202614, 264, 0, 264, 0, 0, 0
2666, 1, 1636421202554, 1636421202826, 272, 0, 272, 0, 0, 0
2667, 1, 1636421202690, 1636421202962, 272, 0, 272, 0, 0, 0
2668, 1, 1636421202790, 1636421203054, 264, 0, 264, 0, 0, 0
2669, 1, 1636421202786, 1636421203054, 268, 0, 268, 0, 0, 0
2670, 1, 1636421202838, 1636421203102, 264, 0, 264, 0, 0, 0
2671, 1, 1636421202918, 1636421203186, 268, 0, 268, 0, 0, 0
2672, 1, 1636421202946, 1636421203218, 272, 0, 272, 0, 0, 0
2674, 1, 1636421202970, 1636421203234, 264, 0, 264, 0, 0, 0
2673, 1, 1636421202974, 1636421203246, 272, 0, 272, 0, 0, 0
2675, 1, 1636421203014, 1636421203282, 268, 0, 268, 0, 0, 0
2677, 1, 1636421203226, 1636421203498, 272, 0, 272, 0, 0, 0
2676, 1, 1636421203010, 1636421203502, 492, 225, 267, 224, 0, 224
2678, 1, 1636421203358, 1636421203634, 276, 0, 276, 0, 0, 0
2680, 1, 1636421203450, 1636421203722, 272, 1, 271, 1, 0, 1
2679, 1, 1636421203450, 1636421203722, 272, 1, 271, 1, 0, 1
2681, 1, 1636421203502, 1636421203774, 272, 0, 272, 0, 0, 0
2682, 1, 1636421203582, 1636421203850, 268, 0, 268, 0, 0, 0
2683, 1, 1636421203618, 1636421203890, 272, 0, 272, 0, 0, 0
2684, 1, 1636421203638, 1636421203902, 264, 0, 264, 0, 0, 0
2685, 1, 1636421203646, 1636421203926, 280, 0, 280, 0, 0, 0
2686, 1, 1636421203682, 1636421203950, 268, 0, 268, 0, 0, 0
2687, 1, 1636421203894, 1636421204162, 268, 0, 268, 0, 0, 0
2688, 1, 1636421203898, 1636421204170, 272, 0, 272, 0, 0, 0
2689, 1, 1636421204030, 1636421204294, 264, 1, 263, 0, 0, 0
2692, 1, 1636421204090, 1636421204362, 272, 0, 272, 0, 0, 0
2690, 1, 1636421204118, 1636421204390, 272, 0, 272, 0, 0, 0
2691, 1, 1636421204118, 1636421204390, 272, 1, 271, 0, 1, 1
2694, 1, 1636421204246, 1636421204514, 268, 0, 268, 0, 0, 0
2696, 1, 1636421204302, 1636421204582, 280, 0, 280, 0, 0, 0
2697, 1, 1636421204326, 1636421204594, 268, 0, 268, 0, 0, 0
2698, 1, 1636421204346, 1636421204614, 268, 0, 268, 0, 0, 0
2693, 1, 1636421204170, 1636421204634, 464, 193, 271, 193, 0, 193
2700, 1, 1636421204558, 1636421204830, 272, 0, 272, 0, 0, 0
2701, 1, 1636421204566, 1636421204838, 272, 0, 272, 0, 0, 0
2702, 1, 1636421204694, 1636421204970, 276, 0, 276, 0, 0, 0
2703, 1, 1636421204782, 1636421205046, 264, 1, 263, 0, 0, 0
2705, 1, 1636421204786, 1636421205054, 268, 1, 267, 0, 0, 0
2706, 1, 1636421204906, 1636421205178, 272, 0, 272, 0, 0, 0
2708, 1, 1636421204982, 1636421205262, 280, 0, 280, 0, 0, 0
2711, 1, 1636421205042, 1636421205314, 272, 0, 272, 0, 0, 0
2710, 1, 1636421205022, 1636421205318, 296, 24, 272, 24, 0, 24
2712, 1, 1636421205226, 1636421205498, 272, 0, 272, 0, 0, 0
2713, 1, 1636421205234, 1636421205510, 276, 0, 276, 0, 0, 0
2714, 1, 1636421205366, 1636421205642, 276, 0, 276, 0, 0, 0
2715, 1, 1636421205442, 1636421205722, 280, 0, 280, 0, 0, 0
2718, 1, 1636421205578, 1636421205846, 268, 0, 268, 0, 0, 0
2719, 1, 1636421205662, 1636421205930, 268, 0, 268, 0, 0, 0
2720, 1, 1636421205710, 1636421205982, 272, 0, 272, 0, 0, 0
2722, 1, 1636421205894, 1636421206162, 268, 0, 268, 0, 0, 0
2723, 1, 1636421205906, 1636421206178, 272, 0, 272, 0, 0, 0
2725, 1, 1636421206118, 1636421206394, 276, 1, 275, 0, 1, 1
2727, 1, 1636421206246, 1636421206514, 268, 0, 268, 0, 0, 0
2729, 1, 1636421206378, 1636421206646, 268, 0, 268, 0, 0, 0
2731, 1, 1636421206574, 1636421206854, 280, 0, 280, 0, 0, 0
2733, 1, 1636421206790, 1636421207062, 272, 0, 272, 0, 0, 0
2735, 1, 1636421207042, 1636421207326, 284, 0, 284, 0, 0, 0
2736, 1, 1636421207250, 1636421207526, 276, 0, 276, 0, 0, 0
2738, 1, 1636421207458, 1636421207730, 272, 0, 272, 0, 0, 0
2741, 1, 1636421207926, 1636421208198, 272, 1, 271, 0, 1, 1
2742, 1, 1636421208127, 1636421208398, 271, 0, 271, 0, 0, 0
2745, 1, 1636421208794, 1636421209070, 276, 1, 275, 1, 0, 1
2695, 2, 1636421204294, 1636421214294, 10000, 0, 10000, 0, 0, 0
2704, 2, 1636421204786, 1636421214786, 10000, 0, 10000, 0, 0, 0
2699, 2, 1636421204466, 1636421214830, 10364, 169, 10195, 169, 0, 169
2707, 2, 1636421204934, 1636421214970, 10036, 0, 10036, 9897, 0, 9897
2709, 2, 1636421204990, 1636421215014, 10024, 0, 10024, 0, 0, 0
2716, 2, 1636421205458, 1636421215458, 10000, 0, 10000, 9374, 0, 9374
2717, 2, 1636421205478, 1636421215506, 10028, 0, 10028, 9354, 0, 9354
2749, 1, 1636421215234, 1636421215554, 320, 1, 319, 0, 1, 1
2748, 1, 1636421215234, 1636421215554, 320, 1, 319, 1, 0, 1
2721, 2, 1636421205718, 1636421215718, 10000, 0, 10000, 0, 0, 0
2724, 2, 1636421206042, 1636421216042, 10000, 0, 10000, 8789, 0, 8789
2726, 2, 1636421206086, 1636421216086, 10000, 0, 10000, 8744, 0, 8744
2752, 1, 1636421215950, 1636421216222, 272, 1, 271, 1, 0, 1
2751, 1, 1636421215950, 1636421216222, 272, 1, 271, 1, 0, 1
2728, 2, 1636421206326, 1636421216326, 10000, 0, 10000, 0, 0, 0
2730, 2, 1636421206566, 1636421216566, 10000, 0, 10000, 8265, 0, 8265
2732, 2, 1636421206682, 1636421216682, 10000, 0, 10000, 8150, 0, 8150
2734, 2, 1636421206910, 1636421216910, 10000, 0, 10000, 0, 0, 0
2755, 1, 1636421216654, 1636421216958, 304, 1, 303, 1, 0, 1
2754, 1, 1636421216654, 1636421216958, 304, 1, 303, 0, 1, 1
2737, 2, 1636421207210, 1636421217210, 10000, 0, 10000, 7620, 0, 7620
2758, 1, 1636421217386, 1636421217666, 280, 1, 279, 0, 1, 1
2759, 1, 1636421217386, 1636421217666, 280, 1, 279, 0, 0, 0
2740, 2, 1636421207706, 1636421217706, 10000, 0, 10000, 7126, 0, 7126
2739, 2, 1636421207726, 1636421217750, 10024, 0, 10024, 0, 0, 0
2762, 1, 1636421218066, 1636421218338, 272, 1, 271, 0, 1, 1
2744, 2, 1636421208582, 1636421218582, 10000, 0, 10000, 6250, 0, 6250
2743, 2, 1636421208594, 1636421218626, 10032, 0, 10032, 6237, 0, 6237
2763, 1, 1636421218758, 1636421219034, 276, 0, 276, 0, 0, 0
2746, 2, 1636421209466, 1636421219474, 10008, 0, 10008, 5365, 0, 5365
2764, 1, 1636421219430, 1636421219702, 272, 0, 272, 0, 0, 0
2747, 2, 1636421214602, 1636421224603, 10001, 0, 10001, 229, 0, 229
2750, 2, 1636421215298, 1636421225298, 10000, 0, 10000, 0, 0, 0
2753, 2, 1636421216026, 1636421226027, 10001, 0, 10001, 0, 0, 0
2756, 2, 1636421216654, 1636421226654, 10000, 0, 10000, 1, 0, 1
2757, 2, 1636421217258, 1636421227258, 10000, 0, 10000, 0, 0, 0
2760, 2, 1636421218034, 1636421228034, 10000, 0, 10000, 0, 0, 0
2761, 2, 1636421218066, 1636421228078, 10012, 0, 10012, 0, 0, 0
2765, 1, 1636421220098, 1636421228306, 8208, 7937, 271, 1, 7936, 7937
2784, 1, 1636421228374, 1636421228646, 272, 0, 272, 0, 0, 0
2772, 2, 1636421225142, 1636421235142, 10000, 0, 10000, 1, 0, 1
2776, 2, 1636421225150, 1636421235186, 10036, 0, 10036, 1, 0, 1
2768, 2, 1636421225150, 1636421235230, 10080, 0, 10080, 0, 0, 0
2766, 2, 1636421225150, 1636421235274, 10124, 0, 10124, 1, 0, 1
2775, 2, 1636421225150, 1636421235319, 10169, 0, 10169, 1, 0, 1
2773, 2, 1636421225150, 1636421235367, 10217, 0, 10217, 1, 0, 1
2777, 2, 1636421225150, 1636421235414, 10264, 0, 10264, 1, 0, 1
2767, 2, 1636421225150, 1636421235462, 10312, 0, 10312, 1, 0, 1
2770, 2, 1636421225150, 1636421235506, 10356, 0, 10356, 1, 0, 1
2769, 2, 1636421225150, 1636421235550, 10400, 0, 10400, 0, 0, 0
2778, 2, 1636421225150, 1636421235594, 10444, 0, 10444, 1, 0, 1
2771, 2, 1636421225142, 1636421235638, 10496, 0, 10496, 1, 0, 1
2774, 2, 1636421225142, 1636421235686, 10544, 0, 10544, 1, 0, 1
2779, 2, 1636421225610, 1636421235730, 10120, 0, 10120, 0, 0, 0
2779, 2, 1636421225610, 1636421235730, 10120, 0, 10120, 0, 0, 0
2785, 1, 1636421228706, 1636421235962, 7256, 6981, 275, 0, 6981, 6981
2788, 1, 1636421235990, 1636421236262, 272, 1, 271, 0, 1, 1
2793, 1, 1636421235998, 1636421236263, 265, 0, 265, 0, 0, 0
2787, 1, 1636421235990, 1636421236262, 272, 1, 271, 0, 1, 1
2780, 2, 1636421226334, 1636421236334, 10000, 0, 10000, 0, 0, 0
2791, 1, 1636421236006, 1636421236566, 560, 258, 302, 258, 0, 258
2802, 1, 1636421236642, 1636421236914, 272, 1, 271, 0, 0, 0
2804, 1, 1636421236658, 1636421236930, 272, 1, 271, 0, 1, 1
2805, 1, 1636421236658, 1636421236930, 272, 1, 271, 0, 1, 1
2803, 1, 1636421236658, 1636421236934, 276, 1, 275, 1, 0, 1
2781, 2, 1636421226962, 1636421236962, 10000, 0, 10000, 0, 0, 0
2806, 1, 1636421237006, 1636421237274, 268, 0, 268, 0, 0, 0
2807, 1, 1636421237270, 1636421237542, 272, 0, 272, 0, 0, 0
2782, 2, 1636421227566, 1636421237566, 10000, 0, 10000, 0, 0, 0
2808, 1, 1636421237314, 1636421237614, 300, 0, 300, 0, 0, 0
2809, 1, 1636421237326, 1636421237614, 288, 1, 287, 0, 0, 0
2811, 1, 1636421237334, 1636421237614, 280, 0, 280, 0, 0, 0
2812, 1, 1636421237674, 1636421237946, 272, 0, 272, 0, 0, 0
2813, 1, 1636421237878, 1636421238150, 272, 1, 271, 0, 1, 1
2814, 1, 1636421237946, 1636421238210, 264, 1, 263, 0, 1, 1
2816, 1, 1636421238010, 1636421238282, 272, 1, 271, 1, 0, 1
2817, 1, 1636421238010, 1636421238282, 272, 1, 271, 1, 0, 1
2815, 1, 1636421238010, 1636421238286, 276, 1, 275, 0, 1, 1
2783, 2, 1636421228342, 1636421238342, 10000, 0, 10000, 0, 0, 0
2818, 1, 1636421238386, 1636421238654, 268, 0, 268, 0, 0, 0
2819, 1, 1636421238546, 1636421238818, 272, 0, 272, 0, 0, 0
2820, 1, 1636421238614, 1636421238890, 276, 0, 276, 0, 0, 0
2821, 1, 1636421238650, 1636421238914, 264, 0, 264, 0, 0, 0
2823, 1, 1636421238678, 1636421238950, 272, 0, 272, 0, 0, 0
2824, 1, 1636421238678, 1636421238951, 273, 0, 273, 0, 0, 0
2822, 1, 1636421238678, 1636421238951, 273, 0, 273, 0, 0, 0
2786, 2, 1636421229042, 1636421239042, 10000, 0, 10000, 0, 0, 0
2810, 1, 1636421237326, 1636421239310, 1984, 1716, 268, 0, 1716, 1716
2825, 1, 1636421239086, 1636421239362, 276, 0, 276, 0, 0, 0
2826, 1, 1636421239218, 1636421239494, 276, 1, 275, 0, 0, 0
2827, 1, 1636421239290, 1636421239562, 272, 0, 272, 0, 0, 0
2828, 1, 1636421239318, 1636421239590, 272, 0, 272, 0, 0, 0
2831, 1, 1636421239346, 1636421239618, 272, 1, 271, 1, 0, 1
2829, 1, 1636421239346, 1636421239618, 272, 1, 271, 1, 0, 1
2830, 1, 1636421239346, 1636421239626, 280, 16, 264, 16, 0, 16
2832, 1, 1636421239358, 1636421239886, 528, 261, 267, 261, 0, 261
2834, 1, 1636421239758, 1636421240158, 400, 129, 271, 129, 0, 129
2835, 1, 1636421239890, 1636421240166, 276, 0, 276, 0, 0, 0
2836, 1, 1636421239962, 1636421240234, 272, 0, 272, 0, 0, 0
2837, 1, 1636421239986, 1636421240254, 268, 0, 268, 0, 0, 0
2838, 1, 1636421240014, 1636421240286, 272, 0, 272, 0, 0, 0
2839, 1, 1636421240022, 1636421240430, 408, 137, 271, 136, 1, 137
2840, 1, 1636421240026, 1636421240526, 500, 229, 271, 229, 0, 229
2841, 1, 1636421240282, 1636421240550, 268, 0, 268, 0, 0, 0
2843, 1, 1636421240558, 1636421240834, 276, 0, 276, 0, 0, 0
2842, 1, 1636421240562, 1636421240834, 272, 0, 272, 0, 0, 0
2844, 1, 1636421240630, 1636421240902, 272, 0, 272, 0, 0, 0
2845, 1, 1636421240658, 1636421240930, 272, 0, 272, 0, 0, 0
2847, 1, 1636421240834, 1636421241102, 268, 1, 267, 0, 1, 1
2848, 1, 1636421240922, 1636421241194, 272, 0, 272, 0, 0, 0
2849, 1, 1636421240950, 1636421241222, 272, 0, 272, 0, 0, 0
2850, 1, 1636421241230, 1636421241502, 272, 1, 271, 0, 0, 0
2852, 1, 1636421241298, 1636421241574, 276, 0, 276, 0, 0, 0
2853, 1, 1636421241326, 1636421241598, 272, 0, 272, 0, 0, 0
2856, 1, 1636421241622, 1636421241890, 268, 0, 268, 0, 0, 0
2857, 1, 1636421241898, 1636421242170, 272, 0, 272, 0, 0, 0
2859, 1, 1636421241994, 1636421242266, 272, 1, 271, 0, 1, 1
2860, 1, 1636421242286, 1636421242558, 272, 0, 272, 0, 0, 0
2862, 1, 1636421242662, 1636421242934, 272, 0, 272, 0, 0, 0
2863, 1, 1636421242954, 1636421243222, 268, 0, 268, 0, 0, 0
2865, 1, 1636421243618, 1636421243890, 272, 0, 272, 0, 0, 0
2790, 2, 1636421235994, 1636421245994, 10000, 0, 10000, 271, 0, 271
2796, 2, 1636421236006, 1636421246042, 10036, 0, 10036, 257, 0, 257
2795, 2, 1636421236006, 1636421246086, 10080, 0, 10080, 258, 0, 258
2798, 2, 1636421236006, 1636421246131, 10125, 0, 10125, 258, 0, 258
2800, 2, 1636421236006, 1636421246174, 10168, 0, 10168, 257, 0, 257
2789, 2, 1636421236002, 1636421246218, 10216, 0, 10216, 263, 0, 263
2792, 2, 1636421236006, 1636421246262, 10256, 0, 10256, 259, 0, 259
2797, 2, 1636421236006, 1636421246306, 10300, 0, 10300, 257, 0, 257
2799, 2, 1636421236007, 1636421246350, 10343, 0, 10343, 256, 0, 256
2794, 2, 1636421236006, 1636421246394, 10388, 0, 10388, 258, 0, 258
2801, 2, 1636421236378, 1636421246438, 10060, 0, 10060, 0, 0, 0
2855, 1, 1636421241590, 1636421246714, 5124, 4849, 275, 0, 4849, 4849
2867, 1, 1636421246702, 1636421246974, 272, 1, 271, 0, 0, 0
2868, 1, 1636421246702, 1636421246974, 272, 1, 271, 0, 1, 1
2873, 1, 1636421246714, 1636421247246, 532, 262, 270, 262, 0, 262
2875, 1, 1636421246706, 1636421247246, 540, 269, 271, 269, 0, 269
2880, 1, 1636421247374, 1636421247646, 272, 1, 271, 1, 0, 1
2879, 1, 1636421247374, 1636421247646, 272, 1, 271, 0, 1, 1
2881, 1, 1636421247642, 1636421247918, 276, 5, 271, 5, 0, 5
2882, 1, 1636421247642, 1636421247918, 276, 5, 271, 5, 0, 5
2884, 1, 1636421248042, 1636421248310, 268, 1, 267, 0, 0, 0
2885, 1, 1636421248318, 1636421248594, 276, 0, 276, 0, 0, 0
2887, 1, 1636421248706, 1636421248978, 272, 0, 272, 0, 0, 0
2888, 1, 1636421248990, 1636421249266, 276, 0, 276, 0, 0, 0
2889, 1, 1636421249374, 1636421249650, 276, 0, 276, 0, 0, 0
2833, 2, 1636421239710, 1636421249710, 10000, 0, 10000, 0, 0, 0
2890, 1, 1636421249666, 1636421249938, 272, 0, 272, 0, 0, 0
2891, 1, 1636421250010, 1636421250282, 272, 1, 271, 0, 0, 0
2892, 1, 1636421250046, 1636421250550, 504, 237, 267, 237, 0, 237
2846, 2, 1636421240686, 1636421250686, 10000, 0, 10000, 0, 0, 0
2893, 1, 1636421250334, 1636421250822, 488, 217, 271, 217, 0, 217
2894, 1, 1636421250678, 1636421250953, 275, 0, 275, 0, 0, 0
2895, 1, 1636421250946, 1636421251218, 272, 0, 272, 0, 0, 0
2851, 2, 1636421241230, 1636421251230, 10000, 0, 10000, 0, 0, 0
2896, 1, 1636421250994, 1636421251278, 284, 0, 284, 0, 0, 0
2897, 1, 1636421251218, 1636421251486, 268, 1, 267, 1, 0, 1
2854, 2, 1636421241498, 1636421251498, 10000, 0, 10000, 0, 0, 0
2898, 1, 1636421251350, 1636421251634, 284, 1, 283, 0, 0, 0
2899, 1, 1636421251542, 1636421251814, 272, 0, 272, 0, 0, 0
2900, 1, 1636421251618, 1636421251886, 268, 0, 268, 0, 0, 0
2858, 2, 1636421241970, 1636421251970, 10000, 0, 10000, 0, 0, 0
2902, 1, 1636421251806, 1636421252106, 300, 9, 291, 9, 0, 9
2903, 1, 1636421251882, 1636421252198, 316, 5, 311, 5, 0, 5
2904, 1, 1636421252058, 1636421252330, 272, 0, 272, 0, 0, 0
2906, 1, 1636421252278, 1636421252550, 272, 0, 272, 0, 0, 0
2861, 2, 1636421242566, 1636421252566, 10000, 0, 10000, 0, 0, 0
2910, 1, 1636421252742, 1636421253014, 272, 0, 272, 0, 0, 0
2911, 1, 1636421252870, 1636421253142, 272, 0, 272, 0, 0, 0
2864, 2, 1636421243330, 1636421253330, 10000, 0, 10000, 0, 0, 0
2913, 1, 1636421253418, 1636421253690, 272, 1, 271, 0, 0, 0
2915, 1, 1636421253638, 1636421253914, 276, 0, 276, 0, 0, 0
2866, 2, 1636421244286, 1636421254286, 10000, 0, 10000, 0, 0, 0
2916, 1, 1636421254086, 1636421254358, 272, 1, 271, 0, 0, 0
2918, 1, 1636421254598, 1636421254870, 272, 0, 272, 0, 0, 0
2919, 1, 1636421254754, 1636421255026, 272, 0, 272, 0, 0, 0
2921, 1, 1636421255422, 1636421255698, 276, 0, 276, 0, 0, 0
2870, 2, 1636421246702, 1636421256702, 10000, 0, 10000, 544, 0, 544
2872, 2, 1636421246714, 1636421256746, 10032, 0, 10032, 533, 0, 533
2877, 2, 1636421246714, 1636421256790, 10076, 0, 10076, 0, 0, 0
2871, 2, 1636421246714, 1636421256834, 10120, 0, 10120, 533, 0, 533
2874, 2, 1636421246710, 1636421256878, 10168, 0, 10168, 0, 0, 0
2876, 2, 1636421246710, 1636421256926, 10216, 0, 10216, 0, 0, 0
2869, 2, 1636421246710, 1636421256970, 10260, 0, 10260, 537, 0, 537
2878, 2, 1636421247106, 1636421257335, 10229, 142, 10087, 141, 0, 141
2923, 1, 1636421257230, 1636421257518, 288, 0, 288, 0, 0, 0
2909, 1, 1636421252614, 1636421257610, 4996, 4721, 275, 4721, 0, 4721
2926, 1, 1636421257273, 1636421257610, 337, 1, 336, 0, 0, 0
2907, 1, 1636421252290, 1636421257890, 5600, 5321, 279, 5321, 0, 5321
2929, 1, 1636421257602, 1636421257894, 292, 9, 283, 9, 0, 9
2883, 2, 1636421248042, 1636421258042, 10000, 0, 10000, 0, 0, 0
2928, 1, 1636421257602, 1636421258178, 576, 293, 283, 293, 0, 293
2933, 1, 1636421258010, 1636421258282, 272, 0, 272, 0, 0, 0
2886, 2, 1636421248322, 1636421258318, 9996, 0, 9996, 0, 0, 0
2927, 1, 1636421257602, 1636421258454, 852, 577, 275, 576, 0, 576
2935, 1, 1636421258294, 1636421258558, 264, 0, 264, 0, 0, 0
2936, 1, 1636421258362, 1636421258630, 268, 0, 268, 0, 0, 0
2937, 1, 1636421258582, 1636421258858, 276, 0, 276, 0, 0, 0
2938, 1, 1636421258622, 1636421258898, 276, 8, 268, 8, 0, 8
2939, 1, 1636421258678, 1636421258942, 264, 0, 264, 0, 0, 0
2940, 1, 1636421258850, 1636421259122, 272, 9, 263, 9, 0, 9
2941, 1, 1636421258954, 1636421259218, 264, 0, 264, 0, 0, 0
2943, 1, 1636421259254, 1636421259522, 268, 0, 268, 0, 0, 0
2945, 1, 1636421259334, 1636421259602, 268, 0, 268, 0, 0, 0
2946, 1, 1636421259518, 1636421259786, 268, 5, 263, 5, 0, 5
2947, 1, 1636421259618, 1636421259882, 264, 0, 264, 0, 0, 0
2948, 1, 1636421259922, 1636421260194, 272, 1, 271, 0, 0, 0
2949, 1, 1636421259994, 1636421260266, 272, 1, 271, 0, 0, 0
2950, 1, 1636421260182, 1636421260466, 284, 12, 272, 12, 0, 12
2951, 1, 1636421260282, 1636421260554, 272, 0, 272, 0, 0, 0
2952, 1, 1636421260590, 1636421260862, 272, 1, 271, 0, 0, 0
2953, 1, 1636421260658, 1636421260930, 272, 0, 272, 0, 0, 0
2954, 1, 1636421260862, 1636421261130, 268, 0, 268, 0, 0, 0
2955, 1, 1636421260950, 1636421261222, 272, 0, 272, 0, 0, 0
2956, 1, 1636421261258, 1636421261530, 272, 1, 271, 0, 0, 0
2957, 1, 1636421261326, 1636421261602, 276, 0, 276, 0, 0, 0
2901, 2, 1636421251678, 1636421261678, 10000, 0, 10000, 0, 0, 0
2958, 1, 1636421261526, 1636421261814, 288, 5, 283, 5, 0, 5
2959, 1, 1636421261618, 1636421261906, 288, 0, 288, 0, 0, 0
2960, 1, 1636421261926, 1636421262202, 276, 0, 276, 0, 0, 0
2905, 2, 1636421252210, 1636421262210, 10000, 0, 10000, 0, 0, 0
2962, 1, 1636421261994, 1636421262257, 263, 0, 263, 0, 0, 0
2961, 1, 1636421261986, 1636421262258, 272, 1, 271, 0, 0, 0
2963, 1, 1636421262210, 1636421262482, 272, 1, 271, 0, 1, 1
2908, 2, 1636421252502, 1636421262502, 10000, 0, 10000, 0, 0, 0
2964, 1, 1636421262301, 1636421262570, 269, 1, 268, 0, 1, 1
2965, 1, 1636421262546, 1636421262818, 272, 0, 272, 0, 0, 0
2966, 1, 1636421262602, 1636421262874, 272, 1, 271, 0, 0, 0
2912, 2, 1636421252946, 1636421262946, 10000, 0, 10000, 0, 0, 0
2968, 1, 1636421262682, 1636421262994, 312, 0, 312, 0, 0, 0
2969, 1, 1636421262810, 1636421263082, 272, 8, 264, 8, 0, 8
2970, 1, 1636421262886, 1636421263174, 288, 0, 288, 0, 0, 0
2972, 1, 1636421263214, 1636421263482, 268, 0, 268, 0, 0, 0
2973, 1, 1636421263258, 1636421263526, 268, 0, 268, 0, 0, 0
2914, 2, 1636421253538, 1636421263538, 10000, 0, 10000, 0, 0, 0
2975, 1, 1636421263390, 1636421263678, 288, 0, 288, 0, 0, 0
2976, 1, 1636421263478, 1636421263762, 284, 5, 279, 4, 0, 4
2978, 1, 1636421263842, 1636421264114, 272, 1, 271, 0, 0, 0
2979, 1, 1636421263878, 1636421264146, 268, 0, 268, 0, 0, 0
2980, 1, 1636421263922, 1636421264190, 268, 0, 268, 0, 0, 0
2917, 2, 1636421254334, 1636421264334, 10000, 0, 10000, 0, 0, 0
2981, 1, 1636421264074, 1636421264382, 308, 0, 308, 0, 0, 0
2982, 1, 1636421264158, 1636421264470, 312, 0, 312, 0, 0, 0
2983, 1, 1636421264514, 1636421264782, 268, 0, 268, 0, 0, 0
2984, 1, 1636421264542, 1636421264814, 272, 0, 272, 0, 0, 0
2985, 1, 1636421264586, 1636421264858, 272, 0, 272, 0, 0, 0
2986, 1, 1636421264642, 1636421264914, 272, 0, 272, 0, 0, 0
2987, 1, 1636421264782, 1636421265058, 276, 0, 276, 0, 0, 0
2988, 1, 1636421264878, 1636421265150, 272, 0, 272, 0, 0, 0
2920, 2, 1636421255270, 1636421265270, 10000, 0, 10000, 0, 0, 0
2989, 1, 1636421265178, 1636421265450, 272, 0, 272, 0, 0, 0
2990, 1, 1636421265210, 1636421265494, 284, 0, 284, 0, 0, 0
2991, 1, 1636421265258, 1636421265530, 272, 0, 272, 0, 0, 0
2922, 1, 1636421256094, 1636421265542, 9448, 9176, 272, 0, 9176, 9176
2992, 1, 1636421265314, 1636421265590, 276, 0, 276, 0, 0, 0
2993, 1, 1636421265454, 1636421265722, 268, 0, 268, 0, 0, 0
2994, 1, 1636421265554, 1636421265822, 268, 0, 268, 0, 0, 0
2995, 1, 1636421265578, 1636421265846, 268, 0, 268, 0, 0, 0
2996, 1, 1636421265850, 1636421266122, 272, 0, 272, 0, 0, 0
2997, 1, 1636421265890, 1636421266162, 272, 0, 272, 0, 0, 0
2998, 1, 1636421265926, 1636421266198, 272, 0, 272, 0, 0, 0
2999, 1, 1636421265946, 1636421266218, 272, 0, 272, 0, 0, 0
3000, 1, 1636421265986, 1636421266254, 268, 0, 268, 0, 0, 0
3001, 1, 1636421266118, 1636421266386, 268, 0, 268, 0, 0, 0
3002, 1, 1636421266222, 1636421266498, 276, 0, 276, 0, 0, 0
3003, 1, 1636421266242, 1636421266514, 272, 0, 272, 0, 0, 0
3004, 1, 1636421266514, 1636421266790, 276, 0, 276, 0, 0, 0
3005, 1, 1636421266558, 1636421266830, 272, 0, 272, 0, 0, 0
3006, 1, 1636421266594, 1636421266862, 268, 0, 268, 0, 0, 0
3007, 1, 1636421266622, 1636421266890, 268, 0, 268, 0, 0, 0
3008, 1, 1636421266654, 1636421266922, 268, 0, 268, 0, 0, 0
3009, 1, 1636421266782, 1636421267050, 268, 0, 268, 0, 0, 0
3010, 1, 1636421266898, 1636421267170, 272, 0, 272, 0, 0, 0
3011, 1, 1636421266910, 1636421267182, 272, 0, 272, 0, 0, 0
2924, 2, 1636421257234, 1636421267234, 10000, 0, 10000, 285, 0, 285
2925, 2, 1636421257238, 1636421267278, 10040, 0, 10040, 281, 0, 281
3012, 1, 1636421267182, 1636421267506, 324, 0, 324, 0, 0, 0
3013, 1, 1636421267226, 1636421267506, 280, 0, 280, 0, 0, 0
3016, 1, 1636421267322, 1636421267594, 272, 1, 271, 1, 0, 1
3014, 1, 1636421267322, 1636421267594, 272, 1, 271, 1, 0, 1
3015, 1, 1636421267322, 1636421267594, 272, 1, 271, 0, 0, 0
2930, 2, 1636421257638, 1636421267638, 10000, 0, 10000, 0, 0, 0
3018, 1, 1636421267570, 1636421267862, 292, 1, 291, 0, 0, 0
3019, 1, 1636421267582, 1636421267862, 280, 0, 280, 0, 0, 0
2931, 2, 1636421257914, 1636421267914, 10000, 0, 10000, 0, 0, 0
2932, 2, 1636421258006, 1636421268006, 10000, 0, 10000, 0, 0, 0
3023, 1, 1636421267906, 1636421268174, 268, 0, 268, 0, 0, 0
2934, 2, 1636421258286, 1636421268286, 10000, 0, 10000, 0, 0, 0
3026, 1, 1636421268054, 1636421268334, 280, 0, 280, 0, 0, 0
3027, 1, 1636421268054, 1636421268334, 280, 0, 280, 0, 0, 0
3025, 1, 1636421268054, 1636421268334, 280, 1, 279, 0, 0, 0
3028, 1, 1636421268218, 1636421268514, 296, 0, 296, 0, 0, 0
3030, 1, 1636421268262, 1636421268534, 272, 0, 272, 0, 0, 0
3032, 1, 1636421268566, 1636421268838, 272, 0, 272, 0, 0, 0
3036, 1, 1636421268734, 1636421269006, 272, 0, 272, 0, 0, 0
3034, 1, 1636421268738, 1636421269014, 276, 1, 275, 0, 1, 1
2942, 2, 1636421259026, 1636421269026, 10000, 0, 10000, 0, 0, 0
3038, 1, 1636421268934, 1636421269202, 268, 0, 268, 0, 0, 0
2944, 2, 1636421259298, 1636421269298, 10000, 0, 10000, 0, 0, 0
3040, 1, 1636421269342, 1636421269614, 272, 0, 272, 0, 0, 0
3041, 1, 1636421269402, 1636421269674, 272, 0, 272, 0, 0, 0
3042, 1, 1636421269414, 1636421269686, 272, 1, 271, 0, 0, 0
3043, 1, 1636421269602, 1636421269874, 272, 0, 272, 0, 0, 0
3044, 1, 1636421269606, 1636421269886, 280, 9, 271, 9, 0, 9
3045, 1, 1636421270014, 1636421270286, 272, 1, 271, 0, 1, 1
3047, 1, 1636421270090, 1636421270362, 272, 1, 271, 0, 0, 0
3048, 1, 1636421270278, 1636421270546, 268, 0, 268, 0, 0, 0
3049, 1, 1636421270286, 1636421270550, 264, 1, 263, 1, 0, 1
3050, 1, 1636421270682, 1636421270950, 268, 1, 267, 0, 0, 0
3051, 1, 1636421270762, 1636421271038, 276, 1, 275, 0, 0, 0
3053, 1, 1636421270950, 1636421271222, 272, 1, 271, 1, 0, 1
3054, 1, 1636421271354, 1636421271630, 276, 0, 276, 0, 0, 0
3055, 1, 1636421271434, 1636421271706, 272, 1, 271, 0, 0, 0
3056, 1, 1636421271618, 1636421271898, 280, 13, 267, 13, 0, 13
3057, 1, 1636421272030, 1636421272302, 272, 1, 271, 0, 0, 0
3058, 1, 1636421272102, 1636421272374, 272, 1, 271, 0, 0, 0
3059, 1, 1636421272294, 1636421272570, 276, 9, 267, 9, 0, 9
2967, 2, 1636421262678, 1636421272678, 10000, 0, 10000, 0, 0, 0
2971, 2, 1636421262994, 1636421272994, 10000, 0, 10000, 0, 0, 0
3060, 1, 1636421272722, 1636421273038, 316, 0, 316, 0, 0, 0
2974, 2, 1636421263270, 1636421273270, 10000, 0, 10000, 0, 0, 0
3062, 1, 1636421272974, 1636421273318, 344, 64, 280, 64, 0, 64
2977, 2, 1636421263586, 1636421273586, 10000, 0, 10000, 0, 0, 0
3065, 1, 1636421273446, 1636421273722, 276, 0, 276, 0, 0, 0
3037, 1, 1636421268922, 1636421273858, 4936, 4665, 271, 0, 4665, 4665
3067, 1, 1636421273762, 1636421274038, 276, 1, 275, 0, 0, 0
3069, 1, 1636421274118, 1636421274390, 272, 1, 271, 0, 0, 0
3070, 1, 1636421274254, 1636421274526, 272, 0, 272, 0, 0, 0
3071, 1, 1636421274434, 1636421274706, 272, 0, 272, 0, 0, 0
3072, 1, 1636421274786, 1636421275058, 272, 1, 271, 0, 0, 0
3073, 1, 1636421274922, 1636421275190, 268, 0, 268, 0, 0, 0
3074, 1, 1636421275110, 1636421275382, 272, 0, 272, 0, 0, 0
3075, 1, 1636421275454, 1636421275730, 276, 1, 275, 0, 0, 0
3076, 1, 1636421275586, 1636421275858, 272, 1, 271, 0, 1, 1
3077, 1, 1636421275782, 1636421276058, 276, 1, 275, 0, 0, 0
3078, 1, 1636421276130, 1636421276402, 272, 1, 271, 0, 0, 0
3079, 1, 1636421276254, 1636421276526, 272, 0, 272, 0, 0, 0
3080, 1, 1636421276454, 1636421276730, 276, 1, 275, 0, 0, 0
3081, 1, 1636421276798, 1636421277066, 268, 1, 267, 0, 0, 0
3082, 1, 1636421276922, 1636421277194, 272, 1, 271, 0, 0, 0
3083, 1, 1636421277130, 1636421277398, 268, 0, 268, 0, 0, 0
3017, 2, 1636421267454, 1636421277454, 10000, 0, 10000, 0, 0, 0
3084, 1, 1636421277502, 1636421277774, 272, 0, 272, 0, 0, 0
3021, 2, 1636421267830, 1636421277830, 10000, 0, 10000, 0, 0, 0
3020, 2, 1636421267830, 1636421277874, 10044, 0, 10044, 0, 0, 0
3022, 2, 1636421267906, 1636421277918, 10012, 0, 10012, 0, 0, 0
3024, 2, 1636421267962, 1636421277966, 10004, 0, 10004, 0, 0, 0
3085, 1, 1636421277630, 1636421278194, 564, 145, 419, 145, 0, 145
3029, 2, 1636421268258, 1636421278258, 10000, 0, 10000, 0, 0, 0
3031, 2, 1636421268334, 1636421278334, 10000, 0, 10000, 0, 0, 0
3088, 1, 1636421278170, 1636421278486, 316, 1, 315, 0, 0, 0
3087, 1, 1636421277798, 1636421278490, 692, 396, 296, 396, 0, 396
3089, 1, 1636421278182, 1636421278490, 308, 0, 308, 0, 0, 0
3033, 2, 1636421268598, 1636421278598, 10000, 0, 10000, 0, 0, 0
3035, 2, 1636421268738, 1636421278738, 10000, 0, 10000, 0, 0, 0
3093, 1, 1636421278594, 1636421278874, 280, 0, 280, 0, 0, 0
3099, 1, 1636421278914, 1636421279190, 276, 0, 276, 0, 0, 0
3097, 1, 1636421278918, 1636421279190, 272, 0, 272, 0, 0, 0
3098, 1, 1636421278914, 1636421279190, 276, 0, 276, 0, 0, 0
3039, 2, 1636421269230, 1636421279230, 10000, 0, 10000, 0, 0, 0
3101, 1, 1636421279278, 1636421279550, 272, 0, 272, 0, 0, 0
3105, 1, 1636421279590, 1636421279862, 272, 1, 271, 1, 0, 1
3103, 1, 1636421279590, 1636421279862, 272, 1, 271, 1, 0, 1
3104, 1, 1636421279590, 1636421279862, 272, 1, 271, 1, 0, 1
3046, 2, 1636421270070, 1636421280070, 10000, 0, 10000, 0, 0, 0
3106, 1, 1636421279946, 1636421280214, 268, 0, 268, 0, 0, 0
3108, 1, 1636421280254, 1636421280526, 272, 1, 271, 0, 0, 0
3107, 1, 1636421280258, 1636421280530, 272, 0, 272, 0, 0, 0
3109, 1, 1636421280258, 1636421280530, 272, 0, 272, 0, 0, 0
3111, 1, 1636421280610, 1636421280885, 275, 1, 274, 0, 0, 0
3052, 2, 1636421270942, 1636421280942, 10000, 0, 10000, 0, 0, 0
3113, 1, 1636421280926, 1636421281198, 272, 0, 272, 0, 0, 0
3114, 1, 1636421280926, 1636421281198, 272, 0, 272, 0, 0, 0
3116, 1, 1636421281282, 1636421281554, 272, 1, 271, 0, 0, 0
3118, 1, 1636421281595, 1636421281866, 271, 0, 271, 0, 0, 0
3119, 1, 1636421281950, 1636421282222, 272, 1, 271, 0, 1, 1
3061, 2, 1636421272770, 1636421282770, 10000, 0, 10000, 0, 0, 0
3121, 1, 1636421282618, 1636421282906, 288, 0, 288, 0, 0, 0
3063, 2, 1636421272982, 1636421282982, 10000, 0, 10000, 0, 0, 0
3064, 2, 1636421273318, 1636421283318, 10000, 0, 10000, 0, 0, 0
3124, 1, 1636421283302, 1636421283574, 272, 0, 272, 0, 0, 0
3066, 2, 1636421273578, 1636421283578, 10000, 0, 10000, 0, 0, 0
3068, 2, 1636421273894, 1636421283894, 10000, 0, 10000, 0, 0, 0
3127, 1, 1636421283982, 1636421284258, 276, 0, 276, 0, 0, 0
3129, 1, 1636421284654, 1636421284926, 272, 1, 271, 0, 0, 0
3130, 1, 1636421285322, 1636421285591, 269, 0, 269, 0, 0, 0
3131, 1, 1636421285990, 1636421286262, 272, 1, 271, 0, 1, 1
3086, 2, 1636421277770, 1636421287771, 10001, 0, 10001, 0, 0, 0
3090, 2, 1636421278190, 1636421288190, 10000, 0, 10000, 301, 0, 301
3091, 2, 1636421278234, 1636421288234, 10000, 0, 10000, 0, 0, 0
3092, 2, 1636421278306, 1636421288306, 10000, 0, 10000, 185, 0, 185
3133, 1, 1636421288078, 1636421288370, 292, 1, 291, 0, 0, 0
3094, 2, 1636421278642, 1636421288642, 10000, 0, 10000, 0, 0, 0
3095, 2, 1636421278646, 1636421288690, 10044, 0, 10044, 0, 0, 0
3096, 2, 1636421278914, 1636421288914, 10000, 0, 10000, 0, 0, 0
3134, 1, 1636421288570, 1636421288962, 392, 0, 392, 0, 0, 0
3100, 2, 1636421279046, 1636421289046, 10000, 0, 10000, 0, 0, 0
3135, 1, 1636421288782, 1636421289094, 312, 0, 312, 0, 0, 0
3136, 1, 1636421288818, 1636421289094, 276, 1, 275, 0, 0, 0
3139, 1, 1636421288962, 1636421289270, 308, 1, 307, 1, 0, 1
3102, 2, 1636421279542, 1636421289542, 10000, 0, 10000, 0, 0, 0
3142, 1, 1636421289358, 1636421289626, 268, 0, 268, 0, 0, 0
3141, 1, 1636421289354, 1636421289626, 272, 0, 272, 0, 0, 0
3143, 1, 1636421289486, 1636421289766, 280, 0, 280, 0, 0, 0
3144, 1, 1636421289490, 1636421289766, 276, 0, 276, 0, 0, 0
3145, 1, 1636421289666, 1636421289938, 272, 0, 272, 0, 0, 0
3146, 1, 1636421289846, 1636421290122, 276, 1, 275, 0, 0, 0
3148, 1, 1636421290026, 1636421290298, 272, 1, 271, 1, 0, 1
3147, 1, 1636421290026, 1636421290302, 276, 1, 275, 0, 1, 1
3110, 2, 1636421280378, 1636421290378, 10000, 0, 10000, 0, 0, 0
3150, 1, 1636421290162, 1636421290434, 272, 0, 272, 0, 0, 0
3149, 1, 1636421290162, 1636421290434, 272, 0, 272, 0, 0, 0
3151, 1, 1636421290334, 1636421290606, 272, 0, 272, 0, 0, 0
3152, 1, 1636421290554, 1636421290826, 272, 0, 272, 0, 0, 0
3112, 2, 1636421280922, 1636421290922, 10000, 0, 10000, 0, 0, 0
3153, 1, 1636421290686, 1636421290970, 284, 0, 284, 0, 0, 0
3154, 1, 1636421290698, 1636421290974, 276, 1, 275, 0, 0, 0
3155, 1, 1636421290698, 1636421290974, 276, 1, 275, 0, 0, 0
3157, 1, 1636421290830, 1636421291106, 276, 0, 276, 0, 0, 0
3115, 2, 1636421281250, 1636421291250, 10000, 0, 10000, 0, 0, 0
3158, 1, 1636421291010, 1636421291298, 288, 0, 288, 0, 0, 0
3159, 1, 1636421291230, 1636421291502, 272, 1, 271, 0, 0, 0
3160, 1, 1636421291230, 1636421291506, 276, 0, 276, 0, 0, 0
3117, 2, 1636421281594, 1636421291594, 10000, 0, 10000, 0, 0, 0
3161, 1, 1636421291370, 1636421291642, 272, 0, 272, 0, 0, 0
3163, 1, 1636421291374, 1636421291646, 272, 0, 272, 0, 0, 0
3162, 1, 1636421291374, 1636421291650, 276, 0, 276, 0, 0, 0
3164, 1, 1636421291502, 1636421291778, 276, 1, 275, 0, 1, 1
3165, 1, 1636421291558, 1636421291830, 272, 0, 272, 0, 0, 0
3166, 1, 1636421291702, 1636421291974, 272, 0, 272, 0, 0, 0
3167, 1, 1636421291898, 1636421292170, 272, 0, 272, 0, 0, 0
3169, 1, 1636421291902, 1636421292174, 272, 0, 272, 0, 0, 0
3120, 2, 1636421282262, 1636421292262, 10000, 0, 10000, 0, 0, 0
3170, 1, 1636421292042, 1636421292310, 268, 0, 268, 0, 0, 0
3171, 1, 1636421292042, 1636421292310, 268, 0, 268, 0, 0, 0
3172, 1, 1636421292050, 1636421292318, 268, 0, 268, 0, 0, 0
3173, 1, 1636421292178, 1636421292486, 308, 0, 308, 0, 0, 0
3174, 1, 1636421292234, 1636421292498, 264, 0, 264, 0, 0, 0
3175, 1, 1636421292370, 1636421292638, 268, 0, 268, 0, 0, 0
3177, 1, 1636421292566, 1636421292842, 276, 0, 276, 0, 0, 0
3178, 1, 1636421292574, 1636421292846, 272, 0, 272, 0, 0, 0
3180, 1, 1636421292706, 1636421292978, 272, 0, 272, 0, 0, 0
3179, 1, 1636421292706, 1636421292978, 272, 0, 272, 0, 0, 0
3181, 1, 1636421292714, 1636421292982, 268, 0, 268, 0, 0, 0
3122, 2, 1636421283074, 1636421293074, 10000, 0, 10000, 0, 0, 0
3182, 1, 1636421292882, 1636421293150, 268, 0, 268, 0, 0, 0
3183, 1, 1636421292898, 1636421293210, 312, 0, 312, 0, 0, 0
3123, 2, 1636421283290, 1636421293290, 10000, 0, 10000, 0, 0, 0
3184, 1, 1636421293034, 1636421293338, 304, 0, 304, 0, 0, 0
3185, 1, 1636421293250, 1636421293518, 268, 0, 268, 0, 0, 0
3186, 1, 1636421293250, 1636421293522, 272, 1, 271, 0, 0, 0
3125, 2, 1636421283626, 1636421293626, 10000, 0, 10000, 0, 0, 0
3187, 1, 1636421293382, 1636421293674, 292, 1, 291, 0, 0, 0
3190, 1, 1636421293382, 1636421293674, 292, 0, 292, 0, 0, 0
3188, 1, 1636421293382, 1636421293674, 292, 1, 291, 0, 1, 1
3189, 1, 1636421293382, 1636421293674, 292, 1, 291, 0, 0, 0
3191, 1, 1636421293546, 1636421293854, 308, 0, 308, 0, 0, 0
3126, 2, 1636421283886, 1636421293886, 10000, 0, 10000, 0, 0, 0
3193, 1, 1636421293618, 1636421293934, 316, 0, 316, 0, 0, 0
3194, 1, 1636421293738, 1636421294022, 284, 0, 284, 0, 0, 0
3128, 2, 1636421284202, 1636421294202, 10000, 0, 10000, 0, 0, 0
3196, 1, 1636421293934, 1636421294250, 316, 1, 315, 0, 1, 1
3195, 1, 1636421293934, 1636421294250, 316, 1, 315, 0, 1, 1
3200, 1, 1636421294078, 1636421294350, 272, 1, 271, 1, 0, 1
3201, 1, 1636421294078, 1636421294351, 273, 1, 272, 1, 0, 1
3199, 1, 1636421294078, 1636421294351, 273, 1, 272, 1, 0, 1
3198, 1, 1636421294078, 1636421294351, 273, 1, 272, 0, 1, 1
3156, 1, 1636421290830, 1636421294474, 3644, 3372, 272, 0, 3372, 3372
3203, 1, 1636421294294, 1636421294562, 268, 0, 268, 0, 0, 0
3204, 1, 1636421294330, 1636421294602, 272, 0, 272, 0, 0, 0
3205, 1, 1636421294418, 1636421294686, 268, 1, 267, 0, 0, 0
3207, 1, 1636421294642, 1636421294914, 272, 0, 272, 0, 0, 0
3208, 1, 1636421294650, 1636421294918, 268, 0, 268, 0, 0, 0
3209, 1, 1636421294746, 1636421295010, 264, 0, 264, 0, 0, 0
3211, 1, 1636421294750, 1636421295022, 272, 1, 271, 0, 0, 0
3212, 1, 1636421294750, 1636421295022, 272, 1, 271, 0, 1, 1
3210, 1, 1636421294750, 1636421295030, 280, 0, 280, 0, 0, 0
3213, 1, 1636421294870, 1636421295150, 280, 0, 280, 0, 0, 0
3214, 1, 1636421294962, 1636421295234, 272, 0, 272, 0, 0, 0
3215, 1, 1636421295006, 1636421295270, 264, 0, 264, 0, 0, 0
3216, 1, 1636421295082, 1636421295350, 268, 0, 268, 0, 0, 0
3217, 1, 1636421295306, 1636421295574, 268, 0, 268, 0, 0, 0
3218, 1, 1636421295314, 1636421295578, 264, 0, 264, 0, 0, 0
3219, 1, 1636421295410, 1636421295674, 264, 0, 264, 0, 0, 0
3220, 1, 1636421295418, 1636421295694, 276, 0, 276, 0, 0, 0
3222, 1, 1636421295430, 1636421295706, 276, 1, 275, 0, 0, 0
3221, 1, 1636421295430, 1636421295706, 276, 1, 275, 1, 0, 1
3223, 1, 1636421295542, 1636421295810, 268, 1, 267, 0, 0, 0
3224, 1, 1636421295634, 1636421295902, 268, 0, 268, 0, 0, 0
3225, 1, 1636421295670, 1636421295934, 264, 0, 264, 0, 0, 0
3226, 1, 1636421295746, 1636421296014, 268, 0, 268, 0, 0, 0
3228, 1, 1636421295970, 1636421296242, 272, 0, 272, 0, 0, 0
3227, 1, 1636421295970, 1636421296246, 276, 1, 275, 0, 0, 0
3229, 1, 1636421296070, 1636421296334, 264, 1, 263, 0, 0, 0
3230, 1, 1636421296090, 1636421296362, 272, 0, 272, 0, 0, 0
3232, 1, 1636421296106, 1636421296378, 272, 0, 272, 0, 0, 0
3231, 1, 1636421296102, 1636421296378, 276, 0, 276, 0, 0, 0
3233, 1, 1636421296210, 1636421296478, 268, 0, 268, 0, 0, 0
3234, 1, 1636421296302, 1636421296570, 268, 0, 268, 0, 0, 0
3235, 1, 1636421296334, 1636421296602, 268, 0, 268, 0, 0, 0
3132, 2, 1636421286658, 1636421296658, 10000, 0, 10000, 0, 0, 0
3236, 1, 1636421296410, 1636421296706, 296, 0, 296, 0, 0, 0
3237, 1, 1636421296634, 1636421296902, 268, 0, 268, 0, 0, 0
3238, 1, 1636421296642, 1636421296914, 272, 0, 272, 0, 0, 0
3239, 1, 1636421296746, 1636421297014, 268, 0, 268, 0, 0, 0
3240, 1, 1636421296762, 1636421297030, 268, 0, 268, 0, 0, 0
3241, 1, 1636421296774, 1636421297050, 276, 0, 276, 0, 0, 0
3242, 1, 1636421296778, 1636421297050, 272, 0, 272, 0, 0, 0
3243, 1, 1636421296870, 1636421297138, 268, 0, 268, 0, 0, 0
3245, 1, 1636421296966, 1636421297230, 264, 0, 264, 0, 0, 0
3246, 1, 1636421297006, 1636421297286, 280, 0, 280, 0, 0, 0
3247, 1, 1636421297106, 1636421297374, 268, 0, 268, 0, 0, 0
3248, 1, 1636421297298, 1636421297570, 272, 0, 272, 0, 0, 0
3249, 1, 1636421297318, 1636421297590, 272, 0, 272, 0, 0, 0
3250, 1, 1636421297414, 1636421297682, 268, 0, 268, 0, 0, 0
3251, 1, 1636421297430, 1636421297702, 272, 0, 272, 0, 0, 0
3252, 1, 1636421297446, 1636421297718, 272, 1, 271, 0, 1, 1
3253, 1, 1636421297446, 1636421297718, 272, 0, 272, 0, 0, 0
3254, 1, 1636421297534, 1636421297794, 260, 0, 260, 0, 0, 0
3255, 1, 1636421297626, 1636421297890, 264, 0, 264, 0, 0, 0
3256, 1, 1636421297694, 1636421297966, 272, 0, 272, 0, 0, 0
3257, 1, 1636421297770, 1636421298038, 268, 0, 268, 0, 0, 0
3258, 1, 1636421297962, 1636421298238, 276, 0, 276, 0, 0, 0
3259, 1, 1636421297994, 1636421298258, 264, 0, 264, 0, 0, 0
3260, 1, 1636421298078, 1636421298342, 264, 0, 264, 0, 0, 0
3261, 1, 1636421298098, 1636421298370, 272, 0, 272, 0, 0, 0
3262, 1, 1636421298118, 1636421298390, 272, 1, 271, 0, 1, 1
3264, 1, 1636421298186, 1636421298458, 272, 0, 272, 0, 0, 0
3263, 1, 1636421298118, 1636421298526, 408, 141, 267, 141, 0, 141
3265, 1, 1636421298294, 1636421298562, 268, 1, 267, 0, 0, 0
3266, 1, 1636421298370, 1636421298638, 268, 0, 268, 0, 0, 0
3267, 1, 1636421298442, 1636421298714, 272, 0, 272, 0, 0, 0
3137, 2, 1636421288818, 1636421298818, 10000, 0, 10000, 277, 0, 277
3268, 1, 1636421298638, 1636421298958, 320, 0, 320, 0, 0, 0
3269, 1, 1636421298650, 1636421298958, 308, 0, 308, 0, 0, 0
3138, 2, 1636421288962, 1636421298962, 10000, 0, 10000, 133, 0, 133
3271, 1, 1636421298766, 1636421299046, 280, 0, 280, 0, 0, 0
3270, 1, 1636421298742, 1636421299046, 304, 0, 304, 0, 0, 0
3272, 1, 1636421298798, 1636421299098, 300, 0, 300, 0, 0, 0
3273, 1, 1636421298866, 1636421299138, 272, 0, 272, 0, 0, 0
3274, 1, 1636421298926, 1636421299194, 268, 0, 268, 0, 0, 0
3140, 2, 1636421289222, 1636421299222, 10000, 0, 10000, 0, 0, 0
3275, 1, 1636421299005, 1636421299270, 265, 1, 264, 1, 0, 1
3276, 1, 1636421299054, 1636421299358, 304, 0, 304, 0, 0, 0
3277, 1, 1636421299142, 1636421299450, 308, 0, 308, 0, 0, 0
3279, 1, 1636421299358, 1636421299630, 272, 0, 272, 0, 0, 0
3278, 1, 1636421299358, 1636421299630, 272, 0, 272, 0, 0, 0
3282, 1, 1636421299442, 1636421299714, 272, 0, 272, 0, 0, 0
3283, 1, 1636421299442, 1636421299726, 284, 8, 276, 8, 0, 8
3284, 1, 1636421299502, 1636421299774, 272, 0, 272, 0, 0, 0
3286, 1, 1636421299534, 1636421299806, 272, 0, 272, 0, 0, 0
3287, 1, 1636421299594, 1636421299862, 268, 0, 268, 0, 0, 0
3288, 1, 1636421299666, 1636421299938, 272, 0, 272, 0, 0, 0
3289, 1, 1636421299754, 1636421300026, 272, 0, 272, 0, 0, 0
3290, 1, 1636421299854, 1636421300118, 264, 0, 264, 0, 0, 0
3292, 1, 1636421300022, 1636421300298, 276, 1, 275, 0, 1, 1
3291, 1, 1636421300022, 1636421300298, 276, 1, 275, 1, 0, 1
3293, 1, 1636421300110, 1636421300386, 276, 0, 276, 0, 0, 0
3294, 1, 1636421300126, 1636421300394, 268, 0, 268, 0, 0, 0
3295, 1, 1636421300174, 1636421300446, 272, 0, 272, 0, 0, 0
3296, 1, 1636421300202, 1636421300474, 272, 0, 272, 0, 0, 0
3297, 1, 1636421300266, 1636421300538, 272, 0, 272, 0, 0, 0
3298, 1, 1636421300338, 1636421300606, 268, 0, 268, 0, 0, 0
3299, 1, 1636421300426, 1636421300694, 268, 0, 268, 0, 0, 0
3300, 1, 1636421300514, 1636421300782, 268, 0, 268, 0, 0, 0
3302, 1, 1636421300690, 1636421300958, 268, 0, 268, 0, 0, 0
3301, 1, 1636421300690, 1636421300962, 272, 0, 272, 0, 0, 0
3303, 1, 1636421300786, 1636421301054, 268, 0, 268, 0, 0, 0
3304, 1, 1636421300794, 1636421301066, 272, 0, 272, 0, 0, 0
3305, 1, 1636421300846, 1636421301122, 276, 0, 276, 0, 0, 0
3307, 1, 1636421300942, 1636421301214, 272, 0, 272, 0, 0, 0
3308, 1, 1636421301006, 1636421301274, 268, 0, 268, 0, 0, 0
3309, 1, 1636421301094, 1636421301362, 268, 0, 268, 0, 0, 0
3310, 1, 1636421301182, 1636421301450, 268, 0, 268, 0, 0, 0
3311, 1, 1636421301354, 1636421301630, 276, 0, 276, 0, 0, 0
3313, 1, 1636421301458, 1636421301726, 268, 1, 267, 0, 0, 0
3314, 1, 1636421301466, 1636421301738, 272, 0, 272, 0, 0, 0
3315, 1, 1636421301522, 1636421301790, 268, 0, 268, 0, 0, 0
3316, 1, 1636421301610, 1636421301882, 272, 0, 272, 0, 0, 0
3168, 2, 1636421291902, 1636421301902, 10000, 0, 10000, 0, 0, 0
3318, 1, 1636421301766, 1636421302038, 272, 0, 272, 0, 0, 0
3319, 1, 1636421301854, 1636421302134, 280, 0, 280, 0, 0, 0
3320, 1, 1636421302026, 1636421302298, 272, 0, 272, 0, 0, 0
3322, 1, 1636421302138, 1636421302410, 272, 0, 272, 0, 0, 0
3323, 1, 1636421302186, 1636421302458, 272, 0, 272, 0, 0, 0
3325, 1, 1636421302282, 1636421302554, 272, 0, 272, 0, 0, 0
3176, 2, 1636421292562, 1636421302562, 10000, 0, 10000, 0, 0, 0
3324, 1, 1636421302210, 1636421302702, 492, 201, 291, 201, 0, 201
3326, 1, 1636421302438, 1636421302710, 272, 1, 271, 0, 0, 0
3328, 1, 1636421302742, 1636421303018, 276, 0, 276, 0, 0, 0
3330, 1, 1636421302858, 1636421303127, 269, 0, 269, 0, 0, 0
3332, 1, 1636421302950, 1636421303218, 268, 0, 268, 0, 0, 0
3331, 1, 1636421302870, 1636421303286, 416, 148, 268, 148, 0, 148
3333, 1, 1636421303102, 1636421303374, 272, 0, 272, 0, 0, 0
3334, 1, 1636421303106, 1636421303374, 268, 0, 268, 0, 0, 0
3192, 2, 1636421293598, 1636421303598, 10000, 0, 10000, 0, 0, 0
3336, 1, 1636421303522, 1636421303826, 304, 0, 304, 0, 0, 0
3337, 1, 1636421303646, 1636421303922, 276, 0, 276, 0, 0, 0
3197, 2, 1636421293934, 1636421303934, 10000, 0, 10000, 1, 0, 1
3338, 1, 1636421303690, 1636421303978, 288, 0, 288, 0, 0, 0
3340, 1, 1636421303778, 1636421304070, 292, 1, 291, 0, 0, 0
3339, 1, 1636421303774, 1636421304071, 297, 0, 297, 0, 0, 0
3202, 2, 1636421294194, 1636421304194, 10000, 0, 10000, 0, 0, 0
3206, 1, 1636421294510, 1636421304458, 9948, 9684, 264, 0, 9684, 9684
3342, 1, 1636421304238, 1636421304502, 264, 0, 264, 0, 0, 0
3345, 1, 1636421304374, 1636421304638, 264, 1, 263, 0, 0, 0
3346, 1, 1636421304466, 1636421304738, 272, 0, 272, 0, 0, 0
3347, 1, 1636421304466, 1636421304738, 272, 1, 271, 0, 0, 0
3350, 1, 1636421304898, 1636421305170, 272, 0, 272, 0, 0, 0
3351, 1, 1636421305034, 1636421305306, 272, 0, 272, 0, 0, 0
3352, 1, 1636421305134, 1636421305402, 268, 1, 267, 0, 1, 1
3354, 1, 1636421305570, 1636421305838, 268, 1, 267, 0, 0, 0
3355, 1, 1636421305702, 1636421305978, 276, 0, 276, 0, 0, 0
3356, 1, 1636421305802, 1636421306066, 264, 0, 264, 0, 0, 0
3357, 1, 1636421306234, 1636421306506, 272, 1, 271, 0, 1, 1
3358, 1, 1636421306374, 1636421306646, 272, 0, 272, 0, 0, 0
3359, 1, 1636421306466, 1636421306734, 268, 0, 268, 0, 0, 0
3244, 2, 1636421296966, 1636421306962, 9996, 0, 9996, 0, 0, 0
3361, 1, 1636421307050, 1636421307322, 272, 0, 272, 0, 0, 0
3362, 1, 1636421307138, 1636421307406, 268, 1, 267, 0, 0, 0
3363, 1, 1636421307270, 1636421307542, 272, 0, 272, 0, 0, 0
3364, 1, 1636421307718, 1636421307990, 272, 0, 272, 0, 0, 0
3365, 1, 1636421307802, 1636421308074, 272, 1, 271, 0, 0, 0
3366, 1, 1636421307938, 1636421308210, 272, 0, 272, 0, 0, 0
3367, 1, 1636421308386, 1636421308658, 272, 0, 272, 0, 0, 0
3368, 1, 1636421308470, 1636421308742, 272, 0, 272, 0, 0, 0
3369, 1, 1636421308606, 1636421308878, 272, 0, 272, 0, 0, 0
3370, 1, 1636421309054, 1636421309326, 272, 0, 272, 0, 0, 0
3281, 2, 1636421299402, 1636421309402, 10000, 0, 10000, 0, 0, 0
3280, 2, 1636421299402, 1636421309446, 10044, 0, 10044, 0, 0, 0
3371, 1, 1636421309138, 1636421309490, 352, 0, 352, 0, 0, 0
3285, 2, 1636421299530, 1636421309530, 10000, 0, 10000, 0, 0, 0
3372, 1, 1636421309274, 1636421309586, 312, 0, 312, 0, 0, 0
3374, 1, 1636421309710, 1636421309982, 272, 0, 272, 0, 0, 0
3375, 1, 1636421309730, 1636421310002, 272, 0, 272, 0, 0, 0
3377, 1, 1636421309886, 1636421310154, 268, 1, 267, 0, 0, 0
3378, 1, 1636421309982, 1636421310246, 264, 1, 263, 0, 1, 1
3379, 1, 1636421310378, 1636421310654, 276, 0, 276, 0, 0, 0
3380, 1, 1636421310398, 1636421310670, 272, 1, 271, 0, 0, 0
3381, 1, 1636421310550, 1636421310826, 276, 1, 275, 0, 0, 0
3306, 2, 1636421300866, 1636421310866, 10000, 0, 10000, 0, 0, 0
3382, 1, 1636421310642, 1636421310914, 272, 0, 272, 0, 0, 0
3383, 1, 1636421311054, 1636421311326, 272, 0, 272, 0, 0, 0
3384, 1, 1636421311074, 1636421311346, 272, 0, 272, 0, 0, 0
3312, 2, 1636421301358, 1636421311358, 10000, 0, 10000, 0, 0, 0
3385, 1, 1636421311166, 1636421311434, 268, 0, 268, 0, 0, 0
3387, 1, 1636421311310, 1636421311582, 272, 0, 272, 0, 0, 0
3317, 2, 1636421301674, 1636421311674, 10000, 0, 10000, 0, 0, 0
3389, 1, 1636421311722, 1636421311994, 272, 0, 272, 0, 0, 0
3321, 2, 1636421302122, 1636421312122, 10000, 0, 10000, 0, 0, 0
3391, 1, 1636421311850, 1636421312166, 316, 0, 316, 0, 0, 0
3393, 1, 1636421311982, 1636421312258, 276, 0, 276, 0, 0, 0
3392, 1, 1636421311978, 1636421312258, 280, 1, 279, 0, 0, 0
3327, 2, 1636421302530, 1636421312530, 10000, 0, 10000, 0, 0, 0
3395, 1, 1636421312430, 1636421312702, 272, 0, 272, 0, 0, 0
3329, 2, 1636421302806, 1636421312806, 10000, 0, 10000, 0, 0, 0
3396, 1, 1636421312574, 1636421312854, 280, 0, 280, 0, 0, 0
3397, 1, 1636421312654, 1636421312942, 288, 1, 287, 0, 0, 0
3399, 1, 1636421312850, 1636421313118, 268, 0, 268, 0, 0, 0
3401, 1, 1636421313118, 1636421313390, 272, 1, 271, 1, 0, 1
3335, 2, 1636421303414, 1636421313414, 10000, 0, 10000, 0, 0, 0
3402, 1, 1636421313250, 1636421313550, 300, 0, 300, 0, 0, 0
3403, 1, 1636421313338, 1636421313642, 304, 1, 303, 0, 1, 1
3341, 2, 1636421303906, 1636421313906, 10000, 0, 10000, 0, 0, 0
3405, 1, 1636421313722, 1636421313990, 268, 0, 268, 0, 0, 0
3407, 1, 1636421313954, 1636421314222, 268, 0, 268, 0, 0, 0
3343, 2, 1636421304238, 1636421314242, 10004, 0, 10004, 0, 0, 0
3344, 2, 1636421304322, 1636421314322, 10000, 0, 10000, 0, 0, 0
3408, 1, 1636421314086, 1636421314378, 292, 0, 292, 0, 0, 0
3348, 2, 1636421304502, 1636421314502, 10000, 0, 10000, 0, 0, 0
3349, 2, 1636421304854, 1636421314854, 10000, 0, 10000, 0, 0, 0
3413, 1, 1636421314634, 1636421314906, 272, 0, 272, 0, 0, 0
3414, 1, 1636421314774, 1636421315082, 308, 0, 308, 0, 0, 0
3394, 1, 1636421312390, 1636421315126, 2736, 2465, 271, 0, 2465, 2465
3353, 2, 1636421305134, 1636421315134, 10000, 0, 10000, 0, 0, 0
3418, 1, 1636421315442, 1636421315718, 276, 0, 276, 0, 0, 0
3419, 1, 1636421315478, 1636421315759, 281, 0, 281, 0, 0, 0
3420, 1, 1636421315522, 1636421315802, 280, 0, 280, 0, 0, 0
3423, 1, 1636421316198, 1636421316478, 280, 0, 280, 0, 0, 0
3360, 2, 1636421306902, 1636421316902, 10000, 0, 10000, 0, 0, 0
3424, 1, 1636421316874, 1636421317146, 272, 1, 271, 0, 0, 0
3425, 1, 1636421317206, 1636421317478, 272, 0, 272, 0, 0, 0
3426, 1, 1636421317542, 1636421317814, 272, 0, 272, 0, 0, 0
3428, 1, 1636421318210, 1636421318487, 277, 1, 276, 0, 0, 0
3429, 1, 1636421318890, 1636421319162, 272, 0, 272, 0, 0, 0
3373, 2, 1636421309710, 1636421319710, 10000, 0, 10000, 273, 0, 273
3376, 2, 1636421309838, 1636421319838, 10000, 0, 10000, 145, 0, 145
3430, 1, 1636421319558, 1636421319886, 328, 1, 327, 0, 1, 1
3431, 1, 1636421320282, 1636421320554, 272, 0, 272, 0, 0, 0
3432, 1, 1636421320290, 1636421320558, 268, 1, 267, 0, 1, 1
3433, 1, 1636421320290, 1636421320838, 548, 268, 280, 268, 0, 268
3434, 1, 1636421320950, 1636421321226, 276, 0, 276, 0, 0, 0
3386, 2, 1636421311226, 1636421321415, 10189, 101, 10088, 101, 0, 101
3388, 2, 1636421311666, 1636421321666, 10000, 0, 10000, 0, 0, 0
3390, 2, 1636421311766, 1636421321766, 10000, 0, 10000, 9649, 0, 9649
3437, 1, 1636421321638, 1636421321906, 268, 0, 268, 0, 0, 0
3438, 1, 1636421321754, 1636421322026, 272, 0, 272, 0, 0, 0
3439, 1, 1636421321970, 1636421322242, 272, 0, 272, 0, 0, 0
3440, 1, 1636421322302, 1636421322578, 276, 0, 276, 0, 0, 0
3398, 2, 1636421312658, 1636421322658, 10000, 0, 10000, 0, 0, 0
3441, 1, 1636421322422, 1636421322706, 284, 1, 283, 0, 1, 1
3442, 1, 1636421322642, 1636421322914, 272, 0, 272, 0, 0, 0
3400, 2, 1636421313098, 1636421323098, 10000, 0, 10000, 0, 0, 0
3444, 1, 1636421322974, 1636421323242, 268, 0, 268, 0, 0, 0
3443, 1, 1636421322966, 1636421323242, 276, 0, 276, 0, 0, 0
3445, 1, 1636421323142, 1636421323414, 272, 0, 272, 0, 0, 0
3404, 2, 1636421313514, 1636421323514, 10000, 0, 10000, 0, 0, 0
3446, 1, 1636421323310, 1636421323582, 272, 1, 271, 0, 0, 0
3447, 1, 1636421323406, 1636421323674, 268, 0, 268, 0, 0, 0
3406, 2, 1636421313790, 1636421323790, 10000, 0, 10000, 0, 0, 0
3451, 1, 1636421323838, 1636421324110, 272, 0, 272, 0, 0, 0
3450, 1, 1636421323838, 1636421324110, 272, 0, 272, 0, 0, 0
3409, 2, 1636421314210, 1636421324210, 10000, 0, 10000, 0, 0, 0
3452, 1, 1636421323978, 1636421324258, 280, 1, 279, 0, 1, 1
3410, 2, 1636421314418, 1636421324418, 10000, 0, 10000, 0, 0, 0
3411, 2, 1636421314590, 1636421324590, 10000, 0, 10000, 0, 0, 0
3412, 2, 1636421314614, 1636421324634, 10020, 0, 10020, 0, 0, 0
3415, 2, 1636421314814, 1636421324814, 10000, 0, 10000, 0, 0, 0
3457, 1, 1636421324530, 1636421324862, 332, 0, 332, 0, 0, 0
3455, 1, 1636421324510, 1636421324862, 352, 1, 351, 0, 0, 0
3458, 1, 1636421324682, 1636421324954, 272, 0, 272, 0, 0, 0
3416, 1, 1636421315182, 1636421325086, 9904, 9633, 271, 0, 9633, 9633
3460, 1, 1636421324902, 1636421325174, 272, 0, 272, 0, 0, 0
3417, 2, 1636421315314, 1636421325314, 10000, 0, 10000, 0, 0, 0
3462, 1, 1636421325126, 1636421325454, 328, 48, 280, 48, 0, 48
3463, 1, 1636421325258, 1636421325546, 288, 1, 287, 1, 0, 1
3465, 1, 1636421325358, 1636421325626, 268, 0, 268, 0, 0, 0
3466, 1, 1636421325498, 1636421325766, 268, 0, 268, 0, 0, 0
3421, 2, 1636421316122, 1636421326118, 9996, 0, 9996, 0, 0, 0
3422, 2, 1636421316154, 1636421326162, 10008, 0, 10008, 5261, 0, 5261
3471, 1, 1636421326018, 1636421326303, 285, 1, 284, 0, 0, 0
3474, 1, 1636421326698, 1636421326970, 272, 0, 272, 0, 0, 0
3475, 1, 1636421327366, 1636421327638, 272, 0, 272, 0, 0, 0
3427, 2, 1636421317874, 1636421327874, 10000, 0, 10000, 0, 0, 0
3476, 1, 1636421328050, 1636421328326, 276, 0, 276, 0, 0, 0
3478, 1, 1636421328726, 1636421329002, 276, 1, 275, 0, 0, 0
3479, 1, 1636421329398, 1636421329674, 276, 1, 275, 0, 0, 0
3480, 1, 1636421330070, 1636421330342, 272, 0, 272, 0, 0, 0
3435, 2, 1636421320962, 1636421330962, 10000, 0, 10000, 453, 0, 453
3436, 2, 1636421321234, 1636421331235, 10001, 0, 10001, 181, 0, 181
3483, 1, 1636421331718, 1636421331990, 272, 0, 272, 0, 0, 0
3482, 1, 1636421331722, 1636421331994, 272, 0, 272, 0, 0, 0
3485, 1, 1636421331722, 1636421332258, 536, 269, 267, 269, 0, 269
3486, 1, 1636421332386, 1636421332658, 272, 1, 271, 0, 1, 1
3487, 1, 1636421332390, 1636421332658, 268, 0, 268, 0, 0, 0
3488, 1, 1636421332654, 1636421332934, 280, 4, 276, 4, 0, 4
3490, 1, 1636421333058, 1636421333322, 264, 1, 263, 0, 1, 1
3489, 1, 1636421333054, 1636421333326, 272, 0, 272, 0, 0, 0
3491, 1, 1636421333330, 1636421333602, 272, 0, 272, 0, 0, 0
3449, 2, 1636421323638, 1636421333638, 10000, 0, 10000, 0, 0, 0
3448, 2, 1636421323638, 1636421333686, 10048, 0, 10048, 0, 0, 0
3493, 1, 1636421333734, 1636421334006, 272, 1, 271, 1, 0, 1
3492, 1, 1636421333734, 1636421334006, 272, 1, 271, 1, 0, 1
3453, 2, 1636421324070, 1636421334070, 10000, 0, 10000, 0, 0, 0
3454, 2, 1636421324098, 1636421334198, 10100, 13, 10087, 13, 0, 13
3495, 1, 1636421333954, 1636421334290, 336, 0, 336, 0, 0, 0
3496, 1, 1636421333998, 1636421334378, 380, 9, 371, 9, 0, 9
3477, 1, 1636421328178, 1636421334474, 6296, 6021, 275, 6020, 1, 6021
3456, 2, 1636421324510, 1636421334510, 10000, 0, 10000, 0, 0, 0
3497, 1, 1636421334374, 1636421334646, 272, 0, 272, 0, 0, 0
3498, 1, 1636421334418, 1636421334682, 264, 1, 263, 0, 1, 1
3499, 1, 1636421334418, 1636421334686, 268, 1, 267, 0, 0, 0
3468, 1, 1636421325622, 1636421334738, 9116, 8852, 264, 8852, 0, 8852
3459, 2, 1636421324770, 1636421334770, 10000, 0, 10000, 9969, 0, 9969
3461, 2, 1636421324918, 1636421334918, 10000, 0, 10000, 0, 0, 0
3501, 1, 1636421334689, 1636421334998, 309, 1, 308, 0, 0, 0
3473, 1, 1636421326430, 1636421335058, 8628, 8340, 288, 8308, 31, 8339
3502, 1, 1636421334818, 1636421335090, 272, 0, 272, 0, 0, 0
3503, 1, 1636421334818, 1636421335090, 272, 1, 271, 0, 0, 0
3464, 2, 1636421325258, 1636421335258, 10000, 0, 10000, 0, 0, 0
3505, 1, 1636421335050, 1636421335318, 268, 0, 268, 0, 0, 0
3507, 1, 1636421335094, 1636421335394, 300, 0, 300, 0, 0, 0
3506, 1, 1636421335094, 1636421335398, 304, 0, 304, 0, 0, 0
3467, 2, 1636421325574, 1636421335574, 10000, 0, 10000, 0, 0, 0
3509, 1, 1636421335222, 1636421335658, 436, 173, 263, 173, 0, 173
3511, 1, 1636421335438, 1636421335714, 276, 0, 276, 0, 0, 0
3513, 1, 1636421335486, 1636421335802, 316, 0, 316, 0, 0, 0
3469, 2, 1636421325850, 1636421335850, 10000, 0, 10000, 0, 0, 0
3514, 1, 1636421335486, 1636421335922, 436, 172, 264, 172, 0, 172
3470, 2, 1636421325942, 1636421335942, 10000, 0, 10000, 0, 0, 0
3516, 1, 1636421335750, 1636421336014, 264, 0, 264, 0, 0, 0
3518, 1, 1636421335794, 1636421336078, 284, 0, 284, 0, 0, 0
3472, 2, 1636421326210, 1636421336210, 10000, 0, 10000, 0, 0, 0
3520, 1, 1636421336050, 1636421336346, 296, 1, 295, 0, 0, 0
3521, 1, 1636421336126, 1636421336442, 316, 1, 315, 0, 0, 0
3523, 1, 1636421336202, 1636421336474, 272, 0, 272, 0, 0, 0
3481, 1, 1636421330738, 1636421336490, 5752, 5472, 280, 0, 5472, 5472
3527, 1, 1636421336478, 1636421336754, 276, 0, 276, 0, 0, 0
3529, 1, 1636421336738, 1636421337006, 268, 0, 268, 0, 0, 0
3530, 1, 1636421336838, 1636421337107, 269, 0, 269, 0, 0, 0
3532, 1, 1636421336886, 1636421337162, 276, 0, 276, 0, 0, 0
3533, 1, 1636421337150, 1636421337422, 272, 0, 272, 0, 0, 0
3534, 1, 1636421337398, 1636421337670, 272, 0, 272, 0, 0, 0
3535, 1, 1636421337506, 1636421337778, 272, 0, 272, 0, 0, 0
3536, 1, 1636421337562, 1636421337834, 272, 1, 271, 0, 0, 0
3537, 1, 1636421337818, 1636421338090, 272, 0, 272, 0, 0, 0
3538, 1, 1636421338066, 1636421338342, 276, 1, 275, 0, 1, 1
3539, 1, 1636421338174, 1636421338446, 272, 0, 272, 0, 0, 0
3540, 1, 1636421338230, 1636421338502, 272, 0, 272, 0, 0, 0
3541, 1, 1636421338486, 1636421338754, 268, 0, 268, 0, 0, 0
3542, 1, 1636421338738, 1636421339010, 272, 0, 272, 0, 0, 0
3543, 1, 1636421338842, 1636421339110, 268, 0, 268, 0, 0, 0
3544, 1, 1636421338894, 1636421339166, 272, 0, 272, 0, 0, 0
3545, 1, 1636421339150, 1636421339418, 268, 0, 268, 0, 0, 0
3546, 1, 1636421339402, 1636421339674, 272, 1, 271, 0, 1, 1
3548, 1, 1636421339566, 1636421339842, 276, 1, 275, 1, 0, 1
3550, 1, 1636421340066, 1636421340338, 272, 0, 272, 0, 0, 0
3551, 1, 1636421340238, 1636421340514, 276, 0, 276, 0, 0, 0
3552, 1, 1636421340730, 1636421341002, 272, 1, 271, 0, 0, 0
3554, 1, 1636421341398, 1636421341670, 272, 0, 272, 0, 0, 0
3484, 2, 1636421331722, 1636421342087, 10365, 272, 10093, 272, 1, 273
3555, 1, 1636421342070, 1636421342358, 288, 1, 287, 0, 0, 0
3556, 1, 1636421342398, 1636421342674, 276, 0, 276, 0, 0, 0
3557, 1, 1636421342750, 1636421343026, 276, 1, 275, 0, 0, 0
3558, 1, 1636421343070, 1636421343342, 272, 0, 272, 0, 0, 0
3559, 1, 1636421343422, 1636421343690, 268, 0, 268, 0, 0, 0
3494, 2, 1636421333954, 1636421343955, 10001, 0, 10001, 0, 0, 0
3560, 1, 1636421343738, 1636421344006, 268, 0, 268, 0, 0, 0
3561, 1, 1636421344130, 1636421344402, 272, 1, 271, 0, 1, 1
3500, 2, 1636421334510, 1636421344510, 10000, 0, 10000, 0, 0, 0
3562, 1, 1636421344262, 1636421344558, 296, 0, 296, 0, 0, 0
3563, 1, 1636421344402, 1636421344674, 272, 1, 271, 0, 1, 1
3504, 2, 1636421334870, 1636421344870, 10000, 0, 10000, 0, 0, 0
3564, 1, 1636421344794, 1636421345098, 304, 0, 304, 0, 0, 0
3565, 1, 1636421344818, 1636421345098, 280, 1, 279, 0, 0, 0
3508, 2, 1636421335138, 1636421345138, 10000, 0, 10000, 0, 0, 0
3566, 1, 1636421344958, 1636421345278, 320, 1, 319, 0, 0, 0
3510, 2, 1636421335366, 1636421345366, 10000, 0, 10000, 0, 0, 0
3567, 1, 1636421345070, 1636421345414, 344, 0, 344, 0, 0, 0
3512, 2, 1636421335458, 1636421345458, 10000, 0, 10000, 0, 0, 0
3568, 1, 1636421345186, 1636421345506, 320, 0, 320, 0, 0, 0
3515, 2, 1636421335562, 1636421345562, 10000, 0, 10000, 6525, 0, 6525
3517, 2, 1636421335790, 1636421345790, 10000, 0, 10000, 0, 0, 0
3570, 1, 1636421345506, 1636421345838, 332, 0, 332, 0, 0, 0
3571, 1, 1636421345550, 1636421345838, 288, 0, 288, 0, 0, 0
3569, 1, 1636421345506, 1636421345839, 333, 1, 332, 0, 0, 0
3519, 2, 1636421335894, 1636421345894, 10000, 0, 10000, 6193, 0, 6193
3573, 1, 1636421345674, 1636421345954, 280, 0, 280, 0, 0, 0
3575, 1, 1636421345838, 1636421346126, 288, 1, 287, 0, 1, 1
3574, 1, 1636421345774, 1636421346126, 352, 66, 286, 65, 0, 65
3522, 2, 1636421336162, 1636421346162, 10000, 0, 10000, 5925, 0, 5925
3576, 1, 1636421345938, 1636421346214, 276, 1, 275, 0, 0, 0
3524, 2, 1636421336254, 1636421346258, 10004, 0, 10004, 189, 0, 189
3525, 2, 1636421336322, 1636421346322, 10000, 0, 10000, 0, 0, 0
3572, 1, 1636421345670, 1636421346394, 724, 457, 267, 457, 0, 457
3526, 2, 1636421336410, 1636421346410, 10000, 0, 10000, 33, 0, 33
3528, 2, 1636421336518, 1636421346518, 10000, 0, 10000, 5569, 0, 5569
3580, 1, 1636421346254, 1636421346566, 312, 1, 311, 1, 0, 1
3578, 1, 1636421346254, 1636421346566, 312, 1, 311, 0, 1, 1
3579, 1, 1636421346258, 1636421346566, 308, 0, 308, 0, 0, 0
3581, 1, 1636421346370, 1636421346654, 284, 0, 284, 0, 0, 0
3583, 1, 1636421346562, 1636421346830, 268, 0, 268, 0, 0, 0
3531, 2, 1636421336870, 1636421346870, 10000, 0, 10000, 0, 0, 0
3584, 1, 1636421346614, 1636421346918, 304, 0, 304, 0, 0, 0
3589, 1, 1636421346826, 1636421347098, 272, 0, 272, 0, 0, 0
3587, 1, 1636421346782, 1636421347098, 316, 0, 316, 0, 0, 0
3591, 1, 1636421346966, 1636421347238, 272, 1, 271, 0, 1, 1
3590, 1, 1636421346966, 1636421347246, 280, 1, 279, 0, 1, 1
3593, 1, 1636421347050, 1636421347318, 268, 0, 268, 0, 0, 0
3594, 1, 1636421347178, 1636421347454, 276, 0, 276, 0, 0, 0
3595, 1, 1636421347226, 1636421347502, 276, 0, 276, 0, 0, 0
3597, 1, 1636421347494, 1636421347766, 272, 0, 272, 0, 0, 0
3598, 1, 1636421347494, 1636421347766, 272, 1, 271, 0, 0, 0
3600, 1, 1636421347638, 1636421347902, 264, 0, 264, 0, 0, 0
3601, 1, 1636421347718, 1636421347994, 276, 0, 276, 0, 0, 0
3602, 1, 1636421347854, 1636421348122, 268, 0, 268, 0, 0, 0
3603, 1, 1636421347898, 1636421348170, 272, 0, 272, 0, 0, 0
3605, 1, 1636421348162, 1636421348434, 272, 0, 272, 0, 0, 0
3604, 1, 1636421348162, 1636421348434, 272, 0, 272, 0, 0, 0
3606, 1, 1636421348298, 1636421348570, 272, 0, 272, 0, 0, 0
3607, 1, 1636421348390, 1636421348662, 272, 0, 272, 0, 0, 0
3608, 1, 1636421348518, 1636421348794, 276, 0, 276, 0, 0, 0
3609, 1, 1636421348566, 1636421348834, 268, 5, 263, 5, 0, 5
3610, 1, 1636421348834, 1636421349106, 272, 1, 271, 1, 0, 1
3611, 1, 1636421348834, 1636421349106, 272, 1, 271, 0, 0, 0
3613, 1, 1636421349058, 1636421349326, 268, 1, 267, 0, 0, 0
3614, 1, 1636421349190, 1636421349462, 272, 0, 272, 0, 0, 0
3615, 1, 1636421349230, 1636421349502, 272, 0, 272, 0, 0, 0
3547, 2, 1636421339506, 1636421349506, 10000, 0, 10000, 0, 0, 0
3616, 1, 1636421349502, 1636421349778, 276, 0, 276, 0, 0, 0
3549, 2, 1636421339814, 1636421349814, 10000, 0, 10000, 0, 0, 0
3618, 1, 1636421349722, 1636421349998, 276, 0, 276, 0, 0, 0
3619, 1, 1636421349858, 1636421350126, 268, 0, 268, 0, 0, 0
3622, 1, 1636421350122, 1636421350390, 268, 0, 268, 0, 0, 0
3623, 1, 1636421350178, 1636421350446, 268, 0, 268, 0, 0, 0
3624, 1, 1636421350398, 1636421350674, 276, 0, 276, 0, 0, 0
3625, 1, 1636421350526, 1636421350798, 272, 0, 272, 0, 0, 0
3553, 2, 1636421340910, 1636421350910, 10000, 0, 10000, 0, 0, 0
3627, 1, 1636421350842, 1636421351138, 296, 0, 296, 0, 0, 0
3628, 1, 1636421351086, 1636421351358, 272, 0, 272, 0, 0, 0
3631, 1, 1636421351534, 1636421351806, 272, 1, 271, 0, 1, 1
3632, 1, 1636421351754, 1636421352026, 272, 1, 271, 0, 1, 1
3633, 1, 1636421352202, 1636421352474, 272, 0, 272, 0, 0, 0
3634, 1, 1636421352390, 1636421352658, 268, 1, 267, 0, 0, 0
3637, 1, 1636421352422, 1636421352698, 276, 0, 276, 0, 0, 0
3638, 1, 1636421352870, 1636421353142, 272, 1, 271, 0, 0, 0
3639, 1, 1636421353054, 1636421353326, 272, 0, 272, 0, 0, 0
3640, 1, 1636421353094, 1636421353366, 272, 1, 271, 0, 0, 0
3641, 1, 1636421353538, 1636421353806, 268, 1, 267, 0, 0, 0
3642, 1, 1636421353722, 1636421353998, 276, 0, 276, 0, 0, 0
3643, 1, 1636421353762, 1636421354034, 272, 0, 272, 0, 0, 0
3645, 1, 1636421354394, 1636421354662, 268, 0, 268, 0, 0, 0
3646, 1, 1636421354430, 1636421354702, 272, 1, 271, 0, 1, 1
3647, 1, 1636421355058, 1636421355330, 272, 0, 272, 0, 0, 0
3648, 1, 1636421355098, 1636421355374, 276, 1, 275, 0, 1, 1
3649, 1, 1636421355726, 1636421356006, 280, 0, 280, 0, 0, 0
3650, 1, 1636421355770, 1636421356046, 276, 0, 276, 0, 0, 0
3577, 2, 1636421346094, 1636421356094, 10000, 0, 10000, 0, 0, 0
3582, 2, 1636421346562, 1636421356655, 10093, 5, 10088, 4, 2, 6
3585, 2, 1636421346694, 1636421356746, 10052, 0, 10052, 0, 0, 0
3588, 2, 1636421346786, 1636421356791, 10005, 9869, 136, 9869, 0, 9869
3586, 2, 1636421346782, 1636421356834, 10052, 0, 10052, 0, 0, 0
3653, 1, 1636421356442, 1636421356878, 436, 0, 436, 0, 0, 0
3652, 1, 1636421356402, 1636421356878, 476, 0, 476, 0, 0, 0
3592, 2, 1636421346970, 1636421356970, 10000, 0, 10000, 0, 0, 0
3596, 2, 1636421347314, 1636421357314, 10000, 0, 10000, 0, 0, 0
3659, 1, 1636421357274, 1636421357546, 272, 0, 272, 0, 0, 0
3660, 1, 1636421357278, 1636421357554, 276, 0, 276, 0, 0, 0
3599, 2, 1636421347634, 1636421357634, 10000, 0, 10000, 0, 0, 0
3661, 1, 1636421357626, 1636421357898, 272, 0, 272, 0, 0, 0
3662, 1, 1636421357942, 1636421358214, 272, 0, 272, 0, 0, 0
3664, 1, 1636421357954, 1636421358226, 272, 0, 272, 0, 0, 0
3665, 1, 1636421358298, 1636421358570, 272, 0, 272, 0, 0, 0
3666, 1, 1636421358610, 1636421358886, 276, 0, 276, 0, 0, 0
3667, 1, 1636421358622, 1636421358898, 276, 0, 276, 0, 0, 0
3612, 2, 1636421348962, 1636421358962, 10000, 0, 10000, 0, 0, 0
3668, 1, 1636421359006, 1636421359278, 272, 0, 272, 0, 0, 0
3617, 2, 1636421349550, 1636421359554, 10004, 0, 10004, 0, 0, 0
3671, 1, 1636421359298, 1636421359602, 304, 0, 304, 0, 0, 0
3670, 1, 1636421359286, 1636421359602, 316, 0, 316, 0, 0, 0
3620, 2, 1636421349858, 1636421359858, 10000, 0, 10000, 0, 0, 0
3621, 2, 1636421349902, 1636421359902, 10000, 0, 10000, 0, 0, 0
3672, 1, 1636421359674, 1636421359950, 276, 0, 276, 0, 0, 0
3673, 1, 1636421359858, 1636421360130, 272, 1, 271, 1, 0, 1
3674, 1, 1636421360082, 1636421360354, 272, 1, 271, 0, 1, 1
3676, 1, 1636421360170, 1636421360442, 272, 0, 272, 0, 0, 0
3677, 1, 1636421360210, 1636421360482, 272, 0, 272, 0, 0, 0
3626, 2, 1636421350790, 1636421360790, 10000, 0, 10000, 0, 0, 0
3679, 1, 1636421360526, 1636421360838, 312, 0, 312, 0, 0, 0
3681, 1, 1636421360838, 1636421361106, 268, 1, 267, 1, 0, 1
3629, 2, 1636421351194, 1636421361194, 10000, 0, 10000, 0, 0, 0
3630, 2, 1636421351214, 1636421361242, 10028, 0, 10028, 0, 0, 0
3635, 2, 1636421352394, 1636421362394, 10000, 0, 10000, 264, 0, 264
3636, 2, 1636421352394, 1636421362438, 10044, 0, 10044, 265, 0, 265
3658, 1, 1636421357274, 1636421362706, 5432, 5164, 268, 0, 5164, 5164
3688, 1, 1636421362966, 1636421363238, 272, 1, 271, 0, 1, 1
3690, 1, 1636421363102, 1636421363374, 272, 0, 272, 0, 0, 0
3689, 1, 1636421362966, 1636421363502, 536, 272, 264, 271, 0, 271
3691, 1, 1636421363634, 1636421363906, 272, 0, 272, 0, 0, 0
3692, 1, 1636421363770, 1636421364038, 268, 0, 268, 0, 0, 0
3693, 1, 1636421363894, 1636421364178, 284, 13, 271, 13, 0, 13
3644, 2, 1636421354202, 1636421364202, 10000, 0, 10000, 0, 0, 0
3694, 1, 1636421364302, 1636421364574, 272, 1, 271, 0, 0, 0
3695, 1, 1636421364434, 1636421364710, 276, 0, 276, 0, 0, 0
3696, 1, 1636421364510, 1636421364774, 264, 0, 264, 0, 0, 0
3697, 1, 1636421364574, 1636421364842, 268, 1, 267, 0, 1, 1
3698, 1, 1636421364970, 1636421365238, 268, 1, 267, 0, 0, 0
3701, 1, 1636421365234, 1636421365502, 268, 4, 264, 4, 0, 4
3702, 1, 1636421365634, 1636421365902, 268, 0, 268, 0, 0, 0
3703, 1, 1636421365894, 1636421366174, 280, 9, 271, 9, 0, 9
3651, 2, 1636421356398, 1636421366398, 10000, 0, 10000, 0, 0, 0
3704, 1, 1636421366298, 1636421366574, 276, 0, 276, 0, 0, 0
3705, 1, 1636421366574, 1636421366838, 264, 1, 263, 1, 0, 1
3655, 2, 1636421357058, 1636421367058, 10000, 0, 10000, 0, 0, 0
3656, 2, 1636421357098, 1636421367102, 10004, 0, 10004, 0, 0, 0
3657, 2, 1636421357094, 1636421367146, 10052, 0, 10052, 0, 0, 0
3654, 2, 1636421357058, 1636421367190, 10132, 10000, 132, 0, 10000, 10000
3707, 1, 1636421366970, 1636421367418, 448, 0, 448, 0, 0, 0
3708, 1, 1636421367326, 1636421367686, 360, 93, 267, 92, 1, 93
3663, 2, 1636421357942, 1636421367942, 10000, 0, 10000, 0, 0, 0
3713, 1, 1636421367814, 1636421368090, 276, 0, 276, 0, 0, 0
3714, 1, 1636421368118, 1636421368394, 276, 0, 276, 0, 0, 0
3716, 1, 1636421368486, 1636421368762, 276, 1, 275, 0, 1, 1
3717, 1, 1636421368790, 1636421369062, 272, 1, 271, 0, 0, 0
3669, 2, 1636421359262, 1636421369262, 10000, 0, 10000, 0, 0, 0
3718, 1, 1636421369158, 1636421369434, 276, 0, 276, 0, 0, 0
3719, 1, 1636421369454, 1636421369726, 272, 0, 272, 0, 0, 0
3675, 2, 1636421360082, 1636421370083, 10001, 0, 10001, 0, 0, 0
3678, 2, 1636421360346, 1636421370347, 10001, 0, 10001, 0, 0, 0
3723, 1, 1636421370394, 1636421370670, 276, 0, 276, 0, 0, 0
3680, 2, 1636421360750, 1636421370750, 10000, 0, 10000, 0, 0, 0
3682, 2, 1636421360882, 1636421370882, 10000, 0, 10000, 0, 0, 0
3724, 1, 1636421370650, 1636421371022, 372, 21, 351, 21, 0, 21
3683, 2, 1636421361098, 1636421371098, 10000, 0, 10000, 0, 0, 0
3684, 2, 1636421361286, 1636421371238, 9952, 0, 9952, 0, 0, 0
3725, 1, 1636421371058, 1636421371329, 271, 0, 271, 0, 0, 0
3726, 1, 1636421371070, 1636421371374, 304, 0, 304, 0, 0, 0
3685, 2, 1636421361502, 1636421371503, 10001, 0, 10001, 0, 0, 0
3687, 2, 1636421361526, 1636421371550, 10024, 0, 10024, 0, 0, 0
3686, 2, 1636421361510, 1636421371594, 10084, 0, 10084, 0, 0, 0
3728, 1, 1636421371414, 1636421371822, 408, 1, 407, 0, 0, 0
3729, 1, 1636421371418, 1636421371822, 404, 0, 404, 0, 0, 0
3732, 1, 1636421371774, 1636421372094, 320, 49, 271, 48, 0, 48
3733, 1, 1636421371862, 1636421372134, 272, 0, 272, 0, 0, 0
3736, 1, 1636421372218, 1636421372498, 280, 1, 279, 0, 0, 0
3739, 1, 1636421372530, 1636421372806, 276, 1, 275, 1, 0, 1
3740, 1, 1636421372894, 1636421373162, 268, 0, 268, 0, 0, 0
3742, 1, 1636421373558, 1636421373830, 272, 0, 272, 0, 0, 0
3743, 1, 1636421374226, 1636421374502, 276, 1, 275, 0, 0, 0
3699, 2, 1636421365106, 1636421375106, 10000, 0, 10000, 0, 0, 0
3744, 1, 1636421374898, 1636421375170, 272, 1, 271, 0, 0, 0
3700, 2, 1636421365174, 1636421375174, 10000, 0, 10000, 0, 0, 0
3745, 1, 1636421375438, 1636421375706, 268, 0, 268, 0, 0, 0
3747, 1, 1636421375566, 1636421375842, 276, 1, 275, 0, 0, 0
3749, 1, 1636421376238, 1636421376510, 272, 0, 272, 0, 0, 0
3706, 2, 1636421366702, 1636421376702, 10000, 0, 10000, 0, 0, 0
3750, 1, 1636421376906, 1636421377178, 272, 1, 271, 0, 1, 1
3709, 2, 1636421367450, 1636421377450, 10000, 0, 10000, 0, 0, 0
3712, 2, 1636421367458, 1636421377494, 10036, 0, 10036, 0, 0, 0
3711, 2, 1636421367454, 1636421377538, 10084, 0, 10084, 0, 0, 0
3710, 2, 1636421367450, 1636421377582, 10132, 0, 10132, 0, 0, 0
3715, 1, 1636421368250, 1636421377854, 9604, 9333, 271, 0, 9333, 9333
3752, 1, 1636421377630, 1636421377906, 276, 0, 276, 0, 0, 0
3753, 1, 1636421377846, 1636421378118, 272, 0, 272, 0, 0, 0
3756, 1, 1636421377846, 1636421378122, 276, 0, 276, 0, 0, 0
3755, 1, 1636421377854, 1636421378390, 536, 269, 267, 268, 1, 269
3758, 1, 1636421378302, 1636421378574, 272, 0, 272, 0, 0, 0
3759, 1, 1636421378514, 1636421378786, 272, 0, 272, 0, 0, 0
3760, 1, 1636421378522, 1636421378794, 272, 0, 272, 0, 0, 0
3761, 1, 1636421378786, 1636421379070, 284, 8, 276, 8, 0, 8
3762, 1, 1636421378978, 1636421379250, 272, 0, 272, 0, 0, 0
3763, 1, 1636421379182, 1636421379454, 272, 0, 272, 0, 0, 0
3764, 1, 1636421379198, 1636421379474, 276, 1, 275, 0, 0, 0
3720, 2, 1636421369566, 1636421379566, 10000, 0, 10000, 0, 0, 0
3765, 1, 1636421379466, 1636421379746, 280, 9, 271, 9, 0, 9
3721, 2, 1636421369830, 1636421379830, 10000, 0, 10000, 0, 0, 0
3766, 1, 1636421379654, 1636421379966, 312, 0, 312, 0, 0, 0
3722, 2, 1636421370130, 1636421380130, 10000, 0, 10000, 0, 0, 0
3768, 1, 1636421379874, 1636421380178, 304, 0, 304, 0, 0, 0
3767, 1, 1636421379874, 1636421380178, 304, 0, 304, 0, 0, 0
3770, 1, 1636421380178, 1636421380454, 276, 1, 275, 0, 1, 1
3771, 1, 1636421380178, 1636421380454, 276, 1, 275, 1, 0, 1
3772, 1, 1636421380362, 1636421380634, 272, 0, 272, 0, 0, 0
3773, 1, 1636421380434, 1636421380726, 292, 21, 271, 20, 1, 21
3774, 1, 1636421380570, 1636421380842, 272, 0, 272, 0, 0, 0
3775, 1, 1636421380578, 1636421380850, 272, 0, 272, 0, 0, 0
3776, 1, 1636421380850, 1636421381118, 268, 1, 267, 0, 1, 1
3727, 2, 1636421371190, 1636421381190, 10000, 0, 10000, 0, 0, 0
3778, 1, 1636421381030, 1636421381330, 300, 0, 300, 0, 0, 0
3780, 1, 1636421381238, 1636421381514, 276, 0, 276, 0, 0, 0
3781, 1, 1636421381282, 1636421381550, 268, 0, 268, 0, 0, 0
3730, 2, 1636421371642, 1636421381642, 10000, 0, 10000, 0, 0, 0
3731, 2, 1636421371774, 1636421381774, 10000, 0, 10000, 0, 0, 0
3782, 1, 1636421381498, 1636421381822, 324, 1, 323, 0, 0, 0
3783, 1, 1636421381518, 1636421381822, 304, 0, 304, 0, 0, 0
3734, 2, 1636421371858, 1636421381858, 10000, 0, 10000, 0, 0, 0
3735, 2, 1636421371862, 1636421381902, 10040, 0, 10040, 0, 0, 0
3784, 1, 1636421381734, 1636421382042, 308, 0, 308, 0, 0, 0
3737, 2, 1636421372218, 1636421382218, 10000, 0, 10000, 0, 0, 0
3787, 1, 1636421381954, 1636421382266, 312, 1, 311, 0, 0, 0
3786, 1, 1636421381954, 1636421382266, 312, 1, 311, 1, 0, 1
3785, 1, 1636421381954, 1636421382266, 312, 1, 311, 0, 1, 1
3738, 2, 1636421372490, 1636421382490, 10000, 0, 10000, 0, 0, 0
3791, 1, 1636421382262, 1636421382538, 276, 5, 271, 5, 0, 5
3790, 1, 1636421382170, 1636421382546, 376, 98, 278, 97, 0, 97
3792, 1, 1636421382266, 1636421382546, 280, 1, 279, 0, 1, 1
3793, 1, 1636421382438, 1636421382718, 280, 0, 280, 0, 0, 0
3795, 1, 1636421382670, 1636421382946, 276, 1, 275, 0, 1, 1
3796, 1, 1636421382670, 1636421382950, 280, 0, 280, 0, 0, 0
3741, 2, 1636421373202, 1636421383202, 10000, 0, 10000, 0, 0, 0
3800, 1, 1636421382942, 1636421383250, 308, 4, 304, 4, 0, 4
3801, 1, 1636421382942, 1636421383250, 308, 0, 308, 0, 0, 0
3802, 1, 1636421383118, 1636421383426, 308, 0, 308, 0, 0, 0
3803, 1, 1636421383378, 1636421383650, 272, 0, 272, 0, 0, 0
3805, 1, 1636421383510, 1636421383786, 276, 0, 276, 0, 0, 0
3807, 1, 1636421383650, 1636421383922, 272, 0, 272, 0, 0, 0
3808, 1, 1636421383826, 1636421384098, 272, 0, 272, 0, 0, 0
3809, 1, 1636421384054, 1636421384326, 272, 0, 272, 0, 0, 0
3810, 1, 1636421384202, 1636421384478, 276, 0, 276, 0, 0, 0
3811, 1, 1636421384326, 1636421384598, 272, 1, 271, 0, 1, 1
3812, 1, 1636421384498, 1636421384770, 272, 0, 272, 0, 0, 0
3813, 1, 1636421384722, 1636421384994, 272, 1, 271, 0, 0, 0
3814, 1, 1636421384874, 1636421385150, 276, 1, 275, 0, 1, 1
3815, 1, 1636421384994, 1636421385270, 276, 0, 276, 0, 0, 0
3746, 2, 1636421375482, 1636421385482, 10000, 0, 10000, 0, 0, 0
3819, 1, 1636421385666, 1636421385942, 276, 0, 276, 0, 0, 0
3820, 1, 1636421385790, 1636421386066, 276, 0, 276, 0, 0, 0
3748, 2, 1636421376102, 1636421386102, 10000, 0, 10000, 0, 0, 0
3821, 1, 1636421386338, 1636421386614, 276, 0, 276, 0, 0, 0
3823, 1, 1636421386462, 1636421386734, 272, 1, 271, 0, 0, 0
3751, 2, 1636421377006, 1636421387018, 10012, 0, 10012, 0, 0, 0
3824, 1, 1636421387066, 1636421387342, 276, 0, 276, 0, 0, 0
3825, 1, 1636421387130, 1636421387402, 272, 1, 271, 0, 0, 0
3826, 1, 1636421387310, 1636421387582, 272, 1, 271, 0, 0, 0
3754, 2, 1636421377842, 1636421387842, 10000, 0, 10000, 0, 0, 0
3827, 1, 1636421387738, 1636421388010, 272, 1, 271, 0, 0, 0
3828, 1, 1636421387798, 1636421388070, 272, 0, 272, 0, 0, 0
3757, 2, 1636421378254, 1636421388254, 10000, 0, 10000, 0, 0, 0
3829, 1, 1636421388018, 1636421388302, 284, 0, 284, 0, 0, 0
3830, 1, 1636421388146, 1636421388414, 268, 1, 267, 0, 0, 0
3831, 1, 1636421388434, 1636421388706, 272, 0, 272, 0, 0, 0
3832, 1, 1636421388466, 1636421388738, 272, 0, 272, 0, 0, 0
3834, 1, 1636421388698, 1636421388970, 272, 0, 272, 0, 0, 0
3835, 1, 1636421388810, 1636421389086, 276, 0, 276, 0, 0, 0
3836, 1, 1636421389106, 1636421389382, 276, 0, 276, 0, 0, 0
3837, 1, 1636421389134, 1636421389402, 268, 0, 268, 0, 0, 0
3838, 1, 1636421389370, 1636421389642, 272, 0, 272, 0, 0, 0
3839, 1, 1636421389482, 1636421389754, 272, 1, 271, 0, 0, 0
3769, 2, 1636421379874, 1636421389878, 10004, 0, 10004, 0, 0, 0
3840, 1, 1636421389778, 1636421390050, 272, 0, 272, 0, 0, 0
3841, 1, 1636421389798, 1636421390102, 304, 0, 304, 0, 0, 0
3842, 1, 1636421390054, 1636421390334, 280, 0, 280, 0, 0, 0
3843, 1, 1636421390154, 1636421390426, 272, 0, 272, 0, 0, 0
3845, 1, 1636421390450, 1636421390722, 272, 1, 271, 0, 1, 1
3846, 1, 1636421390498, 1636421390770, 272, 0, 272, 0, 0, 0
3777, 2, 1636421380850, 1636421390850, 10000, 0, 10000, 0, 0, 0
3847, 1, 1636421390734, 1636421391010, 276, 0, 276, 0, 0, 0
3848, 1, 1636421390822, 1636421391098, 276, 0, 276, 0, 0, 0
3779, 2, 1636421381118, 1636421391118, 10000, 0, 10000, 0, 0, 0
3849, 1, 1636421391162, 1636421391434, 272, 0, 272, 0, 0, 0
3851, 1, 1636421391166, 1636421391446, 280, 0, 280, 0, 0, 0
3852, 1, 1636421391410, 1636421391682, 272, 0, 272, 0, 0, 0
3854, 1, 1636421391494, 1636421391770, 276, 1, 275, 0, 0, 0
3855, 1, 1636421391834, 1636421392106, 272, 0, 272, 0, 0, 0
3856, 1, 1636421391842, 1636421392110, 268, 0, 268, 0, 0, 0
3788, 2, 1636421382126, 1636421392126, 10000, 0, 10000, 0, 0, 0
3789, 2, 1636421382166, 1636421392174, 10008, 0, 10008, 0, 0, 0
3857, 1, 1636421392085, 1636421392402, 317, 1, 316, 0, 0, 0
3858, 1, 1636421392218, 1636421392494, 276, 0, 276, 0, 0, 0
3794, 2, 1636421382538, 1636421392534, 9996, 0, 9996, 0, 0, 0
3797, 2, 1636421382670, 1636421392666, 9996, 0, 9996, 0, 0, 0
3859, 1, 1636421392438, 1636421392714, 276, 0, 276, 0, 0, 0
3798, 2, 1636421382798, 1636421392798, 10000, 0, 10000, 0, 0, 0
3860, 1, 1636421392470, 1636421392846, 376, 0, 376, 0, 0, 0
3862, 1, 1636421392510, 1636421392847, 337, 0, 337, 0, 0, 0
3861, 1, 1636421392502, 1636421392847, 345, 0, 345, 0, 0, 0
3799, 2, 1636421382934, 1636421392934, 10000, 0, 10000, 0, 0, 0
3864, 1, 1636421392846, 1636421393158, 312, 1, 311, 0, 1, 1
3865, 1, 1636421392890, 1636421393158, 268, 0, 268, 0, 0, 0
3863, 1, 1636421392846, 1636421393158, 312, 1, 311, 0, 1, 1
3868, 1, 1636421393114, 1636421393382, 268, 0, 268, 0, 0, 0
3804, 2, 1636421383382, 1636421393382, 10000, 0, 10000, 0, 0, 0
3867, 1, 1636421393110, 1636421393430, 320, 49, 271, 48, 1, 49
3872, 1, 1636421393246, 1636421393518, 272, 0, 272, 0, 0, 0
3871, 1, 1636421393242, 1636421393518, 276, 1, 275, 0, 0, 0
3870, 1, 1636421393242, 1636421393522, 280, 1, 279, 0, 1, 1
3806, 2, 1636421383646, 1636421393646, 10000, 0, 10000, 0, 0, 0
3874, 1, 1636421393558, 1636421393874, 316, 0, 316, 0, 0, 0
3873, 1, 1636421393558, 1636421393874, 316, 1, 315, 0, 0, 0
3875, 1, 1636421393558, 1636421393878, 320, 0, 320, 0, 0, 0
3876, 1, 1636421393694, 1636421393966, 272, 0, 272, 0, 0, 0
3878, 1, 1636421393834, 1636421394150, 316, 44, 272, 44, 0, 44
3881, 1, 1636421393918, 1636421394190, 272, 0, 272, 0, 0, 0
3880, 1, 1636421393914, 1636421394190, 276, 0, 276, 0, 0, 0
3882, 1, 1636421393958, 1636421394234, 276, 8, 268, 8, 0, 8
3879, 1, 1636421393914, 1636421394414, 500, 236, 264, 236, 0, 236
3883, 1, 1636421394270, 1636421394542, 272, 1, 271, 0, 0, 0
3884, 1, 1636421394270, 1636421394542, 272, 1, 271, 1, 0, 1
3886, 1, 1636421394362, 1636421394634, 272, 0, 272, 0, 0, 0
3888, 1, 1636421394586, 1636421394850, 264, 0, 264, 0, 0, 0
3889, 1, 1636421394598, 1636421394866, 268, 0, 268, 0, 0, 0
3890, 1, 1636421394630, 1636421394902, 272, 5, 267, 5, 0, 5
3891, 1, 1636421394810, 1636421395078, 268, 0, 268, 0, 0, 0
3816, 2, 1636421385166, 1636421395166, 10000, 0, 10000, 0, 0, 0
3892, 1, 1636421394938, 1636421395214, 276, 1, 275, 1, 0, 1
3894, 1, 1636421395034, 1636421395302, 268, 0, 268, 0, 0, 0
3817, 2, 1636421385390, 1636421395394, 10004, 0, 10004, 0, 0, 0
3895, 1, 1636421395258, 1636421395530, 272, 0, 272, 0, 0, 0
3818, 2, 1636421385570, 1636421395570, 10000, 0, 10000, 0, 0, 0
3897, 1, 1636421395298, 1636421395626, 328, 4, 324, 4, 0, 4
3899, 1, 1636421395486, 1636421395798, 312, 1, 311, 0, 1, 1
3898, 1, 1636421395486, 1636421395802, 316, 1, 315, 0, 0, 0
3903, 1, 1636421395878, 1636421396150, 272, 1, 271, 0, 0, 0
3904, 1, 1636421395926, 1636421396202, 276, 0, 276, 0, 0, 0
3822, 2, 1636421386410, 1636421396410, 10000, 0, 10000, 0, 0, 0
3906, 1, 1636421396190, 1636421396462, 272, 0, 272, 0, 0, 0
3908, 1, 1636421396590, 1636421396862, 272, 1, 271, 0, 0, 0
3909, 1, 1636421396598, 1636421396870, 272, 1, 271, 0, 0, 0
3910, 1, 1636421396714, 1636421396982, 268, 0, 268, 0, 0, 0
3911, 1, 1636421396858, 1636421397130, 272, 0, 272, 0, 0, 0
3913, 1, 1636421397266, 1636421397530, 264, 0, 264, 0, 0, 0
3912, 1, 1636421397258, 1636421397530, 272, 0, 272, 0, 0, 0
3914, 1, 1636421397378, 1636421397654, 276, 1, 275, 0, 0, 0
3915, 1, 1636421397526, 1636421397794, 268, 0, 268, 0, 0, 0
3917, 1, 1636421397930, 1636421398206, 276, 0, 276, 0, 0, 0
3916, 1, 1636421397930, 1636421398210, 280, 0, 280, 0, 0, 0
3918, 1, 1636421398050, 1636421398326, 276, 0, 276, 0, 0, 0
3919, 1, 1636421398190, 1636421398458, 268, 0, 268, 0, 0, 0
3833, 2, 1636421388562, 1636421398562, 10000, 0, 10000, 0, 0, 0
3920, 1, 1636421398606, 1636421398878, 272, 1, 271, 0, 0, 0
3921, 1, 1636421398606, 1636421398878, 272, 1, 271, 0, 0, 0
3922, 1, 1636421398738, 1636421399006, 268, 1, 267, 0, 0, 0
3923, 1, 1636421398854, 1636421399126, 272, 0, 272, 0, 0, 0
3925, 1, 1636421399274, 1636421399546, 272, 1, 271, 0, 1, 1
3927, 1, 1636421399402, 1636421399678, 276, 0, 276, 0, 0, 0
3928, 1, 1636421399522, 1636421399799, 277, 1, 276, 0, 0, 0
3844, 2, 1636421390174, 1636421400174, 10000, 0, 10000, 0, 0, 0
3929, 1, 1636421399942, 1636421400222, 280, 1, 279, 0, 0, 0
3930, 1, 1636421400074, 1636421400342, 268, 1, 267, 0, 0, 0
3932, 1, 1636421400482, 1636421400758, 276, 1, 275, 0, 0, 0
3933, 1, 1636421400622, 1636421400890, 268, 0, 268, 0, 0, 0
3934, 1, 1636421400738, 1636421401010, 272, 1, 271, 0, 0, 0
3850, 2, 1636421391162, 1636421401166, 10004, 0, 10004, 0, 0, 0
3935, 1, 1636421401154, 1636421401426, 272, 0, 272, 0, 0, 0
3853, 2, 1636421391430, 1636421401430, 10000, 0, 10000, 0, 0, 0
3936, 1, 1636421401290, 1636421401566, 276, 0, 276, 0, 0, 0
3937, 1, 1636421401410, 1636421401686, 276, 0, 276, 0, 0, 0
3938, 1, 1636421401474, 1636421401742, 268, 0, 268, 0, 0, 0
3939, 1, 1636421401734, 1636421402010, 276, 9, 267, 9, 0, 9
3940, 1, 1636421401818, 1636421402090, 272, 0, 272, 0, 0, 0
3941, 1, 1636421401962, 1636421402238, 276, 0, 276, 0, 0, 0
3942, 1, 1636421402082, 1636421402354, 272, 0, 272, 0, 0, 0
3943, 1, 1636421402138, 1636421402406, 268, 0, 268, 0, 0, 0
3944, 1, 1636421402402, 1636421402674, 272, 5, 267, 4, 1, 5
3945, 1, 1636421402486, 1636421402750, 264, 0, 264, 0, 0, 0
3946, 1, 1636421402638, 1636421402910, 272, 0, 272, 0, 0, 0
3866, 2, 1636421392982, 1636421402982, 10000, 0, 10000, 0, 0, 0
3947, 1, 1636421402754, 1636421403030, 276, 0, 276, 0, 0, 0
3948, 1, 1636421402810, 1636421403118, 308, 0, 308, 0, 0, 0
3869, 2, 1636421393242, 1636421403242, 10000, 0, 10000, 0, 0, 0
3949, 1, 1636421403074, 1636421403390, 316, 44, 272, 44, 0, 44
3950, 1, 1636421403158, 1636421403470, 312, 0, 312, 0, 0, 0
3951, 1, 1636421403290, 1636421403562, 272, 0, 272, 0, 0, 0
3953, 1, 1636421403434, 1636421403698, 264, 0, 264, 0, 0, 0
3954, 1, 1636421403518, 1636421403786, 268, 0, 268, 0, 0, 0
3877, 2, 1636421393826, 1636421403826, 10000, 0, 10000, 0, 0, 0
3955, 1, 1636421403558, 1636421403874, 316, 5, 311, 4, 0, 4
3956, 1, 1636421403782, 1636421404054, 272, 4, 268, 4, 0, 4
3957, 1, 1636421403874, 1636421404142, 268, 0, 268, 0, 0, 0
3958, 1, 1636421403962, 1636421404234, 272, 0, 272, 0, 0, 0
3885, 2, 1636421394274, 1636421404274, 10000, 0, 10000, 0, 0, 0
3960, 1, 1636421404134, 1636421404410, 276, 0, 276, 0, 0, 0
3959, 1, 1636421404094, 1636421404410, 316, 0, 316, 0, 0, 0
3961, 1, 1636421404182, 1636421404450, 268, 0, 268, 0, 0, 0
3962, 1, 1636421404270, 1636421404542, 272, 0, 272, 0, 0, 0
3887, 2, 1636421394546, 1636421404546, 10000, 0, 10000, 0, 0, 0
3963, 1, 1636421404450, 1636421404714, 264, 1, 263, 1, 0, 1
3964, 1, 1636421404534, 1636421404798, 264, 0, 264, 0, 0, 0
3965, 1, 1636421404590, 1636421404858, 268, 0, 268, 0, 0, 0
3893, 2, 1636421394938, 1636421404938, 10000, 0, 10000, 0, 0, 0
3968, 1, 1636421404806, 1636421405074, 268, 0, 268, 0, 0, 0
3967, 1, 1636421404806, 1636421405078, 272, 0, 272, 0, 0, 0
3969, 1, 1636421404846, 1636421405118, 272, 0, 272, 0, 0, 0
3970, 1, 1636421404858, 1636421405170, 312, 1, 311, 1, 0, 1
3896, 2, 1636421395266, 1636421405266, 10000, 0, 10000, 0, 0, 0
3972, 1, 1636421405118, 1636421405402, 284, 1, 283, 0, 0, 0
3973, 1, 1636421405194, 1636421405494, 300, 0, 300, 0, 0, 0
3975, 1, 1636421405254, 1636421405526, 272, 0, 272, 0, 0, 0
3900, 2, 1636421395618, 1636421405618, 10000, 0, 10000, 0, 0, 0
3901, 2, 1636421395698, 1636421405698, 10000, 0, 10000, 0, 0, 0
3902, 2, 1636421395698, 1636421405742, 10044, 0, 10044, 0, 0, 0
3977, 1, 1636421405478, 1636421405786, 308, 0, 308, 0, 0, 0
3978, 1, 1636421405514, 1636421405786, 272, 0, 272, 0, 0, 0
3976, 1, 1636421405474, 1636421405786, 312, 0, 312, 0, 0, 0
3979, 1, 1636421405566, 1636421405878, 312, 0, 312, 0, 0, 0
3980, 1, 1636421405574, 1636421405882, 308, 0, 308, 0, 0, 0
3905, 2, 1636421396022, 1636421406022, 10000, 0, 10000, 0, 0, 0
3981, 1, 1636421405830, 1636421406098, 268, 0, 268, 0, 0, 0
3983, 1, 1636421405918, 1636421406190, 272, 0, 272, 0, 0, 0
3982, 1, 1636421405918, 1636421406190, 272, 0, 272, 0, 0, 0
3907, 2, 1636421396202, 1636421406202, 10000, 0, 10000, 0, 0, 0
3985, 1, 1636421406006, 1636421406278, 272, 0, 272, 0, 0, 0
3986, 1, 1636421406006, 1636421406278, 272, 1, 271, 0, 1, 1
3987, 1, 1636421406198, 1636421406478, 280, 0, 280, 0, 0, 0
3988, 1, 1636421406250, 1636421406518, 268, 0, 268, 0, 0, 0
3990, 1, 1636421406294, 1636421406562, 268, 0, 268, 0, 0, 0
3992, 1, 1636421406330, 1636421406602, 272, 0, 272, 0, 0, 0
3993, 1, 1636421406490, 1636421406786, 296, 29, 267, 28, 0, 28
3995, 1, 1636421406586, 1636421406854, 268, 0, 268, 0, 0, 0
3997, 1, 1636421406678, 1636421406950, 272, 0, 272, 0, 0, 0
3998, 1, 1636421406678, 1636421407058, 380, 108, 272, 108, 0, 108
3999, 1, 1636421406874, 1636421407142, 268, 0, 268, 0, 0, 0
4000, 1, 1636421406914, 1636421407182, 268, 0, 268, 0, 0, 0
4002, 1, 1636421407002, 1636421407270, 268, 0, 268, 0, 0, 0
4003, 1, 1636421407186, 1636421407458, 272, 0, 272, 0, 0, 0
4004, 1, 1636421407246, 1636421407518, 272, 0, 272, 0, 0, 0
4005, 1, 1636421407346, 1636421407618, 272, 0, 272, 0, 0, 0
4007, 1, 1636421407546, 1636421407814, 268, 0, 268, 0, 0, 0
4008, 1, 1636421407578, 1636421407850, 272, 0, 272, 0, 0, 0
4009, 1, 1636421407666, 1636421407942, 276, 1, 275, 0, 0, 0
4010, 1, 1636421407850, 1636421408118, 268, 1, 267, 0, 1, 1
4012, 1, 1636421408018, 1636421408290, 272, 0, 272, 0, 0, 0
4013, 1, 1636421408214, 1636421408486, 272, 0, 272, 0, 0, 0
4014, 1, 1636421408250, 1636421408522, 272, 0, 272, 0, 0, 0
4015, 1, 1636421408346, 1636421408622, 276, 0, 276, 0, 0, 0
4016, 1, 1636421408514, 1636421408794, 280, 9, 271, 9, 0, 9
3924, 2, 1636421398874, 1636421408874, 10000, 0, 10000, 0, 0, 0
4017, 1, 1636421408686, 1636421408958, 272, 0, 272, 0, 0, 0
4018, 1, 1636421408922, 1636421409190, 268, 0, 268, 0, 0, 0
4019, 1, 1636421408922, 1636421409190, 268, 0, 268, 0, 0, 0
3926, 2, 1636421399274, 1636421409274, 10000, 0, 10000, 0, 0, 0
4020, 1, 1636421409058, 1636421409330, 272, 0, 272, 0, 0, 0
4021, 1, 1636421409182, 1636421409502, 320, 0, 320, 0, 0, 0
4022, 1, 1636421409186, 1636421409502, 316, 5, 311, 5, 0, 5
4023, 1, 1636421409366, 1636421409638, 272, 1, 271, 0, 0, 0
4024, 1, 1636421409582, 1636421409854, 272, 0, 272, 0, 0, 0
4026, 1, 1636421409590, 1636421409858, 268, 0, 268, 0, 0, 0
4025, 1, 1636421409586, 1636421409858, 272, 0, 272, 0, 0, 0
4027, 1, 1636421409734, 1636421410002, 268, 0, 268, 0, 0, 0
4028, 1, 1636421409894, 1636421410166, 272, 0, 272, 0, 0, 0
4029, 1, 1636421409898, 1636421410166, 268, 0, 268, 0, 0, 0
3931, 2, 1636421400218, 1636421410226, 10008, 0, 10008, 0, 0, 0
4030, 1, 1636421410034, 1636421410306, 272, 0, 272, 0, 0, 0
4033, 1, 1636421410274, 1636421410542, 268, 0, 268, 0, 0, 0
4034, 1, 1636421410402, 1636421410678, 276, 0, 276, 0, 0, 0
4036, 1, 1636421410562, 1636421410834, 272, 0, 272, 0, 0, 0
4037, 1, 1636421410566, 1636421410834, 268, 1, 267, 0, 0, 0
4038, 1, 1636421410706, 1636421410974, 268, 0, 268, 0, 0, 0
4039, 1, 1636421410938, 1636421411214, 276, 0, 276, 0, 0, 0
4040, 1, 1636421411078, 1636421411350, 272, 0, 272, 0, 0, 0
4041, 1, 1636421411230, 1636421411510, 280, 0, 280, 0, 0, 0
4042, 1, 1636421411234, 1636421411510, 276, 0, 276, 0, 0, 0
4043, 1, 1636421411370, 1636421411642, 272, 0, 272, 0, 0, 0
4044, 1, 1636421411614, 1636421411886, 272, 0, 272, 0, 0, 0
4045, 1, 1636421411746, 1636421412014, 268, 0, 268, 0, 0, 0
4047, 1, 1636421411902, 1636421412178, 276, 0, 276, 0, 0, 0
4046, 1, 1636421411910, 1636421412178, 268, 0, 268, 0, 0, 0
4048, 1, 1636421412046, 1636421412318, 272, 0, 272, 0, 0, 0
4049, 1, 1636421412282, 1636421412554, 272, 0, 272, 0, 0, 0
4050, 1, 1636421412410, 1636421412682, 272, 1, 271, 0, 0, 0
4051, 1, 1636421412574, 1636421412846, 272, 1, 271, 0, 0, 0
4052, 1, 1636421412574, 1636421412846, 272, 1, 271, 1, 0, 1
4053, 1, 1636421412714, 1636421412986, 272, 0, 272, 0, 0, 0
4054, 1, 1636421412950, 1636421413222, 272, 0, 272, 0, 0, 0
3952, 2, 1636421403330, 1636421413330, 10000, 0, 10000, 0, 0, 0
4055, 1, 1636421413078, 1636421413378, 300, 0, 300, 0, 0, 0
4056, 1, 1636421413238, 1636421413510, 272, 0, 272, 0, 0, 0
4057, 1, 1636421413242, 1636421413558, 316, 0, 316, 0, 0, 0
4059, 1, 1636421413618, 1636421413894, 276, 0, 276, 0, 0, 0
4060, 1, 1636421413638, 1636421413914, 276, 0, 276, 0, 0, 0
4062, 1, 1636421413902, 1636421414178, 276, 0, 276, 0, 0, 0
4063, 1, 1636421413954, 1636421414230, 276, 0, 276, 0, 0, 0
4064, 1, 1636421414290, 1636421414562, 272, 0, 272, 0, 0, 0
4065, 1, 1636421414318, 1636421414590, 272, 0, 272, 0, 0, 0
3966, 2, 1636421404638, 1636421414638, 10000, 0, 10000, 0, 0, 0
4066, 1, 1636421414574, 1636421414866, 292, 0, 292, 0, 0, 0
4067, 1, 1636421414626, 1636421414898, 272, 0, 272, 0, 0, 0
3971, 2, 1636421404982, 1636421414986, 10004, 0, 10004, 0, 0, 0
4068, 1, 1636421414946, 1636421415214, 268, 0, 268, 0, 0, 0
3974, 2, 1636421405246, 1636421415246, 10000, 0, 10000, 0, 0, 0
4070, 1, 1636421415030, 1636421415306, 276, 0, 276, 0, 0, 0
4073, 1, 1636421415294, 1636421415566, 272, 1, 271, 0, 1, 1
4072, 1, 1636421415294, 1636421415566, 272, 1, 271, 0, 1, 1
4074, 1, 1636421415550, 1636421415826, 276, 0, 276, 0, 0, 0
4075, 1, 1636421415606, 1636421415878, 272, 0, 272, 0, 0, 0
3984, 2, 1636421405962, 1636421415963, 10001, 0, 10001, 0, 0, 0
4076, 1, 1636421415702, 1636421416010, 308, 0, 308, 0, 0, 0
3989, 2, 1636421406246, 1636421416202, 9956, 0, 9956, 0, 0, 0
4077, 1, 1636421415962, 1636421416250, 288, 1, 287, 0, 1, 1
4078, 1, 1636421415962, 1636421416250, 288, 1, 287, 1, 0, 1
3991, 2, 1636421406294, 1636421416294, 10000, 0, 10000, 0, 0, 0
3994, 2, 1636421406514, 1636421416514, 10000, 0, 10000, 0, 0, 0
4079, 1, 1636421416250, 1636421416562, 312, 0, 312, 0, 0, 0
3996, 2, 1636421406590, 1636421416590, 10000, 0, 10000, 0, 0, 0
4080, 1, 1636421416338, 1636421416650, 312, 0, 312, 0, 0, 0
4081, 1, 1636421416338, 1636421416650, 312, 0, 312, 0, 0, 0
4082, 1, 1636421416410, 1636421416726, 316, 0, 316, 0, 0, 0
4083, 1, 1636421416562, 1636421416834, 272, 0, 272, 0, 0, 0
4001, 2, 1636421406958, 1636421416958, 10000, 0, 10000, 0, 0, 0
4086, 1, 1636421416694, 1636421417006, 312, 0, 312, 0, 0, 0
4088, 1, 1636421416894, 1636421417190, 296, 0, 296, 0, 0, 0
4091, 1, 1636421417054, 1636421417326, 272, 0, 272, 0, 0, 0
4092, 1, 1636421417138, 1636421417406, 268, 0, 268, 0, 0, 0
4006, 2, 1636421407454, 1636421417454, 10000, 0, 10000, 0, 0, 0
4093, 1, 1636421417230, 1636421417502, 272, 1, 271, 0, 0, 0
4094, 1, 1636421417266, 1636421417538, 272, 0, 272, 0, 0, 0
4096, 1, 1636421417630, 1636421417902, 272, 0, 272, 0, 0, 0
4011, 2, 1636421407910, 1636421417910, 10000, 0, 10000, 0, 0, 0
4098, 1, 1636421417762, 1636421418046, 284, 0, 284, 0, 0, 0
4099, 1, 1636421417802, 1636421418074, 272, 0, 272, 0, 0, 0
4100, 1, 1636421417898, 1636421418166, 268, 0, 268, 0, 0, 0
4101, 1, 1636421417954, 1636421418226, 272, 0, 272, 0, 0, 0
4103, 1, 1636421418294, 1636421418566, 272, 0, 272, 0, 0, 0
4104, 1, 1636421418442, 1636421418714, 272, 1, 271, 0, 1, 1
4105, 1, 1636421418562, 1636421418842, 280, 0, 280, 0, 0, 0
4106, 1, 1636421418626, 1636421418898, 272, 0, 272, 0, 0, 0
4107, 1, 1636421418962, 1636421419238, 276, 0, 276, 0, 0, 0
4108, 1, 1636421419110, 1636421419382, 272, 0, 272, 0, 0, 0
4109, 1, 1636421419238, 1636421419510, 272, 1, 271, 0, 1, 1
4110, 1, 1636421419294, 1636421419562, 268, 0, 268, 0, 0, 0
4111, 1, 1636421419634, 1636421419906, 272, 0, 272, 0, 0, 0
4113, 1, 1636421419910, 1636421420178, 268, 0, 268, 0, 0, 0
4114, 1, 1636421419958, 1636421420230, 272, 0, 272, 0, 0, 0
4032, 2, 1636421410274, 1636421420274, 10000, 0, 10000, 0, 0, 0
4031, 2, 1636421410274, 1636421420318, 10044, 0, 10044, 0, 0, 0
4035, 2, 1636421410522, 1636421420522, 10000, 0, 10000, 0, 0, 0
4115, 1, 1636421420362, 1636421420662, 300, 0, 300, 0, 0, 0
4116, 1, 1636421420570, 1636421420846, 276, 0, 276, 0, 0, 0
4117, 1, 1636421420614, 1636421420886, 272, 0, 272, 0, 0, 0
4119, 1, 1636421420626, 1636421420926, 300, 36, 264, 36, 0, 36
4120, 1, 1636421420826, 1636421421098, 272, 0, 272, 0, 0, 0
4121, 1, 1636421421058, 1636421421330, 272, 0, 272, 0, 0, 0
4122, 1, 1636421421246, 1636421421518, 272, 0, 272, 0, 0, 0
4124, 1, 1636421421322, 1636421421606, 284, 9, 275, 8, 1, 9
4125, 1, 1636421421494, 1636421421766, 272, 0, 272, 0, 0, 0
4126, 1, 1636421421726, 1636421421998, 272, 0, 272, 0, 0, 0
4127, 1, 1636421421914, 1636421422186, 272, 0, 272, 0, 0, 0
4128, 1, 1636421422006, 1636421422279, 273, 0, 273, 0, 0, 0
4130, 1, 1636421422398, 1636421422670, 272, 1, 271, 0, 0, 0
4131, 1, 1636421422582, 1636421422858, 276, 0, 276, 0, 0, 0
4132, 1, 1636421422674, 1636421422946, 272, 0, 272, 0, 0, 0
4133, 1, 1636421423066, 1636421423338, 272, 0, 272, 0, 0, 0
4058, 2, 1636421413422, 1636421423422, 10000, 0, 10000, 0, 0, 0
4134, 1, 1636421423254, 1636421423558, 304, 0, 304, 0, 0, 0
4135, 1, 1636421423342, 1636421423650, 308, 0, 308, 0, 0, 0
4061, 2, 1636421413774, 1636421423774, 10000, 0, 10000, 0, 0, 0
4136, 1, 1636421423730, 1636421424002, 272, 1, 271, 0, 0, 0
4137, 1, 1636421423738, 1636421424006, 268, 0, 268, 0, 0, 0
4139, 1, 1636421424046, 1636421424318, 272, 0, 272, 0, 0, 0
4140, 1, 1636421424082, 1636421424358, 276, 0, 276, 0, 0, 0
4141, 1, 1636421424398, 1636421424674, 276, 0, 276, 0, 0, 0
4069, 2, 1636421414962, 1636421424962, 10000, 0, 10000, 0, 0, 0
4144, 1, 1636421424754, 1636421425026, 272, 0, 272, 0, 0, 0
4071, 2, 1636421415294, 1636421425294, 10000, 0, 10000, 0, 0, 0
4145, 1, 1636421425074, 1636421425342, 268, 0, 268, 0, 0, 0
4146, 1, 1636421425270, 1636421425546, 276, 0, 276, 0, 0, 0
4147, 1, 1636421425422, 1636421425698, 276, 0, 276, 0, 0, 0
4148, 1, 1636421425598, 1636421425870, 272, 0, 272, 0, 0, 0
4149, 1, 1636421425746, 1636421426018, 272, 0, 272, 0, 0, 0
4151, 1, 1636421426094, 1636421426362, 268, 0, 268, 0, 0, 0
4084, 2, 1636421416634, 1636421426638, 10004, 0, 10004, 0, 0, 0
4153, 1, 1636421426414, 1636421426686, 272, 0, 272, 0, 0, 0
4085, 2, 1636421416694, 1636421426694, 10000, 0, 10000, 0, 0, 0
4087, 2, 1636421416854, 1636421426854, 10000, 0, 10000, 0, 0, 0
4089, 2, 1636421416958, 1636421426958, 10000, 0, 10000, 0, 0, 0
4090, 2, 1636421417050, 1636421427050, 10000, 0, 10000, 0, 0, 0
4154, 1, 1636421426782, 1636421427098, 316, 1, 315, 0, 0, 0
4157, 1, 1636421427098, 1636421427370, 272, 1, 271, 0, 1, 1
4095, 2, 1636421417406, 1636421427406, 10000, 0, 10000, 0, 0, 0
4158, 1, 1636421427162, 1636421427454, 292, 0, 292, 0, 0, 0
4159, 1, 1636421427262, 1636421427546, 284, 0, 284, 0, 0, 0
4160, 1, 1636421427354, 1636421427634, 280, 0, 280, 0, 0, 0
4097, 2, 1636421417722, 1636421427722, 10000, 0, 10000, 0, 0, 0
4161, 1, 1636421427494, 1636421427770, 276, 0, 276, 0, 0, 0
4162, 1, 1636421427714, 1636421427986, 272, 0, 272, 0, 0, 0
4163, 1, 1636421427770, 1636421428034, 264, 0, 264, 0, 0, 0
4164, 1, 1636421427854, 1636421428118, 264, 0, 264, 0, 0, 0
4102, 2, 1636421418210, 1636421428210, 10000, 0, 10000, 0, 0, 0
4165, 1, 1636421427954, 1636421428258, 304, 0, 304, 0, 0, 0
4167, 1, 1636421428030, 1636421428294, 264, 0, 264, 0, 0, 0
4166, 1, 1636421428026, 1636421428298, 272, 0, 272, 0, 0, 0
4168, 1, 1636421428170, 1636421428438, 268, 0, 268, 0, 0, 0
4169, 1, 1636421428386, 1636421428650, 264, 0, 264, 0, 0, 0
4171, 1, 1636421428514, 1636421428786, 272, 0, 272, 0, 0, 0
4170, 1, 1636421428510, 1636421428786, 276, 0, 276, 0, 0, 0
4172, 1, 1636421428658, 1636421428934, 276, 0, 276, 0, 0, 0
4173, 1, 1636421428686, 1636421428958, 272, 0, 272, 0, 0, 0
4174, 1, 1636421428702, 1636421428966, 264, 0, 264, 0, 0, 0
4175, 1, 1636421429046, 1636421429318, 272, 0, 272, 0, 0, 0
4177, 1, 1636421429182, 1636421429454, 272, 0, 272, 0, 0, 0
4176, 1, 1636421429186, 1636421429454, 268, 0, 268, 0, 0, 0
4180, 1, 1636421429362, 1636421429630, 268, 0, 268, 0, 0, 0
4179, 1, 1636421429358, 1636421429630, 272, 0, 272, 0, 0, 0
4112, 2, 1636421419778, 1636421429778, 10000, 0, 10000, 0, 0, 0
4181, 1, 1636421429714, 1636421430006, 292, 0, 292, 0, 0, 0
4182, 1, 1636421429870, 1636421430142, 272, 0, 272, 0, 0, 0
4184, 1, 1636421430026, 1636421430307, 281, 1, 280, 0, 1, 1
4186, 1, 1636421430086, 1636421430354, 268, 0, 268, 0, 0, 0
4118, 2, 1636421420614, 1636421430615, 10001, 0, 10001, 0, 0, 0
4187, 1, 1636421430402, 1636421430678, 276, 1, 275, 0, 0, 0
4188, 1, 1636421430542, 1636421430838, 296, 0, 296, 0, 0, 0
4189, 1, 1636421430706, 1636421430970, 264, 0, 264, 0, 0, 0
4190, 1, 1636421430794, 1636421431058, 264, 0, 264, 0, 0, 0
4123, 2, 1636421421286, 1636421431286, 10000, 0, 10000, 0, 0, 0
4192, 1, 1636421431082, 1636421431350, 268, 0, 268, 0, 0, 0
4193, 1, 1636421431234, 1636421431514, 280, 0, 280, 0, 0, 0
4194, 1, 1636421431374, 1636421431646, 272, 1, 271, 0, 0, 0
4195, 1, 1636421431462, 1636421431734, 272, 0, 272, 0, 0, 0
4197, 1, 1636421431746, 1636421432018, 272, 0, 272, 0, 0, 0
4129, 2, 1636421422158, 1636421432158, 10000, 0, 10000, 0, 0, 0
4198, 1, 1636421431910, 1636421432202, 292, 0, 292, 0, 0, 0
4199, 1, 1636421432038, 1636421432306, 268, 1, 267, 0, 0, 0
4200, 1, 1636421432130, 1636421432394, 264, 0, 264, 0, 0, 0
4201, 1, 1636421432414, 1636421432682, 268, 1, 267, 0, 0, 0
4202, 1, 1636421432466, 1636421432734, 268, 0, 268, 0, 0, 0
4203, 1, 1636421432606, 1636421432882, 276, 0, 276, 0, 0, 0
4204, 1, 1636421432698, 1636421432970, 272, 0, 272, 0, 0, 0
4205, 1, 1636421432794, 1636421433062, 268, 0, 268, 0, 0, 0
4206, 1, 1636421433078, 1636421433354, 276, 0, 276, 0, 0, 0
4207, 1, 1636421433130, 1636421433402, 272, 0, 272, 0, 0, 0
4208, 1, 1636421433278, 1636421433546, 268, 1, 267, 0, 1, 1
4209, 1, 1636421433362, 1636421433630, 268, 0, 268, 0, 0, 0
4210, 1, 1636421433458, 1636421433734, 276, 0, 276, 0, 0, 0
4138, 2, 1636421423954, 1636421433954, 10000, 0, 10000, 0, 0, 0
4211, 1, 1636421433750, 1636421434022, 272, 0, 272, 0, 0, 0
4212, 1, 1636421433802, 1636421434090, 288, 0, 288, 0, 0, 0
4213, 1, 1636421433942, 1636421434214, 272, 0, 272, 0, 0, 0
4214, 1, 1636421434042, 1636421434314, 272, 0, 272, 0, 0, 0
4142, 2, 1636421424402, 1636421434402, 10000, 0, 10000, 0, 0, 0
4215, 1, 1636421434130, 1636421434450, 320, 0, 320, 0, 0, 0
4216, 1, 1636421434262, 1636421434538, 276, 0, 276, 0, 0, 0
4143, 2, 1636421424714, 1636421434714, 10000, 0, 10000, 0, 0, 0
4217, 1, 1636421434450, 1636421434762, 312, 0, 312, 0, 0, 0
4220, 1, 1636421434706, 1636421434982, 276, 0, 276, 0, 0, 0
4222, 1, 1636421434846, 1636421435118, 272, 0, 272, 0, 0, 0
4223, 1, 1636421434942, 1636421435210, 268, 1, 267, 0, 0, 0
4224, 1, 1636421435022, 1636421435294, 272, 1, 271, 0, 0, 0
4226, 1, 1636421435378, 1636421435650, 272, 0, 272, 0, 0, 0
4227, 1, 1636421435514, 1636421435782, 268, 0, 268, 0, 0, 0
4228, 1, 1636421435606, 1636421435870, 264, 0, 264, 0, 0, 0
4150, 2, 1636421425942, 1636421435943, 10001, 0, 10001, 0, 0, 0
4229, 1, 1636421435690, 1636421435990, 300, 0, 300, 0, 0, 0
4152, 2, 1636421426270, 1636421436270, 10000, 0, 10000, 0, 0, 0
4230, 1, 1636421436046, 1636421436318, 272, 0, 272, 0, 0, 0
4231, 1, 1636421436178, 1636421436446, 268, 0, 268, 0, 0, 0
4233, 1, 1636421436266, 1636421436538, 272, 0, 272, 0, 0, 0
4234, 1, 1636421436386, 1636421436654, 268, 0, 268, 0, 0, 0
4236, 1, 1636421436718, 1636421436994, 276, 1, 275, 0, 0, 0
4155, 2, 1636421427006, 1636421437006, 10000, 0, 10000, 0, 0, 0
4156, 2, 1636421427098, 1636421437098, 10000, 0, 10000, 0, 0, 0
4237, 1, 1636421436842, 1636421437146, 304, 0, 304, 0, 0, 0
4238, 1, 1636421436938, 1636421437234, 296, 1, 295, 0, 0, 0
4239, 1, 1636421437054, 1636421437330, 276, 0, 276, 0, 0, 0
4240, 1, 1636421437314, 1636421437590, 276, 0, 276, 0, 0, 0
4241, 1, 1636421437390, 1636421437658, 268, 0, 268, 0, 0, 0
4242, 1, 1636421437410, 1636421437682, 272, 0, 272, 0, 0, 0
4244, 1, 1636421437630, 1636421437898, 268, 0, 268, 0, 0, 0
4245, 1, 1636421437726, 1636421437994, 268, 0, 268, 0, 0, 0
4246, 1, 1636421437990, 1636421438258, 268, 0, 268, 0, 0, 0
4247, 1, 1636421438054, 1636421438326, 272, 0, 272, 0, 0, 0
4248, 1, 1636421438078, 1636421438350, 272, 0, 272, 0, 0, 0
4249, 1, 1636421438294, 1636421438562, 268, 0, 268, 0, 0, 0
4250, 1, 1636421438390, 1636421438654, 264, 0, 264, 0, 0, 0
4251, 1, 1636421438654, 1636421438922, 268, 1, 267, 0, 1, 1
4252, 1, 1636421438726, 1636421438998, 272, 0, 272, 0, 0, 0
4254, 1, 1636421439050, 1636421439318, 268, 0, 268, 0, 0, 0
4178, 2, 1636421429330, 1636421439330, 10000, 0, 10000, 0, 0, 0
4255, 1, 1636421439318, 1636421439590, 272, 0, 272, 0, 0, 0
4183, 2, 1636421429870, 1636421439870, 10000, 0, 10000, 0, 0, 0
4256, 1, 1636421439638, 1636421439918, 280, 0, 280, 0, 0, 0
4185, 2, 1636421430026, 1636421440026, 10000, 0, 10000, 0, 0, 0
4257, 1, 1636421439986, 1636421440254, 268, 0, 268, 0, 0, 0
4258, 1, 1636421440198, 1636421440470, 272, 0, 272, 0, 0, 0
4259, 1, 1636421440314, 1636421440590, 276, 0, 276, 0, 0, 0
4260, 1, 1636421440334, 1636421440614, 280, 0, 280, 0, 0, 0
4191, 2, 1636421430922, 1636421440922, 10000, 0, 10000, 0, 0, 0
4261, 1, 1636421440650, 1636421440967, 317, 1, 316, 0, 0, 0
4262, 1, 1636421440862, 1636421441150, 288, 0, 288, 0, 0, 0
4263, 1, 1636421441014, 1636421441290, 276, 1, 275, 0, 0, 0
4264, 1, 1636421441014, 1636421441290, 276, 0, 276, 0, 0, 0
4265, 1, 1636421441234, 1636421441506, 272, 0, 272, 0, 0, 0
4196, 2, 1636421431594, 1636421441594, 10000, 0, 10000, 0, 0, 0
4266, 1, 1636421441366, 1636421441642, 276, 0, 276, 0, 0, 0
4267, 1, 1636421441542, 1636421441826, 284, 1, 283, 0, 0, 0
4268, 1, 1636421441686, 1636421441958, 272, 0, 272, 0, 0, 0
4269, 1, 1636421441690, 1636421441958, 268, 0, 268, 0, 0, 0
4271, 1, 1636421441902, 1636421442178, 276, 1, 275, 0, 0, 0
4272, 1, 1636421442038, 1636421442314, 276, 1, 275, 0, 0, 0
4275, 1, 1636421442354, 1636421442626, 272, 1, 271, 0, 1, 1
4274, 1, 1636421442354, 1636421442626, 272, 0, 272, 0, 0, 0
4276, 1, 1636421442574, 1636421442846, 272, 1, 271, 1, 0, 1
4277, 1, 1636421442710, 1636421442982, 272, 0, 272, 0, 0, 0
4279, 1, 1636421443022, 1636421443290, 268, 0, 268, 0, 0, 0
4278, 1, 1636421443022, 1636421443294, 272, 0, 272, 0, 0, 0
4280, 1, 1636421443242, 1636421443510, 268, 1, 267, 1, 0, 1
4281, 1, 1636421443378, 1636421443646, 268, 0, 268, 0, 0, 0
4282, 1, 1636421443686, 1636421443958, 272, 1, 271, 0, 1, 1
4283, 1, 1636421443686, 1636421443962, 276, 1, 275, 0, 0, 0
4284, 1, 1636421443906, 1636421444178, 272, 0, 272, 0, 0, 0
4285, 1, 1636421444042, 1636421444310, 268, 1, 267, 0, 0, 0
4218, 2, 1636421434494, 1636421444494, 10000, 0, 10000, 0, 0, 0
4219, 2, 1636421434610, 1636421444610, 10000, 0, 10000, 0, 0, 0
4286, 1, 1636421444354, 1636421444662, 308, 0, 308, 0, 0, 0
4287, 1, 1636421444354, 1636421444662, 308, 0, 308, 0, 0, 0
4221, 2, 1636421434706, 1636421444706, 10000, 0, 10000, 0, 0, 0
4288, 1, 1636421444582, 1636421444858, 276, 1, 275, 0, 0, 0
4290, 1, 1636421444802, 1636421445074, 272, 0, 272, 0, 0, 0
4225, 2, 1636421435158, 1636421445158, 10000, 0, 10000, 0, 0, 0
4292, 1, 1636421445018, 1636421445294, 276, 0, 276, 0, 0, 0
4293, 1, 1636421445054, 1636421445326, 272, 0, 272, 0, 0, 0
4294, 1, 1636421445062, 1636421445342, 280, 0, 280, 0, 0, 0
4295, 1, 1636421445254, 1636421445518, 264, 0, 264, 0, 0, 0
4296, 1, 1636421445470, 1636421445742, 272, 0, 272, 0, 0, 0
4297, 1, 1636421445470, 1636421445742, 272, 0, 272, 0, 0, 0
4298, 1, 1636421445686, 1636421445958, 272, 0, 272, 0, 0, 0
4299, 1, 1636421445722, 1636421445994, 272, 0, 272, 0, 0, 0
4300, 1, 1636421445742, 1636421446006, 264, 1, 263, 0, 1, 1
4301, 1, 1636421445914, 1636421446186, 272, 0, 272, 0, 0, 0
4232, 2, 1636421436250, 1636421446250, 10000, 0, 10000, 0, 0, 0
4302, 1, 1636421446138, 1636421446406, 268, 0, 268, 0, 0, 0
4303, 1, 1636421446138, 1636421446410, 272, 0, 272, 0, 0, 0
4235, 2, 1636421436578, 1636421446578, 10000, 0, 10000, 0, 0, 0
4304, 1, 1636421446350, 1636421446626, 276, 0, 276, 0, 0, 0
4305, 1, 1636421446426, 1636421446714, 288, 0, 288, 0, 0, 0
4306, 1, 1636421446426, 1636421446714, 288, 0, 288, 0, 0, 0
4308, 1, 1636421446622, 1636421446894, 272, 0, 272, 0, 0, 0
4309, 1, 1636421446802, 1636421447070, 268, 0, 268, 0, 0, 0
4310, 1, 1636421446806, 1636421447074, 268, 0, 268, 0, 0, 0
4312, 1, 1636421447018, 1636421447294, 276, 1, 275, 0, 0, 0
4313, 1, 1636421447110, 1636421447382, 272, 1, 271, 0, 0, 0
4243, 2, 1636421437542, 1636421447542, 10000, 0, 10000, 0, 0, 0
4315, 1, 1636421447294, 1636421447590, 296, 1, 295, 0, 1, 1
4317, 1, 1636421447466, 1636421447770, 304, 1, 303, 1, 0, 1
4316, 1, 1636421447466, 1636421447770, 304, 1, 303, 0, 1, 1
4318, 1, 1636421447718, 1636421447990, 272, 0, 272, 0, 0, 0
4320, 1, 1636421447850, 1636421448122, 272, 0, 272, 0, 0, 0
4321, 1, 1636421447990, 1636421448258, 268, 1, 267, 0, 1, 1
4323, 1, 1636421448170, 1636421448434, 264, 1, 263, 0, 1, 1
4322, 1, 1636421448170, 1636421448438, 268, 1, 267, 0, 0, 0
4324, 1, 1636421448382, 1636421448654, 272, 1, 271, 0, 1, 1
4253, 2, 1636421438750, 1636421448750, 10000, 0, 10000, 0, 0, 0
4325, 1, 1636421448526, 1636421448798, 272, 1, 271, 0, 1, 1
4328, 1, 1636421448838, 1636421449118, 280, 0, 280, 0, 0, 0
4327, 1, 1636421448842, 1636421449118, 276, 0, 276, 0, 0, 0
4329, 1, 1636421449050, 1636421449322, 272, 0, 272, 0, 0, 0
4330, 1, 1636421449058, 1636421449330, 272, 0, 272, 0, 0, 0
4331, 1, 1636421449194, 1636421449462, 268, 0, 268, 0, 0, 0
4334, 1, 1636421449734, 1636421450006, 272, 0, 272, 0, 0, 0
4335, 1, 1636421449858, 1636421450130, 272, 0, 272, 0, 0, 0
4336, 1, 1636421450406, 1636421450678, 272, 1, 271, 0, 1, 1
4337, 1, 1636421450526, 1636421450794, 268, 1, 267, 0, 0, 0
4339, 1, 1636421451190, 1636421451467, 277, 1, 276, 0, 0, 0
4270, 2, 1636421441902, 1636421451902, 10000, 0, 10000, 0, 0, 0
4273, 2, 1636421442218, 1636421452218, 10000, 0, 10000, 0, 0, 0
4341, 1, 1636421452210, 1636421452482, 272, 1, 271, 0, 0, 0
4342, 1, 1636421452518, 1636421452794, 276, 1, 275, 1, 0, 1
4343, 1, 1636421452878, 1636421453154, 276, 1, 275, 0, 0, 0
4344, 1, 1636421453186, 1636421453462, 276, 0, 276, 0, 0, 0
4345, 1, 1636421453550, 1636421453818, 268, 0, 268, 0, 0, 0
4346, 1, 1636421453854, 1636421454130, 276, 0, 276, 0, 0, 0
4347, 1, 1636421454214, 1636421454486, 272, 0, 272, 0, 0, 0
4289, 2, 1636421444706, 1636421454706, 10000, 0, 10000, 0, 0, 0
4348, 1, 1636421454526, 1636421454846, 320, 1, 319, 0, 0, 0
4291, 2, 1636421444922, 1636421454918, 9996, 0, 9996, 0, 0, 0
4349, 1, 1636421454882, 1636421455150, 268, 0, 268, 0, 0, 0
4351, 1, 1636421455230, 1636421455502, 272, 0, 272, 0, 0, 0
4352, 1, 1636421455238, 1636421455510, 272, 0, 272, 0, 0, 0
4353, 1, 1636421455550, 1636421455822, 272, 0, 272, 0, 0, 0
4354, 1, 1636421455898, 1636421456166, 268, 1, 267, 0, 0, 0
4355, 1, 1636421455906, 1636421456178, 272, 0, 272, 0, 0, 0
4356, 1, 1636421456218, 1636421456490, 272, 0, 272, 0, 0, 0
4307, 2, 1636421446558, 1636421456558, 10000, 0, 10000, 0, 0, 0
4358, 1, 1636421456606, 1636421456878, 272, 1, 271, 0, 0, 0
4311, 2, 1636421446886, 1636421456886, 10000, 0, 10000, 0, 0, 0
4314, 2, 1636421447110, 1636421457110, 10000, 0, 10000, 0, 0, 0
4359, 1, 1636421456866, 1636421457158, 292, 0, 292, 0, 0, 0
4360, 1, 1636421456930, 1636421457202, 272, 0, 272, 0, 0, 0
4361, 1, 1636421457198, 1636421457466, 268, 0, 268, 0, 0, 0
4363, 1, 1636421457414, 1636421457686, 272, 1, 271, 0, 0, 0
4319, 2, 1636421447782, 1636421457782, 10000, 0, 10000, 0, 0, 0
4364, 1, 1636421457558, 1636421457830, 272, 0, 272, 0, 0, 0
4365, 1, 1636421457598, 1636421457870, 272, 1, 271, 0, 0, 0
4366, 1, 1636421457870, 1636421458138, 268, 1, 267, 0, 0, 0
4368, 1, 1636421458082, 1636421458354, 272, 0, 272, 0, 0, 0
4367, 1, 1636421458082, 1636421458354, 272, 0, 272, 0, 0, 0
4369, 1, 1636421458230, 1636421458506, 276, 1, 275, 0, 0, 0
4370, 1, 1636421458266, 1636421458534, 268, 0, 268, 0, 0, 0
4326, 2, 1636421448654, 1636421458654, 10000, 0, 10000, 0, 0, 0
4371, 1, 1636421458530, 1636421458798, 268, 0, 268, 0, 0, 0
4372, 1, 1636421458750, 1636421459022, 272, 0, 272, 0, 0, 0
4373, 1, 1636421458750, 1636421459022, 272, 0, 272, 0, 0, 0
4374, 1, 1636421458906, 1636421459182, 276, 0, 276, 0, 0, 0
4375, 1, 1636421458930, 1636421459202, 272, 0, 272, 0, 0, 0
4377, 1, 1636421459194, 1636421459462, 268, 0, 268, 0, 0, 0
4332, 2, 1636421449514, 1636421459514, 10000, 0, 10000, 0, 0, 0
4333, 2, 1636421449514, 1636421459558, 10044, 0, 10044, 1, 0, 1
4378, 1, 1636421459418, 1636421459694, 276, 0, 276, 0, 0, 0
4379, 1, 1636421459422, 1636421459694, 272, 0, 272, 0, 0, 0
4380, 1, 1636421459602, 1636421459874, 272, 0, 272, 0, 0, 0
4382, 1, 1636421459818, 1636421460090, 272, 0, 272, 0, 0, 0
4383, 1, 1636421459858, 1636421460138, 280, 17, 263, 17, 0, 17
4384, 1, 1636421460090, 1636421460358, 268, 1, 267, 0, 0, 0
4385, 1, 1636421460090, 1636421460362, 272, 0, 272, 0, 0, 0
4386, 1, 1636421460270, 1636421460542, 272, 0, 272, 0, 0, 0
4387, 1, 1636421460486, 1636421460766, 280, 1, 279, 0, 0, 0
4388, 1, 1636421460530, 1636421460818, 288, 13, 275, 13, 0, 13
4389, 1, 1636421460754, 1636421461026, 272, 0, 272, 0, 0, 0
4390, 1, 1636421460766, 1636421461038, 272, 1, 271, 0, 1, 1
4338, 2, 1636421451074, 1636421461074, 10000, 0, 10000, 0, 0, 0
4391, 1, 1636421460938, 1636421461214, 276, 1, 275, 0, 1, 1
4392, 1, 1636421461162, 1636421461434, 272, 0, 272, 0, 0, 0
4393, 1, 1636421461250, 1636421461518, 268, 0, 268, 0, 0, 0
4394, 1, 1636421461382, 1636421461654, 272, 0, 272, 0, 0, 0
4395, 1, 1636421461422, 1636421461694, 272, 1, 271, 0, 0, 0
4340, 2, 1636421451862, 1636421461862, 10000, 0, 10000, 0, 0, 0
4397, 1, 1636421461618, 1636421461906, 288, 1, 287, 0, 0, 0
4399, 1, 1636421461910, 1636421462186, 276, 0, 276, 0, 0, 0
4400, 1, 1636421462050, 1636421462326, 276, 0, 276, 0, 0, 0
4402, 1, 1636421462302, 1636421462574, 272, 1, 271, 0, 0, 0
4403, 1, 1636421462578, 1636421462850, 272, 0, 272, 0, 0, 0
4404, 1, 1636421462726, 1636421462994, 268, 1, 267, 0, 1, 1
4405, 1, 1636421462970, 1636421463242, 272, 0, 272, 0, 0, 0
4406, 1, 1636421463242, 1636421463514, 272, 1, 271, 1, 0, 1
4407, 1, 1636421463390, 1636421463662, 272, 0, 272, 0, 0, 0
4408, 1, 1636421463638, 1636421463910, 272, 1, 271, 0, 0, 0
4409, 1, 1636421463906, 1636421464182, 276, 4, 272, 4, 0, 4
4410, 1, 1636421464058, 1636421464334, 276, 0, 276, 0, 0, 0
4413, 1, 1636421464730, 1636421465006, 276, 0, 276, 0, 0, 0
4350, 2, 1636421455014, 1636421465014, 10000, 0, 10000, 0, 0, 0
4414, 1, 1636421465322, 1636421465594, 272, 0, 272, 0, 0, 0
4415, 1, 1636421465402, 1636421465678, 276, 0, 276, 0, 0, 0
4416, 1, 1636421465990, 1636421466266, 276, 1, 275, 0, 0, 0
4357, 2, 1636421456606, 1636421466606, 10000, 0, 10000, 0, 0, 0
4419, 1, 1636421466914, 1636421467190, 276, 1, 275, 0, 0, 0
4362, 2, 1636421457286, 1636421467286, 10000, 0, 10000, 0, 0, 0
4421, 1, 1636421467590, 1636421467858, 268, 0, 268, 0, 0, 0
4420, 1, 1636421467586, 1636421467858, 272, 0, 272, 0, 0, 0
4423, 1, 1636421468258, 1636421468526, 268, 0, 268, 0, 0, 0
4422, 1, 1636421468254, 1636421468526, 272, 0, 272, 0, 0, 0
4376, 2, 1636421458962, 1636421468962, 10000, 0, 10000, 0, 0, 0
4424, 1, 1636421468922, 1636421469194, 272, 1, 271, 0, 1, 1
4426, 1, 1636421469270, 1636421469542, 272, 0, 272, 0, 0, 0
4381, 2, 1636421459606, 1636421469602, 9996, 0, 9996, 0, 0, 0
4429, 1, 1636421469938, 1636421470210, 272, 0, 272, 0, 0, 0
4396, 2, 1636421461438, 1636421471438, 10000, 0, 10000, 0, 0, 0
4398, 2, 1636421461830, 1636421471830, 10000, 0, 10000, 0, 0, 0
4401, 2, 1636421462086, 1636421472086, 10000, 0, 10000, 0, 0, 0
4417, 1, 1636421466074, 1636421472358, 6284, 6012, 272, 0, 6012, 6012
4431, 1, 1636421472134, 1636421472406, 272, 0, 272, 0, 0, 0
4432, 1, 1636421472754, 1636421473030, 276, 1, 275, 0, 0, 0
4433, 1, 1636421472802, 1636421473078, 276, 0, 276, 0, 0, 0
4434, 1, 1636421473430, 1636421473698, 268, 0, 268, 0, 0, 0
4435, 1, 1636421473474, 1636421473746, 272, 0, 272, 0, 0, 0
4411, 2, 1636421464306, 1636421474306, 10000, 0, 10000, 0, 0, 0
4436, 1, 1636421474094, 1636421474366, 272, 1, 271, 0, 0, 0
4437, 1, 1636421474146, 1636421474442, 296, 0, 296, 0, 0, 0
4412, 2, 1636421464574, 1636421474574, 10000, 0, 10000, 0, 0, 0
4440, 1, 1636421474838, 1636421475114, 276, 0, 276, 0, 0, 0
4442, 1, 1636421475510, 1636421475786, 276, 1, 275, 1, 0, 1
4443, 1, 1636421476182, 1636421476455, 273, 0, 273, 0, 0, 0
4418, 2, 1636421466698, 1636421476698, 10000, 0, 10000, 0, 0, 0
4444, 1, 1636421477006, 1636421477282, 276, 0, 276, 0, 0, 0
4445, 1, 1636421477678, 1636421477958, 280, 0, 280, 0, 0, 0
4446, 1, 1636421478354, 1636421478630, 276, 1, 275, 0, 0, 0
4425, 2, 1636421468922, 1636421478923, 10001, 0, 10001, 0, 0, 0
4448, 1, 1636421479230, 1636421479507, 277, 1, 276, 0, 1, 1
4427, 2, 1636421469586, 1636421479586, 10000, 0, 10000, 0, 0, 0
4428, 2, 1636421469914, 1636421479914, 10000, 0, 10000, 0, 0, 0
4449, 1, 1636421479886, 1636421480158, 272, 0, 272, 0, 0, 0
4450, 1, 1636421479906, 1636421480186, 280, 0, 280, 0, 0, 0
4451, 1, 1636421480218, 1636421480494, 276, 0, 276, 0, 0, 0
4430, 2, 1636421470606, 1636421480606, 10000, 0, 10000, 0, 0, 0
4452, 1, 1636421480554, 1636421480834, 280, 0, 280, 0, 0, 0
4453, 1, 1636421480582, 1636421480846, 264, 0, 264, 0, 0, 0
4454, 1, 1636421480894, 1636421481166, 272, 0, 272, 0, 0, 0
4455, 1, 1636421480914, 1636421481186, 272, 0, 272, 0, 0, 0
4456, 1, 1636421481226, 1636421481502, 276, 0, 276, 0, 0, 0
4457, 1, 1636421481242, 1636421481514, 272, 0, 272, 0, 0, 0
4459, 1, 1636421481586, 1636421481854, 268, 0, 268, 0, 0, 0
4460, 1, 1636421481898, 1636421482174, 276, 0, 276, 0, 0, 0
4461, 1, 1636421481910, 1636421482186, 276, 0, 276, 0, 0, 0
4462, 1, 1636421482250, 1636421482522, 272, 0, 272, 0, 0, 0
4463, 1, 1636421482570, 1636421482842, 272, 0, 272, 0, 0, 0
4464, 1, 1636421482582, 1636421482854, 272, 1, 271, 0, 0, 0
4466, 1, 1636421483238, 1636421483506, 268, 1, 267, 0, 0, 0
4467, 1, 1636421483250, 1636421483522, 272, 0, 272, 0, 0, 0
4468, 1, 1636421483898, 1636421484174, 276, 0, 276, 0, 0, 0
4469, 1, 1636421483922, 1636421484442, 520, 253, 267, 253, 0, 253
4438, 2, 1636421474618, 1636421484622, 10004, 0, 10004, 0, 0, 0
4439, 2, 1636421474762, 1636421484762, 10000, 0, 10000, 0, 0, 0
4441, 2, 1636421474882, 1636421484882, 10000, 0, 10000, 0, 0, 0
4470, 1, 1636421484850, 1636421485122, 272, 0, 272, 0, 0, 0
4471, 1, 1636421484970, 1636421485242, 272, 1, 271, 0, 0, 0
4472, 1, 1636421485070, 1636421485346, 276, 1, 275, 0, 0, 0
4473, 1, 1636421485190, 1636421485514, 324, 53, 271, 53, 0, 53
4474, 1, 1636421485518, 1636421485794, 276, 0, 276, 0, 0, 0
4475, 1, 1636421485638, 1636421485910, 272, 1, 271, 0, 1, 1
4476, 1, 1636421485746, 1636421486026, 280, 1, 279, 0, 1, 1
4477, 1, 1636421485906, 1636421486186, 280, 5, 275, 5, 0, 5
4478, 1, 1636421486194, 1636421486466, 272, 0, 272, 0, 0, 0
4480, 1, 1636421486422, 1636421486694, 272, 0, 272, 0, 0, 0
4483, 1, 1636421487090, 1636421487370, 280, 1, 279, 0, 0, 0
4484, 1, 1636421487766, 1636421488042, 276, 0, 276, 0, 0, 0
4485, 1, 1636421488438, 1636421488714, 276, 0, 276, 0, 0, 0
4447, 2, 1636421479026, 1636421489026, 10000, 0, 10000, 0, 0, 0
4486, 1, 1636421489114, 1636421489394, 280, 1, 279, 0, 0, 0
4487, 1, 1636421489334, 1636421489610, 276, 1, 275, 0, 1, 1
4488, 1, 1636421490006, 1636421490283, 277, 1, 276, 0, 0, 0
4489, 1, 1636421490678, 1636421490954, 276, 0, 276, 0, 0, 0
4458, 2, 1636421481562, 1636421491562, 10000, 0, 10000, 0, 0, 0
4490, 1, 1636421491350, 1636421491622, 272, 1, 271, 0, 0, 0
4491, 1, 1636421491866, 1636421492142, 276, 0, 276, 0, 0, 0
4492, 1, 1636421492018, 1636421492290, 272, 1, 271, 0, 0, 0
4493, 1, 1636421492542, 1636421492818, 276, 1, 275, 0, 1, 1
4465, 2, 1636421482918, 1636421492918, 10000, 0, 10000, 0, 0, 0
4494, 1, 1636421492686, 1636421493090, 404, 133, 271, 133, 0, 133
4495, 1, 1636421493214, 1636421493486, 272, 0, 272, 0, 0, 0
4496, 1, 1636421493234, 1636421493510, 276, 1, 275, 0, 0, 0
4497, 1, 1636421493486, 1636421493766, 280, 1, 279, 0, 1, 1
4499, 1, 1636421493906, 1636421494178, 272, 1, 271, 0, 0, 0
4500, 1, 1636421494162, 1636421494438, 276, 0, 276, 0, 0, 0
4501, 1, 1636421494582, 1636421494854, 272, 1, 271, 0, 1, 1
4502, 1, 1636421494834, 1636421495110, 276, 0, 276, 0, 0, 0
4503, 1, 1636421495250, 1636421495522, 272, 0, 272, 0, 0, 0
4504, 1, 1636421495506, 1636421495778, 272, 1, 271, 0, 1, 1
4505, 1, 1636421495918, 1636421496190, 272, 1, 271, 0, 0, 0
4479, 2, 1636421486306, 1636421496310, 10004, 0, 10004, 0, 0, 0
4506, 1, 1636421496174, 1636421496450, 276, 0, 276, 0, 0, 0
4481, 2, 1636421486582, 1636421496582, 10000, 0, 10000, 0, 0, 0
4482, 2, 1636421486862, 1636421496862, 10000, 0, 10000, 0, 0, 0
4508, 1, 1636421496630, 1636421496910, 280, 0, 280, 0, 0, 0
4507, 1, 1636421496630, 1636421496910, 280, 0, 280, 0, 0, 0
4510, 1, 1636421496906, 1636421497182, 276, 5, 271, 4, 0, 4
4511, 1, 1636421497170, 1636421497442, 272, 0, 272, 0, 0, 0
4512, 1, 1636421497310, 1636421497582, 272, 1, 271, 0, 0, 0
4513, 1, 1636421497310, 1636421497583, 273, 1, 272, 1, 0, 1
4514, 1, 1636421497574, 1636421497850, 276, 9, 267, 9, 0, 9
4515, 1, 1636421497838, 1636421498110, 272, 1, 271, 0, 0, 0
4516, 1, 1636421497978, 1636421498250, 272, 1, 271, 0, 0, 0
4517, 1, 1636421497982, 1636421498254, 272, 1, 271, 0, 0, 0
4518, 1, 1636421498242, 1636421498530, 288, 13, 275, 13, 0, 13
4519, 1, 1636421498506, 1636421498782, 276, 0, 276, 0, 0, 0
4520, 1, 1636421498646, 1636421498922, 276, 0, 276, 0, 0, 0
4523, 1, 1636421499178, 1636421499450, 272, 0, 272, 0, 0, 0
4524, 1, 1636421499318, 1636421499590, 272, 0, 272, 0, 0, 0
4525, 1, 1636421499846, 1636421500122, 276, 1, 275, 0, 0, 0
4526, 1, 1636421499986, 1636421500258, 272, 1, 271, 0, 0, 0
4527, 1, 1636421500518, 1636421500795, 277, 0, 277, 0, 0, 0
4529, 1, 1636421501194, 1636421501470, 276, 0, 276, 0, 0, 0
4498, 2, 1636421493882, 1636421503882, 10000, 0, 10000, 0, 0, 0
4530, 1, 1636421504190, 1636421504466, 276, 0, 276, 0, 0, 0
4531, 1, 1636421504862, 1636421505138, 276, 0, 276, 0, 0, 0
4532, 1, 1636421505534, 1636421505806, 272, 1, 271, 0, 1, 1
4533, 1, 1636421506202, 1636421506478, 276, 1, 275, 0, 0, 0
4509, 2, 1636421496846, 1636421506846, 10000, 0, 10000, 0, 0, 0
4534, 1, 1636421506890, 1636421507162, 272, 0, 272, 0, 0, 0
4535, 1, 1636421507154, 1636421507431, 277, 1, 276, 0, 1, 1
4536, 1, 1636421507558, 1636421507830, 272, 0, 272, 0, 0, 0
4537, 1, 1636421507826, 1636421508106, 280, 1, 279, 0, 0, 0
4538, 1, 1636421508230, 1636421508506, 276, 0, 276, 0, 0, 0
4521, 2, 1636421498658, 1636421508658, 10000, 0, 10000, 0, 0, 0
4539, 1, 1636421508502, 1636421508794, 292, 0, 292, 0, 0, 0
4522, 2, 1636421498922, 1636421508922, 10000, 0, 10000, 0, 0, 0
4540, 1, 1636421508902, 1636421509174, 272, 0, 272, 0, 0, 0
4541, 1, 1636421508966, 1636421509234, 268, 0, 268, 0, 0, 0
4542, 1, 1636421509198, 1636421509474, 276, 0, 276, 0, 0, 0
4543, 1, 1636421509230, 1636421509502, 272, 5, 267, 5, 0, 5
4544, 1, 1636421509574, 1636421509846, 272, 0, 272, 0, 0, 0
4545, 1, 1636421509630, 1636421509902, 272, 0, 272, 0, 0, 0
4546, 1, 1636421509870, 1636421510142, 272, 0, 272, 0, 0, 0
4547, 1, 1636421509894, 1636421510170, 276, 9, 267, 9, 0, 9
4548, 1, 1636421510242, 1636421510514, 272, 1, 271, 1, 0, 1
4549, 1, 1636421510302, 1636421510570, 268, 0, 268, 0, 0, 0
4528, 2, 1636421500654, 1636421510654, 10000, 0, 10000, 0, 0, 0
4550, 1, 1636421510538, 1636421510814, 276, 0, 276, 0, 0, 0
4551, 1, 1636421510566, 1636421510890, 324, 5, 319, 5, 0, 5
4552, 1, 1636421510910, 1636421511182, 272, 0, 272, 0, 0, 0
4553, 1, 1636421510962, 1636421511234, 272, 0, 272, 0, 0, 0
4554, 1, 1636421510966, 1636421511238, 272, 0, 272, 0, 0, 0
4555, 1, 1636421511210, 1636421511486, 276, 0, 276, 0, 0, 0
4556, 1, 1636421511282, 1636421511554, 272, 0, 272, 0, 0, 0
4558, 1, 1636421511630, 1636421511902, 272, 0, 272, 0, 0, 0
4559, 1, 1636421511634, 1636421511906, 272, 0, 272, 0, 0, 0
4560, 1, 1636421511946, 1636421512222, 276, 0, 276, 0, 0, 0
4562, 1, 1636421512302, 1636421512574, 272, 1, 271, 1, 0, 1
4561, 1, 1636421512302, 1636421512574, 272, 1, 271, 0, 0, 0
4563, 1, 1636421512622, 1636421512894, 272, 0, 272, 0, 0, 0
4564, 1, 1636421512970, 1636421513246, 276, 1, 275, 0, 1, 1
4565, 1, 1636421512970, 1636421513246, 276, 1, 275, 0, 1, 1
4566, 1, 1636421513290, 1636421513558, 268, 0, 268, 0, 0, 0
4568, 1, 1636421513642, 1636421513914, 272, 1, 271, 0, 1, 1
4567, 1, 1636421513642, 1636421513914, 272, 1, 271, 0, 0, 0
4569, 1, 1636421513954, 1636421514222, 268, 1, 267, 0, 1, 1
4570, 1, 1636421514310, 1636421514582, 272, 1, 271, 0, 1, 1
4571, 1, 1636421514310, 1636421514582, 272, 1, 271, 1, 0, 1
4572, 1, 1636421514618, 1636421514894, 276, 1, 275, 0, 0, 0
4574, 1, 1636421514978, 1636421515250, 272, 1, 271, 0, 1, 1
4573, 1, 1636421514978, 1636421515250, 272, 1, 271, 1, 0, 1
4575, 1, 1636421515290, 1636421515558, 268, 0, 268, 0, 0, 0
4576, 1, 1636421515646, 1636421515918, 272, 1, 271, 0, 0, 0
4577, 1, 1636421515954, 1636421516226, 272, 0, 272, 0, 0, 0
4557, 2, 1636421511578, 1636421521578, 10000, 0, 10000, 0, 0, 0
4580, 1, 1636421521886, 1636421522158, 272, 0, 272, 0, 0, 0
4581, 1, 1636421522554, 1636421522830, 276, 1, 275, 0, 0, 0
4582, 1, 1636421523226, 1636421523502, 276, 1, 275, 0, 0, 0
4583, 1, 1636421523898, 1636421524170, 272, 1, 271, 1, 0, 1
4584, 1, 1636421524566, 1636421524838, 272, 0, 272, 0, 0, 0
4585, 1, 1636421525234, 1636421525506, 272, 0, 272, 0, 0, 0
4586, 1, 1636421525902, 1636421526178, 276, 0, 276, 0, 0, 0
4578, 2, 1636421516314, 1636421526314, 10000, 0, 10000, 0, 0, 0
4579, 2, 1636421516622, 1636421526622, 10000, 0, 10000, 0, 0, 0
4587, 1, 1636421526666, 1636421526938, 272, 0, 272, 0, 0, 0
4588, 1, 1636421526926, 1636421527210, 284, 13, 271, 13, 0, 13
4589, 1, 1636421527334, 1636421527610, 276, 0, 276, 0, 0, 0
4590, 1, 1636421527602, 1636421527882, 280, 9, 271, 8, 0, 8
4591, 1, 1636421528010, 1636421528282, 272, 0, 272, 0, 0, 0
4592, 1, 1636421528274, 1636421528554, 280, 9, 271, 9, 0, 9
4593, 1, 1636421528678, 1636421528950, 272, 0, 272, 0, 0, 0
4594, 1, 1636421528946, 1636421529226, 280, 5, 275, 5, 0, 5
4595, 1, 1636421529346, 1636421529618, 272, 0, 272, 0, 0, 0
4596, 1, 1636421529630, 1636421529902, 272, 0, 272, 0, 0, 0
4597, 1, 1636421530014, 1636421530286, 272, 0, 272, 0, 0, 0
4598, 1, 1636421530298, 1636421530570, 272, 0, 272, 0, 0, 0
4599, 1, 1636421530682, 1636421530954, 272, 0, 272, 0, 0, 0
4600, 1, 1636421530962, 1636421531234, 272, 0, 272, 0, 0, 0
4601, 1, 1636421835890, 1636421836162, 272, 1, 271, 0, 0, 0
4603, 1, 1636421836658, 1636421836930, 272, 0, 272, 0, 0, 0
4604, 1, 1636421837306, 1636421837578, 272, 0, 272, 0, 0, 0
4606, 1, 1636421837918, 1636421838194, 276, 1, 275, 0, 0, 0
4608, 1, 1636421838538, 1636421838810, 272, 0, 272, 0, 0, 0
4611, 1, 1636421839234, 1636421839506, 272, 1, 271, 0, 0, 0
4613, 1, 1636421839954, 1636421840226, 272, 1, 271, 0, 0, 0
4615, 1, 1636421840586, 1636421840862, 276, 0, 276, 0, 0, 0
4614, 1, 1636421840622, 1636421840894, 272, 0, 272, 0, 0, 0
4616, 1, 1636421841218, 1636421841490, 272, 1, 271, 0, 1, 1
4617, 1, 1636421841290, 1636421841566, 276, 0, 276, 0, 0, 0
4620, 1, 1636421841898, 1636421842174, 276, 1, 275, 0, 0, 0
4622, 1, 1636421842570, 1636421842847, 277, 1, 276, 0, 0, 0
4623, 1, 1636421843246, 1636421843518, 272, 1, 271, 0, 0, 0
4624, 1, 1636421843602, 1636421843878, 276, 0, 276, 0, 0, 0
4627, 1, 1636421844294, 1636421844575, 281, 0, 281, 0, 0, 0
4628, 1, 1636421844970, 1636421845246, 276, 1, 275, 0, 0, 0
4629, 1, 1636421845506, 1636421845778, 272, 0, 272, 0, 0, 0
4630, 1, 1636421845646, 1636421845922, 276, 0, 276, 0, 0, 0
4632, 1, 1636421846134, 1636421846406, 272, 0, 272, 0, 0, 0
4631, 1, 1636421846174, 1636421846446, 272, 1, 271, 0, 0, 0
4602, 2, 1636421836594, 1636421846594, 10000, 0, 10000, 0, 0, 0
4635, 1, 1636421846838, 1636421847110, 272, 1, 271, 0, 0, 0
4636, 1, 1636421846902, 1636421847174, 272, 0, 272, 0, 0, 0
4637, 1, 1636421847034, 1636421847310, 276, 0, 276, 0, 0, 0
4605, 2, 1636421837362, 1636421847362, 10000, 0, 10000, 0, 0, 0
4639, 1, 1636421847570, 1636421847842, 272, 0, 272, 0, 0, 0
4640, 1, 1636421847670, 1636421847946, 276, 0, 276, 0, 0, 0
4607, 2, 1636421838014, 1636421848014, 10000, 0, 10000, 0, 0, 0
4642, 1, 1636421847834, 1636421848150, 316, 1, 315, 0, 0, 0
4643, 1, 1636421848238, 1636421848510, 272, 0, 272, 0, 0, 0
4644, 1, 1636421848322, 1636421848590, 268, 0, 268, 0, 0, 0
4645, 1, 1636421848346, 1636421848618, 272, 0, 272, 0, 0, 0
4609, 2, 1636421838626, 1636421848626, 10000, 0, 10000, 0, 0, 0
4647, 1, 1636421848510, 1636421848782, 272, 0, 272, 0, 0, 0
4646, 1, 1636421848546, 1636421848854, 308, 0, 308, 0, 0, 0
4648, 1, 1636421848910, 1636421849182, 272, 0, 272, 0, 0, 0
4649, 1, 1636421848934, 1636421849206, 272, 1, 271, 0, 0, 0
4610, 2, 1636421839242, 1636421849242, 10000, 0, 10000, 0, 0, 0
4651, 1, 1636421849014, 1636421849290, 276, 0, 276, 0, 0, 0
4650, 1, 1636421848990, 1636421849290, 300, 0, 300, 0, 0, 0
4652, 1, 1636421849030, 1636421849298, 268, 0, 268, 0, 0, 0
4654, 1, 1636421849286, 1636421849562, 276, 0, 276, 0, 0, 0
4655, 1, 1636421849546, 1636421849818, 272, 0, 272, 0, 0, 0
4656, 1, 1636421849578, 1636421849854, 276, 0, 276, 0, 0, 0
4657, 1, 1636421849606, 1636421849878, 272, 0, 272, 0, 0, 0
4612, 2, 1636421839938, 1636421849938, 10000, 0, 10000, 0, 0, 0
4659, 1, 1636421849706, 1636421849986, 280, 0, 280, 0, 0, 0
4658, 1, 1636421849690, 1636421849986, 296, 0, 296, 0, 0, 0
4660, 1, 1636421849678, 1636421850166, 488, 177, 311, 177, 0, 177
4663, 1, 1636421850214, 1636421850482, 268, 0, 268, 0, 0, 0
4665, 1, 1636421850250, 1636421850514, 264, 0, 264, 0, 0, 0
4664, 1, 1636421850246, 1636421850514, 268, 0, 268, 0, 0, 0
4666, 1, 1636421850278, 1636421850542, 264, 0, 264, 0, 0, 0
4668, 1, 1636421850382, 1636421850650, 268, 0, 268, 0, 0, 0
4667, 1, 1636421850382, 1636421850658, 276, 0, 276, 0, 0, 0
4669, 1, 1636421850562, 1636421850834, 272, 0, 272, 0, 0, 0
4670, 1, 1636421850878, 1636421851150, 272, 0, 272, 0, 0, 0
4671, 1, 1636421850910, 1636421851182, 272, 0, 272, 0, 0, 0
4672, 1, 1636421850918, 1636421851186, 268, 0, 268, 0, 0, 0
4673, 1, 1636421850942, 1636421851218, 276, 0, 276, 0, 0, 0
4618, 2, 1636421841294, 1636421851294, 10000, 0, 10000, 0, 0, 0
4674, 1, 1636421851054, 1636421851342, 288, 0, 288, 0, 0, 0
4675, 1, 1636421851058, 1636421851342, 284, 0, 284, 0, 0, 0
4676, 1, 1636421851226, 1636421851518, 292, 0, 292, 0, 0, 0
4677, 1, 1636421851550, 1636421851822, 272, 0, 272, 0, 0, 0
4678, 1, 1636421851578, 1636421851850, 272, 0, 272, 0, 0, 0
4679, 1, 1636421851590, 1636421851862, 272, 0, 272, 0, 0, 0
4680, 1, 1636421851594, 1636421851874, 280, 0, 280, 0, 0, 0
4682, 1, 1636421851614, 1636421851886, 272, 0, 272, 0, 0, 0
4619, 2, 1636421841922, 1636421851922, 10000, 0, 10000, 0, 0, 0
4621, 2, 1636421841962, 1636421851966, 10004, 0, 10004, 0, 0, 0
4684, 1, 1636421851746, 1636421852102, 356, 1, 355, 1, 0, 1
4683, 1, 1636421851746, 1636421852102, 356, 1, 355, 0, 1, 1
4681, 1, 1636421851614, 1636421852190, 576, 273, 303, 273, 0, 273
4686, 1, 1636421852214, 1636421852486, 272, 1, 271, 0, 0, 0
4687, 1, 1636421852226, 1636421852498, 272, 0, 272, 0, 0, 0
4688, 1, 1636421852246, 1636421852518, 272, 0, 272, 0, 0, 0
4689, 1, 1636421852266, 1636421852538, 272, 0, 272, 0, 0, 0
4691, 1, 1636421852270, 1636421852550, 280, 0, 280, 0, 0, 0
4690, 1, 1636421852270, 1636421852774, 504, 229, 275, 229, 0, 229
4693, 1, 1636421852498, 1636421852778, 280, 1, 279, 0, 0, 0
4694, 1, 1636421852498, 1636421852782, 284, 0, 284, 0, 0, 0
4695, 1, 1636421852586, 1636421852858, 272, 0, 272, 0, 0, 0
4696, 1, 1636421852886, 1636421853154, 268, 0, 268, 0, 0, 0
4697, 1, 1636421852902, 1636421853174, 272, 0, 272, 0, 0, 0
4698, 1, 1636421852914, 1636421853186, 272, 0, 272, 0, 0, 0
4700, 1, 1636421852954, 1636421853226, 272, 0, 272, 0, 0, 0
4701, 1, 1636421853174, 1636421853438, 264, 1, 263, 1, 0, 1
4703, 1, 1636421853178, 1636421853442, 264, 0, 264, 0, 0, 0
4702, 1, 1636421853178, 1636421853450, 272, 0, 272, 0, 0, 0
4704, 1, 1636421853254, 1636421853522, 268, 1, 267, 0, 0, 0
4705, 1, 1636421853550, 1636421853822, 272, 0, 272, 0, 0, 0
4706, 1, 1636421853566, 1636421853838, 272, 0, 272, 0, 0, 0
4707, 1, 1636421853590, 1636421853862, 272, 0, 272, 0, 0, 0
4708, 1, 1636421853622, 1636421853890, 268, 0, 268, 0, 0, 0
4625, 2, 1636421843914, 1636421853914, 10000, 0, 10000, 0, 0, 0
4709, 1, 1636421853842, 1636421854142, 300, 0, 300, 0, 0, 0
4711, 1, 1636421853846, 1636421854146, 300, 0, 300, 0, 0, 0
4712, 1, 1636421853962, 1636421854234, 272, 0, 272, 0, 0, 0
4626, 2, 1636421844314, 1636421854314, 10000, 0, 10000, 0, 0, 0
4714, 1, 1636421854218, 1636421854490, 272, 0, 272, 0, 0, 0
4716, 1, 1636421854262, 1636421854542, 280, 0, 280, 0, 0, 0
4713, 1, 1636421854218, 1636421854542, 324, 16, 308, 16, 0, 16
4715, 1, 1636421854242, 1636421854542, 300, 0, 300, 0, 0, 0
4717, 1, 1636421854290, 1636421854562, 272, 0, 272, 0, 0, 0
4718, 1, 1636421854538, 1636421854814, 276, 5, 271, 5, 0, 5
4720, 1, 1636421854622, 1636421854898, 276, 1, 275, 0, 0, 0
4721, 1, 1636421854630, 1636421854899, 269, 0, 269, 0, 0, 0
4722, 1, 1636421854890, 1636421855158, 268, 0, 268, 0, 0, 0
4723, 1, 1636421854934, 1636421855202, 268, 0, 268, 0, 0, 0
4725, 1, 1636421854942, 1636421855210, 268, 0, 268, 0, 0, 0
4724, 1, 1636421854942, 1636421855222, 280, 0, 280, 0, 0, 0
4726, 1, 1636421854958, 1636421855230, 272, 1, 271, 0, 0, 0
4727, 1, 1636421855218, 1636421855490, 272, 0, 272, 0, 0, 0
4728, 1, 1636421855294, 1636421855570, 276, 0, 276, 0, 0, 0
4730, 1, 1636421855554, 1636421855826, 272, 0, 272, 0, 0, 0
4732, 1, 1636421855610, 1636421855882, 272, 0, 272, 0, 0, 0
4733, 1, 1636421855622, 1636421855898, 276, 0, 276, 0, 0, 0
4734, 1, 1636421855630, 1636421855906, 276, 0, 276, 0, 0, 0
4735, 1, 1636421855890, 1636421856162, 272, 0, 272, 0, 0, 0
4736, 1, 1636421855970, 1636421856242, 272, 0, 272, 0, 0, 0
4633, 2, 1636421846326, 1636421856326, 10000, 0, 10000, 0, 0, 0
4737, 1, 1636421856222, 1636421856498, 276, 0, 276, 0, 0, 0
4738, 1, 1636421856278, 1636421856554, 276, 0, 276, 0, 0, 0
4740, 1, 1636421856306, 1636421856578, 272, 0, 272, 0, 0, 0
4634, 2, 1636421846838, 1636421856838, 10000, 0, 10000, 0, 0, 0
4741, 1, 1636421856566, 1636421856886, 320, 0, 320, 0, 0, 0
4742, 1, 1636421856638, 1636421856910, 272, 0, 272, 0, 0, 0
4743, 1, 1636421856638, 1636421856910, 272, 1, 271, 0, 1, 1
4744, 1, 1636421856930, 1636421857206, 276, 0, 276, 0, 0, 0
4745, 1, 1636421856950, 1636421857218, 268, 0, 268, 0, 0, 0
4746, 1, 1636421857014, 1636421857286, 272, 1, 271, 0, 0, 0
4747, 1, 1636421857142, 1636421857418, 276, 0, 276, 0, 0, 0
4638, 2, 1636421847538, 1636421857538, 10000, 0, 10000, 0, 0, 0
4749, 1, 1636421857306, 1636421857586, 280, 0, 280, 0, 0, 0
4748, 1, 1636421857282, 1636421857586, 304, 0, 304, 0, 0, 0
4750, 1, 1636421857306, 1636421857586, 280, 0, 280, 0, 0, 0
4641, 2, 1636421847746, 1636421857746, 10000, 0, 10000, 0, 0, 0
4752, 1, 1636421857630, 1636421857894, 264, 0, 264, 0, 0, 0
4751, 1, 1636421857630, 1636421857902, 272, 0, 272, 0, 0, 0
4754, 1, 1636421857834, 1636421858106, 272, 0, 272, 0, 0, 0
4755, 1, 1636421857842, 1636421858114, 272, 0, 272, 0, 0, 0
4757, 1, 1636421857982, 1636421858250, 268, 0, 268, 0, 0, 0
4756, 1, 1636421857982, 1636421858258, 276, 1, 275, 0, 0, 0
4758, 1, 1636421857986, 1636421858266, 280, 0, 280, 0, 0, 0
4759, 1, 1636421858054, 1636421858386, 332, 61, 271, 60, 1, 61
4761, 1, 1636421858298, 1636421858570, 272, 0, 272, 0, 0, 0
4762, 1, 1636421858498, 1636421858766, 268, 0, 268, 0, 0, 0
4763, 1, 1636421858510, 1636421858782, 272, 0, 272, 0, 0, 0
4764, 1, 1636421858650, 1636421858922, 272, 0, 272, 0, 0, 0
4766, 1, 1636421858662, 1636421858942, 280, 0, 280, 0, 0, 0
4767, 1, 1636421858782, 1636421859058, 276, 1, 275, 1, 0, 1
4653, 2, 1636421849222, 1636421859222, 10000, 0, 10000, 0, 0, 0
4768, 1, 1636421858966, 1636421859270, 304, 0, 304, 0, 0, 0
4770, 1, 1636421859178, 1636421859450, 272, 1, 271, 0, 1, 1
4769, 1, 1636421859166, 1636421859450, 284, 0, 284, 0, 0, 0
4771, 1, 1636421859322, 1636421859586, 264, 0, 264, 0, 0, 0
4772, 1, 1636421859338, 1636421859602, 264, 1, 263, 0, 0, 0
4773, 1, 1636421859458, 1636421859726, 268, 0, 268, 0, 0, 0
4661, 2, 1636421849742, 1636421859742, 10000, 0, 10000, 0, 0, 0
4774, 1, 1636421859530, 1636421859802, 272, 0, 272, 0, 0, 0
4775, 1, 1636421859666, 1636421859970, 304, 0, 304, 0, 0, 0
4662, 2, 1636421849982, 1636421859986, 10004, 0, 10004, 0, 0, 0
4776, 1, 1636421859846, 1636421860122, 276, 0, 276, 0, 0, 0
4777, 1, 1636421859842, 1636421860122, 280, 0, 280, 0, 0, 0
4778, 1, 1636421860034, 1636421860298, 264, 1, 263, 0, 1, 1
4779, 1, 1636421860034, 1636421860302, 268, 0, 268, 0, 0, 0
4780, 1, 1636421860078, 1636421860346, 268, 0, 268, 0, 0, 0
4781, 1, 1636421860166, 1636421860442, 276, 0, 276, 0, 0, 0
4782, 1, 1636421860198, 1636421860474, 276, 0, 276, 0, 0, 0
4783, 1, 1636421860290, 1636421860610, 320, 56, 264, 56, 0, 56
4785, 1, 1636421860514, 1636421860782, 268, 0, 268, 0, 0, 0
4786, 1, 1636421860518, 1636421860786, 268, 0, 268, 0, 0, 0
4787, 1, 1636421860698, 1636421860970, 272, 0, 272, 0, 0, 0
4789, 1, 1636421860746, 1636421861018, 272, 0, 272, 0, 0, 0
4790, 1, 1636421860838, 1636421861106, 268, 0, 268, 0, 0, 0
4791, 1, 1636421860870, 1636421861142, 272, 0, 272, 0, 0, 0
4792, 1, 1636421861006, 1636421861290, 284, 12, 272, 12, 0, 12
4793, 1, 1636421861182, 1636421861454, 272, 1, 271, 0, 0, 0
4794, 1, 1636421861182, 1636421861454, 272, 1, 271, 0, 0, 0
4795, 1, 1636421861366, 1636421861638, 272, 0, 272, 0, 0, 0
4796, 1, 1636421861418, 1636421861686, 268, 0, 268, 0, 0, 0
4797, 1, 1636421861510, 1636421861778, 268, 0, 268, 0, 0, 0
4798, 1, 1636421861538, 1636421861806, 268, 0, 268, 0, 0, 0
4685, 2, 1636421851910, 1636421861910, 10000, 0, 10000, 0, 0, 0
4799, 1, 1636421861690, 1636421861966, 276, 0, 276, 0, 0, 0
4801, 1, 1636421861854, 1636421862138, 284, 0, 284, 0, 0, 0
4800, 1, 1636421861846, 1636421862138, 292, 1, 291, 0, 0, 0
4692, 2, 1636421852322, 1636421862322, 10000, 0, 10000, 0, 0, 0
4802, 1, 1636421862086, 1636421862370, 284, 0, 284, 0, 0, 0
4803, 1, 1636421862090, 1636421862370, 280, 0, 280, 0, 0, 0
4804, 1, 1636421862174, 1636421862454, 280, 0, 280, 0, 0, 0
4805, 1, 1636421862210, 1636421862482, 272, 0, 272, 0, 0, 0
4806, 1, 1636421862218, 1636421862486, 268, 0, 268, 0, 0, 0
4807, 1, 1636421862370, 1636421862638, 268, 1, 267, 1, 0, 1
4808, 1, 1636421862534, 1636421862806, 272, 0, 272, 0, 0, 0
4809, 1, 1636421862542, 1636421862814, 272, 0, 272, 0, 0, 0
4810, 1, 1636421862634, 1636421862906, 272, 0, 272, 0, 0, 0
4699, 2, 1636421852934, 1636421862934, 10000, 0, 10000, 0, 0, 0
4811, 1, 1636421862770, 1636421863074, 304, 0, 304, 0, 0, 0
4814, 1, 1636421862878, 1636421863162, 284, 1, 283, 0, 1, 1
4813, 1, 1636421862850, 1636421863162, 312, 0, 312, 0, 0, 0
4815, 1, 1636421862878, 1636421863162, 284, 0, 284, 0, 0, 0
4816, 1, 1636421863034, 1636421863342, 308, 41, 267, 41, 0, 41
4818, 1, 1636421863210, 1636421863486, 276, 0, 276, 0, 0, 0
4820, 1, 1636421863306, 1636421863574, 268, 0, 268, 0, 0, 0
4819, 1, 1636421863242, 1636421863610, 368, 101, 267, 101, 0, 101
4821, 1, 1636421863478, 1636421863746, 268, 0, 268, 0, 0, 0
4822, 1, 1636421863554, 1636421863826, 272, 0, 272, 0, 0, 0
4823, 1, 1636421863558, 1636421863830, 272, 0, 272, 0, 0, 0
4824, 1, 1636421863558, 1636421863830, 272, 0, 272, 0, 0, 0
4710, 2, 1636421853846, 1636421863846, 10000, 0, 10000, 0, 0, 0
4825, 1, 1636421863738, 1636421864014, 276, 9, 267, 9, 0, 9
4827, 1, 1636421863974, 1636421864250, 276, 0, 276, 0, 0, 0
4828, 1, 1636421864034, 1636421864302, 268, 0, 268, 0, 0, 0
4829, 1, 1636421864142, 1636421864410, 268, 0, 268, 0, 0, 0
4830, 1, 1636421864158, 1636421864426, 268, 0, 268, 0, 0, 0
4831, 1, 1636421864222, 1636421864490, 268, 0, 268, 0, 0, 0
4833, 1, 1636421864234, 1636421864502, 268, 0, 268, 0, 0, 0
4719, 2, 1636421854542, 1636421864542, 10000, 0, 10000, 0, 0, 0
4834, 1, 1636421864410, 1636421864678, 268, 1, 267, 1, 0, 1
4835, 1, 1636421864646, 1636421864918, 272, 1, 271, 0, 0, 0
4836, 1, 1636421864718, 1636421864994, 276, 1, 275, 0, 0, 0
4837, 1, 1636421864810, 1636421865086, 276, 0, 276, 0, 0, 0
4838, 1, 1636421864826, 1636421865094, 268, 0, 268, 0, 0, 0
4839, 1, 1636421864858, 1636421865126, 268, 0, 268, 0, 0, 0
4729, 2, 1636421855298, 1636421865298, 10000, 0, 10000, 0, 0, 0
4842, 1, 1636421865078, 1636421865354, 276, 9, 267, 8, 1, 9
4841, 1, 1636421864902, 1636421865366, 464, 193, 271, 193, 0, 193
4840, 1, 1636421864886, 1636421865434, 548, 241, 307, 241, 0, 241
4731, 2, 1636421855602, 1636421865602, 10000, 0, 10000, 0, 0, 0
4844, 1, 1636421865394, 1636421865666, 272, 0, 272, 0, 0, 0
4843, 1, 1636421865346, 1636421865742, 396, 89, 307, 89, 0, 89
4845, 1, 1636421865482, 1636421865758, 276, 0, 276, 0, 0, 0
4846, 1, 1636421865494, 1636421865766, 272, 0, 272, 0, 0, 0
4848, 1, 1636421865646, 1636421866014, 368, 97, 271, 96, 0, 96
4847, 1, 1636421865530, 1636421866034, 504, 229, 275, 229, 0, 229
4851, 1, 1636421865826, 1636421866098, 272, 0, 272, 0, 0, 0
4852, 1, 1636421865910, 1636421866282, 372, 105, 267, 105, 0, 105
4739, 2, 1636421856294, 1636421866294, 10000, 0, 10000, 0, 0, 0
4850, 1, 1636421865778, 1636421866342, 564, 257, 307, 257, 0, 257
4854, 1, 1636421866138, 1636421866430, 292, 0, 292, 0, 0, 0
4856, 1, 1636421866162, 1636421866430, 268, 0, 268, 0, 0, 0
4853, 1, 1636421866066, 1636421866554, 488, 216, 272, 216, 0, 216
4857, 1, 1636421866410, 1636421866686, 276, 0, 276, 0, 0, 0
4858, 1, 1636421866474, 1636421866742, 268, 0, 268, 0, 0, 0
4859, 1, 1636421866498, 1636421866766, 268, 0, 268, 0, 0, 0
4860, 1, 1636421866602, 1636421866870, 268, 0, 268, 0, 0, 0
4861, 1, 1636421866674, 1636421866958, 284, 13, 271, 13, 0, 13
4864, 1, 1636421866834, 1636421867110, 276, 0, 276, 0, 0, 0
4863, 1, 1636421866826, 1636421867150, 324, 45, 279, 45, 0, 45
4865, 1, 1636421866950, 1636421867226, 276, 0, 276, 0, 0, 0
4866, 1, 1636421867086, 1636421867358, 272, 0, 272, 0, 0, 0
4867, 1, 1636421867142, 1636421867418, 276, 0, 276, 0, 0, 0
4868, 1, 1636421867166, 1636421867438, 272, 0, 272, 0, 0, 0
4869, 1, 1636421867270, 1636421867538, 268, 0, 268, 0, 0, 0
4870, 1, 1636421867354, 1636421867630, 276, 5, 271, 5, 0, 5
4753, 2, 1636421857714, 1636421867714, 10000, 0, 10000, 0, 0, 0
4871, 1, 1636421867506, 1636421867778, 272, 0, 272, 0, 0, 0
4872, 1, 1636421867554, 1636421867850, 296, 0, 296, 0, 0, 0
4874, 1, 1636421867802, 1636421868074, 272, 0, 272, 0, 0, 0
4875, 1, 1636421867822, 1636421868090, 268, 0, 268, 0, 0, 0
4876, 1, 1636421867834, 1636421868106, 272, 0, 272, 0, 0, 0
4877, 1, 1636421867942, 1636421868214, 272, 0, 272, 0, 0, 0
4760, 2, 1636421858294, 1636421868294, 10000, 0, 10000, 0, 0, 0
4879, 1, 1636421868030, 1636421868346, 316, 45, 271, 45, 0, 45
4878, 1, 1636421868022, 1636421868370, 348, 68, 280, 68, 0, 68
4880, 1, 1636421868178, 1636421868442, 264, 0, 264, 0, 0, 0
4765, 2, 1636421858658, 1636421868658, 10000, 0, 10000, 0, 0, 0
4882, 1, 1636421868470, 1636421868738, 268, 0, 268, 0, 0, 0
4883, 1, 1636421868494, 1636421868794, 300, 0, 300, 0, 0, 0
4886, 1, 1636421868614, 1636421868886, 272, 1, 271, 0, 1, 1
4885, 1, 1636421868598, 1636421869014, 416, 140, 276, 140, 0, 140
4888, 1, 1636421868766, 1636421869042, 276, 0, 276, 0, 0, 0
4891, 1, 1636421869138, 1636421869414, 276, 0, 276, 0, 0, 0
4894, 1, 1636421869414, 1636421869682, 268, 1, 267, 0, 0, 0
4895, 1, 1636421869438, 1636421869706, 268, 1, 267, 0, 1, 1
4897, 1, 1636421870082, 1636421870354, 272, 1, 271, 0, 0, 0
4784, 2, 1636421860366, 1636421870366, 10000, 0, 10000, 0, 0, 0
4898, 1, 1636421870106, 1636421870414, 308, 1, 307, 0, 0, 0
4788, 2, 1636421860702, 1636421870702, 10000, 0, 10000, 0, 0, 0
4900, 1, 1636421870750, 1636421871026, 276, 0, 276, 0, 0, 0
4812, 2, 1636421862770, 1636421872770, 10000, 0, 10000, 0, 0, 0
4817, 2, 1636421863206, 1636421873206, 10000, 0, 10000, 0, 0, 0
4826, 2, 1636421863894, 1636421873895, 10001, 0, 10001, 0, 0, 0
4832, 2, 1636421864226, 1636421874226, 10000, 0, 10000, 0, 0, 0
4849, 2, 1636421865778, 1636421875778, 10000, 0, 10000, 0, 0, 0
4855, 2, 1636421866158, 1636421876158, 10000, 0, 10000, 0, 0, 0
4862, 2, 1636421866742, 1636421876742, 10000, 0, 10000, 0, 0, 0
4873, 2, 1636421867622, 1636421877622, 10000, 0, 10000, 0, 0, 0
4911, 1, 1636421877930, 1636421878206, 276, 1, 275, 0, 0, 0
4881, 2, 1636421868250, 1636421878250, 10000, 0, 10000, 0, 0, 0
4884, 2, 1636421868506, 1636421878506, 10000, 0, 10000, 0, 0, 0
4887, 2, 1636421868746, 1636421878746, 10000, 0, 10000, 269, 0, 269
4889, 2, 1636421868846, 1636421878846, 10000, 0, 10000, 0, 0, 0
4912, 1, 1636421878594, 1636421878890, 296, 0, 296, 0, 0, 0
4913, 1, 1636421878602, 1636421878890, 288, 0, 288, 0, 0, 0
4890, 2, 1636421868966, 1636421878966, 10000, 0, 10000, 49, 0, 49
4892, 2, 1636421869190, 1636421879190, 10000, 0, 10000, 0, 0, 0
4893, 2, 1636421869282, 1636421879282, 10000, 0, 10000, 0, 0, 0
4918, 1, 1636421879330, 1636421879602, 272, 1, 271, 1, 0, 1
4916, 1, 1636421879330, 1636421879603, 273, 1, 272, 0, 1, 1
4917, 1, 1636421879330, 1636421879603, 273, 1, 272, 1, 0, 1
4919, 1, 1636421879330, 1636421879602, 272, 0, 272, 0, 0, 0
4920, 1, 1636421879502, 1636421879770, 268, 0, 268, 0, 0, 0
4896, 2, 1636421869810, 1636421879810, 10000, 0, 10000, 0, 0, 0
4921, 1, 1636421879590, 1636421879870, 280, 14, 266, 14, 0, 14
4922, 1, 1636421879998, 1636421880266, 268, 0, 268, 0, 0, 0
4925, 1, 1636421879998, 1636421880270, 272, 0, 272, 0, 0, 0
4924, 1, 1636421880002, 1636421880270, 268, 0, 268, 0, 0, 0
4927, 1, 1636421880166, 1636421880442, 276, 0, 276, 0, 0, 0
4926, 1, 1636421880118, 1636421880542, 424, 153, 271, 153, 0, 153
4899, 2, 1636421870670, 1636421880670, 10000, 0, 10000, 0, 0, 0
4901, 2, 1636421870810, 1636421880810, 10000, 0, 10000, 0, 0, 0
4929, 1, 1636421880666, 1636421880950, 284, 1, 283, 1, 0, 1
4931, 1, 1636421880666, 1636421880950, 284, 1, 283, 0, 0, 0
4930, 1, 1636421880670, 1636421880950, 280, 0, 280, 0, 0, 0
4902, 2, 1636421871010, 1636421881010, 10000, 0, 10000, 0, 0, 0
4932, 1, 1636421880858, 1636421881238, 380, 93, 287, 93, 0, 93
4933, 1, 1636421880938, 1636421881238, 300, 0, 300, 0, 0, 0
4934, 1, 1636421880986, 1636421881258, 272, 0, 272, 0, 0, 0
4935, 1, 1636421881114, 1636421881386, 272, 0, 272, 0, 0, 0
4903, 2, 1636421871426, 1636421881426, 10000, 0, 10000, 0, 0, 0
4936, 1, 1636421881318, 1636421881590, 272, 0, 272, 0, 0, 0
4937, 1, 1636421881350, 1636421881654, 304, 1, 303, 1, 0, 1
4938, 1, 1636421881350, 1636421881654, 304, 1, 303, 0, 0, 0
4941, 1, 1636421881638, 1636421881910, 272, 0, 272, 0, 0, 0
4942, 1, 1636421881654, 1636421881926, 272, 0, 272, 0, 0, 0
4940, 1, 1636421881638, 1636421881934, 296, 17, 279, 17, 0, 17
4943, 1, 1636421881734, 1636421882002, 268, 0, 268, 0, 0, 0
4945, 1, 1636421881986, 1636421882262, 276, 0, 276, 0, 0, 0
4946, 1, 1636421882050, 1636421882322, 272, 1, 271, 0, 0, 0
4947, 1, 1636421882050, 1636421882326, 276, 1, 275, 0, 1, 1
4948, 1, 1636421882306, 1636421882574, 268, 0, 268, 0, 0, 0
4949, 1, 1636421882322, 1636421882590, 268, 1, 267, 0, 0, 0
4950, 1, 1636421882330, 1636421882598, 268, 0, 268, 0, 0, 0
4952, 1, 1636421882658, 1636421882930, 272, 1, 271, 0, 0, 0
4953, 1, 1636421882718, 1636421882990, 272, 0, 272, 0, 0, 0
4954, 1, 1636421882726, 1636421882998, 272, 0, 272, 0, 0, 0
4904, 2, 1636421873078, 1636421883078, 10000, 0, 10000, 0, 0, 0
4955, 1, 1636421882974, 1636421883250, 276, 0, 276, 0, 0, 0
4957, 1, 1636421882998, 1636421883306, 308, 1, 307, 0, 0, 0
4905, 2, 1636421873510, 1636421883510, 10000, 0, 10000, 0, 0, 0
4960, 1, 1636421883386, 1636421883658, 272, 1, 271, 0, 0, 0
4959, 1, 1636421883386, 1636421883662, 276, 1, 275, 0, 0, 0
4961, 1, 1636421883394, 1636421883662, 268, 0, 268, 0, 0, 0
4962, 1, 1636421883686, 1636421883958, 272, 0, 272, 0, 0, 0
4963, 1, 1636421883702, 1636421883974, 272, 0, 272, 0, 0, 0
4964, 1, 1636421883810, 1636421884082, 272, 1, 271, 0, 0, 0
4906, 2, 1636421874198, 1636421884198, 10000, 0, 10000, 0, 0, 0
4965, 1, 1636421884054, 1636421884338, 284, 0, 284, 0, 0, 0
4966, 1, 1636421884058, 1636421884338, 280, 0, 280, 0, 0, 0
4967, 1, 1636421884062, 1636421884338, 276, 0, 276, 0, 0, 0
4907, 2, 1636421874534, 1636421884534, 10000, 0, 10000, 0, 0, 0
4969, 1, 1636421884378, 1636421884670, 292, 0, 292, 0, 0, 0
4968, 1, 1636421884378, 1636421884674, 296, 0, 296, 0, 0, 0
4971, 1, 1636421884502, 1636421884777, 275, 0, 275, 0, 0, 0
4970, 1, 1636421884482, 1636421884934, 452, 188, 264, 188, 0, 188
4973, 1, 1636421884734, 1636421885006, 272, 1, 271, 0, 0, 0
4972, 1, 1636421884734, 1636421885007, 273, 0, 273, 0, 0, 0
4974, 1, 1636421884738, 1636421885007, 269, 0, 269, 0, 0, 0
4975, 1, 1636421884842, 1636421885106, 264, 1, 263, 0, 0, 0
4976, 1, 1636421885070, 1636421885342, 272, 1, 271, 0, 0, 0
4977, 1, 1636421885070, 1636421885342, 272, 1, 271, 0, 1, 1
4979, 1, 1636421885326, 1636421885606, 280, 0, 280, 0, 0, 0
4978, 1, 1636421885178, 1636421885606, 428, 165, 263, 165, 0, 165
4982, 1, 1636421885406, 1636421885678, 272, 1, 271, 0, 0, 0
4983, 1, 1636421885506, 1636421885878, 372, 100, 272, 100, 0, 100
4985, 1, 1636421885738, 1636421886006, 268, 1, 267, 0, 1, 1
4984, 1, 1636421885738, 1636421886006, 268, 1, 267, 0, 1, 1
4908, 2, 1636421876086, 1636421886086, 10000, 0, 10000, 0, 0, 0
4986, 1, 1636421886002, 1636421886314, 312, 0, 312, 0, 0, 0
4909, 2, 1636421876466, 1636421886466, 10000, 0, 10000, 0, 0, 0
4989, 1, 1636421886274, 1636421886602, 328, 41, 287, 41, 0, 41
4992, 1, 1636421886414, 1636421886694, 280, 1, 279, 0, 1, 1
4991, 1, 1636421886414, 1636421886694, 280, 0, 280, 0, 0, 0
4990, 1, 1636421886394, 1636421886698, 304, 0, 304, 0, 0, 0
4994, 1, 1636421886774, 1636421887050, 276, 0, 276, 0, 0, 0
4910, 2, 1636421877050, 1636421887050, 10000, 0, 10000, 0, 0, 0
4997, 1, 1636421887098, 1636421887370, 272, 1, 271, 1, 0, 1
4998, 1, 1636421887098, 1636421887370, 272, 1, 271, 0, 0, 0
4999, 1, 1636421887354, 1636421887626, 272, 0, 272, 0, 0, 0
5000, 1, 1636421887446, 1636421887714, 268, 1, 267, 0, 1, 1
5001, 1, 1636421887766, 1636421888046, 280, 0, 280, 0, 0, 0
5003, 1, 1636421888022, 1636421888294, 272, 0, 272, 0, 0, 0
5004, 1, 1636421888110, 1636421888382, 272, 1, 271, 0, 0, 0
4914, 2, 1636421878834, 1636421888834, 10000, 0, 10000, 0, 0, 0
5006, 1, 1636421888690, 1636421888979, 289, 1, 288, 0, 1, 1
4915, 2, 1636421879154, 1636421889154, 10000, 0, 10000, 0, 0, 0
5008, 1, 1636421889142, 1636421889410, 268, 0, 268, 0, 0, 0
5010, 1, 1636421889462, 1636421889734, 272, 0, 272, 0, 0, 0
4923, 2, 1636421879998, 1636421889998, 10000, 0, 10000, 0, 0, 0
5011, 1, 1636421889802, 1636421890074, 272, 0, 272, 0, 0, 0
4928, 2, 1636421880270, 1636421890270, 10000, 0, 10000, 0, 0, 0
5012, 1, 1636421890130, 1636421890410, 280, 0, 280, 0, 0, 0
5013, 1, 1636421890314, 1636421890682, 368, 97, 271, 97, 0, 97
5014, 1, 1636421890470, 1636421890742, 272, 0, 272, 0, 0, 0
5015, 1, 1636421890578, 1636421890958, 380, 105, 275, 105, 0, 105
5016, 1, 1636421890806, 1636421891078, 272, 0, 272, 0, 0, 0
4939, 2, 1636421881350, 1636421891350, 10000, 0, 10000, 1, 0, 1
5017, 1, 1636421891078, 1636421891398, 320, 0, 320, 0, 0, 0
5019, 1, 1636421891398, 1636421891666, 268, 1, 267, 1, 0, 1
4944, 2, 1636421881786, 1636421891786, 10000, 0, 10000, 0, 0, 0
5021, 1, 1636421891658, 1636421891930, 272, 0, 272, 0, 0, 0
5022, 1, 1636421891830, 1636421892106, 276, 1, 275, 0, 1, 1
5024, 1, 1636421892090, 1636421892362, 272, 0, 272, 0, 0, 0
5023, 1, 1636421892066, 1636421892374, 308, 41, 267, 40, 0, 40
4951, 2, 1636421882402, 1636421892402, 10000, 0, 10000, 0, 0, 0
5026, 1, 1636421892498, 1636421892770, 272, 1, 271, 0, 0, 0
5027, 1, 1636421892706, 1636421892978, 272, 0, 272, 0, 0, 0
4956, 2, 1636421882986, 1636421892986, 10000, 0, 10000, 0, 0, 0
5028, 1, 1636421892758, 1636421893034, 276, 0, 276, 0, 0, 0
5029, 1, 1636421892770, 1636421893042, 272, 1, 271, 1, 0, 1
4958, 2, 1636421883326, 1636421893326, 10000, 0, 10000, 0, 0, 0
5030, 1, 1636421893166, 1636421893466, 300, 1, 299, 0, 1, 1
5031, 1, 1636421893290, 1636421893566, 276, 1, 275, 0, 0, 0
5032, 1, 1636421893374, 1636421893650, 276, 0, 276, 0, 0, 0
5034, 1, 1636421893438, 1636421893746, 308, 28, 280, 28, 0, 28
5035, 1, 1636421893634, 1636421893906, 272, 0, 272, 0, 0, 0
5033, 1, 1636421893430, 1636421894014, 584, 317, 267, 316, 1, 317
5036, 1, 1636421893862, 1636421894138, 276, 0, 276, 0, 0, 0
5038, 1, 1636421894046, 1636421894318, 272, 0, 272, 0, 0, 0
5039, 1, 1636421894142, 1636421894410, 268, 0, 268, 0, 0, 0
5041, 1, 1636421894414, 1636421894690, 276, 0, 276, 0, 0, 0
5042, 1, 1636421894534, 1636421894806, 272, 1, 271, 1, 0, 1
5043, 1, 1636421894714, 1636421894986, 272, 1, 271, 0, 0, 0
5044, 1, 1636421894810, 1636421895082, 272, 0, 272, 0, 0, 0
5045, 1, 1636421895090, 1636421895366, 276, 0, 276, 0, 0, 0
4981, 2, 1636421885406, 1636421895406, 10000, 0, 10000, 0, 0, 0
4980, 2, 1636421885406, 1636421895454, 10048, 0, 10048, 1, 0, 1
5046, 1, 1636421895198, 1636421895502, 304, 1, 303, 0, 1, 1
5047, 1, 1636421895382, 1636421895682, 300, 0, 300, 0, 0, 0
5048, 1, 1636421895502, 1636421895774, 272, 0, 272, 0, 0, 0
5049, 1, 1636421895718, 1636421895990, 272, 0, 272, 0, 0, 0
5050, 1, 1636421895722, 1636421895994, 272, 0, 272, 0, 0, 0
4987, 2, 1636421886002, 1636421896002, 10000, 0, 10000, 0, 0, 0
5051, 1, 1636421895766, 1636421896050, 284, 0, 284, 0, 0, 0
4988, 2, 1636421886074, 1636421896074, 10000, 0, 10000, 0, 0, 0
5052, 1, 1636421895898, 1636421896210, 312, 0, 312, 0, 0, 0
5053, 1, 1636421896118, 1636421896390, 272, 0, 272, 0, 0, 0
5054, 1, 1636421896178, 1636421896482, 304, 33, 271, 33, 0, 33
5055, 1, 1636421896334, 1636421896606, 272, 1, 271, 0, 1, 1
5056, 1, 1636421896382, 1636421896654, 272, 0, 272, 0, 0, 0
4993, 2, 1636421886714, 1636421896714, 10000, 0, 10000, 0, 0, 0
5059, 1, 1636421896446, 1636421896762, 316, 0, 316, 0, 0, 0
5060, 1, 1636421896606, 1636421896882, 276, 0, 276, 0, 0, 0
4995, 2, 1636421886998, 1636421896998, 10000, 0, 10000, 0, 0, 0
5061, 1, 1636421896806, 1636421897078, 272, 0, 272, 0, 0, 0
4996, 2, 1636421887098, 1636421897094, 9996, 0, 9996, 0, 0, 0
5062, 1, 1636421896894, 1636421897170, 276, 0, 276, 0, 0, 0
5064, 1, 1636421897042, 1636421897322, 280, 0, 280, 0, 0, 0
5066, 1, 1636421897182, 1636421897454, 272, 0, 272, 0, 0, 0
5067, 1, 1636421897278, 1636421897558, 280, 0, 280, 0, 0, 0
5068, 1, 1636421897306, 1636421897590, 284, 17, 267, 17, 0, 17
5069, 1, 1636421897414, 1636421897686, 272, 0, 272, 0, 0, 0
5070, 1, 1636421897474, 1636421897746, 272, 0, 272, 0, 0, 0
5002, 2, 1636421887766, 1636421897766, 10000, 0, 10000, 0, 0, 0
5071, 1, 1636421897570, 1636421897838, 268, 0, 268, 0, 0, 0
5073, 1, 1636421897854, 1636421898126, 272, 0, 272, 0, 0, 0
5076, 1, 1636421898074, 1636421898346, 272, 0, 272, 0, 0, 0
5078, 1, 1636421898146, 1636421898422, 276, 0, 276, 0, 0, 0
5005, 2, 1636421888442, 1636421898442, 10000, 0, 10000, 0, 0, 0
5007, 2, 1636421888778, 1636421898778, 10000, 0, 10000, 0, 0, 0
5080, 1, 1636421898530, 1636421898826, 296, 0, 296, 0, 0, 0
5082, 1, 1636421898750, 1636421899022, 272, 1, 271, 0, 0, 0
5083, 1, 1636421898822, 1636421899098, 276, 4, 272, 4, 0, 4
5084, 1, 1636421899086, 1636421899362, 276, 0, 276, 0, 0, 0
5009, 2, 1636421889374, 1636421899374, 10000, 0, 10000, 0, 0, 0
5085, 1, 1636421899222, 1636421899514, 292, 0, 292, 0, 0, 0
5087, 1, 1636421899494, 1636421899786, 292, 21, 271, 21, 0, 21
5088, 1, 1636421899682, 1636421899954, 272, 0, 272, 0, 0, 0
5018, 2, 1636421891134, 1636421901134, 10000, 0, 10000, 0, 0, 0
5020, 1, 1636421891482, 1636421901410, 9928, 9653, 275, 0, 9653, 9653
5093, 1, 1636421901438, 1636421901710, 272, 1, 271, 0, 1, 1
5094, 1, 1636421901806, 1636421902078, 272, 0, 272, 0, 0, 0
5025, 2, 1636421892326, 1636421902326, 10000, 0, 10000, 0, 0, 0
5097, 1, 1636421902634, 1636421902910, 276, 0, 276, 0, 0, 0
5098, 1, 1636421903310, 1636421903582, 272, 1, 271, 0, 0, 0
5037, 2, 1636421893966, 1636421903966, 10000, 0, 10000, 0, 0, 0
5099, 1, 1636421904010, 1636421904282, 272, 0, 272, 0, 0, 0
5040, 2, 1636421894302, 1636421904302, 10000, 0, 10000, 0, 0, 0
5100, 1, 1636421904270, 1636421904546, 276, 1, 275, 0, 1, 1
5101, 1, 1636421904610, 1636421904886, 276, 0, 276, 0, 0, 0
5102, 1, 1636421904678, 1636421904950, 272, 1, 271, 0, 0, 0
5103, 1, 1636421904946, 1636421905218, 272, 0, 272, 0, 0, 0
5104, 1, 1636421905282, 1636421905554, 272, 0, 272, 0, 0, 0
5105, 1, 1636421905346, 1636421905618, 272, 1, 271, 0, 0, 0
5106, 1, 1636421905618, 1636421905890, 272, 1, 271, 1, 0, 1
5107, 1, 1636421905950, 1636421906226, 276, 0, 276, 0, 0, 0
5108, 1, 1636421906018, 1636421906290, 272, 0, 272, 0, 0, 0
5057, 2, 1636421896386, 1636421906386, 10000, 0, 10000, 0, 0, 0
5058, 2, 1636421896390, 1636421906430, 10040, 0, 10040, 0, 0, 0
5109, 1, 1636421906286, 1636421906566, 280, 0, 280, 0, 0, 0
5110, 1, 1636421906622, 1636421906898, 276, 0, 276, 0, 0, 0
5111, 1, 1636421906686, 1636421906958, 272, 0, 272, 0, 0, 0
5112, 1, 1636421906694, 1636421906966, 272, 0, 272, 0, 0, 0
5063, 2, 1636421896998, 1636421906998, 10000, 0, 10000, 0, 0, 0
5065, 2, 1636421897086, 1636421907086, 10000, 0, 10000, 0, 0, 0
5114, 1, 1636421906962, 1636421907238, 276, 0, 276, 0, 0, 0
5115, 1, 1636421907294, 1636421907574, 280, 0, 280, 0, 0, 0
5116, 1, 1636421907346, 1636421907614, 268, 0, 268, 0, 0, 0
5118, 1, 1636421907366, 1636421907638, 272, 0, 272, 0, 0, 0
5072, 2, 1636421897718, 1636421907718, 10000, 0, 10000, 0, 0, 0
5117, 1, 1636421907354, 1636421907882, 528, 261, 267, 261, 0, 261
5120, 1, 1636421907638, 1636421907946, 308, 1, 307, 0, 0, 0
5074, 2, 1636421897950, 1636421907950, 10000, 0, 10000, 0, 0, 0
5075, 2, 1636421897986, 1636421907994, 10008, 0, 10008, 0, 0, 0
5077, 2, 1636421898086, 1636421908086, 10000, 0, 10000, 0, 0, 0
5079, 2, 1636421898238, 1636421908238, 10000, 0, 10000, 0, 0, 0
5122, 1, 1636421908042, 1636421908314, 272, 0, 272, 0, 0, 0
5121, 1, 1636421908038, 1636421908314, 276, 1, 275, 1, 0, 1
5123, 1, 1636421908042, 1636421908314, 272, 0, 272, 0, 0, 0
5124, 1, 1636421908038, 1636421908318, 280, 1, 279, 0, 0, 0
5126, 1, 1636421908286, 1636421908554, 268, 1, 267, 0, 0, 0
5125, 1, 1636421908286, 1636421908554, 268, 1, 267, 0, 0, 0
5127, 1, 1636421908330, 1636421908606, 276, 0, 276, 0, 0, 0
5128, 1, 1636421908342, 1636421908606, 264, 0, 264, 0, 0, 0
5081, 2, 1636421898742, 1636421908742, 10000, 0, 10000, 0, 0, 0
5132, 1, 1636421908706, 1636421908974, 268, 0, 268, 0, 0, 0
5131, 1, 1636421908714, 1636421908986, 272, 1, 271, 1, 0, 1
5133, 1, 1636421908714, 1636421908986, 272, 1, 271, 0, 0, 0
5134, 1, 1636421908722, 1636421908990, 268, 0, 268, 0, 0, 0
5135, 1, 1636421908954, 1636421909218, 264, 0, 264, 0, 0, 0
5137, 1, 1636421909002, 1636421909274, 272, 0, 272, 0, 0, 0
5138, 1, 1636421909010, 1636421909294, 284, 0, 284, 0, 0, 0
5086, 2, 1636421899422, 1636421909422, 10000, 0, 10000, 0, 0, 0
5140, 1, 1636421909374, 1636421909650, 276, 0, 276, 0, 0, 0
5141, 1, 1636421909386, 1636421909658, 272, 0, 272, 0, 0, 0
5143, 1, 1636421909390, 1636421909658, 268, 0, 268, 0, 0, 0
5089, 2, 1636421899758, 1636421909758, 10000, 0, 10000, 0, 0, 0
5144, 1, 1636421909622, 1636421909894, 272, 0, 272, 0, 0, 0
5090, 2, 1636421899906, 1636421909906, 10000, 0, 10000, 0, 0, 0
5142, 1, 1636421909390, 1636421909950, 560, 268, 292, 268, 0, 268
5146, 1, 1636421909698, 1636421909982, 284, 0, 284, 0, 0, 0
5147, 1, 1636421909730, 1636421910042, 312, 0, 312, 0, 0, 0
5091, 2, 1636421900182, 1636421910182, 10000, 0, 10000, 0, 0, 0
5145, 1, 1636421909674, 1636421910226, 552, 277, 275, 277, 0, 277
5092, 2, 1636421900350, 1636421910350, 10000, 0, 10000, 0, 0, 0
5148, 1, 1636421910082, 1636421910399, 317, 0, 317, 0, 0, 0
5149, 1, 1636421910086, 1636421910399, 313, 0, 313, 0, 0, 0
5151, 1, 1636421910086, 1636421910399, 313, 1, 312, 0, 0, 0
5150, 1, 1636421910086, 1636421910494, 408, 140, 268, 140, 0, 140
5155, 1, 1636421910398, 1636421910670, 272, 1, 271, 0, 1, 1
5154, 1, 1636421910398, 1636421910670, 272, 1, 271, 0, 1, 1
5156, 1, 1636421910442, 1636421910714, 272, 0, 272, 0, 0, 0
5158, 1, 1636421910630, 1636421910902, 272, 0, 272, 0, 0, 0
5159, 1, 1636421910654, 1636421910922, 268, 0, 268, 0, 0, 0
5160, 1, 1636421910794, 1636421911058, 264, 1, 263, 1, 0, 1
5161, 1, 1636421910794, 1636421911059, 265, 1, 264, 1, 0, 1
5162, 1, 1636421910794, 1636421911058, 264, 1, 263, 1, 0, 1
5163, 1, 1636421910890, 1636421911158, 268, 0, 268, 0, 0, 0
5165, 1, 1636421911066, 1636421911334, 268, 0, 268, 0, 0, 0
5164, 1, 1636421911066, 1636421911334, 268, 0, 268, 0, 0, 0
5166, 1, 1636421911114, 1636421911390, 276, 0, 276, 0, 0, 0
5168, 1, 1636421911318, 1636421911590, 272, 0, 272, 0, 0, 0
5167, 1, 1636421911298, 1636421911654, 356, 93, 263, 93, 0, 93
5169, 1, 1636421911458, 1636421911730, 272, 0, 272, 0, 0, 0
5170, 1, 1636421911462, 1636421911738, 276, 0, 276, 0, 0, 0
5172, 1, 1636421911558, 1636421911826, 268, 0, 268, 0, 0, 0
5171, 1, 1636421911462, 1636421911922, 460, 193, 267, 193, 0, 193
5173, 1, 1636421911738, 1636421912014, 276, 1, 275, 0, 1, 1
5175, 1, 1636421911790, 1636421912066, 276, 0, 276, 0, 0, 0
5095, 2, 1636421902102, 1636421912102, 10000, 0, 10000, 0, 0, 0
5176, 1, 1636421911986, 1636421912254, 268, 1, 267, 0, 0, 0
5177, 1, 1636421912054, 1636421912330, 276, 0, 276, 0, 0, 0
5178, 1, 1636421912150, 1636421912422, 272, 0, 272, 0, 0, 0
5180, 1, 1636421912222, 1636421912494, 272, 0, 272, 0, 0, 0
5096, 2, 1636421902506, 1636421912506, 10000, 0, 10000, 0, 0, 0
5181, 1, 1636421912318, 1636421912590, 272, 0, 272, 0, 0, 0
5183, 1, 1636421912414, 1636421912682, 268, 0, 268, 0, 0, 0
5184, 1, 1636421912462, 1636421912730, 268, 0, 268, 0, 0, 0
5182, 1, 1636421912406, 1636421912758, 352, 89, 263, 89, 0, 89
5185, 1, 1636421912682, 1636421912962, 280, 0, 280, 0, 0, 0
5186, 1, 1636421912730, 1636421912998, 268, 0, 268, 0, 0, 0
5187, 1, 1636421912814, 1636421913086, 272, 0, 272, 0, 0, 0
5189, 1, 1636421912886, 1636421913162, 276, 1, 275, 0, 0, 0
5190, 1, 1636421912990, 1636421913266, 276, 0, 276, 0, 0, 0
5191, 1, 1636421913082, 1636421913358, 276, 0, 276, 0, 0, 0
5188, 1, 1636421912814, 1636421913358, 544, 272, 272, 272, 0, 272
5192, 1, 1636421913130, 1636421913402, 272, 0, 272, 0, 0, 0
5193, 1, 1636421913150, 1636421913422, 272, 0, 272, 0, 0, 0
5194, 1, 1636421913358, 1636421913622, 264, 0, 264, 0, 0, 0
5195, 1, 1636421913402, 1636421913666, 264, 0, 264, 0, 0, 0
5196, 1, 1636421913486, 1636421913762, 276, 0, 276, 0, 0, 0
5197, 1, 1636421913558, 1636421913830, 272, 0, 272, 0, 0, 0
5198, 1, 1636421913662, 1636421913934, 272, 0, 272, 0, 0, 0
5200, 1, 1636421913758, 1636421914026, 268, 0, 268, 0, 0, 0
5199, 1, 1636421913754, 1636421914026, 272, 0, 272, 0, 0, 0
5201, 1, 1636421913806, 1636421914070, 264, 0, 264, 0, 0, 0
5202, 1, 1636421913818, 1636421914090, 272, 0, 272, 0, 0, 0
5203, 1, 1636421914022, 1636421914294, 272, 0, 272, 0, 0, 0
5204, 1, 1636421914066, 1636421914334, 268, 0, 268, 0, 0, 0
5205, 1, 1636421914158, 1636421914430, 272, 0, 272, 0, 0, 0
5206, 1, 1636421914226, 1636421914498, 272, 0, 272, 0, 0, 0
5207, 1, 1636421914330, 1636421914598, 268, 0, 268, 0, 0, 0
5209, 1, 1636421914426, 1636421914690, 264, 0, 264, 0, 0, 0
5210, 1, 1636421914470, 1636421914738, 268, 0, 268, 0, 0, 0
5211, 1, 1636421914486, 1636421914750, 264, 0, 264, 0, 0, 0
5212, 1, 1636421914690, 1636421914954, 264, 0, 264, 0, 0, 0
5213, 1, 1636421914730, 1636421915002, 272, 0, 272, 0, 0, 0
5214, 1, 1636421914834, 1636421915106, 272, 0, 272, 0, 0, 0
5216, 1, 1636421914994, 1636421915266, 272, 1, 271, 0, 0, 0
5217, 1, 1636421915090, 1636421915362, 272, 0, 272, 0, 0, 0
5218, 1, 1636421915134, 1636421915406, 272, 0, 272, 0, 0, 0
5219, 1, 1636421915154, 1636421915426, 272, 0, 272, 0, 0, 0
5220, 1, 1636421915354, 1636421915626, 272, 0, 272, 0, 0, 0
5221, 1, 1636421915402, 1636421915670, 268, 0, 268, 0, 0, 0
5222, 1, 1636421915506, 1636421915778, 272, 0, 272, 0, 0, 0
5223, 1, 1636421915662, 1636421915930, 268, 0, 268, 0, 0, 0
5225, 1, 1636421915806, 1636421916078, 272, 0, 272, 0, 0, 0
5226, 1, 1636421915822, 1636421916090, 268, 0, 268, 0, 0, 0
5227, 1, 1636421916026, 1636421916298, 272, 0, 272, 0, 0, 0
5229, 1, 1636421916174, 1636421916446, 272, 0, 272, 0, 0, 0
5230, 1, 1636421916330, 1636421916598, 268, 1, 267, 0, 0, 0
5113, 2, 1636421906702, 1636421916702, 10000, 0, 10000, 0, 0, 0
5231, 1, 1636421916474, 1636421916750, 276, 0, 276, 0, 0, 0
5232, 1, 1636421916490, 1636421916758, 268, 0, 268, 0, 0, 0
5233, 1, 1636421916698, 1636421916962, 264, 0, 264, 0, 0, 0
5234, 1, 1636421916878, 1636421917154, 276, 0, 276, 0, 0, 0
5235, 1, 1636421916998, 1636421917270, 272, 0, 272, 0, 0, 0
5236, 1, 1636421917014, 1636421917282, 268, 0, 268, 0, 0, 0
5119, 2, 1636421907398, 1636421917398, 10000, 0, 10000, 0, 0, 0
5238, 1, 1636421917158, 1636421917562, 404, 125, 279, 125, 0, 125
5239, 1, 1636421917362, 1636421917630, 268, 0, 268, 0, 0, 0
5240, 1, 1636421917578, 1636421917850, 272, 0, 272, 0, 0, 0
5242, 1, 1636421917678, 1636421917946, 268, 0, 268, 0, 0, 0
5243, 1, 1636421917706, 1636421917978, 272, 1, 271, 0, 0, 0
5244, 1, 1636421917954, 1636421918222, 268, 0, 268, 0, 0, 0
5129, 2, 1636421908414, 1636421918414, 10000, 0, 10000, 0, 0, 0
5246, 1, 1636421918246, 1636421918550, 304, 0, 304, 0, 0, 0
5130, 2, 1636421908546, 1636421918643, 10097, 9, 10088, 9, 0, 9
5248, 1, 1636421918374, 1636421918734, 360, 0, 360, 0, 0, 0
5247, 1, 1636421918346, 1636421918734, 388, 1, 387, 0, 0, 0
5157, 1, 1636421910526, 1636421918922, 8396, 8117, 279, 8117, 0, 8117
5136, 2, 1636421908954, 1636421918954, 10000, 0, 10000, 0, 0, 0
5250, 1, 1636421918738, 1636421919018, 280, 0, 280, 0, 0, 0
5139, 2, 1636421909050, 1636421919050, 10000, 0, 10000, 0, 0, 0
5152, 1, 1636421910226, 1636421919190, 8964, 8697, 267, 8697, 0, 8697
5251, 1, 1636421918946, 1636421919286, 340, 73, 267, 73, 0, 73
5254, 1, 1636421919138, 1636421919410, 272, 1, 271, 0, 1, 1
5253, 1, 1636421919138, 1636421919410, 272, 1, 271, 1, 0, 1
5257, 1, 1636421919358, 1636421919630, 272, 0, 272, 0, 0, 0
5258, 1, 1636421919418, 1636421919690, 272, 0, 272, 0, 0, 0
5260, 1, 1636421919682, 1636421919958, 276, 0, 276, 0, 0, 0
5261, 1, 1636421919810, 1636421920082, 272, 0, 272, 0, 0, 0
5262, 1, 1636421919810, 1636421920082, 272, 0, 272, 0, 0, 0
5153, 2, 1636421910294, 1636421920294, 10000, 0, 10000, 0, 0, 0
5263, 1, 1636421920026, 1636421920342, 316, 1, 315, 0, 0, 0
5264, 1, 1636421920086, 1636421920358, 272, 0, 272, 0, 0, 0
5266, 1, 1636421920478, 1636421920750, 272, 0, 272, 0, 0, 0
5267, 1, 1636421920482, 1636421920750, 268, 0, 268, 0, 0, 0
5268, 1, 1636421920602, 1636421920874, 272, 0, 272, 0, 0, 0
5269, 1, 1636421920738, 1636421921006, 268, 0, 268, 0, 0, 0
5270, 1, 1636421920754, 1636421921018, 264, 0, 264, 0, 0, 0
5271, 1, 1636421921146, 1636421921418, 272, 1, 271, 1, 0, 1
5272, 1, 1636421921146, 1636421921418, 272, 1, 271, 0, 1, 1
5274, 1, 1636421921406, 1636421921674, 268, 0, 268, 0, 0, 0
5275, 1, 1636421921426, 1636421921690, 264, 0, 264, 0, 0, 0
5174, 2, 1636421911738, 1636421921738, 10000, 0, 10000, 0, 0, 0
5276, 1, 1636421921826, 1636421922098, 272, 0, 272, 0, 0, 0
5277, 1, 1636421921826, 1636421922102, 276, 0, 276, 0, 0, 0
5179, 2, 1636421912150, 1636421922146, 9996, 0, 9996, 0, 0, 0
5278, 1, 1636421922042, 1636421922314, 272, 0, 272, 0, 0, 0
5279, 1, 1636421922074, 1636421922374, 300, 0, 300, 0, 0, 0
5280, 1, 1636421922094, 1636421922374, 280, 0, 280, 0, 0, 0
5281, 1, 1636421922458, 1636421922730, 272, 0, 272, 0, 0, 0
5282, 1, 1636421922494, 1636421922766, 272, 0, 272, 0, 0, 0
5283, 1, 1636421922498, 1636421922770, 272, 0, 272, 0, 0, 0
5286, 1, 1636421922774, 1636421923054, 280, 0, 280, 0, 0, 0
5285, 1, 1636421922778, 1636421923055, 277, 0, 277, 0, 0, 0
5289, 1, 1636421923166, 1636421923434, 268, 0, 268, 0, 0, 0
5288, 1, 1636421923162, 1636421923434, 272, 0, 272, 0, 0, 0
5290, 1, 1636421923450, 1636421923722, 272, 1, 271, 0, 0, 0
5291, 1, 1636421923450, 1636421923730, 280, 0, 280, 0, 0, 0
5293, 1, 1636421923834, 1636421924102, 268, 0, 268, 0, 0, 0
5292, 1, 1636421923830, 1636421924106, 276, 0, 276, 0, 0, 0
5294, 1, 1636421924122, 1636421924394, 272, 0, 272, 0, 0, 0
5295, 1, 1636421924130, 1636421924406, 276, 1, 275, 0, 1, 1
5208, 2, 1636421914426, 1636421924426, 10000, 0, 10000, 0, 0, 0
5296, 1, 1636421924514, 1636421924786, 272, 1, 271, 0, 1, 1
5297, 1, 1636421924514, 1636421924790, 276, 0, 276, 0, 0, 0
5215, 2, 1636421914890, 1636421924890, 10000, 0, 10000, 0, 0, 0
5298, 1, 1636421924734, 1636421925026, 292, 1, 291, 0, 1, 1
5299, 1, 1636421924794, 1636421925066, 272, 0, 272, 0, 0, 0
5300, 1, 1636421924802, 1636421925118, 316, 0, 316, 0, 0, 0
5301, 1, 1636421925182, 1636421925450, 268, 0, 268, 0, 0, 0
5302, 1, 1636421925186, 1636421925450, 264, 0, 264, 0, 0, 0
5303, 1, 1636421925190, 1636421925458, 268, 0, 268, 0, 0, 0
5305, 1, 1636421925462, 1636421925734, 272, 0, 272, 0, 0, 0
5224, 2, 1636421915762, 1636421925762, 10000, 0, 10000, 0, 0, 0
5306, 1, 1636421925514, 1636421925806, 292, 0, 292, 0, 0, 0
5228, 2, 1636421916070, 1636421926070, 10000, 0, 10000, 0, 0, 0
5308, 1, 1636421925854, 1636421926126, 272, 1, 271, 1, 0, 1
5307, 1, 1636421925854, 1636421926126, 272, 1, 271, 0, 1, 1
5310, 1, 1636421926066, 1636421926338, 272, 0, 272, 0, 0, 0
5311, 1, 1636421926162, 1636421926430, 268, 0, 268, 0, 0, 0
5312, 1, 1636421926206, 1636421926478, 272, 0, 272, 0, 0, 0
5313, 1, 1636421926378, 1636421926650, 272, 1, 271, 0, 1, 1
5315, 1, 1636421926522, 1636421926790, 268, 0, 268, 0, 0, 0
5314, 1, 1636421926522, 1636421926790, 268, 0, 268, 0, 0, 0
5317, 1, 1636421926826, 1636421927094, 268, 0, 268, 0, 0, 0
5318, 1, 1636421926874, 1636421927142, 268, 0, 268, 0, 0, 0
5237, 2, 1636421917146, 1636421927146, 10000, 0, 10000, 0, 0, 0
5321, 1, 1636421927190, 1636421927462, 272, 0, 272, 0, 0, 0
5320, 1, 1636421927194, 1636421927462, 268, 0, 268, 0, 0, 0
5241, 2, 1636421917666, 1636421927666, 10000, 0, 10000, 0, 0, 0
5322, 1, 1636421927454, 1636421927726, 272, 0, 272, 0, 0, 0
5323, 1, 1636421927494, 1636421927802, 308, 1, 307, 0, 0, 0
5324, 1, 1636421927542, 1636421927810, 268, 0, 268, 0, 0, 0
5245, 2, 1636421918034, 1636421928034, 10000, 0, 10000, 0, 0, 0
5326, 1, 1636421927858, 1636421928170, 312, 0, 312, 0, 0, 0
5325, 1, 1636421927866, 1636421928170, 304, 0, 304, 0, 0, 0
5327, 1, 1636421927978, 1636421928262, 284, 0, 284, 0, 0, 0
5330, 1, 1636421928214, 1636421928478, 264, 0, 264, 0, 0, 0
5329, 1, 1636421928214, 1636421928478, 264, 0, 264, 0, 0, 0
5331, 1, 1636421928350, 1636421928618, 268, 1, 267, 0, 1, 1
5249, 2, 1636421918622, 1636421928622, 10000, 0, 10000, 0, 0, 0
5332, 1, 1636421928566, 1636421928850, 284, 0, 284, 0, 0, 0
5333, 1, 1636421928570, 1636421928850, 280, 0, 280, 0, 0, 0
5252, 2, 1636421918998, 1636421928998, 10000, 0, 10000, 0, 0, 0
5335, 1, 1636421928878, 1636421929150, 272, 1, 271, 0, 0, 0
5336, 1, 1636421928878, 1636421929150, 272, 1, 271, 0, 1, 1
5337, 1, 1636421928926, 1636421929226, 300, 0, 300, 0, 0, 0
5255, 2, 1636421919262, 1636421929262, 10000, 0, 10000, 0, 0, 0
5256, 2, 1636421919318, 1636421929318, 10000, 0, 10000, 0, 0, 0
5339, 1, 1636421929246, 1636421929550, 304, 0, 304, 0, 0, 0
5340, 1, 1636421929246, 1636421929550, 304, 0, 304, 0, 0, 0
5259, 2, 1636421919586, 1636421929586, 10000, 0, 10000, 0, 0, 0
5342, 1, 1636421929546, 1636421929814, 268, 0, 268, 0, 0, 0
5343, 1, 1636421929546, 1636421929814, 268, 0, 268, 0, 0, 0
5344, 1, 1636421929578, 1636421929854, 276, 0, 276, 0, 0, 0
5349, 1, 1636421929946, 1636421930218, 272, 1, 271, 1, 0, 1
5348, 1, 1636421929946, 1636421930218, 272, 1, 271, 0, 0, 0
5265, 2, 1636421920382, 1636421930382, 10000, 0, 10000, 0, 0, 0
5351, 1, 1636421930214, 1636421930518, 304, 1, 303, 0, 0, 0
5350, 1, 1636421930214, 1636421930522, 308, 1, 307, 0, 1, 1
5352, 1, 1636421930254, 1636421930526, 272, 0, 272, 0, 0, 0
5353, 1, 1636421930614, 1636421930886, 272, 1, 271, 1, 0, 1
5355, 1, 1636421930690, 1636421930962, 272, 0, 272, 0, 0, 0
5356, 1, 1636421930914, 1636421931186, 272, 0, 272, 0, 0, 0
5357, 1, 1636421930922, 1636421931190, 268, 1, 267, 0, 0, 0
5358, 1, 1636421930922, 1636421931194, 272, 1, 271, 1, 0, 1
5273, 2, 1636421921270, 1636421931270, 10000, 0, 10000, 0, 0, 0
5362, 1, 1636421931582, 1636421931854, 272, 0, 272, 0, 0, 0
5363, 1, 1636421931586, 1636421931862, 276, 0, 276, 0, 0, 0
5364, 1, 1636421931590, 1636421931862, 272, 0, 272, 0, 0, 0
5365, 1, 1636421932250, 1636421932526, 276, 1, 275, 0, 0, 0
5367, 1, 1636421932266, 1636421932538, 272, 0, 272, 0, 0, 0
5284, 2, 1636421922710, 1636421932710, 10000, 0, 10000, 0, 0, 0
5287, 2, 1636421923126, 1636421933126, 10000, 0, 10000, 0, 0, 0
5369, 1, 1636421932930, 1636421933202, 272, 0, 272, 0, 0, 0
5372, 1, 1636421933598, 1636421933874, 276, 1, 275, 0, 1, 1
5373, 1, 1636421934274, 1636421934546, 272, 0, 272, 0, 0, 0
5374, 1, 1636421934942, 1636421935219, 277, 1, 276, 0, 1, 1
5304, 2, 1636421925426, 1636421935426, 10000, 0, 10000, 0, 0, 0
5309, 2, 1636421925854, 1636421935854, 10000, 0, 10000, 0, 0, 0
5375, 1, 1636421935614, 1636421935902, 288, 1, 287, 0, 0, 0
5378, 1, 1636421936298, 1636421936574, 276, 1, 275, 1, 0, 1
5316, 2, 1636421926738, 1636421936739, 10001, 0, 10001, 0, 0, 0
5319, 2, 1636421927046, 1636421937046, 10000, 0, 10000, 0, 0, 0
5379, 1, 1636421936970, 1636421937278, 308, 0, 308, 0, 0, 0
5382, 1, 1636421937674, 1636421937950, 276, 1, 275, 0, 0, 0
5328, 2, 1636421928126, 1636421938126, 10000, 0, 10000, 0, 0, 0
5383, 1, 1636421938342, 1636421938618, 276, 0, 276, 0, 0, 0
5334, 2, 1636421928666, 1636421938670, 10004, 0, 10004, 0, 0, 0
5338, 2, 1636421929046, 1636421939046, 10000, 0, 10000, 0, 0, 0
5386, 1, 1636421939014, 1636421939290, 276, 0, 276, 0, 0, 0
5341, 2, 1636421929306, 1636421939306, 10000, 0, 10000, 0, 0, 0
5346, 2, 1636421929630, 1636421939630, 10000, 0, 10000, 0, 0, 0
5345, 2, 1636421929630, 1636421939678, 10048, 0, 10048, 0, 0, 0
5347, 2, 1636421929894, 1636421939894, 10000, 0, 10000, 0, 0, 0
5388, 1, 1636421939614, 1636421939942, 328, 0, 328, 0, 0, 0
5389, 1, 1636421939726, 1636421940030, 304, 0, 304, 0, 0, 0
5392, 1, 1636421940198, 1636421940474, 276, 0, 276, 0, 0, 0
5354, 2, 1636421930614, 1636421940614, 10000, 0, 10000, 0, 0, 0
5393, 1, 1636421940342, 1636421940662, 320, 0, 320, 0, 0, 0
5394, 1, 1636421940430, 1636421940702, 272, 0, 272, 0, 0, 0
5391, 1, 1636421939942, 1636421940750, 808, 533, 275, 533, 0, 533
5395, 1, 1636421940870, 1636421941142, 272, 1, 271, 0, 0, 0
5396, 1, 1636421940922, 1636421941194, 272, 0, 272, 0, 0, 0
5359, 2, 1636421931318, 1636421941314, 9996, 0, 9996, 0, 0, 0
5360, 2, 1636421931358, 1636421941358, 10000, 0, 10000, 0, 0, 0
5397, 1, 1636421941058, 1636421941402, 344, 1, 343, 0, 0, 0
5398, 1, 1636421941094, 1636421941402, 308, 0, 308, 0, 0, 0
5399, 1, 1636421941146, 1636421941494, 348, 0, 348, 0, 0, 0
5361, 2, 1636421931578, 1636421941578, 10000, 0, 10000, 0, 0, 0
5400, 1, 1636421941534, 1636421941806, 272, 0, 272, 0, 0, 0
5402, 1, 1636421941666, 1636421941934, 268, 0, 268, 0, 0, 0
5404, 1, 1636421941798, 1636421942070, 272, 0, 272, 0, 0, 0
5405, 1, 1636421941802, 1636421942070, 268, 0, 268, 0, 0, 0
5407, 1, 1636421941886, 1636421942154, 268, 1, 267, 1, 0, 1
5406, 1, 1636421941886, 1636421942154, 268, 1, 267, 0, 1, 1
5366, 2, 1636421932258, 1636421942258, 10000, 0, 10000, 0, 0, 0
5408, 1, 1636421942202, 1636421942486, 284, 0, 284, 0, 0, 0
5411, 1, 1636421942474, 1636421942746, 272, 1, 271, 0, 1, 1
5410, 1, 1636421942474, 1636421942746, 272, 0, 272, 0, 0, 0
5413, 1, 1636421942554, 1636421942822, 268, 0, 268, 0, 0, 0
5412, 1, 1636421942550, 1636421942822, 272, 0, 272, 0, 0, 0
5414, 1, 1636421942570, 1636421942837, 267, 0, 267, 0, 0, 0
5368, 2, 1636421932922, 1636421942922, 10000, 0, 10000, 0, 0, 0
5370, 2, 1636421933014, 1636421943014, 10000, 0, 10000, 0, 0, 0
5415, 1, 1636421942886, 1636421943158, 272, 0, 272, 0, 0, 0
5417, 1, 1636421943142, 1636421943418, 276, 0, 276, 0, 0, 0
5371, 2, 1636421933438, 1636421943438, 10000, 0, 10000, 0, 0, 0
5418, 1, 1636421943218, 1636421943490, 272, 1, 271, 0, 0, 0
5419, 1, 1636421943218, 1636421943490, 272, 1, 271, 0, 1, 1
5420, 1, 1636421943230, 1636421943510, 280, 0, 280, 0, 0, 0
5422, 1, 1636421943318, 1636421943590, 272, 0, 272, 0, 0, 0
5423, 1, 1636421943554, 1636421943826, 272, 0, 272, 0, 0, 0
5424, 1, 1636421943746, 1636421944018, 272, 1, 271, 0, 0, 0
5425, 1, 1636421943814, 1636421944090, 276, 0, 276, 0, 0, 0
5426, 1, 1636421943890, 1636421944162, 272, 1, 271, 0, 1, 1
5427, 1, 1636421943890, 1636421944162, 272, 1, 271, 1, 0, 1
5429, 1, 1636421943990, 1636421944262, 272, 0, 272, 0, 0, 0
5430, 1, 1636421944222, 1636421944490, 268, 0, 268, 0, 0, 0
5431, 1, 1636421944422, 1636421944698, 276, 0, 276, 0, 0, 0
5432, 1, 1636421944490, 1636421944754, 264, 1, 263, 0, 1, 1
5433, 1, 1636421944558, 1636421944830, 272, 0, 272, 0, 0, 0
5434, 1, 1636421944558, 1636421944830, 272, 0, 272, 0, 0, 0
5435, 1, 1636421944662, 1636421944938, 276, 1, 275, 0, 0, 0
5436, 1, 1636421944886, 1636421945158, 272, 0, 272, 0, 0, 0
5437, 1, 1636421945098, 1636421945370, 272, 1, 271, 0, 0, 0
5438, 1, 1636421945158, 1636421945430, 272, 0, 272, 0, 0, 0
5440, 1, 1636421945230, 1636421945502, 272, 1, 271, 0, 1, 1
5439, 1, 1636421945230, 1636421945502, 272, 1, 271, 1, 0, 1
5441, 1, 1636421945334, 1636421945606, 272, 0, 272, 0, 0, 0
5376, 2, 1636421935734, 1636421945734, 10000, 0, 10000, 0, 0, 0
5442, 1, 1636421945554, 1636421945874, 320, 0, 320, 0, 0, 0
5443, 1, 1636421945782, 1636421946054, 272, 0, 272, 0, 0, 0
5444, 1, 1636421945830, 1636421946102, 272, 0, 272, 0, 0, 0
5377, 2, 1636421936158, 1636421946158, 10000, 0, 10000, 0, 0, 0
5446, 1, 1636421945910, 1636421946206, 296, 0, 296, 0, 0, 0
5445, 1, 1636421945917, 1636421946206, 289, 1, 288, 0, 0, 0
5447, 1, 1636421946002, 1636421946294, 292, 0, 292, 0, 0, 0
5448, 1, 1636421946042, 1636421946318, 276, 0, 276, 0, 0, 0
5449, 1, 1636421946270, 1636421946546, 276, 0, 276, 0, 0, 0
5451, 1, 1636421946466, 1636421946730, 264, 0, 264, 0, 0, 0
5450, 1, 1636421946454, 1636421946730, 276, 0, 276, 0, 0, 0
5452, 1, 1636421946498, 1636421946766, 268, 0, 268, 0, 0, 0
5454, 1, 1636421946602, 1636421946874, 272, 1, 271, 0, 1, 1
5453, 1, 1636421946602, 1636421946878, 276, 1, 275, 0, 0, 0
5455, 1, 1636421946694, 1636421946962, 268, 0, 268, 0, 0, 0
5456, 1, 1636421946714, 1636421946990, 276, 0, 276, 0, 0, 0
5380, 2, 1636421937042, 1636421947042, 10000, 0, 10000, 0, 0, 0
5457, 1, 1636421946942, 1636421947214, 272, 0, 272, 0, 0, 0
5381, 2, 1636421937354, 1636421947354, 10000, 0, 10000, 0, 0, 0
5458, 1, 1636421947134, 1636421947406, 272, 0, 272, 0, 0, 0
5459, 1, 1636421947134, 1636421947406, 272, 0, 272, 0, 0, 0
5460, 1, 1636421947166, 1636421947434, 268, 0, 268, 0, 0, 0
5461, 1, 1636421947270, 1636421947586, 316, 0, 316, 0, 0, 0
5462, 1, 1636421947274, 1636421947586, 312, 0, 312, 0, 0, 0
5463, 1, 1636421947346, 1636421947618, 272, 1, 271, 0, 0, 0
5465, 1, 1636421947402, 1636421947674, 272, 0, 272, 0, 0, 0
5464, 1, 1636421947398, 1636421947674, 276, 0, 276, 0, 0, 0
5466, 1, 1636421947610, 1636421947882, 272, 0, 272, 0, 0, 0
5467, 1, 1636421947674, 1636421947946, 272, 0, 272, 0, 0, 0
5468, 1, 1636421947802, 1636421948082, 280, 0, 280, 0, 0, 0
5469, 1, 1636421947810, 1636421948086, 276, 0, 276, 0, 0, 0
5470, 1, 1636421947834, 1636421948106, 272, 0, 272, 0, 0, 0
5471, 1, 1636421947986, 1636421948258, 272, 0, 272, 0, 0, 0
5472, 1, 1636421947994, 1636421948266, 272, 0, 272, 0, 0, 0
5473, 1, 1636421948026, 1636421948294, 268, 0, 268, 0, 0, 0
5475, 1, 1636421948074, 1636421948346, 272, 0, 272, 0, 0, 0
5474, 1, 1636421948074, 1636421948354, 280, 1, 279, 0, 1, 1
5384, 2, 1636421938438, 1636421948438, 10000, 0, 10000, 0, 0, 0
5476, 1, 1636421948278, 1636421948574, 296, 0, 296, 0, 0, 0
5477, 1, 1636421948346, 1636421948610, 264, 0, 264, 0, 0, 0
5478, 1, 1636421948486, 1636421948758, 272, 0, 272, 0, 0, 0
5479, 1, 1636421948486, 1636421948758, 272, 1, 271, 0, 1, 1
5480, 1, 1636421948533, 1636421948806, 273, 1, 272, 0, 0, 0
5481, 1, 1636421948654, 1636421948926, 272, 0, 272, 0, 0, 0
5482, 1, 1636421948670, 1636421948938, 268, 0, 268, 0, 0, 0
5483, 1, 1636421948690, 1636421948962, 272, 0, 272, 0, 0, 0
5385, 2, 1636421938974, 1636421948978, 10004, 0, 10004, 0, 0, 0
5486, 1, 1636421948754, 1636421949026, 272, 0, 272, 0, 0, 0
5485, 1, 1636421948746, 1636421949026, 280, 0, 280, 0, 0, 0
5484, 1, 1636421948742, 1636421949026, 284, 0, 284, 0, 0, 0
5487, 1, 1636421948970, 1636421949238, 268, 0, 268, 0, 0, 0
5488, 1, 1636421949022, 1636421949298, 276, 0, 276, 0, 0, 0
5387, 2, 1636421939350, 1636421949354, 10004, 0, 10004, 0, 0, 0
5490, 1, 1636421949162, 1636421949434, 272, 0, 272, 0, 0, 0
5489, 1, 1636421949158, 1636421949434, 276, 0, 276, 0, 0, 0
5491, 1, 1636421949210, 1636421949494, 284, 0, 284, 0, 0, 0
5492, 1, 1636421949282, 1636421949582, 300, 0, 300, 0, 0, 0
5493, 1, 1636421949322, 1636421949590, 268, 0, 268, 0, 0, 0
5494, 1, 1636421949350, 1636421949618, 268, 0, 268, 0, 0, 0
5495, 1, 1636421949402, 1636421949670, 268, 0, 268, 0, 0, 0
5498, 1, 1636421949446, 1636421949714, 268, 0, 268, 0, 0, 0
5496, 1, 1636421949446, 1636421949722, 276, 0, 276, 0, 0, 0
5497, 1, 1636421949446, 1636421949722, 276, 1, 275, 0, 0, 0
5499, 1, 1636421949642, 1636421949914, 272, 0, 272, 0, 0, 0
5500, 1, 1636421949658, 1636421949926, 268, 0, 268, 0, 0, 0
5390, 2, 1636421939942, 1636421949942, 10000, 0, 10000, 0, 0, 0
5501, 1, 1636421949694, 1636421949990, 296, 0, 296, 0, 0, 0
5503, 1, 1636421949830, 1636421950098, 268, 0, 268, 0, 0, 0
5502, 1, 1636421949834, 1636421950110, 276, 0, 276, 0, 0, 0
5504, 1, 1636421949890, 1636421950170, 280, 0, 280, 0, 0, 0
5505, 1, 1636421949990, 1636421950262, 272, 0, 272, 0, 0, 0
5506, 1, 1636421949990, 1636421950262, 272, 0, 272, 0, 0, 0
5507, 1, 1636421950034, 1636421950306, 272, 0, 272, 0, 0, 0
5508, 1, 1636421950066, 1636421950338, 272, 0, 272, 0, 0, 0
5509, 1, 1636421950122, 1636421950386, 264, 0, 264, 0, 0, 0
5511, 1, 1636421950126, 1636421950394, 268, 0, 268, 0, 0, 0
5510, 1, 1636421950126, 1636421950394, 268, 0, 268, 0, 0, 0
5512, 1, 1636421950242, 1636421950506, 264, 0, 264, 0, 0, 0
5513, 1, 1636421950310, 1636421950578, 268, 0, 268, 0, 0, 0
5514, 1, 1636421950322, 1636421950594, 272, 0, 272, 0, 0, 0
5515, 1, 1636421950386, 1636421950654, 268, 0, 268, 0, 0, 0
5516, 1, 1636421950498, 1636421950766, 268, 0, 268, 0, 0, 0
5517, 1, 1636421950506, 1636421950774, 268, 0, 268, 0, 0, 0
5518, 1, 1636421950574, 1636421950838, 264, 0, 264, 0, 0, 0
5520, 1, 1636421950658, 1636421950930, 272, 1, 271, 0, 0, 0
5519, 1, 1636421950658, 1636421950930, 272, 1, 271, 0, 1, 1
5521, 1, 1636421950706, 1636421950974, 268, 0, 268, 0, 0, 0
5522, 1, 1636421950738, 1636421951010, 272, 0, 272, 0, 0, 0
5523, 1, 1636421950782, 1636421951054, 272, 0, 272, 0, 0, 0
5525, 1, 1636421950794, 1636421951070, 276, 0, 276, 0, 0, 0
5524, 1, 1636421950790, 1636421951070, 280, 0, 280, 0, 0, 0
5526, 1, 1636421950902, 1636421951166, 264, 0, 264, 0, 0, 0
5527, 1, 1636421950982, 1636421951254, 272, 0, 272, 0, 0, 0
5528, 1, 1636421950994, 1636421951266, 272, 0, 272, 0, 0, 0
5529, 1, 1636421951054, 1636421951318, 264, 0, 264, 0, 0, 0
5530, 1, 1636421951162, 1636421951442, 280, 0, 280, 0, 0, 0
5531, 1, 1636421951170, 1636421951442, 272, 0, 272, 0, 0, 0
5532, 1, 1636421951238, 1636421951518, 280, 0, 280, 0, 0, 0
5533, 1, 1636421951326, 1636421951598, 272, 1, 271, 0, 1, 1
5534, 1, 1636421951326, 1636421951602, 276, 1, 275, 0, 1, 1
5401, 2, 1636421941622, 1636421951626, 10004, 0, 10004, 0, 0, 0
5403, 2, 1636421941670, 1636421951670, 10000, 0, 10000, 0, 0, 0
5536, 1, 1636421951410, 1636421951722, 312, 0, 312, 0, 0, 0
5535, 1, 1636421951374, 1636421951722, 348, 0, 348, 0, 0, 0
5538, 1, 1636421951466, 1636421951810, 344, 0, 344, 0, 0, 0
5539, 1, 1636421951474, 1636421951814, 340, 0, 340, 0, 0, 0
5537, 1, 1636421951450, 1636421951814, 364, 0, 364, 0, 0, 0
5540, 1, 1636421951570, 1636421951902, 332, 0, 332, 0, 0, 0
5542, 1, 1636421951718, 1636421951990, 272, 1, 271, 0, 0, 0
5541, 1, 1636421951718, 1636421951990, 272, 1, 271, 0, 1, 1
5543, 1, 1636421951722, 1636421951994, 272, 1, 271, 0, 0, 0
5545, 1, 1636421951846, 1636421952122, 276, 0, 276, 0, 0, 0
5544, 1, 1636421951850, 1636421952122, 272, 0, 272, 0, 0, 0
5546, 1, 1636421951918, 1636421952182, 264, 0, 264, 0, 0, 0
5548, 1, 1636421951978, 1636421952246, 268, 0, 268, 0, 0, 0
5549, 1, 1636421951994, 1636421952266, 272, 0, 272, 0, 0, 0
5550, 1, 1636421952002, 1636421952274, 272, 0, 272, 0, 0, 0
5409, 2, 1636421942346, 1636421952346, 10000, 0, 10000, 0, 0, 0
5551, 1, 1636421952118, 1636421952398, 280, 1, 279, 0, 1, 1
5552, 1, 1636421952118, 1636421952402, 284, 1, 283, 0, 0, 0
5553, 1, 1636421952210, 1636421952482, 272, 0, 272, 0, 0, 0
5554, 1, 1636421952218, 1636421952490, 272, 0, 272, 0, 0, 0
5555, 1, 1636421952210, 1636421952498, 288, 0, 288, 0, 0, 0
5556, 1, 1636421952294, 1636421952585, 291, 0, 291, 0, 0, 0
5557, 1, 1636421952390, 1636421952674, 284, 0, 284, 0, 0, 0
5558, 1, 1636421952390, 1636421952675, 285, 12, 273, 12, 0, 12
5559, 1, 1636421952390, 1636421952675, 285, 0, 285, 0, 0, 0
5560, 1, 1636421952526, 1636421952806, 280, 0, 280, 0, 0, 0
5561, 1, 1636421952526, 1636421952806, 280, 0, 280, 0, 0, 0
5562, 1, 1636421952590, 1636421952850, 260, 0, 260, 0, 0, 0
5563, 1, 1636421952642, 1636421952906, 264, 0, 264, 0, 0, 0
5566, 1, 1636421952678, 1636421952946, 268, 0, 268, 0, 0, 0
5565, 1, 1636421952674, 1636421952950, 276, 1, 275, 0, 1, 1
5568, 1, 1636421952806, 1636421953074, 268, 0, 268, 0, 0, 0
5567, 1, 1636421952802, 1636421953074, 272, 0, 272, 0, 0, 0
5416, 2, 1636421943138, 1636421953138, 10000, 0, 10000, 0, 0, 0
5571, 1, 1636421952894, 1636421953186, 292, 0, 292, 0, 0, 0
5570, 1, 1636421952890, 1636421953186, 296, 0, 296, 0, 0, 0
5569, 1, 1636421952894, 1636421953186, 292, 0, 292, 0, 0, 0
5421, 2, 1636421943234, 1636421953234, 10000, 0, 10000, 0, 0, 0
5572, 1, 1636421952978, 1636421953282, 304, 0, 304, 0, 0, 0
5573, 1, 1636421953070, 1636421953370, 300, 5, 295, 4, 1, 5
5574, 1, 1636421953070, 1636421953370, 300, 1, 299, 0, 0, 0
5575, 1, 1636421953070, 1636421953374, 304, 1, 303, 1, 0, 1
5576, 1, 1636421953230, 1636421953498, 268, 0, 268, 0, 0, 0
5577, 1, 1636421953230, 1636421953510, 280, 0, 280, 0, 0, 0
5579, 1, 1636421953326, 1636421953594, 268, 0, 268, 0, 0, 0
5581, 1, 1636421953350, 1636421953622, 272, 0, 272, 0, 0, 0
5580, 1, 1636421953342, 1636421953646, 304, 32, 272, 32, 0, 32
5582, 1, 1636421953446, 1636421953718, 272, 0, 272, 0, 0, 0
5584, 1, 1636421953470, 1636421953742, 272, 1, 271, 0, 0, 0
5583, 1, 1636421953470, 1636421953742, 272, 0, 272, 0, 0, 0
5586, 1, 1636421953590, 1636421953862, 272, 1, 271, 0, 0, 0
5587, 1, 1636421953590, 1636421953870, 280, 1, 279, 0, 1, 1
5588, 1, 1636421953590, 1636421953870, 280, 1, 279, 0, 0, 0
5428, 2, 1636421943910, 1636421953910, 10000, 0, 10000, 0, 0, 0
5589, 1, 1636421953678, 1636421953958, 280, 0, 280, 0, 0, 0
5591, 1, 1636421953770, 1636421954042, 272, 1, 271, 0, 0, 0
5590, 1, 1636421953770, 1636421954042, 272, 0, 272, 0, 0, 0
5593, 1, 1636421953894, 1636421954166, 272, 0, 272, 0, 0, 0
5594, 1, 1636421953906, 1636421954178, 272, 0, 272, 0, 0, 0
5595, 1, 1636421954005, 1636421954278, 273, 1, 272, 0, 0, 0
5596, 1, 1636421954018, 1636421954290, 272, 0, 272, 0, 0, 0
5599, 1, 1636421954142, 1636421954414, 272, 1, 271, 0, 0, 0
5600, 1, 1636421954142, 1636421954414, 272, 0, 272, 0, 0, 0
5604, 1, 1636421954266, 1636421954534, 268, 0, 268, 0, 0, 0
5602, 1, 1636421954258, 1636421954534, 276, 0, 276, 0, 0, 0
5603, 1, 1636421954262, 1636421954538, 276, 0, 276, 0, 0, 0
5605, 1, 1636421954350, 1636421954622, 272, 0, 272, 0, 0, 0
5606, 1, 1636421954438, 1636421954710, 272, 0, 272, 0, 0, 0
5607, 1, 1636421954438, 1636421954710, 272, 0, 272, 0, 0, 0
5608, 1, 1636421954558, 1636421954826, 268, 0, 268, 0, 0, 0
5609, 1, 1636421954582, 1636421954862, 280, 0, 280, 0, 0, 0
5610, 1, 1636421954678, 1636421954950, 272, 0, 272, 0, 0, 0
5611, 1, 1636421954690, 1636421954958, 268, 0, 268, 0, 0, 0
5613, 1, 1636421954814, 1636421955086, 272, 1, 271, 0, 0, 0
5612, 1, 1636421954814, 1636421955086, 272, 0, 272, 0, 0, 0
5615, 1, 1636421954934, 1636421955218, 284, 0, 284, 0, 0, 0
5614, 1, 1636421954938, 1636421955218, 280, 0, 280, 0, 0, 0
5616, 1, 1636421954938, 1636421955218, 280, 0, 280, 0, 0, 0
5617, 1, 1636421955018, 1636421955286, 268, 0, 268, 0, 0, 0
5618, 1, 1636421955106, 1636421955378, 272, 1, 271, 0, 1, 1
5619, 1, 1636421955106, 1636421955382, 276, 1, 275, 0, 0, 0
5620, 1, 1636421955226, 1636421955498, 272, 0, 272, 0, 0, 0
5621, 1, 1636421955258, 1636421955526, 268, 0, 268, 0, 0, 0
5622, 1, 1636421955346, 1636421955618, 272, 0, 272, 0, 0, 0
5623, 1, 1636421955358, 1636421955622, 264, 0, 264, 0, 0, 0
5625, 1, 1636421955486, 1636421955758, 272, 0, 272, 0, 0, 0
5628, 1, 1636421955614, 1636421955886, 272, 1, 271, 0, 1, 1
5627, 1, 1636421955614, 1636421955890, 276, 1, 275, 1, 0, 1
5626, 1, 1636421955614, 1636421955890, 276, 1, 275, 1, 0, 1
5629, 1, 1636421955686, 1636421955958, 272, 0, 272, 0, 0, 0
5630, 1, 1636421955782, 1636421956054, 272, 0, 272, 0, 0, 0
5631, 1, 1636421955782, 1636421956054, 272, 1, 271, 0, 1, 1
5632, 1, 1636421955890, 1636421956162, 272, 1, 271, 0, 0, 0
5633, 1, 1636421955922, 1636421956198, 276, 0, 276, 0, 0, 0
5635, 1, 1636421956026, 1636421956298, 272, 0, 272, 0, 0, 0
5634, 1, 1636421956026, 1636421956302, 276, 0, 276, 0, 0, 0
5636, 1, 1636421956154, 1636421956426, 272, 0, 272, 0, 0, 0
5637, 1, 1636421956286, 1636421956558, 272, 1, 271, 0, 0, 0
5639, 1, 1636421956290, 1636421956559, 269, 0, 269, 0, 0, 0
5638, 1, 1636421956286, 1636421956559, 273, 1, 272, 0, 1, 1
5640, 1, 1636421956354, 1636421956630, 276, 0, 276, 0, 0, 0
5642, 1, 1636421956454, 1636421956726, 272, 0, 272, 0, 0, 0
5641, 1, 1636421956450, 1636421956726, 276, 0, 276, 0, 0, 0
5643, 1, 1636421956558, 1636421956822, 264, 1, 263, 1, 0, 1
5644, 1, 1636421956594, 1636421956862, 268, 0, 268, 0, 0, 0
5646, 1, 1636421956698, 1636421956970, 272, 1, 271, 0, 1, 1
5645, 1, 1636421956698, 1636421956970, 272, 1, 271, 1, 0, 1
5647, 1, 1636421956826, 1636421957098, 272, 0, 272, 0, 0, 0
5648, 1, 1636421956954, 1636421957226, 272, 0, 272, 0, 0, 0
5650, 1, 1636421956958, 1636421957226, 268, 0, 268, 0, 0, 0
5651, 1, 1636421957026, 1636421957298, 272, 0, 272, 0, 0, 0
5652, 1, 1636421957122, 1636421957390, 268, 0, 268, 0, 0, 0
5653, 1, 1636421957130, 1636421957402, 272, 0, 272, 0, 0, 0
5654, 1, 1636421957222, 1636421957494, 272, 5, 267, 5, 0, 5
5657, 1, 1636421957370, 1636421957646, 276, 1, 275, 0, 1, 1
5656, 1, 1636421957370, 1636421957646, 276, 1, 275, 0, 1, 1
5658, 1, 1636421957494, 1636421957758, 264, 0, 264, 0, 0, 0
5660, 1, 1636421957622, 1636421957894, 272, 0, 272, 0, 0, 0
5659, 1, 1636421957622, 1636421957894, 272, 0, 272, 0, 0, 0
5661, 1, 1636421957698, 1636421957970, 272, 0, 272, 0, 0, 0
5662, 1, 1636421957790, 1636421958062, 272, 0, 272, 0, 0, 0
5663, 1, 1636421957798, 1636421958066, 268, 0, 268, 0, 0, 0
5664, 1, 1636421957890, 1636421958166, 276, 5, 271, 5, 0, 5
5666, 1, 1636421958042, 1636421958310, 268, 0, 268, 0, 0, 0
5665, 1, 1636421958042, 1636421958314, 272, 0, 272, 0, 0, 0
5667, 1, 1636421958162, 1636421958438, 276, 0, 276, 0, 0, 0
5668, 1, 1636421958294, 1636421958566, 272, 1, 271, 1, 0, 1
5669, 1, 1636421958294, 1636421958566, 272, 1, 271, 0, 1, 1
5670, 1, 1636421958362, 1636421958634, 272, 0, 272, 0, 0, 0
5671, 1, 1636421958458, 1636421958730, 272, 0, 272, 0, 0, 0
5672, 1, 1636421958466, 1636421958738, 272, 0, 272, 0, 0, 0
5673, 1, 1636421958562, 1636421958834, 272, 5, 267, 5, 0, 5
5674, 1, 1636421958710, 1636421958982, 272, 0, 272, 0, 0, 0
5675, 1, 1636421958714, 1636421958982, 268, 0, 268, 0, 0, 0
5676, 1, 1636421958834, 1636421959098, 264, 1, 263, 0, 1, 1
5677, 1, 1636421958962, 1636421959234, 272, 0, 272, 0, 0, 0
5678, 1, 1636421958962, 1636421959234, 272, 0, 272, 0, 0, 0
5679, 1, 1636421959034, 1636421959302, 268, 0, 268, 0, 0, 0
5680, 1, 1636421959130, 1636421959398, 268, 0, 268, 0, 0, 0
5681, 1, 1636421959138, 1636421959406, 268, 0, 268, 0, 0, 0
5682, 1, 1636421959226, 1636421959502, 276, 9, 267, 8, 1, 9
5683, 1, 1636421959378, 1636421959654, 276, 0, 276, 0, 0, 0
5684, 1, 1636421959386, 1636421959658, 272, 0, 272, 0, 0, 0
5685, 1, 1636421959502, 1636421959766, 264, 1, 263, 0, 1, 1
5686, 1, 1636421959634, 1636421959906, 272, 0, 272, 0, 0, 0
5688, 1, 1636421959698, 1636421959970, 272, 0, 272, 0, 0, 0
5689, 1, 1636421959806, 1636421960078, 272, 0, 272, 0, 0, 0
5690, 1, 1636421959810, 1636421960078, 268, 0, 268, 0, 0, 0
5692, 1, 1636421960050, 1636421960322, 272, 0, 272, 0, 0, 0
5693, 1, 1636421960054, 1636421960326, 272, 0, 272, 0, 0, 0
5694, 1, 1636421960166, 1636421960438, 272, 0, 272, 0, 0, 0
5695, 1, 1636421960306, 1636421960582, 276, 0, 276, 0, 0, 0
5696, 1, 1636421960370, 1636421960642, 272, 0, 272, 0, 0, 0
5697, 1, 1636421960478, 1636421960750, 272, 1, 271, 1, 0, 1
5698, 1, 1636421960478, 1636421960750, 272, 1, 271, 1, 0, 1
5699, 1, 1636421960718, 1636421960990, 272, 0, 272, 0, 0, 0
5700, 1, 1636421960726, 1636421960998, 272, 0, 272, 0, 0, 0
5702, 1, 1636421960978, 1636421961250, 272, 0, 272, 0, 0, 0
5703, 1, 1636421961038, 1636421961306, 268, 0, 268, 0, 0, 0
5704, 1, 1636421961146, 1636421961418, 272, 0, 272, 0, 0, 0
5706, 1, 1636421961386, 1636421961658, 272, 0, 272, 0, 0, 0
5707, 1, 1636421961402, 1636421961674, 272, 0, 272, 0, 0, 0
5708, 1, 1636421961646, 1636421961918, 272, 0, 272, 0, 0, 0
5547, 2, 1636421951946, 1636421961942, 9996, 0, 9996, 0, 0, 0
5709, 1, 1636421961706, 1636421961990, 284, 0, 284, 0, 0, 0
5710, 1, 1636421961814, 1636421962090, 276, 1, 275, 0, 0, 0
5711, 1, 1636421962058, 1636421962330, 272, 0, 272, 0, 0, 0
5712, 1, 1636421962122, 1636421962402, 280, 0, 280, 0, 0, 0
5715, 1, 1636421962386, 1636421962662, 276, 0, 276, 0, 0, 0
5564, 2, 1636421952674, 1636421962674, 10000, 0, 10000, 0, 0, 0
5716, 1, 1636421962486, 1636421962754, 268, 0, 268, 0, 0, 0
5718, 1, 1636421962802, 1636421963074, 272, 0, 272, 0, 0, 0
5578, 2, 1636421953282, 1636421963282, 10000, 0, 10000, 0, 0, 0
5720, 1, 1636421963054, 1636421963330, 276, 0, 276, 0, 0, 0
5585, 2, 1636421953546, 1636421963542, 9996, 0, 9996, 0, 0, 0
5722, 1, 1636421963470, 1636421963766, 296, 1, 295, 1, 0, 1
5592, 2, 1636421953778, 1636421963778, 10000, 0, 10000, 0, 0, 0
5723, 1, 1636421963590, 1636421963854, 264, 0, 264, 0, 0, 0
5597, 2, 1636421954045, 1636421964046, 10001, 0, 10001, 0, 0, 0
5598, 2, 1636421954110, 1636421964110, 10000, 0, 10000, 0, 0, 0
5601, 2, 1636421954218, 1636421964218, 10000, 0, 10000, 0, 0, 0
5726, 1, 1636421964090, 1636421964366, 276, 0, 276, 0, 0, 0
5727, 1, 1636421964198, 1636421964470, 272, 0, 272, 0, 0, 0
5729, 1, 1636421964394, 1636421964670, 276, 0, 276, 0, 0, 0
5733, 1, 1636421964866, 1636421965143, 277, 1, 276, 0, 1, 1
5624, 2, 1636421955486, 1636421965486, 10000, 0, 10000, 0, 0, 0
5736, 1, 1636421965794, 1636421966066, 272, 1, 271, 0, 1, 1
5649, 2, 1636421956954, 1636421966958, 10004, 0, 10004, 0, 0, 0
5655, 2, 1636421957262, 1636421967262, 10000, 0, 10000, 0, 0, 0
5738, 1, 1636421967258, 1636421967534, 276, 0, 276, 0, 0, 0
5739, 1, 1636421967570, 1636421967846, 276, 1, 275, 0, 1, 1
5687, 2, 1636421959634, 1636421969635, 10001, 0, 10001, 0, 0, 0
5691, 2, 1636421959898, 1636421969898, 10000, 0, 10000, 0, 0, 0
5742, 1, 1636421969946, 1636421970218, 272, 0, 272, 0, 0, 0
5743, 1, 1636421970198, 1636421970490, 292, 21, 271, 21, 0, 21
5701, 2, 1636421960838, 1636421970838, 10000, 0, 10000, 0, 0, 0
5705, 2, 1636421961150, 1636421971150, 10000, 0, 10000, 0, 0, 0
5746, 1, 1636421971142, 1636421971414, 272, 1, 271, 0, 0, 0
5747, 1, 1636421971458, 1636421971734, 276, 1, 275, 0, 0, 0
5713, 2, 1636421962258, 1636421972258, 10000, 0, 10000, 0, 0, 0
5714, 2, 1636421962318, 1636421972318, 10000, 0, 10000, 0, 0, 0
5717, 2, 1636421962766, 1636421972766, 10000, 0, 10000, 0, 0, 0
5750, 1, 1636421972582, 1636421972854, 272, 0, 272, 0, 0, 0
5751, 1, 1636421972626, 1636421972906, 280, 1, 279, 0, 1, 1
5719, 2, 1636421962986, 1636421972986, 10000, 0, 10000, 0, 0, 0
5721, 2, 1636421963150, 1636421973150, 10000, 0, 10000, 0, 0, 0
5752, 1, 1636421973074, 1636421973374, 300, 1, 299, 0, 1, 1
5753, 1, 1636421973250, 1636421973526, 276, 0, 276, 0, 0, 0
5754, 1, 1636421973326, 1636421973598, 272, 1, 271, 0, 0, 0
5724, 2, 1636421963726, 1636421973726, 10000, 0, 10000, 0, 0, 0
5756, 1, 1636421973454, 1636421973770, 316, 0, 316, 0, 0, 0
5725, 2, 1636421963866, 1636421973866, 10000, 0, 10000, 0, 0, 0
5758, 1, 1636421973958, 1636421974226, 268, 0, 268, 0, 0, 0
5759, 1, 1636421973994, 1636421974266, 272, 0, 272, 0, 0, 0
5728, 2, 1636421964306, 1636421974306, 10000, 0, 10000, 0, 0, 0
5760, 1, 1636421974038, 1636421974350, 312, 0, 312, 0, 0, 0
5730, 2, 1636421964414, 1636421974414, 10000, 0, 10000, 0, 0, 0
5762, 1, 1636421974174, 1636421974462, 288, 0, 288, 0, 0, 0
5731, 2, 1636421964526, 1636421974526, 10000, 0, 10000, 0, 0, 0
5732, 2, 1636421964762, 1636421974762, 10000, 0, 10000, 0, 0, 0
5764, 1, 1636421974622, 1636421974898, 276, 0, 276, 0, 0, 0
5765, 1, 1636421974706, 1636421974986, 280, 0, 280, 0, 0, 0
5734, 2, 1636421965066, 1636421975066, 10000, 0, 10000, 0, 0, 0
5768, 1, 1636421974850, 1636421975122, 272, 1, 271, 0, 0, 0
5769, 1, 1636421974862, 1636421975134, 272, 0, 272, 0, 0, 0
5771, 1, 1636421975294, 1636421975570, 276, 0, 276, 0, 0, 0
5735, 2, 1636421965574, 1636421975574, 10000, 0, 10000, 0, 0, 0
5773, 1, 1636421975382, 1636421975658, 276, 0, 276, 0, 0, 0
5775, 1, 1636421975530, 1636421975806, 276, 0, 276, 0, 0, 0
5774, 1, 1636421975522, 1636421975806, 284, 0, 284, 0, 0, 0
5776, 1, 1636421975882, 1636421976150, 268, 1, 267, 0, 0, 0
5777, 1, 1636421975966, 1636421976238, 272, 0, 272, 0, 0, 0
5778, 1, 1636421976058, 1636421976330, 272, 0, 272, 0, 0, 0
5737, 2, 1636421966462, 1636421976462, 10000, 0, 10000, 0, 0, 0
5780, 1, 1636421976206, 1636421976510, 304, 1, 303, 0, 1, 1
5779, 1, 1636421976206, 1636421976510, 304, 0, 304, 0, 0, 0
5782, 1, 1636421976642, 1636421976910, 268, 0, 268, 0, 0, 0
5783, 1, 1636421976726, 1636421976998, 272, 0, 272, 0, 0, 0
5786, 1, 1636421976906, 1636421977182, 276, 0, 276, 0, 0, 0
5785, 1, 1636421976906, 1636421977182, 276, 1, 275, 0, 1, 1
5787, 1, 1636421977310, 1636421977586, 276, 1, 275, 0, 0, 0
5788, 1, 1636421977394, 1636421977670, 276, 0, 276, 0, 0, 0
5789, 1, 1636421977578, 1636421977854, 276, 1, 275, 0, 0, 0
5790, 1, 1636421977578, 1636421977854, 276, 1, 275, 1, 0, 1
5740, 2, 1636421967930, 1636421977930, 10000, 0, 10000, 0, 0, 0
5741, 2, 1636421968242, 1636421978242, 10000, 0, 10000, 0, 0, 0
5791, 1, 1636421978022, 1636421978290, 268, 0, 268, 0, 0, 0
5792, 1, 1636421978110, 1636421978378, 268, 0, 268, 0, 0, 0
5795, 1, 1636421978290, 1636421978562, 272, 0, 272, 0, 0, 0
5794, 1, 1636421978290, 1636421978566, 276, 0, 276, 0, 0, 0
5797, 1, 1636421978682, 1636421978958, 276, 1, 275, 0, 1, 1
5798, 1, 1636421978778, 1636421979050, 272, 1, 271, 0, 1, 1
5799, 1, 1636421978958, 1636421979230, 272, 1, 271, 1, 0, 1
5800, 1, 1636421978962, 1636421979242, 280, 0, 280, 0, 0, 0
5801, 1, 1636421979354, 1636421979626, 272, 1, 271, 0, 1, 1
5802, 1, 1636421979446, 1636421979718, 272, 1, 271, 0, 1, 1
5803, 1, 1636421979626, 1636421979898, 272, 0, 272, 0, 0, 0
5804, 1, 1636421979642, 1636421979918, 276, 0, 276, 0, 0, 0
5806, 1, 1636421980114, 1636421980386, 272, 0, 272, 0, 0, 0
5807, 1, 1636421980294, 1636421980566, 272, 0, 272, 0, 0, 0
5808, 1, 1636421980314, 1636421980586, 272, 0, 272, 0, 0, 0
5744, 2, 1636421970618, 1636421980618, 10000, 0, 10000, 0, 0, 0
5745, 2, 1636421970926, 1636421980926, 10000, 0, 10000, 0, 0, 0
5811, 1, 1636421980974, 1636421981242, 268, 0, 268, 0, 0, 0
5812, 1, 1636421981018, 1636421981290, 272, 0, 272, 0, 0, 0
5748, 2, 1636421971810, 1636421981810, 10000, 0, 10000, 0, 0, 0
5815, 1, 1636421981686, 1636421981962, 276, 1, 275, 0, 0, 0
5749, 2, 1636421972130, 1636421982130, 10000, 0, 10000, 0, 0, 0
5755, 2, 1636421973330, 1636421983331, 10001, 0, 10001, 0, 0, 0
5757, 2, 1636421973774, 1636421983774, 10000, 0, 10000, 0, 0, 0
5761, 2, 1636421974166, 1636421984166, 10000, 0, 10000, 0, 0, 0
5763, 2, 1636421974614, 1636421984614, 10000, 0, 10000, 0, 0, 0
5766, 2, 1636421974726, 1636421984726, 10000, 0, 10000, 0, 0, 0
5767, 2, 1636421974742, 1636421984774, 10032, 0, 10032, 0, 0, 0
5770, 2, 1636421975110, 1636421985066, 9956, 0, 9956, 0, 0, 0
5823, 1, 1636421985038, 1636421985310, 272, 0, 272, 0, 0, 0
5772, 2, 1636421975370, 1636421985370, 10000, 0, 10000, 0, 0, 0
5827, 1, 1636421985702, 1636421985974, 272, 1, 271, 0, 1, 1
5781, 2, 1636421976554, 1636421986554, 10000, 0, 10000, 0, 0, 0
5828, 1, 1636421986378, 1636421986690, 312, 0, 312, 0, 0, 0
5784, 2, 1636421976770, 1636421986770, 10000, 0, 10000, 0, 0, 0
5831, 1, 1636421987082, 1636421987358, 276, 0, 276, 0, 0, 0
5832, 1, 1636421987754, 1636421988031, 277, 1, 276, 0, 0, 0
5793, 2, 1636421978234, 1636421988234, 10000, 0, 10000, 0, 0, 0
5796, 2, 1636421978550, 1636421988551, 10001, 0, 10001, 0, 0, 0
5833, 1, 1636421988426, 1636421988702, 276, 0, 276, 0, 0, 0
5836, 1, 1636421989098, 1636421989374, 276, 1, 275, 0, 0, 0
5805, 2, 1636421980026, 1636421990026, 10000, 0, 10000, 0, 0, 0
5837, 1, 1636421989774, 1636421990074, 300, 0, 300, 0, 0, 0
5839, 1, 1636421990470, 1636421990746, 276, 0, 276, 0, 0, 0
5809, 2, 1636421980802, 1636421990802, 10000, 0, 10000, 0, 0, 0
5810, 2, 1636421980926, 1636421990927, 10001, 0, 10001, 0, 0, 0
5813, 2, 1636421981230, 1636421991230, 10000, 0, 10000, 0, 0, 0
5841, 1, 1636421991138, 1636421991414, 276, 0, 276, 0, 0, 0
5814, 2, 1636421981638, 1636421991638, 10000, 0, 10000, 0, 0, 0
5844, 1, 1636421991814, 1636421992086, 272, 0, 272, 0, 0, 0
5816, 2, 1636421982122, 1636421992122, 10000, 0, 10000, 0, 0, 0
5817, 2, 1636421982366, 1636421992366, 10000, 0, 10000, 0, 0, 0
5818, 2, 1636421982438, 1636421992438, 10000, 0, 10000, 0, 0, 0
5819, 2, 1636421983638, 1636421993638, 10000, 0, 10000, 0, 0, 0
5820, 2, 1636421984082, 1636421994082, 10000, 0, 10000, 0, 0, 0
5821, 2, 1636421984474, 1636421994474, 10000, 0, 10000, 0, 0, 0
5822, 2, 1636421984950, 1636421994950, 10000, 0, 10000, 0, 0, 0
5824, 2, 1636421985046, 1636421995046, 10000, 0, 10000, 0, 0, 0
5825, 2, 1636421985414, 1636421995418, 10004, 0, 10004, 0, 0, 0
5853, 1, 1636421995258, 1636421995558, 300, 1, 299, 0, 0, 0
5826, 2, 1636421985674, 1636421995674, 10000, 0, 10000, 0, 0, 0
5855, 1, 1636421995722, 1636421995998, 276, 0, 276, 0, 0, 0
5856, 1, 1636421995954, 1636421996226, 272, 0, 272, 0, 0, 0
5857, 1, 1636421995978, 1636421996274, 296, 21, 275, 21, 0, 21
5858, 1, 1636421996394, 1636421996662, 268, 1, 267, 0, 0, 0
5829, 2, 1636421986862, 1636421996862, 10000, 0, 10000, 0, 0, 0
5859, 1, 1636421996626, 1636421996910, 284, 1, 283, 0, 1, 1
5860, 1, 1636421996670, 1636421996946, 276, 0, 276, 0, 0, 0
5830, 2, 1636421987078, 1636421997078, 10000, 0, 10000, 0, 0, 0
5861, 1, 1636421997058, 1636421997334, 276, 0, 276, 0, 0, 0
5863, 1, 1636421997306, 1636421997578, 272, 0, 272, 0, 0, 0
5864, 1, 1636421997342, 1636421997618, 276, 0, 276, 0, 0, 0
5865, 1, 1636421997386, 1636421997658, 272, 0, 272, 0, 0, 0
5866, 1, 1636421997730, 1636421998002, 272, 1, 271, 0, 1, 1
5867, 1, 1636421997974, 1636421998246, 272, 0, 272, 0, 0, 0
5868, 1, 1636421998018, 1636421998286, 268, 0, 268, 0, 0, 0
5869, 1, 1636421998054, 1636421998326, 272, 0, 272, 0, 0, 0
5834, 2, 1636421988538, 1636421998538, 10000, 0, 10000, 0, 0, 0
5870, 1, 1636421998398, 1636421998674, 276, 0, 276, 0, 0, 0
5835, 2, 1636421988858, 1636421998858, 10000, 0, 10000, 0, 0, 0
5871, 1, 1636421998650, 1636421998926, 276, 0, 276, 0, 0, 0
5873, 1, 1636421998722, 1636421998994, 272, 0, 272, 0, 0, 0
5872, 1, 1636421998714, 1636421998994, 280, 0, 280, 0, 0, 0
5874, 1, 1636421998842, 1636421999110, 268, 1, 267, 0, 0, 0
5875, 1, 1636421999074, 1636421999342, 268, 0, 268, 0, 0, 0
5876, 1, 1636421999166, 1636421999434, 268, 0, 268, 0, 0, 0
5877, 1, 1636421999326, 1636421999602, 276, 0, 276, 0, 0, 0
5878, 1, 1636421999394, 1636421999658, 264, 0, 264, 0, 0, 0
5879, 1, 1636421999386, 1636421999658, 272, 0, 272, 0, 0, 0
5880, 1, 1636421999506, 1636421999782, 276, 1, 275, 0, 1, 1
5881, 1, 1636421999742, 1636422000018, 276, 0, 276, 0, 0, 0
5882, 1, 1636421999830, 1636422000098, 268, 0, 268, 0, 0, 0
5883, 1, 1636421999998, 1636422000270, 272, 0, 272, 0, 0, 0
5838, 2, 1636421990334, 1636422000334, 10000, 0, 10000, 0, 0, 0
5885, 1, 1636422000062, 1636422000382, 320, 0, 320, 0, 0, 0
5884, 1, 1636422000062, 1636422000382, 320, 0, 320, 0, 0, 0
5886, 1, 1636422000178, 1636422000474, 296, 0, 296, 0, 0, 0
5887, 1, 1636422000426, 1636422000694, 268, 0, 268, 0, 0, 0
5888, 1, 1636422000514, 1636422000790, 276, 0, 276, 0, 0, 0
5889, 1, 1636422000642, 1636422000914, 272, 0, 272, 0, 0, 0
5890, 1, 1636422000666, 1636422000938, 272, 1, 271, 0, 0, 0
5892, 1, 1636422000778, 1636422001050, 272, 0, 272, 0, 0, 0
5891, 1, 1636422000778, 1636422001050, 272, 0, 272, 0, 0, 0
5840, 2, 1636421991110, 1636422001110, 10000, 0, 10000, 0, 0, 0
5893, 1, 1636422000874, 1636422001246, 372, 65, 307, 65, 0, 65
5842, 2, 1636421991274, 1636422001278, 10004, 0, 10004, 0, 0, 0
5895, 1, 1636422001198, 1636422001522, 324, 49, 275, 49, 0, 49
5843, 2, 1636421991530, 1636422001530, 10000, 0, 10000, 0, 0, 0
5896, 1, 1636422001326, 1636422001602, 276, 0, 276, 0, 0, 0
5897, 1, 1636422001370, 1636422001666, 296, 0, 296, 0, 0, 0
5898, 1, 1636422001454, 1636422001758, 304, 1, 303, 0, 0, 0
5899, 1, 1636422001454, 1636422001762, 308, 1, 307, 0, 1, 1
5900, 1, 1636422001454, 1636422001794, 340, 68, 272, 67, 0, 67
5901, 1, 1636422001618, 1636422001882, 264, 0, 264, 0, 0, 0
5902, 1, 1636422001642, 1636422001914, 272, 0, 272, 0, 0, 0
5845, 2, 1636421991946, 1636422001946, 10000, 0, 10000, 0, 0, 0
5894, 1, 1636422001090, 1636422002082, 992, 705, 287, 705, 0, 705
5903, 1, 1636422001830, 1636422002178, 348, 53, 295, 53, 0, 53
5904, 1, 1636422001918, 1636422002198, 280, 0, 280, 0, 0, 0
5906, 1, 1636422002062, 1636422002334, 272, 0, 272, 0, 0, 0
5908, 1, 1636422002158, 1636422002434, 276, 1, 275, 0, 0, 0
5907, 1, 1636422002158, 1636422002434, 276, 1, 275, 0, 1, 1
5909, 1, 1636422002190, 1636422002466, 276, 0, 276, 0, 0, 0
5847, 2, 1636421992486, 1636422002486, 10000, 0, 10000, 0, 0, 0
5846, 2, 1636421992486, 1636422002530, 10044, 0, 10044, 0, 0, 0
5910, 1, 1636422002258, 1636422002578, 320, 0, 320, 0, 0, 0
5911, 1, 1636422002278, 1636422002578, 300, 0, 300, 0, 0, 0
5912, 1, 1636422002314, 1636422002662, 348, 0, 348, 0, 0, 0
5848, 2, 1636421992706, 1636422002706, 10000, 0, 10000, 0, 0, 0
5849, 2, 1636421992746, 1636422002750, 10004, 0, 10004, 0, 0, 0
5913, 1, 1636422002474, 1636422002798, 324, 0, 324, 0, 0, 0
5914, 1, 1636422002578, 1636422002886, 308, 1, 307, 1, 0, 1
5915, 1, 1636422002621, 1636422002978, 357, 41, 316, 41, 0, 41
5917, 1, 1636422002798, 1636422003066, 268, 0, 268, 0, 0, 0
5920, 1, 1636422002842, 1636422003106, 264, 0, 264, 0, 0, 0
5921, 1, 1636422002926, 1636422003202, 276, 1, 275, 0, 0, 0
5922, 1, 1636422002974, 1636422003246, 272, 0, 272, 0, 0, 0
5924, 1, 1636422003018, 1636422003302, 284, 0, 284, 0, 0, 0
5926, 1, 1636422003058, 1636422003334, 276, 0, 276, 0, 0, 0
5925, 1, 1636422003054, 1636422003338, 284, 12, 272, 12, 0, 12
5927, 1, 1636422003190, 1636422003474, 284, 13, 271, 12, 1, 13
5923, 1, 1636422002974, 1636422003510, 536, 273, 263, 272, 1, 273
5929, 1, 1636422003374, 1636422003646, 272, 0, 272, 0, 0, 0
5930, 1, 1636422003462, 1636422003734, 272, 0, 272, 0, 0, 0
5931, 1, 1636422003502, 1636422003774, 272, 0, 272, 0, 0, 0
5928, 1, 1636422003278, 1636422003778, 500, 232, 268, 232, 0, 232
5850, 2, 1636421993946, 1636422003946, 10000, 0, 10000, 0, 0, 0
5935, 1, 1636422003730, 1636422003998, 268, 0, 268, 0, 0, 0
5936, 1, 1636422003738, 1636422004006, 268, 0, 268, 0, 0, 0
5934, 1, 1636422003702, 1636422004082, 380, 76, 304, 76, 0, 76
5938, 1, 1636422003906, 1636422004178, 272, 0, 272, 0, 0, 0
5939, 1, 1636422004042, 1636422004314, 272, 0, 272, 0, 0, 0
5851, 2, 1636421994390, 1636422004390, 10000, 0, 10000, 0, 0, 0
5940, 1, 1636422004130, 1636422004438, 308, 0, 308, 0, 0, 0
5942, 1, 1636422004170, 1636422004446, 276, 8, 268, 8, 0, 8
5941, 1, 1636422004170, 1636422004446, 276, 0, 276, 0, 0, 0
5943, 1, 1636422004254, 1636422004526, 272, 0, 272, 0, 0, 0
5945, 1, 1636422004438, 1636422004710, 272, 1, 271, 0, 0, 0
5944, 1, 1636422004438, 1636422004718, 280, 8, 272, 8, 0, 8
5852, 2, 1636421994790, 1636422004790, 10000, 0, 10000, 0, 0, 0
5947, 1, 1636422004578, 1636422004854, 276, 0, 276, 0, 0, 0
5948, 1, 1636422004698, 1636422004970, 272, 0, 272, 0, 0, 0
5949, 1, 1636422004718, 1636422005018, 300, 0, 300, 0, 0, 0
5952, 1, 1636422004882, 1636422005154, 272, 1, 271, 0, 0, 0
5953, 1, 1636422004970, 1636422005238, 268, 0, 268, 0, 0, 0
5950, 1, 1636422004838, 1636422005290, 452, 180, 272, 180, 0, 180
5854, 2, 1636421995350, 1636422005350, 10000, 0, 10000, 0, 0, 0
5954, 1, 1636422005094, 1636422005398, 304, 0, 304, 0, 0, 0
5956, 1, 1636422005118, 1636422005398, 280, 0, 280, 0, 0, 0
5955, 1, 1636422005110, 1636422005578, 468, 181, 287, 181, 0, 181
5957, 1, 1636422005262, 1636422005578, 316, 0, 316, 0, 0, 0
5958, 1, 1636422005398, 1636422005670, 272, 1, 271, 0, 1, 1
5959, 1, 1636422005442, 1636422005714, 272, 0, 272, 0, 0, 0
5960, 1, 1636422005554, 1636422005850, 296, 25, 271, 25, 0, 25
5961, 1, 1636422005638, 1636422005910, 272, 0, 272, 0, 0, 0
5962, 1, 1636422005658, 1636422005934, 276, 0, 276, 0, 0, 0
5963, 1, 1636422005686, 1636422005958, 272, 0, 272, 0, 0, 0
5964, 1, 1636422005794, 1636422006066, 272, 0, 272, 0, 0, 0
5965, 1, 1636422005802, 1636422006070, 268, 0, 268, 0, 0, 0
5966, 1, 1636422005974, 1636422006250, 276, 1, 275, 1, 0, 1
5967, 1, 1636422005974, 1636422006254, 280, 1, 279, 1, 0, 1
5968, 1, 1636422006066, 1636422006338, 272, 0, 272, 0, 0, 0
5969, 1, 1636422006110, 1636422006382, 272, 0, 272, 0, 0, 0
5970, 1, 1636422006242, 1636422006522, 280, 12, 268, 12, 0, 12
5971, 1, 1636422006306, 1636422006570, 264, 0, 264, 0, 0, 0
5972, 1, 1636422006334, 1636422006602, 268, 0, 268, 0, 0, 0
5973, 1, 1636422006362, 1636422006626, 264, 0, 264, 0, 0, 0
5974, 1, 1636422006474, 1636422006737, 263, 0, 263, 0, 0, 0
5976, 1, 1636422006646, 1636422006918, 272, 0, 272, 0, 0, 0
5977, 1, 1636422006650, 1636422006918, 268, 0, 268, 0, 0, 0
5978, 1, 1636422006737, 1636422007014, 277, 1, 276, 0, 1, 1
5862, 2, 1636421997170, 1636422007170, 10000, 0, 10000, 0, 0, 0
5980, 1, 1636422006914, 1636422007218, 304, 5, 299, 5, 0, 5
5981, 1, 1636422006974, 1636422007246, 272, 0, 272, 0, 0, 0
5982, 1, 1636422006998, 1636422007306, 308, 0, 308, 0, 0, 0
5983, 1, 1636422007026, 1636422007306, 280, 0, 280, 0, 0, 0
5984, 1, 1636422007138, 1636422007406, 268, 0, 268, 0, 0, 0
5986, 1, 1636422007350, 1636422007622, 272, 0, 272, 0, 0, 0
5985, 1, 1636422007346, 1636422007682, 336, 61, 275, 61, 0, 61
5987, 1, 1636422007414, 1636422007690, 276, 0, 276, 0, 0, 0
5988, 1, 1636422007478, 1636422007750, 272, 0, 272, 0, 0, 0
5990, 1, 1636422007646, 1636422007918, 272, 0, 272, 0, 0, 0
5989, 1, 1636422007618, 1636422007954, 336, 65, 271, 64, 1, 65
5992, 1, 1636422007714, 1636422007982, 268, 0, 268, 0, 0, 0
5993, 1, 1636422007806, 1636422008074, 268, 0, 268, 0, 0, 0
5991, 1, 1636422007698, 1636422008226, 528, 257, 271, 257, 0, 257
5994, 1, 1636422008018, 1636422008290, 272, 0, 272, 0, 0, 0
5995, 1, 1636422008078, 1636422008342, 264, 0, 264, 0, 0, 0
5996, 1, 1636422008086, 1636422008358, 272, 0, 272, 0, 0, 0
5997, 1, 1636422008146, 1636422008418, 272, 0, 272, 0, 0, 0
5998, 1, 1636422008322, 1636422008594, 272, 0, 272, 0, 0, 0
5999, 1, 1636422008346, 1636422008622, 276, 0, 276, 0, 0, 0
6000, 1, 1636422008378, 1636422008650, 272, 0, 272, 0, 0, 0
6001, 1, 1636422008474, 1636422008742, 268, 0, 268, 0, 0, 0
6002, 1, 1636422008622, 1636422008890, 268, 1, 267, 0, 0, 0
6003, 1, 1636422008690, 1636422008962, 272, 0, 272, 0, 0, 0
6004, 1, 1636422008742, 1636422009006, 264, 0, 264, 0, 0, 0
6005, 1, 1636422008754, 1636422009022, 268, 0, 268, 0, 0, 0
6006, 1, 1636422008814, 1636422009090, 276, 0, 276, 0, 0, 0
6007, 1, 1636422008990, 1636422009266, 276, 0, 276, 0, 0, 0
6008, 1, 1636422009014, 1636422009282, 268, 0, 268, 0, 0, 0
6009, 1, 1636422009050, 1636422009318, 268, 0, 268, 0, 0, 0
6010, 1, 1636422009146, 1636422009418, 272, 0, 272, 0, 0, 0
6011, 1, 1636422009290, 1636422009562, 272, 0, 272, 0, 0, 0
6012, 1, 1636422009362, 1636422009630, 268, 0, 268, 0, 0, 0
6014, 1, 1636422009422, 1636422009698, 276, 0, 276, 0, 0, 0
6015, 1, 1636422009490, 1636422009762, 272, 0, 272, 0, 0, 0
6018, 1, 1636422009718, 1636422009990, 272, 0, 272, 0, 0, 0
6016, 1, 1636422009666, 1636422010038, 372, 97, 275, 96, 0, 96
6019, 1, 1636422009814, 1636422010078, 264, 0, 264, 0, 0, 0
6020, 1, 1636422009954, 1636422010222, 268, 0, 268, 0, 0, 0
6021, 1, 1636422010030, 1636422010298, 268, 0, 268, 0, 0, 0
6022, 1, 1636422010098, 1636422010370, 272, 0, 272, 0, 0, 0
6023, 1, 1636422010158, 1636422010430, 272, 0, 272, 0, 0, 0
6025, 1, 1636422010434, 1636422010702, 268, 0, 268, 0, 0, 0
6026, 1, 1636422010478, 1636422010746, 268, 0, 268, 0, 0, 0
6027, 1, 1636422010622, 1636422010894, 272, 0, 272, 0, 0, 0
6029, 1, 1636422010766, 1636422011038, 272, 1, 271, 0, 0, 0
6030, 1, 1636422010826, 1636422011094, 268, 0, 268, 0, 0, 0
6031, 1, 1636422011102, 1636422011374, 272, 0, 272, 0, 0, 0
6032, 1, 1636422011150, 1636422011418, 268, 0, 268, 0, 0, 0
6033, 1, 1636422011286, 1636422011558, 272, 0, 272, 0, 0, 0
6034, 1, 1636422011438, 1636422011710, 272, 0, 272, 0, 0, 0
6035, 1, 1636422011498, 1636422011770, 272, 0, 272, 0, 0, 0
5905, 2, 1636422002038, 1636422012038, 10000, 0, 10000, 0, 0, 0
6037, 1, 1636422011814, 1636422012086, 272, 0, 272, 0, 0, 0
6038, 1, 1636422011954, 1636422012270, 316, 0, 316, 0, 0, 0
6040, 1, 1636422012166, 1636422012438, 272, 1, 271, 0, 0, 0
6041, 1, 1636422012346, 1636422012618, 272, 0, 272, 0, 0, 0
5916, 2, 1636422002794, 1636422012798, 10004, 0, 10004, 0, 0, 0
5919, 2, 1636422002842, 1636422012842, 10000, 0, 10000, 0, 0, 0
5918, 2, 1636422002798, 1636422012886, 10088, 0, 10088, 0, 0, 0
6043, 1, 1636422012666, 1636422013022, 356, 0, 356, 0, 0, 0
6044, 1, 1636422012930, 1636422013202, 272, 1, 271, 0, 1, 1
6045, 1, 1636422013066, 1636422013338, 272, 0, 272, 0, 0, 0
6048, 1, 1636422013150, 1636422013426, 276, 1, 275, 0, 1, 1
6046, 1, 1636422013154, 1636422013430, 276, 0, 276, 0, 0, 0
5932, 2, 1636422003606, 1636422013606, 10000, 0, 10000, 0, 0, 0
5933, 2, 1636422003646, 1636422013650, 10004, 0, 10004, 0, 0, 0
5937, 2, 1636422003866, 1636422013866, 10000, 0, 10000, 0, 0, 0
6050, 1, 1636422013598, 1636422013914, 316, 0, 316, 0, 0, 0
6051, 1, 1636422013738, 1636422014006, 268, 1, 267, 0, 0, 0
6052, 1, 1636422013826, 1636422014102, 276, 1, 275, 0, 0, 0
6053, 1, 1636422013826, 1636422014103, 277, 0, 277, 0, 0, 0
6055, 1, 1636422013954, 1636422014230, 276, 1, 275, 0, 0, 0
5946, 2, 1636422004478, 1636422014478, 10000, 0, 10000, 0, 0, 0
6057, 1, 1636422014310, 1636422014614, 304, 0, 304, 0, 0, 0
6059, 1, 1636422014526, 1636422014798, 272, 0, 272, 0, 0, 0
5951, 2, 1636422004882, 1636422014882, 10000, 0, 10000, 0, 0, 0
6061, 1, 1636422014658, 1636422014930, 272, 0, 272, 0, 0, 0
6062, 1, 1636422014786, 1636422015058, 272, 0, 272, 0, 0, 0
6066, 1, 1636422015326, 1636422015598, 272, 0, 272, 0, 0, 0
6067, 1, 1636422015454, 1636422015730, 276, 0, 276, 0, 0, 0
6069, 1, 1636422016126, 1636422016402, 276, 0, 276, 0, 0, 0
5975, 2, 1636422006474, 1636422016475, 10001, 0, 10001, 0, 0, 0
5979, 2, 1636422006778, 1636422016778, 10000, 0, 10000, 0, 0, 0
6013, 2, 1636422009414, 1636422019414, 10000, 0, 10000, 0, 0, 0
6017, 2, 1636422009682, 1636422019682, 10000, 0, 10000, 0, 0, 0
6024, 2, 1636422010382, 1636422020382, 10000, 0, 10000, 0, 0, 0
6028, 2, 1636422010698, 1636422020698, 10000, 0, 10000, 0, 0, 0
6036, 2, 1636422011770, 1636422021771, 10001, 0, 10001, 0, 0, 0
6039, 2, 1636422012126, 1636422022126, 10000, 0, 10000, 0, 0, 0
6042, 2, 1636422012482, 1636422022482, 10000, 0, 10000, 0, 0, 0
6047, 2, 1636422013154, 1636422023154, 10000, 0, 10000, 0, 0, 0
6049, 2, 1636422013414, 1636422023414, 10000, 0, 10000, 0, 0, 0
6080, 1, 1636422023502, 1636422023778, 276, 0, 276, 0, 0, 0
6054, 2, 1636422013914, 1636422023914, 10000, 0, 10000, 0, 0, 0
6056, 2, 1636422014170, 1636422024171, 10001, 0, 10001, 0, 0, 0
6058, 2, 1636422014406, 1636422024406, 10000, 0, 10000, 0, 0, 0
6082, 1, 1636422024218, 1636422024490, 272, 0, 272, 0, 0, 0
6083, 1, 1636422024218, 1636422024490, 272, 0, 272, 0, 0, 0
6060, 2, 1636422014526, 1636422024526, 10000, 0, 10000, 0, 0, 0
6084, 1, 1636422024494, 1636422024762, 268, 0, 268, 0, 0, 0
6085, 1, 1636422024718, 1636422024994, 276, 0, 276, 0, 0, 0
6063, 2, 1636422015010, 1636422025010, 10000, 0, 10000, 0, 0, 0
6086, 1, 1636422024830, 1636422025146, 316, 0, 316, 0, 0, 0
6088, 1, 1636422024886, 1636422025158, 272, 1, 271, 0, 1, 1
6064, 2, 1636422015190, 1636422025190, 10000, 0, 10000, 0, 0, 0
6065, 2, 1636422015194, 1636422025234, 10040, 0, 10040, 0, 0, 0
6089, 1, 1636422025186, 1636422025466, 280, 0, 280, 0, 0, 0
6091, 1, 1636422025418, 1636422025690, 272, 0, 272, 0, 0, 0
6092, 1, 1636422025498, 1636422025770, 272, 0, 272, 0, 0, 0
6093, 1, 1636422025506, 1636422025778, 272, 1, 271, 0, 0, 0
6094, 1, 1636422025542, 1636422025814, 272, 0, 272, 0, 0, 0
6068, 2, 1636422015998, 1636422025998, 10000, 0, 10000, 0, 0, 0
6097, 1, 1636422026086, 1636422026362, 276, 0, 276, 0, 0, 0
6099, 1, 1636422026178, 1636422026450, 272, 0, 272, 0, 0, 0
6098, 1, 1636422026178, 1636422026454, 276, 0, 276, 0, 0, 0
6100, 1, 1636422026210, 1636422026478, 268, 1, 267, 0, 1, 1
6101, 1, 1636422026310, 1636422026578, 268, 0, 268, 0, 0, 0
6070, 2, 1636422016778, 1636422026778, 10000, 0, 10000, 0, 0, 0
6071, 2, 1636422016822, 1636422026822, 10000, 0, 10000, 0, 0, 0
6102, 1, 1636422026758, 1636422027054, 296, 0, 296, 0, 0, 0
6072, 2, 1636422017086, 1636422027086, 10000, 0, 10000, 0, 0, 0
6104, 1, 1636422026866, 1636422027138, 272, 0, 272, 0, 0, 0
6106, 1, 1636422026998, 1636422027314, 316, 0, 316, 0, 0, 0
6107, 1, 1636422027082, 1636422027354, 272, 0, 272, 0, 0, 0
6108, 1, 1636422027134, 1636422027410, 276, 0, 276, 0, 0, 0
6109, 1, 1636422027394, 1636422027670, 276, 0, 276, 0, 0, 0
6110, 1, 1636422027454, 1636422027726, 272, 0, 272, 0, 0, 0
6111, 1, 1636422027534, 1636422027806, 272, 0, 272, 0, 0, 0
6112, 1, 1636422027718, 1636422027994, 276, 0, 276, 0, 0, 0
6113, 1, 1636422027750, 1636422028022, 272, 0, 272, 0, 0, 0
6114, 1, 1636422027806, 1636422028074, 268, 0, 268, 0, 0, 0
6115, 1, 1636422028070, 1636422028342, 272, 0, 272, 0, 0, 0
6116, 1, 1636422028122, 1636422028394, 272, 0, 272, 0, 0, 0
6117, 1, 1636422028202, 1636422028474, 272, 0, 272, 0, 0, 0
6118, 1, 1636422028390, 1636422028662, 272, 0, 272, 0, 0, 0
6120, 1, 1636422028474, 1636422028750, 276, 0, 276, 0, 0, 0
6122, 1, 1636422028794, 1636422029062, 268, 0, 268, 0, 0, 0
6123, 1, 1636422028870, 1636422029142, 272, 0, 272, 0, 0, 0
6124, 1, 1636422029062, 1636422029334, 272, 0, 272, 0, 0, 0
6125, 1, 1636422029150, 1636422029422, 272, 0, 272, 0, 0, 0
6126, 1, 1636422029458, 1636422029726, 268, 0, 268, 0, 0, 0
6073, 2, 1636422019730, 1636422029730, 10000, 0, 10000, 0, 0, 0
6127, 1, 1636422029538, 1636422029810, 272, 0, 272, 0, 0, 0
6074, 2, 1636422019986, 1636422029986, 10000, 0, 10000, 0, 0, 0
6128, 1, 1636422029778, 1636422030050, 272, 0, 272, 0, 0, 0
6129, 1, 1636422029818, 1636422030122, 304, 0, 304, 0, 0, 0
6130, 1, 1636422030074, 1636422030346, 272, 0, 272, 0, 0, 0
6131, 1, 1636422030166, 1636422030434, 268, 0, 268, 0, 0, 0
6132, 1, 1636422030206, 1636422030474, 268, 0, 268, 0, 0, 0
6133, 1, 1636422030290, 1636422030610, 320, 56, 264, 56, 0, 56
6075, 2, 1636422020686, 1636422030686, 10000, 0, 10000, 0, 0, 0
6134, 1, 1636422030446, 1636422030734, 288, 0, 288, 0, 0, 0
6135, 1, 1636422030522, 1636422030822, 300, 0, 300, 0, 0, 0
6076, 2, 1636422021006, 1636422031006, 10000, 0, 10000, 0, 0, 0
6136, 1, 1636422030774, 1636422031054, 280, 0, 280, 0, 0, 0
6138, 1, 1636422030874, 1636422031146, 272, 0, 272, 0, 0, 0
6137, 1, 1636422030866, 1636422031146, 280, 0, 280, 0, 0, 0
6139, 1, 1636422030990, 1636422031262, 272, 0, 272, 0, 0, 0
6140, 1, 1636422031006, 1636422031326, 320, 49, 271, 49, 0, 49
6141, 1, 1636422031130, 1636422031398, 268, 0, 268, 0, 0, 0
6142, 1, 1636422031218, 1636422031490, 272, 0, 272, 0, 0, 0
6143, 1, 1636422031314, 1636422031582, 268, 0, 268, 0, 0, 0
6146, 1, 1636422031546, 1636422031818, 272, 0, 272, 0, 0, 0
6145, 1, 1636422031546, 1636422031818, 272, 0, 272, 0, 0, 0
6147, 1, 1636422031658, 1636422031930, 272, 0, 272, 0, 0, 0
6149, 1, 1636422031798, 1636422032066, 268, 0, 268, 0, 0, 0
6077, 2, 1636422022078, 1636422032078, 10000, 0, 10000, 0, 0, 0
6150, 1, 1636422031886, 1636422032154, 268, 0, 268, 0, 0, 0
6151, 1, 1636422031982, 1636422032250, 268, 0, 268, 0, 0, 0
6078, 2, 1636422022434, 1636422032434, 10000, 0, 10000, 0, 0, 0
6152, 1, 1636422032258, 1636422032570, 312, 0, 312, 0, 0, 0
6155, 1, 1636422032390, 1636422032662, 272, 0, 272, 0, 0, 0
6156, 1, 1636422032482, 1636422032754, 272, 0, 272, 0, 0, 0
6079, 2, 1636422022790, 1636422032790, 10000, 0, 10000, 0, 0, 0
6157, 1, 1636422032554, 1636422032838, 284, 0, 284, 0, 0, 0
6159, 1, 1636422032742, 1636422033018, 276, 1, 275, 0, 0, 0
6161, 1, 1636422033066, 1636422033338, 272, 0, 272, 0, 0, 0
6162, 1, 1636422033094, 1636422033374, 280, 0, 280, 0, 0, 0
6163, 1, 1636422033158, 1636422033430, 272, 0, 272, 0, 0, 0
6164, 1, 1636422033234, 1636422033502, 268, 0, 268, 0, 0, 0
6165, 1, 1636422033414, 1636422033682, 268, 0, 268, 0, 0, 0
6081, 2, 1636422023718, 1636422033718, 10000, 0, 10000, 0, 0, 0
6167, 1, 1636422033810, 1636422034082, 272, 0, 272, 0, 0, 0
6169, 1, 1636422033902, 1636422034174, 272, 0, 272, 0, 0, 0
6170, 1, 1636422034026, 1636422034302, 276, 1, 275, 0, 0, 0
6087, 2, 1636422024886, 1636422034886, 10000, 0, 10000, 0, 0, 0
6174, 1, 1636422034694, 1636422034966, 272, 0, 272, 0, 0, 0
6090, 2, 1636422025326, 1636422035326, 10000, 0, 10000, 0, 0, 0
6175, 1, 1636422035194, 1636422035462, 268, 0, 268, 0, 0, 0
6095, 2, 1636422025558, 1636422035558, 10000, 0, 10000, 0, 0, 0
6096, 2, 1636422025858, 1636422035858, 10000, 0, 10000, 0, 0, 0
6177, 1, 1636422035646, 1636422035918, 272, 0, 272, 0, 0, 0
6178, 1, 1636422035906, 1636422036178, 272, 1, 271, 0, 1, 1
6179, 1, 1636422035906, 1636422036178, 272, 0, 272, 0, 0, 0
6180, 1, 1636422036162, 1636422036446, 284, 17, 267, 17, 0, 17
6181, 1, 1636422036314, 1636422036590, 276, 1, 275, 0, 1, 1
6182, 1, 1636422036574, 1636422036846, 272, 0, 272, 0, 0, 0
6183, 1, 1636422036578, 1636422036846, 268, 0, 268, 0, 0, 0
6103, 2, 1636422026866, 1636422036866, 10000, 0, 10000, 0, 0, 0
6105, 2, 1636422026910, 1636422036914, 10004, 0, 10004, 0, 0, 0
6184, 1, 1636422036842, 1636422037142, 300, 5, 295, 5, 0, 5
6186, 1, 1636422037178, 1636422037450, 272, 0, 272, 0, 0, 0
6187, 1, 1636422037214, 1636422037482, 268, 0, 268, 0, 0, 0
6189, 1, 1636422037246, 1636422037518, 272, 0, 272, 0, 0, 0
6190, 1, 1636422037534, 1636422037806, 272, 0, 272, 0, 0, 0
6191, 1, 1636422037846, 1636422038114, 268, 0, 268, 0, 0, 0
6192, 1, 1636422037882, 1636422038154, 272, 0, 272, 0, 0, 0
6119, 2, 1636422028422, 1636422038422, 10000, 0, 10000, 0, 0, 0
6121, 2, 1636422028742, 1636422038742, 10000, 0, 10000, 0, 0, 0
6195, 1, 1636422038514, 1636422038786, 272, 0, 272, 0, 0, 0
6196, 1, 1636422038550, 1636422038822, 272, 0, 272, 0, 0, 0
6197, 1, 1636422038730, 1636422039002, 272, 0, 272, 0, 0, 0
6198, 1, 1636422039050, 1636422039322, 272, 0, 272, 0, 0, 0
6200, 1, 1636422039214, 1636422039490, 276, 0, 276, 0, 0, 0
6201, 1, 1636422039398, 1636422039670, 272, 0, 272, 0, 0, 0
6202, 1, 1636422039718, 1636422039994, 276, 0, 276, 0, 0, 0
6203, 1, 1636422039882, 1636422040154, 272, 0, 272, 0, 0, 0
6204, 1, 1636422040070, 1636422040346, 276, 0, 276, 0, 0, 0
6205, 1, 1636422040394, 1636422040666, 272, 0, 272, 0, 0, 0
6206, 1, 1636422040554, 1636422040826, 272, 1, 271, 0, 0, 0
6144, 2, 1636422031454, 1636422041454, 10000, 0, 10000, 0, 0, 0
6209, 1, 1636422041222, 1636422041502, 280, 1, 279, 0, 0, 0
6148, 2, 1636422031718, 1636422041718, 10000, 0, 10000, 0, 0, 0
6210, 1, 1636422041766, 1636422042038, 272, 0, 272, 0, 0, 0
6211, 1, 1636422041894, 1636422042166, 272, 0, 272, 0, 0, 0
6153, 2, 1636422032258, 1636422042258, 10000, 0, 10000, 0, 0, 0
6212, 1, 1636422042022, 1636422042306, 284, 17, 267, 17, 0, 17
6154, 2, 1636422032330, 1636422042330, 10000, 0, 10000, 0, 0, 0
6158, 2, 1636422032646, 1636422042646, 10000, 0, 10000, 0, 0, 0
6213, 1, 1636422042434, 1636422042710, 276, 0, 276, 0, 0, 0
6215, 1, 1636422042598, 1636422042870, 272, 0, 272, 0, 0, 0
6214, 1, 1636422042562, 1636422042870, 308, 0, 308, 0, 0, 0
6216, 1, 1636422042634, 1636422042906, 272, 1, 271, 0, 0, 0
6160, 2, 1636422032970, 1636422042970, 10000, 0, 10000, 0, 0, 0
6217, 1, 1636422042734, 1636422043018, 284, 0, 284, 0, 0, 0
6218, 1, 1636422042954, 1636422043226, 272, 0, 272, 0, 0, 0
6219, 1, 1636422043146, 1636422043422, 276, 0, 276, 0, 0, 0
6221, 1, 1636422043266, 1636422043538, 272, 0, 272, 0, 0, 0
6220, 1, 1636422043262, 1636422043538, 276, 0, 276, 0, 0, 0
6222, 1, 1636422043278, 1636422043550, 272, 0, 272, 0, 0, 0
6223, 1, 1636422043302, 1636422043574, 272, 0, 272, 0, 0, 0
6224, 1, 1636422043414, 1636422043686, 272, 9, 263, 8, 1, 9
6166, 2, 1636422033762, 1636422043766, 10004, 0, 10004, 0, 0, 0
6168, 2, 1636422033826, 1636422043826, 10000, 0, 10000, 0, 0, 0
6225, 1, 1636422043622, 1636422043906, 284, 0, 284, 0, 0, 0
6171, 2, 1636422034078, 1636422044078, 10000, 0, 10000, 0, 0, 0
6227, 1, 1636422043942, 1636422044214, 272, 0, 272, 0, 0, 0
6229, 1, 1636422043946, 1636422044222, 276, 0, 276, 0, 0, 0
6228, 1, 1636422043946, 1636422044222, 276, 0, 276, 0, 0, 0
6230, 1, 1636422044002, 1636422044306, 304, 0, 304, 0, 0, 0
6232, 1, 1636422044126, 1636422044394, 268, 1, 267, 0, 0, 0
6233, 1, 1636422044170, 1636422044442, 272, 0, 272, 0, 0, 0
6172, 2, 1636422034478, 1636422044478, 10000, 0, 10000, 0, 0, 0
6173, 2, 1636422034570, 1636422044570, 10000, 0, 10000, 0, 0, 0
6234, 1, 1636422044306, 1636422044618, 312, 1, 311, 0, 1, 1
6235, 1, 1636422044386, 1636422044706, 320, 8, 312, 8, 0, 8
6236, 1, 1636422044662, 1636422044926, 264, 0, 264, 0, 0, 0
6238, 1, 1636422044662, 1636422044934, 272, 0, 272, 0, 0, 0
6240, 1, 1636422044782, 1636422045054, 272, 1, 271, 0, 0, 0
6241, 1, 1636422044790, 1636422045058, 268, 0, 268, 0, 0, 0
6242, 1, 1636422044838, 1636422045110, 272, 0, 272, 0, 0, 0
6243, 1, 1636422044878, 1636422045150, 272, 0, 272, 0, 0, 0
6176, 2, 1636422035374, 1636422045374, 10000, 0, 10000, 0, 0, 0
6245, 1, 1636422045106, 1636422045418, 312, 0, 312, 0, 0, 0
6246, 1, 1636422045322, 1636422045602, 280, 0, 280, 0, 0, 0
6247, 1, 1636422045334, 1636422045602, 268, 0, 268, 0, 0, 0
6249, 1, 1636422045462, 1636422045734, 272, 0, 272, 0, 0, 0
6248, 1, 1636422045462, 1636422045734, 272, 0, 272, 0, 0, 0
6250, 1, 1636422045550, 1636422045818, 268, 0, 268, 0, 0, 0
6251, 1, 1636422045550, 1636422045818, 268, 0, 268, 0, 0, 0
6252, 1, 1636422045678, 1636422045950, 272, 0, 272, 0, 0, 0
6253, 1, 1636422045814, 1636422046086, 272, 0, 272, 0, 0, 0
6255, 1, 1636422046002, 1636422046266, 264, 0, 264, 0, 0, 0
6254, 1, 1636422045998, 1636422046358, 360, 89, 271, 88, 1, 89
6258, 1, 1636422046218, 1636422046490, 272, 0, 272, 0, 0, 0
6259, 1, 1636422046218, 1636422046494, 276, 0, 276, 0, 0, 0
6260, 1, 1636422046346, 1636422046614, 268, 0, 268, 0, 0, 0
6257, 1, 1636422046134, 1636422046630, 496, 225, 271, 224, 1, 225
6262, 1, 1636422046670, 1636422046946, 276, 0, 276, 0, 0, 0
6185, 2, 1636422037002, 1636422047002, 10000, 0, 10000, 0, 0, 0
6263, 1, 1636422046758, 1636422047050, 292, 0, 292, 0, 0, 0
6264, 1, 1636422046886, 1636422047158, 272, 0, 272, 0, 0, 0
6265, 1, 1636422046894, 1636422047166, 272, 0, 272, 0, 0, 0
6188, 2, 1636422037242, 1636422047242, 10000, 0, 10000, 0, 0, 0
6266, 1, 1636422047050, 1636422047322, 272, 1, 271, 0, 0, 0
6268, 1, 1636422047330, 1636422047602, 272, 0, 272, 0, 0, 0
6269, 1, 1636422047342, 1636422047618, 276, 0, 276, 0, 0, 0
6272, 1, 1636422047554, 1636422047826, 272, 0, 272, 0, 0, 0
6271, 1, 1636422047550, 1636422047826, 276, 0, 276, 0, 0, 0
6273, 1, 1636422047566, 1636422047842, 276, 0, 276, 0, 0, 0
6193, 2, 1636422037918, 1636422047918, 10000, 0, 10000, 0, 0, 0
6194, 2, 1636422038202, 1636422048202, 10000, 0, 10000, 0, 0, 0
6275, 1, 1636422048006, 1636422048278, 272, 0, 272, 0, 0, 0
6279, 1, 1636422048250, 1636422048526, 276, 0, 276, 0, 0, 0
6280, 1, 1636422048250, 1636422048527, 277, 0, 277, 0, 0, 0
6277, 1, 1636422048250, 1636422048527, 277, 0, 277, 0, 0, 0
6278, 1, 1636422048250, 1636422048526, 276, 0, 276, 0, 0, 0
6281, 1, 1636422048506, 1636422048798, 292, 22, 270, 22, 0, 22
6282, 1, 1636422048682, 1636422048954, 272, 0, 272, 0, 0, 0
6199, 2, 1636422039190, 1636422049190, 10000, 0, 10000, 0, 0, 0
6286, 1, 1636422048926, 1636422049238, 312, 0, 312, 0, 0, 0
6285, 1, 1636422048926, 1636422049238, 312, 0, 312, 0, 0, 0
6284, 1, 1636422048922, 1636422049238, 316, 1, 315, 0, 0, 0
6287, 1, 1636422049238, 1636422049506, 268, 1, 267, 1, 0, 1
6289, 1, 1636422049498, 1636422049770, 272, 0, 272, 0, 0, 0
6290, 1, 1636422049634, 1636422049906, 272, 0, 272, 0, 0, 0
6292, 1, 1636422049634, 1636422049906, 272, 0, 272, 0, 0, 0
6293, 1, 1636422049902, 1636422050174, 272, 5, 267, 5, 0, 5
6294, 1, 1636422050166, 1636422050438, 272, 0, 272, 0, 0, 0
6296, 1, 1636422050302, 1636422050574, 272, 0, 272, 0, 0, 0
6295, 1, 1636422050302, 1636422050574, 272, 0, 272, 0, 0, 0
6207, 2, 1636422040742, 1636422050742, 10000, 0, 10000, 0, 0, 0
6297, 1, 1636422050570, 1636422050874, 304, 5, 299, 5, 0, 5
6208, 2, 1636422041062, 1636422051062, 10000, 0, 10000, 0, 0, 0
6298, 1, 1636422050842, 1636422051114, 272, 0, 272, 0, 0, 0
6300, 1, 1636422050970, 1636422051242, 272, 1, 271, 0, 1, 1
6299, 1, 1636422050970, 1636422051246, 276, 1, 275, 1, 0, 1
6301, 1, 1636422051046, 1636422051318, 272, 0, 272, 0, 0, 0
6302, 1, 1636422051274, 1636422051546, 272, 0, 272, 0, 0, 0
6303, 1, 1636422051370, 1636422051642, 272, 0, 272, 0, 0, 0
6304, 1, 1636422051514, 1636422051786, 272, 0, 272, 0, 0, 0
6305, 1, 1636422051638, 1636422051914, 276, 0, 276, 0, 0, 0
6306, 1, 1636422051646, 1636422051922, 276, 0, 276, 0, 0, 0
6307, 1, 1636422051718, 1636422051990, 272, 0, 272, 0, 0, 0
6308, 1, 1636422051942, 1636422052218, 276, 0, 276, 0, 0, 0
6309, 1, 1636422052046, 1636422052318, 272, 0, 272, 0, 0, 0
6310, 1, 1636422052186, 1636422052462, 276, 0, 276, 0, 0, 0
6311, 1, 1636422052314, 1636422052582, 268, 0, 268, 0, 0, 0
6312, 1, 1636422052322, 1636422052594, 272, 0, 272, 0, 0, 0
6313, 1, 1636422052390, 1636422052666, 276, 0, 276, 0, 0, 0
6314, 1, 1636422052614, 1636422052886, 272, 0, 272, 0, 0, 0
6315, 1, 1636422052726, 1636422052998, 272, 0, 272, 0, 0, 0
6316, 1, 1636422052862, 1636422053134, 272, 0, 272, 0, 0, 0
6317, 1, 1636422052982, 1636422053258, 276, 0, 276, 0, 0, 0
6318, 1, 1636422052990, 1636422053262, 272, 0, 272, 0, 0, 0
6319, 1, 1636422053066, 1636422053334, 268, 0, 268, 0, 0, 0
6320, 1, 1636422053282, 1636422053554, 272, 0, 272, 0, 0, 0
6321, 1, 1636422053394, 1636422053666, 272, 0, 272, 0, 0, 0
6322, 1, 1636422053530, 1636422053802, 272, 0, 272, 0, 0, 0
6226, 2, 1636422043870, 1636422053870, 10000, 0, 10000, 0, 0, 0
6323, 1, 1636422053658, 1636422053930, 272, 0, 272, 0, 0, 0
6324, 1, 1636422053666, 1636422053934, 268, 0, 268, 0, 0, 0
6325, 1, 1636422053734, 1636422054006, 272, 0, 272, 0, 0, 0
6231, 2, 1636422044126, 1636422054126, 10000, 0, 10000, 0, 0, 0
6326, 1, 1636422053958, 1636422054262, 304, 0, 304, 0, 0, 0
6327, 1, 1636422054066, 1636422054358, 292, 0, 292, 0, 0, 0
6328, 1, 1636422054214, 1636422054482, 268, 0, 268, 0, 0, 0
6329, 1, 1636422054218, 1636422054490, 272, 0, 272, 0, 0, 0
6331, 1, 1636422054330, 1636422054598, 268, 0, 268, 0, 0, 0
6330, 1, 1636422054326, 1636422054598, 272, 0, 272, 0, 0, 0
6237, 2, 1636422044662, 1636422054662, 10000, 0, 10000, 0, 0, 0
6239, 2, 1636422044702, 1636422054706, 10004, 0, 10004, 0, 0, 0
6332, 1, 1636422054410, 1636422054754, 344, 0, 344, 0, 0, 0
6333, 1, 1636422054434, 1636422054842, 408, 48, 360, 48, 0, 48
6334, 1, 1636422054658, 1636422054934, 276, 0, 276, 0, 0, 0
6244, 2, 1636422045018, 1636422055018, 10000, 0, 10000, 0, 0, 0
6335, 1, 1636422054794, 1636422055070, 276, 0, 276, 0, 0, 0
6336, 1, 1636422054882, 1636422055154, 272, 0, 272, 0, 0, 0
6337, 1, 1636422054890, 1636422055162, 272, 0, 272, 0, 0, 0
6338, 1, 1636422054978, 1636422055242, 264, 0, 264, 0, 0, 0
6339, 1, 1636422054998, 1636422055270, 272, 0, 272, 0, 0, 0
6341, 1, 1636422055006, 1636422055278, 272, 0, 272, 0, 0, 0
6342, 1, 1636422055150, 1636422055422, 272, 0, 272, 0, 0, 0
6343, 1, 1636422055238, 1636422055510, 272, 0, 272, 0, 0, 0
6344, 1, 1636422055326, 1636422055598, 272, 0, 272, 0, 0, 0
6345, 1, 1636422055330, 1636422055602, 272, 0, 272, 0, 0, 0
6346, 1, 1636422055462, 1636422055734, 272, 0, 272, 0, 0, 0
6347, 1, 1636422055550, 1636422055826, 276, 0, 276, 0, 0, 0
6348, 1, 1636422055562, 1636422055830, 268, 0, 268, 0, 0, 0
6349, 1, 1636422055638, 1636422055910, 272, 0, 272, 0, 0, 0
6351, 1, 1636422055678, 1636422055950, 272, 0, 272, 0, 0, 0
6352, 1, 1636422055822, 1636422056090, 268, 0, 268, 0, 0, 0
6256, 2, 1636422046134, 1636422056134, 10000, 0, 10000, 0, 0, 0
6353, 1, 1636422055906, 1636422056182, 276, 0, 276, 0, 0, 0
6354, 1, 1636422055994, 1636422056270, 276, 0, 276, 0, 0, 0
6356, 1, 1636422056130, 1636422056402, 272, 0, 272, 0, 0, 0
6261, 2, 1636422046486, 1636422056486, 10000, 0, 10000, 0, 0, 0
6358, 1, 1636422056226, 1636422056534, 308, 0, 308, 0, 0, 0
6357, 1, 1636422056222, 1636422056534, 312, 0, 312, 0, 0, 0
6360, 1, 1636422056350, 1636422056622, 272, 0, 272, 0, 0, 0
6359, 1, 1636422056310, 1636422056622, 312, 0, 312, 0, 0, 0
6362, 1, 1636422056486, 1636422056754, 268, 0, 268, 0, 0, 0
6363, 1, 1636422056581, 1636422056846, 265, 1, 264, 0, 0, 0
6361, 1, 1636422056442, 1636422056890, 448, 181, 267, 181, 0, 181
6364, 1, 1636422056666, 1636422056934, 268, 0, 268, 0, 0, 0
6267, 2, 1636422047050, 1636422057050, 10000, 0, 10000, 0, 0, 0
6366, 1, 1636422056802, 1636422057098, 296, 0, 296, 0, 0, 0
6365, 1, 1636422056794, 1636422057186, 392, 96, 296, 96, 0, 96
6368, 1, 1636422056930, 1636422057198, 268, 0, 268, 0, 0, 0
6369, 1, 1636422057018, 1636422057290, 272, 1, 271, 1, 0, 1
6370, 1, 1636422057018, 1636422057290, 272, 1, 271, 0, 0, 0
6371, 1, 1636422057150, 1636422057422, 272, 0, 272, 0, 0, 0
6270, 2, 1636422047446, 1636422057446, 10000, 0, 10000, 0, 0, 0
6372, 1, 1636422057246, 1636422057514, 268, 0, 268, 0, 0, 0
6373, 1, 1636422057290, 1636422057582, 292, 0, 292, 0, 0, 0
6374, 1, 1636422057334, 1636422057602, 268, 0, 268, 0, 0, 0
6375, 1, 1636422057354, 1636422057678, 324, 0, 324, 0, 0, 0
6274, 2, 1636422047714, 1636422057714, 10000, 0, 10000, 0, 0, 0
6376, 1, 1636422057494, 1636422057770, 276, 0, 276, 0, 0, 0
6378, 1, 1636422057622, 1636422057890, 268, 0, 268, 0, 0, 0
6377, 1, 1636422057622, 1636422057890, 268, 0, 268, 0, 0, 0
6379, 1, 1636422057690, 1636422057958, 268, 0, 268, 0, 0, 0
6380, 1, 1636422057694, 1636422057966, 272, 0, 272, 0, 0, 0
6276, 2, 1636422048014, 1636422058014, 10000, 0, 10000, 0, 0, 0
6382, 1, 1636422057818, 1636422058090, 272, 0, 272, 0, 0, 0
6383, 1, 1636422057910, 1636422058182, 272, 0, 272, 0, 0, 0
6384, 1, 1636422057978, 1636422058246, 268, 0, 268, 0, 0, 0
6385, 1, 1636422058006, 1636422058274, 268, 0, 268, 0, 0, 0
6386, 1, 1636422058062, 1636422058342, 280, 0, 280, 0, 0, 0
6387, 1, 1636422058102, 1636422058374, 272, 0, 272, 0, 0, 0
6388, 1, 1636422058194, 1636422058466, 272, 0, 272, 0, 0, 0
6390, 1, 1636422058290, 1636422058558, 268, 0, 268, 0, 0, 0
6389, 1, 1636422058290, 1636422058558, 268, 0, 268, 0, 0, 0
6393, 1, 1636422058362, 1636422058622, 260, 0, 260, 0, 0, 0
6392, 1, 1636422058354, 1636422058622, 268, 0, 268, 0, 0, 0
6395, 1, 1636422058574, 1636422058842, 268, 0, 268, 0, 0, 0
6396, 1, 1636422058646, 1636422058922, 276, 0, 276, 0, 0, 0
6283, 2, 1636422048922, 1636422058922, 10000, 0, 10000, 0, 0, 0
6397, 1, 1636422058674, 1636422058970, 296, 0, 296, 0, 0, 0
6398, 1, 1636422058738, 1636422059006, 268, 0, 268, 0, 0, 0
6399, 1, 1636422058770, 1636422059058, 288, 0, 288, 0, 0, 0
6401, 1, 1636422058970, 1636422059242, 272, 0, 272, 0, 0, 0
6402, 1, 1636422058970, 1636422059242, 272, 0, 272, 0, 0, 0
6403, 1, 1636422059022, 1636422059294, 272, 0, 272, 0, 0, 0
6288, 2, 1636422049370, 1636422059370, 10000, 0, 10000, 0, 0, 0
6406, 1, 1636422059242, 1636422059510, 268, 1, 267, 1, 0, 1
6407, 1, 1636422059318, 1636422059594, 276, 0, 276, 0, 0, 0
6291, 2, 1636422049634, 1636422059634, 10000, 0, 10000, 0, 0, 0
6408, 1, 1636422059370, 1636422059682, 312, 0, 312, 0, 0, 0
6409, 1, 1636422059418, 1636422059686, 268, 0, 268, 0, 0, 0
6410, 1, 1636422059458, 1636422059774, 316, 0, 316, 0, 0, 0
6412, 1, 1636422059682, 1636422059954, 272, 1, 271, 0, 0, 0
6411, 1, 1636422059682, 1636422059954, 272, 0, 272, 0, 0, 0
6413, 1, 1636422059682, 1636422059958, 276, 0, 276, 0, 0, 0
6414, 1, 1636422059726, 1636422059994, 268, 0, 268, 0, 0, 0
6415, 1, 1636422059906, 1636422060218, 312, 49, 263, 49, 0, 49
6417, 1, 1636422059990, 1636422060262, 272, 0, 272, 0, 0, 0
6419, 1, 1636422060082, 1636422060355, 273, 0, 273, 0, 0, 0
6418, 1, 1636422060082, 1636422060356, 274, 0, 274, 0, 0, 0
6420, 1, 1636422060170, 1636422060446, 276, 0, 276, 0, 0, 0
6423, 1, 1636422060355, 1636422060618, 263, 1, 262, 0, 0, 0
6421, 1, 1636422060350, 1636422060618, 268, 0, 268, 0, 0, 0
6422, 1, 1636422060350, 1636422060618, 268, 0, 268, 0, 0, 0
6424, 1, 1636422060394, 1636422060662, 268, 0, 268, 0, 0, 0
6426, 1, 1636422060658, 1636422060926, 268, 0, 268, 0, 0, 0
6427, 1, 1636422060746, 1636422061014, 268, 0, 268, 0, 0, 0
6428, 1, 1636422060754, 1636422061022, 268, 0, 268, 0, 0, 0
6429, 1, 1636422060842, 1636422061114, 272, 0, 272, 0, 0, 0
6432, 1, 1636422061022, 1636422061294, 272, 0, 272, 0, 0, 0
6431, 1, 1636422061018, 1636422061294, 276, 0, 276, 0, 0, 0
6430, 1, 1636422061018, 1636422061294, 276, 0, 276, 0, 0, 0
6434, 1, 1636422061326, 1636422061594, 268, 0, 268, 0, 0, 0
6435, 1, 1636422061414, 1636422061690, 276, 0, 276, 0, 0, 0
6437, 1, 1636422061514, 1636422061782, 268, 0, 268, 0, 0, 0
6439, 1, 1636422061694, 1636422061966, 272, 0, 272, 0, 0, 0
6438, 1, 1636422061690, 1636422061966, 276, 0, 276, 0, 0, 0
6441, 1, 1636422061990, 1636422062258, 268, 0, 268, 0, 0, 0
6442, 1, 1636422062082, 1636422062354, 272, 0, 272, 0, 0, 0
6443, 1, 1636422062178, 1636422062450, 272, 1, 271, 0, 0, 0
6445, 1, 1636422062370, 1636422062634, 264, 0, 264, 0, 0, 0
6444, 1, 1636422062362, 1636422062638, 276, 0, 276, 0, 0, 0
6447, 1, 1636422062754, 1636422063026, 272, 1, 271, 0, 1, 1
6448, 1, 1636422062846, 1636422063118, 272, 0, 272, 0, 0, 0
6450, 1, 1636422063033, 1636422063310, 277, 1, 276, 1, 0, 1
6451, 1, 1636422063418, 1636422063694, 276, 1, 275, 0, 0, 0
6453, 1, 1636422063706, 1636422063978, 272, 0, 272, 0, 0, 0
6455, 1, 1636422064374, 1636422064650, 276, 1, 275, 0, 0, 0
6340, 2, 1636422055002, 1636422065002, 10000, 0, 10000, 0, 0, 0
6456, 1, 1636422065050, 1636422065322, 272, 0, 272, 0, 0, 0
6457, 1, 1636422065310, 1636422065586, 276, 0, 276, 0, 0, 0
6350, 2, 1636422055670, 1636422065670, 10000, 0, 10000, 0, 0, 0
6355, 2, 1636422055998, 1636422065998, 10000, 0, 10000, 0, 0, 0
6459, 1, 1636422065974, 1636422066246, 272, 1, 271, 0, 0, 0
6460, 1, 1636422065982, 1636422066254, 272, 0, 272, 0, 0, 0
6461, 1, 1636422066302, 1636422066574, 272, 0, 272, 0, 0, 0
6462, 1, 1636422066642, 1636422066914, 272, 0, 272, 0, 0, 0
6463, 1, 1636422066654, 1636422066926, 272, 0, 272, 0, 0, 0
6367, 2, 1636422056930, 1636422066930, 10000, 0, 10000, 0, 0, 0
6464, 1, 1636422066974, 1636422067250, 276, 0, 276, 0, 0, 0
6465, 1, 1636422067238, 1636422067510, 272, 0, 272, 0, 0, 0
6466, 1, 1636422067310, 1636422067582, 272, 0, 272, 0, 0, 0
6467, 1, 1636422067322, 1636422067594, 272, 1, 271, 0, 1, 1
6381, 2, 1636422057758, 1636422067762, 10004, 0, 10004, 0, 0, 0
6468, 1, 1636422067646, 1636422067922, 276, 0, 276, 0, 0, 0
6469, 1, 1636422067938, 1636422068210, 272, 0, 272, 0, 0, 0
6470, 1, 1636422067978, 1636422068250, 272, 0, 272, 0, 0, 0
6471, 1, 1636422067990, 1636422068262, 272, 0, 272, 0, 0, 0
6391, 2, 1636422058326, 1636422068326, 10000, 0, 10000, 0, 0, 0
6394, 2, 1636422058486, 1636422068486, 10000, 0, 10000, 0, 0, 0
6472, 1, 1636422068318, 1636422068626, 308, 0, 308, 0, 0, 0
6400, 2, 1636422058862, 1636422068862, 10000, 0, 10000, 0, 0, 0
6473, 1, 1636422068606, 1636422068910, 304, 0, 304, 0, 0, 0
6475, 1, 1636422068662, 1636422068934, 272, 0, 272, 0, 0, 0
6474, 1, 1636422068662, 1636422068934, 272, 1, 271, 0, 0, 0
6404, 2, 1636422059030, 1636422069030, 10000, 0, 10000, 0, 0, 0
6476, 1, 1636422068790, 1636422069090, 300, 0, 300, 0, 0, 0
6405, 2, 1636422059230, 1636422069230, 10000, 0, 10000, 0, 0, 0
6477, 1, 1636422069078, 1636422069366, 288, 0, 288, 0, 0, 0
6478, 1, 1636422069206, 1636422069478, 272, 0, 272, 0, 0, 0
6479, 1, 1636422069318, 1636422069586, 268, 0, 268, 0, 0, 0
6482, 1, 1636422069334, 1636422069602, 268, 0, 268, 0, 0, 0
6480, 1, 1636422069330, 1636422069602, 272, 0, 272, 0, 0, 0
6481, 1, 1636422069334, 1636422069602, 268, 0, 268, 0, 0, 0
6483, 1, 1636422069486, 1636422069758, 272, 0, 272, 0, 0, 0
6416, 2, 1636422059942, 1636422069942, 10000, 0, 10000, 0, 0, 0
6484, 1, 1636422069762, 1636422070079, 317, 0, 317, 0, 0, 0
6485, 1, 1636422069878, 1636422070170, 292, 0, 292, 0, 0, 0
6486, 1, 1636422069990, 1636422070262, 272, 0, 272, 0, 0, 0
6489, 1, 1636422070034, 1636422070306, 272, 0, 272, 0, 0, 0
6487, 1, 1636422070034, 1636422070310, 276, 0, 276, 0, 0, 0
6490, 1, 1636422070154, 1636422070430, 276, 0, 276, 0, 0, 0
6425, 2, 1636422060610, 1636422070707, 10097, 9, 10088, 9, 0, 9
6491, 1, 1636422070474, 1636422070798, 324, 0, 324, 0, 0, 0
6492, 1, 1636422070566, 1636422070890, 324, 0, 324, 0, 0, 0
6493, 1, 1636422070658, 1636422070982, 324, 0, 324, 0, 0, 0
6433, 2, 1636422061058, 1636422071058, 10000, 0, 10000, 9649, 0, 9649
6495, 1, 1636422070842, 1636422071118, 276, 0, 276, 0, 0, 0
6496, 1, 1636422071014, 1636422071286, 272, 0, 272, 0, 0, 0
6436, 2, 1636422061418, 1636422071418, 10000, 0, 10000, 9290, 0, 9290
6498, 1, 1636422071290, 1636422071562, 272, 0, 272, 0, 0, 0
6499, 1, 1636422071378, 1636422071650, 272, 0, 272, 0, 0, 0
6440, 2, 1636422061698, 1636422071698, 10000, 0, 10000, 0, 0, 0
6500, 1, 1636422071514, 1636422071786, 272, 0, 272, 0, 0, 0
6502, 1, 1636422071958, 1636422072230, 272, 0, 272, 0, 0, 0
6503, 1, 1636422072006, 1636422072274, 268, 0, 268, 0, 0, 0
6504, 1, 1636422072182, 1636422072454, 272, 1, 271, 0, 0, 0
6446, 2, 1636422062658, 1636422072658, 10000, 0, 10000, 8049, 0, 8049
6505, 1, 1636422072626, 1636422072898, 272, 0, 272, 0, 0, 0
6506, 1, 1636422072706, 1636422072978, 272, 0, 272, 0, 0, 0
6449, 2, 1636422063033, 1636422073034, 10001, 0, 10001, 7674, 0, 7674
6507, 1, 1636422072850, 1636422073118, 268, 0, 268, 0, 0, 0
6452, 2, 1636422063514, 1636422073514, 10000, 0, 10000, 7193, 0, 7193
6508, 1, 1636422073298, 1636422073574, 276, 0, 276, 0, 0, 0
6509, 1, 1636422073374, 1636422073650, 276, 0, 276, 0, 0, 0
6454, 2, 1636422064086, 1636422074087, 10001, 0, 10001, 6621, 0, 6621
6511, 1, 1636422074046, 1636422074323, 277, 0, 277, 0, 0, 0
6512, 1, 1636422074718, 1636422074995, 277, 0, 277, 0, 0, 0
6513, 1, 1636422075398, 1636422075670, 272, 1, 271, 1, 0, 1
6458, 2, 1636422065718, 1636422075718, 10000, 0, 10000, 4989, 0, 4989
6514, 1, 1636422076026, 1636422076298, 272, 0, 272, 0, 0, 0
6515, 1, 1636422076066, 1636422076334, 268, 0, 268, 0, 0, 0
6488, 2, 1636422070034, 1636422080034, 10000, 0, 10000, 0, 0, 0
6494, 2, 1636422070706, 1636422080706, 10000, 0, 10000, 0, 0, 0
6497, 2, 1636422071234, 1636422081234, 10000, 0, 10000, 0, 0, 0
6518, 1, 1636422081010, 1636422081282, 272, 1, 271, 1, 0, 1
6522, 1, 1636422081014, 1636422081554, 540, 269, 271, 269, 0, 269
6501, 2, 1636422071682, 1636422081682, 10000, 0, 10000, 0, 0, 0
6528, 1, 1636422081986, 1636422082263, 277, 1, 276, 0, 1, 1
6529, 1, 1636422082654, 1636422082926, 272, 1, 271, 0, 1, 1
6530, 1, 1636422083326, 1636422083602, 276, 1, 275, 0, 1, 1
6510, 2, 1636422073971, 1636422083970, 9999, 0, 9999, 0, 0, 0
6531, 1, 1636422084018, 1636422084294, 276, 1, 275, 0, 1, 1
6533, 1, 1636422084686, 1636422084962, 276, 1, 275, 0, 0, 0
6534, 1, 1636422085366, 1636422085643, 277, 1, 276, 1, 0, 1
6535, 1, 1636422086038, 1636422086310, 272, 1, 271, 1, 0, 1
6516, 2, 1636422076694, 1636422086694, 10000, 0, 10000, 0, 0, 0
6537, 1, 1636422087002, 1636422087274, 272, 1, 271, 1, 0, 1
6538, 1, 1636422087670, 1636422087942, 272, 1, 271, 1, 0, 1
6539, 1, 1636422088342, 1636422088614, 272, 1, 271, 0, 1, 1
6540, 1, 1636422089010, 1636422089282, 272, 1, 271, 0, 1, 1
6541, 1, 1636422089678, 1636422089954, 276, 1, 275, 0, 0, 0
6517, 2, 1636422080342, 1636422090342, 10000, 0, 10000, 0, 0, 0
6542, 1, 1636422090386, 1636422090658, 272, 1, 271, 1, 0, 1
6524, 2, 1636422081010, 1636422091010, 10000, 0, 10000, 544, 0, 544
6523, 2, 1636422081014, 1636422091054, 10040, 0, 10040, 541, 0, 541
6520, 2, 1636422081014, 1636422091098, 10084, 0, 10084, 540, 0, 540
6519, 2, 1636422081014, 1636422091146, 10132, 0, 10132, 541, 0, 541
6521, 2, 1636422081010, 1636422091194, 10184, 0, 10184, 0, 0, 0
6543, 1, 1636422091242, 1636422091514, 272, 0, 272, 0, 0, 0
6525, 2, 1636422081538, 1636422091538, 10000, 0, 10000, 0, 0, 0
6526, 2, 1636422081678, 1636422091682, 10004, 0, 10004, 0, 0, 0
6527, 2, 1636422081950, 1636422091950, 10000, 0, 10000, 0, 0, 0
6549, 1, 1636422091998, 1636422092274, 276, 0, 276, 0, 0, 0
6550, 1, 1636422092254, 1636422092542, 288, 21, 267, 21, 0, 21
6551, 1, 1636422092670, 1636422092942, 272, 0, 272, 0, 0, 0
6552, 1, 1636422092938, 1636422093218, 280, 5, 275, 5, 0, 5
6553, 1, 1636422093338, 1636422093614, 276, 1, 275, 1, 0, 1
6554, 1, 1636422093618, 1636422093891, 273, 1, 272, 0, 1, 1
6532, 2, 1636422084278, 1636422094278, 10000, 0, 10000, 0, 0, 0
6555, 1, 1636422094010, 1636422094326, 316, 1, 315, 1, 0, 1
6556, 1, 1636422094326, 1636422094598, 272, 1, 271, 1, 0, 1
6557, 1, 1636422094726, 1636422094998, 272, 0, 272, 0, 0, 0
6558, 1, 1636422094998, 1636422095270, 272, 1, 271, 1, 0, 1
6559, 1, 1636422095394, 1636422095666, 272, 1, 271, 0, 0, 0
6560, 1, 1636422095666, 1636422095938, 272, 1, 271, 0, 0, 0
6561, 1, 1636422096062, 1636422096335, 273, 1, 272, 0, 0, 0
6562, 1, 1636422096334, 1636422096606, 272, 1, 271, 0, 0, 0
6536, 2, 1636422086738, 1636422096742, 10004, 0, 10004, 0, 0, 0
6544, 2, 1636422091458, 1636422101458, 10000, 0, 10000, 0, 0, 0
6547, 2, 1636422091862, 1636422101862, 10000, 0, 10000, 0, 0, 0
6546, 2, 1636422091862, 1636422101906, 10044, 0, 10044, 0, 0, 0
6545, 2, 1636422091862, 1636422101950, 10088, 0, 10088, 0, 0, 0
6548, 2, 1636422091910, 1636422101998, 10088, 0, 10088, 0, 0, 0
6564, 1, 1636422101766, 1636422102134, 368, 1, 367, 0, 1, 1
6565, 1, 1636422102214, 1636422102482, 268, 1, 267, 0, 1, 1
6569, 1, 1636422102530, 1636422102798, 268, 1, 267, 0, 0, 0
6570, 1, 1636422102878, 1636422103150, 272, 1, 271, 0, 0, 0
6571, 1, 1636422103194, 1636422103463, 269, 1, 268, 1, 0, 1
6572, 1, 1636422103546, 1636422103822, 276, 1, 275, 0, 0, 0
6573, 1, 1636422103862, 1636422104130, 268, 0, 268, 0, 0, 0
6574, 1, 1636422104214, 1636422104486, 272, 0, 272, 0, 0, 0
6575, 1, 1636422104526, 1636422104798, 272, 1, 271, 0, 0, 0
6576, 1, 1636422104882, 1636422105154, 272, 1, 271, 1, 0, 1
6577, 1, 1636422105194, 1636422105470, 276, 1, 275, 0, 0, 0
6578, 1, 1636422105546, 1636422105822, 276, 1, 275, 1, 0, 1
6579, 1, 1636422105866, 1636422106134, 268, 0, 268, 0, 0, 0
6580, 1, 1636422106214, 1636422106486, 272, 0, 272, 0, 0, 0
6563, 2, 1636422097042, 1636422107042, 10000, 0, 10000, 0, 0, 0
6566, 2, 1636422102218, 1636422112218, 10000, 0, 10000, 265, 0, 265
6568, 2, 1636422102262, 1636422112266, 10004, 0, 10004, 0, 0, 0
6567, 2, 1636422102218, 1636422112310, 10092, 10001, 91, 265, 9736, 10001
6583, 1, 1636422112578, 1636422112854, 276, 0, 276, 0, 0, 0
6584, 1, 1636422112618, 1636422113127, 509, 237, 272, 237, 0, 237
6585, 1, 1636422113250, 1636422113522, 272, 1, 271, 0, 1, 1
6586, 1, 1636422113522, 1636422113794, 272, 1, 271, 1, 0, 1
6587, 1, 1636422113918, 1636422114195, 277, 0, 277, 0, 0, 0
6588, 1, 1636422114194, 1636422114462, 268, 1, 267, 0, 0, 0
6589, 1, 1636422114590, 1636422114866, 276, 1, 275, 0, 0, 0
6590, 1, 1636422114862, 1636422115134, 272, 5, 267, 5, 0, 5
6591, 1, 1636422115262, 1636422115538, 276, 1, 275, 0, 0, 0
6592, 1, 1636422115530, 1636422115810, 280, 9, 271, 9, 0, 9
6593, 1, 1636422115934, 1636422116206, 272, 1, 271, 0, 0, 0
6594, 1, 1636422116206, 1636422116474, 268, 1, 267, 0, 1, 1
6581, 2, 1636422106534, 1636422116534, 10000, 0, 10000, 0, 0, 0
6582, 2, 1636422106882, 1636422116882, 10000, 0, 10000, 0, 0, 0
6595, 2, 1636422116622, 1636422126622, 10000, 0, 10000, 0, 0, 0
6596, 2, 1636422116842, 1636422126842, 10000, 0, 10000, 0, 0, 0
6597, 2, 1636422116874, 1636422126886, 10012, 0, 10012, 0, 0, 0
6598, 2, 1636422117186, 1636422127186, 10000, 0, 10000, 0, 0, 0
6599, 2, 1636422126934, 1636422136934, 10000, 0, 10000, 0, 0, 0
6600, 2, 1636422127182, 1636422137182, 10000, 0, 10000, 0, 0, 0
6601, 1, 1636422474674, 1636422474951, 277, 1, 276, 0, 1, 1
6602, 1, 1636422475146, 1636422475422, 276, 1, 275, 0, 0, 0
6604, 1, 1636422475702, 1636422475978, 276, 1, 275, 0, 0, 0
6606, 1, 1636422476230, 1636422476502, 272, 1, 271, 0, 0, 0
6608, 1, 1636422476798, 1636422477074, 276, 1, 275, 0, 0, 0
6610, 1, 1636422477398, 1636422477674, 276, 1, 275, 0, 0, 0
6612, 1, 1636422477918, 1636422478190, 272, 1, 271, 0, 1, 1
6614, 1, 1636422478530, 1636422478802, 272, 1, 271, 0, 1, 1
6616, 1, 1636422479066, 1636422479342, 276, 1, 275, 0, 1, 1
6618, 1, 1636422479534, 1636422479810, 276, 0, 276, 0, 0, 0
6621, 1, 1636422481178, 1636422481454, 276, 1, 275, 0, 1, 1
6622, 1, 1636422481694, 1636422481966, 272, 1, 271, 0, 0, 0
6624, 1, 1636422482259, 1636422482526, 267, 0, 267, 0, 0, 0
6626, 1, 1636422482850, 1636422483122, 272, 1, 271, 0, 1, 1
6628, 1, 1636422483394, 1636422483666, 272, 1, 271, 1, 0, 1
6630, 1, 1636422483902, 1636422484178, 276, 1, 275, 0, 0, 0
6632, 1, 1636422484514, 1636422484790, 276, 0, 276, 0, 0, 0
6634, 1, 1636422485098, 1636422485374, 276, 1, 275, 0, 0, 0
6603, 2, 1636422475426, 1636422485426, 10000, 0, 10000, 0, 0, 0
6605, 2, 1636422475898, 1636422485898, 10000, 0, 10000, 0, 0, 0
6637, 1, 1636422485698, 1636422485970, 272, 0, 272, 0, 0, 0
6636, 1, 1636422485735, 1636422486034, 299, 0, 299, 0, 0, 0
6607, 2, 1636422476458, 1636422486458, 10000, 0, 10000, 0, 0, 0
6639, 1, 1636422486206, 1636422486506, 300, 0, 300, 0, 0, 0
6640, 1, 1636422486442, 1636422486722, 280, 0, 280, 0, 0, 0
6641, 1, 1636422486450, 1636422486722, 272, 0, 272, 0, 0, 0
6609, 2, 1636422476990, 1636422486990, 10000, 0, 10000, 0, 0, 0
6643, 1, 1636422486766, 1636422487038, 272, 0, 272, 0, 0, 0
6644, 1, 1636422486918, 1636422487222, 304, 0, 304, 0, 0, 0
6647, 1, 1636422487262, 1636422487534, 272, 1, 271, 0, 0, 0
6646, 1, 1636422487298, 1636422487570, 272, 1, 271, 0, 0, 0
6611, 2, 1636422477582, 1636422487582, 10000, 0, 10000, 0, 0, 0
6648, 1, 1636422487482, 1636422487754, 272, 0, 272, 0, 0, 0
6649, 1, 1636422487726, 1636422488002, 276, 0, 276, 0, 0, 0
6613, 2, 1636422478154, 1636422488154, 10000, 0, 10000, 0, 0, 0
6650, 1, 1636422487890, 1636422488202, 312, 0, 312, 0, 0, 0
6651, 1, 1636422488014, 1636422488290, 276, 0, 276, 0, 0, 0
6653, 1, 1636422488298, 1636422488566, 268, 0, 268, 0, 0, 0
6615, 2, 1636422478702, 1636422488702, 10000, 0, 10000, 0, 0, 0
6654, 1, 1636422488461, 1636422488750, 289, 1, 288, 0, 0, 0
6656, 1, 1636422488606, 1636422488878, 272, 1, 271, 0, 1, 1
6657, 1, 1636422488834, 1636422489110, 276, 1, 275, 0, 1, 1
6617, 2, 1636422479282, 1636422489282, 10000, 0, 10000, 0, 0, 0
6658, 1, 1636422489010, 1636422489330, 320, 0, 320, 0, 0, 0
6660, 1, 1636422489178, 1636422489450, 272, 0, 272, 0, 0, 0
6661, 1, 1636422489422, 1636422489694, 272, 0, 272, 0, 0, 0
6619, 2, 1636422479818, 1636422489818, 10000, 0, 10000, 0, 0, 0
6662, 1, 1636422489590, 1636422489866, 276, 0, 276, 0, 0, 0
6664, 1, 1636422489766, 1636422490046, 280, 1, 279, 1, 0, 1
6665, 1, 1636422489994, 1636422490266, 272, 0, 272, 0, 0, 0
6620, 2, 1636422480322, 1636422490322, 10000, 0, 10000, 0, 0, 0
6666, 1, 1636422490122, 1636422490394, 272, 0, 272, 0, 0, 0
6668, 1, 1636422490310, 1636422490570, 260, 0, 260, 0, 0, 0
6669, 1, 1636422490530, 1636422490802, 272, 0, 272, 0, 0, 0
6670, 1, 1636422490626, 1636422490898, 272, 0, 272, 0, 0, 0
6672, 1, 1636422490846, 1636422491118, 272, 0, 272, 0, 0, 0
6673, 1, 1636422491122, 1636422491390, 268, 0, 268, 0, 0, 0
6675, 1, 1636422491354, 1636422491626, 272, 0, 272, 0, 0, 0
6623, 2, 1636422481934, 1636422491934, 10000, 0, 10000, 0, 0, 0
6676, 1, 1636422491666, 1636422491982, 316, 0, 316, 0, 0, 0
6678, 1, 1636422492166, 1636422492434, 268, 0, 268, 0, 0, 0
6625, 2, 1636422482478, 1636422492478, 10000, 0, 10000, 0, 0, 0
6679, 1, 1636422492242, 1636422492526, 284, 0, 284, 0, 0, 0
6627, 2, 1636422483054, 1636422493054, 10000, 0, 10000, 0, 0, 0
6681, 1, 1636422492786, 1636422493098, 312, 0, 312, 0, 0, 0
6682, 1, 1636422492958, 1636422493234, 276, 0, 276, 0, 0, 0
6629, 2, 1636422483610, 1636422493610, 10000, 0, 10000, 0, 0, 0
6684, 1, 1636422493358, 1636422493658, 300, 0, 300, 0, 0, 0
6685, 1, 1636422493502, 1636422493774, 272, 0, 272, 0, 0, 0
6686, 1, 1636422493774, 1636422494046, 272, 0, 272, 0, 0, 0
6631, 2, 1636422484154, 1636422494154, 10000, 0, 10000, 0, 0, 0
6687, 1, 1636422493914, 1636422494202, 288, 0, 288, 0, 0, 0
6688, 1, 1636422494078, 1636422494382, 304, 0, 304, 0, 0, 0
6689, 1, 1636422494314, 1636422494590, 276, 0, 276, 0, 0, 0
6633, 2, 1636422484690, 1636422494690, 10000, 0, 10000, 0, 0, 0
6690, 1, 1636422494462, 1636422494738, 276, 1, 275, 0, 0, 0
6692, 1, 1636422494634, 1636422494914, 280, 1, 279, 0, 1, 1
6693, 1, 1636422494878, 1636422495150, 272, 0, 272, 0, 0, 0
6635, 2, 1636422485266, 1636422495266, 10000, 0, 10000, 0, 0, 0
6694, 1, 1636422494994, 1636422495310, 316, 0, 316, 0, 0, 0
6696, 1, 1636422495178, 1636422495494, 316, 1, 315, 0, 0, 0
6697, 1, 1636422495446, 1636422495714, 268, 1, 267, 0, 1, 1
6638, 2, 1636422485850, 1636422495850, 10000, 0, 10000, 0, 0, 0
6698, 1, 1636422495578, 1636422495898, 320, 0, 320, 0, 0, 0
6700, 1, 1636422495714, 1636422495990, 276, 0, 276, 0, 0, 0
6701, 1, 1636422495982, 1636422496258, 276, 0, 276, 0, 0, 0
6702, 1, 1636422496162, 1636422496430, 268, 1, 267, 0, 1, 1
6642, 2, 1636422486446, 1636422496446, 10000, 0, 10000, 0, 0, 0
6704, 1, 1636422496334, 1636422496606, 272, 0, 272, 0, 0, 0
6705, 1, 1636422496534, 1636422496810, 276, 0, 276, 0, 0, 0
6706, 1, 1636422496754, 1636422497026, 272, 0, 272, 0, 0, 0
6708, 1, 1636422496874, 1636422497146, 272, 0, 272, 0, 0, 0
6645, 2, 1636422487198, 1636422497198, 10000, 0, 10000, 0, 0, 0
6709, 1, 1636422497094, 1636422497366, 272, 0, 272, 0, 0, 0
6712, 1, 1636422497470, 1636422497741, 271, 0, 271, 0, 0, 0
6711, 1, 1636422497506, 1636422497782, 276, 1, 275, 0, 1, 1
6713, 1, 1636422497690, 1636422497962, 272, 0, 272, 0, 0, 0
6652, 2, 1636422488050, 1636422498050, 10000, 0, 10000, 0, 0, 0
6715, 1, 1636422498222, 1636422498494, 272, 0, 272, 0, 0, 0
6655, 2, 1636422488514, 1636422498514, 10000, 0, 10000, 0, 0, 0
6716, 1, 1636422498282, 1636422498562, 280, 0, 280, 0, 0, 0
6717, 1, 1636422498358, 1636422498650, 292, 0, 292, 0, 0, 0
6659, 2, 1636422489086, 1636422499086, 10000, 0, 10000, 0, 0, 0
6719, 1, 1636422498822, 1636422499134, 312, 0, 312, 0, 0, 0
6720, 1, 1636422499038, 1636422499318, 280, 0, 280, 0, 0, 0
6721, 1, 1636422499070, 1636422499342, 272, 0, 272, 0, 0, 0
6663, 2, 1636422489622, 1636422499622, 10000, 0, 10000, 0, 0, 0
6723, 1, 1636422499398, 1636422499670, 272, 0, 272, 0, 0, 0
6724, 1, 1636422499534, 1636422499850, 316, 0, 316, 0, 0, 0
6727, 1, 1636422499930, 1636422500202, 272, 0, 272, 0, 0, 0
6667, 2, 1636422490210, 1636422500210, 10000, 0, 10000, 0, 0, 0
6728, 1, 1636422500110, 1636422500382, 272, 0, 272, 0, 0, 0
6671, 2, 1636422490782, 1636422500782, 10000, 0, 10000, 0, 0, 0
6730, 1, 1636422500518, 1636422500830, 312, 0, 312, 0, 0, 0
6731, 1, 1636422500646, 1636422500918, 272, 0, 272, 0, 0, 0
6674, 2, 1636422491318, 1636422501318, 10000, 0, 10000, 0, 0, 0
6733, 1, 1636422501090, 1636422501366, 276, 1, 275, 0, 1, 1
6734, 1, 1636422501230, 1636422501546, 316, 0, 316, 0, 0, 0
6736, 1, 1636422501626, 1636422501894, 268, 1, 267, 0, 0, 0
6677, 2, 1636422491922, 1636422501922, 10000, 0, 10000, 0, 0, 0
6737, 1, 1636422501802, 1636422502078, 276, 1, 275, 1, 0, 1
6680, 2, 1636422492454, 1636422502454, 10000, 0, 10000, 0, 0, 0
6739, 1, 1636422502226, 1636422502502, 276, 0, 276, 0, 0, 0
6740, 1, 1636422502342, 1636422502614, 272, 1, 271, 0, 1, 1
6683, 2, 1636422492966, 1636422502966, 10000, 0, 10000, 0, 0, 0
6742, 1, 1636422502758, 1636422503030, 272, 1, 271, 1, 0, 1
6743, 1, 1636422502950, 1636422503222, 272, 0, 272, 0, 0, 0
6745, 1, 1636422503270, 1636422503546, 276, 0, 276, 0, 0, 0
6746, 1, 1636422503482, 1636422503754, 272, 1, 271, 0, 1, 1
6748, 1, 1636422503990, 1636422504266, 276, 0, 276, 0, 0, 0
6691, 2, 1636422494562, 1636422504562, 10000, 0, 10000, 0, 0, 0
6695, 2, 1636422495102, 1636422505102, 10000, 0, 10000, 0, 0, 0
6751, 1, 1636422504870, 1636422505150, 280, 0, 280, 0, 0, 0
6699, 2, 1636422495666, 1636422505666, 10000, 0, 10000, 0, 0, 0
6752, 1, 1636422505410, 1636422505714, 304, 1, 303, 0, 1, 1
6753, 1, 1636422505586, 1636422505894, 308, 1, 307, 0, 1, 1
6703, 2, 1636422496234, 1636422506234, 10000, 0, 10000, 0, 0, 0
6754, 1, 1636422505970, 1636422506282, 312, 0, 312, 0, 0, 0
6755, 1, 1636422506126, 1636422506402, 276, 1, 275, 0, 1, 1
6707, 2, 1636422496770, 1636422506770, 10000, 0, 10000, 0, 0, 0
6757, 1, 1636422506538, 1636422506818, 280, 0, 280, 0, 0, 0
6758, 1, 1636422506694, 1636422506994, 300, 0, 300, 0, 0, 0
6710, 2, 1636422497330, 1636422507330, 10000, 0, 10000, 0, 0, 0
6760, 1, 1636422507078, 1636422507378, 300, 0, 300, 0, 0, 0
6761, 1, 1636422507258, 1636422507558, 300, 1, 299, 0, 1, 1
6714, 2, 1636422497878, 1636422507878, 10000, 0, 10000, 0, 0, 0
6763, 1, 1636422507634, 1636422507926, 292, 1, 291, 0, 0, 0
6764, 1, 1636422507794, 1636422508110, 316, 1, 315, 0, 1, 1
6766, 1, 1636422508186, 1636422508458, 272, 0, 272, 0, 0, 0
6718, 2, 1636422498478, 1636422508478, 10000, 0, 10000, 0, 0, 0
6767, 1, 1636422508354, 1636422508626, 272, 1, 271, 0, 1, 1
6769, 1, 1636422508786, 1636422509062, 276, 0, 276, 0, 0, 0
6722, 2, 1636422499078, 1636422509078, 10000, 0, 10000, 0, 0, 0
6770, 1, 1636422508898, 1636422509214, 316, 1, 315, 0, 1, 1
6772, 1, 1636422509386, 1636422509662, 276, 1, 275, 0, 1, 1
6773, 1, 1636422509502, 1636422509770, 268, 1, 267, 0, 0, 0
6725, 2, 1636422499830, 1636422509830, 10000, 0, 10000, 0, 0, 0
6726, 2, 1636422499862, 1636422509875, 10013, 0, 10013, 0, 0, 0
6729, 2, 1636422500342, 1636422510342, 10000, 0, 10000, 0, 0, 0
6776, 1, 1636422510098, 1636422510390, 292, 0, 292, 0, 0, 0
6775, 1, 1636422510142, 1636422510414, 272, 1, 271, 0, 0, 0
6777, 1, 1636422510170, 1636422510478, 308, 0, 308, 0, 0, 0
6732, 2, 1636422500914, 1636422510914, 10000, 0, 10000, 0, 0, 0
6779, 1, 1636422510650, 1636422510962, 312, 0, 312, 0, 0, 0
6780, 1, 1636422510858, 1636422511142, 284, 0, 284, 0, 0, 0
6781, 1, 1636422510886, 1636422511158, 272, 0, 272, 0, 0, 0
6735, 2, 1636422501450, 1636422511450, 10000, 0, 10000, 0, 0, 0
6783, 1, 1636422511222, 1636422511498, 276, 0, 276, 0, 0, 0
6784, 1, 1636422511366, 1636422511678, 312, 0, 312, 0, 0, 0
6786, 1, 1636422511690, 1636422511962, 272, 0, 272, 0, 0, 0
6787, 1, 1636422511758, 1636422512030, 272, 0, 272, 0, 0, 0
6738, 2, 1636422502054, 1636422512054, 10000, 0, 10000, 0, 0, 0
6788, 1, 1636422511938, 1636422512206, 268, 0, 268, 0, 0, 0
6789, 1, 1636422512186, 1636422512458, 272, 0, 272, 0, 0, 0
6741, 2, 1636422502594, 1636422512594, 10000, 0, 10000, 0, 0, 0
6790, 1, 1636422512354, 1636422512642, 288, 0, 288, 0, 0, 0
6791, 1, 1636422512474, 1636422512746, 272, 0, 272, 0, 0, 0
6792, 1, 1636422512490, 1636422512766, 276, 0, 276, 0, 0, 0
6793, 1, 1636422512754, 1636422513026, 272, 0, 272, 0, 0, 0
6744, 2, 1636422503138, 1636422513138, 10000, 0, 10000, 0, 0, 0
6794, 1, 1636422512902, 1636422513186, 284, 1, 283, 0, 0, 0
6795, 1, 1636422512970, 1636422513274, 304, 0, 304, 0, 0, 0
6796, 1, 1636422513078, 1636422513366, 288, 0, 288, 0, 0, 0
6797, 1, 1636422513282, 1636422513554, 272, 0, 272, 0, 0, 0
6798, 1, 1636422513282, 1636422513558, 276, 0, 276, 0, 0, 0
6799, 1, 1636422513446, 1636422513722, 276, 0, 276, 0, 0, 0
6747, 2, 1636422503742, 1636422513742, 10000, 0, 10000, 0, 0, 0
6800, 1, 1636422513546, 1636422513822, 276, 0, 276, 0, 0, 0
6801, 1, 1636422513618, 1636422513890, 272, 0, 272, 0, 0, 0
6802, 1, 1636422513786, 1636422514058, 272, 0, 272, 0, 0, 0
6803, 1, 1636422513882, 1636422514154, 272, 0, 272, 0, 0, 0
6749, 2, 1636422504274, 1636422514274, 10000, 0, 10000, 0, 0, 0
6804, 1, 1636422514046, 1636422514322, 276, 0, 276, 0, 0, 0
6805, 1, 1636422514074, 1636422514346, 272, 0, 272, 0, 0, 0
6807, 1, 1636422514162, 1636422514434, 272, 0, 272, 0, 0, 0
6806, 1, 1636422514078, 1636422514618, 540, 269, 271, 269, 0, 269
6808, 1, 1636422514362, 1636422514638, 276, 0, 276, 0, 0, 0
6809, 1, 1636422514422, 1636422514690, 268, 0, 268, 0, 0, 0
6750, 2, 1636422504786, 1636422514782, 9996, 0, 9996, 0, 0, 0
6810, 1, 1636422514578, 1636422514850, 272, 0, 272, 0, 0, 0
6811, 1, 1636422514558, 1636422514918, 360, 60, 300, 60, 0, 60
6813, 1, 1636422514770, 1636422515046, 276, 0, 276, 0, 0, 0
6814, 1, 1636422514914, 1636422515186, 272, 0, 272, 0, 0, 0
6812, 1, 1636422514674, 1636422515194, 520, 245, 275, 245, 0, 245
6815, 1, 1636422514970, 1636422515242, 272, 0, 272, 0, 0, 0
6816, 1, 1636422515022, 1636422515298, 276, 0, 276, 0, 0, 0
6817, 1, 1636422515094, 1636422515366, 272, 0, 272, 0, 0, 0
6818, 1, 1636422515138, 1636422515462, 324, 57, 267, 57, 0, 57
6820, 1, 1636422515302, 1636422515574, 272, 0, 272, 0, 0, 0
6821, 1, 1636422515358, 1636422515630, 272, 0, 272, 0, 0, 0
6819, 1, 1636422515214, 1636422515726, 512, 249, 263, 249, 0, 249
6823, 1, 1636422515578, 1636422515854, 276, 0, 276, 0, 0, 0
6822, 1, 1636422515590, 1636422515866, 276, 0, 276, 0, 0, 0
6824, 1, 1636422515686, 1636422515958, 272, 0, 272, 0, 0, 0
6825, 1, 1636422515766, 1636422516034, 268, 0, 268, 0, 0, 0
6827, 1, 1636422515814, 1636422516090, 276, 0, 276, 0, 0, 0
6828, 1, 1636422515938, 1636422516206, 268, 0, 268, 0, 0, 0
6756, 2, 1636422506374, 1636422516374, 10000, 0, 10000, 0, 0, 0
6829, 1, 1636422516130, 1636422516422, 292, 0, 292, 0, 0, 0
6830, 1, 1636422516110, 1636422516422, 312, 0, 312, 0, 0, 0
6831, 1, 1636422516158, 1636422516430, 272, 0, 272, 0, 0, 0
6833, 1, 1636422516370, 1636422516642, 272, 0, 272, 0, 0, 0
6834, 1, 1636422516506, 1636422516778, 272, 0, 272, 0, 0, 0
6835, 1, 1636422516546, 1636422516818, 272, 0, 272, 0, 0, 0
6836, 1, 1636422516626, 1636422516902, 276, 0, 276, 0, 0, 0
6759, 2, 1636422506918, 1636422516918, 10000, 0, 10000, 0, 0, 0
6837, 1, 1636422516686, 1636422516966, 280, 0, 280, 0, 0, 0
6838, 1, 1636422516734, 1636422516998, 264, 0, 264, 0, 0, 0
6840, 1, 1636422516898, 1636422517170, 272, 0, 272, 0, 0, 0
6841, 1, 1636422517006, 1636422517278, 272, 0, 272, 0, 0, 0
6842, 1, 1636422517158, 1636422517426, 268, 0, 268, 0, 0, 0
6762, 2, 1636422507490, 1636422517490, 10000, 0, 10000, 0, 0, 0
6843, 1, 1636422517226, 1636422517538, 312, 0, 312, 0, 0, 0
6844, 1, 1636422517306, 1636422517578, 272, 0, 272, 0, 0, 0
6845, 1, 1636422517342, 1636422517626, 284, 0, 284, 0, 0, 0
6846, 1, 1636422517398, 1636422517670, 272, 0, 272, 0, 0, 0
6848, 1, 1636422517578, 1636422517846, 268, 1, 267, 0, 0, 0
6847, 1, 1636422517422, 1636422517894, 472, 205, 267, 204, 0, 204
6849, 1, 1636422517686, 1636422517966, 280, 0, 280, 0, 0, 0
6851, 1, 1636422517770, 1636422518042, 272, 0, 272, 0, 0, 0
6765, 2, 1636422508054, 1636422518054, 10000, 0, 10000, 0, 0, 0
6850, 1, 1636422517794, 1636422518102, 308, 0, 308, 0, 0, 0
6852, 1, 1636422517942, 1636422518210, 268, 0, 268, 0, 0, 0
6853, 1, 1636422517950, 1636422518222, 272, 0, 272, 0, 0, 0
6854, 1, 1636422518098, 1636422518366, 268, 0, 268, 0, 0, 0
6855, 1, 1636422518150, 1636422518426, 276, 0, 276, 0, 0, 0
6856, 1, 1636422518214, 1636422518490, 276, 0, 276, 0, 0, 0
6857, 1, 1636422518290, 1636422518566, 276, 0, 276, 0, 0, 0
6859, 1, 1636422518338, 1636422518610, 272, 0, 272, 0, 0, 0
6768, 2, 1636422508614, 1636422518618, 10004, 0, 10004, 0, 0, 0
6858, 1, 1636422518358, 1636422518666, 308, 0, 308, 0, 0, 0
6860, 1, 1636422518478, 1636422518754, 276, 0, 276, 0, 0, 0
6861, 1, 1636422518514, 1636422518786, 272, 0, 272, 0, 0, 0
6862, 1, 1636422518570, 1636422518842, 272, 0, 272, 0, 0, 0
6863, 1, 1636422518750, 1636422519018, 268, 0, 268, 0, 0, 0
6864, 1, 1636422518754, 1636422519026, 272, 0, 272, 0, 0, 0
6771, 2, 1636422509166, 1636422519166, 10000, 0, 10000, 0, 0, 0
6867, 1, 1636422518938, 1636422519214, 276, 0, 276, 0, 0, 0
6865, 1, 1636422518922, 1636422519214, 292, 0, 292, 0, 0, 0
6866, 1, 1636422518898, 1636422519214, 316, 0, 316, 0, 0, 0
6868, 1, 1636422519010, 1636422519298, 288, 0, 288, 0, 0, 0
6870, 1, 1636422519086, 1636422519394, 308, 0, 308, 0, 0, 0
6871, 1, 1636422519138, 1636422519406, 268, 0, 268, 0, 0, 0
6872, 1, 1636422519302, 1636422519574, 272, 0, 272, 0, 0, 0
6873, 1, 1636422519326, 1636422519602, 276, 0, 276, 0, 0, 0
6874, 1, 1636422519370, 1636422519638, 268, 0, 268, 0, 0, 0
6774, 2, 1636422509686, 1636422519686, 10000, 0, 10000, 0, 0, 0
6875, 1, 1636422519470, 1636422519734, 264, 0, 264, 0, 0, 0
6877, 1, 1636422519550, 1636422519822, 272, 0, 272, 0, 0, 0
6876, 1, 1636422519538, 1636422519822, 284, 0, 284, 0, 0, 0
6878, 1, 1636422519646, 1636422519918, 272, 0, 272, 0, 0, 0
6879, 1, 1636422519734, 1636422520002, 268, 0, 268, 0, 0, 0
6880, 1, 1636422519778, 1636422520046, 268, 0, 268, 0, 0, 0
6881, 1, 1636422519822, 1636422520090, 268, 0, 268, 0, 0, 0
6882, 1, 1636422519886, 1636422520158, 272, 0, 272, 0, 0, 0
6883, 1, 1636422519946, 1636422520218, 272, 0, 272, 0, 0, 0
6884, 1, 1636422520002, 1636422520274, 272, 0, 272, 0, 0, 0
6778, 2, 1636422510294, 1636422520294, 10000, 0, 10000, 0, 0, 0
6885, 1, 1636422520078, 1636422520346, 268, 0, 268, 0, 0, 0
6886, 1, 1636422520118, 1636422520430, 312, 0, 312, 0, 0, 0
6887, 1, 1636422520182, 1636422520446, 264, 0, 264, 0, 0, 0
6888, 1, 1636422520190, 1636422520454, 264, 0, 264, 0, 0, 0
6889, 1, 1636422520338, 1636422520602, 264, 0, 264, 0, 0, 0
6890, 1, 1636422520382, 1636422520654, 272, 0, 272, 0, 0, 0
6891, 1, 1636422520450, 1636422520718, 268, 0, 268, 0, 0, 0
6893, 1, 1636422520538, 1636422520806, 268, 0, 268, 0, 0, 0
6894, 1, 1636422520602, 1636422520878, 276, 1, 275, 1, 0, 1
6895, 1, 1636422520602, 1636422520878, 276, 0, 276, 0, 0, 0
6782, 2, 1636422510898, 1636422520898, 10000, 0, 10000, 0, 0, 0
6897, 1, 1636422520714, 1636422520982, 268, 0, 268, 0, 0, 0
6898, 1, 1636422520750, 1636422521034, 284, 0, 284, 0, 0, 0
6896, 1, 1636422520682, 1636422521142, 460, 197, 263, 197, 0, 197
6899, 1, 1636422520890, 1636422521166, 276, 0, 276, 0, 0, 0
6900, 1, 1636422520946, 1636422521210, 264, 0, 264, 0, 0, 0
6902, 1, 1636422521034, 1636422521302, 268, 0, 268, 0, 0, 0
6903, 1, 1636422521122, 1636422521406, 284, 20, 264, 20, 0, 20
6904, 1, 1636422521166, 1636422521426, 260, 0, 260, 0, 0, 0
6905, 1, 1636422521210, 1636422521466, 256, 0, 256, 0, 0, 0
6907, 1, 1636422521322, 1636422521578, 256, 0, 256, 0, 0, 0
6908, 1, 1636422521334, 1636422521594, 260, 0, 260, 0, 0, 0
6785, 2, 1636422511650, 1636422521650, 10000, 0, 10000, 0, 0, 0
6906, 1, 1636422521242, 1636422521694, 452, 164, 288, 164, 0, 164
6909, 1, 1636422521402, 1636422521698, 296, 0, 296, 0, 0, 0
6911, 1, 1636422521530, 1636422521794, 264, 0, 264, 0, 0, 0
6910, 1, 1636422521534, 1636422521798, 264, 0, 264, 0, 0, 0
6913, 1, 1636422521694, 1636422521966, 272, 0, 272, 0, 0, 0
6914, 1, 1636422521738, 1636422522001, 263, 0, 263, 0, 0, 0
6917, 1, 1636422521926, 1636422522202, 276, 0, 276, 0, 0, 0
6918, 1, 1636422521930, 1636422522202, 272, 0, 272, 0, 0, 0
6916, 1, 1636422521958, 1636422522226, 268, 0, 268, 0, 0, 0
6919, 1, 1636422521966, 1636422522230, 264, 0, 264, 0, 0, 0
6915, 1, 1636422521794, 1636422522278, 484, 208, 276, 208, 0, 208
6920, 1, 1636422522098, 1636422522366, 268, 0, 268, 0, 0, 0
6921, 1, 1636422522134, 1636422522402, 268, 0, 268, 0, 0, 0
6922, 1, 1636422522134, 1636422522414, 280, 1, 279, 0, 0, 0
6923, 1, 1636422522210, 1636422522482, 272, 0, 272, 0, 0, 0
6925, 1, 1636422522322, 1636422522594, 272, 0, 272, 0, 0, 0
6926, 1, 1636422522486, 1636422522758, 272, 0, 272, 0, 0, 0
6927, 1, 1636422522514, 1636422522790, 276, 0, 276, 0, 0, 0
6929, 1, 1636422522674, 1636422522942, 268, 0, 268, 0, 0, 0
6928, 1, 1636422522674, 1636422522946, 272, 0, 272, 0, 0, 0
6930, 1, 1636422522734, 1636422523002, 268, 0, 268, 0, 0, 0
6931, 1, 1636422522734, 1636422523002, 268, 0, 268, 0, 0, 0
6932, 1, 1636422522766, 1636422523034, 268, 0, 268, 0, 0, 0
6934, 1, 1636422522926, 1636422523194, 268, 0, 268, 0, 0, 0
6935, 1, 1636422522950, 1636422523222, 272, 0, 272, 0, 0, 0
6936, 1, 1636422523014, 1636422523290, 276, 0, 276, 0, 0, 0
6937, 1, 1636422523114, 1636422523386, 272, 0, 272, 0, 0, 0
6938, 1, 1636422523298, 1636422523570, 272, 0, 272, 0, 0, 0
6939, 1, 1636422523310, 1636422523586, 276, 0, 276, 0, 0, 0
6941, 1, 1636422523478, 1636422523750, 272, 1, 271, 0, 1, 1
6942, 1, 1636422523530, 1636422523802, 272, 0, 272, 0, 0, 0
6943, 1, 1636422523546, 1636422523818, 272, 0, 272, 0, 0, 0
6944, 1, 1636422523577, 1636422523846, 269, 1, 268, 0, 0, 0
6945, 1, 1636422523714, 1636422523990, 276, 0, 276, 0, 0, 0
6947, 1, 1636422523814, 1636422524090, 276, 0, 276, 0, 0, 0
6948, 1, 1636422523914, 1636422524194, 280, 0, 280, 0, 0, 0
6949, 1, 1636422524106, 1636422524378, 272, 0, 272, 0, 0, 0
6950, 1, 1636422524118, 1636422524390, 272, 0, 272, 0, 0, 0
6951, 1, 1636422524274, 1636422524546, 272, 0, 272, 0, 0, 0
6952, 1, 1636422524310, 1636422524578, 268, 0, 268, 0, 0, 0
6953, 1, 1636422524342, 1636422524610, 268, 0, 268, 0, 0, 0
6955, 1, 1636422524510, 1636422524810, 300, 36, 264, 36, 0, 36
6956, 1, 1636422524610, 1636422524878, 268, 1, 267, 0, 0, 0
6957, 1, 1636422524714, 1636422524982, 268, 0, 268, 0, 0, 0
6959, 1, 1636422524914, 1636422525182, 268, 0, 268, 0, 0, 0
6960, 1, 1636422525058, 1636422525330, 272, 0, 272, 0, 0, 0
6961, 1, 1636422525102, 1636422525374, 272, 0, 272, 0, 0, 0
6962, 1, 1636422525146, 1636422525410, 264, 0, 264, 0, 0, 0
6963, 1, 1636422525310, 1636422525578, 268, 0, 268, 0, 0, 0
6964, 1, 1636422525410, 1636422525682, 272, 1, 271, 1, 0, 1
6965, 1, 1636422525510, 1636422525782, 272, 1, 271, 0, 1, 1
6826, 2, 1636422515786, 1636422525786, 10000, 0, 10000, 0, 0, 0
6966, 1, 1636422525710, 1636422526018, 308, 1, 307, 0, 1, 1
6967, 1, 1636422525874, 1636422526142, 268, 1, 267, 0, 1, 1
6968, 1, 1636422525918, 1636422526194, 276, 0, 276, 0, 0, 0
6969, 1, 1636422525946, 1636422526218, 272, 0, 272, 0, 0, 0
6832, 2, 1636422516354, 1636422526354, 10000, 0, 10000, 0, 0, 0
6971, 1, 1636422526106, 1636422526402, 296, 0, 296, 0, 0, 0
6972, 1, 1636422526218, 1636422526490, 272, 0, 272, 0, 0, 0
6973, 1, 1636422526326, 1636422526594, 268, 0, 268, 0, 0, 0
6974, 1, 1636422526514, 1636422526782, 268, 0, 268, 0, 0, 0
6839, 2, 1636422516882, 1636422526882, 10000, 0, 10000, 0, 0, 0
6976, 1, 1636422526662, 1636422526938, 276, 0, 276, 0, 0, 0
6977, 1, 1636422526702, 1636422526970, 268, 0, 268, 0, 0, 0
6978, 1, 1636422526758, 1636422527030, 272, 0, 272, 0, 0, 0
6979, 1, 1636422526926, 1636422527194, 268, 0, 268, 0, 0, 0
6981, 1, 1636422527122, 1636422527390, 268, 0, 268, 0, 0, 0
6983, 1, 1636422527322, 1636422527594, 272, 0, 272, 0, 0, 0
6984, 1, 1636422527462, 1636422527734, 272, 1, 271, 0, 1, 1
6985, 1, 1636422527518, 1636422527790, 272, 0, 272, 0, 0, 0
6987, 1, 1636422527706, 1636422527974, 268, 0, 268, 0, 0, 0
6988, 1, 1636422527922, 1636422528194, 272, 1, 271, 0, 1, 1
6990, 1, 1636422528278, 1636422528550, 272, 0, 272, 0, 0, 0
6991, 1, 1636422528314, 1636422528586, 272, 0, 272, 0, 0, 0
6992, 1, 1636422528506, 1636422528782, 276, 0, 276, 0, 0, 0
6993, 1, 1636422528726, 1636422528998, 272, 0, 272, 0, 0, 0
6869, 2, 1636422519050, 1636422529050, 10000, 0, 10000, 0, 0, 0
6994, 1, 1636422529098, 1636422529366, 268, 0, 268, 0, 0, 0
6995, 1, 1636422529142, 1636422529414, 272, 0, 272, 0, 0, 0
6996, 1, 1636422529318, 1636422529590, 272, 0, 272, 0, 0, 0
6998, 1, 1636422529530, 1636422529810, 280, 0, 280, 0, 0, 0
6999, 1, 1636422529862, 1636422530134, 272, 0, 272, 0, 0, 0
7000, 1, 1636422529914, 1636422530186, 272, 0, 272, 0, 0, 0
7001, 1, 1636422530126, 1636422530398, 272, 0, 272, 0, 0, 0
6892, 2, 1636422520506, 1636422530506, 10000, 0, 10000, 0, 0, 0
7003, 1, 1636422530670, 1636422530938, 268, 1, 267, 0, 0, 0
7004, 1, 1636422530722, 1636422530986, 264, 0, 264, 0, 0, 0
6901, 2, 1636422520990, 1636422530990, 10000, 0, 10000, 0, 0, 0
7005, 1, 1636422530814, 1636422531126, 312, 0, 312, 0, 0, 0
6912, 2, 1636422521542, 1636422531542, 10000, 0, 10000, 0, 0, 0
7007, 1, 1636422531298, 1636422531590, 292, 1, 291, 0, 1, 1
7008, 1, 1636422531474, 1636422531774, 300, 0, 300, 0, 0, 0
7010, 1, 1636422531526, 1636422532046, 520, 249, 271, 249, 0, 249
7011, 1, 1636422531850, 1636422532122, 272, 1, 271, 0, 0, 0
6924, 2, 1636422522306, 1636422532306, 10000, 0, 10000, 0, 0, 0
7012, 1, 1636422532010, 1636422532354, 344, 37, 307, 37, 0, 37
7014, 1, 1636422532486, 1636422532758, 272, 1, 271, 0, 1, 1
7015, 1, 1636422532554, 1636422532830, 276, 0, 276, 0, 0, 0
6933, 2, 1636422522858, 1636422532858, 10000, 0, 10000, 0, 0, 0
7017, 1, 1636422532810, 1636422533090, 280, 0, 280, 0, 0, 0
6940, 2, 1636422523430, 1636422533430, 10000, 0, 10000, 0, 0, 0
7019, 1, 1636422533246, 1636422533514, 268, 0, 268, 0, 0, 0
7020, 1, 1636422533354, 1636422533658, 304, 1, 303, 0, 1, 1
6946, 2, 1636422523746, 1636422533746, 10000, 0, 10000, 0, 0, 0
7021, 1, 1636422533610, 1636422533882, 272, 0, 272, 0, 0, 0
7024, 1, 1636422534046, 1636422534318, 272, 0, 272, 0, 0, 0
7023, 1, 1636422534054, 1636422534326, 272, 0, 272, 0, 0, 0
6954, 2, 1636422524378, 1636422534378, 10000, 0, 10000, 0, 0, 0
7025, 1, 1636422534162, 1636422534434, 272, 0, 272, 0, 0, 0
6958, 2, 1636422524906, 1636422534906, 10000, 0, 10000, 0, 0, 0
7027, 1, 1636422534682, 1636422534954, 272, 0, 272, 0, 0, 0
7028, 1, 1636422534758, 1636422535042, 284, 0, 284, 0, 0, 0
7029, 1, 1636422534834, 1636422535134, 300, 0, 300, 0, 0, 0
7031, 1, 1636422535210, 1636422535482, 272, 0, 272, 0, 0, 0
7032, 1, 1636422535398, 1636422535666, 268, 1, 267, 0, 1, 1
7033, 1, 1636422535557, 1636422535830, 273, 1, 272, 0, 0, 0
7034, 1, 1636422535638, 1636422535906, 268, 0, 268, 0, 0, 0
6970, 2, 1636422526098, 1636422536098, 10000, 0, 10000, 0, 0, 0
7035, 1, 1636422535922, 1636422536234, 312, 0, 312, 0, 0, 0
7036, 1, 1636422536230, 1636422536506, 276, 0, 276, 0, 0, 0
7038, 1, 1636422536370, 1636422536642, 272, 0, 272, 0, 0, 0
6975, 2, 1636422526662, 1636422536662, 10000, 0, 10000, 0, 0, 0
7037, 1, 1636422536406, 1636422536710, 304, 0, 304, 0, 0, 0
7040, 1, 1636422536710, 1636422536978, 268, 0, 268, 0, 0, 0
6980, 2, 1636422527014, 1636422537014, 10000, 0, 10000, 0, 0, 0
6982, 2, 1636422527190, 1636422537190, 10000, 0, 10000, 0, 0, 0
7041, 1, 1636422536970, 1636422537246, 276, 0, 276, 0, 0, 0
7042, 1, 1636422537002, 1636422537274, 272, 0, 272, 0, 0, 0
7043, 1, 1636422537146, 1636422537418, 272, 1, 271, 0, 1, 1
6986, 2, 1636422527546, 1636422537546, 10000, 0, 10000, 0, 0, 0
7045, 1, 1636422537322, 1636422537594, 272, 0, 272, 0, 0, 0
7046, 1, 1636422537498, 1636422537770, 272, 0, 272, 0, 0, 0
7047, 1, 1636422537518, 1636422537794, 276, 0, 276, 0, 0, 0
7048, 1, 1636422537686, 1636422537954, 268, 0, 268, 0, 0, 0
6989, 2, 1636422528118, 1636422538118, 10000, 0, 10000, 0, 0, 0
7050, 1, 1636422537854, 1636422538166, 312, 0, 312, 0, 0, 0
7051, 1, 1636422537922, 1636422538194, 272, 0, 272, 0, 0, 0
7052, 1, 1636422538026, 1636422538298, 272, 0, 272, 0, 0, 0
7053, 1, 1636422538210, 1636422538482, 272, 0, 272, 0, 0, 0
7055, 1, 1636422538422, 1636422538694, 272, 1, 271, 0, 1, 1
7056, 1, 1636422538482, 1636422538754, 272, 0, 272, 0, 0, 0
7057, 1, 1636422538566, 1636422538842, 276, 0, 276, 0, 0, 0
7058, 1, 1636422538738, 1636422539010, 272, 0, 272, 0, 0, 0
7059, 1, 1636422538826, 1636422539098, 272, 0, 272, 0, 0, 0
7060, 1, 1636422539010, 1636422539278, 268, 0, 268, 0, 0, 0
6997, 2, 1636422529354, 1636422539354, 10000, 0, 10000, 0, 0, 0
7061, 1, 1636422539134, 1636422539402, 268, 0, 268, 0, 0, 0
7062, 1, 1636422539298, 1636422539582, 284, 0, 284, 0, 0, 0
7063, 1, 1636422539402, 1636422539678, 276, 0, 276, 0, 0, 0
7064, 1, 1636422539534, 1636422539806, 272, 0, 272, 0, 0, 0
7066, 1, 1636422539630, 1636422539902, 272, 0, 272, 0, 0, 0
7065, 1, 1636422539658, 1636422539930, 272, 0, 272, 0, 0, 0
7067, 1, 1636422539830, 1636422540098, 268, 0, 268, 0, 0, 0
7068, 1, 1636422539930, 1636422540194, 264, 0, 264, 0, 0, 0
7002, 2, 1636422530322, 1636422540322, 10000, 0, 10000, 0, 0, 0
7069, 1, 1636422540094, 1636422540370, 276, 0, 276, 0, 0, 0
7070, 1, 1636422540166, 1636422540458, 292, 0, 292, 0, 0, 0
7071, 1, 1636422540370, 1636422540642, 272, 0, 272, 0, 0, 0
7072, 1, 1636422540414, 1636422540686, 272, 0, 272, 0, 0, 0
7075, 1, 1636422540626, 1636422540898, 272, 0, 272, 0, 0, 0
7074, 1, 1636422540630, 1636422540906, 276, 1, 275, 0, 0, 0
7006, 2, 1636422530922, 1636422540922, 10000, 0, 10000, 0, 0, 0
7076, 1, 1636422540734, 1636422541006, 272, 0, 272, 0, 0, 0
7077, 1, 1636422540894, 1636422541162, 268, 0, 268, 0, 0, 0
7079, 1, 1636422541146, 1636422541418, 272, 0, 272, 0, 0, 0
7080, 1, 1636422541174, 1636422541446, 272, 0, 272, 0, 0, 0
7081, 1, 1636422541234, 1636422541502, 268, 0, 268, 0, 0, 0
7009, 2, 1636422531506, 1636422541506, 10000, 0, 10000, 0, 0, 0
7082, 1, 1636422541334, 1636422541642, 308, 0, 308, 0, 0, 0
7083, 1, 1636422541422, 1636422541734, 312, 0, 312, 0, 0, 0
7085, 1, 1636422541698, 1636422541974, 276, 0, 276, 0, 0, 0
7086, 1, 1636422541810, 1636422542086, 276, 0, 276, 0, 0, 0
7087, 1, 1636422541934, 1636422542206, 272, 0, 272, 0, 0, 0
7089, 1, 1636422541986, 1636422542258, 272, 0, 272, 0, 0, 0
7013, 2, 1636422532270, 1636422542270, 10000, 0, 10000, 0, 0, 0
7090, 1, 1636422542122, 1636422542410, 288, 0, 288, 0, 0, 0
7088, 1, 1636422541958, 1636422542498, 540, 249, 291, 249, 0, 249
7091, 1, 1636422542230, 1636422542498, 268, 0, 268, 0, 0, 0
7016, 2, 1636422532610, 1636422542610, 10000, 0, 10000, 0, 0, 0
7092, 1, 1636422542510, 1636422542782, 272, 0, 272, 0, 0, 0
7094, 1, 1636422542578, 1636422542854, 276, 1, 275, 0, 0, 0
7095, 1, 1636422542746, 1636422543022, 276, 0, 276, 0, 0, 0
7093, 1, 1636422542518, 1636422543050, 532, 264, 268, 264, 0, 264
7096, 1, 1636422542782, 1636422543054, 272, 0, 272, 0, 0, 0
7018, 2, 1636422533166, 1636422543166, 10000, 0, 10000, 0, 0, 0
7098, 1, 1636422542910, 1636422543214, 304, 0, 304, 0, 0, 0
7099, 1, 1636422542926, 1636422543214, 288, 0, 288, 0, 0, 0
7100, 1, 1636422543038, 1636422543322, 284, 13, 271, 13, 0, 13
7101, 1, 1636422543298, 1636422543602, 304, 25, 279, 25, 0, 25
7103, 1, 1636422543442, 1636422543718, 276, 1, 275, 0, 0, 0
7022, 2, 1636422533734, 1636422543734, 10000, 0, 10000, 0, 0, 0
7104, 1, 1636422543474, 1636422543782, 308, 1, 307, 0, 0, 0
7105, 1, 1636422543550, 1636422543822, 272, 0, 272, 0, 0, 0
7106, 1, 1636422543582, 1636422543866, 284, 0, 284, 0, 0, 0
7107, 1, 1636422543630, 1636422543902, 272, 0, 272, 0, 0, 0
7110, 1, 1636422544038, 1636422544310, 272, 0, 272, 0, 0, 0
7111, 1, 1636422544073, 1636422544346, 273, 1, 272, 1, 0, 1
7026, 2, 1636422534422, 1636422544426, 10004, 0, 10004, 0, 0, 0
7112, 1, 1636422544186, 1636422544474, 288, 0, 288, 0, 0, 0
7113, 1, 1636422544206, 1636422544474, 268, 0, 268, 0, 0, 0
7115, 1, 1636422544386, 1636422544654, 268, 0, 268, 0, 0, 0
7116, 1, 1636422544474, 1636422544746, 272, 0, 272, 0, 0, 0
7030, 2, 1636422534950, 1636422544954, 10004, 0, 10004, 0, 0, 0
7117, 1, 1636422544734, 1636422545010, 276, 0, 276, 0, 0, 0
7118, 1, 1636422544758, 1636422545030, 272, 0, 272, 0, 0, 0
7119, 1, 1636422544886, 1636422545182, 296, 0, 296, 0, 0, 0
7120, 1, 1636422544998, 1636422545266, 268, 0, 268, 0, 0, 0
7121, 1, 1636422545046, 1636422545314, 268, 0, 268, 0, 0, 0
7122, 1, 1636422545190, 1636422545458, 268, 0, 268, 0, 0, 0
7124, 1, 1636422545234, 1636422545498, 264, 0, 264, 0, 0, 0
7123, 1, 1636422545258, 1636422545526, 268, 0, 268, 0, 0, 0
7125, 1, 1636422545446, 1636422545710, 264, 0, 264, 0, 0, 0
7126, 1, 1636422545554, 1636422545826, 272, 0, 272, 0, 0, 0
7128, 1, 1636422545786, 1636422546054, 268, 0, 268, 0, 0, 0
7129, 1, 1636422545810, 1636422546078, 268, 0, 268, 0, 0, 0
7130, 1, 1636422545978, 1636422546250, 272, 1, 271, 0, 1, 1
7132, 1, 1636422546030, 1636422546298, 268, 0, 268, 0, 0, 0
7039, 2, 1636422536446, 1636422546446, 10000, 0, 10000, 0, 0, 0
7134, 1, 1636422546370, 1636422546674, 304, 0, 304, 0, 0, 0
7135, 1, 1636422546578, 1636422546850, 272, 0, 272, 0, 0, 0
7136, 1, 1636422546618, 1636422546882, 264, 0, 264, 0, 0, 0
7137, 1, 1636422546754, 1636422547022, 268, 0, 268, 0, 0, 0
7139, 1, 1636422546830, 1636422547102, 272, 0, 272, 0, 0, 0
7044, 2, 1636422537154, 1636422547154, 10000, 0, 10000, 0, 0, 0
7140, 1, 1636422547198, 1636422547470, 272, 0, 272, 0, 0, 0
7141, 1, 1636422547378, 1636422547654, 276, 0, 276, 0, 0, 0
7142, 1, 1636422547462, 1636422547730, 268, 0, 268, 0, 0, 0
7144, 1, 1636422547474, 1636422547746, 272, 0, 272, 0, 0, 0
7049, 2, 1636422537786, 1636422547786, 10000, 0, 10000, 0, 0, 0
7145, 1, 1636422547634, 1636422547922, 288, 0, 288, 0, 0, 0
7146, 1, 1636422547958, 1636422548230, 272, 1, 271, 0, 0, 0
7054, 2, 1636422538306, 1636422548306, 10000, 0, 10000, 0, 0, 0
7147, 1, 1636422548086, 1636422548362, 276, 1, 275, 0, 1, 1
7148, 1, 1636422548182, 1636422548450, 268, 1, 267, 0, 1, 1
7149, 1, 1636422548182, 1636422548458, 276, 1, 275, 0, 1, 1
7150, 1, 1636422548286, 1636422548558, 272, 0, 272, 0, 0, 0
7151, 1, 1636422548450, 1636422548714, 264, 0, 264, 0, 0, 0
7152, 1, 1636422548610, 1636422548882, 272, 0, 272, 0, 0, 0
7153, 1, 1636422548770, 1636422549046, 276, 0, 276, 0, 0, 0
7154, 1, 1636422548810, 1636422549086, 276, 0, 276, 0, 0, 0
7156, 1, 1636422548990, 1636422549262, 272, 1, 271, 0, 1, 1
7157, 1, 1636422549074, 1636422549346, 272, 0, 272, 0, 0, 0
7159, 1, 1636422549334, 1636422549606, 272, 0, 272, 0, 0, 0
7160, 1, 1636422549582, 1636422549854, 272, 0, 272, 0, 0, 0
7163, 1, 1636422549866, 1636422550146, 280, 1, 279, 0, 0, 0
7073, 2, 1636422540414, 1636422550414, 10000, 0, 10000, 0, 0, 0
7166, 1, 1636422550670, 1636422550946, 276, 0, 276, 0, 0, 0
7078, 2, 1636422540966, 1636422550970, 10004, 0, 10004, 0, 0, 0
7167, 1, 1636422550722, 1636422551018, 296, 0, 296, 0, 0, 0
7168, 1, 1636422551274, 1636422551542, 268, 1, 267, 0, 1, 1
7084, 2, 1636422541550, 1636422551554, 10004, 0, 10004, 0, 0, 0
7169, 1, 1636422551434, 1636422551710, 276, 0, 276, 0, 0, 0
7170, 1, 1636422551478, 1636422551786, 308, 0, 308, 0, 0, 0
7171, 1, 1636422551854, 1636422552126, 272, 0, 272, 0, 0, 0
7172, 1, 1636422551990, 1636422552270, 280, 0, 280, 0, 0, 0
7174, 1, 1636422552278, 1636422552554, 276, 0, 276, 0, 0, 0
7175, 1, 1636422552578, 1636422552850, 272, 1, 271, 0, 1, 1
7097, 2, 1636422542902, 1636422552902, 10000, 0, 10000, 0, 0, 0
7102, 2, 1636422543302, 1636422553302, 10000, 0, 10000, 0, 0, 0
7177, 1, 1636422553094, 1636422553366, 272, 0, 272, 0, 0, 0
7108, 2, 1636422543714, 1636422553714, 10000, 0, 10000, 0, 0, 0
7109, 2, 1636422543826, 1636422553826, 10000, 0, 10000, 0, 0, 0
7180, 1, 1636422553610, 1636422553882, 272, 1, 271, 0, 1, 1
7181, 1, 1636422553914, 1636422554186, 272, 0, 272, 0, 0, 0
7182, 1, 1636422554022, 1636422554294, 272, 0, 272, 0, 0, 0
7114, 2, 1636422544338, 1636422554338, 10000, 0, 10000, 0, 0, 0
7183, 1, 1636422554134, 1636422554406, 272, 0, 272, 0, 0, 0
7184, 1, 1636422554326, 1636422554598, 272, 0, 272, 0, 0, 0
7185, 1, 1636422554646, 1636422554914, 268, 0, 268, 0, 0, 0
7186, 1, 1636422554690, 1636422554962, 272, 0, 272, 0, 0, 0
7187, 1, 1636422554738, 1636422555006, 268, 0, 268, 0, 0, 0
7188, 1, 1636422554842, 1636422555114, 272, 0, 272, 0, 0, 0
7189, 1, 1636422555122, 1636422555394, 272, 0, 272, 0, 0, 0
7190, 1, 1636422555366, 1636422555634, 268, 0, 268, 0, 0, 0
7127, 2, 1636422545674, 1636422555674, 10000, 0, 10000, 0, 0, 0
7191, 1, 1636422555490, 1636422555762, 272, 1, 271, 1, 0, 1
7193, 1, 1636422555638, 1636422555906, 268, 0, 268, 0, 0, 0
7131, 2, 1636422545990, 1636422555990, 10000, 0, 10000, 0, 0, 0
7194, 1, 1636422555934, 1636422556214, 280, 0, 280, 0, 0, 0
7133, 2, 1636422546250, 1636422556250, 10000, 0, 10000, 0, 0, 0
7195, 1, 1636422555982, 1636422556298, 316, 0, 316, 0, 0, 0
7197, 1, 1636422556298, 1636422556570, 272, 1, 271, 0, 1, 1
7198, 1, 1636422556298, 1636422556570, 272, 1, 271, 1, 0, 1
7199, 1, 1636422556450, 1636422556723, 273, 1, 272, 0, 1, 1
7138, 2, 1636422546794, 1636422556794, 10000, 0, 10000, 0, 0, 0
7200, 1, 1636422556558, 1636422556842, 284, 0, 284, 0, 0, 0
7201, 1, 1636422556698, 1636422556974, 276, 0, 276, 0, 0, 0
7203, 1, 1636422557002, 1636422557274, 272, 0, 272, 0, 0, 0
7204, 1, 1636422557106, 1636422557378, 272, 0, 272, 0, 0, 0
7205, 1, 1636422557110, 1636422557382, 272, 0, 272, 0, 0, 0
7143, 2, 1636422547422, 1636422557422, 10000, 0, 10000, 0, 0, 0
7207, 1, 1636422557278, 1636422557558, 280, 0, 280, 0, 0, 0
7209, 1, 1636422557722, 1636422557994, 272, 1, 271, 0, 1, 1
7210, 1, 1636422557798, 1636422558070, 272, 1, 271, 0, 0, 0
7211, 1, 1636422557826, 1636422558098, 272, 0, 272, 0, 0, 0
7212, 1, 1636422557906, 1636422558178, 272, 0, 272, 0, 0, 0
7213, 1, 1636422558090, 1636422558366, 276, 0, 276, 0, 0, 0
7214, 1, 1636422558450, 1636422558722, 272, 1, 271, 0, 0, 0
7215, 1, 1636422558618, 1636422558890, 272, 0, 272, 0, 0, 0
7216, 1, 1636422558634, 1636422558906, 272, 0, 272, 0, 0, 0
7155, 2, 1636422548990, 1636422558990, 10000, 0, 10000, 0, 0, 0
7218, 1, 1636422558878, 1636422559150, 272, 0, 272, 0, 0, 0
7158, 2, 1636422549254, 1636422559254, 10000, 0, 10000, 0, 0, 0
7219, 1, 1636422559298, 1636422559570, 272, 0, 272, 0, 0, 0
7220, 1, 1636422559302, 1636422559574, 272, 0, 272, 0, 0, 0
7161, 2, 1636422549622, 1636422559622, 10000, 0, 10000, 0, 0, 0
7222, 1, 1636422559422, 1636422559694, 272, 0, 272, 0, 0, 0
7162, 2, 1636422549786, 1636422559786, 10000, 0, 10000, 0, 0, 0
7223, 1, 1636422559562, 1636422559854, 292, 0, 292, 0, 0, 0
7224, 1, 1636422559670, 1636422559946, 276, 0, 276, 0, 0, 0
7164, 2, 1636422550154, 1636422560154, 10000, 0, 10000, 0, 0, 0
7225, 1, 1636422559962, 1636422560234, 272, 0, 272, 0, 0, 0
7226, 1, 1636422560014, 1636422560294, 280, 0, 280, 0, 0, 0
7228, 1, 1636422560058, 1636422560326, 268, 0, 268, 0, 0, 0
7165, 2, 1636422550378, 1636422560378, 10000, 0, 10000, 0, 0, 0
7227, 1, 1636422560094, 1636422560422, 328, 0, 328, 0, 0, 0
7229, 1, 1636422560242, 1636422560510, 268, 0, 268, 0, 0, 0
7230, 1, 1636422560286, 1636422560558, 272, 0, 272, 0, 0, 0
7231, 1, 1636422560466, 1636422560738, 272, 0, 272, 0, 0, 0
7232, 1, 1636422560466, 1636422560738, 272, 0, 272, 0, 0, 0
7234, 1, 1636422560650, 1636422560918, 268, 0, 268, 0, 0, 0
7233, 1, 1636422560682, 1636422560954, 272, 0, 272, 0, 0, 0
7236, 1, 1636422560822, 1636422561090, 268, 0, 268, 0, 0, 0
7235, 1, 1636422560850, 1636422561118, 268, 0, 268, 0, 0, 0
7237, 1, 1636422560850, 1636422561118, 268, 0, 268, 0, 0, 0
7238, 1, 1636422561010, 1636422561278, 268, 0, 268, 0, 0, 0
7239, 1, 1636422561070, 1636422561342, 272, 0, 272, 0, 0, 0
7240, 1, 1636422561182, 1636422561450, 268, 0, 268, 0, 0, 0
7241, 1, 1636422561270, 1636422561542, 272, 0, 272, 0, 0, 0
7242, 1, 1636422561398, 1636422561670, 272, 0, 272, 0, 0, 0
7243, 1, 1636422561462, 1636422561734, 272, 0, 272, 0, 0, 0
7244, 1, 1636422561598, 1636422561866, 268, 0, 268, 0, 0, 0
7246, 1, 1636422561634, 1636422561906, 272, 0, 272, 0, 0, 0
7247, 1, 1636422561822, 1636422562086, 264, 1, 263, 0, 1, 1
7245, 1, 1636422561610, 1636422562142, 532, 256, 276, 256, 0, 256
7248, 1, 1636422561882, 1636422562158, 276, 0, 276, 0, 0, 0
7173, 2, 1636422552254, 1636422562254, 10000, 0, 10000, 0, 0, 0
7249, 1, 1636422561994, 1636422562302, 308, 0, 308, 0, 0, 0
7250, 1, 1636422562066, 1636422562338, 272, 0, 272, 0, 0, 0
7251, 1, 1636422562194, 1636422562482, 288, 0, 288, 0, 0, 0
7253, 1, 1636422562410, 1636422562678, 268, 0, 268, 0, 0, 0
7254, 1, 1636422562454, 1636422562726, 272, 0, 272, 0, 0, 0
7252, 1, 1636422562250, 1636422562750, 500, 233, 267, 232, 1, 233
7176, 2, 1636422552802, 1636422562802, 10000, 0, 10000, 0, 0, 0
7256, 1, 1636422562570, 1636422562854, 284, 0, 284, 0, 0, 0
7257, 1, 1636422562606, 1636422562878, 272, 0, 272, 0, 0, 0
7259, 1, 1636422562790, 1636422563058, 268, 0, 268, 0, 0, 0
7260, 1, 1636422562890, 1636422563162, 272, 0, 272, 0, 0, 0
7178, 2, 1636422553210, 1636422563210, 10000, 0, 10000, 0, 0, 0
7261, 1, 1636422563010, 1636422563278, 268, 0, 268, 0, 0, 0
7262, 1, 1636422563110, 1636422563382, 272, 0, 272, 0, 0, 0
7179, 2, 1636422553394, 1636422563394, 10000, 0, 10000, 0, 0, 0
7265, 1, 1636422563254, 1636422563530, 276, 0, 276, 0, 0, 0
7266, 1, 1636422563298, 1636422563566, 268, 0, 268, 0, 0, 0
7267, 1, 1636422563438, 1636422563710, 272, 0, 272, 0, 0, 0
7269, 1, 1636422563582, 1636422563850, 268, 0, 268, 0, 0, 0
7271, 1, 1636422563674, 1636422563938, 264, 0, 264, 0, 0, 0
7270, 1, 1636422563698, 1636422563962, 264, 0, 264, 0, 0, 0
7273, 1, 1636422563826, 1636422564098, 272, 0, 272, 0, 0, 0
7274, 1, 1636422564058, 1636422564330, 272, 0, 272, 0, 0, 0
7275, 1, 1636422564090, 1636422564362, 272, 0, 272, 0, 0, 0
7276, 1, 1636422564218, 1636422564490, 272, 0, 272, 0, 0, 0
7277, 1, 1636422564366, 1636422564642, 276, 0, 276, 0, 0, 0
7278, 1, 1636422564422, 1636422564694, 272, 0, 272, 0, 0, 0
7279, 1, 1636422564458, 1636422564730, 272, 1, 271, 0, 0, 0
7280, 1, 1636422564638, 1636422564910, 272, 0, 272, 0, 0, 0
7281, 1, 1636422564850, 1636422565126, 276, 0, 276, 0, 0, 0
7282, 1, 1636422564874, 1636422565142, 268, 0, 268, 0, 0, 0
7283, 1, 1636422564998, 1636422565266, 268, 0, 268, 0, 0, 0
7284, 1, 1636422565182, 1636422565450, 268, 0, 268, 0, 0, 0
7285, 1, 1636422565242, 1636422565514, 272, 0, 272, 0, 0, 0
7286, 1, 1636422565266, 1636422565542, 276, 0, 276, 0, 0, 0
7192, 2, 1636422555554, 1636422565554, 10000, 0, 10000, 0, 0, 0
7287, 1, 1636422565430, 1636422565694, 264, 0, 264, 0, 0, 0
7288, 1, 1636422565642, 1636422565914, 272, 0, 272, 0, 0, 0
7289, 1, 1636422565686, 1636422565958, 272, 0, 272, 0, 0, 0
7290, 1, 1636422565802, 1636422566070, 268, 0, 268, 0, 0, 0
7291, 1, 1636422565866, 1636422566142, 276, 0, 276, 0, 0, 0
7196, 2, 1636422556170, 1636422566170, 10000, 0, 10000, 0, 0, 0
7292, 1, 1636422565970, 1636422566242, 272, 0, 272, 0, 0, 0
7293, 1, 1636422566026, 1636422566306, 280, 0, 280, 0, 0, 0
7294, 1, 1636422566070, 1636422566334, 264, 0, 264, 0, 0, 0
7295, 1, 1636422566214, 1636422566486, 272, 0, 272, 0, 0, 0
7297, 1, 1636422566442, 1636422566718, 276, 0, 276, 0, 0, 0
7202, 2, 1636422556722, 1636422566722, 10000, 0, 10000, 0, 0, 0
7298, 1, 1636422566454, 1636422566770, 316, 0, 316, 0, 0, 0
7296, 1, 1636422566478, 1636422566770, 292, 0, 292, 0, 0, 0
7299, 1, 1636422566578, 1636422566854, 276, 0, 276, 0, 0, 0
7300, 1, 1636422566618, 1636422566882, 264, 0, 264, 0, 0, 0
7301, 1, 1636422566814, 1636422567074, 260, 0, 260, 0, 0, 0
7302, 1, 1636422566814, 1636422567086, 272, 0, 272, 0, 0, 0
7303, 1, 1636422566870, 1636422567142, 272, 0, 272, 0, 0, 0
7206, 2, 1636422557234, 1636422567234, 10000, 0, 10000, 0, 0, 0
7305, 1, 1636422567014, 1636422567286, 272, 0, 272, 0, 0, 0
7304, 1, 1636422567026, 1636422567298, 272, 0, 272, 0, 0, 0
7306, 1, 1636422567194, 1636422567462, 268, 0, 268, 0, 0, 0
7208, 2, 1636422557514, 1636422567514, 10000, 0, 10000, 0, 0, 0
7308, 1, 1636422567282, 1636422567562, 280, 0, 280, 0, 0, 0
7307, 1, 1636422567282, 1636422567562, 280, 0, 280, 0, 0, 0
7309, 1, 1636422567394, 1636422567662, 268, 0, 268, 0, 0, 0
7310, 1, 1636422567422, 1636422567742, 320, 0, 320, 0, 0, 0
7311, 1, 1636422567562, 1636422567826, 264, 0, 264, 0, 0, 0
7312, 1, 1636422567610, 1636422567874, 264, 0, 264, 0, 0, 0
7313, 1, 1636422567602, 1636422567878, 276, 0, 276, 0, 0, 0
7315, 1, 1636422567758, 1636422568030, 272, 0, 272, 0, 0, 0
7317, 1, 1636422567818, 1636422568086, 268, 0, 268, 0, 0, 0
7314, 1, 1636422567670, 1636422568098, 428, 157, 271, 157, 0, 157
7316, 1, 1636422567826, 1636422568102, 276, 0, 276, 0, 0, 0
7318, 1, 1636422568010, 1636422568278, 268, 0, 268, 0, 0, 0
7319, 1, 1636422568062, 1636422568326, 264, 0, 264, 0, 0, 0
7320, 1, 1636422568066, 1636422568330, 264, 0, 264, 0, 0, 0
7321, 1, 1636422568178, 1636422568446, 268, 0, 268, 0, 0, 0
7322, 1, 1636422568214, 1636422568486, 272, 0, 272, 0, 0, 0
7323, 1, 1636422568254, 1636422568530, 276, 0, 276, 0, 0, 0
7324, 1, 1636422568374, 1636422568638, 264, 0, 264, 0, 0, 0
7325, 1, 1636422568418, 1636422568686, 268, 0, 268, 0, 0, 0
7217, 2, 1636422558702, 1636422568702, 10000, 0, 10000, 0, 0, 0
7327, 1, 1636422568542, 1636422568838, 296, 0, 296, 0, 0, 0
7329, 1, 1636422568606, 1636422568874, 268, 0, 268, 0, 0, 0
7330, 1, 1636422568794, 1636422569070, 276, 0, 276, 0, 0, 0
7331, 1, 1636422568858, 1636422569130, 272, 0, 272, 0, 0, 0
7332, 1, 1636422568870, 1636422569146, 276, 0, 276, 0, 0, 0
7334, 1, 1636422568974, 1636422569246, 272, 0, 272, 0, 0, 0
7333, 1, 1636422569010, 1636422569286, 276, 0, 276, 0, 0, 0
7221, 2, 1636422559398, 1636422569398, 10000, 0, 10000, 0, 0, 0
7337, 1, 1636422569202, 1636422569470, 268, 0, 268, 0, 0, 0
7338, 1, 1636422569210, 1636422569478, 268, 0, 268, 0, 0, 0
7339, 1, 1636422569350, 1636422569626, 276, 1, 275, 0, 0, 0
7340, 1, 1636422569446, 1636422569722, 276, 0, 276, 0, 0, 0
7341, 1, 1636422569586, 1636422569854, 268, 0, 268, 0, 0, 0
7343, 1, 1636422569658, 1636422569926, 268, 0, 268, 0, 0, 0
7344, 1, 1636422569702, 1636422569974, 272, 0, 272, 0, 0, 0
7345, 1, 1636422569722, 1636422569994, 272, 0, 272, 0, 0, 0
7346, 1, 1636422569754, 1636422570026, 272, 0, 272, 0, 0, 0
7347, 1, 1636422570002, 1636422570278, 276, 0, 276, 0, 0, 0
7348, 1, 1636422570018, 1636422570282, 264, 0, 264, 0, 0, 0
7349, 1, 1636422570138, 1636422570410, 272, 0, 272, 0, 0, 0
7350, 1, 1636422570202, 1636422570478, 276, 0, 276, 0, 0, 0
7351, 1, 1636422570370, 1636422570646, 276, 0, 276, 0, 0, 0
7352, 1, 1636422570430, 1636422570698, 268, 0, 268, 0, 0, 0
7353, 1, 1636422570446, 1636422570718, 272, 0, 272, 0, 0, 0
7354, 1, 1636422570506, 1636422570778, 272, 0, 272, 0, 0, 0
7355, 1, 1636422570566, 1636422570834, 268, 0, 268, 0, 0, 0
7356, 1, 1636422570798, 1636422571070, 272, 0, 272, 0, 0, 0
7357, 1, 1636422570810, 1636422571078, 268, 0, 268, 0, 0, 0
7358, 1, 1636422570930, 1636422571202, 272, 0, 272, 0, 0, 0
7359, 1, 1636422570986, 1636422571262, 276, 0, 276, 0, 0, 0
7360, 1, 1636422571186, 1636422571462, 276, 0, 276, 0, 0, 0
7362, 1, 1636422571246, 1636422571518, 272, 0, 272, 0, 0, 0
7363, 1, 1636422571306, 1636422571578, 272, 0, 272, 0, 0, 0
7364, 1, 1636422571362, 1636422571634, 272, 0, 272, 0, 0, 0
7365, 1, 1636422571598, 1636422571870, 272, 0, 272, 0, 0, 0
7366, 1, 1636422571610, 1636422571882, 272, 0, 272, 0, 0, 0
7367, 1, 1636422571714, 1636422571986, 272, 0, 272, 0, 0, 0
7368, 1, 1636422571790, 1636422572062, 272, 0, 272, 0, 0, 0
7369, 1, 1636422571978, 1636422572246, 268, 0, 268, 0, 0, 0
7370, 1, 1636422572046, 1636422572318, 272, 0, 272, 0, 0, 0
7371, 1, 1636422572102, 1636422572374, 272, 0, 272, 0, 0, 0
7372, 1, 1636422572174, 1636422572446, 272, 0, 272, 0, 0, 0
7255, 2, 1636422562546, 1636422572546, 10000, 0, 10000, 0, 0, 0
7258, 2, 1636422562670, 1636422572670, 10000, 0, 10000, 0, 0, 0
7374, 1, 1636422572414, 1636422572714, 300, 0, 300, 0, 0, 0
7375, 1, 1636422572530, 1636422572806, 276, 0, 276, 0, 0, 0
7376, 1, 1636422572590, 1636422572894, 304, 0, 304, 0, 0, 0
7377, 1, 1636422572802, 1636422573066, 264, 0, 264, 0, 0, 0
7379, 1, 1636422572846, 1636422573118, 272, 0, 272, 0, 0, 0
7263, 2, 1636422563146, 1636422573146, 10000, 0, 10000, 0, 0, 0
7380, 1, 1636422572890, 1636422573194, 304, 0, 304, 0, 0, 0
7264, 2, 1636422563194, 1636422573194, 10000, 0, 10000, 0, 0, 0
7382, 1, 1636422572958, 1636422573242, 284, 0, 284, 0, 0, 0
7381, 1, 1636422572970, 1636422573282, 312, 0, 312, 0, 0, 0
7383, 1, 1636422573238, 1636422573502, 264, 0, 264, 0, 0, 0
7268, 2, 1636422563518, 1636422573518, 10000, 0, 10000, 0, 0, 0
7384, 1, 1636422573326, 1636422573598, 272, 0, 272, 0, 0, 0
7385, 1, 1636422573402, 1636422573670, 268, 0, 268, 0, 0, 0
7387, 1, 1636422573502, 1636422573766, 264, 0, 264, 0, 0, 0
7272, 2, 1636422563794, 1636422573794, 10000, 0, 10000, 0, 0, 0
7388, 1, 1636422573610, 1636422573878, 268, 0, 268, 0, 0, 0
7391, 1, 1636422573698, 1636422573970, 272, 0, 272, 0, 0, 0
7392, 1, 1636422573754, 1636422574022, 268, 0, 268, 0, 0, 0
7390, 1, 1636422573734, 1636422574022, 288, 0, 288, 0, 0, 0
7389, 1, 1636422573654, 1636422574038, 384, 112, 272, 112, 0, 112
7393, 1, 1636422573838, 1636422574106, 268, 0, 268, 0, 0, 0
7394, 1, 1636422574038, 1636422574314, 276, 1, 275, 0, 0, 0
7395, 1, 1636422574106, 1636422574378, 272, 0, 272, 0, 0, 0
7396, 1, 1636422574142, 1636422574410, 268, 1, 267, 0, 0, 0
7398, 1, 1636422574222, 1636422574494, 272, 0, 272, 0, 0, 0
7399, 1, 1636422574378, 1636422574646, 268, 0, 268, 0, 0, 0
7397, 1, 1636422574210, 1636422574650, 440, 169, 271, 168, 1, 169
7402, 1, 1636422574502, 1636422574774, 272, 0, 272, 0, 0, 0
7403, 1, 1636422574538, 1636422574806, 268, 0, 268, 0, 0, 0
7404, 1, 1636422574558, 1636422574834, 276, 0, 276, 0, 0, 0
7405, 1, 1636422574818, 1636422575090, 272, 0, 272, 0, 0, 0
7406, 1, 1636422574838, 1636422575110, 272, 0, 272, 0, 0, 0
7407, 1, 1636422574926, 1636422575202, 276, 0, 276, 0, 0, 0
7408, 1, 1636422575046, 1636422575318, 272, 0, 272, 0, 0, 0
7410, 1, 1636422575178, 1636422575450, 272, 0, 272, 0, 0, 0
7411, 1, 1636422575302, 1636422575574, 272, 0, 272, 0, 0, 0
7412, 1, 1636422575334, 1636422575606, 272, 0, 272, 0, 0, 0
7413, 1, 1636422575366, 1636422575638, 272, 0, 272, 0, 0, 0
7416, 1, 1636422575722, 1636422575998, 276, 0, 276, 0, 0, 0
7417, 1, 1636422575814, 1636422576086, 272, 1, 271, 0, 1, 1
7418, 1, 1636422575982, 1636422576254, 272, 0, 272, 0, 0, 0
7419, 1, 1636422576106, 1636422576378, 272, 0, 272, 0, 0, 0
7420, 1, 1636422576146, 1636422576414, 268, 0, 268, 0, 0, 0
7421, 1, 1636422576178, 1636422576446, 268, 0, 268, 0, 0, 0
7422, 1, 1636422576526, 1636422576798, 272, 1, 271, 0, 0, 0
7423, 1, 1636422576606, 1636422576882, 276, 0, 276, 0, 0, 0
7424, 1, 1636422576790, 1636422577062, 272, 0, 272, 0, 0, 0
7425, 1, 1636422576922, 1636422577190, 268, 0, 268, 0, 0, 0
7427, 1, 1636422576970, 1636422577238, 268, 0, 268, 0, 0, 0
7428, 1, 1636422577326, 1636422577598, 272, 0, 272, 0, 0, 0
7429, 1, 1636422577394, 1636422577666, 272, 0, 272, 0, 0, 0
7430, 1, 1636422577590, 1636422577862, 272, 0, 272, 0, 0, 0
7431, 1, 1636422577718, 1636422577990, 272, 0, 272, 0, 0, 0
7433, 1, 1636422578138, 1636422578410, 272, 1, 271, 1, 0, 1
7434, 1, 1636422578190, 1636422578462, 272, 0, 272, 0, 0, 0
7326, 2, 1636422568514, 1636422578514, 10000, 0, 10000, 0, 0, 0
7328, 2, 1636422568570, 1636422578570, 10000, 0, 10000, 0, 0, 0
7436, 1, 1636422578558, 1636422578830, 272, 0, 272, 0, 0, 0
7335, 2, 1636422569010, 1636422579010, 10000, 0, 10000, 0, 0, 0
7336, 2, 1636422569070, 1636422579070, 10000, 0, 10000, 0, 0, 0
7438, 1, 1636422578870, 1636422579146, 276, 0, 276, 0, 0, 0
7437, 1, 1636422578834, 1636422579146, 312, 0, 312, 0, 0, 0
7439, 1, 1636422578938, 1636422579238, 300, 0, 300, 0, 0, 0
7440, 1, 1636422578998, 1636422579302, 304, 0, 304, 0, 0, 0
7441, 1, 1636422579334, 1636422579606, 272, 0, 272, 0, 0, 0
7442, 1, 1636422579330, 1636422579606, 276, 0, 276, 0, 0, 0
7443, 1, 1636422579378, 1636422579646, 268, 0, 268, 0, 0, 0
7342, 2, 1636422569654, 1636422579654, 10000, 0, 10000, 0, 0, 0
7444, 1, 1636422579546, 1636422579822, 276, 0, 276, 0, 0, 0
7447, 1, 1636422579798, 1636422580074, 276, 0, 276, 0, 0, 0
7445, 1, 1636422579598, 1636422580090, 492, 225, 267, 225, 0, 225
7448, 1, 1636422579962, 1636422580238, 276, 0, 276, 0, 0, 0
7449, 1, 1636422580042, 1636422580362, 320, 49, 271, 49, 0, 49
7451, 1, 1636422580114, 1636422580382, 268, 0, 268, 0, 0, 0
7452, 1, 1636422580330, 1636422580602, 272, 0, 272, 0, 0, 0
7450, 1, 1636422580098, 1636422580630, 532, 265, 267, 265, 0, 265
7453, 1, 1636422580482, 1636422580754, 272, 1, 271, 0, 0, 0
7454, 1, 1636422580606, 1636422580878, 272, 0, 272, 0, 0, 0
7455, 1, 1636422580674, 1636422580942, 268, 0, 268, 0, 0, 0
7456, 1, 1636422580842, 1636422581114, 272, 0, 272, 0, 0, 0
7457, 1, 1636422580914, 1636422581186, 272, 0, 272, 0, 0, 0
7361, 2, 1636422571246, 1636422581246, 10000, 0, 10000, 0, 0, 0
7458, 1, 1636422581030, 1636422581302, 272, 0, 272, 0, 0, 0
7459, 1, 1636422581126, 1636422581398, 272, 0, 272, 0, 0, 0
7460, 1, 1636422581234, 1636422581506, 272, 0, 272, 0, 0, 0
7461, 1, 1636422581406, 1636422581678, 272, 0, 272, 0, 0, 0
7462, 1, 1636422581458, 1636422581726, 268, 0, 268, 0, 0, 0
7463, 1, 1636422581550, 1636422581818, 268, 0, 268, 0, 0, 0
7464, 1, 1636422581638, 1636422581910, 272, 0, 272, 0, 0, 0
7465, 1, 1636422581698, 1636422581974, 276, 0, 276, 0, 0, 0
7466, 1, 1636422581786, 1636422582058, 272, 0, 272, 0, 0, 0
7467, 1, 1636422581938, 1636422582210, 272, 0, 272, 0, 0, 0
7373, 2, 1636422572394, 1636422582394, 10000, 0, 10000, 0, 0, 0
7469, 1, 1636422582206, 1636422582474, 268, 0, 268, 0, 0, 0
7470, 1, 1636422582242, 1636422582526, 284, 0, 284, 0, 0, 0
7471, 1, 1636422582278, 1636422582550, 272, 0, 272, 0, 0, 0
7472, 1, 1636422582482, 1636422582766, 284, 0, 284, 0, 0, 0
7473, 1, 1636422582526, 1636422582802, 276, 0, 276, 0, 0, 0
7378, 2, 1636422572866, 1636422582866, 10000, 0, 10000, 0, 0, 0
7476, 1, 1636422582726, 1636422583002, 276, 0, 276, 0, 0, 0
7475, 1, 1636422582698, 1636422583002, 304, 0, 304, 0, 0, 0
7477, 1, 1636422583010, 1636422583278, 268, 0, 268, 0, 0, 0
7478, 1, 1636422583050, 1636422583318, 268, 0, 268, 0, 0, 0
7479, 1, 1636422583094, 1636422583366, 272, 0, 272, 0, 0, 0
7480, 1, 1636422583174, 1636422583442, 268, 0, 268, 0, 0, 0
7386, 2, 1636422573458, 1636422583458, 10000, 0, 10000, 0, 0, 0
7481, 1, 1636422583246, 1636422583518, 272, 0, 272, 0, 0, 0
7482, 1, 1636422583286, 1636422583590, 304, 0, 304, 0, 0, 0
7483, 1, 1636422583418, 1636422583690, 272, 0, 272, 0, 0, 0
7484, 1, 1636422583546, 1636422583818, 272, 0, 272, 0, 0, 0
7485, 1, 1636422583762, 1636422584038, 276, 1, 275, 0, 0, 0
7486, 1, 1636422583826, 1636422584098, 272, 0, 272, 0, 0, 0
7487, 1, 1636422583842, 1636422584110, 268, 0, 268, 0, 0, 0
7488, 1, 1636422583878, 1636422584146, 268, 0, 268, 0, 0, 0
7489, 1, 1636422583882, 1636422584150, 268, 0, 268, 0, 0, 0
7490, 1, 1636422584062, 1636422584330, 268, 0, 268, 0, 0, 0
7491, 1, 1636422584078, 1636422584346, 268, 0, 268, 0, 0, 0
7400, 2, 1636422574446, 1636422584446, 10000, 0, 10000, 0, 0, 0
7401, 2, 1636422574494, 1636422584494, 10000, 0, 10000, 0, 0, 0
7492, 1, 1636422584202, 1636422584494, 292, 0, 292, 0, 0, 0
7493, 1, 1636422584346, 1636422584630, 284, 0, 284, 0, 0, 0
7494, 1, 1636422584490, 1636422584762, 272, 0, 272, 0, 0, 0
7495, 1, 1636422584626, 1636422584898, 272, 0, 272, 0, 0, 0
7496, 1, 1636422584658, 1636422584930, 272, 0, 272, 0, 0, 0
7497, 1, 1636422584670, 1636422584938, 268, 0, 268, 0, 0, 0
7498, 1, 1636422584690, 1636422584962, 272, 0, 272, 0, 0, 0
7499, 1, 1636422584762, 1636422585034, 272, 0, 272, 0, 0, 0
7409, 2, 1636422575038, 1636422585038, 10000, 0, 10000, 0, 0, 0
7500, 1, 1636422584794, 1636422585086, 292, 0, 292, 0, 0, 0
7502, 1, 1636422584870, 1636422585174, 304, 0, 304, 0, 0, 0
7501, 1, 1636422584862, 1636422585178, 316, 0, 316, 0, 0, 0
7503, 1, 1636422585002, 1636422585270, 268, 0, 268, 0, 0, 0
7504, 1, 1636422585130, 1636422585394, 264, 0, 264, 0, 0, 0
7505, 1, 1636422585294, 1636422585574, 280, 0, 280, 0, 0, 0
7506, 1, 1636422585350, 1636422585626, 276, 0, 276, 0, 0, 0
7415, 2, 1636422575634, 1636422585634, 10000, 0, 10000, 0, 0, 0
7414, 2, 1636422575634, 1636422585682, 10048, 0, 10048, 0, 0, 0
7507, 1, 1636422585438, 1636422585730, 292, 0, 292, 0, 0, 0
7511, 1, 1636422585482, 1636422585818, 336, 0, 336, 0, 0, 0
7510, 1, 1636422585470, 1636422585818, 348, 0, 348, 0, 0, 0
7509, 1, 1636422585462, 1636422585822, 360, 0, 360, 0, 0, 0
7508, 1, 1636422585454, 1636422585822, 368, 0, 368, 0, 0, 0
7513, 1, 1636422585730, 1636422585998, 268, 0, 268, 0, 0, 0
7514, 1, 1636422585730, 1636422586010, 280, 1, 279, 0, 1, 1
7515, 1, 1636422585814, 1636422586086, 272, 0, 272, 0, 0, 0
7512, 1, 1636422585522, 1636422586090, 568, 297, 271, 297, 0, 297
7516, 1, 1636422585946, 1636422586218, 272, 0, 272, 0, 0, 0
7518, 1, 1636422585950, 1636422586222, 272, 0, 272, 0, 0, 0
7517, 1, 1636422585950, 1636422586222, 272, 0, 272, 0, 0, 0
7519, 1, 1636422586070, 1636422586362, 292, 20, 272, 20, 0, 20
7520, 1, 1636422586090, 1636422586362, 272, 0, 272, 0, 0, 0
7521, 1, 1636422586222, 1636422586486, 264, 0, 264, 0, 0, 0
7522, 1, 1636422586258, 1636422586530, 272, 0, 272, 0, 0, 0
7523, 1, 1636422586262, 1636422586530, 268, 0, 268, 0, 0, 0
7524, 1, 1636422586270, 1636422586538, 268, 0, 268, 0, 0, 0
7527, 1, 1636422586458, 1636422586730, 272, 0, 272, 0, 0, 0
7526, 1, 1636422586486, 1636422586758, 272, 0, 272, 0, 0, 0
7525, 1, 1636422586286, 1636422586802, 516, 245, 271, 244, 1, 245
7529, 1, 1636422586598, 1636422586874, 276, 0, 276, 0, 0, 0
7426, 2, 1636422576930, 1636422586930, 10000, 0, 10000, 0, 0, 0
7530, 1, 1636422586658, 1636422586974, 316, 0, 316, 0, 0, 0
7532, 1, 1636422586758, 1636422587070, 312, 0, 312, 0, 0, 0
7533, 1, 1636422586874, 1636422587158, 284, 0, 284, 0, 0, 0
7534, 1, 1636422586902, 1636422587166, 264, 0, 264, 0, 0, 0
7531, 1, 1636422586666, 1636422587246, 580, 308, 272, 308, 0, 308
7535, 1, 1636422587018, 1636422587286, 268, 0, 268, 0, 0, 0
7537, 1, 1636422587062, 1636422587334, 272, 0, 272, 0, 0, 0
7536, 1, 1636422587062, 1636422587334, 272, 0, 272, 0, 0, 0
7538, 1, 1636422587074, 1636422587342, 268, 0, 268, 0, 0, 0
7539, 1, 1636422587202, 1636422587466, 264, 0, 264, 0, 0, 0
7541, 1, 1636422587242, 1636422587510, 268, 0, 268, 0, 0, 0
7540, 1, 1636422587238, 1636422587510, 272, 0, 272, 0, 0, 0
7542, 1, 1636422587278, 1636422587546, 268, 0, 268, 0, 0, 0
7543, 1, 1636422587414, 1636422587690, 276, 0, 276, 0, 0, 0
7544, 1, 1636422587454, 1636422587726, 272, 0, 272, 0, 0, 0
7432, 2, 1636422577762, 1636422587762, 10000, 0, 10000, 0, 0, 0
7545, 1, 1636422587558, 1636422587834, 276, 0, 276, 0, 0, 0
7546, 1, 1636422587642, 1636422587910, 268, 0, 268, 0, 0, 0
7547, 1, 1636422587658, 1636422587930, 272, 0, 272, 0, 0, 0
7548, 1, 1636422587702, 1636422587990, 288, 0, 288, 0, 0, 0
7549, 1, 1636422587810, 1636422588082, 272, 0, 272, 0, 0, 0
7552, 1, 1636422587858, 1636422588130, 272, 0, 272, 0, 0, 0
7550, 1, 1636422587894, 1636422588166, 272, 0, 272, 0, 0, 0
7551, 1, 1636422587898, 1636422588170, 272, 0, 272, 0, 0, 0
7553, 1, 1636422587950, 1636422588218, 268, 0, 268, 0, 0, 0
7554, 1, 1636422587966, 1636422588238, 272, 0, 272, 0, 0, 0
7555, 1, 1636422588070, 1636422588346, 276, 1, 275, 0, 1, 1
7557, 1, 1636422588070, 1636422588346, 276, 1, 275, 1, 0, 1
7435, 2, 1636422578386, 1636422588386, 10000, 0, 10000, 0, 0, 0
7558, 1, 1636422588218, 1636422588522, 304, 0, 304, 0, 0, 0
7559, 1, 1636422588250, 1636422588522, 272, 0, 272, 0, 0, 0
7560, 1, 1636422588374, 1636422588650, 276, 0, 276, 0, 0, 0
7561, 1, 1636422588434, 1636422588702, 268, 0, 268, 0, 0, 0
7562, 1, 1636422588478, 1636422588746, 268, 0, 268, 0, 0, 0
7563, 1, 1636422588518, 1636422588786, 268, 0, 268, 0, 0, 0
7564, 1, 1636422588586, 1636422588858, 272, 0, 272, 0, 0, 0
7566, 1, 1636422588654, 1636422588922, 268, 0, 268, 0, 0, 0
7567, 1, 1636422588658, 1636422588930, 272, 0, 272, 0, 0, 0
7568, 1, 1636422588686, 1636422588954, 268, 0, 268, 0, 0, 0
7565, 1, 1636422588698, 1636422588970, 272, 0, 272, 0, 0, 0
7570, 1, 1636422588770, 1636422589038, 268, 0, 268, 0, 0, 0
7571, 1, 1636422588778, 1636422589046, 268, 0, 268, 0, 0, 0
7572, 1, 1636422588890, 1636422589158, 268, 0, 268, 0, 0, 0
7573, 1, 1636422589010, 1636422589278, 268, 0, 268, 0, 0, 0
7574, 1, 1636422589062, 1636422589334, 272, 0, 272, 0, 0, 0
7575, 1, 1636422589170, 1636422589442, 272, 0, 272, 0, 0, 0
7577, 1, 1636422589250, 1636422589526, 276, 0, 276, 0, 0, 0
7578, 1, 1636422589302, 1636422589578, 276, 0, 276, 0, 0, 0
7579, 1, 1636422589378, 1636422589650, 272, 0, 272, 0, 0, 0
7580, 1, 1636422589402, 1636422589670, 268, 0, 268, 0, 0, 0
7581, 1, 1636422589438, 1636422589710, 272, 0, 272, 0, 0, 0
7582, 1, 1636422589470, 1636422589742, 272, 0, 272, 0, 0, 0
7446, 2, 1636422579746, 1636422589746, 10000, 0, 10000, 0, 0, 0
7583, 1, 1636422589502, 1636422589794, 292, 0, 292, 0, 0, 0
7585, 1, 1636422589586, 1636422589882, 296, 0, 296, 0, 0, 0
7584, 1, 1636422589566, 1636422589882, 316, 0, 316, 0, 0, 0
7586, 1, 1636422589682, 1636422589974, 292, 0, 292, 0, 0, 0
7587, 1, 1636422589838, 1636422590102, 264, 0, 264, 0, 0, 0
7588, 1, 1636422589878, 1636422590150, 272, 0, 272, 0, 0, 0
7589, 1, 1636422589958, 1636422590234, 276, 0, 276, 0, 0, 0
7590, 1, 1636422590054, 1636422590322, 268, 0, 268, 0, 0, 0
7591, 1, 1636422590062, 1636422590334, 272, 0, 272, 0, 0, 0
7592, 1, 1636422590098, 1636422590378, 280, 0, 280, 0, 0, 0
7593, 1, 1636422590170, 1636422590438, 268, 0, 268, 0, 0, 0
7594, 1, 1636422590190, 1636422590458, 268, 0, 268, 0, 0, 0
7595, 1, 1636422590242, 1636422590510, 268, 0, 268, 0, 0, 0
7596, 1, 1636422590270, 1636422590542, 272, 0, 272, 0, 0, 0
7597, 1, 1636422590290, 1636422590558, 268, 0, 268, 0, 0, 0
7598, 1, 1636422590362, 1636422590634, 272, 0, 272, 0, 0, 0
7599, 1, 1636422590390, 1636422590662, 272, 0, 272, 0, 0, 0
7600, 1, 1636422590478, 1636422590750, 272, 1, 271, 0, 0, 0
7601, 1, 1636422590618, 1636422590894, 276, 0, 276, 0, 0, 0
7602, 1, 1636422590654, 1636422590926, 272, 0, 272, 0, 0, 0
7603, 1, 1636422590758, 1636422591030, 272, 0, 272, 0, 0, 0
7604, 1, 1636422590766, 1636422591034, 268, 0, 268, 0, 0, 0
7605, 1, 1636422590854, 1636422591114, 260, 0, 260, 0, 0, 0
7606, 1, 1636422590902, 1636422591166, 264, 0, 264, 0, 0, 0
7607, 1, 1636422590962, 1636422591230, 268, 0, 268, 0, 0, 0
7608, 1, 1636422590990, 1636422591254, 264, 0, 264, 0, 0, 0
7609, 1, 1636422591046, 1636422591318, 272, 0, 272, 0, 0, 0
7610, 1, 1636422591066, 1636422591342, 276, 0, 276, 0, 0, 0
7611, 1, 1636422591074, 1636422591342, 268, 0, 268, 0, 0, 0
7612, 1, 1636422591174, 1636422591446, 272, 0, 272, 0, 0, 0
7613, 1, 1636422591202, 1636422591470, 268, 0, 268, 0, 0, 0
7614, 1, 1636422591262, 1636422591534, 272, 0, 272, 0, 0, 0
7615, 1, 1636422591418, 1636422591686, 268, 0, 268, 0, 0, 0
7616, 1, 1636422591458, 1636422591730, 272, 0, 272, 0, 0, 0
7617, 1, 1636422591542, 1636422591806, 264, 0, 264, 0, 0, 0
7618, 1, 1636422591550, 1636422591818, 268, 0, 268, 0, 0, 0
7619, 1, 1636422591662, 1636422591930, 268, 0, 268, 0, 0, 0
7620, 1, 1636422591698, 1636422591974, 276, 0, 276, 0, 0, 0
7468, 2, 1636422582022, 1636422592022, 10000, 0, 10000, 0, 0, 0
7621, 1, 1636422591750, 1636422592070, 320, 0, 320, 0, 0, 0
7622, 1, 1636422591806, 1636422592082, 276, 0, 276, 0, 0, 0
7625, 1, 1636422591882, 1636422592158, 276, 0, 276, 0, 0, 0
7624, 1, 1636422591874, 1636422592158, 284, 0, 284, 0, 0, 0
7623, 1, 1636422591842, 1636422592158, 316, 0, 316, 0, 0, 0
7626, 1, 1636422591962, 1636422592250, 288, 0, 288, 0, 0, 0
7627, 1, 1636422592010, 1636422592282, 272, 0, 272, 0, 0, 0
7628, 1, 1636422592066, 1636422592334, 268, 0, 268, 0, 0, 0
7629, 1, 1636422592230, 1636422592498, 268, 1, 267, 0, 0, 0
7630, 1, 1636422592254, 1636422592522, 268, 0, 268, 0, 0, 0
7474, 2, 1636422582566, 1636422592566, 10000, 0, 10000, 0, 0, 0
7634, 1, 1636422592446, 1636422592718, 272, 0, 272, 0, 0, 0
7636, 1, 1636422592546, 1636422592818, 272, 0, 272, 0, 0, 0
7637, 1, 1636422592614, 1636422592886, 272, 0, 272, 0, 0, 0
7638, 1, 1636422592658, 1636422592934, 276, 0, 276, 0, 0, 0
7640, 1, 1636422592702, 1636422592974, 272, 0, 272, 0, 0, 0
7639, 1, 1636422592702, 1636422592982, 280, 0, 280, 0, 0, 0
7641, 1, 1636422592778, 1636422593054, 276, 0, 276, 0, 0, 0
7642, 1, 1636422592818, 1636422593090, 272, 0, 272, 0, 0, 0
7645, 1, 1636422593026, 1636422593294, 268, 0, 268, 0, 0, 0
7646, 1, 1636422593058, 1636422593326, 268, 0, 268, 0, 0, 0
7647, 1, 1636422593230, 1636422593510, 280, 0, 280, 0, 0, 0
7649, 1, 1636422593402, 1636422593674, 272, 0, 272, 0, 0, 0
7652, 1, 1636422593478, 1636422593750, 272, 0, 272, 0, 0, 0
7653, 1, 1636422593578, 1636422593850, 272, 0, 272, 0, 0, 0
7654, 1, 1636422593606, 1636422593878, 272, 0, 272, 0, 0, 0
7655, 1, 1636422593806, 1636422594078, 272, 0, 272, 0, 0, 0
7656, 1, 1636422593874, 1636422594146, 272, 0, 272, 0, 0, 0
7657, 1, 1636422594038, 1636422594310, 272, 0, 272, 0, 0, 0
7658, 1, 1636422594202, 1636422594470, 268, 0, 268, 0, 0, 0
7659, 1, 1636422594294, 1636422594566, 272, 0, 272, 0, 0, 0
7660, 1, 1636422594378, 1636422594650, 272, 0, 272, 0, 0, 0
7661, 1, 1636422594394, 1636422594666, 272, 0, 272, 0, 0, 0
7662, 1, 1636422594590, 1636422594866, 276, 0, 276, 0, 0, 0
7663, 1, 1636422594670, 1636422594942, 272, 0, 272, 0, 0, 0
7664, 1, 1636422594834, 1636422595110, 276, 1, 275, 0, 0, 0
7665, 1, 1636422594986, 1636422595258, 272, 0, 272, 0, 0, 0
7666, 1, 1636422595086, 1636422595358, 272, 0, 272, 0, 0, 0
7667, 1, 1636422595182, 1636422595450, 268, 0, 268, 0, 0, 0
7669, 1, 1636422595378, 1636422595646, 268, 1, 267, 0, 0, 0
7670, 1, 1636422595486, 1636422595758, 272, 1, 271, 0, 1, 1
7671, 1, 1636422595646, 1636422595914, 268, 0, 268, 0, 0, 0
7672, 1, 1636422595790, 1636422596062, 272, 0, 272, 0, 0, 0
7673, 1, 1636422595870, 1636422596142, 272, 0, 272, 0, 0, 0
7674, 1, 1636422595994, 1636422596266, 272, 0, 272, 0, 0, 0
7528, 2, 1636422586462, 1636422596462, 10000, 0, 10000, 0, 0, 0
7676, 1, 1636422596274, 1636422596546, 272, 0, 272, 0, 0, 0
7677, 1, 1636422596446, 1636422596718, 272, 1, 271, 0, 0, 0
7678, 1, 1636422596610, 1636422596886, 276, 0, 276, 0, 0, 0
7679, 1, 1636422596666, 1636422596938, 272, 0, 272, 0, 0, 0
7680, 1, 1636422596774, 1636422597042, 268, 0, 268, 0, 0, 0
7681, 1, 1636422596794, 1636422597066, 272, 0, 272, 0, 0, 0
7682, 1, 1636422597058, 1636422597326, 268, 0, 268, 0, 0, 0
7684, 1, 1636422597402, 1636422597670, 268, 0, 268, 0, 0, 0
7685, 1, 1636422597450, 1636422597722, 272, 0, 272, 0, 0, 0
7686, 1, 1636422597494, 1636422597762, 268, 0, 268, 0, 0, 0
7687, 1, 1636422597610, 1636422597882, 272, 0, 272, 0, 0, 0
7556, 2, 1636422588038, 1636422598038, 10000, 0, 10000, 0, 0, 0
7688, 1, 1636422597854, 1636422598122, 268, 0, 268, 0, 0, 0
7689, 1, 1636422598218, 1636422598490, 272, 0, 272, 0, 0, 0
7691, 1, 1636422598282, 1636422598554, 272, 0, 272, 0, 0, 0
7693, 1, 1636422598398, 1636422598670, 272, 0, 272, 0, 0, 0
7569, 2, 1636422588754, 1636422598754, 10000, 0, 10000, 0, 0, 0
7694, 1, 1636422598642, 1636422598914, 272, 0, 272, 0, 0, 0
7576, 2, 1636422589186, 1636422599186, 10000, 0, 10000, 0, 0, 0
7695, 1, 1636422599014, 1636422599322, 308, 0, 308, 0, 0, 0
7696, 1, 1636422599062, 1636422599330, 268, 0, 268, 0, 0, 0
7697, 1, 1636422599086, 1636422599354, 268, 0, 268, 0, 0, 0
7698, 1, 1636422599182, 1636422599454, 272, 0, 272, 0, 0, 0
7701, 1, 1636422599782, 1636422600058, 276, 1, 275, 0, 1, 1
7702, 1, 1636422599810, 1636422600082, 272, 0, 272, 0, 0, 0
7703, 1, 1636422599898, 1636422600166, 268, 0, 268, 0, 0, 0
7704, 1, 1636422599978, 1636422600246, 268, 0, 268, 0, 0, 0
7705, 1, 1636422600586, 1636422600858, 272, 0, 272, 0, 0, 0
7706, 1, 1636422600606, 1636422600878, 272, 1, 271, 0, 0, 0
7707, 1, 1636422600690, 1636422600962, 272, 0, 272, 0, 0, 0
7708, 1, 1636422600766, 1636422601038, 272, 0, 272, 0, 0, 0
7709, 1, 1636422601374, 1636422601646, 272, 0, 272, 0, 0, 0
7710, 1, 1636422601394, 1636422601666, 272, 1, 271, 0, 0, 0
7711, 1, 1636422601490, 1636422601758, 268, 0, 268, 0, 0, 0
7631, 2, 1636422592326, 1636422602326, 10000, 0, 10000, 0, 0, 0
7633, 2, 1636422592346, 1636422602370, 10024, 0, 10024, 0, 0, 0
7632, 2, 1636422592346, 1636422602414, 10068, 0, 10068, 0, 0, 0
7635, 2, 1636422592498, 1636422602498, 10000, 0, 10000, 0, 0, 0
7713, 1, 1636422602166, 1636422602554, 388, 0, 388, 0, 0, 0
7715, 1, 1636422602282, 1636422602638, 356, 0, 356, 0, 0, 0
7644, 2, 1636422592846, 1636422602846, 10000, 0, 10000, 0, 0, 0
7643, 2, 1636422592878, 1636422602890, 10012, 0, 10012, 0, 0, 0
7717, 1, 1636422602682, 1636422603026, 344, 0, 344, 0, 0, 0
7716, 1, 1636422602678, 1636422603026, 348, 0, 348, 0, 0, 0
7718, 1, 1636422602682, 1636422603034, 352, 0, 352, 0, 0, 0
7719, 1, 1636422602806, 1636422603114, 308, 0, 308, 0, 0, 0
7720, 1, 1636422602982, 1636422603254, 272, 0, 272, 0, 0, 0
7648, 2, 1636422593346, 1636422603346, 10000, 0, 10000, 0, 0, 0
7721, 1, 1636422603086, 1636422603394, 308, 0, 308, 0, 0, 0
7650, 2, 1636422593426, 1636422603426, 10000, 0, 10000, 0, 0, 0
7651, 2, 1636422593458, 1636422603470, 10012, 0, 10012, 0, 0, 0
7722, 1, 1636422603154, 1636422603518, 364, 0, 364, 0, 0, 0
7723, 1, 1636422603186, 1636422603518, 332, 0, 332, 0, 0, 0
7725, 1, 1636422603514, 1636422603782, 268, 0, 268, 0, 0, 0
7724, 1, 1636422603518, 1636422603786, 268, 0, 268, 0, 0, 0
7726, 1, 1636422603518, 1636422603790, 272, 0, 272, 0, 0, 0
7727, 1, 1636422603606, 1636422603882, 276, 0, 276, 0, 0, 0
7729, 1, 1636422603730, 1636422603998, 268, 0, 268, 0, 0, 0
7728, 1, 1636422603734, 1636422603998, 264, 0, 264, 0, 0, 0
7730, 1, 1636422603758, 1636422604030, 272, 0, 272, 0, 0, 0
7731, 1, 1636422603774, 1636422604046, 272, 0, 272, 0, 0, 0
7733, 1, 1636422603890, 1636422604162, 272, 0, 272, 0, 0, 0
7732, 1, 1636422603914, 1636422604186, 272, 0, 272, 0, 0, 0
7734, 1, 1636422603942, 1636422604214, 272, 0, 272, 0, 0, 0
7736, 1, 1636422604198, 1636422604462, 264, 0, 264, 0, 0, 0
7735, 1, 1636422604198, 1636422604470, 272, 0, 272, 0, 0, 0
7737, 1, 1636422604210, 1636422604478, 268, 0, 268, 0, 0, 0
7738, 1, 1636422604314, 1636422604586, 272, 0, 272, 0, 0, 0
7739, 1, 1636422604450, 1636422604722, 272, 0, 272, 0, 0, 0
7740, 1, 1636422604454, 1636422604726, 272, 0, 272, 0, 0, 0
7741, 1, 1636422604470, 1636422604742, 272, 1, 271, 0, 0, 0
7742, 1, 1636422604570, 1636422604842, 272, 0, 272, 0, 0, 0
7743, 1, 1636422604670, 1636422604938, 268, 0, 268, 0, 0, 0
7744, 1, 1636422604674, 1636422604946, 272, 0, 272, 0, 0, 0
7745, 1, 1636422604706, 1636422604978, 272, 0, 272, 0, 0, 0
7668, 2, 1636422595190, 1636422605190, 10000, 0, 10000, 0, 0, 0
7748, 1, 1636422604994, 1636422605262, 268, 0, 268, 0, 0, 0
7747, 1, 1636422604990, 1636422605262, 272, 0, 272, 0, 0, 0
7750, 1, 1636422605238, 1636422605510, 272, 0, 272, 0, 0, 0
7751, 1, 1636422605238, 1636422605510, 272, 0, 272, 0, 0, 0
7753, 1, 1636422605382, 1636422605654, 272, 0, 272, 0, 0, 0
7756, 1, 1636422605494, 1636422605766, 272, 0, 272, 0, 0, 0
7757, 1, 1636422605498, 1636422605766, 268, 0, 268, 0, 0, 0
7754, 1, 1636422605502, 1636422605770, 268, 0, 268, 0, 0, 0
7758, 1, 1636422605798, 1636422606070, 272, 0, 272, 0, 0, 0
7759, 1, 1636422605810, 1636422606082, 272, 0, 272, 0, 0, 0
7675, 2, 1636422596178, 1636422606178, 10000, 0, 10000, 0, 0, 0
7761, 1, 1636422606046, 1636422606314, 268, 0, 268, 0, 0, 0
7762, 1, 1636422606170, 1636422606442, 272, 0, 272, 0, 0, 0
7763, 1, 1636422606222, 1636422606494, 272, 0, 272, 0, 0, 0
7764, 1, 1636422606314, 1636422606582, 268, 1, 267, 1, 0, 1
7765, 1, 1636422606314, 1636422606582, 268, 1, 267, 0, 0, 0
7766, 1, 1636422606482, 1636422606758, 276, 0, 276, 0, 0, 0
7767, 1, 1636422606590, 1636422606862, 272, 0, 272, 0, 0, 0
7768, 1, 1636422606598, 1636422606874, 276, 0, 276, 0, 0, 0
7769, 1, 1636422606854, 1636422607126, 272, 0, 272, 0, 0, 0
7770, 1, 1636422606950, 1636422607226, 276, 0, 276, 0, 0, 0
7683, 2, 1636422597238, 1636422607238, 10000, 0, 10000, 0, 0, 0
7771, 1, 1636422607026, 1636422607302, 276, 0, 276, 0, 0, 0
7773, 1, 1636422607098, 1636422607374, 276, 0, 276, 0, 0, 0
7772, 1, 1636422607094, 1636422607374, 280, 0, 280, 0, 0, 0
7774, 1, 1636422607202, 1636422607466, 264, 0, 264, 0, 0, 0
7775, 1, 1636422607378, 1636422607646, 268, 0, 268, 0, 0, 0
7776, 1, 1636422607386, 1636422607658, 272, 0, 272, 0, 0, 0
7777, 1, 1636422607546, 1636422607818, 272, 0, 272, 0, 0, 0
7778, 1, 1636422607650, 1636422607922, 272, 0, 272, 0, 0, 0
7779, 1, 1636422607758, 1636422608034, 276, 1, 275, 0, 1, 1
7780, 1, 1636422607818, 1636422608086, 268, 0, 268, 0, 0, 0
7782, 1, 1636422607886, 1636422608154, 268, 0, 268, 0, 0, 0
7781, 1, 1636422607882, 1636422608154, 272, 0, 272, 0, 0, 0
7690, 2, 1636422598254, 1636422608254, 10000, 0, 10000, 0, 0, 0
7692, 2, 1636422598338, 1636422608338, 10000, 0, 10000, 0, 0, 0
7785, 1, 1636422608190, 1636422608474, 284, 0, 284, 0, 0, 0
7784, 1, 1636422608186, 1636422608482, 296, 0, 296, 0, 0, 0
7786, 1, 1636422608298, 1636422608570, 272, 0, 272, 0, 0, 0
7787, 1, 1636422608470, 1636422608746, 276, 0, 276, 0, 0, 0
7789, 1, 1636422608562, 1636422608834, 272, 0, 272, 0, 0, 0
7788, 1, 1636422608606, 1636422608878, 272, 0, 272, 0, 0, 0
7791, 1, 1636422608622, 1636422608894, 272, 0, 272, 0, 0, 0
7790, 1, 1636422608638, 1636422608910, 272, 0, 272, 0, 0, 0
7792, 1, 1636422608698, 1636422608970, 272, 0, 272, 0, 0, 0
7793, 1, 1636422608702, 1636422608982, 280, 0, 280, 0, 0, 0
7795, 1, 1636422608994, 1636422609262, 268, 1, 267, 0, 1, 1
7794, 1, 1636422608994, 1636422609266, 272, 1, 271, 0, 0, 0
7796, 1, 1636422609054, 1636422609326, 272, 0, 272, 0, 0, 0
7699, 2, 1636422599442, 1636422609442, 10000, 0, 10000, 0, 0, 0
7700, 2, 1636422599490, 1636422609490, 10000, 0, 10000, 0, 0, 0
7797, 1, 1636422609246, 1636422609538, 292, 0, 292, 0, 0, 0
7798, 1, 1636422609318, 1636422609626, 308, 0, 308, 0, 0, 0
7799, 1, 1636422609358, 1636422609670, 312, 0, 312, 0, 0, 0
7800, 1, 1636422609374, 1636422609670, 296, 0, 296, 0, 0, 0
7802, 1, 1636422609534, 1636422609806, 272, 0, 272, 0, 0, 0
7803, 1, 1636422609538, 1636422609814, 276, 0, 276, 0, 0, 0
7801, 1, 1636422609422, 1636422609898, 476, 205, 271, 205, 0, 205
7804, 1, 1636422609750, 1636422610014, 264, 0, 264, 0, 0, 0
7805, 1, 1636422609794, 1636422610062, 268, 0, 268, 0, 0, 0
7807, 1, 1636422609794, 1636422610062, 268, 0, 268, 0, 0, 0
7806, 1, 1636422609790, 1636422610066, 276, 0, 276, 0, 0, 0
7809, 1, 1636422610050, 1636422610318, 268, 0, 268, 0, 0, 0
7811, 1, 1636422610158, 1636422610426, 268, 0, 268, 0, 0, 0
7812, 1, 1636422610162, 1636422610430, 268, 0, 268, 0, 0, 0
7813, 1, 1636422610302, 1636422610574, 272, 0, 272, 0, 0, 0
7814, 1, 1636422610306, 1636422610574, 268, 0, 268, 0, 0, 0
7815, 1, 1636422610314, 1636422610578, 264, 0, 264, 0, 0, 0
7816, 1, 1636422610458, 1636422610726, 268, 0, 268, 0, 0, 0
7817, 1, 1636422610506, 1636422610774, 268, 0, 268, 0, 0, 0
7818, 1, 1636422610594, 1636422610870, 276, 0, 276, 0, 0, 0
7819, 1, 1636422610594, 1636422610870, 276, 0, 276, 0, 0, 0
7820, 1, 1636422610854, 1636422611126, 272, 0, 272, 0, 0, 0
7821, 1, 1636422610950, 1636422611222, 272, 0, 272, 0, 0, 0
7823, 1, 1636422611062, 1636422611330, 268, 0, 268, 0, 0, 0
7824, 1, 1636422611094, 1636422611366, 272, 0, 272, 0, 0, 0
7825, 1, 1636422611114, 1636422611382, 268, 0, 268, 0, 0, 0
7712, 2, 1636422601566, 1636422611566, 10000, 0, 10000, 0, 0, 0
7827, 1, 1636422611314, 1636422611614, 300, 0, 300, 0, 0, 0
7828, 1, 1636422611382, 1636422611650, 268, 1, 267, 0, 1, 1
7830, 1, 1636422611658, 1636422611930, 272, 0, 272, 0, 0, 0
7831, 1, 1636422611766, 1636422612034, 268, 0, 268, 0, 0, 0
7833, 1, 1636422611858, 1636422612126, 268, 0, 268, 0, 0, 0
7832, 1, 1636422611874, 1636422612146, 272, 0, 272, 0, 0, 0
7714, 2, 1636422602190, 1636422612190, 10000, 0, 10000, 0, 0, 0
7834, 1, 1636422611902, 1636422612330, 428, 133, 295, 133, 0, 133
7836, 1, 1636422612110, 1636422612426, 316, 0, 316, 0, 0, 0
7837, 1, 1636422612178, 1636422612450, 272, 0, 272, 0, 0, 0
7838, 1, 1636422612442, 1636422612714, 272, 0, 272, 0, 0, 0
7839, 1, 1636422612502, 1636422612766, 264, 0, 264, 0, 0, 0
7840, 1, 1636422612550, 1636422612822, 272, 0, 272, 0, 0, 0
7841, 1, 1636422612586, 1636422612858, 272, 0, 272, 0, 0, 0
7842, 1, 1636422612666, 1636422612938, 272, 0, 272, 0, 0, 0
7843, 1, 1636422612746, 1636422613018, 272, 0, 272, 0, 0, 0
7844, 1, 1636422612914, 1636422613194, 280, 0, 280, 0, 0, 0
7845, 1, 1636422612966, 1636422613238, 272, 0, 272, 0, 0, 0
7846, 1, 1636422613206, 1636422613482, 276, 0, 276, 0, 0, 0
7847, 1, 1636422613250, 1636422613522, 272, 0, 272, 0, 0, 0
7848, 1, 1636422613334, 1636422613606, 272, 0, 272, 0, 0, 0
7850, 1, 1636422613478, 1636422613750, 272, 0, 272, 0, 0, 0
7851, 1, 1636422613498, 1636422613774, 276, 0, 276, 0, 0, 0
7852, 1, 1636422613710, 1636422613990, 280, 0, 280, 0, 0, 0
7853, 1, 1636422613770, 1636422614042, 272, 0, 272, 0, 0, 0
7855, 1, 1636422614050, 1636422614322, 272, 0, 272, 0, 0, 0
7856, 1, 1636422614138, 1636422614410, 272, 0, 272, 0, 0, 0
7858, 1, 1636422614286, 1636422614558, 272, 0, 272, 0, 0, 0
7857, 1, 1636422614282, 1636422614558, 276, 0, 276, 0, 0, 0
7859, 1, 1636422614502, 1636422614778, 276, 0, 276, 0, 0, 0
7860, 1, 1636422614562, 1636422614834, 272, 0, 272, 0, 0, 0
7746, 2, 1636422604990, 1636422614990, 10000, 0, 10000, 0, 0, 0
7749, 2, 1636422605114, 1636422615114, 10000, 0, 10000, 0, 0, 0
7861, 1, 1636422614842, 1636422615158, 316, 0, 316, 0, 0, 0
7862, 1, 1636422614942, 1636422615250, 308, 1, 307, 0, 0, 0
7752, 2, 1636422605282, 1636422615282, 10000, 0, 10000, 0, 0, 0
7864, 1, 1636422615082, 1636422615354, 272, 0, 272, 0, 0, 0
7863, 1, 1636422615158, 1636422615434, 276, 0, 276, 0, 0, 0
7755, 2, 1636422605470, 1636422615470, 10000, 0, 10000, 0, 0, 0
7865, 1, 1636422615330, 1636422615606, 276, 0, 276, 0, 0, 0
7866, 1, 1636422615330, 1636422615606, 276, 0, 276, 0, 0, 0
7868, 1, 1636422615458, 1636422615734, 276, 0, 276, 0, 0, 0
7870, 1, 1636422615642, 1636422615914, 272, 1, 271, 0, 1, 1
7872, 1, 1636422615754, 1636422616026, 272, 0, 272, 0, 0, 0
7760, 2, 1636422606030, 1636422616030, 10000, 0, 10000, 0, 0, 0
7871, 1, 1636422615778, 1636422616078, 300, 0, 300, 0, 0, 0
7873, 1, 1636422615890, 1636422616166, 276, 1, 275, 0, 1, 1
7874, 1, 1636422615890, 1636422616166, 276, 1, 275, 0, 1, 1
7875, 1, 1636422616010, 1636422616278, 268, 0, 268, 0, 0, 0
7808, 1, 1636422609850, 1636422616298, 6448, 6180, 268, 0, 6180, 6180
7877, 1, 1636422616122, 1636422616386, 264, 0, 264, 0, 0, 0
7876, 1, 1636422616162, 1636422616430, 268, 0, 268, 0, 0, 0
7878, 1, 1636422616334, 1636422616602, 268, 0, 268, 0, 0, 0
7879, 1, 1636422616434, 1636422616702, 268, 0, 268, 0, 0, 0
7880, 1, 1636422616490, 1636422616762, 272, 0, 272, 0, 0, 0
7881, 1, 1636422616550, 1636422616822, 272, 0, 272, 0, 0, 0
7883, 1, 1636422616694, 1636422616966, 272, 0, 272, 0, 0, 0
7884, 1, 1636422616702, 1636422616970, 268, 0, 268, 0, 0, 0
7882, 1, 1636422616698, 1636422616970, 272, 0, 272, 0, 0, 0
7886, 1, 1636422616926, 1636422617194, 268, 0, 268, 0, 0, 0
7887, 1, 1636422616946, 1636422617222, 276, 0, 276, 0, 0, 0
7888, 1, 1636422617062, 1636422617338, 276, 0, 276, 0, 0, 0
7889, 1, 1636422617238, 1636422617518, 280, 0, 280, 0, 0, 0
7892, 1, 1636422617466, 1636422617734, 268, 0, 268, 0, 0, 0
7894, 1, 1636422617506, 1636422617774, 268, 0, 268, 0, 0, 0
7893, 1, 1636422617502, 1636422617774, 272, 0, 272, 0, 0, 0
7783, 2, 1636422607986, 1636422617986, 10000, 0, 10000, 0, 0, 0
7896, 1, 1636422617734, 1636422618030, 296, 0, 296, 0, 0, 0
7895, 1, 1636422617722, 1636422618030, 308, 0, 308, 0, 0, 0
7897, 1, 1636422617866, 1636422618138, 272, 0, 272, 0, 0, 0
7898, 1, 1636422618074, 1636422618346, 272, 0, 272, 0, 0, 0
7900, 1, 1636422618274, 1636422618546, 272, 0, 272, 0, 0, 0
7901, 1, 1636422618306, 1636422618578, 272, 0, 272, 0, 0, 0
7902, 1, 1636422618310, 1636422618582, 272, 0, 272, 0, 0, 0
7904, 1, 1636422618542, 1636422618822, 280, 0, 280, 0, 0, 0
7905, 1, 1636422618654, 1636422618926, 272, 0, 272, 0, 0, 0
7906, 1, 1636422618846, 1636422619122, 276, 0, 276, 0, 0, 0
7907, 1, 1636422619058, 1636422619330, 272, 0, 272, 0, 0, 0
7910, 1, 1636422619342, 1636422619614, 272, 0, 272, 0, 0, 0
7911, 1, 1636422619462, 1636422619734, 272, 0, 272, 0, 0, 0
7912, 1, 1636422619654, 1636422619926, 272, 1, 271, 0, 0, 0
7810, 2, 1636422610106, 1636422620106, 10000, 0, 10000, 0, 0, 0
7913, 1, 1636422619862, 1636422620154, 292, 0, 292, 0, 0, 0
7914, 1, 1636422620150, 1636422620422, 272, 0, 272, 0, 0, 0
7915, 1, 1636422620266, 1636422620542, 276, 1, 275, 0, 0, 0
7917, 1, 1636422620446, 1636422620718, 272, 0, 272, 0, 0, 0
7918, 1, 1636422620670, 1636422620942, 272, 1, 271, 0, 0, 0
7822, 2, 1636422610954, 1636422620954, 10000, 0, 10000, 0, 0, 0
7919, 1, 1636422620942, 1636422621202, 260, 0, 260, 0, 0, 0
7826, 2, 1636422611254, 1636422621254, 10000, 0, 10000, 0, 0, 0
7829, 2, 1636422611390, 1636422621390, 10000, 0, 10000, 0, 0, 0
7920, 1, 1636422621086, 1636422621438, 352, 0, 352, 0, 0, 0
7922, 1, 1636422621238, 1636422621522, 284, 0, 284, 0, 0, 0
7921, 1, 1636422621298, 1636422621566, 268, 0, 268, 0, 0, 0
7923, 1, 1636422621478, 1636422621750, 272, 0, 272, 0, 0, 0
7835, 2, 1636422611906, 1636422621906, 10000, 0, 10000, 0, 0, 0
7925, 1, 1636422621694, 1636422621966, 272, 0, 272, 0, 0, 0
7926, 1, 1636422621746, 1636422622038, 292, 0, 292, 0, 0, 0
7927, 1, 1636422621866, 1636422622134, 268, 0, 268, 0, 0, 0
7928, 1, 1636422621994, 1636422622266, 272, 0, 272, 0, 0, 0
7929, 1, 1636422622046, 1636422622325, 279, 0, 279, 0, 0, 0
7930, 1, 1636422622214, 1636422622486, 272, 1, 271, 0, 0, 0
7931, 1, 1636422622278, 1636422622546, 268, 0, 268, 0, 0, 0
7932, 1, 1636422622406, 1636422622674, 268, 0, 268, 0, 0, 0
7933, 1, 1636422622534, 1636422622806, 272, 0, 272, 0, 0, 0
7935, 1, 1636422622770, 1636422623042, 272, 0, 272, 0, 0, 0
7934, 1, 1636422622682, 1636422623078, 396, 125, 271, 125, 0, 125
7936, 1, 1636422622838, 1636422623110, 272, 0, 272, 0, 0, 0
7937, 1, 1636422622926, 1636422623198, 272, 1, 271, 0, 0, 0
7938, 1, 1636422623090, 1636422623358, 268, 1, 267, 0, 0, 0
7849, 2, 1636422613382, 1636422623382, 10000, 0, 10000, 0, 0, 0
7939, 1, 1636422623194, 1636422623462, 268, 0, 268, 0, 0, 0
7940, 1, 1636422623338, 1636422623614, 276, 0, 276, 0, 0, 0
7941, 1, 1636422623470, 1636422623742, 272, 0, 272, 0, 0, 0
7942, 1, 1636422623562, 1636422623834, 272, 0, 272, 0, 0, 0
7944, 1, 1636422623646, 1636422623918, 272, 0, 272, 0, 0, 0
7945, 1, 1636422623714, 1636422623986, 272, 0, 272, 0, 0, 0
7854, 2, 1636422614006, 1636422624006, 10000, 0, 10000, 0, 0, 0
7946, 1, 1636422623882, 1636422624150, 268, 0, 268, 0, 0, 0
7947, 1, 1636422623990, 1636422624258, 268, 0, 268, 0, 0, 0
7948, 1, 1636422624138, 1636422624410, 272, 0, 272, 0, 0, 0
7950, 1, 1636422624282, 1636422624554, 272, 0, 272, 0, 0, 0
7951, 1, 1636422624374, 1636422624647, 273, 0, 273, 0, 0, 0
7952, 1, 1636422624450, 1636422624722, 272, 1, 271, 0, 0, 0
7953, 1, 1636422624510, 1636422624790, 280, 0, 280, 0, 0, 0
7954, 1, 1636422624690, 1636422624954, 264, 0, 264, 0, 0, 0
7955, 1, 1636422624802, 1636422625074, 272, 0, 272, 0, 0, 0
7956, 1, 1636422624914, 1636422625190, 276, 0, 276, 0, 0, 0
7957, 1, 1636422625070, 1636422625342, 272, 0, 272, 0, 0, 0
7867, 2, 1636422615374, 1636422625374, 10000, 0, 10000, 0, 0, 0
7958, 1, 1636422625166, 1636422625438, 272, 0, 272, 0, 0, 0
7959, 1, 1636422625250, 1636422625518, 268, 0, 268, 0, 0, 0
7869, 2, 1636422615586, 1636422625586, 10000, 0, 10000, 0, 0, 0
7960, 1, 1636422625314, 1636422625634, 320, 0, 320, 0, 0, 0
7961, 1, 1636422625506, 1636422625814, 308, 0, 308, 0, 0, 0
7962, 1, 1636422625634, 1636422625906, 272, 0, 272, 0, 0, 0
7964, 1, 1636422625718, 1636422625990, 272, 0, 272, 0, 0, 0
7966, 1, 1636422625862, 1636422626130, 268, 0, 268, 0, 0, 0
7965, 1, 1636422625890, 1636422626170, 280, 0, 280, 0, 0, 0
7967, 1, 1636422625978, 1636422626250, 272, 0, 272, 0, 0, 0
7969, 1, 1636422626102, 1636422626382, 280, 0, 280, 0, 0, 0
7970, 1, 1636422626278, 1636422626550, 272, 0, 272, 0, 0, 0
7971, 1, 1636422626398, 1636422626670, 272, 0, 272, 0, 0, 0
7972, 1, 1636422626510, 1636422626782, 272, 0, 272, 0, 0, 0
7885, 2, 1636422616814, 1636422626814, 10000, 0, 10000, 0, 0, 0
7973, 1, 1636422626606, 1636422626878, 272, 0, 272, 0, 0, 0
7974, 1, 1636422626646, 1636422626950, 304, 0, 304, 0, 0, 0
7975, 1, 1636422626778, 1636422627046, 268, 0, 268, 0, 0, 0
7976, 1, 1636422626946, 1636422627214, 268, 0, 268, 0, 0, 0
7890, 2, 1636422617294, 1636422627294, 10000, 0, 10000, 0, 0, 0
7977, 1, 1636422627066, 1636422627342, 276, 0, 276, 0, 0, 0
7891, 2, 1636422617346, 1636422627346, 10000, 0, 10000, 0, 0, 0
7978, 1, 1636422627122, 1636422627430, 308, 0, 308, 0, 0, 0
7979, 1, 1636422627198, 1636422627482, 284, 0, 284, 0, 0, 0
7980, 1, 1636422627342, 1636422627610, 268, 0, 268, 0, 0, 0
7982, 1, 1636422627478, 1636422627754, 276, 0, 276, 0, 0, 0
7984, 1, 1636422627574, 1636422627842, 268, 0, 268, 0, 0, 0
7983, 1, 1636422627618, 1636422627890, 272, 0, 272, 0, 0, 0
7985, 1, 1636422627646, 1636422627918, 272, 0, 272, 0, 0, 0
7986, 1, 1636422627718, 1636422627990, 272, 0, 272, 0, 0, 0
7988, 1, 1636422627870, 1636422628138, 268, 0, 268, 0, 0, 0
7987, 1, 1636422627834, 1636422628182, 348, 85, 263, 85, 0, 85
7989, 1, 1636422627998, 1636422628270, 272, 0, 272, 0, 0, 0
7899, 2, 1636422618290, 1636422628290, 10000, 0, 10000, 0, 0, 0
7903, 2, 1636422618506, 1636422628506, 10000, 0, 10000, 0, 0, 0
7991, 1, 1636422628246, 1636422628554, 308, 0, 308, 0, 0, 0
7992, 1, 1636422628338, 1636422628638, 300, 0, 300, 0, 0, 0
7994, 1, 1636422628382, 1636422628662, 280, 0, 280, 0, 0, 0
7993, 1, 1636422628382, 1636422628662, 280, 0, 280, 0, 0, 0
7995, 1, 1636422628554, 1636422628822, 268, 0, 268, 0, 0, 0
7996, 1, 1636422628598, 1636422628870, 272, 0, 272, 0, 0, 0
7997, 1, 1636422628638, 1636422628906, 268, 1, 267, 0, 1, 1
7998, 1, 1636422628662, 1636422628938, 276, 1, 275, 0, 1, 1
7999, 1, 1636422628814, 1636422629082, 268, 0, 268, 0, 0, 0
8000, 1, 1636422628806, 1636422629082, 276, 0, 276, 0, 0, 0
7908, 2, 1636422619098, 1636422629098, 10000, 0, 10000, 0, 0, 0
7909, 2, 1636422619110, 1636422629150, 10040, 0, 10040, 0, 0, 0
8002, 1, 1636422629194, 1636422629466, 272, 0, 272, 0, 0, 0
8004, 1, 1636422629198, 1636422629474, 276, 0, 276, 0, 0, 0
8003, 1, 1636422629198, 1636422629478, 280, 0, 280, 0, 0, 0
8005, 1, 1636422629306, 1636422629586, 280, 0, 280, 0, 0, 0
8006, 1, 1636422629322, 1636422629594, 272, 0, 272, 0, 0, 0
8007, 1, 1636422629418, 1636422629678, 260, 0, 260, 0, 0, 0
8008, 1, 1636422629426, 1636422629694, 268, 0, 268, 0, 0, 0
8009, 1, 1636422629450, 1636422629722, 272, 0, 272, 0, 0, 0
8011, 1, 1636422629526, 1636422629794, 268, 0, 268, 0, 0, 0
8012, 1, 1636422629622, 1636422629894, 272, 0, 272, 0, 0, 0
8013, 1, 1636422629922, 1636422630190, 268, 0, 268, 0, 0, 0
8014, 1, 1636422629954, 1636422630226, 272, 0, 272, 0, 0, 0
8015, 1, 1636422629970, 1636422630238, 268, 0, 268, 0, 0, 0
8017, 1, 1636422630118, 1636422630390, 272, 0, 272, 0, 0, 0
8018, 1, 1636422630126, 1636422630398, 272, 0, 272, 0, 0, 0
7916, 2, 1636422620414, 1636422630414, 10000, 0, 10000, 0, 0, 0
8019, 1, 1636422630258, 1636422630546, 288, 0, 288, 0, 0, 0
8020, 1, 1636422630326, 1636422630638, 312, 0, 312, 0, 0, 0
8021, 1, 1636422630458, 1636422630730, 272, 0, 272, 0, 0, 0
8022, 1, 1636422630722, 1636422630990, 268, 0, 268, 0, 0, 0
8023, 1, 1636422630742, 1636422631014, 272, 0, 272, 0, 0, 0
8024, 1, 1636422630766, 1636422631042, 276, 0, 276, 0, 0, 0
8025, 1, 1636422630778, 1636422631050, 272, 0, 272, 0, 0, 0
8026, 1, 1636422630918, 1636422631194, 276, 0, 276, 0, 0, 0
8028, 1, 1636422631046, 1636422631322, 276, 0, 276, 0, 0, 0
8029, 1, 1636422631114, 1636422631382, 268, 0, 268, 0, 0, 0
8030, 1, 1636422631226, 1636422631494, 268, 0, 268, 0, 0, 0
7924, 2, 1636422621566, 1636422631566, 10000, 0, 10000, 0, 0, 0
8031, 1, 1636422631430, 1636422631702, 272, 0, 272, 0, 0, 0
8032, 1, 1636422631526, 1636422631786, 260, 0, 260, 0, 0, 0
8033, 1, 1636422631562, 1636422631830, 268, 0, 268, 0, 0, 0
8034, 1, 1636422631610, 1636422631878, 268, 0, 268, 0, 0, 0
8035, 1, 1636422631730, 1636422632002, 272, 0, 272, 0, 0, 0
8037, 1, 1636422631850, 1636422632118, 268, 0, 268, 0, 0, 0
8036, 1, 1636422631878, 1636422632150, 272, 0, 272, 0, 0, 0
8038, 1, 1636422631930, 1636422632194, 264, 0, 264, 0, 0, 0
8039, 1, 1636422632018, 1636422632286, 268, 0, 268, 0, 0, 0
8041, 1, 1636422632338, 1636422632610, 272, 0, 272, 0, 0, 0
8043, 1, 1636422632374, 1636422632642, 268, 0, 268, 0, 0, 0
8042, 1, 1636422632366, 1636422632646, 280, 0, 280, 0, 0, 0
8044, 1, 1636422632526, 1636422632794, 268, 0, 268, 0, 0, 0
8045, 1, 1636422632586, 1636422632882, 296, 24, 272, 24, 0, 24
8046, 1, 1636422632642, 1636422632918, 276, 0, 276, 0, 0, 0
8047, 1, 1636422632714, 1636422632986, 272, 0, 272, 0, 0, 0
8048, 1, 1636422632802, 1636422633078, 276, 0, 276, 0, 0, 0
8049, 1, 1636422633130, 1636422633406, 276, 0, 276, 0, 0, 0
8050, 1, 1636422633154, 1636422633430, 276, 0, 276, 0, 0, 0
8051, 1, 1636422633190, 1636422633462, 272, 0, 272, 0, 0, 0
8052, 1, 1636422633310, 1636422633586, 276, 0, 276, 0, 0, 0
7943, 2, 1636422623690, 1636422633690, 10000, 0, 10000, 0, 0, 0
8054, 1, 1636422633450, 1636422633738, 288, 0, 288, 0, 0, 0
8055, 1, 1636422633530, 1636422633826, 296, 0, 296, 0, 0, 0
8056, 1, 1636422633586, 1636422633862, 276, 0, 276, 0, 0, 0
8057, 1, 1636422633946, 1636422634214, 268, 0, 268, 0, 0, 0
8058, 1, 1636422633946, 1636422634222, 276, 0, 276, 0, 0, 0
8060, 1, 1636422633998, 1636422634266, 268, 0, 268, 0, 0, 0
8059, 1, 1636422633998, 1636422634266, 268, 0, 268, 0, 0, 0
7949, 2, 1636422624314, 1636422634314, 10000, 0, 10000, 0, 0, 0
8061, 1, 1636422634090, 1636422634362, 272, 0, 272, 0, 0, 0
8062, 1, 1636422634262, 1636422634542, 280, 0, 280, 0, 0, 0
8063, 1, 1636422634362, 1636422634630, 268, 0, 268, 0, 0, 0
8064, 1, 1636422634402, 1636422634674, 272, 0, 272, 0, 0, 0
8065, 1, 1636422634626, 1636422634894, 268, 0, 268, 0, 0, 0
8066, 1, 1636422634706, 1636422634978, 272, 0, 272, 0, 0, 0
8068, 1, 1636422634754, 1636422635022, 268, 0, 268, 0, 0, 0
8067, 1, 1636422634750, 1636422635026, 276, 0, 276, 0, 0, 0
8069, 1, 1636422634798, 1636422635074, 276, 0, 276, 0, 0, 0
8070, 1, 1636422634878, 1636422635146, 268, 0, 268, 0, 0, 0
8071, 1, 1636422635050, 1636422635322, 272, 0, 272, 0, 0, 0
8072, 1, 1636422635122, 1636422635394, 272, 0, 272, 0, 0, 0
8073, 1, 1636422635170, 1636422635450, 280, 0, 280, 0, 0, 0
8074, 1, 1636422635330, 1636422635602, 272, 0, 272, 0, 0, 0
7963, 2, 1636422625682, 1636422635682, 10000, 0, 10000, 0, 0, 0
8076, 1, 1636422635542, 1636422635818, 276, 1, 275, 0, 1, 1
8077, 1, 1636422635542, 1636422635822, 280, 0, 280, 0, 0, 0
8078, 1, 1636422635602, 1636422635914, 312, 0, 312, 0, 0, 0
8079, 1, 1636422635682, 1636422635950, 268, 0, 268, 0, 0, 0
7968, 2, 1636422626066, 1636422636066, 10000, 0, 10000, 0, 0, 0
8080, 1, 1636422635854, 1636422636130, 276, 0, 276, 0, 0, 0
8081, 1, 1636422635926, 1636422636202, 276, 0, 276, 0, 0, 0
8083, 1, 1636422635966, 1636422636238, 272, 0, 272, 0, 0, 0
8082, 1, 1636422635990, 1636422636294, 304, 0, 304, 0, 0, 0
8085, 1, 1636422636338, 1636422636610, 272, 0, 272, 0, 0, 0
8087, 1, 1636422636354, 1636422636618, 264, 0, 264, 0, 0, 0
8086, 1, 1636422636378, 1636422636650, 272, 0, 272, 0, 0, 0
8088, 1, 1636422636398, 1636422636666, 268, 0, 268, 0, 0, 0
8089, 1, 1636422636466, 1636422636738, 272, 0, 272, 0, 0, 0
8090, 1, 1636422636666, 1636422636938, 272, 0, 272, 0, 0, 0
8091, 1, 1636422636698, 1636422636970, 272, 0, 272, 0, 0, 0
8092, 1, 1636422636730, 1636422637002, 272, 0, 272, 0, 0, 0
8093, 1, 1636422636758, 1636422637026, 268, 0, 268, 0, 0, 0
8094, 1, 1636422637134, 1636422637406, 272, 0, 272, 0, 0, 0
8095, 1, 1636422637154, 1636422637426, 272, 0, 272, 0, 0, 0
7981, 2, 1636422627434, 1636422637434, 10000, 0, 10000, 0, 0, 0
8096, 1, 1636422637210, 1636422637482, 272, 0, 272, 0, 0, 0
8097, 1, 1636422637262, 1636422637570, 308, 1, 307, 0, 0, 0
8098, 1, 1636422637482, 1636422637750, 268, 0, 268, 0, 0, 0
8101, 1, 1636422637526, 1636422637802, 276, 0, 276, 0, 0, 0
8100, 1, 1636422637566, 1636422637842, 276, 0, 276, 0, 0, 0
8102, 1, 1636422637734, 1636422638006, 272, 0, 272, 0, 0, 0
7990, 2, 1636422628086, 1636422638086, 10000, 0, 10000, 0, 0, 0
8104, 1, 1636422637954, 1636422638222, 268, 0, 268, 0, 0, 0
8103, 1, 1636422637922, 1636422638222, 300, 0, 300, 0, 0, 0
8105, 1, 1636422638002, 1636422638314, 312, 0, 312, 0, 0, 0
8106, 1, 1636422638062, 1636422638334, 272, 0, 272, 0, 0, 0
8107, 1, 1636422638246, 1636422638514, 268, 0, 268, 0, 0, 0
8108, 1, 1636422638342, 1636422638610, 268, 0, 268, 0, 0, 0
8109, 1, 1636422638350, 1636422638630, 280, 0, 280, 0, 0, 0
8111, 1, 1636422638462, 1636422638734, 272, 0, 272, 0, 0, 0
8113, 1, 1636422638742, 1636422639014, 272, 0, 272, 0, 0, 0
8001, 2, 1636422629038, 1636422639038, 10000, 0, 10000, 0, 0, 0
8114, 1, 1636422638794, 1636422639086, 292, 0, 292, 0, 0, 0
8115, 1, 1636422638846, 1636422639118, 272, 0, 272, 0, 0, 0
8116, 1, 1636422639086, 1636422639354, 268, 0, 268, 0, 0, 0
8118, 1, 1636422639134, 1636422639406, 272, 0, 272, 0, 0, 0
8010, 2, 1636422629450, 1636422639450, 10000, 0, 10000, 0, 0, 0
8119, 1, 1636422639246, 1636422639518, 272, 0, 272, 0, 0, 0
8121, 1, 1636422639582, 1636422639850, 268, 0, 268, 0, 0, 0
8122, 1, 1636422639594, 1636422639862, 268, 0, 268, 0, 0, 0
8016, 2, 1636422630110, 1636422640110, 10000, 0, 10000, 0, 0, 0
8125, 1, 1636422639838, 1636422640154, 316, 0, 316, 0, 0, 0
8126, 1, 1636422639914, 1636422640182, 268, 0, 268, 0, 0, 0
8127, 1, 1636422640054, 1636422640338, 284, 1, 283, 0, 1, 1
8128, 1, 1636422640350, 1636422640618, 268, 0, 268, 0, 0, 0
8130, 1, 1636422640390, 1636422640658, 268, 0, 268, 0, 0, 0
8129, 1, 1636422640414, 1636422640686, 272, 0, 272, 0, 0, 0
8131, 1, 1636422640650, 1636422640922, 272, 0, 272, 0, 0, 0
8027, 2, 1636422630926, 1636422640926, 10000, 0, 10000, 0, 0, 0
8132, 1, 1636422640714, 1636422640986, 272, 0, 272, 0, 0, 0
8133, 1, 1636422640862, 1636422641154, 292, 1, 291, 0, 0, 0
8134, 1, 1636422641134, 1636422641406, 272, 0, 272, 0, 0, 0
8135, 1, 1636422641154, 1636422641430, 276, 1, 275, 0, 1, 1
8136, 1, 1636422641190, 1636422641466, 276, 0, 276, 0, 0, 0
8137, 1, 1636422641234, 1636422641502, 268, 0, 268, 0, 0, 0
8138, 1, 1636422641442, 1636422641710, 268, 0, 268, 0, 0, 0
8139, 1, 1636422641498, 1636422641766, 268, 0, 268, 0, 0, 0
8140, 1, 1636422641646, 1636422641918, 272, 0, 272, 0, 0, 0
8141, 1, 1636422641918, 1636422642182, 264, 0, 264, 0, 0, 0
8143, 1, 1636422641954, 1636422642222, 268, 1, 267, 0, 1, 1
8142, 1, 1636422641954, 1636422642222, 268, 1, 267, 0, 1, 1
8040, 2, 1636422632238, 1636422642238, 10000, 0, 10000, 0, 0, 0
8144, 1, 1636422641978, 1636422642286, 308, 0, 308, 0, 0, 0
8145, 1, 1636422642286, 1636422642550, 264, 0, 264, 0, 0, 0
8146, 1, 1636422642326, 1636422642598, 272, 0, 272, 0, 0, 0
8147, 1, 1636422642462, 1636422642742, 280, 0, 280, 0, 0, 0
8148, 1, 1636422642546, 1636422642818, 272, 0, 272, 0, 0, 0
8149, 1, 1636422642734, 1636422643002, 268, 0, 268, 0, 0, 0
8150, 1, 1636422642742, 1636422643014, 272, 0, 272, 0, 0, 0
8151, 1, 1636422642762, 1636422643038, 276, 0, 276, 0, 0, 0
8152, 1, 1636422642770, 1636422643282, 512, 245, 267, 245, 0, 245
8153, 1, 1636422643062, 1636422643330, 268, 0, 268, 0, 0, 0
8154, 1, 1636422643086, 1636422643362, 276, 0, 276, 0, 0, 0
8053, 2, 1636422633390, 1636422643390, 10000, 0, 10000, 0, 0, 0
8156, 1, 1636422643266, 1636422643538, 272, 0, 272, 0, 0, 0
8155, 1, 1636422643246, 1636422643618, 372, 85, 287, 85, 0, 85
8157, 1, 1636422643538, 1636422643810, 272, 1, 271, 0, 0, 0
8158, 1, 1636422643546, 1636422643814, 268, 0, 268, 0, 0, 0
8159, 1, 1636422643566, 1636422643886, 320, 52, 268, 52, 0, 52
8161, 1, 1636422643694, 1636422643966, 272, 1, 271, 0, 0, 0
8162, 1, 1636422643850, 1636422644122, 272, 0, 272, 0, 0, 0
8163, 1, 1636422643882, 1636422644146, 264, 0, 264, 0, 0, 0
8164, 1, 1636422644054, 1636422644326, 272, 0, 272, 0, 0, 0
8165, 1, 1636422644058, 1636422644414, 356, 89, 267, 89, 0, 89
8166, 1, 1636422644330, 1636422644594, 264, 0, 264, 0, 0, 0
8167, 1, 1636422644354, 1636422644622, 268, 1, 267, 0, 0, 0
8168, 1, 1636422644362, 1636422644642, 280, 0, 280, 0, 0, 0
8169, 1, 1636422644422, 1636422644694, 272, 0, 272, 0, 0, 0
8170, 1, 1636422644642, 1636422644914, 272, 0, 272, 0, 0, 0
8171, 1, 1636422644670, 1636422644942, 272, 0, 272, 0, 0, 0
8172, 1, 1636422644858, 1636422645126, 268, 1, 267, 0, 0, 0
8173, 1, 1636422644866, 1636422645142, 276, 0, 276, 0, 0, 0
8174, 1, 1636422645134, 1636422645414, 280, 0, 280, 0, 0, 0
8175, 1, 1636422645150, 1636422645422, 272, 1, 271, 1, 0, 1
8176, 1, 1636422645150, 1636422645422, 272, 1, 271, 0, 1, 1
8177, 1, 1636422645214, 1636422645482, 268, 0, 268, 0, 0, 0
8075, 2, 1636422635514, 1636422645514, 10000, 0, 10000, 0, 0, 0
8178, 1, 1636422645450, 1636422645742, 292, 0, 292, 0, 0, 0
8179, 1, 1636422645454, 1636422645746, 292, 0, 292, 0, 0, 0
8180, 1, 1636422645646, 1636422645914, 268, 0, 268, 0, 0, 0
8181, 1, 1636422645678, 1636422645950, 272, 0, 272, 0, 0, 0
8182, 1, 1636422645822, 1636422646094, 272, 0, 272, 0, 0, 0
8084, 2, 1636422636158, 1636422646158, 10000, 0, 10000, 0, 0, 0
8183, 1, 1636422645922, 1636422646206, 284, 0, 284, 0, 0, 0
8185, 1, 1636422645958, 1636422646230, 272, 0, 272, 0, 0, 0
8184, 1, 1636422645954, 1636422646234, 280, 0, 280, 0, 0, 0
8186, 1, 1636422646018, 1636422646294, 276, 0, 276, 0, 0, 0
8187, 1, 1636422646246, 1636422646518, 272, 0, 272, 0, 0, 0
8190, 1, 1636422646454, 1636422646730, 276, 0, 276, 0, 0, 0
8189, 1, 1636422646474, 1636422646746, 272, 0, 272, 0, 0, 0
8191, 1, 1636422646474, 1636422646746, 272, 0, 272, 0, 0, 0
8192, 1, 1636422646538, 1636422646814, 276, 0, 276, 0, 0, 0
8193, 1, 1636422646734, 1636422647006, 272, 0, 272, 0, 0, 0
8194, 1, 1636422646742, 1636422647018, 276, 0, 276, 0, 0, 0
8195, 1, 1636422646750, 1636422647026, 276, 0, 276, 0, 0, 0
8196, 1, 1636422646834, 1636422647102, 268, 0, 268, 0, 0, 0
8197, 1, 1636422647050, 1636422647322, 272, 0, 272, 0, 0, 0
8198, 1, 1636422647190, 1636422647466, 276, 0, 276, 0, 0, 0
8099, 2, 1636422637526, 1636422647526, 10000, 0, 10000, 0, 0, 0
8199, 1, 1636422647262, 1636422647570, 308, 0, 308, 0, 0, 0
8200, 1, 1636422647282, 1636422647571, 289, 0, 289, 0, 0, 0
8201, 1, 1636422647326, 1636422647590, 264, 0, 264, 0, 0, 0
8203, 1, 1636422647570, 1636422647838, 268, 1, 267, 0, 1, 1
8202, 1, 1636422647570, 1636422647838, 268, 1, 267, 0, 1, 1
8204, 1, 1636422647570, 1636422647838, 268, 1, 267, 1, 0, 1
8205, 1, 1636422647658, 1636422647918, 260, 0, 260, 0, 0, 0
8206, 1, 1636422647838, 1636422648102, 264, 1, 263, 1, 0, 1
8207, 1, 1636422647850, 1636422648118, 268, 0, 268, 0, 0, 0
8208, 1, 1636422647982, 1636422648254, 272, 0, 272, 0, 0, 0
8209, 1, 1636422648054, 1636422648322, 268, 0, 268, 0, 0, 0
8210, 1, 1636422648082, 1636422648354, 272, 0, 272, 0, 0, 0
8110, 2, 1636422638390, 1636422648390, 10000, 0, 10000, 0, 0, 0
8211, 1, 1636422648134, 1636422648438, 304, 0, 304, 0, 0, 0
8213, 1, 1636422648342, 1636422648618, 276, 0, 276, 0, 0, 0
8212, 1, 1636422648326, 1636422648622, 296, 0, 296, 0, 0, 0
8214, 1, 1636422648374, 1636422648642, 268, 0, 268, 0, 0, 0
8215, 1, 1636422648438, 1636422648710, 272, 0, 272, 0, 0, 0
8112, 2, 1636422638722, 1636422648722, 10000, 0, 10000, 0, 0, 0
8216, 1, 1636422648554, 1636422648858, 304, 1, 303, 0, 1, 1
8218, 1, 1636422648662, 1636422648950, 288, 0, 288, 0, 0, 0
8217, 1, 1636422648694, 1636422648970, 276, 0, 276, 0, 0, 0
8219, 1, 1636422648810, 1636422649078, 268, 0, 268, 0, 0, 0
8220, 1, 1636422648858, 1636422649126, 268, 0, 268, 0, 0, 0
8221, 1, 1636422648886, 1636422649158, 272, 0, 272, 0, 0, 0
8117, 2, 1636422639170, 1636422649170, 10000, 0, 10000, 0, 0, 0
8222, 1, 1636422648950, 1636422649217, 267, 0, 267, 0, 0, 0
8223, 1, 1636422649030, 1636422649302, 272, 0, 272, 0, 0, 0
8120, 2, 1636422639342, 1636422649342, 10000, 0, 10000, 0, 0, 0
8224, 1, 1636422649134, 1636422649398, 264, 0, 264, 0, 0, 0
8225, 1, 1636422649146, 1636422649418, 272, 0, 272, 0, 0, 0
8226, 1, 1636422649154, 1636422649478, 324, 4, 320, 4, 0, 4
8227, 1, 1636422649258, 1636422649574, 316, 0, 316, 0, 0, 0
8123, 2, 1636422639654, 1636422649654, 10000, 0, 10000, 0, 0, 0
8228, 1, 1636422649390, 1636422649702, 312, 0, 312, 0, 0, 0
8229, 1, 1636422649438, 1636422649714, 276, 0, 276, 0, 0, 0
8230, 1, 1636422649470, 1636422649742, 272, 0, 272, 0, 0, 0
8124, 2, 1636422639758, 1636422649762, 10004, 0, 10004, 0, 0, 0
8231, 1, 1636422649590, 1636422649898, 308, 0, 308, 0, 0, 0
8232, 1, 1636422649650, 1636422649922, 272, 0, 272, 0, 0, 0
8233, 1, 1636422649702, 1636422649990, 288, 0, 288, 0, 0, 0
8234, 1, 1636422649698, 1636422649990, 292, 0, 292, 0, 0, 0
8235, 1, 1636422649746, 1636422650010, 264, 0, 264, 0, 0, 0
8236, 1, 1636422649746, 1636422650022, 276, 0, 276, 0, 0, 0
8238, 1, 1636422649938, 1636422650210, 272, 0, 272, 0, 0, 0
8237, 1, 1636422649962, 1636422650234, 272, 0, 272, 0, 0, 0
8239, 1, 1636422649962, 1636422650234, 272, 1, 271, 0, 0, 0
8241, 1, 1636422650034, 1636422650298, 264, 0, 264, 0, 0, 0
8240, 1, 1636422650070, 1636422650342, 272, 0, 272, 0, 0, 0
8242, 1, 1636422650154, 1636422650422, 268, 0, 268, 0, 0, 0
8243, 1, 1636422650198, 1636422650470, 272, 0, 272, 0, 0, 0
8245, 1, 1636422650362, 1636422650634, 272, 0, 272, 0, 0, 0
8246, 1, 1636422650378, 1636422650650, 272, 0, 272, 0, 0, 0
8247, 1, 1636422650446, 1636422650718, 272, 0, 272, 0, 0, 0
8248, 1, 1636422650478, 1636422650750, 272, 0, 272, 0, 0, 0
8249, 1, 1636422650534, 1636422650806, 272, 0, 272, 0, 0, 0
8250, 1, 1636422650538, 1636422650898, 360, 97, 263, 97, 0, 97
8251, 1, 1636422650682, 1636422650954, 272, 0, 272, 0, 0, 0
8252, 1, 1636422650738, 1636422651014, 276, 0, 276, 0, 0, 0
8253, 1, 1636422650770, 1636422651042, 272, 0, 272, 0, 0, 0
8255, 1, 1636422650842, 1636422651110, 268, 0, 268, 0, 0, 0
8254, 1, 1636422650778, 1636422651162, 384, 121, 263, 121, 0, 121
8256, 1, 1636422650962, 1636422651238, 276, 0, 276, 0, 0, 0
8257, 1, 1636422650982, 1636422651250, 268, 0, 268, 0, 0, 0
8259, 1, 1636422651178, 1636422651454, 276, 0, 276, 0, 0, 0
8260, 1, 1636422651250, 1636422651510, 260, 0, 260, 0, 0, 0
8261, 1, 1636422651290, 1636422651558, 268, 0, 268, 0, 0, 0
8262, 1, 1636422651334, 1636422651610, 276, 0, 276, 0, 0, 0
8263, 1, 1636422651342, 1636422651626, 284, 0, 284, 0, 0, 0
8264, 1, 1636422651466, 1636422651742, 276, 0, 276, 0, 0, 0
8265, 1, 1636422651538, 1636422651810, 272, 0, 272, 0, 0, 0
8266, 1, 1636422651570, 1636422651850, 280, 0, 280, 0, 0, 0
8268, 1, 1636422651626, 1636422651902, 276, 0, 276, 0, 0, 0
8269, 1, 1636422651754, 1636422652026, 272, 0, 272, 0, 0, 0
8270, 1, 1636422651790, 1636422652058, 268, 0, 268, 0, 0, 0
8271, 1, 1636422651970, 1636422652246, 276, 0, 276, 0, 0, 0
8272, 1, 1636422652042, 1636422652310, 268, 0, 268, 0, 0, 0
8273, 1, 1636422652090, 1636422652366, 276, 0, 276, 0, 0, 0
8274, 1, 1636422652138, 1636422652414, 276, 0, 276, 0, 0, 0
8275, 1, 1636422652150, 1636422652426, 276, 0, 276, 0, 0, 0
8276, 1, 1636422652274, 1636422652546, 272, 0, 272, 0, 0, 0
8277, 1, 1636422652350, 1636422652622, 272, 0, 272, 0, 0, 0
8278, 1, 1636422652366, 1636422652638, 272, 0, 272, 0, 0, 0
8279, 1, 1636422652434, 1636422652706, 272, 0, 272, 0, 0, 0
8280, 1, 1636422652554, 1636422652826, 272, 1, 271, 0, 0, 0
8281, 1, 1636422652602, 1636422652870, 268, 0, 268, 0, 0, 0
8282, 1, 1636422652786, 1636422653058, 272, 0, 272, 0, 0, 0
8283, 1, 1636422652854, 1636422653126, 272, 0, 272, 0, 0, 0
8284, 1, 1636422652890, 1636422653162, 272, 0, 272, 0, 0, 0
8285, 1, 1636422652942, 1636422653206, 264, 0, 264, 0, 0, 0
8286, 1, 1636422652950, 1636422653214, 264, 0, 264, 0, 0, 0
8287, 1, 1636422653082, 1636422653354, 272, 0, 272, 0, 0, 0
8288, 1, 1636422653142, 1636422653414, 272, 0, 272, 0, 0, 0
8289, 1, 1636422653170, 1636422653446, 276, 0, 276, 0, 0, 0
8290, 1, 1636422653246, 1636422653514, 268, 0, 268, 0, 0, 0
8291, 1, 1636422653354, 1636422653622, 268, 0, 268, 0, 0, 0
8292, 1, 1636422653398, 1636422653666, 268, 0, 268, 0, 0, 0
8160, 2, 1636422643674, 1636422653678, 10004, 0, 10004, 0, 0, 0
8293, 1, 1636422653590, 1636422653906, 316, 0, 316, 0, 0, 0
8294, 1, 1636422653662, 1636422653930, 268, 0, 268, 0, 0, 0
8295, 1, 1636422653726, 1636422653990, 264, 0, 264, 0, 0, 0
8297, 1, 1636422653770, 1636422654042, 272, 1, 271, 0, 0, 0
8296, 1, 1636422653770, 1636422654042, 272, 0, 272, 0, 0, 0
8298, 1, 1636422653878, 1636422654146, 268, 0, 268, 0, 0, 0
8301, 1, 1636422653954, 1636422654214, 260, 0, 260, 0, 0, 0
8300, 1, 1636422653950, 1636422654218, 268, 0, 268, 0, 0, 0
8302, 1, 1636422654038, 1636422654306, 268, 0, 268, 0, 0, 0
8303, 1, 1636422654166, 1636422654438, 272, 0, 272, 0, 0, 0
8304, 1, 1636422654198, 1636422654470, 272, 0, 272, 0, 0, 0
8305, 1, 1636422654382, 1636422654706, 324, 57, 267, 56, 0, 56
8306, 1, 1636422654450, 1636422654726, 276, 0, 276, 0, 0, 0
8307, 1, 1636422654490, 1636422654766, 276, 0, 276, 0, 0, 0
8309, 1, 1636422654562, 1636422654830, 268, 0, 268, 0, 0, 0
8308, 1, 1636422654562, 1636422654834, 272, 0, 272, 0, 0, 0
8310, 1, 1636422654678, 1636422654950, 272, 1, 271, 0, 0, 0
8312, 1, 1636422654758, 1636422655030, 272, 0, 272, 0, 0, 0
8313, 1, 1636422654830, 1636422655102, 272, 0, 272, 0, 0, 0
8311, 1, 1636422654742, 1636422655230, 488, 209, 279, 209, 0, 209
8314, 1, 1636422654978, 1636422655250, 272, 0, 272, 0, 0, 0
8315, 1, 1636422654990, 1636422655254, 264, 0, 264, 0, 0, 0
8316, 1, 1636422655190, 1636422655466, 276, 0, 276, 0, 0, 0
8317, 1, 1636422655242, 1636422655514, 272, 0, 272, 0, 0, 0
8318, 1, 1636422655282, 1636422655550, 268, 0, 268, 0, 0, 0
8319, 1, 1636422655362, 1636422655634, 272, 0, 272, 0, 0, 0
8320, 1, 1636422655366, 1636422655638, 272, 0, 272, 0, 0, 0
8321, 1, 1636422655470, 1636422655742, 272, 0, 272, 0, 0, 0
8322, 1, 1636422655550, 1636422655826, 276, 0, 276, 0, 0, 0
8324, 1, 1636422655630, 1636422655898, 268, 0, 268, 0, 0, 0
8325, 1, 1636422655762, 1636422656034, 272, 0, 272, 0, 0, 0
8327, 1, 1636422655998, 1636422656270, 272, 0, 272, 0, 0, 0
8188, 2, 1636422646290, 1636422656290, 10000, 0, 10000, 0, 0, 0
8328, 1, 1636422656054, 1636422656338, 284, 0, 284, 0, 0, 0
8326, 1, 1636422655806, 1636422656338, 532, 229, 303, 229, 0, 229
8330, 1, 1636422656162, 1636422656434, 272, 0, 272, 0, 0, 0
8331, 1, 1636422656162, 1636422656438, 276, 0, 276, 0, 0, 0
8329, 1, 1636422656086, 1636422656542, 456, 185, 271, 185, 0, 185
8332, 1, 1636422656286, 1636422656610, 324, 53, 271, 53, 0, 53
8333, 1, 1636422656382, 1636422656646, 264, 0, 264, 0, 0, 0
8334, 1, 1636422656422, 1636422656690, 268, 0, 268, 0, 0, 0
8336, 1, 1636422656566, 1636422656838, 272, 0, 272, 0, 0, 0
8335, 1, 1636422656594, 1636422656858, 264, 0, 264, 0, 0, 0
8337, 1, 1636422656730, 1636422657002, 272, 0, 272, 0, 0, 0
8338, 1, 1636422656798, 1636422657070, 272, 0, 272, 0, 0, 0
8339, 1, 1636422656846, 1636422657122, 276, 0, 276, 0, 0, 0
8340, 1, 1636422656938, 1636422657210, 272, 0, 272, 0, 0, 0
8341, 1, 1636422656950, 1636422657222, 272, 0, 