Xid, State, StartTime, EndTime, TransactionTime, ExecuteTime, CommunicationTime, ReadTime, WriteTime, DBTime
1, 1, 1636426901348, 1636426902246, 898, 376, 522, 7, 15, 22
2, 1, 1636426902808, 1636426903626, 818, 276, 542, 2, 4, 6
3, 1, 1636426903415, 1636426904242, 827, 281, 546, 0, 3, 3
4, 1, 1636426904195, 1636426905023, 828, 283, 545, 2, 2, 4
5, 1, 1636426904859, 1636426905686, 827, 282, 545, 1, 0, 1
6, 1, 1636426905004, 1636426905807, 803, 274, 529, 1, 1, 2
7, 1, 1636426905523, 1636426906346, 823, 280, 543, 0, 3, 3
8, 1, 1636426906167, 1636426906979, 812, 275, 537, 0, 2, 2
9, 1, 1636426906714, 1636426907522, 808, 270, 538, 0, 2, 2
10, 1, 1636426906730, 1636426907566, 836, 306, 530, 0, 1, 1
12, 1, 1636426907286, 1636426908106, 820, 288, 532, 1, 0, 1
11, 1, 1636426907266, 1636426908162, 896, 347, 549, 0, 2, 2
13, 1, 1636426907818, 1636426908738, 920, 390, 530, 1, 1, 2
14, 1, 1636426908063, 1636426908874, 811, 273, 538, 0, 1, 1
15, 1, 1636426908727, 1636426909538, 811, 275, 536, 0, 1, 1
16, 1, 1636426908931, 1636426909746, 815, 278, 537, 0, 1, 1
17, 1, 1636426909436, 1636426910162, 726, 271, 455, 0, 1, 1
18, 1, 1636426909470, 1636426910198, 728, 274, 454, 1, 2, 3
19, 1, 1636426909978, 1636426910706, 728, 270, 458, 0, 1, 1
20, 1, 1636426910067, 1636426910782, 715, 271, 444, 1, 1, 2
21, 1, 1636426910469, 1636426911198, 729, 275, 454, 1, 1, 2
23, 1, 1636426910609, 1636426911318, 709, 266, 443, 0, 2, 2
22, 1, 1636426910595, 1636426911322, 727, 270, 457, 1, 2, 3
24, 1, 1636426911083, 1636426911818, 735, 287, 448, 0, 0, 0
25, 1, 1636426911118, 1636426911838, 720, 273, 447, 0, 3, 3
26, 1, 1636426911134, 1636426911858, 724, 271, 453, 1, 0, 1
27, 1, 1636426911570, 1636426912330, 760, 312, 448, 0, 1, 1
28, 1, 1636426911707, 1636426912434, 727, 270, 457, 0, 1, 1
29, 1, 1636426911818, 1636426912538, 720, 266, 454, 0, 0, 0
30, 1, 1636426912239, 1636426912954, 715, 269, 446, 1, 2, 3
31, 1, 1636426912483, 1636426913202, 719, 269, 450, 0, 2, 2
32, 1, 1636426912778, 1636426913494, 716, 275, 441, 1, 1, 2
33, 1, 1636426913051, 1636426913758, 707, 266, 441, 0, 1, 1
34, 1, 1636426913257, 1636426913930, 673, 270, 403, 0, 0, 0
35, 1, 1636426913298, 1636426914018, 720, 271, 449, 0, 2, 2
36, 1, 1636426913425, 1636426914102, 677, 271, 406, 1, 1, 2
37, 1, 1636426913754, 1636426914430, 676, 272, 404, 0, 3, 3
38, 1, 1636426913765, 1636426914554, 789, 384, 405, 0, 1, 1
39, 1, 1636426913846, 1636426914554, 708, 270, 438, 3, 0, 3
40, 1, 1636426914296, 1636426914966, 670, 265, 405, 0, 2, 2
41, 1, 1636426914374, 1636426915090, 716, 266, 450, 1, 0, 1
42, 1, 1636426914548, 1636426915218, 670, 272, 398, 1, 3, 4
43, 1, 1636426914637, 1636426915314, 677, 270, 407, 1, 1, 2
44, 1, 1636426914790, 1636426915454, 664, 271, 393, 1, 2, 3
45, 1, 1636426915085, 1636426915750, 665, 271, 394, 2, 2, 4
46, 1, 1636426915251, 1636426915926, 675, 273, 402, 2, 1, 3
47, 1, 1636426915266, 1636426915938, 672, 270, 402, 0, 1, 1
48, 1, 1636426915501, 1636426916206, 705, 304, 401, 0, 2, 2
49, 1, 1636426915950, 1636426916622, 672, 270, 402, 0, 0, 0
50, 1, 1636426915973, 1636426916658, 685, 283, 402, 0, 1, 1
51, 1, 1636426916513, 1636426917194, 681, 269, 412, 1, 1, 2
52, 1, 1636426916615, 1636426917290, 675, 269, 406, 3, 0, 3
53, 1, 1636426917246, 1636426917914, 668, 270, 398, 1, 0, 1
54, 1, 1636426917251, 1636426917922, 671, 270, 401, 0, 1, 1
55, 1, 1636426917340, 1636426918010, 670, 265, 405, 2, 0, 2
56, 1, 1636426917434, 1636426918110, 676, 270, 406, 1, 4, 5
58, 1, 1636426917659, 1636426918382, 723, 323, 400, 1, 0, 1
57, 1, 1636426917550, 1636426918462, 912, 510, 402, 0, 2, 2
59, 1, 1636426917932, 1636426918610, 678, 271, 407, 0, 2, 2
60, 1, 1636426918108, 1636426918842, 734, 327, 407, 0, 3, 3
61, 1, 1636426918462, 1636426919130, 668, 267, 401, 0, 1, 1
62, 1, 1636426918475, 1636426919150, 675, 270, 405, 0, 1, 1
63, 1, 1636426918809, 1636426919486, 677, 272, 405, 0, 3, 3
64, 1, 1636426918811, 1636426919594, 783, 381, 402, 1, 0, 1
65, 1, 1636426919090, 1636426919758, 668, 267, 401, 1, 3, 4
66, 1, 1636426919217, 1636426920050, 833, 430, 403, 1, 2, 3
67, 1, 1636426919422, 1636426920094, 672, 266, 406, 0, 1, 1
68, 1, 1636426919444, 1636426920222, 778, 375, 403, 0, 2, 2
69, 1, 1636426919889, 1636426920562, 673, 270, 403, 0, 0, 0
70, 1, 1636426920122, 1636426920802, 680, 270, 410, 0, 1, 1
71, 1, 1636426920428, 1636426921090, 662, 271, 391, 0, 2, 2
72, 1, 1636426920788, 1636426921450, 662, 266, 396, 0, 1, 1
73, 1, 1636426920966, 1636426921638, 672, 269, 403, 1, 0, 1
74, 1, 1636426921167, 1636426921838, 671, 271, 400, 0, 1, 1
76, 1, 1636426921519, 1636426922202, 683, 270, 413, 0, 2, 2
77, 1, 1636426921607, 1636426922282, 675, 270, 405, 0, 1, 1
75, 1, 1636426921475, 1636426922298, 823, 427, 396, 0, 0, 0
79, 1, 1636426921843, 1636426922654, 811, 408, 403, 0, 0, 0
78, 1, 1636426921816, 1636426922762, 946, 540, 406, 0, 0, 0
80, 1, 1636426922104, 1636426922774, 670, 270, 400, 0, 1, 1
81, 1, 1636426922647, 1636426923322, 675, 268, 407, 1, 0, 1
82, 1, 1636426922724, 1636426923394, 670, 262, 408, 1, 0, 1
83, 1, 1636426922763, 1636426923438, 675, 271, 404, 0, 1, 1
84, 1, 1636426923021, 1636426923894, 873, 471, 402, 0, 2, 2
86, 1, 1636426923336, 1636426924014, 678, 271, 407, 1, 3, 4
87, 1, 1636426923410, 1636426924090, 680, 273, 407, 0, 0, 0
85, 1, 1636426923318, 1636426924342, 1024, 627, 397, 0, 1, 1
88, 1, 1636426923445, 1636426924546, 1101, 699, 402, 0, 1, 1
90, 1, 1636426924074, 1636426924750, 676, 268, 408, 1, 0, 1
89, 1, 1636426924067, 1636426924794, 727, 326, 401, 0, 0, 0
91, 1, 1636426924507, 1636426925202, 695, 297, 398, 0, 0, 0
92, 1, 1636426924729, 1636426925398, 669, 271, 398, 1, 2, 3
93, 1, 1636426924997, 1636426925666, 669, 271, 398, 0, 2, 2
94, 1, 1636426925344, 1636426926014, 670, 271, 399, 1, 2, 3
95, 1, 1636426925521, 1636426926194, 673, 271, 402, 0, 1, 1
96, 1, 1636426925567, 1636426926238, 671, 270, 401, 0, 0, 0
97, 1, 1636426925744, 1636426926470, 726, 327, 399, 1, 0, 1
99, 1, 1636426926018, 1636426926694, 676, 269, 407, 1, 1, 2
98, 1, 1636426925905, 1636426926698, 793, 393, 400, 0, 0, 0
100, 1, 1636426926068, 1636426926922, 854, 447, 407, 0, 1, 1
101, 1, 1636426926561, 1636426927242, 681, 269, 412, 0, 1, 1
102, 1, 1636426926756, 1636426927430, 674, 270, 404, 1, 2, 3
103, 1, 1636426926935, 1636426927606, 671, 269, 402, 0, 2, 2
105, 1, 1636426927247, 1636426927918, 671, 271, 400, 0, 1, 1
108, 1, 1636426927368, 1636426928038, 670, 272, 398, 0, 3, 3
106, 1, 1636426927360, 1636426928378, 1018, 614, 404, 0, 1, 1
109, 1, 1636426928105, 1636426928786, 681, 272, 409, 1, 3, 4
111, 1, 1636426928783, 1636426929454, 671, 274, 397, 0, 1, 1
113, 1, 1636426929053, 1636426929730, 677, 270, 407, 0, 1, 1
114, 1, 1636426929480, 1636426930162, 682, 270, 412, 0, 0, 0
116, 1, 1636426929553, 1636426930230, 677, 271, 406, 0, 1, 1
117, 1, 1636426929744, 1636426930622, 878, 469, 409, 0, 0, 0
119, 1, 1636426930050, 1636426930722, 672, 270, 402, 0, 0, 0
121, 1, 1636426930811, 1636426931474, 663, 269, 394, 1, 0, 1
122, 1, 1636426930849, 1636426931526, 677, 271, 406, 2, 0, 2
123, 1, 1636426930875, 1636426931538, 663, 267, 396, 2, 1, 3
124, 1, 1636426931279, 1636426931998, 719, 313, 406, 0, 0, 0
125, 1, 1636426931423, 1636426932098, 675, 272, 403, 1, 0, 1
126, 1, 1636426931611, 1636426932450, 839, 443, 396, 0, 2, 2
127, 1, 1636426932390, 1636426933070, 680, 272, 408, 1, 2, 3
128, 1, 1636426932839, 1636426933526, 687, 288, 399, 1, 2, 3
129, 1, 1636426933129, 1636426933810, 681, 271, 410, 2, 3, 5
130, 1, 1636426933608, 1636426934282, 674, 270, 404, 0, 2, 2
131, 1, 1636426933792, 1636426934474, 682, 279, 403, 0, 0, 0
133, 1, 1636426934105, 1636426934782, 677, 269, 408, 0, 0, 0
132, 1, 1636426934044, 1636426934930, 886, 481, 405, 0, 0, 0
134, 1, 1636426934881, 1636426935554, 673, 269, 404, 0, 0, 0
135, 1, 1636426934916, 1636426935586, 670, 269, 401, 0, 0, 0
136, 1, 1636426935028, 1636426935698, 670, 270, 400, 2, 1, 3
137, 1, 1636426935291, 1636426936046, 755, 349, 406, 0, 1, 1
138, 1, 1636426935498, 1636426936178, 680, 270, 410, 1, 1, 2
139, 1, 1636426935616, 1636426936506, 890, 483, 407, 0, 1, 1
140, 1, 1636426936524, 1636426937194, 670, 270, 400, 0, 0, 0
104, 2, 1636426927041, 1636426937226, 10185, 1, 10184, 0, 1, 1
107, 2, 1636426927368, 1636426937545, 10177, 1, 10176, 0, 0, 0
141, 1, 1636426936973, 1636426937674, 701, 307, 394, 0, 30, 30
142, 1, 1636426937424, 1636426938086, 662, 264, 398, 1, 0, 1
143, 1, 1636426937685, 1636426938350, 665, 269, 396, 0, 1, 1
110, 2, 1636426928300, 1636426938473, 10173, 0, 10173, 0, 0, 0
145, 1, 1636426937782, 1636426938494, 712, 270, 442, 0, 0, 0
146, 1, 1636426938076, 1636426938750, 674, 274, 400, 0, 1, 1
147, 1, 1636426938181, 1636426938854, 673, 270, 403, 0, 1, 1
144, 1, 1636426937778, 1636426938950, 1172, 727, 445, 0, 0, 0
112, 2, 1636426928901, 1636426939081, 10180, 1, 10179, 0, 0, 0
148, 1, 1636426938336, 1636426939210, 874, 464, 410, 0, 1, 1
149, 1, 1636426938654, 1636426939438, 784, 341, 443, 0, 28, 28
150, 1, 1636426938936, 1636426939650, 714, 304, 410, 0, 1, 1
151, 1, 1636426938991, 1636426939654, 663, 272, 391, 2, 1, 3
115, 2, 1636426929516, 1636426939693, 10177, 1, 10176, 0, 0, 0
152, 1, 1636426939249, 1636426939958, 709, 308, 401, 0, 40, 40
153, 1, 1636426939262, 1636426939970, 708, 267, 441, 1, 1, 2
154, 1, 1636426939419, 1636426940138, 719, 327, 392, 1, 40, 41
118, 2, 1636426929977, 1636426940153, 10176, 1, 10175, 0, 0, 0
155, 1, 1636426939794, 1636426940510, 716, 271, 445, 0, 0, 0
157, 1, 1636426939874, 1636426940606, 732, 287, 445, 1, 12, 13
156, 1, 1636426939810, 1636426940610, 800, 398, 402, 1, 17, 18
120, 1, 1636426930361, 1636426940650, 10289, 9878, 411, 1, 1, 2
158, 1, 1636426940334, 1636426941062, 728, 291, 437, 0, 0, 0
159, 1, 1636426940568, 1636426941246, 678, 268, 410, 1, 0, 1
160, 1, 1636426940676, 1636426941522, 846, 399, 447, 0, 1, 1
161, 1, 1636426941019, 1636426941698, 679, 282, 397, 0, 1, 1
162, 1, 1636426941098, 1636426941770, 672, 266, 406, 1, 0, 1
163, 1, 1636426941571, 1636426942250, 679, 271, 408, 0, 1, 1
165, 1, 1636426941905, 1636426942578, 673, 275, 398, 0, 3, 3
164, 1, 1636426941669, 1636426942698, 1029, 631, 398, 0, 1, 1
166, 1, 1636426942152, 1636426942818, 666, 266, 400, 0, 0, 0
167, 1, 1636426942402, 1636426943074, 672, 270, 402, 0, 2, 2
168, 1, 1636426942509, 1636426943174, 665, 270, 395, 1, 0, 1
169, 1, 1636426942642, 1636426943314, 672, 270, 402, 0, 0, 0
170, 1, 1636426942951, 1636426943626, 675, 270, 405, 0, 2, 2
171, 1, 1636426943036, 1636426943702, 666, 270, 396, 0, 1, 1
172, 1, 1636426943051, 1636426943730, 679, 275, 404, 1, 1, 2
173, 1, 1636426943063, 1636426943766, 703, 306, 397, 0, 1, 1
174, 1, 1636426943623, 1636426944294, 671, 268, 403, 0, 0, 0
175, 1, 1636426943655, 1636426944318, 663, 267, 396, 0, 2, 2
176, 1, 1636426943697, 1636426944370, 673, 270, 403, 2, 0, 2
177, 1, 1636426944043, 1636426944746, 703, 302, 401, 0, 0, 0
178, 1, 1636426944122, 1636426944798, 676, 274, 402, 0, 1, 1
179, 1, 1636426944303, 1636426944978, 675, 273, 402, 1, 0, 1
180, 1, 1636426944589, 1636426945262, 673, 270, 403, 1, 1, 2
181, 1, 1636426944754, 1636426945430, 676, 276, 400, 1, 0, 1
182, 1, 1636426944888, 1636426945562, 674, 271, 403, 0, 1, 1
183, 1, 1636426945258, 1636426945926, 668, 272, 396, 1, 1, 2
185, 1, 1636426945641, 1636426946318, 677, 271, 406, 0, 3, 3
184, 1, 1636426945423, 1636426946394, 971, 558, 413, 0, 0, 0
186, 1, 1636426946137, 1636426946810, 673, 271, 402, 1, 0, 1
187, 1, 1636426946337, 1636426947006, 669, 269, 400, 1, 1, 2
188, 1, 1636426946373, 1636426947050, 677, 271, 406, 0, 2, 2
189, 1, 1636426946710, 1636426947374, 664, 270, 394, 1, 1, 2
191, 1, 1636426946741, 1636426947418, 677, 272, 405, 0, 2, 2
190, 1, 1636426946738, 1636426947458, 720, 314, 406, 0, 2, 2
192, 1, 1636426946863, 1636426947542, 679, 271, 408, 0, 1, 1
193, 1, 1636426947107, 1636426947998, 891, 488, 403, 0, 1, 1
194, 1, 1636426947358, 1636426948034, 676, 274, 402, 0, 1, 1
195, 1, 1636426947483, 1636426948162, 679, 271, 408, 0, 0, 0
196, 1, 1636426947487, 1636426948162, 675, 271, 404, 0, 1, 1
197, 1, 1636426947744, 1636426948486, 742, 346, 396, 0, 1, 1
198, 1, 1636426947820, 1636426948614, 794, 398, 396, 0, 0, 0
199, 1, 1636426948093, 1636426948770, 677, 271, 406, 0, 1, 1
200, 1, 1636426948277, 1636426949066, 789, 385, 404, 1, 0, 1
201, 1, 1636426948544, 1636426949234, 690, 287, 403, 0, 2, 2
202, 1, 1636426948735, 1636426949410, 675, 269, 406, 1, 0, 1
203, 1, 1636426949164, 1636426949834, 670, 268, 402, 0, 2, 2
205, 1, 1636426949431, 1636426950102, 671, 272, 399, 0, 2, 2
204, 1, 1636426949175, 1636426950294, 1119, 714, 405, 1, 0, 1
206, 1, 1636426949927, 1636426950602, 675, 270, 405, 0, 1, 1
207, 1, 1636426950108, 1636426950778, 670, 268, 402, 0, 1, 1
208, 1, 1636426950208, 1636426950882, 674, 270, 404, 0, 0, 0
211, 1, 1636426950590, 1636426951254, 664, 260, 404, 0, 0, 0
210, 1, 1636426950588, 1636426951266, 678, 266, 412, 0, 0, 0
209, 1, 1636426950445, 1636426951334, 889, 494, 395, 0, 1, 1
214, 1, 1636426951149, 1636426951838, 689, 278, 411, 1, 2, 3
215, 1, 1636426951256, 1636426951930, 674, 270, 404, 1, 0, 1
217, 1, 1636426951425, 1636426952294, 869, 468, 401, 1, 2, 3
218, 1, 1636426951811, 1636426952486, 675, 271, 404, 0, 1, 1
220, 1, 1636426952268, 1636426952942, 674, 269, 405, 1, 1, 2
222, 1, 1636426952787, 1636426953458, 671, 271, 400, 0, 0, 0
223, 1, 1636426952861, 1636426953538, 677, 270, 407, 0, 0, 0
224, 1, 1636426953108, 1636426953990, 882, 486, 396, 0, 1, 1
227, 1, 1636426953898, 1636426954570, 672, 271, 401, 0, 2, 2
228, 1, 1636426953905, 1636426954586, 681, 271, 410, 0, 1, 1
229, 1, 1636426954336, 1636426955042, 706, 302, 404, 0, 1, 1
231, 1, 1636426954641, 1636426955314, 673, 271, 402, 0, 1, 1
232, 1, 1636426954953, 1636426955630, 677, 270, 407, 1, 1, 2
235, 1, 1636426955508, 1636426956186, 678, 271, 407, 0, 3, 3
236, 1, 1636426955965, 1636426956646, 681, 271, 410, 1, 2, 3
237, 1, 1636426956573, 1636426957246, 673, 271, 402, 1, 1, 2
238, 1, 1636426956670, 1636426957346, 676, 271, 405, 0, 1, 1
239, 1, 1636426956910, 1636426957794, 884, 487, 397, 1, 2, 3
240, 1, 1636426957735, 1636426958406, 671, 271, 400, 1, 1, 2
242, 1, 1636426958308, 1636426958982, 674, 271, 403, 2, 0, 2
243, 1, 1636426958427, 1636426959106, 679, 271, 408, 1, 1, 2
244, 1, 1636426958762, 1636426959426, 664, 265, 399, 0, 1, 1
245, 1, 1636426959317, 1636426959990, 673, 270, 403, 0, 1, 1
246, 1, 1636426959794, 1636426960474, 680, 270, 410, 0, 1, 1
212, 2, 1636426950599, 1636426960777, 10178, 0, 10178, 0, 1, 1
213, 2, 1636426950986, 1636426961165, 10179, 1, 10178, 0, 0, 0
247, 1, 1636426960777, 1636426961458, 681, 271, 410, 1, 2, 3
216, 2, 1636426951335, 1636426961513, 10178, 1, 10177, 1, 0, 1
248, 1, 1636426960867, 1636426961534, 667, 265, 402, 0, 0, 0
249, 1, 1636426960990, 1636426961986, 996, 600, 396, 47, 1, 48
219, 2, 1636426951940, 1636426962117, 10177, 0, 10177, 1, 0, 1
252, 1, 1636426961690, 1636426962410, 720, 270, 450, 0, 0, 0
221, 2, 1636426952538, 1636426962709, 10171, 1, 10170, 0, 0, 0
254, 1, 1636426962302, 1636426963022, 720, 272, 448, 0, 1, 1
255, 1, 1636426962442, 1636426963170, 728, 318, 410, 0, 43, 43
225, 2, 1636426953278, 1636426963457, 10179, 1, 10178, 0, 0, 0
257, 1, 1636426962891, 1636426963598, 707, 269, 438, 0, 1, 1
226, 2, 1636426953774, 1636426963954, 10180, 1, 10179, 1, 0, 1
260, 1, 1636426963646, 1636426964410, 764, 274, 490, 3, 2, 5
230, 2, 1636426954406, 1636426964581, 10175, 1, 10174, 0, 0, 0
262, 1, 1636426964134, 1636426964866, 732, 281, 451, 1, 0, 1
263, 1, 1636426964631, 1636426965298, 667, 270, 397, 0, 1, 1
233, 2, 1636426955141, 1636426965317, 10176, 1, 10175, 0, 0, 0
264, 1, 1636426964770, 1636426965482, 712, 268, 444, 1, 1, 2
234, 2, 1636426955352, 1636426965535, 10183, 1, 10182, 0, 0, 0
265, 1, 1636426964897, 1636426965586, 689, 285, 404, 0, 16, 16
266, 1, 1636426965101, 1636426966034, 933, 535, 398, 0, 1, 1
241, 1, 1636426957745, 1636426966034, 8289, 7882, 407, 0, 1, 1
267, 1, 1636426965536, 1636426966254, 718, 271, 447, 1, 1, 2
269, 1, 1636426965807, 1636426966482, 675, 270, 405, 0, 0, 0
268, 1, 1636426965722, 1636426966702, 980, 546, 434, 0, 0, 0
271, 1, 1636426966350, 1636426967030, 680, 268, 412, 0, 0, 0
272, 1, 1636426966419, 1636426967098, 679, 270, 409, 1, 1, 2
270, 1, 1636426966054, 1636426967158, 1104, 655, 449, 1, 0, 1
273, 1, 1636426967163, 1636426967842, 679, 272, 407, 0, 0, 0
274, 1, 1636426967834, 1636426968510, 676, 267, 409, 0, 0, 0
275, 1, 1636426968357, 1636426969030, 673, 270, 403, 0, 0, 0
276, 1, 1636426968412, 1636426969086, 674, 271, 403, 1, 0, 1
277, 1, 1636426969041, 1636426969710, 669, 270, 399, 1, 0, 1
278, 1, 1636426969069, 1636426969742, 673, 271, 402, 0, 1, 1
279, 1, 1636426969112, 1636426970206, 1094, 688, 406, 0, 0, 0
280, 1, 1636426969690, 1636426970366, 676, 271, 405, 1, 1, 2
281, 1, 1636426969768, 1636426970434, 666, 269, 397, 1, 0, 1
283, 1, 1636426970130, 1636426970802, 672, 268, 404, 0, 0, 0
282, 1, 1636426969966, 1636426970814, 848, 453, 395, 0, 0, 0
285, 1, 1636426970263, 1636426970938, 675, 269, 406, 0, 1, 1
284, 1, 1636426970162, 1636426971266, 1104, 703, 401, 0, 1, 1
250, 2, 1636426961402, 1636426971649, 10247, 0, 10247, 0, 1, 1
286, 1, 1636426971007, 1636426971674, 667, 270, 397, 0, 1, 1
251, 2, 1636426961402, 1636426971697, 10295, 1, 10294, 0, 0, 0
253, 2, 1636426961933, 1636426972109, 10176, 0, 10176, 1, 0, 1
287, 1, 1636426971795, 1636426972466, 671, 270, 401, 0, 4, 4
256, 2, 1636426962505, 1636426972685, 10180, 0, 10180, 0, 0, 0
291, 1, 1636426972317, 1636426972998, 681, 271, 410, 1, 2, 3
258, 2, 1636426962943, 1636426973121, 10178, 0, 10178, 0, 0, 0
292, 1, 1636426972708, 1636426973394, 686, 286, 400, 1, 13, 14
294, 1, 1636426973002, 1636426973674, 672, 269, 403, 2, 0, 2
259, 2, 1636426963515, 1636426973689, 10174, 1, 10173, 1, 1, 2
296, 1, 1636426973285, 1636426973954, 669, 274, 395, 2, 4, 6
261, 1, 1636426964057, 1636426974182, 10125, 9722, 403, 2, 1, 3
298, 1, 1636426973690, 1636426974318, 628, 271, 357, 0, 0, 0
299, 1, 1636426973692, 1636426974366, 674, 274, 400, 1, 0, 1
297, 1, 1636426973351, 1636426974402, 1051, 655, 396, 0, 1, 1
302, 1, 1636426973956, 1636426974778, 822, 425, 397, 0, 0, 0
303, 1, 1636426974107, 1636426974822, 715, 314, 401, 1, 1, 2
305, 1, 1636426974427, 1636426975098, 671, 270, 401, 1, 0, 1
301, 1, 1636426973902, 1636426975230, 1328, 930, 398, 0, 1, 1
306, 1, 1636426974811, 1636426975482, 671, 268, 403, 1, 0, 1
307, 1, 1636426975640, 1636426976314, 674, 271, 403, 0, 2, 2
308, 1, 1636426976176, 1636426976846, 670, 269, 401, 1, 0, 1
309, 1, 1636426976817, 1636426977494, 677, 268, 409, 0, 0, 0
310, 1, 1636426976861, 1636426977534, 673, 269, 404, 0, 0, 0
311, 1, 1636426976996, 1636426977662, 666, 269, 397, 0, 0, 0
312, 1, 1636426977160, 1636426978130, 970, 562, 408, 1, 0, 1
313, 1, 1636426977576, 1636426978246, 670, 272, 398, 3, 0, 3
316, 1, 1636426977961, 1636426978638, 677, 271, 406, 0, 1, 1
315, 1, 1636426977821, 1636426978698, 877, 478, 399, 0, 0, 0
317, 1, 1636426978323, 1636426979094, 771, 365, 406, 0, 0, 0
318, 1, 1636426978468, 1636426979138, 670, 270, 400, 1, 0, 1
314, 1, 1636426977703, 1636426979150, 1447, 1046, 401, 1, 0, 1
319, 1, 1636426979080, 1636426979754, 674, 269, 405, 0, 0, 0
320, 1, 1636426979909, 1636426980586, 677, 270, 407, 0, 3, 3
321, 1, 1636426980444, 1636426981118, 674, 270, 404, 1, 2, 3
322, 1, 1636426980595, 1636426981266, 671, 271, 400, 0, 0, 0
323, 1, 1636426980919, 1636426981594, 675, 270, 405, 1, 0, 1
324, 1, 1636426981130, 1636426981802, 672, 269, 403, 1, 1, 2
325, 1, 1636426981140, 1636426982046, 906, 501, 405, 0, 0, 0
289, 2, 1636426972109, 1636426982329, 10220, 0, 10220, 0, 0, 0
288, 2, 1636426972109, 1636426982377, 10268, 0, 10268, 0, 1, 1
290, 2, 1636426972246, 1636426982469, 10223, 1, 10222, 0, 1, 1
326, 1, 1636426981812, 1636426982482, 670, 270, 400, 0, 0, 0
329, 1, 1636426982218, 1636426982922, 704, 274, 430, 0, 3, 3
330, 1, 1636426982246, 1636426983006, 760, 360, 400, 47, 48, 95
293, 2, 1636426972822, 1636426983045, 10223, 0, 10223, 0, 0, 0
331, 1, 1636426982469, 1636426983182, 713, 270, 443, 1, 0, 1
333, 1, 1636426982525, 1636426983402, 877, 478, 399, 0, 28, 28
295, 2, 1636426973250, 1636426983473, 10223, 1, 10222, 0, 0, 0
336, 1, 1636426983338, 1636426984010, 672, 265, 407, 0, 0, 0
300, 2, 1636426973823, 1636426984038, 10215, 1, 10214, 1, 0, 1
304, 1, 1636426974184, 1636426984534, 10350, 9898, 452, 1, 1, 2
338, 1, 1636426984166, 1636426984838, 672, 269, 403, 0, 0, 0
341, 1, 1636426984589, 1636426985266, 677, 274, 403, 0, 1, 1
342, 1, 1636426984701, 1636426985374, 673, 272, 401, 1, 1, 2
344, 1, 1636426985388, 1636426986058, 670, 271, 399, 0, 2, 2
346, 1, 1636426985976, 1636426986646, 670, 270, 400, 0, 1, 1
347, 1, 1636426986069, 1636426986734, 665, 265, 400, 0, 0, 0
348, 1, 1636426986246, 1636426986922, 676, 270, 406, 0, 1, 1
353, 1, 1636426988510, 1636426989182, 672, 270, 402, 0, 0, 0
356, 1, 1636426989898, 1636426990570, 672, 269, 403, 0, 1, 1
358, 1, 1636426990209, 1636426990882, 673, 266, 407, 0, 1, 1
327, 2, 1636426981845, 1636426992025, 10180, 1, 10179, 0, 0, 0
328, 2, 1636426981981, 1636426992157, 10176, 1, 10175, 1, 0, 1
332, 2, 1636426982470, 1636426992693, 10223, 0, 10223, 0, 0, 0
334, 2, 1636426982598, 1636426992821, 10223, 1, 10222, 0, 0, 0
359, 1, 1636426992467, 1636426993186, 719, 318, 401, 0, 55, 55
335, 2, 1636426983182, 1636426993401, 10219, 0, 10219, 0, 0, 0
337, 2, 1636426983606, 1636426993829, 10223, 1, 10222, 1, 0, 1
339, 2, 1636426984170, 1636426994385, 10215, 0, 10215, 0, 0, 0
365, 1, 1636426993853, 1636426994530, 677, 269, 408, 0, 0, 0
340, 1, 1636426984536, 1636426994874, 10338, 9895, 443, 1, 0, 1
367, 1, 1636426994200, 1636426994874, 674, 271, 403, 0, 1, 1
343, 2, 1636426985187, 1636426995361, 10174, 1, 10173, 1, 0, 1
345, 1, 1636426985405, 1636426995862, 10457, 10045, 412, 0, 0, 0
349, 2, 1636426986268, 1636426996445, 10177, 1, 10176, 0, 1, 1
350, 2, 1636426986658, 1636426996837, 10179, 1, 10178, 0, 0, 0
372, 1, 1636426996534, 1636426997214, 680, 275, 405, 0, 2, 2
351, 2, 1636426987367, 1636426997541, 10174, 1, 10173, 0, 0, 0
373, 1, 1636426997014, 1636426997726, 712, 263, 449, 1, 0, 1
374, 1, 1636426997018, 1636426997726, 708, 266, 442, 0, 1, 1
375, 1, 1636426997678, 1636426998386, 708, 268, 440, 0, 0, 0
352, 2, 1636426988247, 1636426998421, 10174, 0, 10174, 0, 0, 0
376, 1, 1636426997953, 1636426998630, 677, 270, 407, 0, 0, 0
377, 1, 1636426998159, 1636426998870, 711, 314, 397, 0, 44, 44
354, 2, 1636426988782, 1636426998961, 10179, 0, 10179, 0, 0, 0
378, 1, 1636426998554, 1636426999274, 720, 272, 448, 1, 1, 2
355, 2, 1636426989469, 1636426999645, 10176, 1, 10175, 0, 0, 0
379, 1, 1636426999094, 1636426999810, 716, 269, 447, 0, 0, 0
357, 1, 1636426990194, 1636427000142, 9948, 9542, 406, 0, 1, 1
380, 1, 1636426999779, 1636427000482, 703, 265, 438, 1, 0, 1
381, 1, 1636427000144, 1636427000938, 794, 349, 445, 0, 1, 1
382, 1, 1636427000670, 1636427001342, 672, 270, 402, 0, 1, 1
383, 1, 1636427001258, 1636427001930, 672, 268, 404, 0, 0, 0
384, 1, 1636427001290, 1636427001962, 672, 270, 402, 0, 1, 1
385, 1, 1636427001649, 1636427002386, 737, 339, 398, 0, 1, 1
361, 2, 1636426992571, 1636427002785, 10214, 0, 10214, 1, 0, 1
386, 1, 1636427002121, 1636427002793, 672, 270, 402, 0, 0, 0
387, 1, 1636427002156, 1636427002821, 665, 270, 395, 0, 1, 1
360, 2, 1636426992570, 1636427002829, 10259, 0, 10259, 0, 0, 0
388, 1, 1636427002514, 1636427003186, 672, 271, 401, 0, 3, 3
362, 2, 1636426993274, 1636427003493, 10219, 0, 10219, 0, 0, 0
363, 2, 1636426993275, 1636427003541, 10266, 1, 10265, 1, 0, 1
364, 2, 1636426993530, 1636427003749, 10219, 1, 10218, 0, 0, 0
391, 1, 1636427003051, 1636427003806, 755, 310, 445, 0, 44, 44
366, 2, 1636426993962, 1636427004185, 10223, 1, 10222, 0, 0, 0
393, 1, 1636427003631, 1636427004382, 751, 269, 482, 1, 0, 1
395, 1, 1636427004000, 1636427004666, 666, 269, 397, 0, 0, 0
368, 2, 1636426994514, 1636427004729, 10215, 0, 10215, 0, 0, 0
394, 1, 1636427003882, 1636427004834, 952, 507, 445, 1, 1, 2
398, 1, 1636427004347, 1636427005022, 675, 269, 406, 1, 0, 1
396, 1, 1636427004252, 1636427005126, 874, 470, 404, 0, 1, 1
369, 1, 1636426994876, 1636427005226, 10350, 9903, 447, 1, 0, 1
370, 2, 1636426995498, 1636427005713, 10215, 1, 10214, 1, 0, 1
400, 1, 1636427005163, 1636427005834, 671, 269, 402, 0, 0, 0
402, 1, 1636427005251, 1636427005918, 667, 271, 396, 0, 0, 0
371, 1, 1636426995883, 1636427006206, 10323, 9880, 443, 1, 1, 2
403, 1, 1636427005441, 1636427006286, 845, 447, 398, 0, 1, 1
404, 1, 1636427005834, 1636427006510, 676, 267, 409, 0, 0, 0
407, 1, 1636427006418, 1636427007094, 676, 270, 406, 0, 0, 0
408, 1, 1636427006438, 1636427007118, 680, 269, 411, 0, 1, 1
409, 1, 1636427006943, 1636427007618, 675, 271, 404, 1, 2, 3
410, 1, 1636427007815, 1636427008482, 667, 271, 396, 0, 1, 1
412, 1, 1636427008001, 1636427008686, 685, 271, 414, 1, 2, 3
414, 1, 1636427008106, 1636427008786, 680, 279, 401, 0, 0, 0
411, 1, 1636427007964, 1636427008934, 970, 565, 405, 1, 0, 1
413, 1, 1636427008035, 1636427009138, 1103, 699, 404, 0, 2, 2
415, 1, 1636427009045, 1636427009722, 677, 270, 407, 1, 1, 2
417, 1, 1636427009175, 1636427009850, 675, 272, 403, 1, 1, 2
416, 1, 1636427009167, 1636427010178, 1011, 611, 400, 0, 0, 0
418, 1, 1636427009592, 1636427010262, 670, 272, 398, 0, 1, 1
419, 1, 1636427010146, 1636427010822, 676, 269, 407, 0, 0, 0
420, 1, 1636427010303, 1636427010974, 671, 270, 401, 2, 0, 2
421, 1, 1636427010826, 1636427011507, 681, 270, 411, 1, 0, 1
422, 1, 1636427011626, 1636427012298, 672, 270, 402, 1, 0, 1
423, 1, 1636427011699, 1636427012370, 671, 274, 397, 0, 0, 0
424, 1, 1636427011752, 1636427012750, 998, 603, 395, 1, 1, 2
425, 1, 1636427012033, 1636427012830, 797, 390, 407, 1, 1, 2
426, 1, 1636427012318, 1636427012990, 672, 268, 404, 1, 0, 1
390, 2, 1636427002914, 1636427013129, 10215, 1, 10214, 1, 1, 2
389, 2, 1636427002914, 1636427013173, 10259, 1, 10258, 0, 1, 1
392, 2, 1636427003630, 1636427013889, 10259, 0, 10259, 0, 0, 0
427, 1, 1636427013244, 1636427013914, 670, 269, 401, 1, 1, 2
428, 1, 1636427013262, 1636427013966, 704, 270, 434, 0, 0, 0
431, 1, 1636427013443, 1636427014166, 723, 315, 408, 0, 44, 44
430, 1, 1636427013338, 1636427014374, 1036, 631, 405, 1, 0, 1
429, 1, 1636427013263, 1636427014418, 1155, 717, 438, 2, 0, 2
432, 1, 1636427013804, 1636427014478, 674, 272, 402, 0, 1, 1
397, 2, 1636427004322, 1636427014545, 10223, 1, 10222, 1, 0, 1
433, 1, 1636427013992, 1636427014670, 678, 270, 408, 1, 1, 2
399, 2, 1636427004862, 1636427015072, 10210, 1, 10209, 0, 0, 0
434, 1, 1636427014597, 1636427015270, 673, 271, 402, 1, 0, 1
401, 1, 1636427005228, 1636427015562, 10334, 9885, 449, 0, 1, 1
435, 1, 1636427014888, 1636427015726, 838, 435, 403, 0, 1, 1
405, 2, 1636427005854, 1636427016069, 10215, 1, 10214, 0, 0, 0
440, 1, 1636427015600, 1636427016274, 674, 270, 404, 0, 0, 0
406, 1, 1636427006207, 1636427016558, 10351, 9906, 445, 1, 0, 1
442, 1, 1636427015991, 1636427016698, 707, 273, 434, 0, 0, 0
441, 1, 1636427015651, 1636427016722, 1071, 671, 400, 0, 0, 0
443, 1, 1636427016202, 1636427016914, 712, 274, 438, 0, 0, 0
445, 1, 1636427016396, 1636427017062, 666, 268, 398, 0, 0, 0
444, 1, 1636427016295, 1636427017150, 855, 456, 399, 1, 0, 1
446, 1, 1636427016559, 1636427017374, 815, 367, 448, 1, 0, 1
448, 1, 1636427017387, 1636427018054, 667, 269, 398, 1, 0, 1
450, 1, 1636427017478, 1636427018150, 672, 274, 398, 1, 0, 1
452, 1, 1636427017838, 1636427018506, 668, 270, 398, 1, 0, 1
451, 1, 1636427017545, 1636427018510, 965, 562, 403, 1, 0, 1
453, 1, 1636427017883, 1636427018550, 667, 266, 401, 0, 1, 1
454, 1, 1636427018740, 1636427019414, 674, 268, 406, 0, 0, 0
455, 1, 1636427019200, 1636427019874, 674, 271, 403, 1, 1, 2
456, 1, 1636427019918, 1636427020586, 668, 266, 402, 2, 1, 3
458, 1, 1636427020147, 1636427020814, 667, 268, 399, 1, 0, 1
460, 1, 1636427020233, 1636427020902, 669, 268, 401, 1, 0, 1
457, 1, 1636427019924, 1636427021038, 1114, 710, 404, 1, 0, 1
461, 1, 1636427020591, 1636427021262, 671, 271, 400, 0, 2, 2
463, 1, 1636427021185, 1636427021858, 673, 272, 401, 0, 2, 2
466, 1, 1636427021569, 1636427022242, 673, 271, 402, 0, 3, 3
464, 1, 1636427021252, 1636427022314, 1062, 662, 400, 0, 1, 1
467, 1, 1636427021720, 1636427022390, 670, 270, 400, 0, 1, 1
468, 1, 1636427022506, 1636427023178, 672, 270, 402, 0, 1, 1
469, 1, 1636427022965, 1636427023642, 677, 274, 403, 0, 2, 2
470, 1, 1636427023775, 1636427024446, 671, 271, 400, 0, 1, 1
472, 1, 1636427023946, 1636427024618, 672, 270, 402, 0, 1, 1
473, 1, 1636427024183, 1636427024854, 671, 268, 403, 2, 2, 4
471, 1, 1636427023817, 1636427024902, 1085, 683, 402, 2, 0, 2
474, 1, 1636427024355, 1636427025074, 719, 318, 401, 0, 1, 1
436, 2, 1636427014926, 1636427025146, 10220, 1, 10219, 1, 0, 1
437, 2, 1636427014927, 1636427025193, 10266, 1, 10265, 0, 1, 1
438, 2, 1636427015210, 1636427025426, 10216, 1, 10215, 0, 1, 1
439, 2, 1636427015564, 1636427025785, 10221, 1, 10220, 0, 0, 0
478, 1, 1636427025427, 1636427026054, 627, 269, 358, 1, 0, 1
480, 1, 1636427025671, 1636427026350, 679, 275, 404, 0, 1, 1
481, 1, 1636427025716, 1636427026414, 698, 270, 428, 0, 1, 1
477, 1, 1636427025426, 1636427026510, 1084, 674, 410, 0, 1, 1
483, 1, 1636427026701, 1636427027374, 673, 274, 399, 1, 1, 2
447, 2, 1636427017355, 1636427027529, 10174, 1, 10173, 0, 1, 1
449, 2, 1636427017419, 1636427027597, 10178, 0, 10178, 0, 0, 0
484, 1, 1636427027160, 1636427027866, 706, 302, 404, 0, 36, 36
485, 1, 1636427027598, 1636427028270, 672, 270, 402, 1, 0, 1
487, 1, 1636427027686, 1636427028398, 712, 274, 438, 0, 2, 2
489, 1, 1636427027972, 1636427028646, 674, 270, 404, 0, 1, 1
486, 1, 1636427027654, 1636427028730, 1076, 666, 410, 1, 0, 1
490, 1, 1636427028140, 1636427028802, 662, 266, 396, 0, 2, 2
488, 1, 1636427027727, 1636427028842, 1115, 682, 433, 0, 1, 1
491, 1, 1636427028477, 1636427029258, 781, 374, 407, 1, 0, 1
492, 1, 1636427029358, 1636427030034, 676, 271, 405, 2, 1, 3
493, 1, 1636427029643, 1636427030314, 671, 270, 401, 0, 0, 0
494, 1, 1636427029665, 1636427030338, 673, 268, 405, 0, 0, 0
459, 2, 1636427020188, 1636427030361, 10173, 0, 10173, 0, 0, 0
495, 1, 1636427029699, 1636427030810, 1111, 717, 394, 1, 20, 21
462, 2, 1636427020675, 1636427030853, 10178, 1, 10177, 0, 0, 0
496, 1, 1636427030494, 1636427031214, 720, 282, 438, 0, 12, 12
465, 1, 1636427021559, 1636427031342, 9783, 9386, 397, 1, 0, 1
498, 1, 1636427031020, 1636427031690, 670, 271, 399, 1, 0, 1
497, 1, 1636427030982, 1636427031706, 724, 278, 446, 1, 1, 2
499, 1, 1636427031246, 1636427032134, 888, 491, 397, 1, 0, 1
500, 1, 1636427031368, 1636427032154, 786, 342, 444, 2, 0, 2
503, 1, 1636427031908, 1636427032574, 666, 268, 398, 1, 0, 1
502, 1, 1636427031786, 1636427032610, 824, 424, 400, 1, 1, 2
505, 1, 1636427032127, 1636427032802, 675, 272, 403, 0, 0, 0
504, 1, 1636427031932, 1636427033026, 1094, 693, 401, 0, 0, 0
501, 1, 1636427031721, 1636427033066, 1345, 944, 401, 0, 1, 1
506, 1, 1636427032469, 1636427033142, 673, 271, 402, 0, 1, 1
507, 1, 1636427032752, 1636427033602, 850, 445, 405, 0, 0, 0
508, 1, 1636427033513, 1636427034186, 673, 269, 404, 1, 1, 2
509, 1, 1636427033574, 1636427034246, 672, 270, 402, 0, 0, 0
510, 1, 1636427033581, 1636427034254, 673, 269, 404, 0, 0, 0
511, 1, 1636427033654, 1636427034710, 1056, 651, 405, 0, 1, 1
512, 1, 1636427034455, 1636427035122, 667, 271, 396, 1, 0, 1
476, 2, 1636427025283, 1636427035506, 10223, 1, 10222, 1, 1, 2
475, 2, 1636427025282, 1636427035553, 10271, 0, 10271, 0, 1, 1
513, 1, 1636427034933, 1636427035594, 661, 268, 393, 1, 1, 2
514, 1, 1636427034940, 1636427035602, 662, 265, 397, 0, 0, 0
479, 2, 1636427025558, 1636427035773, 10215, 0, 10215, 1, 0, 1
515, 1, 1636427034972, 1636427036050, 1078, 674, 404, 1, 1, 2
516, 1, 1636427035382, 1636427036134, 752, 311, 441, 1, 44, 45
482, 1, 1636427025970, 1636427036270, 10300, 9848, 452, 0, 1, 1
519, 1, 1636427035805, 1636427036478, 673, 269, 404, 1, 0, 1
520, 1, 1636427035807, 1636427036586, 779, 378, 401, 1, 0, 1
523, 1, 1636427035929, 1636427036598, 669, 267, 402, 0, 2, 2
522, 1, 1636427035907, 1636427036934, 1027, 624, 403, 1, 0, 1
524, 1, 1636427035999, 1636427037034, 1035, 634, 401, 0, 0, 0
526, 1, 1636427036382, 1636427037050, 668, 269, 399, 0, 1, 1
527, 1, 1636427036515, 1636427037502, 987, 586, 401, 0, 1, 1
528, 1, 1636427037314, 1636427037990, 676, 271, 405, 1, 1, 2
529, 1, 1636427037435, 1636427038106, 671, 269, 402, 0, 0, 0
531, 1, 1636427037758, 1636427038426, 668, 265, 403, 1, 0, 1
530, 1, 1636427037628, 1636427038558, 930, 530, 400, 0, 1, 1
532, 1, 1636427038455, 1636427039126, 671, 271, 400, 1, 1, 2
533, 1, 1636427038701, 1636427039374, 673, 271, 402, 1, 2, 3
535, 1, 1636427038940, 1636427039614, 674, 271, 403, 1, 1, 2
534, 1, 1636427038781, 1636427039830, 1049, 641, 408, 1, 0, 1
536, 1, 1636427039274, 1636427040066, 792, 390, 402, 1, 1, 2
538, 1, 1636427039688, 1636427040358, 670, 269, 401, 0, 0, 0
537, 1, 1636427039668, 1636427040518, 850, 455, 395, 1, 2, 3
540, 1, 1636427039971, 1636427040638, 667, 270, 397, 0, 0, 0
539, 1, 1636427039814, 1636427040814, 1000, 602, 398, 2, 1, 3
542, 1, 1636427040231, 1636427040898, 667, 268, 399, 0, 0, 0
541, 1, 1636427039999, 1636427040970, 971, 571, 400, 1, 1, 2
543, 1, 1636427040329, 1636427041354, 1025, 623, 402, 2, 3, 5
544, 1, 1636427041356, 1636427042026, 670, 271, 399, 1, 0, 1
545, 1, 1636427041481, 1636427042154, 673, 270, 403, 1, 1, 2
546, 1, 1636427041493, 1636427042162, 669, 264, 405, 0, 0, 0
547, 1, 1636427041900, 1636427042622, 722, 321, 401, 0, 0, 0
548, 1, 1636427042337, 1636427043006, 669, 271, 398, 1, 1, 2
549, 1, 1636427042760, 1636427043430, 670, 271, 399, 0, 0, 0
550, 1, 1636427042823, 1636427043494, 671, 270, 401, 0, 0, 0
552, 1, 1636427043029, 1636427043890, 861, 458, 403, 1, 1, 2
551, 1, 1636427042965, 1636427043942, 977, 578, 399, 0, 0, 0
553, 1, 1636427043644, 1636427044390, 746, 342, 404, 0, 1, 1
555, 1, 1636427043776, 1636427044442, 666, 271, 395, 1, 1, 2
556, 1, 1636427043895, 1636427044562, 667, 270, 397, 1, 0, 1
554, 1, 1636427043762, 1636427044846, 1084, 682, 402, 0, 1, 1
557, 1, 1636427043981, 1636427045022, 1041, 638, 403, 1, 0, 1
558, 1, 1636427044449, 1636427045118, 669, 270, 399, 1, 1, 2
559, 1, 1636427044583, 1636427045574, 991, 586, 405, 0, 1, 1
518, 2, 1636427035642, 1636427045865, 10223, 1, 10222, 1, 1, 2
517, 2, 1636427035642, 1636427045909, 10267, 1, 10266, 0, 1, 1
560, 1, 1636427045233, 1636427045910, 677, 269, 408, 0, 0, 0
561, 1, 1636427045239, 1636427045910, 671, 269, 402, 0, 1, 1
521, 2, 1636427035906, 1636427046125, 10219, 1, 10218, 0, 0, 0
562, 1, 1636427045651, 1636427046390, 739, 345, 394, 0, 76, 76
525, 1, 1636427036272, 1636427046630, 10358, 9907, 451, 1, 2, 3
564, 1, 1636427046003, 1636427046750, 747, 270, 477, 1, 0, 1
565, 1, 1636427046070, 1636427046842, 772, 358, 414, 1, 1, 2
567, 1, 1636427046470, 1636427047138, 668, 269, 399, 0, 0, 0
569, 1, 1636427046917, 1636427047590, 673, 271, 402, 0, 1, 1
570, 1, 1636427047001, 1636427047678, 677, 270, 407, 1, 0, 1
572, 1, 1636427047318, 1636427048046, 728, 325, 403, 1, 1, 2
571, 1, 1636427047116, 1636427048130, 1014, 610, 404, 0, 0, 0
573, 1, 1636427047623, 1636427048294, 671, 270, 401, 0, 1, 1
574, 1, 1636427047917, 1636427048602, 685, 270, 415, 0, 0, 0
575, 1, 1636427047945, 1636427048606, 661, 267, 394, 0, 1, 1
577, 1, 1636427048199, 1636427049058, 859, 460, 399, 0, 1, 1
576, 1, 1636427048028, 1636427049066, 1038, 630, 408, 1, 1, 2
578, 1, 1636427048607, 1636427049274, 667, 271, 396, 0, 1, 1
579, 1, 1636427048848, 1636427049730, 882, 481, 401, 1, 0, 1
580, 1, 1636427049116, 1636427049786, 670, 269, 401, 0, 0, 0
581, 1, 1636427049387, 1636427050054, 667, 269, 398, 0, 1, 1
582, 1, 1636427049401, 1636427050078, 677, 273, 404, 1, 0, 1
583, 1, 1636427049753, 1636427050434, 681, 279, 402, 0, 2, 2
584, 1, 1636427050069, 1636427050746, 677, 271, 406, 0, 2, 2
585, 1, 1636427050492, 1636427051158, 666, 270, 396, 1, 0, 1
586, 1, 1636427050725, 1636427051402, 677, 270, 407, 0, 1, 1
587, 1, 1636427051144, 1636427051814, 670, 270, 400, 0, 1, 1
588, 1, 1636427051261, 1636427051934, 673, 270, 403, 0, 1, 1
589, 1, 1636427051407, 1636427052262, 855, 450, 405, 0, 0, 0
590, 1, 1636427051621, 1636427052290, 669, 274, 395, 1, 0, 1
591, 1, 1636427051634, 1636427052314, 680, 270, 410, 1, 0, 1
592, 1, 1636427051968, 1636427052710, 742, 342, 400, 0, 0, 0
593, 1, 1636427052073, 1636427052746, 673, 273, 400, 1, 1, 2
595, 1, 1636427052329, 1636427053010, 681, 274, 407, 1, 1, 2
594, 1, 1636427052236, 1636427053166, 930, 531, 399, 2, 2, 4
596, 1, 1636427052540, 1636427053466, 926, 522, 404, 0, 1, 1
597, 1, 1636427053127, 1636427053794, 667, 266, 401, 0, 1, 1
598, 1, 1636427053376, 1636427054050, 674, 274, 400, 0, 1, 1
599, 1, 1636427053549, 1636427054222, 673, 271, 402, 1, 0, 1
600, 1, 1636427053768, 1636427054434, 666, 270, 396, 1, 0, 1
601, 1, 1636427053851, 1636427054522, 671, 268, 403, 0, 0, 0
602, 1, 1636427054288, 1636427054954, 666, 268, 398, 0, 0, 0
603, 1, 1636427054508, 1636427055174, 666, 269, 397, 1, 0, 1
604, 1, 1636427054909, 1636427055582, 673, 270, 403, 1, 2, 3
605, 1, 1636427055043, 1636427055714, 671, 270, 401, 0, 0, 0
606, 1, 1636427055392, 1636427056062, 670, 271, 399, 0, 2, 2
563, 2, 1636427046002, 1636427056261, 10259, 1, 10258, 0, 2, 2
566, 2, 1636427046258, 1636427056473, 10215, 1, 10214, 1, 0, 1
607, 1, 1636427055817, 1636427056530, 713, 314, 399, 2, 44, 46
608, 1, 1636427055867, 1636427056542, 675, 275, 400, 2, 0, 2
609, 1, 1636427055917, 1636427056618, 701, 303, 398, 2, 32, 34
611, 1, 1636427056070, 1636427056746, 676, 273, 403, 1, 0, 1
568, 1, 1636427046632, 1636427056962, 10330, 9885, 445, 1, 1, 2
612, 1, 1636427056268, 1636427056986, 718, 320, 398, 1, 0, 1
610, 1, 1636427056051, 1636427056990, 939, 542, 397, 0, 0, 0
613, 1, 1636427056474, 1636427057202, 728, 321, 407, 2, 1, 3
614, 1, 1636427056842, 1636427057554, 712, 271, 441, 0, 1, 1
617, 1, 1636427057090, 1636427057754, 664, 267, 397, 0, 0, 0
618, 1, 1636427057136, 1636427057802, 666, 271, 395, 0, 0, 0
615, 1, 1636427056843, 1636427058006, 1163, 722, 441, 1, 0, 1
619, 1, 1636427057565, 1636427058234, 669, 266, 403, 0, 0, 0
620, 1, 1636427057618, 1636427058290, 672, 269, 403, 0, 0, 0
621, 1, 1636427057727, 1636427058398, 671, 270, 401, 1, 0, 1
616, 1, 1636427056964, 1636427058462, 1498, 1052, 446, 0, 0, 0
622, 1, 1636427058223, 1636427058898, 675, 270, 405, 0, 2, 2
623, 1, 1636427058439, 1636427059110, 671, 271, 400, 0, 1, 1
624, 1, 1636427058757, 1636427059430, 673, 270, 403, 0, 2, 2
625, 1, 1636427059104, 1636427059774, 670, 271, 399, 0, 0, 0
626, 1, 1636427059587, 1636427060258, 671, 271, 400, 0, 1, 1
627, 1, 1636427059783, 1636427060450, 667, 270, 397, 1, 0, 1
628, 1, 1636427059996, 1636427060670, 674, 269, 405, 0, 0, 0
629, 1, 1636427060062, 1636427060730, 668, 271, 397, 0, 1, 1
630, 1, 1636427060080, 1636427060746, 666, 270, 396, 2, 0, 2
632, 1, 1636427060378, 1636427061046, 668, 269, 399, 0, 0, 0
631, 1, 1636427060350, 1636427061190, 840, 438, 402, 0, 0, 0
633, 1, 1636427060532, 1636427061202, 670, 269, 401, 0, 1, 1
634, 1, 1636427060689, 1636427061362, 673, 269, 404, 1, 1, 2
636, 1, 1636427060762, 1636427061430, 668, 269, 399, 0, 0, 0
638, 1, 1636427061154, 1636427061826, 672, 269, 403, 0, 1, 1
639, 1, 1636427061451, 1636427062122, 671, 271, 400, 0, 2, 2
640, 1, 1636427061560, 1636427062234, 674, 270, 404, 0, 1, 1
641, 1, 1636427061654, 1636427062326, 672, 269, 403, 0, 0, 0
642, 1, 1636427062217, 1636427062894, 677, 273, 404, 1, 0, 1
644, 1, 1636427062758, 1636427063418, 660, 263, 397, 0, 2, 2
643, 1, 1636427062752, 1636427063422, 670, 275, 395, 0, 1, 1
645, 1, 1636427063423, 1636427064094, 671, 271, 400, 0, 1, 1
646, 1, 1636427063455, 1636427064118, 663, 272, 391, 1, 1, 2
648, 1, 1636427063880, 1636427064546, 666, 270, 396, 0, 1, 1
647, 1, 1636427063876, 1636427064546, 670, 269, 401, 0, 0, 0
649, 1, 1636427063906, 1636427064582, 676, 270, 406, 0, 0, 0
650, 1, 1636427064050, 1636427064722, 672, 269, 403, 0, 0, 0
651, 1, 1636427064391, 1636427065066, 675, 270, 405, 0, 0, 0
652, 1, 1636427064446, 1636427065110, 664, 270, 394, 2, 0, 2
654, 1, 1636427064501, 1636427065166, 665, 266, 399, 0, 0, 0
655, 1, 1636427064533, 1636427065210, 677, 269, 408, 0, 0, 0
653, 1, 1636427064464, 1636427065518, 1054, 650, 404, 1, 1, 2
656, 1, 1636427065034, 1636427065710, 676, 274, 402, 0, 2, 2
657, 1, 1636427065450, 1636427066122, 672, 270, 402, 0, 0, 0
658, 1, 1636427065747, 1636427066418, 671, 271, 400, 2, 0, 2
659, 1, 1636427065880, 1636427066554, 674, 269, 405, 0, 0, 0
660, 1, 1636427066108, 1636427066778, 670, 270, 400, 0, 0, 0
661, 1, 1636427066558, 1636427067226, 668, 270, 398, 0, 1, 1
662, 1, 1636427066643, 1636427067310, 667, 270, 397, 1, 1, 2
663, 1, 1636427067194, 1636427067870, 676, 273, 403, 0, 0, 0
664, 1, 1636427067336, 1636427068006, 670, 269, 401, 1, 0, 1
665, 1, 1636427067570, 1636427068250, 680, 270, 410, 0, 1, 1
666, 1, 1636427067729, 1636427068406, 677, 274, 403, 1, 0, 1
667, 1, 1636427067819, 1636427068490, 671, 269, 402, 1, 0, 1
668, 1, 1636427067941, 1636427068614, 673, 271, 402, 1, 1, 2
669, 1, 1636427068271, 1636427068938, 667, 269, 398, 1, 0, 1
670, 1, 1636427068285, 1636427068962, 677, 270, 407, 0, 1, 1
671, 1, 1636427068295, 1636427068966, 671, 270, 401, 1, 0, 1
673, 1, 1636427068729, 1636427069406, 677, 275, 402, 0, 1, 1
672, 1, 1636427068304, 1636427069418, 1114, 701, 413, 0, 0, 0
674, 1, 1636427068801, 1636427069466, 665, 266, 399, 1, 1, 2
675, 1, 1636427069359, 1636427070030, 671, 271, 400, 0, 1, 1
676, 1, 1636427069789, 1636427070462, 673, 271, 402, 1, 1, 2
677, 1, 1636427070016, 1636427070690, 674, 270, 404, 1, 0, 1
678, 1, 1636427070047, 1636427070718, 671, 269, 402, 0, 0, 0
635, 2, 1636427060715, 1636427070889, 10174, 0, 10174, 1, 0, 1
637, 2, 1636427060869, 1636427071049, 10180, 0, 10180, 0, 0, 0
679, 1, 1636427070407, 1636427071074, 667, 270, 397, 0, 2, 2
680, 1, 1636427070413, 1636427071158, 745, 345, 400, 1, 12, 13
681, 1, 1636427071103, 1636427071770, 667, 268, 399, 2, 0, 2
683, 1, 1636427071190, 1636427071862, 672, 270, 402, 1, 2, 3
682, 1, 1636427071186, 1636427071898, 712, 271, 441, 0, 1, 1
685, 1, 1636427071673, 1636427072346, 673, 271, 402, 1, 2, 3
684, 1, 1636427071454, 1636427072354, 900, 455, 445, 2, 0, 2
686, 1, 1636427071787, 1636427072462, 675, 274, 401, 2, 1, 3
687, 1, 1636427071851, 1636427072522, 671, 268, 403, 0, 1, 1
688, 1, 1636427071874, 1636427072542, 668, 270, 398, 1, 1, 2
689, 1, 1636427072026, 1636427072798, 772, 369, 403, 0, 0, 0
691, 1, 1636427072355, 1636427073022, 667, 267, 400, 0, 1, 1
690, 1, 1636427072139, 1636427073262, 1123, 714, 409, 2, 0, 2
692, 1, 1636427072429, 1636427073474, 1045, 644, 401, 0, 0, 0
693, 1, 1636427072893, 1636427073574, 681, 270, 411, 0, 0, 0
694, 1, 1636427072953, 1636427073626, 673, 273, 400, 0, 0, 0
695, 1, 1636427073430, 1636427074106, 676, 268, 408, 1, 0, 1
696, 1, 1636427073568, 1636427074238, 670, 269, 401, 0, 0, 0
697, 1, 1636427074088, 1636427074758, 670, 272, 398, 1, 1, 2
698, 1, 1636427074279, 1636427074954, 675, 271, 404, 1, 1, 2
699, 1, 1636427074598, 1636427075270, 672, 268, 404, 0, 0, 0
700, 1, 1636427074625, 1636427075718, 1093, 696, 397, 1, 2, 3
701, 1, 1636427075145, 1636427075810, 665, 265, 400, 0, 0, 0
704, 1, 1636427075493, 1636427076266, 773, 370, 403, 0, 0, 0
707, 1, 1636427075945, 1636427076610, 665, 270, 395, 0, 1, 1
708, 1, 1636427076016, 1636427076686, 670, 271, 399, 1, 0, 1
711, 1, 1636427076315, 1636427076982, 667, 270, 397, 0, 1, 1
712, 1, 1636427076466, 1636427077138, 672, 270, 402, 0, 1, 1
713, 1, 1636427076914, 1636427077590, 676, 274, 402, 0, 1, 1
714, 1, 1636427077035, 1636427077714, 679, 278, 401, 0, 1, 1
715, 1, 1636427077215, 1636427077886, 671, 271, 400, 0, 1, 1
716, 1, 1636427077562, 1636427078238, 676, 272, 404, 0, 2, 2
717, 1, 1636427077872, 1636427078546, 674, 271, 403, 0, 1, 1
718, 1, 1636427078383, 1636427079050, 667, 269, 398, 1, 0, 1
719, 1, 1636427078514, 1636427079190, 676, 269, 407, 1, 0, 1
720, 1, 1636427078911, 1636427079586, 675, 272, 403, 0, 0, 0
721, 1, 1636427079001, 1636427079682, 681, 279, 402, 1, 1, 2
722, 1, 1636427079349, 1636427080138, 789, 376, 413, 0, 0, 0
723, 1, 1636427079667, 1636427080334, 667, 270, 397, 1, 1, 2
724, 1, 1636427079985, 1636427080662, 677, 269, 408, 1, 0, 1
725, 1, 1636427080099, 1636427080770, 671, 273, 398, 0, 1, 1
726, 1, 1636427080276, 1636427080950, 674, 274, 400, 0, 2, 2
727, 1, 1636427080882, 1636427081550, 668, 270, 398, 1, 1, 2
728, 1, 1636427080999, 1636427081666, 667, 267, 400, 0, 1, 1
729, 1, 1636427081085, 1636427081758, 673, 271, 402, 0, 0, 0
730, 1, 1636427081483, 1636427082154, 671, 271, 400, 1, 0, 1
731, 1, 1636427081741, 1636427082418, 677, 271, 406, 1, 0, 1
732, 1, 1636427082168, 1636427082874, 706, 306, 400, 0, 1, 1
733, 1, 1636427082676, 1636427083350, 674, 278, 396, 1, 1, 2
734, 1, 1636427082719, 1636427083386, 667, 271, 396, 2, 1, 3
735, 1, 1636427082724, 1636427083402, 678, 275, 403, 0, 0, 0
736, 1, 1636427083096, 1636427083806, 710, 305, 405, 1, 0, 1
737, 1, 1636427083657, 1636427084326, 669, 270, 399, 0, 1, 1
738, 1, 1636427084023, 1636427084690, 667, 269, 398, 1, 1, 2
739, 1, 1636427084058, 1636427084782, 724, 325, 399, 0, 0, 0
740, 1, 1636427084142, 1636427084814, 672, 267, 405, 0, 0, 0
702, 2, 1636427075248, 1636427085425, 10177, 1, 10176, 0, 0, 0
703, 2, 1636427075261, 1636427085473, 10212, 1, 10211, 0, 1, 1
741, 1, 1636427084860, 1636427085534, 674, 274, 400, 1, 1, 2
742, 1, 1636427084952, 1636427085626, 674, 267, 407, 0, 0, 0
743, 1, 1636427085008, 1636427085746, 738, 281, 457, 0, 12, 12
705, 2, 1636427075731, 1636427085909, 10178, 1, 10177, 1, 0, 1
706, 2, 1636427075920, 1636427086097, 10177, 1, 10176, 0, 1, 1
744, 1, 1636427085474, 1636427086178, 704, 303, 401, 1, 33, 34
745, 1, 1636427085665, 1636427086370, 705, 298, 407, 1, 28, 29
709, 2, 1636427076303, 1636427086481, 10178, 0, 10178, 1, 0, 1
710, 2, 1636427076303, 1636427086528, 10225, 1, 10224, 0, 0, 0
747, 1, 1636427085811, 1636427086550, 739, 287, 452, 1, 18, 19
746, 1, 1636427085810, 1636427086550, 740, 283, 457, 0, 12, 12
749, 1, 1636427086112, 1636427086886, 774, 333, 441, 1, 17, 18
748, 1, 1636427086038, 1636427087002, 964, 518, 446, 2, 0, 2
750, 1, 1636427086286, 1636427087062, 776, 310, 466, 48, 2, 50
753, 1, 1636427086640, 1636427087310, 670, 269, 401, 0, 1, 1
754, 1, 1636427086709, 1636427087382, 673, 266, 407, 0, 0, 0
752, 1, 1636427086618, 1636427087454, 836, 391, 445, 0, 1, 1
755, 1, 1636427086878, 1636427087542, 664, 271, 393, 0, 1, 1
751, 1, 1636427086618, 1636427087898, 1280, 847, 433, 0, 1, 1
756, 1, 1636427087142, 1636427087982, 840, 447, 393, 1, 1, 2
757, 1, 1636427087372, 1636427088030, 658, 265, 393, 1, 0, 1
758, 1, 1636427088007, 1636427088674, 667, 270, 397, 0, 0, 0
759, 1, 1636427088263, 1636427088930, 667, 269, 398, 0, 0, 0
760, 1, 1636427088451, 1636427089122, 671, 271, 400, 0, 1, 1
761, 1, 1636427088817, 1636427089498, 681, 271, 410, 1, 0, 1
762, 1, 1636427089115, 1636427089786, 671, 269, 402, 0, 0, 0
763, 1, 1636427089260, 1636427089930, 670, 270, 400, 0, 0, 0
764, 1, 1636427089531, 1636427090202, 671, 271, 400, 0, 2, 2
765, 1, 1636427089608, 1636427090274, 666, 270, 396, 0, 1, 1
767, 1, 1636427089799, 1636427090470, 671, 270, 401, 0, 0, 0
768, 1, 1636427089881, 1636427090546, 665, 269, 396, 2, 0, 2
766, 1, 1636427089793, 1636427090658, 865, 459, 406, 1, 1, 2
769, 1, 1636427090184, 1636427090922, 738, 338, 400, 1, 0, 1
770, 1, 1636427090247, 1636427091010, 763, 358, 405, 1, 1, 2
771, 1, 1636427090349, 1636427091038, 689, 270, 419, 0, 1, 1
773, 1, 1636427090424, 1636427091098, 674, 274, 400, 1, 0, 1
772, 1, 1636427090386, 1636427091106, 720, 322, 398, 1, 0, 1
774, 1, 1636427090498, 1636427091566, 1068, 660, 408, 0, 0, 0
775, 1, 1636427091092, 1636427091766, 674, 273, 401, 0, 0, 0
776, 1, 1636427091335, 1636427092002, 667, 270, 397, 1, 1, 2
777, 1, 1636427091340, 1636427092222, 882, 482, 400, 0, 0, 0
778, 1, 1636427091679, 1636427092454, 775, 376, 399, 0, 0, 0
779, 1, 1636427092136, 1636427092810, 674, 269, 405, 0, 0, 0
780, 1, 1636427092296, 1636427092958, 662, 269, 393, 0, 0, 0
781, 1, 1636427092516, 1636427093186, 670, 270, 400, 0, 0, 0
782, 1, 1636427092946, 1636427093618, 672, 270, 402, 0, 1, 1
783, 1, 1636427093190, 1636427093862, 672, 271, 401, 1, 2, 3
784, 1, 1636427093320, 1636427093994, 674, 271, 403, 2, 2, 4
785, 1, 1636427093610, 1636427094450, 840, 437, 403, 0, 0, 0
786, 1, 1636427093848, 1636427094514, 666, 269, 397, 0, 1, 1
787, 1, 1636427093874, 1636427094558, 684, 270, 414, 0, 0, 0
788, 1, 1636427093900, 1636427094570, 670, 273, 397, 1, 0, 1
789, 1, 1636427094228, 1636427094902, 674, 274, 400, 0, 0, 0
790, 1, 1636427094268, 1636427094938, 670, 271, 399, 2, 1, 3
791, 1, 1636427094275, 1636427095026, 751, 346, 405, 0, 2, 2
793, 1, 1636427094390, 1636427095054, 664, 265, 399, 0, 0, 0
794, 1, 1636427094417, 1636427095094, 677, 269, 408, 0, 0, 0
792, 1, 1636427094375, 1636427095362, 987, 577, 410, 1, 0, 1
795, 1, 1636427094997, 1636427095670, 673, 270, 403, 2, 1, 3
796, 1, 1636427095074, 1636427095738, 664, 269, 395, 0, 1, 1
797, 1, 1636427095137, 1636427096122, 985, 584, 401, 0, 0, 0
798, 1, 1636427095440, 1636427096186, 746, 353, 393, 1, 0, 1
799, 1, 1636427095835, 1636427096502, 667, 267, 400, 0, 0, 0
800, 1, 1636427096305, 1636427096974, 669, 270, 399, 0, 1, 1
801, 1, 1636427096645, 1636427097318, 673, 271, 402, 1, 2, 3
802, 1, 1636427096677, 1636427097350, 673, 270, 403, 0, 0, 0
803, 1, 1636427097351, 1636427098026, 675, 272, 403, 1, 2, 3
804, 1, 1636427097475, 1636427098146, 671, 271, 400, 0, 1, 1
806, 1, 1636427097780, 1636427098446, 666, 267, 399, 2, 1, 3
807, 1, 1636427097780, 1636427098450, 670, 269, 401, 0, 0, 0
805, 1, 1636427097699, 1636427098602, 903, 506, 397, 0, 0, 0
808, 1, 1636427098090, 1636427098758, 668, 270, 398, 1, 0, 1
809, 1, 1636427098255, 1636427098926, 671, 270, 401, 0, 1, 1
810, 1, 1636427098308, 1636427098982, 674, 274, 400, 1, 0, 1
811, 1, 1636427098383, 1636427099053, 670, 270, 400, 2, 0, 2
813, 1, 1636427098527, 1636427099194, 667, 270, 397, 1, 1, 2
812, 1, 1636427098400, 1636427099206, 806, 411, 395, 0, 0, 0
815, 1, 1636427098844, 1636427099506, 662, 268, 394, 0, 1, 1
814, 1, 1636427098631, 1636427099506, 875, 472, 403, 0, 1, 1
816, 1, 1636427098870, 1636427099530, 660, 260, 400, 1, 1, 2
818, 1, 1636427099121, 1636427099958, 837, 437, 400, 0, 0, 0
817, 1, 1636427098880, 1636427099982, 1102, 706, 396, 0, 0, 0
819, 1, 1636427100059, 1636427100730, 671, 267, 404, 0, 0, 0
820, 1, 1636427100146, 1636427100814, 668, 270, 398, 0, 0, 0
821, 1, 1636427100661, 1636427101338, 677, 270, 407, 2, 0, 2
822, 1, 1636427100744, 1636427101414, 670, 268, 402, 0, 0, 0
823, 1, 1636427101193, 1636427101870, 677, 270, 407, 1, 0, 1
824, 1, 1636427101277, 1636427101950, 673, 270, 403, 1, 0, 1
825, 1, 1636427101473, 1636427102141, 668, 269, 399, 1, 0, 1
827, 1, 1636427101719, 1636427102386, 667, 271, 396, 0, 1, 1
826, 1, 1636427101684, 1636427102398, 714, 314, 400, 0, 0, 0
828, 1, 1636427101949, 1636427102622, 673, 271, 402, 1, 1, 2
829, 1, 1636427102090, 1636427102758, 668, 266, 402, 0, 0, 0
830, 1, 1636427102185, 1636427102858, 673, 270, 403, 0, 0, 0
831, 1, 1636427102217, 1636427102886, 669, 269, 400, 0, 0, 0
833, 1, 1636427102395, 1636427103078, 683, 273, 410, 1, 0, 1
832, 1, 1636427102235, 1636427103210, 975, 576, 399, 0, 0, 0
834, 1, 1636427102397, 1636427103302, 905, 511, 394, 1, 0, 1
836, 1, 1636427103002, 1636427103670, 668, 265, 403, 0, 0, 0
835, 1, 1636427103002, 1636427103670, 668, 269, 399, 1, 0, 1
837, 1, 1636427103061, 1636427104114, 1053, 658, 395, 1, 0, 1
838, 1, 1636427103292, 1636427104118, 826, 435, 391, 0, 0, 0
839, 1, 1636427104240, 1636427104914, 674, 275, 399, 0, 1, 1
840, 1, 1636427104321, 1636427104990, 669, 270, 399, 0, 0, 0
841, 1, 1636427104508, 1636427105182, 674, 271, 403, 0, 1, 1
842, 1, 1636427104924, 1636427105594, 670, 270, 400, 1, 0, 1
843, 1, 1636427105229, 1636427105898, 669, 267, 402, 1, 2, 3
844, 1, 1636427105319, 1636427105982, 663, 266, 397, 0, 1, 1
845, 1, 1636427105596, 1636427106266, 670, 265, 405, 0, 0, 0
846, 1, 1636427105738, 1636427106434, 696, 297, 399, 0, 0, 0
847, 1, 1636427105771, 1636427106442, 671, 274, 397, 0, 0, 0
848, 1, 1636427106114, 1636427106786, 672, 270, 402, 0, 0, 0
849, 1, 1636427106228, 1636427106910, 682, 279, 403, 1, 0, 1
850, 1, 1636427106265, 1636427106934, 669, 271, 398, 0, 2, 2
851, 1, 1636427106287, 1636427106954, 667, 266, 401, 0, 0, 0
854, 1, 1636427106626, 1636427107302, 676, 275, 401, 0, 1, 1
852, 1, 1636427106436, 1636427107366, 930, 522, 408, 0, 0, 0
853, 1, 1636427106534, 1636427107390, 856, 454, 402, 1, 1, 2
855, 1, 1636427106955, 1636427107626, 671, 271, 400, 0, 1, 1
856, 1, 1636427107024, 1636427107694, 670, 270, 400, 0, 1, 1
857, 1, 1636427107051, 1636427108082, 1031, 628, 403, 0, 0, 0
858, 1, 1636427107224, 1636427108146, 922, 522, 400, 0, 0, 0
859, 1, 1636427108354, 1636427109026, 672, 271, 401, 0, 0, 0
860, 1, 1636427108380, 1636427109050, 670, 269, 401, 0, 0, 0
861, 1, 1636427108412, 1636427109078, 666, 269, 397, 0, 0, 0
862, 1, 1636427109066, 1636427109742, 676, 269, 407, 1, 1, 2
863, 1, 1636427109124, 1636427109798, 674, 274, 400, 0, 1, 1
864, 1, 1636427109320, 1636427109986, 666, 272, 394, 1, 1, 2
865, 1, 1636427109521, 1636427110250, 729, 329, 400, 0, 1, 1
866, 1, 1636427109678, 1636427110350, 672, 270, 402, 0, 0, 0
867, 1, 1636427109850, 1636427110522, 672, 270, 402, 0, 0, 0
868, 1, 1636427110139, 1636427110814, 675, 271, 404, 0, 1, 1
869, 1, 1636427110197, 1636427110874, 677, 269, 408, 1, 0, 1
870, 1, 1636427110240, 1636427110906, 666, 271, 395, 0, 0, 0
872, 1, 1636427110356, 1636427111034, 678, 269, 409, 1, 0, 1
871, 1, 1636427110268, 1636427111270, 1002, 606, 396, 0, 0, 0
874, 1, 1636427110758, 1636427111426, 668, 263, 405, 0, 1, 1
875, 1, 1636427110789, 1636427111466, 677, 272, 405, 0, 0, 0
876, 1, 1636427110824, 1636427111486, 662, 268, 394, 1, 0, 1
873, 1, 1636427110684, 1636427111494, 810, 400, 410, 0, 0, 0
878, 1, 1636427111024, 1636427111922, 898, 497, 401, 1, 0, 1
877, 1, 1636427110872, 1636427111942, 1070, 673, 397, 0, 0, 0
879, 1, 1636427112131, 1636427112798, 667, 270, 397, 1, 1, 2
880, 1, 1636427112285, 1636427112958, 673, 270, 403, 1, 0, 1
881, 1, 1636427112531, 1636427113190, 659, 266, 393, 1, 0, 1
882, 1, 1636427112971, 1636427113642, 671, 269, 402, 0, 1, 1
883, 1, 1636427113007, 1636427113678, 671, 265, 406, 2, 0, 2
884, 1, 1636427113440, 1636427114110, 670, 270, 400, 0, 1, 1
885, 1, 1636427113458, 1636427114134, 676, 274, 402, 0, 1, 1
886, 1, 1636427113583, 1636427114254, 671, 270, 401, 1, 0, 1
887, 1, 1636427113648, 1636427114314, 666, 270, 396, 1, 0, 1
889, 1, 1636427114025, 1636427114698, 673, 270, 403, 1, 0, 1
888, 1, 1636427114023, 1636427114698, 675, 274, 401, 1, 0, 1
890, 1, 1636427114166, 1636427114830, 664, 265, 399, 0, 0, 0
892, 1, 1636427114454, 1636427115126, 672, 269, 403, 0, 1, 1
891, 1, 1636427114199, 1636427115154, 955, 554, 401, 1, 0, 1
894, 1, 1636427114600, 1636427115270, 670, 267, 403, 0, 0, 0
893, 1, 1636427114593, 1636427115274, 681, 270, 411, 3, 0, 3
897, 1, 1636427114984, 1636427115654, 670, 269, 401, 1, 0, 1
895, 1, 1636427114730, 1636427115722, 992, 594, 398, 1, 1, 2
896, 1, 1636427114876, 1636427115730, 854, 457, 397, 0, 0, 0
898, 1, 1636427115319, 1636427116110, 791, 395, 396, 0, 1, 1
899, 1, 1636427116175, 1636427116850, 675, 269, 406, 1, 1, 2
900, 1, 1636427116452, 1636427117130, 678, 274, 404, 2, 1, 3
901, 1, 1636427116609, 1636427117282, 673, 266, 407, 0, 0, 0
902, 1, 1636427117018, 1636427117690, 672, 270, 402, 0, 0, 0
903, 1, 1636427117216, 1636427117890, 674, 272, 402, 0, 1, 1
904, 1, 1636427117295, 1636427117962, 667, 265, 402, 0, 0, 0
905, 1, 1636427117469, 1636427118142, 673, 274, 399, 0, 0, 0
906, 1, 1636427117532, 1636427118202, 670, 269, 401, 1, 0, 1
907, 1, 1636427117718, 1636427118386, 668, 269, 399, 0, 0, 0
908, 1, 1636427117949, 1636427118610, 661, 268, 393, 1, 1, 2
909, 1, 1636427118033, 1636427118702, 669, 266, 403, 0, 1, 1
910, 1, 1636427118236, 1636427118906, 670, 267, 403, 0, 0, 0
911, 1, 1636427118359, 1636427119034, 675, 269, 406, 1, 0, 1
913, 1, 1636427118487, 1636427119158, 671, 270, 401, 0, 2, 2
912, 1, 1636427118462, 1636427119158, 696, 295, 401, 0, 1, 1
915, 1, 1636427118716, 1636427119386, 670, 267, 403, 0, 0, 0
914, 1, 1636427118711, 1636427119474, 763, 366, 397, 1, 0, 1
916, 1, 1636427118738, 1636427119842, 1104, 703, 401, 0, 0, 0
917, 1, 1636427119304, 1636427119978, 674, 269, 405, 0, 1, 1
918, 1, 1636427119422, 1636427120430, 1008, 610, 398, 0, 1, 1
919, 1, 1636427120077, 1636427120750, 673, 266, 407, 0, 1, 1
920, 1, 1636427120545, 1636427121222, 677, 271, 406, 1, 0, 1
921, 1, 1636427120765, 1636427121442, 677, 271, 406, 1, 1, 2
922, 1, 1636427121039, 1636427121706, 667, 269, 398, 0, 1, 1
923, 1, 1636427121308, 1636427121978, 670, 270, 400, 0, 1, 1
924, 1, 1636427121321, 1636427121994, 673, 265, 408, 0, 0, 0
925, 1, 1636427121367, 1636427122042, 675, 274, 401, 0, 0, 0
926, 1, 1636427121489, 1636427122162, 673, 269, 404, 1, 0, 1
927, 1, 1636427121989, 1636427122658, 669, 271, 398, 0, 1, 1
928, 1, 1636427122043, 1636427122714, 671, 269, 402, 0, 0, 0
929, 1, 1636427122187, 1636427122850, 663, 271, 392, 0, 0, 0
930, 1, 1636427122450, 1636427123126, 676, 275, 401, 1, 1, 2
931, 1, 1636427122545, 1636427123214, 669, 270, 399, 0, 1, 1
932, 1, 1636427122579, 1636427123254, 675, 267, 408, 0, 2, 2
933, 1, 1636427122729, 1636427123394, 665, 270, 395, 0, 1, 1
934, 1, 1636427122790, 1636427123454, 664, 266, 398, 0, 0, 0
935, 1, 1636427122922, 1636427123582, 660, 263, 397, 0, 0, 0
937, 1, 1636427123217, 1636427123902, 685, 271, 414, 0, 1, 1
936, 1, 1636427122976, 1636427123910, 934, 526, 408, 0, 0, 0
938, 1, 1636427123299, 1636427124354, 1055, 658, 397, 1, 0, 1
939, 1, 1636427124008, 1636427124682, 674, 271, 403, 1, 0, 1
940, 1, 1636427124866, 1636427125534, 668, 270, 398, 0, 0, 0
941, 1, 1636427124960, 1636427125634, 674, 271, 403, 1, 0, 1
942, 1, 1636427125057, 1636427125730, 673, 270, 403, 0, 0, 0
943, 1, 1636427125477, 1636427126142, 665, 262, 403, 1, 0, 1
944, 1, 1636427125562, 1636427126234, 672, 269, 403, 0, 0, 0
945, 1, 1636427125628, 1636427126293, 665, 265, 400, 1, 1, 2
946, 1, 1636427125675, 1636427126346, 671, 275, 396, 3, 0, 3
947, 1, 1636427125680, 1636427126346, 666, 267, 399, 0, 1, 1
948, 1, 1636427126220, 1636427126882, 662, 266, 396, 0, 0, 0
949, 1, 1636427126231, 1636427126902, 671, 274, 397, 0, 1, 1
950, 1, 1636427126234, 1636427126910, 676, 273, 403, 0, 0, 0
951, 1, 1636427126464, 1636427127122, 658, 266, 392, 0, 0, 0
952, 1, 1636427126747, 1636427127406, 659, 265, 394, 0, 0, 0
953, 1, 1636427126771, 1636427127438, 667, 266, 401, 0, 0, 0
954, 1, 1636427126799, 1636427127470, 671, 274, 397, 0, 0, 0
955, 1, 1636427127206, 1636427127882, 676, 271, 405, 0, 0, 0
957, 1, 1636427127221, 1636427127898, 677, 270, 407, 1, 0, 1
956, 1, 1636427127220, 1636427127926, 706, 309, 397, 1, 0, 1
958, 1, 1636427127273, 1636427128334, 1061, 658, 403, 0, 0, 0
959, 1, 1636427128191, 1636427128866, 675, 268, 407, 1, 0, 1
960, 1, 1636427128824, 1636427129494, 670, 270, 400, 1, 0, 1
961, 1, 1636427128836, 1636427129506, 670, 269, 401, 0, 0, 0
962, 1, 1636427128937, 1636427129618, 681, 271, 410, 0, 1, 1
963, 1, 1636427129375, 1636427130046, 671, 271, 400, 1, 0, 1
965, 1, 1636427129393, 1636427130062, 669, 270, 399, 2, 0, 2
964, 1, 1636427129390, 1636427130070, 680, 278, 402, 0, 1, 1
966, 1, 1636427129426, 1636427130102, 676, 274, 402, 1, 0, 1
967, 1, 1636427129586, 1636427130258, 672, 266, 406, 0, 0, 0
968, 1, 1636427129931, 1636427130606, 675, 270, 405, 1, 1, 2
969, 1, 1636427130113, 1636427130794, 681, 270, 411, 0, 0, 0
970, 1, 1636427130229, 1636427130894, 665, 271, 394, 0, 1, 1
971, 1, 1636427130457, 1636427131246, 789, 387, 402, 0, 1, 1
972, 1, 1636427130641, 1636427131310, 669, 269, 400, 1, 0, 1
973, 1, 1636427130728, 1636427131390, 662, 262, 400, 0, 0, 0
974, 1, 1636427130768, 1636427131438, 670, 271, 399, 1, 1, 2
975, 1, 1636427130978, 1636427131766, 788, 390, 398, 0, 0, 0
976, 1, 1636427131192, 1636427131870, 678, 271, 407, 0, 1, 1
977, 1, 1636427131264, 1636427131930, 666, 264, 402, 1, 0, 1
978, 1, 1636427131422, 1636427132386, 964, 564, 400, 0, 0, 0
979, 1, 1636427131915, 1636427132586, 671, 270, 401, 0, 1, 1
980, 1, 1636427132693, 1636427133362, 669, 269, 400, 0, 0, 0
981, 1, 1636427132980, 1636427133650, 670, 271, 399, 0, 2, 2
982, 1, 1636427132990, 1636427133670, 680, 275, 405, 2, 1, 3
983, 1, 1636427133146, 1636427133818, 672, 267, 405, 0, 0, 0
984, 1, 1636427133435, 1636427134106, 671, 270, 401, 1, 0, 1
985, 1, 1636427133472, 1636427134142, 670, 274, 396, 0, 1, 1
986, 1, 1636427133591, 1636427134262, 671, 270, 401, 0, 0, 0
987, 1, 1636427133730, 1636427134402, 672, 269, 403, 0, 0, 0
988, 1, 1636427133870, 1636427134550, 680, 275, 405, 0, 0, 0
989, 1, 1636427134029, 1636427134702, 673, 269, 404, 0, 0, 0
990, 1, 1636427134229, 1636427134894, 665, 267, 398, 0, 0, 0
991, 1, 1636427134451, 1636427135118, 667, 269, 398, 0, 0, 0
992, 1, 1636427134598, 1636427135270, 672, 269, 403, 0, 0, 0
993, 1, 1636427134811, 1636427135478, 667, 266, 401, 0, 0, 0
994, 1, 1636427134817, 1636427135478, 661, 266, 395, 1, 0, 1
995, 1, 1636427135066, 1636427135934, 868, 470, 398, 0, 0, 0
996, 1, 1636427135303, 1636427135974, 671, 269, 402, 1, 0, 1
997, 1, 1636427135376, 1636427136050, 674, 269, 405, 1, 0, 1
999, 1, 1636427135673, 1636427136346, 673, 270, 403, 0, 0, 0
998, 1, 1636427135606, 1636427136502, 896, 499, 397, 0, 1, 1
1000, 1, 1636427136858, 1636427137538, 680, 273, 407, 0, 2, 2
1001, 1, 1636427137050, 1636427137722, 672, 274, 398, 1, 0, 1
1002, 1, 1636427137261, 1636427137926, 665, 269, 396, 0, 0, 0
1004, 1, 1636427137311, 1636427137978, 667, 270, 397, 1, 0, 1
1003, 1, 1636427137310, 1636427137990, 680, 278, 402, 0, 0, 0
1005, 1, 1636427137652, 1636427138326, 674, 270, 404, 0, 0, 0
1006, 1, 1636427137903, 1636427138570, 667, 270, 397, 1, 0, 1
1007, 1, 1636427138012, 1636427138694, 682, 269, 413, 0, 0, 0
1008, 1, 1636427138175, 1636427138846, 671, 274, 397, 0, 0, 0
1009, 1, 1636427138209, 1636427138886, 677, 275, 402, 0, 1, 1
1010, 1, 1636427138372, 1636427139046, 674, 270, 404, 1, 0, 1
1011, 1, 1636427138405, 1636427139078, 673, 270, 403, 0, 0, 0
1012, 1, 1636427138573, 1636427139298, 725, 323, 402, 0, 0, 0
1013, 1, 1636427138951, 1636427139618, 667, 270, 397, 0, 0, 0
1014, 1, 1636427138975, 1636427139642, 667, 269, 398, 0, 0, 0
1015, 1, 1636427139185, 1636427139866, 681, 274, 407, 0, 1, 1
1017, 1, 1636427139369, 1636427140102, 733, 334, 399, 0, 1, 1
1018, 1, 1636427139584, 1636427140254, 670, 271, 399, 0, 0, 0
1016, 1, 1636427139323, 1636427140310, 987, 594, 393, 0, 0, 0
1019, 1, 1636427139835, 1636427140514, 679, 270, 409, 0, 0, 0
1020, 1, 1636427140878, 1636427141550, 672, 272, 400, 0, 0, 0
1021, 1, 1636427141129, 1636427141802, 673, 269, 404, 0, 0, 0
1022, 1, 1636427141156, 1636427141826, 670, 266, 404, 0, 1, 1
1023, 1, 1636427141173, 1636427141854, 681, 269, 412, 0, 0, 0
1024, 1, 1636427141331, 1636427142002, 671, 270, 401, 1, 0, 1
1025, 1, 1636427141793, 1636427142474, 681, 278, 403, 1, 1, 2
1026, 1, 1636427141831, 1636427142502, 671, 270, 401, 0, 0, 0
1027, 1, 1636427141946, 1636427142618, 672, 270, 402, 0, 1, 1
1028, 1, 1636427142178, 1636427142850, 672, 271, 401, 0, 1, 1
1029, 1, 1636427142258, 1636427142930, 672, 269, 403, 2, 0, 2
1030, 1, 1636427142350, 1636427143026, 676, 270, 406, 0, 0, 0
1031, 1, 1636427142496, 1636427143162, 666, 268, 398, 0, 0, 0
1032, 1, 1636427142819, 1636427143490, 671, 271, 400, 1, 1, 2
1033, 1, 1636427142850, 1636427143518, 668, 267, 401, 0, 1, 1
1034, 1, 1636427142925, 1636427143602, 677, 275, 402, 1, 0, 1
1035, 1, 1636427143094, 1636427143766, 672, 269, 403, 0, 0, 0
1036, 1, 1636427143147, 1636427144058, 911, 515, 396, 0, 1, 1
1038, 1, 1636427143523, 1636427144198, 675, 268, 407, 0, 0, 0
1037, 1, 1636427143508, 1636427144214, 706, 313, 393, 0, 0, 0
1039, 1, 1636427143896, 1636427144570, 674, 271, 403, 0, 0, 0
1040, 1, 1636427144847, 1636427145514, 667, 271, 396, 1, 1, 2
1041, 1, 1636427145168, 1636427145838, 670, 270, 400, 0, 0, 0
1042, 1, 1636427145184, 1636427145862, 678, 271, 407, 0, 0, 0
1043, 1, 1636427145273, 1636427145942, 669, 270, 399, 2, 0, 2
1044, 1, 1636427145300, 1636427145974, 674, 274, 400, 0, 0, 0
1045, 1, 1636427145603, 1636427146270, 667, 269, 398, 0, 0, 0
1046, 1, 1636427145855, 1636427146522, 667, 271, 396, 1, 0, 1
1047, 1, 1636427145974, 1636427146646, 672, 270, 402, 0, 1, 1
1048, 1, 1636427146201, 1636427146874, 673, 270, 403, 0, 0, 0
1049, 1, 1636427146226, 1636427146898, 672, 270, 402, 0, 0, 0
1050, 1, 1636427146256, 1636427146926, 670, 271, 399, 1, 1, 2
1051, 1, 1636427146615, 1636427147282, 667, 271, 396, 0, 0, 0
1052, 1, 1636427146639, 1636427147310, 671, 270, 401, 0, 0, 0
1053, 1, 1636427146831, 1636427147506, 675, 271, 404, 1, 0, 1
1054, 1, 1636427146870, 1636427147538, 668, 269, 399, 0, 0, 0
1055, 1, 1636427146962, 1636427147630, 668, 270, 398, 0, 0, 0
1056, 1, 1636427147085, 1636427147770, 685, 283, 402, 0, 0, 0
1057, 1, 1636427147192, 1636427148002, 810, 410, 400, 0, 1, 1
1058, 1, 1636427147666, 1636427148338, 672, 270, 402, 1, 0, 1
1059, 1, 1636427147966, 1636427148642, 676, 268, 408, 0, 0, 0
1060, 1, 1636427148917, 1636427149586, 669, 271, 398, 0, 0, 0
1061, 1, 1636427148964, 1636427149634, 670, 270, 400, 0, 1, 1
1062, 1, 1636427149125, 1636427149798, 673, 270, 403, 1, 0, 1
1063, 1, 1636427149188, 1636427149862, 674, 269, 405, 1, 1, 2
1064, 1, 1636427149455, 1636427150126, 671, 270, 401, 0, 0, 0
1065, 1, 1636427149685, 1636427150358, 673, 270, 403, 1, 0, 1
1066, 1, 1636427149827, 1636427150506, 679, 270, 409, 0, 0, 0
1067, 1, 1636427149925, 1636427150598, 673, 275, 398, 0, 0, 0
1068, 1, 1636427149982, 1636427150654, 672, 268, 404, 1, 0, 1
1069, 1, 1636427150382, 1636427151066, 684, 271, 413, 2, 0, 2
1070, 1, 1636427150536, 1636427151202, 666, 270, 396, 0, 0, 0
1071, 1, 1636427150579, 1636427151258, 679, 269, 410, 1, 0, 1
1072, 1, 1636427150634, 1636427151306, 672, 274, 398, 1, 0, 1
1073, 1, 1636427150803, 1636427151482, 679, 274, 405, 0, 0, 0
1075, 1, 1636427150934, 1636427151602, 668, 268, 400, 0, 0, 0
1076, 1, 1636427150986, 1636427151650, 664, 270, 394, 1, 0, 1
1074, 1, 1636427150900, 1636427151762, 862, 462, 400, 0, 0, 0
1077, 1, 1636427151204, 1636427152054, 850, 452, 398, 0, 0, 0
1078, 1, 1636427151518, 1636427152190, 672, 269, 403, 0, 0, 0
1079, 1, 1636427152001, 1636427152678, 677, 270, 407, 1, 2, 3
1080, 1, 1636427152991, 1636427153654, 663, 268, 395, 0, 0, 0
1081, 1, 1636427153031, 1636427153702, 671, 271, 400, 0, 0, 0
1082, 1, 1636427153225, 1636427153890, 665, 268, 397, 0, 1, 1
1083, 1, 1636427153379, 1636427154050, 671, 271, 400, 1, 0, 1
1084, 1, 1636427153505, 1636427154190, 685, 274, 411, 0, 0, 0
1085, 1, 1636427153637, 1636427154314, 677, 271, 406, 1, 0, 1
1086, 1, 1636427153764, 1636427154434, 670, 271, 399, 1, 1, 2
1087, 1, 1636427154048, 1636427154718, 670, 269, 401, 1, 0, 1
1088, 1, 1636427154081, 1636427154750, 669, 269, 400, 1, 0, 1
1089, 1, 1636427154481, 1636427155162, 681, 274, 407, 1, 0, 1
1090, 1, 1636427154525, 1636427155202, 677, 274, 403, 1, 1, 2
1091, 1, 1636427154550, 1636427155222, 672, 273, 399, 0, 1, 1
1092, 1, 1636427154600, 1636427155262, 662, 273, 389, 2, 1, 3
1093, 1, 1636427154736, 1636427155410, 674, 275, 399, 0, 1, 1
1094, 1, 1636427154869, 1636427155658, 789, 390, 399, 0, 0, 0
1095, 1, 1636427155233, 1636427155902, 669, 270, 399, 0, 1, 1
1096, 1, 1636427155258, 1636427155922, 664, 270, 394, 0, 0, 0
1098, 1, 1636427155384, 1636427156050, 666, 272, 394, 1, 0, 1
1097, 1, 1636427155322, 1636427156358, 1036, 633, 403, 0, 1, 1
1099, 1, 1636427156227, 1636427156902, 675, 271, 404, 0, 2, 2
1100, 1, 1636427156919, 1636427157582, 663, 272, 391, 1, 1, 2
1101, 1, 1636427156962, 1636427157634, 672, 270, 402, 0, 0, 0
1102, 1, 1636427157215, 1636427157882, 667, 271, 396, 1, 1, 2
1103, 1, 1636427157258, 1636427157938, 680, 271, 409, 1, 1, 2
1104, 1, 1636427157325, 1636427158006, 681, 273, 408, 1, 0, 1
1105, 1, 1636427157399, 1636427158066, 667, 271, 396, 0, 0, 0
1106, 1, 1636427157450, 1636427158122, 672, 270, 402, 1, 0, 1
1107, 1, 1636427158232, 1636427158898, 666, 266, 400, 0, 1, 1
1108, 1, 1636427158237, 1636427158906, 669, 263, 406, 1, 0, 1
1109, 1, 1636427158276, 1636427158942, 666, 270, 396, 1, 0, 1
1110, 1, 1636427158375, 1636427159046, 671, 270, 401, 0, 0, 0
1111, 1, 1636427158434, 1636427159106, 672, 269, 403, 0, 0, 0
1113, 1, 1636427158899, 1636427159554, 655, 259, 396, 0, 0, 0
1112, 1, 1636427158794, 1636427159554, 760, 361, 399, 0, 0, 0
1114, 1, 1636427158931, 1636427159606, 675, 270, 405, 0, 0, 0
1115, 1, 1636427158995, 1636427159666, 671, 271, 400, 0, 0, 0
1116, 1, 1636427159191, 1636427159858, 667, 269, 398, 0, 0, 0
1118, 1, 1636427159313, 1636427159986, 673, 269, 404, 0, 0, 0
1117, 1, 1636427159205, 1636427160318, 1113, 713, 400, 0, 0, 0
1119, 1, 1636427160394, 1636427161074, 680, 270, 410, 1, 1, 2
1120, 1, 1636427160661, 1636427161330, 669, 270, 399, 0, 1, 1
1121, 1, 1636427160925, 1636427161590, 665, 266, 399, 0, 0, 0
1122, 1, 1636427161015, 1636427161674, 659, 267, 392, 2, 0, 2
1123, 1, 1636427161043, 1636427161714, 671, 274, 397, 0, 0, 0
1124, 1, 1636427161148, 1636427161806, 658, 266, 392, 0, 0, 0
1125, 1, 1636427161249, 1636427161922, 673, 267, 406, 0, 1, 1
1126, 1, 1636427161405, 1636427162086, 681, 269, 412, 0, 0, 0
1127, 1, 1636427161935, 1636427162606, 671, 269, 402, 0, 0, 0
1128, 1, 1636427162122, 1636427162790, 668, 270, 398, 0, 1, 1
1129, 1, 1636427162267, 1636427162934, 667, 267, 400, 0, 1, 1
1130, 1, 1636427162389, 1636427163058, 669, 265, 404, 0, 0, 0
1131, 1, 1636427162504, 1636427163178, 674, 274, 400, 0, 0, 0
1132, 1, 1636427162694, 1636427163370, 676, 270, 406, 1, 0, 1
1133, 1, 1636427162795, 1636427163466, 671, 271, 400, 0, 0, 0
1134, 1, 1636427162844, 1636427163514, 670, 270, 400, 0, 0, 0
1135, 1, 1636427163025, 1636427163698, 673, 270, 403, 1, 0, 1
1136, 1, 1636427163275, 1636427163942, 667, 269, 398, 1, 0, 1
1138, 1, 1636427163326, 1636427164002, 676, 274, 402, 1, 0, 1
1137, 1, 1636427163297, 1636427164394, 1097, 698, 399, 0, 1, 1
1139, 1, 1636427164545, 1636427165218, 673, 270, 403, 0, 0, 0
1140, 1, 1636427164622, 1636427165290, 668, 270, 398, 1, 0, 1
1141, 1, 1636427164759, 1636427165426, 667, 266, 401, 0, 0, 0
1142, 1, 1636427165019, 1636427165690, 671, 270, 401, 1, 0, 1
1143, 1, 1636427165122, 1636427165794, 672, 269, 403, 0, 0, 0
1144, 1, 1636427165135, 1636427165798, 663, 270, 393, 0, 0, 0
1145, 1, 1636427165136, 1636427165806, 670, 271, 399, 0, 1, 1
1146, 1, 1636427165449, 1636427166122, 673, 271, 402, 1, 0, 1
1147, 1, 1636427166034, 1636427166702, 668, 267, 401, 0, 2, 2
1148, 1, 1636427166154, 1636427166830, 676, 270, 406, 0, 0, 0
1149, 1, 1636427166155, 1636427166834, 679, 273, 406, 0, 0, 0
1150, 1, 1636427166289, 1636427166970, 681, 269, 412, 0, 0, 0
1151, 1, 1636427166388, 1636427167054, 666, 270, 396, 0, 0, 0
1152, 1, 1636427166792, 1636427167462, 670, 275, 395, 0, 1, 1
1153, 1, 1636427166811, 1636427167482, 671, 270, 401, 0, 0, 0
1154, 1, 1636427166960, 1636427167630, 670, 270, 400, 0, 0, 0
1155, 1, 1636427166988, 1636427167658, 670, 270, 400, 1, 0, 1
1156, 1, 1636427167326, 1636427168002, 676, 271, 405, 0, 1, 1
1157, 1, 1636427167415, 1636427168082, 667, 270, 397, 0, 0, 0
1158, 1, 1636427167535, 1636427168546, 1011, 604, 407, 0, 0, 0
1159, 1, 1636427168518, 1636427169194, 676, 270, 406, 0, 1, 1
1160, 1, 1636427168779, 1636427169462, 683, 277, 406, 1, 0, 1
1161, 1, 1636427168868, 1636427169546, 678, 278, 400, 0, 2, 2
1162, 1, 1636427168955, 1636427169630, 675, 274, 401, 1, 1, 2
1163, 1, 1636427169025, 1636427169698, 673, 270, 403, 0, 0, 0
1164, 1, 1636427169169, 1636427169838, 669, 267, 402, 1, 0, 1
1165, 1, 1636427169220, 1636427169886, 666, 270, 396, 1, 0, 1
1166, 1, 1636427169629, 1636427170302, 673, 270, 403, 0, 0, 0
1167, 1, 1636427170070, 1636427170738, 668, 270, 398, 0, 0, 0
1168, 1, 1636427170112, 1636427170782, 670, 270, 400, 0, 0, 0
1169, 1, 1636427170143, 1636427170810, 667, 268, 399, 0, 0, 0
1170, 1, 1636427170284, 1636427170946, 662, 270, 392, 0, 1, 1
1171, 1, 1636427170465, 1636427171134, 669, 274, 395, 1, 0, 1
1172, 1, 1636427170680, 1636427171346, 666, 267, 399, 0, 0, 0
1173, 1, 1636427170972, 1636427171654, 682, 271, 411, 0, 0, 0
1174, 1, 1636427171228, 1636427171898, 670, 273, 397, 0, 0, 0
1175, 1, 1636427171268, 1636427171934, 666, 271, 395, 0, 0, 0
1176, 1, 1636427171273, 1636427171946, 673, 270, 403, 0, 0, 0
1177, 1, 1636427171283, 1636427171954, 671, 266, 405, 1, 1, 2
1178, 1, 1636427171392, 1636427172414, 1022, 620, 402, 0, 0, 0
1179, 1, 1636427172761, 1636427173422, 661, 265, 396, 0, 0, 0
1180, 1, 1636427172802, 1636427173466, 664, 267, 397, 0, 2, 2
1181, 1, 1636427172921, 1636427173602, 681, 269, 412, 0, 1, 1
1182, 1, 1636427173009, 1636427173682, 673, 272, 401, 0, 2, 2
1183, 1, 1636427173073, 1636427173742, 669, 270, 399, 0, 0, 0
1184, 1, 1636427173201, 1636427173870, 669, 267, 402, 1, 0, 1
1185, 1, 1636427173268, 1636427173946, 678, 276, 402, 0, 0, 0
1186, 1, 1636427173770, 1636427174442, 672, 271, 401, 0, 2, 2
1187, 1, 1636427173870, 1636427174542, 672, 269, 403, 0, 0, 0
1188, 1, 1636427174036, 1636427174706, 670, 271, 399, 2, 0, 2
1189, 1, 1636427174167, 1636427174890, 723, 331, 392, 0, 1, 1
1190, 1, 1636427174359, 1636427175030, 671, 270, 401, 0, 0, 0
1191, 1, 1636427174508, 1636427175178, 670, 266, 404, 1, 0, 1
1192, 1, 1636427174584, 1636427175250, 666, 270, 396, 0, 0, 0
1193, 1, 1636427175137, 1636427175814, 677, 275, 402, 1, 0, 1
1194, 1, 1636427175178, 1636427175850, 672, 272, 400, 0, 1, 1
1195, 1, 1636427175396, 1636427176066, 670, 269, 401, 1, 1, 2
1196, 1, 1636427175426, 1636427176094, 668, 271, 397, 0, 0, 0
1198, 1, 1636427175471, 1636427176142, 671, 271, 400, 0, 1, 1
1197, 1, 1636427175453, 1636427176550, 1097, 696, 401, 0, 0, 0
1199, 1, 1636427176541, 1636427177210, 669, 269, 400, 1, 0, 1
1200, 1, 1636427176560, 1636427177222, 662, 269, 393, 2, 0, 2
1201, 1, 1636427176878, 1636427177550, 672, 269, 403, 0, 0, 0
1202, 1, 1636427176913, 1636427177582, 669, 274, 395, 2, 0, 2
1203, 1, 1636427177043, 1636427177714, 671, 271, 400, 1, 2, 3
1204, 1, 1636427177064, 1636427177734, 670, 271, 399, 1, 2, 3
1205, 1, 1636427177272, 1636427177946, 674, 269, 405, 0, 0, 0
1206, 1, 1636427177675, 1636427178346, 671, 270, 401, 1, 0, 1
1207, 1, 1636427177839, 1636427178518, 679, 270, 409, 0, 0, 0
1208, 1, 1636427178143, 1636427178810, 667, 271, 396, 1, 0, 1
1209, 1, 1636427178152, 1636427178818, 666, 270, 396, 0, 0, 0
1210, 1, 1636427178359, 1636427179030, 671, 270, 401, 1, 1, 2
1211, 1, 1636427178764, 1636427179430, 666, 270, 396, 0, 2, 2
1212, 1, 1636427178824, 1636427179490, 666, 271, 395, 1, 1, 2
1213, 1, 1636427179083, 1636427179754, 671, 271, 400, 0, 1, 1
1214, 1, 1636427179268, 1636427179934, 666, 270, 396, 0, 1, 1
1216, 1, 1636427179279, 1636427179942, 663, 266, 397, 0, 0, 0
1217, 1, 1636427179470, 1636427180142, 672, 269, 403, 0, 1, 1
1218, 1, 1636427179652, 1636427180326, 674, 273, 401, 1, 1, 2
1215, 1, 1636427179274, 1636427180386, 1112, 713, 399, 1, 0, 1
1219, 1, 1636427180503, 1636427181174, 671, 271, 400, 1, 0, 1
1220, 1, 1636427180619, 1636427181290, 671, 269, 402, 0, 1, 1
1221, 1, 1636427180777, 1636427181458, 681, 274, 407, 0, 0, 0
1222, 1, 1636427180927, 1636427181594, 667, 266, 401, 1, 0, 1
1223, 1, 1636427181121, 1636427181794, 673, 269, 404, 1, 0, 1
1224, 1, 1636427181234, 1636427181906, 672, 271, 401, 0, 0, 0
1225, 1, 1636427181580, 1636427182246, 666, 262, 404, 0, 0, 0
1226, 1, 1636427181867, 1636427182538, 671, 268, 403, 0, 0, 0
1227, 1, 1636427182000, 1636427182670, 670, 270, 400, 0, 0, 0
1228, 1, 1636427182184, 1636427182846, 662, 265, 397, 1, 0, 1
1229, 1, 1636427182437, 1636427183110, 673, 270, 403, 2, 0, 2
1230, 1, 1636427182464, 1636427183138, 674, 275, 399, 0, 0, 0
1231, 1, 1636427182500, 1636427183170, 670, 270, 400, 1, 0, 1
1232, 1, 1636427182857, 1636427183526, 669, 270, 399, 0, 0, 0
1233, 1, 1636427183121, 1636427183790, 669, 270, 399, 1, 1, 2
1234, 1, 1636427183147, 1636427183814, 667, 275, 392, 0, 0, 0
1236, 1, 1636427183407, 1636427184078, 671, 270, 401, 1, 0, 1
1237, 1, 1636427183432, 1636427184102, 670, 271, 399, 2, 0, 2
1238, 1, 1636427183548, 1636427184214, 666, 269, 397, 0, 0, 0
1235, 1, 1636427183268, 1636427184274, 1006, 611, 395, 1, 0, 1
1239, 1, 1636427184295, 1636427184970, 675, 271, 404, 1, 3, 4
1240, 1, 1636427184569, 1636427185242, 673, 270, 403, 1, 0, 1
1241, 1, 1636427184672, 1636427185346, 674, 275, 399, 0, 0, 0
1242, 1, 1636427184887, 1636427185558, 671, 272, 399, 1, 0, 1
1243, 1, 1636427185317, 1636427185990, 673, 266, 407, 0, 0, 0
1244, 1, 1636427185390, 1636427186062, 672, 269, 403, 1, 1, 2
1245, 1, 1636427185391, 1636427186066, 675, 270, 405, 1, 1, 2
1246, 1, 1636427185726, 1636427186398, 672, 265, 407, 0, 0, 0
1247, 1, 1636427186156, 1636427186826, 670, 271, 399, 2, 0, 2
1248, 1, 1636427186195, 1636427186866, 671, 268, 403, 0, 0, 0
1249, 1, 1636427186567, 1636427187238, 671, 275, 396, 0, 1, 1
1250, 1, 1636427186621, 1636427187310, 689, 274, 415, 0, 0, 0
1251, 1, 1636427186705, 1636427187378, 673, 271, 402, 0, 1, 1
1252, 1, 1636427187017, 1636427187686, 669, 270, 399, 0, 0, 0
1253, 1, 1636427187077, 1636427187746, 669, 270, 399, 0, 0, 0
1254, 1, 1636427187121, 1636427187782, 661, 270, 391, 0, 0, 0
1256, 1, 1636427187499, 1636427188170, 671, 270, 401, 0, 0, 0
1255, 1, 1636427187221, 1636427188198, 977, 577, 400, 0, 0, 0
1257, 1, 1636427187563, 1636427188230, 667, 262, 405, 0, 0, 0
1258, 1, 1636427187611, 1636427188282, 671, 270, 401, 0, 0, 0
1259, 1, 1636427188368, 1636427189030, 662, 266, 396, 2, 0, 2
1260, 1, 1636427188554, 1636427189222, 668, 266, 402, 0, 1, 1
1261, 1, 1636427188576, 1636427189242, 666, 265, 401, 0, 0, 0
1262, 1, 1636427188841, 1636427189510, 669, 266, 403, 0, 0, 0
1263, 1, 1636427189017, 1636427189690, 673, 269, 404, 0, 0, 0
1264, 1, 1636427189343, 1636427190014, 671, 269, 402, 0, 1, 1
1265, 1, 1636427189422, 1636427190098, 676, 269, 407, 0, 0, 0
1266, 1, 1636427189586, 1636427190254, 668, 266, 402, 1, 0, 1
1267, 1, 1636427190036, 1636427190706, 670, 269, 401, 0, 0, 0
1268, 1, 1636427190350, 1636427191026, 676, 270, 406, 1, 0, 1
1269, 1, 1636427190659, 1636427191326, 667, 272, 395, 1, 1, 2
1270, 1, 1636427190750, 1636427191418, 668, 268, 400, 0, 0, 0
1271, 1, 1636427190858, 1636427191530, 672, 273, 399, 0, 0, 0
1272, 1, 1636427190870, 1636427191542, 672, 271, 401, 0, 1, 1
1273, 1, 1636427191050, 1636427191718, 668, 270, 398, 0, 0, 0
1274, 1, 1636427191090, 1636427191762, 672, 269, 403, 0, 0, 0
1275, 1, 1636427191449, 1636427192214, 765, 362, 403, 0, 0, 0
1276, 1, 1636427191566, 1636427192238, 672, 269, 403, 0, 1, 1
1277, 1, 1636427191682, 1636427192362, 680, 270, 410, 0, 0, 0
1278, 1, 1636427191807, 1636427192482, 675, 267, 408, 0, 0, 0
1279, 1, 1636427192422, 1636427193094, 672, 271, 401, 1, 1, 2
1280, 1, 1636427192520, 1636427193190, 670, 266, 404, 0, 0, 0
1281, 1, 1636427192685, 1636427193358, 673, 269, 404, 1, 0, 1
1282, 1, 1636427193089, 1636427193758, 669, 271, 398, 1, 1, 2
1283, 1, 1636427193115, 1636427193790, 675, 271, 404, 0, 0, 0
1284, 1, 1636427193432, 1636427194106, 674, 271, 403, 0, 2, 2
1285, 1, 1636427193591, 1636427194262, 671, 270, 401, 0, 0, 0
1286, 1, 1636427193697, 1636427194370, 673, 270, 403, 0, 1, 1
1287, 1, 1636427194073, 1636427194746, 673, 270, 403, 0, 0, 0
1288, 1, 1636427194215, 1636427194886, 671, 271, 400, 1, 1, 2
1289, 1, 1636427194734, 1636427195406, 672, 274, 398, 1, 0, 1
1290, 1, 1636427194768, 1636427195434, 666, 266, 400, 1, 0, 1
1291, 1, 1636427194786, 1636427195454, 668, 274, 394, 0, 0, 0
1292, 1, 1636427194896, 1636427195566, 670, 271, 399, 0, 0, 0
1293, 1, 1636427195056, 1636427195722, 666, 270, 396, 0, 0, 0
1294, 1, 1636427195089, 1636427195762, 673, 275, 398, 1, 0, 1
1295, 1, 1636427195417, 1636427196210, 793, 397, 396, 1, 0, 1
1296, 1, 1636427195671, 1636427196338, 667, 270, 397, 1, 0, 1
1297, 1, 1636427195814, 1636427196478, 664, 266, 398, 0, 0, 0
1298, 1, 1636427195995, 1636427196666, 671, 270, 401, 2, 0, 2
1299, 1, 1636427196279, 1636427196950, 671, 271, 400, 0, 0, 0
1300, 1, 1636427196466, 1636427197138, 672, 271, 401, 0, 0, 0
1301, 1, 1636427196475, 1636427197146, 671, 269, 402, 0, 0, 0
1302, 1, 1636427197296, 1636427197962, 666, 271, 395, 0, 0, 0
1303, 1, 1636427197416, 1636427198082, 666, 271, 395, 1, 1, 2
1304, 1, 1636427197456, 1636427198126, 670, 269, 401, 0, 1, 1
1305, 1, 1636427197597, 1636427198262, 665, 269, 396, 1, 0, 1
1306, 1, 1636427197919, 1636427198594, 675, 274, 401, 0, 0, 0
1307, 1, 1636427198164, 1636427198838, 674, 270, 404, 0, 0, 0
1308, 1, 1636427198380, 1636427199050, 670, 269, 401, 0, 0, 0
1309, 1, 1636427198671, 1636427199338, 667, 269, 398, 2, 0, 2
1310, 1, 1636427198753, 1636427199426, 673, 271, 402, 1, 0, 1
1311, 1, 1636427198775, 1636427199450, 675, 274, 401, 1, 0, 1
1312, 1, 1636427198899, 1636427199574, 675, 273, 402, 1, 0, 1
1314, 1, 1636427198991, 1636427199658, 667, 274, 393, 1, 0, 1
1313, 1, 1636427198986, 1636427199662, 676, 275, 401, 0, 0, 0
1315, 1, 1636427199129, 1636427200114, 985, 581, 404, 0, 1, 1
1316, 1, 1636427199702, 1636427200374, 672, 265, 407, 0, 0, 0
1317, 1, 1636427199821, 1636427200494, 673, 271, 402, 2, 0, 2
1318, 1, 1636427199881, 1636427200554, 673, 269, 404, 0, 1, 1
1319, 1, 1636427200027, 1636427200698, 671, 269, 402, 0, 0, 0
1320, 1, 1636427200332, 1636427201006, 674, 270, 404, 0, 1, 1
1321, 1, 1636427200598, 1636427201282, 684, 278, 406, 1, 1, 2
1322, 1, 1636427201205, 1636427201882, 677, 274, 403, 0, 0, 0
1323, 1, 1636427201320, 1636427201990, 670, 264, 406, 0, 0, 0
1324, 1, 1636427201346, 1636427202018, 672, 270, 402, 1, 1, 2
1326, 1, 1636427201796, 1636427202466, 670, 269, 401, 0, 0, 0
1325, 1, 1636427201631, 1636427202470, 839, 439, 400, 1, 1, 2
1327, 1, 1636427202401, 1636427203074, 673, 271, 402, 0, 1, 1
1329, 1, 1636427202491, 1636427203158, 667, 270, 397, 1, 1, 2
1328, 1, 1636427202487, 1636427203166, 679, 277, 402, 0, 1, 1
1330, 1, 1636427202654, 1636427203318, 664, 265, 399, 1, 0, 1
1331, 1, 1636427202692, 1636427203366, 674, 270, 404, 0, 0, 0
1332, 1, 1636427203068, 1636427203734, 666, 271, 395, 0, 0, 0
1333, 1, 1636427203212, 1636427203878, 666, 269, 397, 1, 0, 1
1334, 1, 1636427203223, 1636427203882, 659, 267, 392, 1, 0, 1
1335, 1, 1636427203312, 1636427204194, 882, 485, 397, 0, 0, 0
1336, 1, 1636427203533, 1636427204206, 673, 271, 402, 0, 0, 0
1337, 1, 1636427203724, 1636427204390, 666, 271, 395, 0, 1, 1
1338, 1, 1636427203810, 1636427204482, 672, 270, 402, 0, 0, 0
1339, 1, 1636427204014, 1636427204686, 672, 270, 402, 0, 0, 0
1340, 1, 1636427204037, 1636427204710, 673, 270, 403, 0, 0, 0
1341, 1, 1636427204502, 1636427205174, 672, 271, 401, 2, 1, 3
1342, 1, 1636427204987, 1636427205662, 675, 272, 403, 0, 0, 0
1343, 1, 1636427205225, 1636427205894, 669, 271, 398, 0, 1, 1
1344, 1, 1636427205404, 1636427206070, 666, 269, 397, 0, 0, 0
1345, 1, 1636427205884, 1636427206558, 674, 269, 405, 0, 1, 1
1346, 1, 1636427205919, 1636427206598, 679, 271, 408, 1, 1, 2
1347, 1, 1636427206178, 1636427206858, 680, 274, 406, 0, 0, 0
1348, 1, 1636427206292, 1636427206966, 674, 273, 401, 1, 0, 1
1349, 1, 1636427206641, 1636427207306, 665, 269, 396, 1, 0, 1
1350, 1, 1636427206730, 1636427207398, 668, 270, 398, 0, 2, 2
1351, 1, 1636427206815, 1636427207482, 667, 269, 398, 0, 0, 0
1352, 1, 1636427206847, 1636427207518, 671, 269, 402, 1, 0, 1
1353, 1, 1636427207144, 1636427207814, 670, 272, 398, 0, 0, 0
1354, 1, 1636427207253, 1636427207934, 681, 275, 406, 0, 0, 0
1355, 1, 1636427207306, 1636427207974, 668, 270, 398, 0, 0, 0
1356, 1, 1636427207524, 1636427208194, 670, 272, 398, 0, 1, 1
1357, 1, 1636427207592, 1636427208258, 666, 268, 398, 0, 0, 0
1358, 1, 1636427208016, 1636427208686, 670, 270, 400, 2, 0, 2
1359, 1, 1636427208017, 1636427208690, 673, 270, 403, 0, 0, 0
1360, 1, 1636427208137, 1636427208810, 673, 271, 402, 0, 0, 0
1361, 1, 1636427208535, 1636427209214, 679, 270, 409, 0, 1, 1
1362, 1, 1636427209195, 1636427209862, 667, 271, 396, 0, 0, 0
1363, 1, 1636427209270, 1636427209938, 668, 274, 394, 1, 0, 1
1364, 1, 1636427209549, 1636427210230, 681, 270, 411, 0, 0, 0
1365, 1, 1636427209598, 1636427210390, 792, 385, 407, 0, 0, 0
1366, 1, 1636427209930, 1636427210606, 676, 274, 402, 0, 0, 0
1367, 1, 1636427210203, 1636427210874, 671, 270, 401, 2, 0, 2
1368, 1, 1636427210261, 1636427210926, 665, 268, 397, 0, 0, 0
1369, 1, 1636427210506, 1636427211182, 676, 270, 406, 1, 1, 2
1370, 1, 1636427210511, 1636427211182, 671, 269, 402, 1, 0, 1
1372, 1, 1636427210925, 1636427211594, 669, 269, 400, 1, 1, 2
1371, 1, 1636427210925, 1636427211606, 681, 274, 407, 0, 0, 0
1373, 1, 1636427211236, 1636427211906, 670, 274, 396, 1, 0, 1
1374, 1, 1636427211265, 1636427212058, 793, 385, 408, 1, 0, 1
1375, 1, 1636427211403, 1636427212070, 667, 271, 396, 1, 0, 1
1376, 1, 1636427211458, 1636427212130, 672, 270, 402, 0, 1, 1
1377, 1, 1636427211493, 1636427212166, 673, 274, 399, 0, 0, 0
1378, 1, 1636427211977, 1636427212650, 673, 270, 403, 0, 1, 1
1379, 1, 1636427212163, 1636427212834, 671, 270, 401, 0, 1, 1
1380, 1, 1636427212393, 1636427213062, 669, 270, 399, 0, 0, 0
1381, 1, 1636427212799, 1636427213474, 675, 269, 406, 0, 0, 0
1382, 1, 1636427213500, 1636427214166, 666, 270, 396, 0, 0, 0
1383, 1, 1636427213545, 1636427214222, 677, 270, 407, 0, 0, 0
1384, 1, 1636427213557, 1636427214226, 669, 266, 403, 0, 0, 0
1385, 1, 1636427213711, 1636427214382, 671, 269, 402, 0, 0, 0
1386, 1, 1636427213911, 1636427214678, 767, 366, 401, 0, 0, 0
1387, 1, 1636427214329, 1636427214998, 669, 275, 394, 2, 0, 2
1388, 1, 1636427214522, 1636427215202, 680, 272, 408, 0, 0, 0
1389, 1, 1636427214589, 1636427215250, 661, 271, 390, 3, 1, 4
1390, 1, 1636427214724, 1636427215386, 662, 268, 394, 1, 0, 1
1391, 1, 1636427214811, 1636427215470, 659, 263, 396, 0, 2, 2
1392, 1, 1636427214988, 1636427215654, 666, 268, 398, 1, 0, 1
1393, 1, 1636427215044, 1636427215838, 794, 395, 399, 1, 0, 1
1394, 1, 1636427215465, 1636427216146, 681, 275, 406, 2, 1, 3
1395, 1, 1636427215542, 1636427216210, 668, 268, 400, 0, 0, 0
1396, 1, 1636427215556, 1636427216218, 662, 271, 391, 0, 1, 1
1397, 1, 1636427215763, 1636427216430, 667, 270, 397, 1, 0, 1
1398, 1, 1636427216173, 1636427216850, 677, 271, 406, 0, 0, 0
1399, 1, 1636427216290, 1636427216962, 672, 271, 401, 1, 0, 1
1400, 1, 1636427216382, 1636427217046, 664, 266, 398, 0, 0, 0
1401, 1, 1636427216684, 1636427217354, 670, 271, 399, 2, 0, 2
1402, 1, 1636427217650, 1636427218318, 668, 269, 399, 0, 0, 0
1403, 1, 1636427217778, 1636427218446, 668, 271, 397, 1, 1, 2
1404, 1, 1636427217802, 1636427218474, 672, 266, 406, 0, 0, 0
1405, 1, 1636427217846, 1636427218510, 664, 266, 398, 0, 0, 0
1407, 1, 1636427218187, 1636427218854, 667, 270, 397, 0, 1, 1
1406, 1, 1636427217982, 1636427218962, 980, 578, 402, 1, 0, 1
1408, 1, 1636427218494, 1636427219166, 672, 270, 402, 1, 1, 2
1409, 1, 1636427218651, 1636427219318, 667, 269, 398, 1, 0, 1
1410, 1, 1636427218975, 1636427219642, 667, 268, 399, 0, 0, 0
1411, 1, 1636427219044, 1636427219710, 666, 270, 396, 2, 1, 3
1412, 1, 1636427219108, 1636427219778, 670, 270, 400, 0, 0, 0
1413, 1, 1636427219287, 1636427219958, 671, 271, 400, 1, 1, 2
1415, 1, 1636427219301, 1636427220090, 789, 394, 395, 0, 0, 0
1414, 1, 1636427219296, 1636427220162, 866, 465, 401, 1, 0, 1
1416, 1, 1636427219514, 1636427220182, 668, 270, 398, 0, 0, 0
1417, 1, 1636427220060, 1636427220734, 674, 275, 399, 0, 1, 1
1418, 1, 1636427220129, 1636427220802, 673, 270, 403, 0, 0, 0
1419, 1, 1636427220240, 1636427220910, 670, 274, 396, 0, 1, 1
1420, 1, 1636427220316, 1636427220986, 670, 271, 399, 0, 0, 0
1421, 1, 1636427220871, 1636427221542, 671, 269, 402, 0, 0, 0
1422, 1, 1636427221585, 1636427222262, 677, 270, 407, 1, 0, 1
1423, 1, 1636427221666, 1636427222342, 676, 275, 401, 2, 1, 3
1424, 1, 1636427221673, 1636427222346, 673, 275, 398, 0, 0, 0
1425, 1, 1636427221859, 1636427222526, 667, 270, 397, 0, 0, 0
1427, 1, 1636427222088, 1636427222758, 670, 271, 399, 0, 0, 0
1426, 1, 1636427221958, 1636427222798, 840, 438, 402, 0, 0, 0
1429, 1, 1636427222638, 1636427223310, 672, 275, 397, 1, 1, 2
1428, 1, 1636427222638, 1636427223310, 672, 270, 402, 0, 0, 0
1430, 1, 1636427222919, 1636427223590, 671, 270, 401, 0, 0, 0
1431, 1, 1636427222984, 1636427223650, 666, 270, 396, 0, 0, 0
1434, 1, 1636427223354, 1636427224030, 676, 271, 405, 1, 0, 1
1433, 1, 1636427223352, 1636427224106, 754, 360, 394, 0, 1, 1
1436, 1, 1636427223597, 1636427224261, 664, 270, 394, 0, 0, 0
1435, 1, 1636427223441, 1636427224478, 1037, 639, 398, 1, 1, 2
1437, 1, 1636427223871, 1636427224522, 651, 262, 389, 0, 0, 0
1432, 1, 1636427223084, 1636427224550, 1466, 1071, 395, 0, 1, 1
1438, 1, 1636427224217, 1636427224894, 677, 274, 403, 0, 0, 0
1439, 1, 1636427224384, 1636427225054, 670, 271, 399, 0, 0, 0
1440, 1, 1636427224424, 1636427225090, 666, 266, 400, 0, 0, 0
1441, 1, 1636427224701, 1636427225378, 677, 270, 407, 0, 0, 0
1442, 1, 1636427225654, 1636427226322, 668, 270, 398, 1, 1, 2
1443, 1, 1636427225831, 1636427226502, 671, 270, 401, 0, 0, 0
1444, 1, 1636427225976, 1636427226642, 666, 271, 395, 1, 1, 2
1445, 1, 1636427226010, 1636427226678, 668, 271, 397, 0, 1, 1
1447, 1, 1636427226140, 1636427226810, 670, 269, 401, 0, 0, 0
1446, 1, 1636427226117, 1636427227098, 981, 576, 405, 0, 0, 0
1448, 1, 1636427226885, 1636427227550, 665, 269, 396, 0, 0, 0
1449, 1, 1636427226920, 1636427227590, 670, 270, 400, 1, 0, 1
1450, 1, 1636427227106, 1636427227778, 672, 270, 402, 0, 0, 0
1451, 1, 1636427227135, 1636427227806, 671, 266, 405, 1, 0, 1
1452, 1, 1636427227222, 1636427227890, 668, 266, 402, 1, 0, 1
1453, 1, 1636427227405, 1636427228078, 673, 266, 407, 1, 0, 1
1454, 1, 1636427227504, 1636427228226, 722, 330, 392, 0, 0, 0
1456, 1, 1636427227737, 1636427228406, 669, 269, 400, 0, 0, 0
1455, 1, 1636427227661, 1636427228534, 873, 466, 407, 1, 0, 1
1457, 1, 1636427228153, 1636427228826, 673, 273, 400, 0, 0, 0
1458, 1, 1636427228274, 1636427228946, 672, 270, 402, 0, 2, 2
1459, 1, 1636427228459, 1636427229126, 667, 270, 397, 2, 0, 2
1460, 1, 1636427228474, 1636427229146, 672, 270, 402, 1, 0, 1
1461, 1, 1636427228528, 1636427229190, 662, 267, 395, 1, 0, 1
1462, 1, 1636427229601, 1636427230274, 673, 271, 402, 1, 2, 3
1463, 1, 1636427229969, 1636427230630, 661, 264, 397, 0, 1, 1
1464, 1, 1636427230012, 1636427230678, 666, 271, 395, 1, 0, 1
1465, 1, 1636427230026, 1636427230698, 672, 271, 401, 1, 0, 1
1466, 1, 1636427230143, 1636427230826, 683, 274, 409, 0, 0, 0
1467, 1, 1636427230232, 1636427231134, 902, 497, 405, 0, 0, 0
1468, 1, 1636427230818, 1636427231490, 672, 274, 398, 0, 0, 0
1469, 1, 1636427230858, 1636427231534, 676, 274, 402, 0, 0, 0
1471, 1, 1636427230893, 1636427231562, 669, 270, 399, 0, 0, 0
1470, 1, 1636427230893, 1636427231566, 673, 275, 398, 1, 1, 2
1473, 1, 1636427231258, 1636427231926, 668, 266, 402, 0, 0, 0
1472, 1, 1636427231208, 1636427231942, 734, 337, 397, 0, 0, 0
1474, 1, 1636427231292, 1636427231962, 670, 271, 399, 1, 1, 2
1476, 1, 1636427231676, 1636427232346, 670, 270, 400, 0, 0, 0
1475, 1, 1636427231639, 1636427232414, 775, 370, 405, 0, 0, 0
1477, 1, 1636427232264, 1636427232938, 674, 270, 404, 0, 0, 0
1478, 1, 1636427232282, 1636427232954, 672, 270, 402, 1, 0, 1
1479, 1, 1636427232299, 1636427232970, 671, 275, 396, 0, 0, 0
1480, 1, 1636427232347, 1636427233010, 663, 270, 393, 0, 0, 0
1481, 1, 1636427232486, 1636427233158, 672, 266, 406, 0, 1, 1
1482, 1, 1636427233789, 1636427234458, 669, 270, 399, 0, 0, 0
1483, 1, 1636427233814, 1636427234470, 656, 267, 389, 0, 1, 1
1484, 1, 1636427233868, 1636427234526, 658, 266, 392, 0, 0, 0
1485, 1, 1636427233954, 1636427234618, 664, 269, 395, 0, 0, 0
1487, 1, 1636427234164, 1636427234830, 666, 266, 400, 0, 0, 0
1486, 1, 1636427233964, 1636427234906, 942, 546, 396, 0, 0, 0
1488, 1, 1636427234604, 1636427235266, 662, 270, 392, 0, 0, 0
1489, 1, 1636427234642, 1636427235310, 668, 269, 399, 0, 0, 0
1490, 1, 1636427234877, 1636427235550, 673, 274, 399, 0, 0, 0
1491, 1, 1636427235001, 1636427235674, 673, 268, 405, 0, 0, 0
1492, 1, 1636427235035, 1636427235706, 671, 271, 400, 3, 1, 4
1493, 1, 1636427235134, 1636427235806, 672, 266, 406, 1, 0, 1
1494, 1, 1636427235509, 1636427236186, 677, 275, 402, 0, 1, 1
1495, 1, 1636427235537, 1636427236262, 725, 322, 403, 1, 1, 2
1496, 1, 1636427235819, 1636427236482, 663, 271, 392, 0, 0, 0
1497, 1, 1636427235957, 1636427236626, 669, 267, 402, 0, 0, 0
1498, 1, 1636427236095, 1636427236762, 667, 266, 401, 1, 0, 1
1499, 1, 1636427236124, 1636427236790, 666, 270, 396, 0, 1, 1
1500, 1, 1636427236168, 1636427236830, 662, 267, 395, 2, 0, 2
1501, 1, 1636427236370, 1636427237042, 672, 266, 406, 0, 0, 0
1502, 1, 1636427237554, 1636427238222, 668, 269, 399, 0, 0, 0
1503, 1, 1636427237649, 1636427238318, 669, 269, 400, 0, 0, 0
1504, 1, 1636427237780, 1636427238442, 662, 264, 398, 0, 0, 0
1505, 1, 1636427237861, 1636427238526, 665, 267, 398, 0, 2, 2
1506, 1, 1636427237875, 1636427238770, 895, 491, 404, 0, 0, 0
1507, 1, 1636427238275, 1636427238942, 667, 270, 397, 0, 1, 1
1508, 1, 1636427238469, 1636427239146, 677, 277, 400, 0, 0, 0
1509, 1, 1636427238589, 1636427239266, 677, 278, 399, 0, 0, 0
1510, 1, 1636427238615, 1636427239278, 663, 270, 393, 0, 0, 0
1511, 1, 1636427238853, 1636427239522, 669, 269, 400, 0, 0, 0
1512, 1, 1636427238895, 1636427239570, 675, 274, 401, 0, 0, 0
1513, 1, 1636427239099, 1636427239774, 675, 274, 401, 0, 1, 1
1514, 1, 1636427239222, 1636427239890, 668, 270, 398, 0, 0, 0
1515, 1, 1636427239296, 1636427240222, 926, 529, 397, 1, 0, 1
1516, 1, 1636427239660, 1636427240334, 674, 269, 405, 0, 0, 0
1517, 1, 1636427239787, 1636427240454, 667, 271, 396, 0, 1, 1
1518, 1, 1636427239968, 1636427240650, 682, 274, 408, 1, 0, 1
1519, 1, 1636427239968, 1636427240678, 710, 309, 401, 0, 0, 0
1520, 1, 1636427240413, 1636427241086, 673, 268, 405, 0, 0, 0
1521, 1, 1636427240638, 1636427241314, 676, 270, 406, 0, 0, 0
1522, 1, 1636427241676, 1636427242342, 666, 269, 397, 0, 0, 0
1523, 1, 1636427241676, 1636427242346, 670, 275, 395, 0, 1, 1
1524, 1, 1636427241807, 1636427242482, 675, 269, 406, 1, 0, 1
1526, 1, 1636427242005, 1636427242674, 669, 270, 399, 1, 0, 1
1527, 1, 1636427242011, 1636427242678, 667, 270, 397, 0, 0, 0
1525, 1, 1636427242003, 1636427242794, 791, 390, 401, 0, 1, 1
1528, 1, 1636427242479, 1636427243150, 671, 269, 402, 1, 0, 1
1529, 1, 1636427242676, 1636427243350, 674, 275, 399, 0, 1, 1
1530, 1, 1636427242719, 1636427243390, 671, 270, 401, 0, 1, 1
1531, 1, 1636427242894, 1636427243558, 664, 266, 398, 1, 0, 1
1532, 1, 1636427242921, 1636427243594, 673, 271, 402, 0, 1, 1
1533, 1, 1636427243068, 1636427243730, 662, 261, 401, 1, 0, 1
1535, 1, 1636427243497, 1636427244166, 669, 271, 398, 1, 0, 1
1536, 1, 1636427243525, 1636427244190, 665, 268, 397, 0, 1, 1
1534, 1, 1636427243095, 1636427244194, 1099, 690, 409, 0, 1, 1
1538, 1, 1636427243768, 1636427244434, 666, 270, 396, 2, 0, 2
1537, 1, 1636427243690, 1636427244642, 952, 552, 400, 1, 0, 1
1539, 1, 1636427244003, 1636427244674, 671, 271, 400, 0, 0, 0
1540, 1, 1636427244192, 1636427244862, 670, 271, 399, 0, 0, 0
1541, 1, 1636427244897, 1636427245574, 677, 272, 405, 1, 0, 1
1542, 1, 1636427245483, 1636427246150, 667, 269, 398, 0, 0, 0
1543, 1, 1636427245725, 1636427246394, 669, 270, 399, 1, 0, 1
1544, 1, 1636427246000, 1636427246678, 678, 269, 409, 0, 0, 0
1545, 1, 1636427246068, 1636427246742, 674, 269, 405, 0, 0, 0
1546, 1, 1636427246151, 1636427246814, 663, 270, 393, 1, 0, 1
1547, 1, 1636427246331, 1636427247006, 675, 270, 405, 1, 0, 1
1548, 1, 1636427246411, 1636427247082, 671, 270, 401, 2, 0, 2
1549, 1, 1636427246784, 1636427247450, 666, 269, 397, 1, 0, 1
1550, 1, 1636427246823, 1636427247490, 667, 269, 398, 0, 0, 0
1551, 1, 1636427246882, 1636427247562, 680, 270, 410, 0, 0, 0
1552, 1, 1636427247127, 1636427247802, 675, 272, 403, 0, 1, 1
1554, 1, 1636427247192, 1636427247854, 662, 267, 395, 0, 1, 1
1555, 1, 1636427247455, 1636427248122, 667, 270, 397, 0, 1, 1
1553, 1, 1636427247137, 1636427248262, 1125, 718, 407, 1, 0, 1
1556, 1, 1636427247628, 1636427248298, 670, 270, 400, 0, 1, 1
1557, 1, 1636427247795, 1636427248462, 667, 272, 395, 0, 0, 0
1559, 1, 1636427247964, 1636427248630, 666, 271, 395, 1, 2, 3
1558, 1, 1636427247887, 1636427248710, 823, 426, 397, 1, 0, 1
1560, 1, 1636427248075, 1636427248750, 675, 267, 408, 2, 0, 2
1561, 1, 1636427248582, 1636427249250, 668, 268, 400, 1, 0, 1
1562, 1, 1636427249584, 1636427250258, 674, 275, 399, 0, 1, 1
1563, 1, 1636427249754, 1636427250422, 668, 266, 402, 0, 0, 0
1564, 1, 1636427249801, 1636427250470, 669, 270, 399, 0, 0, 0
1565, 1, 1636427250057, 1636427250926, 869, 463, 406, 1, 0, 1
1566, 1, 1636427250301, 1636427250970, 669, 270, 399, 0, 0, 0
1567, 1, 1636427250424, 1636427251094, 670, 271, 399, 0, 0, 0
1568, 1, 1636427250513, 1636427251178, 665, 266, 399, 0, 0, 0
1569, 1, 1636427250913, 1636427251590, 677, 271, 406, 0, 0, 0
1570, 1, 1636427250974, 1636427251650, 676, 273, 403, 0, 0, 0
1572, 1, 1636427251020, 1636427251686, 666, 271, 395, 0, 0, 0
1573, 1, 1636427251082, 1636427251750, 668, 271, 397, 1, 1, 2
1574, 1, 1636427251087, 1636427251758, 671, 270, 401, 0, 0, 0
1571, 1, 1636427250987, 1636427252038, 1051, 655, 396, 0, 0, 0
1575, 1, 1636427251437, 1636427252102, 665, 267, 398, 0, 0, 0
1576, 1, 1636427251461, 1636427252130, 669, 274, 395, 2, 0, 2
1577, 1, 1636427251622, 1636427252290, 668, 267, 401, 0, 0, 0
1578, 1, 1636427251858, 1636427252530, 672, 267, 405, 0, 1, 1
1579, 1, 1636427252247, 1636427252918, 671, 271, 400, 0, 1, 1
1580, 1, 1636427252284, 1636427252954, 670, 270, 400, 1, 1, 2
1581, 1, 1636427252458, 1636427253134, 676, 271, 405, 1, 2, 3
1582, 1, 1636427253280, 1636427253950, 670, 271, 399, 1, 1, 2
1583, 1, 1636427253630, 1636427254298, 668, 270, 398, 0, 1, 1
1584, 1, 1636427253752, 1636427254418, 666, 268, 398, 0, 0, 0
1586, 1, 1636427254125, 1636427254790, 665, 266, 399, 0, 0, 0
1585, 1, 1636427253948, 1636427254874, 926, 526, 400, 0, 0, 0
1587, 1, 1636427254424, 1636427255098, 674, 270, 404, 1, 0, 1
1588, 1, 1636427254549, 1636427255214, 665, 270, 395, 1, 1, 2
1589, 1, 1636427254610, 1636427255282, 672, 270, 402, 1, 0, 1
1590, 1, 1636427254797, 1636427255470, 673, 271, 402, 0, 0, 0
1591, 1, 1636427254908, 1636427255590, 682, 271, 411, 0, 0, 0
1593, 1, 1636427255037, 1636427255710, 673, 266, 407, 0, 0, 0
1594, 1, 1636427255063, 1636427255730, 667, 269, 398, 1, 0, 1
1592, 1, 1636427254913, 1636427255738, 825, 421, 404, 0, 0, 0
1595, 1, 1636427255255, 1636427255934, 679, 270, 409, 0, 0, 0
1596, 1, 1636427255460, 1636427256126, 666, 270, 396, 0, 1, 1
1597, 1, 1636427255554, 1636427256218, 664, 270, 394, 0, 0, 0
1598, 1, 1636427255925, 1636427256590, 665, 273, 392, 2, 0, 2
1599, 1, 1636427256235, 1636427256918, 683, 276, 407, 0, 1, 1
1600, 1, 1636427256317, 1636427256986, 669, 270, 399, 0, 0, 0
1601, 1, 1636427256403, 1636427257074, 671, 270, 401, 1, 1, 2
1602, 1, 1636427257338, 1636427258010, 672, 268, 404, 1, 0, 1
1603, 1, 1636427257555, 1636427258222, 667, 269, 398, 0, 0, 0
1604, 1, 1636427257803, 1636427258470, 667, 270, 397, 0, 0, 0
1605, 1, 1636427257960, 1636427258926, 966, 566, 400, 1, 0, 1
1606, 1, 1636427258327, 1636427259002, 675, 268, 407, 0, 0, 0
1607, 1, 1636427258435, 1636427259106, 671, 269, 402, 1, 0, 1
1608, 1, 1636427258437, 1636427259114, 677, 270, 407, 0, 0, 0
1609, 1, 1636427258865, 1636427259554, 689, 291, 398, 1, 0, 1
1610, 1, 1636427258885, 1636427259558, 673, 270, 403, 0, 0, 0
1611, 1, 1636427259072, 1636427259742, 670, 267, 403, 1, 0, 1
1612, 1, 1636427259099, 1636427259770, 671, 274, 397, 0, 0, 0
1614, 1, 1636427259237, 1636427259914, 677, 270, 407, 1, 0, 1
1613, 1, 1636427259222, 1636427260014, 792, 383, 409, 1, 0, 1
1615, 1, 1636427259356, 1636427260022, 666, 267, 399, 0, 1, 1
1616, 1, 1636427259482, 1636427260146, 664, 271, 393, 0, 0, 0
1617, 1, 1636427259705, 1636427260466, 761, 355, 406, 0, 1, 1
1618, 1, 1636427259961, 1636427260638, 677, 274, 403, 1, 0, 1
1619, 1, 1636427260106, 1636427260782, 676, 269, 407, 1, 0, 1
1620, 1, 1636427260449, 1636427261122, 673, 270, 403, 1, 0, 1
1621, 1, 1636427260565, 1636427261238, 673, 270, 403, 0, 1, 1
1622, 1, 1636427261041, 1636427261718, 677, 268, 409, 0, 0, 0
1623, 1, 1636427261515, 1636427262186, 671, 271, 400, 0, 1, 1
1624, 1, 1636427262092, 1636427262758, 666, 271, 395, 0, 1, 1
1626, 1, 1636427262279, 1636427262946, 667, 271, 396, 0, 0, 0
1627, 1, 1636427262324, 1636427262986, 662, 270, 392, 0, 0, 0
1625, 1, 1636427262170, 1636427263214, 1044, 643, 401, 0, 0, 0
1628, 1, 1636427262569, 1636427263238, 669, 271, 398, 0, 2, 2
1629, 1, 1636427262646, 1636427263322, 676, 270, 406, 1, 0, 1
1630, 1, 1636427262746, 1636427263438, 692, 290, 402, 0, 1, 1
1631, 1, 1636427262930, 1636427263594, 664, 267, 397, 0, 1, 1
1632, 1, 1636427262946, 1636427263774, 828, 427, 401, 1, 1, 2
1633, 1, 1636427263176, 1636427263842, 666, 269, 397, 1, 0, 1
1634, 1, 1636427263196, 1636427263862, 666, 269, 397, 1, 0, 1
1635, 1, 1636427263347, 1636427264010, 663, 267, 396, 0, 1, 1
1636, 1, 1636427263432, 1636427264090, 658, 267, 391, 0, 1, 1
1637, 1, 1636427263447, 1636427264218, 771, 370, 401, 0, 0, 0
1638, 1, 1636427263792, 1636427264462, 670, 270, 400, 0, 0, 0
1639, 1, 1636427264019, 1636427264694, 675, 273, 402, 1, 0, 1
1640, 1, 1636427264445, 1636427265122, 677, 269, 408, 0, 1, 1
1641, 1, 1636427264555, 1636427265234, 679, 274, 405, 1, 1, 2
1642, 1, 1636427264953, 1636427265630, 677, 270, 407, 1, 1, 2
1643, 1, 1636427265264, 1636427265942, 678, 274, 404, 0, 0, 0
1644, 1, 1636427266065, 1636427266730, 665, 266, 399, 0, 0, 0
1645, 1, 1636427266078, 1636427266758, 680, 269, 411, 1, 0, 1
1647, 1, 1636427266394, 1636427267066, 672, 272, 400, 0, 3, 3
1646, 1, 1636427266127, 1636427267186, 1059, 659, 400, 0, 1, 1
1648, 1, 1636427266554, 1636427267218, 664, 270, 394, 0, 1, 1
1649, 1, 1636427266568, 1636427267238, 670, 270, 400, 0, 0, 0
1650, 1, 1636427266802, 1636427267470, 668, 274, 394, 0, 0, 0
1651, 1, 1636427266921, 1636427267590, 669, 266, 403, 1, 0, 1
1652, 1, 1636427267009, 1636427267682, 673, 270, 403, 0, 0, 0
1653, 1, 1636427267123, 1636427267786, 663, 271, 392, 0, 1, 1
1654, 1, 1636427267149, 1636427267822, 673, 270, 403, 0, 0, 0
1655, 1, 1636427267167, 1636427267842, 675, 274, 401, 1, 0, 1
1656, 1, 1636427267333, 1636427267998, 665, 270, 395, 1, 0, 1
1657, 1, 1636427267416, 1636427268082, 666, 270, 396, 0, 0, 0
1658, 1, 1636427267652, 1636427268318, 666, 269, 397, 0, 0, 0
1659, 1, 1636427268105, 1636427268774, 669, 270, 399, 0, 0, 0
1660, 1, 1636427268116, 1636427268778, 662, 266, 396, 0, 0, 0
1661, 1, 1636427268373, 1636427269046, 673, 270, 403, 1, 0, 1
1662, 1, 1636427269040, 1636427269714, 674, 269, 405, 0, 0, 0
1663, 1, 1636427269047, 1636427269718, 671, 271, 400, 0, 0, 0
1664, 1, 1636427269753, 1636427270426, 673, 271, 402, 1, 0, 1
1666, 1, 1636427270035, 1636427270702, 667, 270, 397, 0, 1, 1
1667, 1, 1636427270176, 1636427270846, 670, 272, 398, 0, 0, 0
1665, 1, 1636427269905, 1636427270878, 973, 569, 404, 0, 0, 0
1668, 1, 1636427270426, 1636427271094, 668, 266, 402, 0, 1, 1
1669, 1, 1636427270646, 1636427271322, 676, 273, 403, 2, 0, 2
1670, 1, 1636427270748, 1636427271418, 670, 270, 400, 0, 0, 0
1671, 1, 1636427270880, 1636427271546, 666, 271, 395, 1, 0, 1
1672, 1, 1636427270893, 1636427271569, 676, 270, 406, 0, 0, 0
1673, 1, 1636427270943, 1636427271610, 667, 270, 397, 0, 0, 0
1674, 1, 1636427270995, 1636427271670, 675, 270, 405, 0, 0, 0
1675, 1, 1636427271123, 1636427271786, 663, 268, 395, 1, 0, 1
1676, 1, 1636427271242, 1636427271910, 668, 270, 398, 0, 0, 0
1677, 1, 1636427271430, 1636427272090, 660, 267, 393, 0, 1, 1
1678, 1, 1636427271949, 1636427272622, 673, 274, 399, 0, 0, 0
1679, 1, 1636427271973, 1636427272642, 669, 270, 399, 0, 0, 0
1680, 1, 1636427271996, 1636427272662, 666, 269, 397, 1, 0, 1
1681, 1, 1636427272166, 1636427272842, 676, 270, 406, 0, 2, 2
1682, 1, 1636427272884, 1636427273554, 670, 270, 400, 0, 1, 1
1683, 1, 1636427273253, 1636427273930, 677, 271, 406, 0, 0, 0
1684, 1, 1636427273996, 1636427274662, 666, 269, 397, 0, 1, 1
1686, 1, 1636427274105, 1636427274782, 677, 273, 404, 1, 0, 1
1687, 1, 1636427274383, 1636427275049, 666, 270, 396, 0, 1, 1
1685, 1, 1636427274078, 1636427275114, 1036, 637, 399, 1, 1, 2
1688, 1, 1636427274576, 1636427275242, 666, 271, 395, 0, 1, 1
1689, 1, 1636427274681, 1636427275354, 673, 266, 407, 0, 0, 0
1690, 1, 1636427274914, 1636427275582, 668, 266, 402, 0, 0, 0
1691, 1, 1636427274930, 1636427275602, 672, 267, 405, 0, 1, 1
1692, 1, 1636427274956, 1636427275630, 674, 267, 407, 0, 1, 1
1693, 1, 1636427275020, 1636427275682, 662, 266, 396, 3, 1, 4
1694, 1, 1636427275022, 1636427275686, 664, 265, 399, 1, 1, 2
1695, 1, 1636427275161, 1636427275834, 673, 268, 405, 0, 0, 0
1696, 1, 1636427275467, 1636427276138, 671, 271, 400, 1, 0, 1
1697, 1, 1636427275493, 1636427276166, 673, 275, 398, 0, 0, 0
1698, 1, 1636427275934, 1636427276606, 672, 274, 398, 1, 1, 2
1699, 1, 1636427275955, 1636427276622, 667, 267, 400, 1, 1, 2
1700, 1, 1636427276095, 1636427276766, 671, 270, 401, 2, 0, 2
1701, 1, 1636427276409, 1636427277082, 673, 273, 400, 0, 0, 0
1702, 1, 1636427277029, 1636427277710, 681, 273, 408, 0, 0, 0
1703, 1, 1636427277399, 1636427278070, 671, 270, 401, 0, 0, 0
1704, 1, 1636427277795, 1636427278474, 679, 271, 408, 0, 1, 1
1706, 1, 1636427277964, 1636427278638, 674, 273, 401, 0, 0, 0
1705, 1, 1636427277897, 1636427278926, 1029, 629, 400, 0, 0, 0
1707, 1, 1636427278689, 1636427279354, 665, 266, 399, 1, 0, 1
1708, 1, 1636427278708, 1636427279382, 674, 270, 404, 1, 0, 1
1709, 1, 1636427278829, 1636427279490, 661, 268, 393, 0, 1, 1
1710, 1, 1636427278901, 1636427279574, 673, 266, 407, 0, 0, 0
1711, 1, 1636427278921, 1636427279578, 657, 263, 394, 0, 0, 0
1712, 1, 1636427278940, 1636427279609, 669, 275, 394, 0, 0, 0
1713, 1, 1636427278988, 1636427279650, 662, 267, 395, 1, 0, 1
1714, 1, 1636427279103, 1636427279810, 707, 306, 401, 1, 0, 1
1715, 1, 1636427279420, 1636427280086, 666, 265, 401, 0, 0, 0
1716, 1, 1636427279447, 1636427280106, 659, 271, 388, 2, 1, 3
1717, 1, 1636427279612, 1636427280278, 666, 274, 392, 1, 0, 1
1718, 1, 1636427279647, 1636427280314, 667, 270, 397, 0, 0, 0
1719, 1, 1636427279991, 1636427280658, 667, 269, 398, 0, 0, 0
1720, 1, 1636427280139, 1636427280806, 667, 266, 401, 0, 0, 0
1721, 1, 1636427280361, 1636427281038, 677, 270, 407, 0, 0, 0
1722, 1, 1636427281148, 1636427281826, 678, 272, 406, 1, 0, 1
1723, 1, 1636427281618, 1636427282286, 668, 270, 398, 0, 0, 0
1724, 1, 1636427281660, 1636427282330, 670, 270, 400, 0, 2, 2
1725, 1, 1636427281937, 1636427282606, 669, 268, 401, 0, 0, 0
1726, 1, 1636427281981, 1636427283062, 1081, 676, 405, 0, 0, 0
1727, 1, 1636427282625, 1636427283294, 669, 270, 399, 0, 0, 0
1728, 1, 1636427282714, 1636427283386, 672, 269, 403, 0, 0, 0
1729, 1, 1636427282839, 1636427283514, 675, 279, 396, 0, 1, 1
1730, 1, 1636427282993, 1636427283670, 677, 274, 403, 0, 0, 0
1731, 1, 1636427283146, 1636427283806, 660, 265, 395, 0, 0, 0
1732, 1, 1636427283149, 1636427283822, 673, 274, 399, 0, 0, 0
1733, 1, 1636427283187, 1636427283850, 663, 270, 393, 0, 0, 0
1734, 1, 1636427283233, 1636427283894, 661, 266, 395, 2, 0, 2
1735, 1, 1636427283308, 1636427283974, 666, 271, 395, 0, 0, 0
1736, 1, 1636427283353, 1636427284018, 665, 265, 400, 0, 0, 0
1737, 1, 1636427283556, 1636427284278, 722, 326, 396, 1, 0, 1
1738, 1, 1636427283717, 1636427284382, 665, 270, 395, 1, 0, 1
1739, 1, 1636427283763, 1636427284426, 663, 266, 397, 0, 0, 0
1740, 1, 1636427284362, 1636427285038, 676, 269, 407, 0, 0, 0
1741, 1, 1636427284549, 1636427285227, 678, 272, 406, 1, 1, 2
1742, 1, 1636427285320, 1636427285994, 674, 273, 401, 0, 0, 0
1743, 1, 1636427285552, 1636427286226, 674, 269, 405, 0, 0, 0
1744, 1, 1636427285817, 1636427286490, 673, 270, 403, 0, 0, 0
1746, 1, 1636427285935, 1636427286610, 675, 270, 405, 0, 0, 0
1745, 1, 1636427285922, 1636427286954, 1032, 629, 403, 0, 1, 1
1747, 1, 1636427286535, 1636427287202, 667, 270, 397, 0, 0, 0
1748, 1, 1636427286663, 1636427287338, 675, 270, 405, 1, 0, 1
1749, 1, 1636427286749, 1636427287414, 665, 271, 394, 0, 1, 1
1750, 1, 1636427286782, 1636427287458, 676, 272, 404, 0, 0, 0
1751, 1, 1636427286873, 1636427287538, 665, 271, 394, 0, 1, 1
1752, 1, 1636427286970, 1636427287642, 672, 270, 402, 2, 0, 2
1753, 1, 1636427287063, 1636427287738, 675, 269, 406, 1, 0, 1
1754, 1, 1636427287243, 1636427287914, 671, 270, 401, 0, 0, 0
1755, 1, 1636427287303, 1636427287974, 671, 271, 400, 0, 0, 0
1756, 1, 1636427287476, 1636427288150, 674, 269, 405, 0, 0, 0
1758, 1, 1636427287697, 1636427288370, 673, 270, 403, 0, 1, 1
1759, 1, 1636427287768, 1636427288438, 670, 270, 400, 0, 1, 1
1757, 1, 1636427287557, 1636427288602, 1045, 651, 394, 0, 0, 0
1760, 1, 1636427288535, 1636427289210, 675, 274, 401, 0, 1, 1
1761, 1, 1636427288652, 1636427289322, 670, 273, 397, 0, 1, 1
1763, 1, 1636427289621, 1636427290282, 661, 270, 391, 0, 0, 0
1762, 1, 1636427289609, 1636427290282, 673, 275, 398, 1, 0, 1
1764, 1, 1636427289694, 1636427290362, 668, 274, 394, 0, 1, 1
1765, 1, 1636427289931, 1636427290598, 667, 271, 396, 0, 0, 0
1767, 1, 1636427290242, 1636427290906, 664, 267, 397, 0, 1, 1
1766, 1, 1636427290105, 1636427291050, 945, 542, 403, 0, 0, 0
1768, 1, 1636427290639, 1636427291306, 667, 270, 397, 1, 1, 2
1769, 1, 1636427290731, 1636427291398, 667, 269, 398, 1, 0, 1
1770, 1, 1636427290924, 1636427291594, 670, 273, 397, 0, 0, 0
1771, 1, 1636427291008, 1636427291678, 670, 271, 399, 0, 1, 1
1772, 1, 1636427291029, 1636427291702, 673, 271, 402, 0, 0, 0
1773, 1, 1636427291037, 1636427291706, 669, 267, 402, 1, 1, 2
1774, 1, 1636427291188, 1636427291866, 678, 265, 413, 0, 0, 0
1775, 1, 1636427291259, 1636427291926, 667, 271, 396, 1, 0, 1
1776, 1, 1636427291312, 1636427291970, 658, 262, 396, 1, 0, 1
1777, 1, 1636427291443, 1636427292314, 871, 479, 392, 0, 1, 1
1778, 1, 1636427291765, 1636427292438, 673, 265, 408, 0, 0, 0
1779, 1, 1636427291872, 1636427292538, 666, 267, 399, 0, 1, 1
1781, 1, 1636427292825, 1636427293494, 669, 270, 399, 1, 0, 1
1780, 1, 1636427292823, 1636427293494, 671, 269, 402, 1, 1, 2
1782, 1, 1636427293569, 1636427294238, 669, 270, 399, 2, 0, 2
1783, 1, 1636427293679, 1636427294346, 667, 266, 401, 0, 0, 0
1784, 1, 1636427293782, 1636427294466, 684, 270, 414, 0, 1, 1
1785, 1, 1636427294199, 1636427294866, 667, 271, 396, 0, 0, 0
1786, 1, 1636427294223, 1636427294882, 659, 266, 393, 0, 1, 1
1787, 1, 1636427294395, 1636427295062, 667, 271, 396, 0, 0, 0
1788, 1, 1636427294399, 1636427295330, 931, 534, 397, 0, 0, 0
1789, 1, 1636427294678, 1636427295346, 668, 271, 397, 1, 0, 1
1790, 1, 1636427294711, 1636427295378, 667, 271, 396, 0, 0, 0
1791, 1, 1636427294760, 1636427295426, 666, 265, 401, 0, 0, 0
1792, 1, 1636427295027, 1636427295702, 675, 274, 401, 1, 0, 1
1793, 1, 1636427295036, 1636427295798, 762, 362, 400, 0, 0, 0
1794, 1, 1636427295247, 1636427295918, 671, 269, 402, 0, 0, 0
1795, 1, 1636427295358, 1636427296030, 672, 269, 403, 1, 0, 1
1796, 1, 1636427295551, 1636427296226, 675, 270, 405, 1, 0, 1
1798, 1, 1636427295654, 1636427296315, 661, 266, 395, 0, 0, 0
1797, 1, 1636427295646, 1636427296370, 724, 326, 398, 0, 0, 0
1799, 1, 1636427295845, 1636427296518, 673, 269, 404, 0, 0, 0
1800, 1, 1636427297059, 1636427297726, 667, 270, 397, 0, 0, 0
1801, 1, 1636427297124, 1636427297790, 666, 270, 396, 1, 0, 1
1802, 1, 1636427297505, 1636427298178, 673, 270, 403, 0, 0, 0
1803, 1, 1636427297782, 1636427298442, 660, 271, 389, 0, 0, 0
1804, 1, 1636427297966, 1636427298634, 668, 266, 402, 0, 0, 0
1805, 1, 1636427297982, 1636427298658, 676, 275, 401, 0, 1, 1
1807, 1, 1636427298140, 1636427298798, 658, 262, 396, 0, 0, 0
1808, 1, 1636427298221, 1636427298890, 669, 266, 403, 0, 1, 1
1809, 1, 1636427298450, 1636427299114, 664, 266, 398, 0, 1, 1
1806, 1, 1636427298112, 1636427299114, 1002, 605, 397, 1, 0, 1
1810, 1, 1636427298653, 1636427299322, 669, 270, 399, 0, 0, 0
1811, 1, 1636427298750, 1636427299410, 660, 268, 392, 1, 1, 2
1812, 1, 1636427298910, 1636427299582, 672, 266, 406, 0, 0, 0
1813, 1, 1636427298959, 1636427299626, 667, 271, 396, 0, 0, 0
1814, 1, 1636427299232, 1636427300030, 798, 402, 396, 2, 0, 2
1815, 1, 1636427299345, 1636427300074, 729, 335, 394, 0, 0, 0
1816, 1, 1636427299434, 1636427300106, 672, 270, 402, 1, 0, 1
1817, 1, 1636427299592, 1636427300266, 674, 274, 400, 1, 0, 1
1818, 1, 1636427299639, 1636427300302, 663, 266, 397, 0, 0, 0
1819, 1, 1636427299885, 1636427300554, 669, 270, 399, 0, 0, 0
1820, 1, 1636427300816, 1636427301486, 670, 269, 401, 0, 0, 0
1821, 1, 1636427301654, 1636427302318, 664, 267, 397, 1, 1, 2
1822, 1, 1636427301712, 1636427302378, 666, 271, 395, 0, 1, 1
1823, 1, 1636427301837, 1636427302506, 669, 269, 400, 0, 0, 0
1825, 1, 1636427302182, 1636427302850, 668, 270, 398, 0, 1, 1
1824, 1, 1636427301865, 1636427302966, 1101, 697, 404, 1, 0, 1
1826, 1, 1636427302419, 1636427303086, 667, 270, 397, 1, 0, 1
1827, 1, 1636427302440, 1636427303102, 662, 271, 391, 0, 1, 1
1828, 1, 1636427302527, 1636427303194, 667, 270, 397, 1, 1, 2
1830, 1, 1636427302794, 1636427303466, 672, 270, 402, 1, 0, 1
1829, 1, 1636427302689, 1636427303542, 853, 450, 403, 1, 0, 1
1832, 1, 1636427303235, 1636427303914, 679, 269, 410, 0, 0, 0
1831, 1, 1636427303101, 1636427303918, 817, 419, 398, 0, 1, 1
1833, 1, 1636427303290, 1636427303962, 672, 271, 401, 1, 0, 1
1835, 1, 1636427303554, 1636427304230, 676, 269, 407, 0, 0, 0
1834, 1, 1636427303386, 1636427304358, 972, 582, 390, 0, 0, 0
1836, 1, 1636427303716, 1636427304382, 666, 269, 397, 1, 0, 1
1837, 1, 1636427303758, 1636427304434, 676, 274, 402, 0, 0, 0
1838, 1, 1636427304672, 1636427305346, 674, 270, 404, 0, 1, 1
1839, 1, 1636427305545, 1636427306210, 665, 268, 397, 0, 0, 0
1841, 1, 1636427305908, 1636427306570, 662, 269, 393, 0, 0, 0
1840, 1, 1636427305837, 1636427306662, 825, 421, 404, 1, 0, 1
1842, 1, 1636427306018, 1636427306686, 668, 271, 397, 0, 0, 0
1843, 1, 1636427306138, 1636427306806, 668, 274, 394, 0, 0, 0
1844, 1, 1636427306331, 1636427306986, 655, 259, 396, 0, 1, 1
1845, 1, 1636427306428, 1636427307090, 662, 271, 391, 0, 0, 0
1847, 1, 1636427306515, 1636427307174, 659, 266, 393, 0, 0, 0
1846, 1, 1636427306456, 1636427307262, 806, 406, 400, 1, 0, 1
1848, 1, 1636427306997, 1636427307674, 677, 272, 405, 1, 2, 3
1849, 1, 1636427307062, 1636427307738, 676, 273, 403, 0, 0, 0
1850, 1, 1636427307287, 1636427307958, 671, 270, 401, 1, 0, 1
1851, 1, 1636427307415, 1636427308190, 775, 375, 400, 0, 0, 0
1853, 1, 1636427307616, 1636427308282, 666, 266, 400, 1, 0, 1
1852, 1, 1636427307447, 1636427308410, 963, 567, 396, 1, 0, 1
1854, 1, 1636427308025, 1636427308694, 669, 271, 398, 0, 1, 1
1855, 1, 1636427308380, 1636427309054, 674, 273, 401, 0, 0, 0
1856, 1, 1636427309724, 1636427310378, 654, 269, 385, 1, 1, 2
1857, 1, 1636427309851, 1636427310830, 979, 578, 401, 2, 0, 2
1858, 1, 1636427310168, 1636427310838, 670, 270, 400, 0, 0, 0
1859, 1, 1636427310193, 1636427310862, 669, 267, 402, 1, 0, 1
1860, 1, 1636427310203, 1636427310870, 667, 270, 397, 0, 0, 0
1861, 1, 1636427310353, 1636427311026, 673, 267, 406, 1, 0, 1
1862, 1, 1636427310416, 1636427311078, 662, 271, 391, 1, 1, 2
1864, 1, 1636427310543, 1636427311214, 671, 273, 398, 1, 0, 1
1863, 1, 1636427310492, 1636427311478, 986, 581, 405, 0, 0, 0
1865, 1, 1636427311099, 1636427311774, 675, 274, 401, 0, 0, 0
1866, 1, 1636427311286, 1636427311950, 664, 266, 398, 0, 0, 0
1867, 1, 1636427311321, 1636427311994, 673, 271, 402, 0, 0, 0
1868, 1, 1636427311394, 1636427312230, 836, 434, 402, 0, 0, 0
1870, 1, 1636427311731, 1636427312398, 667, 271, 396, 0, 1, 1
1869, 1, 1636427311570, 1636427312446, 876, 472, 404, 0, 0, 0
1871, 1, 1636427312284, 1636427312946, 662, 269, 393, 0, 0, 0
1872, 1, 1636427312668, 1636427313346, 678, 269, 409, 0, 0, 0
1873, 1, 1636427313657, 1636427314330, 673, 271, 402, 1, 2, 3
1875, 1, 1636427313878, 1636427314546, 668, 269, 399, 0, 0, 0
1876, 1, 1636427313992, 1636427314658, 666, 271, 395, 1, 1, 2
1874, 1, 1636427313762, 1636427314778, 1016, 614, 402, 0, 0, 0
1877, 1, 1636427314262, 1636427314938, 676, 270, 406, 0, 0, 0
1878, 1, 1636427314397, 1636427315066, 669, 271, 398, 0, 1, 1
1879, 1, 1636427314528, 1636427315194, 666, 270, 396, 0, 1, 1
1880, 1, 1636427314531, 1636427315194, 663, 271, 392, 0, 1, 1
1881, 1, 1636427314584, 1636427315526, 942, 538, 404, 0, 0, 0
1882, 1, 1636427315005, 1636427315678, 673, 270, 403, 1, 0, 1
1883, 1, 1636427315018, 1636427315694, 676, 270, 406, 0, 0, 0
1885, 1, 1636427315402, 1636427316082, 680, 269, 411, 1, 0, 1
1884, 1, 1636427315379, 1636427316130, 751, 351, 400, 0, 0, 0
1886, 1, 1636427315467, 1636427316134, 667, 271, 396, 2, 1, 3
1887, 1, 1636427315565, 1636427316534, 969, 570, 399, 0, 1, 1
1888, 1, 1636427316051, 1636427316718, 667, 269, 398, 1, 0, 1
1889, 1, 1636427316446, 1636427317122, 676, 271, 405, 0, 0, 0
1890, 1, 1636427317755, 1636427318422, 667, 269, 398, 0, 1, 1
1891, 1, 1636427318267, 1636427318930, 663, 270, 393, 0, 0, 0
1892, 1, 1636427318302, 1636427318970, 668, 270, 398, 0, 0, 0
1893, 1, 1636427318572, 1636427319242, 670, 270, 400, 0, 1, 1
1894, 1, 1636427318611, 1636427319270, 659, 262, 397, 0, 0, 0
1895, 1, 1636427318621, 1636427319286, 665, 270, 395, 0, 0, 0
1897, 1, 1636427318915, 1636427319590, 675, 269, 406, 1, 0, 1
1896, 1, 1636427318839, 1636427319734, 895, 497, 398, 0, 0, 0
1898, 1, 1636427319310, 1636427320046, 736, 329, 407, 0, 0, 0
1899, 1, 1636427319432, 1636427320102, 670, 268, 402, 0, 0, 0
1900, 1, 1636427319551, 1636427320218, 667, 274, 393, 2, 0, 2
1901, 1, 1636427319637, 1636427320558, 921, 518, 403, 0, 0, 0
1902, 1, 1636427319927, 1636427320594, 667, 268, 399, 0, 0, 0
1903, 1, 1636427321462, 1636427322134, 672, 267, 405, 0, 0, 0
1904, 1, 1636427322191, 1636427322858, 667, 271, 396, 1, 0, 1
1905, 1, 1636427322295, 1636427322966, 671, 271, 400, 0, 0, 0
1906, 1, 1636427322350, 1636427323022, 672, 275, 397, 1, 0, 1
1907, 1, 1636427322861, 1636427323534, 673, 270, 403, 0, 0, 0
1908, 1, 1636427322901, 1636427323570, 669, 274, 395, 0, 2, 2
1909, 1, 1636427322902, 1636427323574, 672, 273, 399, 0, 2, 2
1912, 1, 1636427323262, 1636427323946, 684, 273, 411, 0, 0, 0
1911, 1, 1636427323171, 1636427323986, 815, 419, 396, 1, 0, 1
1910, 1, 1636427323077, 1636427324022, 945, 541, 404, 0, 0, 0
1913, 1, 1636427323439, 1636427324410, 971, 578, 393, 0, 1, 1
1914, 1, 1636427323634, 1636427324438, 804, 405, 399, 2, 0, 2
1915, 1, 1636427323843, 1636427324518, 675, 278, 397, 0, 0, 0
1916, 1, 1636427325166, 1636427325838, 672, 271, 401, 1, 1, 2
1917, 1, 1636427326119, 1636427326790, 671, 270, 401, 0, 0, 0
1918, 1, 1636427326421, 1636427327086, 665, 266, 399, 0, 0, 0
1919, 1, 1636427326564, 1636427327234, 670, 270, 400, 0, 0, 0
1920, 1, 1636427326586, 1636427327254, 668, 269, 399, 0, 0, 0
1921, 1, 1636427326785, 1636427327458, 673, 270, 403, 0, 0, 0
1922, 1, 1636427326954, 1636427327686, 732, 329, 403, 0, 0, 0
1923, 1, 1636427327054, 1636427327730, 676, 269, 407, 0, 0, 0
1925, 1, 1636427327352, 1636427328134, 782, 390, 392, 1, 0, 1
1924, 1, 1636427327311, 1636427328182, 871, 474, 397, 1, 0, 1
1926, 1, 1636427327727, 1636427328394, 667, 270, 397, 0, 0, 0
1927, 1, 1636427329078, 1636427329750, 672, 269, 403, 0, 0, 0
1928, 1, 1636427330292, 1636427330966, 674, 275, 399, 1, 1, 2
1929, 1, 1636427330312, 1636427330982, 670, 270, 400, 0, 0, 0
1930, 1, 1636427330468, 1636427331134, 666, 271, 395, 0, 0, 0
1931, 1, 1636427330476, 1636427331150, 674, 270, 404, 1, 0, 1
1932, 1, 1636427330642, 1636427331310, 668, 270, 398, 0, 0, 0
1933, 1, 1636427330934, 1636427331610, 676, 272, 404, 0, 0, 0
1934, 1, 1636427331080, 1636427331754, 674, 268, 406, 1, 0, 1
1935, 1, 1636427331317, 1636427332066, 749, 346, 403, 1, 1, 2
1937, 1, 1636427331518, 1636427332186, 668, 271, 397, 0, 1, 1
1936, 1, 1636427331409, 1636427332210, 801, 402, 399, 0, 0, 0
1938, 1, 1636427333163, 1636427333838, 675, 271, 404, 1, 1, 2
1939, 1, 1636427334090, 1636427334758, 668, 269, 399, 0, 0, 0
1940, 1, 1636427334260, 1636427334922, 662, 270, 392, 0, 0, 0
1941, 1, 1636427334561, 1636427335234, 673, 271, 402, 1, 1, 2
1942, 1, 1636427334562, 1636427335238, 676, 279, 397, 0, 0, 0
1943, 1, 1636427334613, 1636427335282, 669, 269, 400, 0, 0, 0
1944, 1, 1636427335020, 1636427335694, 674, 274, 400, 1, 0, 1
1945, 1, 1636427335041, 1636427335718, 677, 270, 407, 0, 0, 0
1947, 1, 1636427335379, 1636427336150, 771, 370, 401, 0, 1, 1
1948, 1, 1636427335489, 1636427336162, 673, 269, 404, 1, 0, 1
1946, 1, 1636427335278, 1636427336166, 888, 495, 393, 1, 0, 1
1949, 1, 1636427337006, 1636427337678, 672, 268, 404, 0, 1, 1
1950, 1, 1636427337931, 1636427338602, 671, 270, 401, 1, 1, 2
1951, 1, 1636427338231, 1636427338902, 671, 271, 400, 1, 0, 1
1952, 1, 1636427338405, 1636427339082, 677, 269, 408, 1, 0, 1
1953, 1, 1636427338820, 1636427339486, 666, 271, 395, 0, 0, 0
1954, 1, 1636427338864, 1636427339530, 666, 269, 397, 0, 0, 0
1955, 1, 1636427339098, 1636427339770, 672, 272, 400, 0, 1, 1
1956, 1, 1636427339213, 1636427339990, 777, 369, 408, 0, 0, 0
1957, 1, 1636427339572, 1636427340238, 666, 275, 391, 1, 1, 2
1958, 1, 1636427341153, 1636427341822, 669, 271, 398, 0, 1, 1
1959, 1, 1636427342103, 1636427342782, 679, 275, 404, 0, 1, 1
1960, 1, 1636427342551, 1636427343222, 671, 269, 402, 1, 0, 1
1961, 1, 1636427342587, 1636427343262, 675, 270, 405, 0, 0, 0
1962, 1, 1636427343049, 1636427343730, 681, 271, 410, 0, 0, 0
1963, 1, 1636427343079, 1636427343750, 671, 271, 400, 2, 0, 2
1964, 1, 1636427343298, 1636427344178, 880, 486, 394, 0, 1, 1
1965, 1, 1636427343399, 1636427344202, 803, 403, 400, 0, 1, 1
1966, 1, 1636427345198, 1636427345874, 676, 270, 406, 0, 1, 1
1967, 1, 1636427346408, 1636427347082, 674, 274, 400, 0, 1, 1
1968, 1, 1636427346496, 1636427347166, 670, 270, 400, 0, 1, 1
1969, 1, 1636427346595, 1636427347274, 679, 270, 409, 0, 0, 0
1970, 1, 1636427347123, 1636427347798, 675, 269, 406, 0, 0, 0
1971, 1, 1636427347264, 1636427347938, 674, 270, 404, 0, 1, 1
1973, 1, 1636427347683, 1636427348346, 663, 270, 393, 0, 0, 0
1972, 1, 1636427347566, 1636427348398, 832, 430, 402, 0, 0, 0
1974, 1, 1636427350442, 1636427351118, 676, 270, 406, 0, 0, 0
1975, 1, 1636427350655, 1636427351330, 675, 270, 405, 1, 0, 1
1976, 1, 1636427351368, 1636427352054, 686, 276, 410, 1, 1, 2
1977, 1, 1636427351686, 1636427352506, 820, 423, 397, 0, 1, 1
1978, 1, 1636427354145, 1636427354822, 677, 274, 403, 0, 1, 1
1979, 1, 1636427354535, 1636427355214, 679, 271, 408, 1, 0, 1
1980, 1, 1636427355186, 1636427355862, 676, 270, 406, 1, 0, 1
1981, 1, 1636427355433, 1636427356314, 881, 483, 398, 0, 0, 0
1982, 1, 1636427358057, 1636427358730, 673, 272, 401, 1, 1, 2
1983, 1, 1636427358206, 1636427358882, 676, 269, 407, 1, 0, 1
1984, 1, 1636427358981, 1636427359658, 677, 269, 408, 0, 0, 0
1985, 1, 1636427359217, 1636427360114, 897, 495, 402, 0, 2, 2
1986, 1, 1636427362067, 1636427362742, 675, 271, 404, 0, 0, 0
1987, 1, 1636427362143, 1636427362814, 671, 272, 399, 1, 2, 3
1988, 1, 1636427363224, 1636427363894, 670, 270, 400, 0, 0, 0
1989, 1, 1636427363349, 1636427364354, 1005, 605, 400, 0, 1, 1
1990, 1, 1636427365987, 1636427366654, 667, 269, 398, 1, 0, 1
1991, 1, 1636427366040, 1636427366710, 670, 271, 399, 1, 1, 2
1992, 1, 1636427367176, 1636427367862, 686, 275, 411, 0, 0, 0
1993, 1, 1636427367336, 1636427368314, 978, 578, 400, 0, 1, 1
1994, 1, 1636427369800, 1636427370474, 674, 270, 404, 1, 1, 2
1995, 1, 1636427371364, 1636427372038, 674, 270, 404, 0, 1, 1
1996, 1, 1636427371424, 1636427372498, 1074, 674, 400, 1, 0, 1
1997, 1, 1636427375134, 1636427375806, 672, 270, 402, 0, 0, 0
1998, 1, 1636427375349, 1636427376262, 913, 511, 402, 1, 0, 1
1999, 1, 1636427379423, 1636427380090, 667, 270, 397, 0, 0, 0
2000, 1, 1636427379490, 1636427380547, 1057, 646, 411, 0, 1, 1
2001, 1, 1636427506909, 1636427507594, 685, 281, 404, 1, 2, 3
2002, 1, 1636427510788, 1636427511466, 678, 275, 403, 2, 1, 3
2003, 1, 1636427514704, 1636427515374, 670, 270, 400, 0, 2, 2
2004, 1, 1636427518881, 1636427519558, 677, 270, 407, 0, 1, 1
2005, 1, 1636427523054, 1636427523726, 672, 271, 401, 1, 2, 3
2006, 1, 1636427526968, 1636427527642, 674, 268, 406, 0, 1, 1
2007, 1, 1636427531000, 1636427531674, 674, 270, 404, 0, 0, 0
2008, 1, 1636427535056, 1636427535730, 674, 275, 399, 1, 0, 1
2009, 1, 1636427539131, 1636427539806, 675, 269, 406, 0, 1, 1
2010, 1, 1636427543352, 1636427544026, 674, 270, 404, 2, 0, 2
2011, 1, 1636427547087, 1636427547762, 675, 272, 403, 2, 2, 4
2012, 1, 1636427550877, 1636427551554, 677, 269, 408, 1, 1, 2
2013, 1, 1636427554724, 1636427555402, 678, 279, 399, 1, 1, 2
2014, 1, 1636427559050, 1636427559722, 672, 268, 404, 0, 0, 0
2015, 1, 1636427562837, 1636427563510, 673, 270, 403, 3, 0, 3
2016, 1, 1636427567025, 1636427567710, 685, 276, 409, 2, 1, 3
2017, 1, 1636427570911, 1636427571542, 631, 274, 357, 1, 1, 2
2018, 1, 1636427574806, 1636427575438, 632, 274, 358, 1, 1, 2
2019, 1, 1636427579130, 1636427579758, 628, 271, 357, 1, 2, 3
2020, 1, 1636427583205, 1636427583834, 629, 270, 359, 1, 1, 2
2021, 1, 1636427586896, 1636427587530, 634, 274, 360, 0, 1, 1
2022, 1, 1636427590722, 1636427591354, 632, 270, 362, 2, 0, 2
2023, 1, 1636427605362, 1636427605994, 632, 274, 358, 2, 0, 2
2024, 1, 1636427606359, 1636427606990, 631, 270, 361, 0, 0, 0
2025, 1, 1636427607338, 1636427607974, 636, 274, 362, 0, 1, 1
2026, 1, 1636427608367, 1636427608998, 631, 270, 361, 0, 1, 1
2027, 1, 1636427609400, 1636427610030, 630, 269, 361, 0, 0, 0
2028, 1, 1636427610400, 1636427611026, 626, 269, 357, 1, 1, 2
2029, 1, 1636427611407, 1636427612042, 635, 274, 361, 2, 0, 2
2030, 1, 1636427612430, 1636427613058, 628, 270, 358, 2, 0, 2
2031, 1, 1636427613462, 1636427614090, 628, 270, 358, 0, 1, 1
2032, 1, 1636427614462, 1636427615102, 640, 275, 365, 1, 2, 3
2033, 1, 1636427615436, 1636427616074, 638, 276, 362, 2, 2, 4
2034, 1, 1636427616406, 1636427617038, 632, 270, 362, 1, 0, 1
2035, 1, 1636427617393, 1636427618027, 634, 272, 362, 1, 0, 1
2036, 1, 1636427618404, 1636427619038, 634, 274, 360, 0, 0, 0
2037, 1, 1636427619384, 1636427620018, 634, 272, 362, 0, 0, 0
2038, 1, 1636427620418, 1636427621046, 628, 270, 358, 1, 1, 2
2039, 1, 1636427621414, 1636427622042, 628, 270, 358, 1, 1, 2
2040, 1, 1636427622404, 1636427623034, 630, 272, 358, 2, 2, 4
2041, 1, 1636427623404, 1636427624034, 630, 274, 356, 1, 1, 2
2042, 1, 1636427624414, 1636427625042, 628, 270, 358, 2, 0, 2
2043, 1, 1636427625401, 1636427626038, 637, 271, 366, 0, 1, 1
2044, 1, 1636427626372, 1636427627006, 634, 270, 364, 0, 0, 0
2045, 1, 1636427627358, 1636427627994, 636, 276, 360, 1, 1, 2
2046, 1, 1636427628345, 1636427628974, 629, 268, 361, 1, 1, 2
2047, 1, 1636427629354, 1636427629990, 636, 275, 361, 2, 1, 3
2048, 1, 1636427630368, 1636427631006, 638, 272, 366, 1, 0, 1
2049, 1, 1636427631354, 1636427631986, 632, 269, 363, 0, 0, 0
2050, 1, 1636427632329, 1636427632962, 633, 270, 363, 1, 0, 1
2051, 1, 1636427633337, 1636427633970, 633, 270, 363, 0, 0, 0
2052, 1, 1636427634364, 1636427634998, 634, 276, 358, 1, 3, 4
2053, 1, 1636427635345, 1636427635982, 637, 271, 366, 2, 2, 4
2054, 1, 1636427636335, 1636427636966, 631, 271, 360, 1, 2, 3
2055, 1, 1636427637307, 1636427637942, 635, 275, 360, 1, 2, 3
2056, 1, 1636427638314, 1636427638950, 636, 274, 362, 0, 1, 1
2057, 1, 1636427639285, 1636427639922, 637, 270, 367, 2, 0, 2
2058, 1, 1636427640292, 1636427640922, 630, 271, 359, 0, 1, 1
2059, 1, 1636427641268, 1636427641902, 634, 274, 360, 0, 0, 0
2060, 1, 1636427642268, 1636427642898, 630, 275, 355, 2, 1, 3
2061, 1, 1636427643303, 1636427643938, 635, 276, 359, 2, 2, 4
2062, 1, 1636427644312, 1636427644942, 630, 274, 356, 1, 0, 1
2063, 1, 1636427645329, 1636427645962, 633, 270, 363, 1, 1, 2
2064, 1, 1636427646310, 1636427646938, 628, 271, 357, 1, 0, 1
2065, 1, 1636427647290, 1636427647918, 628, 270, 358, 1, 2, 3
2066, 1, 1636427648294, 1636427648930, 636, 275, 361, 2, 1, 3
2067, 1, 1636427649303, 1636427649934, 631, 275, 356, 1, 2, 3
2068, 1, 1636427650283, 1636427650914, 631, 272, 359, 0, 0, 0
2069, 1, 1636427651300, 1636427651930, 630, 271, 359, 1, 0, 1
2070, 1, 1636427652329, 1636427652966, 637, 276, 361, 1, 2, 3
2071, 1, 1636427653327, 1636427653958, 631, 274, 357, 1, 2, 3
2072, 1, 1636427654299, 1636427654934, 635, 272, 363, 2, 2, 4
2073, 1, 1636427655313, 1636427655942, 629, 269, 360, 0, 1, 1
2074, 1, 1636427656341, 1636427656978, 637, 275, 362, 1, 2, 3
2075, 1, 1636427657375, 1636427658010, 635, 273, 362, 0, 1, 1
2076, 1, 1636427658348, 1636427658978, 630, 275, 355, 0, 2, 2
2077, 1, 1636427659372, 1636427660002, 630, 269, 361, 0, 0, 0
2078, 1, 1636427660373, 1636427661006, 633, 272, 361, 0, 2, 2
2079, 1, 1636427661391, 1636427662018, 627, 269, 358, 1, 1, 2
2080, 1, 1636427662385, 1636427663022, 637, 270, 367, 0, 1, 1
2081, 1, 1636427663399, 1636427664030, 631, 270, 361, 0, 0, 0
2082, 1, 1636427664427, 1636427665062, 635, 276, 359, 2, 1, 3
2083, 1, 1636427665443, 1636427666078, 635, 274, 361, 1, 2, 3
2084, 1, 1636427666463, 1636427667094, 631, 269, 362, 0, 1, 1
2085, 1, 1636427667452, 1636427668086, 634, 273, 361, 1, 0, 1
2086, 1, 1636427668475, 1636427669110, 635, 274, 361, 0, 1, 1
2087, 1, 1636427669507, 1636427670138, 631, 269, 362, 0, 0, 0
2088, 1, 1636427670514, 1636427671150, 636, 274, 362, 0, 0, 0
2089, 1, 1636427671493, 1636427672122, 629, 270, 359, 1, 1, 2
2090, 1, 1636427672474, 1636427673110, 636, 270, 366, 1, 0, 1
2091, 1, 1636427673463, 1636427674090, 627, 267, 360, 0, 1, 1
2092, 1, 1636427674463, 1636427675094, 631, 269, 362, 0, 1, 1
2093, 1, 1636427675498, 1636427676134, 636, 273, 363, 1, 0, 1
2094, 1, 1636427676477, 1636427677114, 637, 275, 362, 1, 2, 3
2095, 1, 1636427677444, 1636427678066, 622, 270, 352, 1, 1, 2
2096, 1, 1636427678448, 1636427679078, 630, 271, 359, 0, 2, 2
2097, 1, 1636427679443, 1636427680078, 635, 275, 360, 0, 3, 3
2098, 1, 1636427680429, 1636427681062, 633, 270, 363, 1, 0, 1
2099, 1, 1636427681400, 1636427682026, 626, 269, 357, 0, 0, 0
2100, 1, 1636427682403, 1636427683034, 631, 270, 361, 0, 1, 1
2101, 1, 1636427683422, 1636427684050, 628, 270, 358, 1, 1, 2
2102, 1, 1636427684436, 1636427685066, 630, 270, 360, 1, 1, 2
2103, 1, 1636427685425, 1636427686058, 633, 274, 359, 0, 1, 1
2104, 1, 1636427686429, 1636427687062, 633, 269, 364, 1, 0, 1
2105, 1, 1636427687396, 1636427688030, 634, 275, 359, 1, 3, 4
2106, 1, 1636427688402, 1636427689034, 632, 271, 361, 2, 1, 3
2107, 1, 1636427689381, 1636427690010, 629, 272, 357, 0, 2, 2
2108, 1, 1636427690401, 1636427691038, 637, 274, 363, 1, 1, 2
2109, 1, 1636427691416, 1636427692054, 638, 275, 363, 1, 2, 3
2110, 1, 1636427692380, 1636427693002, 622, 271, 351, 1, 1, 2
2111, 1, 1636427693368, 1636427694002, 634, 275, 359, 1, 1, 2
2112, 1, 1636427694345, 1636427694979, 634, 268, 366, 1, 0, 1
2113, 1, 1636427695320, 1636427695950, 630, 271, 359, 1, 2, 3
2114, 1, 1636427696289, 1636427696918, 629, 270, 359, 2, 0, 2
2115, 1, 1636427697315, 1636427697950, 635, 273, 362, 0, 1, 1
2116, 1, 1636427698287, 1636427698918, 631, 271, 360, 1, 1, 2
2117, 1, 1636427699314, 1636427699942, 628, 270, 358, 0, 2, 2
2118, 1, 1636427700334, 1636427700974, 640, 279, 361, 0, 1, 1
2119, 1, 1636427701344, 1636427701978, 634, 274, 360, 1, 1, 2
2120, 1, 1636427702345, 1636427702974, 629, 270, 359, 1, 0, 1
2121, 1, 1636427703351, 1636427703974, 623, 265, 358, 0, 0, 0
2122, 1, 1636427704354, 1636427704982, 628, 270, 358, 1, 1, 2
2123, 1, 1636427742481, 1636427743155, 674, 270, 404, 0, 0, 0
2124, 1, 1636427743453, 1636427744086, 633, 271, 362, 1, 2, 3
2125, 1, 1636427744432, 1636427745062, 630, 269, 361, 0, 0, 0
2126, 1, 1636427745461, 1636427746090, 629, 271, 358, 2, 0, 2
2127, 1, 1636427746486, 1636427747118, 632, 271, 361, 0, 1, 1
2128, 1, 1636427747485, 1636427748122, 637, 271, 366, 1, 1, 2
2129, 1, 1636427748497, 1636427749130, 633, 270, 363, 1, 0, 1
2130, 1, 1636427749520, 1636427750146, 626, 270, 356, 2, 0, 2
2131, 1, 1636427750552, 1636427751178, 626, 273, 353, 0, 0, 0
2132, 1, 1636427751552, 1636427752182, 630, 270, 360, 1, 1, 2
2133, 1, 1636427752523, 1636427753146, 623, 266, 357, 1, 0, 1
2134, 1, 1636427753515, 1636427754146, 631, 269, 362, 1, 1, 2
2135, 1, 1636427754502, 1636427755134, 632, 271, 361, 1, 0, 1
2136, 1, 1636427755514, 1636427756146, 632, 271, 361, 1, 1, 2
2137, 1, 1636427756491, 1636427757122, 631, 270, 361, 0, 1, 1
2138, 1, 1636427757524, 1636427758158, 634, 272, 362, 0, 2, 2
2139, 1, 1636427758520, 1636427759154, 634, 270, 364, 1, 0, 1
2140, 1, 1636427759500, 1636427760130, 630, 268, 362, 1, 0, 1
2141, 1, 1636427760500, 1636427761130, 630, 271, 359, 2, 1, 3
2142, 1, 1636427761510, 1636427762142, 632, 270, 362, 1, 1, 2
2143, 1, 1636427762476, 1636427763106, 630, 273, 357, 1, 1, 2
2144, 1, 1636427763446, 1636427764078, 632, 270, 362, 1, 0, 1
2145, 1, 1636427764431, 1636427765062, 631, 268, 363, 0, 0, 0
2146, 1, 1636427765419, 1636427766054, 635, 269, 366, 0, 1, 1
2147, 1, 1636427766427, 1636427767058, 631, 269, 362, 0, 1, 1
2148, 1, 1636427767442, 1636427768078, 636, 273, 363, 0, 0, 0
2149, 1, 1636427768427, 1636427769054, 627, 270, 357, 0, 0, 0
2150, 1, 1636427769403, 1636427770042, 639, 273, 366, 1, 1, 2
2151, 1, 1636427770438, 1636427771066, 628, 270, 358, 1, 1, 2
2152, 1, 1636427771464, 1636427772090, 626, 268, 358, 0, 0, 0
2153, 1, 1636427772449, 1636427773082, 633, 269, 364, 2, 0, 2
2154, 1, 1636427773439, 1636427774074, 635, 273, 362, 1, 0, 1
2155, 1, 1636427774412, 1636427775046, 634, 273, 361, 0, 1, 1
2156, 1, 1636427775419, 1636427776054, 635, 275, 360, 0, 1, 1
2157, 1, 1636427776389, 1636427777022, 633, 270, 363, 1, 1, 2
2158, 1, 1636427777395, 1636427778030, 635, 269, 366, 1, 0, 1
2159, 1, 1636427778371, 1636427778998, 627, 270, 357, 0, 1, 1
2160, 1, 1636427779364, 1636427779998, 634, 273, 361, 1, 1, 2
2161, 1, 1636427780400, 1636427781030, 630, 268, 362, 0, 0, 0
2162, 1, 1636427781410, 1636427782042, 632, 270, 362, 0, 2, 2
2163, 1, 1636427782428, 1636427783058, 630, 270, 360, 0, 0, 0
2164, 1, 1636427783407, 1636427784038, 631, 270, 361, 2, 1, 3
2165, 1, 1636427784398, 1636427785030, 632, 270, 362, 0, 2, 2
2166, 1, 1636427785402, 1636427786034, 632, 275, 357, 0, 2, 2
2167, 1, 1636427786410, 1636427787046, 636, 271, 365, 0, 2, 2
2168, 1, 1636427787390, 1636427788022, 632, 275, 357, 0, 2, 2
2169, 1, 1636427788407, 1636427789038, 631, 269, 362, 1, 0, 1
2170, 1, 1636427789435, 1636427790062, 627, 270, 357, 0, 1, 1
2171, 1, 1636427790431, 1636427791062, 631, 272, 359, 1, 1, 2
2172, 1, 1636427791402, 1636427792042, 640, 274, 366, 1, 0, 1
2173, 1, 1636427792416, 1636427793046, 630, 269, 361, 0, 0, 0
2174, 1, 1636427793444, 1636427794074, 630, 275, 355, 1, 2, 3
2175, 1, 1636427794477, 1636427795106, 629, 269, 360, 0, 0, 0
2176, 1, 1636427795450, 1636427796082, 632, 270, 362, 1, 1, 2
2177, 1, 1636427796474, 1636427797102, 628, 269, 359, 0, 1, 1
2178, 1, 1636427797510, 1636427798146, 636, 270, 366, 1, 1, 2
2179, 1, 1636427798530, 1636427799162, 632, 271, 361, 2, 0, 2
2180, 1, 1636427799502, 1636427800138, 636, 273, 363, 1, 0, 1
2181, 1, 1636427800515, 1636427801142, 627, 271, 356, 2, 1, 3
2182, 1, 1636427801528, 1636427802154, 626, 269, 357, 1, 0, 1
2183, 1, 1636427802534, 1636427803170, 636, 268, 368, 0, 0, 0
2184, 1, 1636427803554, 1636427804186, 632, 269, 363, 1, 1, 2
2185, 1, 1636427804542, 1636427805174, 632, 270, 362, 1, 0, 1
2186, 1, 1636427805565, 1636427806202, 637, 274, 363, 1, 1, 2
2187, 1, 1636427806596, 1636427807222, 626, 269, 357, 0, 1, 1
2188, 1, 1636427807631, 1636427808262, 631, 269, 362, 0, 0, 0
2189, 1, 1636427808609, 1636427809242, 633, 270, 363, 0, 0, 0
2190, 1, 1636427809591, 1636427810226, 635, 274, 361, 1, 1, 2
2191, 1, 1636427810579, 1636427811206, 627, 265, 362, 0, 0, 0
2192, 1, 1636427811580, 1636427812218, 638, 279, 359, 1, 1, 2
2193, 1, 1636427812606, 1636427813238, 632, 269, 363, 0, 0, 0
2194, 1, 1636427813585, 1636427814218, 633, 271, 362, 0, 2, 2
2195, 1, 1636427814553, 1636427815186, 633, 269, 364, 2, 0, 2
2196, 1, 1636427815560, 1636427816194, 634, 272, 362, 1, 0, 1
2197, 1, 1636427816555, 1636427817182, 627, 267, 360, 0, 1, 1
2198, 1, 1636427817540, 1636427818178, 638, 273, 365, 2, 1, 3
2199, 1, 1636427818530, 1636427819158, 628, 269, 359, 0, 0, 0
2200, 1, 1636427819556, 1636427820190, 634, 274, 360, 0, 1, 1
2201, 1, 1636427820575, 1636427821206, 631, 270, 361, 1, 0, 1
2202, 1, 1636427821589, 1636427822218, 629, 267, 362, 2, 0, 2
2203, 1, 1636427822578, 1636427823210, 632, 273, 359, 0, 1, 1
2204, 1, 1636427823582, 1636427824210, 628, 266, 362, 1, 0, 1
2205, 1, 1636427824547, 1636427825170, 623, 271, 352, 2, 1, 3
2206, 1, 1636427825555, 1636427826186, 631, 273, 358, 1, 0, 1
2207, 1, 1636427826535, 1636427827170, 635, 273, 362, 0, 1, 1
2208, 1, 1636427827554, 1636427828190, 636, 274, 362, 1, 0, 1
2209, 1, 1636427828570, 1636427829198, 628, 268, 360, 0, 0, 0
2210, 1, 1636427829559, 1636427830194, 635, 273, 362, 0, 1, 1
2211, 1, 1636427830526, 1636427831158, 632, 271, 361, 1, 1, 2
2212, 1, 1636427831503, 1636427832130, 627, 270, 357, 1, 1, 2
2213, 1, 1636427832496, 1636427833130, 634, 268, 366, 0, 0, 0
2214, 1, 1636427833464, 1636427834098, 634, 274, 360, 0, 1, 1
2215, 1, 1636427834491, 1636427835126, 635, 275, 360, 0, 2, 2
2216, 1, 1636427835462, 1636427836094, 632, 273, 359, 1, 0, 1
2217, 1, 1636427836488, 1636427837122, 634, 275, 359, 1, 2, 3
2218, 1, 1636427837519, 1636427838150, 631, 270, 361, 1, 1, 2
2219, 1, 1636427838554, 1636427839186, 632, 272, 360, 0, 0, 0
2220, 1, 1636427839555, 1636427840182, 627, 269, 358, 0, 0, 0
2221, 1, 1636427840592, 1636427841218, 626, 270, 356, 2, 0, 2
2222, 1, 1636427841593, 1636427842222, 629, 274, 355, 1, 1, 2
