Xid, State, StartTime, EndTime, TransactionTime, ExecuteTime, CommunicationTime, ReadTime, WriteTime, DBTime
1, 1, 1636426201070, 1636426201858, 788, 432, 356, 0, 25, 25
2, 1, 1636426201943, 1636426202627, 684, 281, 403, 0, 1, 1
3, 1, 1636426202671, 1636426203351, 680, 280, 400, 0, 0, 0
4, 1, 1636426203396, 1636426204071, 675, 278, 397, 0, 1, 1
5, 1, 1636426204116, 1636426204795, 679, 274, 405, 0, 1, 1
6, 1, 1636426204839, 1636426205523, 684, 278, 406, 0, 1, 1
7, 1, 1636426205568, 1636426206247, 679, 276, 403, 0, 0, 0
8, 1, 1636426206292, 1636426206966, 674, 276, 398, 0, 0, 0
9, 1, 1636426207012, 1636426207699, 687, 276, 411, 0, 0, 0
10, 1, 1636426207744, 1636426208419, 675, 276, 399, 0, 1, 1
11, 1, 1636426208464, 1636426209134, 670, 277, 393, 0, 1, 1
12, 1, 1636426209180, 1636426209851, 671, 272, 399, 0, 1, 1
13, 1, 1636426209895, 1636426210563, 668, 269, 399, 0, 0, 0
14, 1, 1636426210608, 1636426211275, 667, 266, 401, 0, 0, 0
15, 1, 1636426211320, 1636426211995, 675, 276, 399, 0, 0, 0
16, 1, 1636426212040, 1636426212715, 675, 277, 398, 0, 0, 0
17, 1, 1636426212760, 1636426213427, 667, 266, 401, 0, 0, 0
18, 1, 1636426213429, 1636426214055, 626, 265, 361, 0, 0, 0
19, 1, 1636426214057, 1636426214686, 629, 268, 361, 0, 0, 0
20, 1, 1636426214080, 1636426214914, 834, 380, 454, 0, 2, 2
21, 1, 1636426214688, 1636426215315, 627, 272, 355, 0, 0, 0
22, 1, 1636426214982, 1636426215658, 676, 275, 401, 0, 0, 0
23, 1, 1636426215317, 1636426215943, 626, 266, 360, 0, 0, 0
24, 1, 1636426215660, 1636426216334, 674, 273, 401, 0, 0, 0
25, 1, 1636426215945, 1636426216571, 626, 267, 359, 0, 0, 0
26, 1, 1636426216336, 1636426217010, 674, 274, 400, 0, 0, 0
27, 1, 1636426216573, 1636426217198, 625, 268, 357, 0, 0, 0
28, 1, 1636426217012, 1636426217682, 670, 271, 399, 0, 0, 0
29, 1, 1636426217200, 1636426217831, 631, 273, 358, 0, 0, 0
30, 1, 1636426217684, 1636426218358, 674, 274, 400, 0, 0, 0
31, 1, 1636426217833, 1636426218458, 625, 267, 358, 0, 0, 0
32, 1, 1636426218360, 1636426219034, 674, 277, 397, 0, 0, 0
33, 1, 1636426218461, 1636426219082, 621, 265, 356, 0, 0, 0
34, 1, 1636426219036, 1636426219710, 674, 276, 398, 0, 0, 0
35, 1, 1636426219085, 1636426219715, 630, 269, 361, 0, 0, 0
37, 1, 1636426219717, 1636426220351, 634, 273, 361, 0, 0, 0
36, 1, 1636426219712, 1636426220398, 686, 275, 411, 0, 0, 0
38, 1, 1636426220353, 1636426220979, 626, 265, 361, 0, 0, 0
39, 1, 1636426220400, 1636426221074, 674, 275, 399, 0, 0, 0
40, 1, 1636426220981, 1636426221603, 622, 261, 361, 0, 0, 0
41, 1, 1636426221076, 1636426221750, 674, 275, 399, 0, 0, 0
42, 1, 1636426221605, 1636426222227, 622, 267, 355, 0, 0, 0
43, 1, 1636426221752, 1636426222430, 678, 279, 399, 0, 0, 0
44, 1, 1636426222229, 1636426222850, 621, 261, 360, 0, 0, 0
45, 1, 1636426222432, 1636426223106, 674, 276, 398, 0, 0, 0
46, 1, 1636426222853, 1636426223474, 621, 265, 356, 0, 0, 0
47, 1, 1636426223109, 1636426223786, 677, 273, 404, 0, 0, 0
48, 1, 1636426223476, 1636426224099, 623, 267, 356, 0, 0, 0
49, 1, 1636426223788, 1636426224462, 674, 274, 400, 0, 0, 0
50, 1, 1636426224101, 1636426224730, 629, 270, 359, 0, 0, 0
51, 1, 1636426224464, 1636426225142, 678, 276, 402, 0, 0, 0
52, 1, 1636426224732, 1636426225350, 618, 259, 359, 0, 0, 0
53, 1, 1636426225144, 1636426225770, 626, 274, 352, 0, 0, 0
54, 1, 1636426225353, 1636426225979, 626, 267, 359, 0, 0, 0
55, 1, 1636426225547, 1636426226310, 763, 381, 382, 0, 0, 0
56, 1, 1636426225772, 1636426226402, 630, 276, 354, 0, 0, 0
57, 1, 1636426225981, 1636426226598, 617, 262, 355, 0, 0, 0
59, 1, 1636426226404, 1636426227034, 630, 273, 357, 0, 0, 0
58, 1, 1636426226382, 1636426227050, 668, 274, 394, 0, 1, 1
60, 1, 1636426226600, 1636426227222, 622, 267, 355, 0, 0, 0
61, 1, 1636426227036, 1636426227662, 626, 271, 355, 0, 0, 0
62, 1, 1636426227052, 1636426227738, 686, 279, 407, 0, 0, 0
63, 1, 1636426227224, 1636426227846, 622, 262, 360, 0, 0, 0
64, 1, 1636426227665, 1636426228294, 629, 276, 353, 0, 0, 0
65, 1, 1636426227740, 1636426228410, 670, 273, 397, 0, 0, 0
66, 1, 1636426227848, 1636426228470, 622, 267, 355, 0, 1, 1
67, 1, 1636426228296, 1636426228930, 634, 280, 354, 0, 0, 0
68, 1, 1636426228412, 1636426229078, 666, 273, 393, 0, 0, 0
69, 1, 1636426228473, 1636426229095, 622, 266, 356, 0, 0, 0
70, 1, 1636426228932, 1636426229562, 630, 277, 353, 0, 0, 0
72, 1, 1636426229097, 1636426229722, 625, 267, 358, 0, 1, 1
71, 1, 1636426229080, 1636426229750, 670, 273, 397, 0, 0, 0
73, 1, 1636426229564, 1636426230194, 630, 275, 355, 0, 0, 0
74, 1, 1636426229724, 1636426230342, 618, 266, 352, 0, 0, 0
75, 1, 1636426229752, 1636426230426, 674, 274, 400, 0, 0, 0
76, 1, 1636426230196, 1636426230826, 630, 275, 355, 0, 1, 1
77, 1, 1636426230345, 1636426230970, 625, 268, 357, 0, 0, 0
78, 1, 1636426230428, 1636426231094, 666, 273, 393, 0, 0, 0
79, 1, 1636426230827, 1636426231458, 631, 275, 356, 0, 1, 1
80, 1, 1636426230972, 1636426231590, 618, 267, 351, 0, 1, 1
81, 1, 1636426231096, 1636426231778, 682, 273, 409, 0, 0, 0
82, 1, 1636426231460, 1636426232090, 630, 274, 356, 0, 1, 1
83, 1, 1636426231592, 1636426232210, 618, 266, 352, 0, 1, 1
84, 1, 1636426231780, 1636426232446, 666, 273, 393, 0, 0, 0
85, 1, 1636426232092, 1636426232722, 630, 275, 355, 0, 0, 0
86, 1, 1636426232212, 1636426232826, 614, 264, 350, 0, 0, 0
87, 1, 1636426232448, 1636426233122, 674, 273, 401, 0, 0, 0
88, 1, 1636426232724, 1636426233350, 626, 271, 355, 0, 1, 1
89, 1, 1636426232828, 1636426233450, 622, 270, 352, 0, 1, 1
90, 1, 1636426233124, 1636426233798, 674, 277, 397, 0, 1, 1
91, 1, 1636426233352, 1636426233978, 626, 270, 356, 0, 0, 0
92, 1, 1636426233453, 1636426234074, 621, 263, 358, 0, 0, 0
93, 1, 1636426233800, 1636426234474, 674, 275, 399, 0, 0, 0
94, 1, 1636426233980, 1636426234610, 630, 275, 355, 0, 0, 0
95, 1, 1636426234076, 1636426234694, 618, 261, 357, 0, 0, 0
96, 1, 1636426234476, 1636426235142, 666, 273, 393, 0, 0, 0
97, 1, 1636426234612, 1636426235242, 630, 274, 356, 0, 0, 0
98, 1, 1636426234697, 1636426235322, 625, 267, 358, 0, 0, 0
99, 1, 1636426235144, 1636426235814, 670, 273, 397, 0, 1, 1
100, 1, 1636426235244, 1636426235870, 626, 271, 355, 0, 0, 0
101, 1, 1636426235324, 1636426235947, 623, 264, 359, 0, 0, 0
102, 1, 1636426235816, 1636426236486, 670, 273, 397, 0, 0, 0
103, 1, 1636426235872, 1636426236498, 626, 270, 356, 0, 1, 1
104, 1, 1636426235949, 1636426236574, 625, 267, 358, 0, 0, 0
105, 1, 1636426236488, 1636426237114, 626, 274, 352, 0, 0, 0
106, 1, 1636426236500, 1636426237138, 638, 275, 363, 0, 0, 0
107, 1, 1636426236577, 1636426237202, 625, 268, 357, 0, 1, 1
108, 1, 1636426237116, 1636426237742, 626, 273, 353, 0, 0, 0
109, 1, 1636426237140, 1636426237770, 630, 276, 354, 0, 0, 0
110, 1, 1636426237204, 1636426237823, 619, 262, 357, 0, 0, 0
111, 1, 1636426237744, 1636426238370, 626, 278, 348, 0, 1, 1
112, 1, 1636426237772, 1636426238402, 630, 274, 356, 0, 0, 0
113, 1, 1636426237825, 1636426238454, 629, 275, 354, 0, 1, 1
114, 1, 1636426238372, 1636426239002, 630, 274, 356, 0, 0, 0
115, 1, 1636426238403, 1636426239034, 631, 275, 356, 0, 1, 1
116, 1, 1636426238456, 1636426239074, 618, 261, 357, 0, 0, 0
117, 1, 1636426239004, 1636426239638, 634, 275, 359, 0, 1, 1
118, 1, 1636426239036, 1636426239666, 630, 276, 354, 0, 0, 0
119, 1, 1636426239077, 1636426239694, 617, 262, 355, 0, 0, 0
120, 1, 1636426239640, 1636426240266, 626, 273, 353, 0, 1, 1
121, 1, 1636426239668, 1636426240298, 630, 275, 355, 0, 1, 1
122, 1, 1636426239696, 1636426240323, 627, 269, 358, 0, 0, 0
123, 1, 1636426240268, 1636426240898, 630, 274, 356, 0, 0, 0
124, 1, 1636426240300, 1636426240934, 634, 275, 359, 0, 0, 0
125, 1, 1636426240325, 1636426240943, 618, 261, 357, 0, 0, 0
126, 1, 1636426240900, 1636426241526, 626, 274, 352, 0, 1, 1
127, 1, 1636426240936, 1636426241562, 626, 275, 351, 0, 0, 0
128, 1, 1636426240945, 1636426241574, 629, 271, 358, 0, 0, 0
129, 1, 1636426241528, 1636426242154, 626, 269, 357, 0, 0, 0
130, 1, 1636426241564, 1636426242194, 630, 275, 355, 0, 0, 0
131, 1, 1636426241575, 1636426242198, 623, 271, 352, 0, 0, 0
132, 1, 1636426242156, 1636426242778, 622, 274, 348, 0, 0, 0
134, 1, 1636426242201, 1636426242818, 617, 267, 350, 0, 1, 1
133, 1, 1636426242196, 1636426242826, 630, 275, 355, 0, 0, 0
135, 1, 1636426242780, 1636426243406, 626, 275, 351, 0, 1, 1
136, 1, 1636426242821, 1636426243446, 625, 270, 355, 0, 0, 0
137, 1, 1636426242828, 1636426243458, 630, 272, 358, 0, 0, 0
138, 1, 1636426243408, 1636426244034, 626, 270, 356, 0, 1, 1
139, 1, 1636426243449, 1636426244066, 617, 262, 355, 0, 0, 0
140, 1, 1636426243460, 1636426244086, 626, 275, 351, 0, 0, 0
141, 1, 1636426244036, 1636426244666, 630, 273, 357, 0, 1, 1
142, 1, 1636426244068, 1636426244687, 619, 262, 357, 0, 0, 0
143, 1, 1636426244088, 1636426244718, 630, 276, 354, 0, 0, 0
144, 1, 1636426244668, 1636426245302, 634, 286, 348, 0, 0, 0
145, 1, 1636426244689, 1636426245306, 617, 263, 354, 0, 0, 0
146, 1, 1636426244719, 1636426245346, 627, 271, 356, 0, 0, 0
147, 1, 1636426245304, 1636426245930, 626, 269, 357, 0, 0, 0
148, 1, 1636426245310, 1636426245930, 620, 268, 352, 0, 1, 1
149, 1, 1636426245348, 1636426245978, 630, 274, 356, 0, 0, 0
151, 1, 1636426245933, 1636426246550, 617, 263, 354, 0, 0, 0
150, 1, 1636426245932, 1636426246554, 622, 269, 353, 0, 0, 0
152, 1, 1636426245980, 1636426246610, 630, 276, 354, 0, 1, 1
153, 1, 1636426246553, 1636426247174, 621, 263, 358, 0, 0, 0
154, 1, 1636426246556, 1636426247182, 626, 274, 352, 0, 0, 0
155, 1, 1636426246612, 1636426247242, 630, 274, 356, 0, 0, 0
156, 1, 1636426247176, 1636426247790, 614, 262, 352, 0, 0, 0
157, 1, 1636426247184, 1636426247814, 630, 275, 355, 0, 0, 0
158, 1, 1636426247244, 1636426247874, 630, 273, 357, 0, 0, 0
159, 1, 1636426247792, 1636426248411, 619, 262, 357, 0, 0, 0
160, 1, 1636426247816, 1636426248446, 630, 273, 357, 0, 0, 0
161, 1, 1636426247876, 1636426248506, 630, 275, 355, 0, 0, 0
162, 1, 1636426248413, 1636426249034, 621, 262, 359, 0, 0, 0
163, 1, 1636426248448, 1636426249074, 626, 273, 353, 0, 0, 0
164, 1, 1636426248508, 1636426249134, 626, 271, 355, 0, 0, 0
165, 1, 1636426249036, 1636426249650, 614, 263, 351, 0, 0, 0
166, 1, 1636426249076, 1636426249698, 622, 275, 347, 0, 1, 1
167, 1, 1636426249136, 1636426249762, 626, 271, 355, 0, 0, 0
168, 1, 1636426249652, 1636426250270, 618, 266, 352, 0, 1, 1
169, 1, 1636426249700, 1636426250326, 626, 270, 356, 0, 1, 1
170, 1, 1636426249764, 1636426250398, 634, 278, 356, 0, 1, 1
171, 1, 1636426250273, 1636426250890, 617, 261, 356, 0, 0, 0
172, 1, 1636426250328, 1636426250958, 630, 274, 356, 0, 1, 1
173, 1, 1636426250400, 1636426251030, 630, 275, 355, 0, 0, 0
174, 1, 1636426250892, 1636426251506, 614, 261, 353, 0, 0, 0
175, 1, 1636426250960, 1636426251594, 634, 274, 360, 0, 1, 1
176, 1, 1636426251032, 1636426251662, 630, 274, 356, 0, 1, 1
177, 1, 1636426251508, 1636426252122, 614, 261, 353, 0, 0, 0
178, 1, 1636426251596, 1636426252226, 630, 274, 356, 0, 0, 0
179, 1, 1636426251664, 1636426252294, 630, 275, 355, 0, 1, 1
180, 1, 1636426252125, 1636426252742, 617, 266, 351, 0, 0, 0
181, 1, 1636426252228, 1636426252858, 630, 273, 357, 0, 0, 0
182, 1, 1636426252296, 1636426252930, 634, 275, 359, 0, 0, 0
183, 1, 1636426252744, 1636426253358, 614, 261, 353, 0, 0, 0
184, 1, 1636426252860, 1636426253490, 630, 275, 355, 0, 1, 1
185, 1, 1636426252932, 1636426253566, 634, 275, 359, 0, 0, 0
186, 1, 1636426253361, 1636426253974, 613, 260, 353, 0, 0, 0
187, 1, 1636426253492, 1636426254118, 626, 268, 358, 0, 0, 0
188, 1, 1636426253567, 1636426254198, 631, 275, 356, 0, 0, 0
189, 1, 1636426253976, 1636426254598, 622, 268, 354, 0, 0, 0
190, 1, 1636426254120, 1636426254742, 622, 274, 348, 0, 0, 0
191, 1, 1636426254200, 1636426254830, 630, 275, 355, 0, 0, 0
192, 1, 1636426254601, 1636426255223, 622, 262, 360, 0, 0, 0
193, 1, 1636426254744, 1636426255378, 634, 281, 353, 0, 1, 1
194, 1, 1636426254832, 1636426255466, 634, 279, 355, 0, 0, 0
195, 1, 1636426255225, 1636426255842, 617, 262, 355, 0, 0, 0
196, 1, 1636426255379, 1636426256002, 623, 269, 354, 0, 0, 0
197, 1, 1636426255467, 1636426256094, 627, 270, 357, 0, 0, 0
198, 1, 1636426255845, 1636426256466, 621, 263, 358, 0, 0, 0
199, 1, 1636426256004, 1636426256622, 618, 272, 346, 0, 0, 0
200, 1, 1636426256095, 1636426256722, 627, 272, 355, 0, 0, 0
201, 1, 1636426256468, 1636426257082, 614, 261, 353, 0, 0, 0
202, 1, 1636426256623, 1636426257254, 631, 273, 358, 0, 0, 0
203, 1, 1636426256723, 1636426257358, 635, 275, 360, 0, 0, 0
204, 1, 1636426257085, 1636426257698, 613, 262, 351, 0, 1, 1
205, 1, 1636426257256, 1636426257878, 622, 273, 349, 0, 1, 1
206, 1, 1636426257360, 1636426257994, 634, 275, 359, 0, 0, 0
207, 1, 1636426257701, 1636426258318, 617, 262, 355, 0, 0, 0
208, 1, 1636426257879, 1636426258502, 623, 273, 350, 0, 0, 0
209, 1, 1636426257995, 1636426258630, 635, 279, 356, 0, 0, 0
210, 1, 1636426258321, 1636426258938, 617, 261, 356, 0, 0, 0
211, 1, 1636426258504, 1636426259126, 622, 270, 352, 0, 0, 0
212, 1, 1636426258632, 1636426259262, 630, 274, 356, 0, 0, 0
213, 1, 1636426258941, 1636426259554, 613, 261, 352, 0, 0, 0
214, 1, 1636426259128, 1636426259762, 634, 278, 356, 0, 0, 0
215, 1, 1636426259264, 1636426259894, 630, 275, 355, 0, 0, 0
216, 1, 1636426259556, 1636426260178, 622, 266, 356, 0, 0, 0
217, 1, 1636426259763, 1636426260394, 631, 274, 357, 0, 0, 0
218, 1, 1636426259896, 1636426260522, 626, 271, 355, 0, 1, 1
219, 1, 1636426260180, 1636426260798, 618, 262, 356, 0, 1, 1
220, 1, 1636426260396, 1636426261022, 626, 274, 352, 0, 0, 0
221, 1, 1636426260524, 1636426261154, 630, 276, 354, 0, 0, 0
222, 1, 1636426260799, 1636426261414, 615, 264, 351, 0, 0, 0
223, 1, 1636426261024, 1636426261654, 630, 275, 355, 0, 1, 1
224, 1, 1636426261155, 1636426261786, 631, 272, 359, 0, 0, 0
225, 1, 1636426261415, 1636426262030, 615, 263, 352, 0, 0, 0
226, 1, 1636426261655, 1636426262274, 619, 266, 353, 0, 1, 1
227, 1, 1636426261787, 1636426262418, 631, 275, 356, 0, 1, 1
228, 1, 1636426262032, 1636426262646, 614, 262, 352, 0, 0, 0
229, 1, 1636426262276, 1636426262906, 630, 274, 356, 0, 0, 0
230, 1, 1636426262420, 1636426263046, 626, 275, 351, 0, 0, 0
231, 1, 1636426262649, 1636426263263, 614, 263, 351, 0, 0, 0
232, 1, 1636426262907, 1636426263534, 627, 274, 353, 0, 0, 0
233, 1, 1636426263047, 1636426263678, 631, 275, 356, 0, 0, 0
234, 1, 1636426263265, 1636426263882, 617, 267, 350, 0, 0, 0
235, 1, 1636426263536, 1636426264162, 626, 270, 356, 0, 0, 0
236, 1, 1636426263680, 1636426264302, 622, 266, 356, 0, 0, 0
237, 1, 1636426263884, 1636426264498, 614, 261, 353, 0, 0, 0
238, 1, 1636426264164, 1636426264790, 626, 273, 353, 0, 1, 1
239, 1, 1636426264304, 1636426264942, 638, 282, 356, 0, 0, 0
240, 1, 1636426264501, 1636426265118, 617, 262, 355, 0, 0, 0
241, 1, 1636426264792, 1636426265418, 626, 273, 353, 0, 0, 0
242, 1, 1636426264944, 1636426265574, 630, 274, 356, 0, 0, 0
243, 1, 1636426265120, 1636426265734, 614, 262, 352, 0, 1, 1
244, 1, 1636426265419, 1636426266050, 631, 274, 357, 0, 0, 0
245, 1, 1636426265576, 1636426266194, 618, 263, 355, 0, 0, 0
246, 1, 1636426265736, 1636426266350, 614, 262, 352, 0, 0, 0
247, 1, 1636426266052, 1636426266678, 626, 274, 352, 0, 0, 0
248, 1, 1636426266196, 1636426266826, 630, 276, 354, 0, 0, 0
249, 1, 1636426266353, 1636426266970, 617, 263, 354, 0, 0, 0
250, 1, 1636426266680, 1636426267310, 630, 275, 355, 0, 1, 1
251, 1, 1636426266828, 1636426267458, 630, 275, 355, 0, 0, 0
252, 1, 1636426266972, 1636426267586, 614, 263, 351, 0, 0, 0
253, 1, 1636426267312, 1636426267938, 626, 273, 353, 0, 0, 0
254, 1, 1636426267459, 1636426268090, 631, 270, 361, 0, 0, 0
255, 1, 1636426267588, 1636426268202, 614, 263, 351, 0, 0, 0
256, 1, 1636426267940, 1636426268570, 630, 275, 355, 0, 0, 0
257, 1, 1636426268092, 1636426268722, 630, 277, 353, 0, 0, 0
258, 1, 1636426268203, 1636426268818, 615, 262, 353, 0, 1, 1
259, 1, 1636426268572, 1636426269202, 630, 273, 357, 0, 0, 0
260, 1, 1636426268725, 1636426269354, 629, 275, 354, 0, 1, 1
261, 1, 1636426268821, 1636426269442, 621, 262, 359, 0, 0, 0
262, 1, 1636426269204, 1636426269834, 630, 274, 356, 0, 0, 0
263, 1, 1636426269356, 1636426269982, 626, 270, 356, 0, 0, 0
264, 1, 1636426269444, 1636426270058, 614, 262, 352, 0, 0, 0
265, 1, 1636426269836, 1636426270454, 618, 269, 349, 0, 0, 0
266, 1, 1636426269984, 1636426270618, 634, 279, 355, 0, 0, 0
267, 1, 1636426270061, 1636426270674, 613, 262, 351, 0, 0, 0
268, 1, 1636426270456, 1636426271086, 630, 273, 357, 0, 1, 1
269, 1, 1636426270620, 1636426271254, 634, 275, 359, 0, 0, 0
270, 1, 1636426270676, 1636426271294, 618, 263, 355, 0, 0, 0
271, 1, 1636426271088, 1636426271710, 622, 271, 351, 0, 0, 0
272, 1, 1636426271261, 1636426271890, 629, 275, 354, 0, 0, 0
273, 1, 1636426271296, 1636426271918, 622, 262, 360, 0, 0, 0
274, 1, 1636426271711, 1636426272334, 623, 274, 349, 0, 0, 0
275, 1, 1636426271892, 1636426272522, 630, 275, 355, 0, 0, 0
276, 1, 1636426271920, 1636426272534, 614, 262, 352, 0, 0, 0
277, 1, 1636426272336, 1636426272962, 626, 274, 352, 0, 1, 1
279, 1, 1636426272536, 1636426273151, 615, 263, 352, 0, 0, 0
278, 1, 1636426272524, 1636426273158, 634, 279, 355, 0, 0, 0
280, 1, 1636426272964, 1636426273590, 626, 272, 354, 0, 0, 0
281, 1, 1636426273153, 1636426273770, 617, 262, 355, 0, 0, 0
282, 1, 1636426273160, 1636426273794, 634, 278, 356, 0, 0, 0
283, 1, 1636426273592, 1636426274214, 622, 270, 352, 0, 1, 1
284, 1, 1636426273773, 1636426274386, 613, 261, 352, 0, 0, 0
285, 1, 1636426273796, 1636426274426, 630, 276, 354, 0, 0, 0
286, 1, 1636426274216, 1636426274846, 630, 273, 357, 0, 0, 0
287, 1, 1636426274388, 1636426275002, 614, 262, 352, 0, 0, 0
288, 1, 1636426274428, 1636426275062, 634, 279, 355, 0, 0, 0
289, 1, 1636426274848, 1636426275470, 622, 274, 348, 0, 0, 0
290, 1, 1636426275004, 1636426275622, 618, 266, 352, 0, 0, 0
291, 1, 1636426275064, 1636426275694, 630, 276, 354, 0, 0, 0
292, 1, 1636426275471, 1636426276102, 631, 274, 357, 0, 0, 0
293, 1, 1636426275624, 1636426276242, 618, 266, 352, 0, 0, 0
294, 1, 1636426275696, 1636426276322, 626, 271, 355, 0, 0, 0
295, 1, 1636426276104, 1636426276730, 626, 273, 353, 0, 0, 0
296, 1, 1636426276244, 1636426276862, 618, 268, 350, 0, 0, 0
297, 1, 1636426276324, 1636426276954, 630, 274, 356, 0, 1, 1
298, 1, 1636426276731, 1636426277354, 623, 269, 354, 0, 0, 0
299, 1, 1636426276865, 1636426277482, 617, 262, 355, 0, 0, 0
300, 1, 1636426276956, 1636426277582, 626, 272, 354, 0, 0, 0
301, 1, 1636426277355, 1636426277982, 627, 270, 357, 0, 0, 0
302, 1, 1636426277484, 1636426278102, 618, 262, 356, 0, 0, 0
303, 1, 1636426277584, 1636426278214, 630, 270, 360, 0, 0, 0
304, 1, 1636426277984, 1636426278614, 630, 274, 356, 0, 0, 0
305, 1, 1636426278104, 1636426278718, 614, 262, 352, 0, 0, 0
306, 1, 1636426278216, 1636426278850, 634, 274, 360, 0, 1, 1
307, 1, 1636426278616, 1636426279242, 626, 275, 351, 0, 0, 0
308, 1, 1636426278720, 1636426279334, 614, 263, 351, 0, 1, 1
309, 1, 1636426278852, 1636426279482, 630, 275, 355, 0, 1, 1
310, 1, 1636426279245, 1636426279866, 621, 274, 347, 0, 0, 0
311, 1, 1636426279337, 1636426279950, 613, 264, 349, 0, 0, 0
312, 1, 1636426279483, 1636426280110, 627, 271, 356, 0, 0, 0
313, 1, 1636426279868, 1636426280494, 626, 273, 353, 0, 0, 0
314, 1, 1636426279952, 1636426280566, 614, 262, 352, 0, 0, 0
315, 1, 1636426280111, 1636426280742, 631, 275, 356, 0, 0, 0
316, 1, 1636426280496, 1636426281122, 626, 272, 354, 0, 0, 0
317, 1, 1636426280568, 1636426281182, 614, 263, 351, 0, 1, 1
318, 1, 1636426280744, 1636426281378, 634, 283, 351, 0, 0, 0
319, 1, 1636426281124, 1636426281750, 626, 270, 356, 0, 0, 0
320, 1, 1636426281185, 1636426281802, 617, 262, 355, 0, 0, 0
321, 1, 1636426281379, 1636426282010, 631, 275, 356, 0, 1, 1
322, 1, 1636426281752, 1636426282374, 622, 271, 351, 0, 0, 0
323, 1, 1636426281804, 1636426282418, 614, 262, 352, 0, 1, 1
324, 1, 1636426282012, 1636426282642, 630, 275, 355, 0, 0, 0
325, 1, 1636426282376, 1636426283006, 630, 275, 355, 0, 1, 1
326, 1, 1636426282420, 1636426283034, 614, 261, 353, 0, 0, 0
327, 1, 1636426282643, 1636426283270, 627, 270, 357, 0, 1, 1
328, 1, 1636426283008, 1636426283634, 626, 273, 353, 0, 0, 0
329, 1, 1636426283037, 1636426283650, 613, 262, 351, 0, 0, 0
330, 1, 1636426283272, 1636426283902, 630, 275, 355, 0, 0, 0
331, 1, 1636426283636, 1636426284258, 622, 270, 352, 0, 1, 1
332, 1, 1636426283652, 1636426284270, 618, 263, 355, 0, 1, 1
333, 1, 1636426283904, 1636426284534, 630, 275, 355, 0, 0, 0
334, 1, 1636426284260, 1636426284886, 626, 273, 353, 0, 0, 0
335, 1, 1636426284272, 1636426284890, 618, 263, 355, 0, 1, 1
336, 1, 1636426284536, 1636426285166, 630, 273, 357, 0, 0, 0
338, 1, 1636426284892, 1636426285506, 614, 262, 352, 0, 0, 0
337, 1, 1636426284888, 1636426285518, 630, 275, 355, 0, 1, 1
339, 1, 1636426285168, 1636426285798, 630, 275, 355, 0, 0, 0
340, 1, 1636426285508, 1636426286122, 614, 262, 352, 0, 0, 0
341, 1, 1636426285519, 1636426286150, 631, 274, 357, 0, 0, 0
342, 1, 1636426285800, 1636426286430, 630, 275, 355, 0, 1, 1
343, 1, 1636426286124, 1636426286738, 614, 262, 352, 0, 0, 0
344, 1, 1636426286152, 1636426286778, 626, 269, 357, 0, 1, 1
345, 1, 1636426286432, 1636426287066, 634, 279, 355, 0, 1, 1
346, 1, 1636426286740, 1636426287358, 618, 263, 355, 0, 0, 0
347, 1, 1636426286780, 1636426287410, 630, 273, 357, 0, 0, 0
348, 1, 1636426287068, 1636426287698, 630, 271, 359, 0, 1, 1
349, 1, 1636426287361, 1636426287978, 617, 262, 355, 0, 0, 0
350, 1, 1636426287412, 1636426288038, 626, 274, 352, 0, 0, 0
351, 1, 1636426287700, 1636426288326, 626, 270, 356, 0, 1, 1
352, 1, 1636426287980, 1636426288598, 618, 265, 353, 0, 0, 0
353, 1, 1636426288040, 1636426288670, 630, 274, 356, 0, 0, 0
354, 1, 1636426288328, 1636426288954, 626, 271, 355, 0, 0, 0
355, 1, 1636426288600, 1636426289214, 614, 262, 352, 0, 0, 0
356, 1, 1636426288672, 1636426289298, 626, 274, 352, 0, 1, 1
357, 1, 1636426288956, 1636426289586, 630, 274, 356, 0, 0, 0
358, 1, 1636426289216, 1636426289834, 618, 262, 356, 0, 0, 0
359, 1, 1636426289300, 1636426289934, 634, 279, 355, 0, 1, 1
360, 1, 1636426289587, 1636426290218, 631, 275, 356, 0, 0, 0
361, 1, 1636426289836, 1636426290450, 614, 262, 352, 0, 0, 0
362, 1, 1636426289936, 1636426290562, 626, 275, 351, 0, 0, 0
363, 1, 1636426290220, 1636426290858, 638, 280, 358, 0, 1, 1
364, 1, 1636426290452, 1636426291066, 614, 263, 351, 0, 1, 1
365, 1, 1636426290564, 1636426291194, 630, 274, 356, 0, 0, 0
366, 1, 1636426290859, 1636426291490, 631, 275, 356, 0, 1, 1
367, 1, 1636426291068, 1636426291682, 614, 263, 351, 0, 0, 0
368, 1, 1636426291196, 1636426291814, 618, 270, 348, 0, 0, 0
369, 1, 1636426291492, 1636426292114, 622, 266, 356, 0, 0, 0
370, 1, 1636426291684, 1636426292302, 618, 266, 352, 0, 1, 1
371, 1, 1636426291816, 1636426292442, 626, 275, 351, 0, 0, 0
372, 1, 1636426292116, 1636426292750, 634, 275, 359, 0, 0, 0
373, 1, 1636426292305, 1636426292918, 613, 262, 351, 0, 0, 0
374, 1, 1636426292444, 1636426293078, 634, 275, 359, 0, 0, 0
375, 1, 1636426292752, 1636426293378, 626, 271, 355, 0, 0, 0
376, 1, 1636426292920, 1636426293534, 614, 263, 351, 0, 1, 1
377, 1, 1636426293080, 1636426293710, 630, 274, 356, 0, 0, 0
378, 1, 1636426293379, 1636426294006, 627, 270, 357, 0, 0, 0
379, 1, 1636426293536, 1636426294154, 618, 263, 355, 0, 1, 1
380, 1, 1636426293712, 1636426294338, 626, 274, 352, 0, 0, 0
381, 1, 1636426294008, 1636426294630, 622, 267, 355, 0, 0, 0
382, 1, 1636426294156, 1636426294770, 614, 262, 352, 0, 0, 0
383, 1, 1636426294340, 1636426294966, 626, 274, 352, 0, 0, 0
384, 1, 1636426294632, 1636426295258, 626, 271, 355, 0, 0, 0
385, 1, 1636426294772, 1636426295390, 618, 263, 355, 0, 1, 1
386, 1, 1636426294968, 1636426295594, 626, 275, 351, 0, 0, 0
387, 1, 1636426295260, 1636426295890, 630, 274, 356, 0, 0, 0
388, 1, 1636426295393, 1636426296018, 625, 265, 360, 0, 0, 0
389, 1, 1636426295596, 1636426296222, 626, 274, 352, 0, 0, 0
390, 1, 1636426295892, 1636426296526, 634, 275, 359, 0, 1, 1
391, 1, 1636426296020, 1636426296642, 622, 266, 356, 0, 0, 0
392, 1, 1636426296224, 1636426296854, 630, 274, 356, 0, 1, 1
393, 1, 1636426296528, 1636426297158, 630, 273, 357, 0, 0, 0
394, 1, 1636426296645, 1636426297262, 617, 262, 355, 0, 0, 0
395, 1, 1636426296855, 1636426297486, 631, 279, 352, 0, 0, 0
396, 1, 1636426297160, 1636426297790, 630, 275, 355, 0, 1, 1
397, 1, 1636426297264, 1636426297878, 614, 262, 352, 0, 0, 0
398, 1, 1636426297487, 1636426298114, 627, 273, 354, 0, 0, 0
399, 1, 1636426297792, 1636426298422, 630, 275, 355, 0, 0, 0
400, 1, 1636426297881, 1636426298494, 613, 260, 353, 0, 0, 0
401, 1, 1636426298116, 1636426298742, 626, 275, 351, 0, 0, 0
402, 1, 1636426298423, 1636426299050, 627, 271, 356, 0, 1, 1
403, 1, 1636426298497, 1636426299118, 621, 266, 355