Xid, State, StartTime, EndTime, TransactionTime, ExecuteTime, CommunicationTime, ReadTime, WriteTime, DBTime
1, 1, 1636420148224, 1636420149305, 1081, 714, 367, 0, 46, 46
2, 1, 1636420149401, 1636420150079, 678, 277, 401, 0, 1, 1
3, 1, 1636420150124, 1636420150803, 679, 280, 399, 0, 0, 0
4, 1, 1636420150847, 1636420151527, 680, 278, 402, 0, 1, 1
5, 1, 1636420151572, 1636420152251, 679, 280, 399, 0, 0, 0
6, 1, 1636420152296, 1636420152971, 675, 277, 398, 0, 0, 0
7, 1, 1636420153016, 1636420153691, 675, 277, 398, 0, 1, 1
8, 1, 1636420153735, 1636420154403, 668, 269, 399, 0, 1, 1
9, 1, 1636420154448, 1636420155123, 675, 267, 408, 0, 1, 1
10, 1, 1636420155168, 1636420155839, 671, 268, 403, 0, 1, 1
11, 1, 1636420155884, 1636420156547, 663, 268, 395, 0, 1, 1
12, 1, 1636420156592, 1636420157263, 671, 268, 403, 0, 1, 1
13, 1, 1636420157308, 1636420157979, 671, 268, 403, 0, 1, 1
14, 1, 1636420158024, 1636420158698, 674, 276, 398, 0, 0, 0
15, 1, 1636420158744, 1636420159415, 671, 271, 400, 0, 0, 0
16, 1, 1636420159460, 1636420160138, 678, 280, 398, 0, 0, 0
17, 1, 1636420160184, 1636420160850, 666, 270, 396, 0, 0, 0
18, 1, 1636420160852, 1636420161470, 618, 268, 350, 0, 0, 0
19, 1, 1636420161473, 1636420162099, 626, 271, 355, 0, 0, 0
20, 1, 1636420162101, 1636420162718, 617, 259, 358, 0, 0, 0
22, 1, 1636420162720, 1636420163342, 622, 266, 356, 0, 0, 0
21, 1, 1636420162575, 1636420163386, 811, 414, 397, 0, 1, 1
23, 1, 1636420163345, 1636420163971, 626, 270, 356, 0, 0, 0
24, 1, 1636420163449, 1636420164118, 669, 269, 400, 0, 0, 0
25, 1, 1636420163973, 1636420164598, 625, 271, 354, 0, 0, 0
26, 1, 1636420164120, 1636420164795, 675, 273, 402, 0, 0, 0
27, 1, 1636420164600, 1636420165227, 627, 270, 357, 0, 0, 0
28, 1, 1636420164797, 1636420165470, 673, 269, 404, 0, 0, 0
29, 1, 1636420165229, 1636420165846, 617, 265, 352, 0, 0, 0
30, 1, 1636420165472, 1636420166142, 670, 270, 400, 0, 0, 0
31, 1, 1636420165849, 1636420166471, 622, 264, 358, 0, 0, 0
32, 1, 1636420166145, 1636420166814, 669, 269, 400, 0, 0, 0
33, 1, 1636420166473, 1636420167091, 618, 266, 352, 0, 0, 0
34, 1, 1636420166816, 1636420167486, 670, 271, 399, 0, 0, 0
35, 1, 1636420167093, 1636420167715, 622, 264, 358, 0, 0, 0
36, 1, 1636420167489, 1636420168162, 673, 272, 401, 0, 0, 0
37, 1, 1636420167717, 1636420168339, 622, 271, 351, 0, 1, 1
38, 1, 1636420168165, 1636420168842, 677, 269, 408, 0, 0, 0
39, 1, 1636420168341, 1636420168967, 626, 268, 358, 0, 0, 0
40, 1, 1636420168844, 1636420169518, 674, 274, 400, 0, 0, 0
41, 1, 1636420168969, 1636420169591, 622, 269, 353, 0, 0, 0
42, 1, 1636420169520, 1636420170190, 670, 268, 402, 0, 0, 0
43, 1, 1636420169593, 1636420170214, 621, 267, 354, 0, 0, 0
45, 1, 1636420170217, 1636420170831, 614, 262, 352, 0, 0, 0
44, 1, 1636420170193, 1636420170862, 669, 271, 398, 0, 0, 0
46, 1, 1636420170833, 1636420171458, 625, 264, 361, 0, 0, 0
47, 1, 1636420170864, 1636420171534, 670, 268, 402, 0, 0, 0
48, 1, 1636420171460, 1636420172078, 618, 267, 351, 0, 0, 0
49, 1, 1636420171537, 1636420172206, 669, 267, 402, 0, 0, 0
50, 1, 1636420172081, 1636420172707, 626, 272, 354, 0, 0, 0
51, 1, 1636420172208, 1636420172882, 674, 272, 402, 0, 0, 0
52, 1, 1636420172708, 1636420173330, 622, 267, 355, 0, 0, 0
53, 1, 1636420172884, 1636420173566, 682, 276, 406, 0, 0, 0
54, 1, 1636420173333, 1636420173951, 618, 266, 352, 0, 0, 0
55, 1, 1636420173568, 1636420174194, 626, 272, 354, 0, 0, 0
56, 1, 1636420173953, 1636420174579, 626, 272, 354, 0, 0, 0
57, 1, 1636420174196, 1636420174826, 630, 271, 359, 0, 0, 0
58, 1, 1636420174581, 1636420175198, 617, 266, 351, 0, 0, 0
59, 1, 1636420174828, 1636420175454, 626, 270, 356, 0, 0, 0
60, 1, 1636420175201, 1636420175819, 618, 262, 356, 0, 0, 0
61, 1, 1636420175457, 1636420176082, 625, 270, 355, 0, 0, 0
62, 1, 1636420175820, 1636420176438, 618, 265, 353, 0, 0, 0
63, 1, 1636420176083, 1636420176706, 623, 265, 358, 0, 0, 0
64, 1, 1636420176441, 1636420177059, 618, 262, 356, 0, 0, 0
65, 1, 1636420176707, 1636420177330, 623, 267, 356, 0, 0, 0
66, 1, 1636420177061, 1636420177678, 617, 267, 350, 0, 0, 0
67, 1, 1636420177332, 1636420177954, 622, 266, 356, 0, 0, 0
68, 1, 1636420177681, 1636420178299, 618, 262, 356, 0, 0, 0
69, 1, 1636420177956, 1636420178586, 630, 270, 360, 0, 0, 0
70, 1, 1636420178301, 1636420178918, 617, 266, 351, 0, 0, 0
71, 1, 1636420178588, 1636420179214, 626, 270, 356, 0, 0, 0
72, 1, 1636420178920, 1636420179542, 622, 266, 356, 0, 0, 0
73, 1, 1636420179217, 1636420179846, 629, 271, 358, 0, 0, 0
74, 1, 1636420179545, 1636420180162, 617, 267, 350, 0, 0, 0
75, 1, 1636420179849, 1636420180478, 629, 272, 357, 0, 0, 0
76, 1, 1636420180165, 1636420180787, 622, 267, 355, 0, 0, 0
77, 1, 1636420180481, 1636420181102, 621, 269, 352, 0, 1, 1
78, 1, 1636420180789, 1636420181414, 625, 266, 359, 0, 0, 0
79, 1, 1636420180826, 1636420181602, 776, 387, 389, 0, 0, 0
80, 1, 1636420181105, 1636420181726, 621, 265, 356, 0, 0, 0
81, 1, 1636420181416, 1636420182039, 623, 267, 356, 0, 0, 0
82, 1, 1636420181666, 1636420182342, 676, 271, 405, 0, 0, 0
83, 1, 1636420181728, 1636420182354, 626, 269, 357, 0, 0, 0
84, 1, 1636420182041, 1636420182654, 613, 262, 351, 0, 1, 1
86, 1, 1636420182356, 1636420182986, 630, 273, 357, 0, 0, 0
85, 1, 1636420182344, 1636420183014, 670, 271, 399, 0, 0, 0
87, 1, 1636420182656, 1636420183274, 618, 267, 351, 0, 0, 0
88, 1, 1636420182988, 1636420183614, 626, 270, 356, 0, 1, 1
89, 1, 1636420183015, 1636420183690, 675, 269, 406, 0, 1, 1
90, 1, 1636420183277, 1636420183891, 614, 262, 352, 0, 0, 0
91, 1, 1636420183616, 1636420184242, 626, 271, 355, 0, 0, 0
92, 1, 1636420183692, 1636420184362, 670, 270, 400, 0, 0, 0
93, 1, 1636420183893, 1636420184518, 625, 270, 355, 0, 1, 1
94, 1, 1636420184244, 1636420184870, 626, 269, 357, 0, 0, 0
95, 1, 1636420184364, 1636420185030, 666, 268, 398, 0, 0, 0
96, 1, 1636420184521, 1636420185139, 618, 262, 356, 0, 0, 0
97, 1, 1636420184872, 1636420185506, 634, 270, 364, 0, 0, 0
98, 1, 1636420185031, 1636420185702, 671, 269, 402, 0, 0, 0
99, 1, 1636420185141, 1636420185759, 618, 268, 350, 0, 1, 1
100, 1, 1636420185508, 1636420186134, 626, 268, 358, 0, 0, 0
101, 1, 1636420185705, 1636420186374, 669, 269, 400, 0, 0, 0
102, 1, 1636420185760, 1636420186378, 618, 267, 351, 0, 0, 0
103, 1, 1636420186136, 1636420186762, 626, 270, 356, 0, 0, 0
105, 1, 1636420186379, 1636420186998, 619, 262, 357, 0, 0, 0
104, 1, 1636420186376, 1636420187062, 686, 275, 411, 0, 0, 0
106, 1, 1636420186765, 1636420187390, 625, 265, 360, 0, 0, 0
107, 1, 1636420187000, 1636420187619, 619, 267, 352, 0, 0, 0
108, 1, 1636420187063, 1636420187738, 675, 269, 406, 0, 0, 0
109, 1, 1636420187392, 1636420188018, 626, 270, 356, 0, 0, 0
110, 1, 1636420187621, 1636420188234, 613, 263, 350, 0, 0, 0
111, 1, 1636420187741, 1636420188406, 665, 266, 399, 0, 1, 1
112, 1, 1636420188020, 1636420188642, 622, 265, 357, 0, 0, 0
113, 1, 1636420188236, 1636420188854, 618, 263, 355, 0, 1, 1
114, 1, 1636420188409, 1636420189082, 673, 268, 405, 0, 0, 0
115, 1, 1636420188644, 1636420189266, 622, 267, 355, 0, 0, 0
116, 1, 1636420188856, 1636420189483, 627, 270, 357, 0, 0, 0
117, 1, 1636420189084, 1636420189754, 670, 270, 400, 0, 0, 0
118, 1, 1636420189269, 1636420189890, 621, 267, 354, 0, 1, 1
119, 1, 1636420189485, 1636420190102, 617, 264, 353, 0, 0, 0
120, 1, 1636420189755, 1636420190426, 671, 270, 401, 0, 0, 0
121, 1, 1636420189892, 1636420190518, 626, 269, 357, 0, 1, 1
122, 1, 1636420190105, 1636420190718, 613, 263, 350, 0, 0, 0
123, 1, 1636420190429, 1636420191106, 677, 272, 405, 0, 0, 0
124, 1, 1636420190521, 1636420191154, 633, 272, 361, 0, 0, 0
125, 1, 1636420190719, 1636420191334, 615, 262, 353, 0, 0, 0
127, 1, 1636420191156, 1636420191782, 626, 269, 357, 0, 0, 0
126, 1, 1636420191108, 1636420191782, 674, 272, 402, 0, 0, 0
128, 1, 1636420191335, 1636420191955, 620, 264, 356, 0, 0, 0
129, 1, 1636420191784, 1636420192410, 626, 266, 360, 0, 1, 1
130, 1, 1636420191785, 1636420192410, 625, 269, 356, 0, 0, 0
131, 1, 1636420191957, 1636420192582, 625, 269, 356, 0, 0, 0
132, 1, 1636420192413, 1636420193038, 625, 268, 357, 0, 0, 0
133, 1, 1636420192413, 1636420193038, 625, 269, 356, 0, 0, 0
134, 1, 1636420192584, 1636420193206, 622, 266, 356, 0, 0, 0
136, 1, 1636420193040, 1636420193670, 630, 273, 357, 0, 1, 1
135, 1, 1636420193040, 1636420193670, 630, 275, 355, 0, 0, 0
137, 1, 1636420193209, 1636420193830, 621, 270, 351, 0, 0, 0
138, 1, 1636420193673, 1636420194302, 629, 271, 358, 0, 0, 0
139, 1, 1636420193673, 1636420194302, 629, 274, 355, 0, 0, 0
140, 1, 1636420193833, 1636420194454, 621, 266, 355, 0, 0, 0
142, 1, 1636420194304, 1636420194926, 622, 264, 358, 0, 0, 0
141, 1, 1636420194304, 1636420194934, 630, 271, 359, 0, 0, 0
143, 1, 1636420194456, 1636420195074, 618, 267, 351, 0, 0, 0
145, 1, 1636420194936, 1636420195554, 618, 265, 353, 0, 0, 0
144, 1, 1636420194928, 1636420195554, 626, 270, 356, 0, 0, 0
146, 1, 1636420195076, 1636420195690, 614, 262, 352, 0, 0, 0
147, 1, 1636420195555, 1636420196178, 623, 266, 357, 0, 0, 0
148, 1, 1636420195555, 1636420196182, 627, 269, 358, 0, 0, 0
149, 1, 1636420195692, 1636420196310, 618, 265, 353, 0, 0, 0
150, 1, 1636420196179, 1636420196802, 623, 267, 356, 0, 1, 1
151, 1, 1636420196183, 1636420196806, 623, 266, 357, 0, 0, 0
152, 1, 1636420196312, 1636420196930, 618, 267, 351, 0, 0, 0
153, 1, 1636420196805, 1636420197430, 625, 270, 355, 0, 1, 1
154, 1, 1636420196808, 1636420197430, 622, 265, 357, 0, 0, 0
155, 1, 1636420196933, 1636420197547, 614, 262, 352, 0, 1, 1
157, 1, 1636420197431, 1636420198058, 627, 269, 358, 0, 1, 1
156, 1, 1636420197431, 1636420198058, 627, 269, 358, 0, 0, 0
158, 1, 1636420197549, 1636420198162, 613, 262, 351, 0, 0, 0
159, 1, 1636420198060, 1636420198686, 626, 270, 356, 0, 0, 0
160, 1, 1636420198061, 1636420198686, 625, 271, 354, 0, 1, 1
161, 1, 1636420198164, 1636420198778, 614, 260, 354, 0, 0, 0
162, 1, 1636420198688, 1636420199310, 622, 265, 357, 0, 0, 0
163, 1, 1636420198689, 1636420199310, 621, 264, 357, 0, 0, 0
164, 1, 1636420198780, 1636420199398, 618, 262, 356, 0, 0, 0
166, 1, 1636420199312, 1636420199938, 626, 270, 356, 0, 1, 1
165, 1, 1636420199312, 1636420199942, 630, 272, 358, 0, 0, 0
167, 1, 1636420199402, 1636420200018, 616, 262, 354, 0, 0, 0
168, 1, 1636420199940, 1636420200562, 622, 265, 357, 0, 0, 0
169, 1, 1636420199944, 1636420200570, 626, 269, 357, 0, 0, 0
170, 1, 1636420200019, 1636420200646, 627, 275, 352, 0, 0, 0
171, 1, 1636420200563, 1636420201190, 627, 269, 358, 0, 1, 1
172, 1, 1636420200572, 1636420201198, 626, 270, 356, 0, 0, 0
173, 1, 1636420200648, 1636420201262, 614, 262, 352, 0, 0, 0
174, 1, 1636420201192, 1636420201818, 626, 269, 357, 0, 0, 0
175, 1, 1636420201200, 1636420201826, 626, 270, 356, 0, 0, 0
176, 1, 1636420201264, 1636420201882, 618, 266, 352, 0, 0, 0
177, 1, 1636420201821, 1636420202438, 617, 266, 351, 0, 1, 1
178, 1, 1636420201829, 1636420202450, 621, 268, 353, 0, 0, 0
179, 1, 1636420201884, 1636420202502, 618, 265, 353, 0, 0, 0
180, 1, 1636420202440, 1636420203070, 630, 273, 357, 0, 0, 0
181, 1, 1636420202452, 1636420203078, 626, 270, 356, 0, 0, 0
182, 1, 1636420202505, 1636420203122, 617, 265, 352, 0, 0, 0
183, 1, 1636420203072, 1636420203698, 626, 269, 357, 0, 0, 0
184, 1, 1636420203080, 1636420203702, 622, 265, 357, 0, 0, 0
185, 1, 1636420203124, 1636420203739, 615, 261, 354, 0, 0, 0
187, 1, 1636420203704, 1636420204326, 622, 266, 356, 0, 0, 0
186, 1, 1636420203700, 1636420204326, 626, 269, 357, 0, 0, 0
188, 1, 1636420203741, 1636420204358, 617, 266, 351, 0, 1, 1
190, 1, 1636420204329, 1636420204954, 625, 269, 356, 0, 1, 1
189, 1, 1636420204328, 1636420204954, 626, 268, 358, 0, 0, 0
191, 1, 1636420204360, 1636420204978, 618, 266, 352, 0, 0, 0
193, 1, 1636420204956, 1636420205578, 622, 267, 355, 0, 1, 1
192, 1, 1636420204956, 1636420205586, 630, 271, 359, 0, 0, 0
194, 1, 1636420204981, 1636420205598, 617, 268, 349, 0, 0, 0
195, 1, 1636420205579, 1636420206202, 623, 265, 358, 0, 0, 0
196, 1, 1636420205587, 1636420206214, 627, 268, 359, 0, 0, 0
197, 1, 1636420205599, 1636420206214, 615, 261, 354, 0, 0, 0
198, 1, 1636420206204, 1636420206826, 622, 270, 352, 0, 0, 0
199, 1, 1636420206217, 1636420206834, 617, 265, 352, 0, 0, 0
200, 1, 1636420206217, 1636420206834, 617, 265, 352, 0, 0, 0
203, 1, 1636420206835, 1636420207451, 616, 263, 353, 0, 0, 0
201, 1, 1636420206827, 1636420207454, 627, 269, 358, 0, 0, 0
202, 1, 1636420206835, 1636420207470, 635, 277, 358, 0, 0, 0
204, 1, 1636420207453, 1636420208066, 613, 263, 350, 0, 0, 0
205, 1, 1636420207456, 1636420208078, 622, 266, 356, 0, 0, 0
206, 1, 1636420207472, 1636420208098, 626, 270, 356, 0, 0, 0
207, 1, 1636420208068, 1636420208686, 618, 263, 355, 0, 0, 0
208, 1, 1636420208081, 1636420208702, 621, 266, 355, 0, 0, 0
209, 1, 1636420208100, 1636420208722, 622, 267, 355, 0, 0, 0
210, 1, 1636420208688, 1636420209302, 614, 263, 351, 0, 0, 0
211, 1, 1636420208704, 1636420209326, 622, 264, 358, 0, 0, 0
212, 1, 1636420208724, 1636420209350, 626, 265, 361, 0, 1, 1
213, 1, 1636420209304, 1636420209918, 614, 262, 352, 0, 0, 0
214, 1, 1636420209329, 1636420209950, 621, 265, 356, 0, 0, 0
215, 1, 1636420209352, 1636420209978, 626, 269, 357, 0, 0, 0
216, 1, 1636420209920, 1636420210534, 614, 263, 351, 0, 0, 0
217, 1, 1636420209952, 1636420210574, 622, 266, 356, 0, 0, 0
218, 1, 1636420209981, 1636420210602, 621, 269, 352, 0, 0, 0
219, 1, 1636420210536, 1636420211150, 614, 263, 351, 0, 1, 1
220, 1, 1636420210577, 1636420211206, 629, 269, 360, 0, 1, 1
221, 1, 1636420210604, 1636420211230, 626, 269, 357, 0, 1, 1
222, 1, 1636420211152, 1636420211770, 618, 266, 352, 0, 0, 0
223, 1, 1636420211208, 1636420211834, 626, 269, 357, 0, 0, 0
224, 1, 1636420211233, 1636420211858, 625, 269, 356, 0, 0, 0
225, 1, 1636420211772, 1636420212386, 614, 262, 352, 0, 0, 0
226, 1, 1636420211837, 1636420212454, 617, 266, 351, 0, 1, 1
227, 1, 1636420211861, 1636420212486, 625, 269, 356, 0, 0, 0
228, 1, 1636420212388, 1636420213002, 614, 261, 353, 0, 0, 0
229, 1, 1636420212456, 1636420213078, 622, 265, 357, 0, 1, 1
230, 1, 1636420212488, 1636420213114, 626, 269, 357, 0, 0, 0
231, 1, 1636420213005, 1636420213622, 617, 267, 350, 0, 1, 1
232, 1, 1636420213080, 1636420213702, 622, 267, 355, 0, 1, 1
233, 1, 1636420213116, 1636420213746, 630, 273, 357, 0, 0, 0
234, 1, 1636420213624, 1636420214238, 614, 262, 352, 0, 0, 0
235, 1, 1636420213704, 1636420214326, 622, 264, 358, 0, 0, 0
236, 1, 1636420213748, 1636420214370, 622, 264, 358, 0, 0, 0
237, 1, 1636420214240, 1636420214870, 630, 277, 353, 0, 1, 1
238, 1, 1636420214342, 1636420214970, 628, 268, 360, 0, 0, 0
239, 1, 1636420214372, 1636420215006, 634, 272, 362, 0, 0, 0
240, 1, 1636420214872, 1636420215498, 626, 263, 363, 0, 0, 0
241, 1, 1636420214972, 1636420215602, 630, 274, 356, 0, 0, 0
242, 1, 1636420215008, 1636420215638, 630, 270, 360, 0, 0, 0
243, 1, 1636420215501, 1636420216114, 613, 263, 350, 0, 0, 0
244, 1, 1636420215604, 1636420216226, 622, 270, 352, 0, 1, 1
245, 1, 1636420215640, 1636420216262, 622, 266, 356, 0, 0, 0
246, 1, 1636420216117, 1636420216734, 617, 268, 349, 0, 0, 0
247, 1, 1636420216228, 1636420216854, 626, 270, 356, 0, 1, 1
248, 1, 1636420216264, 1636420216894, 630, 269, 361, 0, 0, 0
249, 1, 1636420216737, 1636420217354, 617, 267, 350, 0, 0, 0
250, 1, 1636420216857, 1636420217474, 617, 263, 354, 0, 0, 0
251, 1, 1636420216896, 1636420217522, 626, 271, 355, 0, 0, 0
252, 1, 1636420217357, 1636420217970, 613, 262, 351, 0, 0, 0
253, 1, 1636420217476, 1636420218098, 622, 266, 356, 0, 0, 0
254, 1, 1636420217525, 1636420218146, 621, 266, 355, 0, 0, 0
255, 1, 1636420217972, 1636420218586, 614, 263, 351, 0, 1, 1
256, 1, 1636420218101, 1636420218726, 625, 269, 356, 0, 0, 0
257, 1, 1636420218149, 1636420218771, 622, 265, 357, 0, 0, 0
258, 1, 1636420218588, 1636420219202, 614, 263, 351, 0, 1, 1
259, 1, 1636420218729, 1636420219358, 629, 273, 356, 0, 0, 0
260, 1, 1636420218773, 1636420219394, 621, 266, 355, 0, 1, 1
261, 1, 1636420219206, 1636420219822, 616, 263, 353, 0, 0, 0
262, 1, 1636420219360, 1636420219978, 618, 262, 356, 0, 0, 0
263, 1, 1636420219396, 1636420220018, 622, 266, 356, 0, 0, 0
264, 1, 1636420219824, 1636420220442, 618, 263, 355, 0, 0, 0
265, 1, 1636420219980, 1636420220602, 622, 265, 357, 0, 0, 0
266, 1, 1636420220020, 1636420220642, 622, 265, 357, 0, 0, 0
267, 1, 1636420220445, 1636420221058, 613, 262, 351, 0, 0, 0
268, 1, 1636420220604, 1636420221230, 626, 269, 357, 0, 0, 0
269, 1, 1636420220644, 1636420221262, 618, 263, 355, 0, 0, 0
270, 1, 1636420221060, 1636420221686, 626, 262, 364, 0, 1, 1
271, 1, 1636420221231, 1636420221858, 627, 269, 358, 0, 0, 0
272, 1, 1636420221263, 1636420221890, 627, 269, 358, 0, 0, 0
273, 1, 1636420221689, 1636420222302, 613, 262, 351, 0, 1, 1
274, 1, 1636420221860, 1636420222486, 626, 269, 357, 0, 1, 1
275, 1, 1636420221892, 1636420222518, 626, 273, 353, 0, 0, 0
276, 1, 1636420222304, 1636420222918, 614, 262, 352, 0, 0, 0
277, 1, 1636420222488, 1636420223110, 622, 265, 357, 0, 1, 1
278, 1, 1636420222520, 1636420223142, 622, 263, 359, 0, 1, 1
279, 1, 1636420222920, 1636420223534, 614, 263, 351, 0, 0, 0
280, 1, 1636420223112, 1636420223738, 626, 269, 357, 0, 1, 1
281, 1, 1636420223144, 1636420223766, 622, 268, 354, 0, 0, 0
282, 1, 1636420223536, 1636420224150, 614, 262, 352, 0, 0, 0
283, 1, 1636420223741, 1636420224362, 621, 264, 357, 0, 0, 0
284, 1, 1636420223768, 1636420224390, 622, 266, 356, 0, 0, 0
285, 1, 1636420224153, 1636420224774, 621, 267, 354, 0, 0, 0
286, 1, 1636420224365, 1636420224986, 621, 266, 355, 0, 0, 0
287, 1, 1636420224392, 1636420225014, 622, 268, 354, 0, 0, 0
288, 1, 1636420224776, 1636420225390, 614, 263, 351, 0, 1, 1
289, 1, 1636420224988, 1636420225610, 622, 265, 357, 0, 1, 1
290, 1, 1636420225016, 1636420225638, 622, 267, 355, 0, 0, 0
291, 1, 1636420225392, 1636420226014, 622, 267, 355, 0, 0, 0
292, 1, 1636420225611, 1636420226234, 623, 267, 356, 0, 0, 0
293, 1, 1636420225640, 1636420226270, 630, 270, 360, 0, 0, 0
294, 1, 1636420226016, 1636420226634, 618, 263, 355, 0, 0, 0
295, 1, 1636420226236, 1636420226862, 626, 269, 357, 0, 0, 0
296, 1, 1636420226272, 1636420226894, 622, 265, 357, 0, 0, 0
297, 1, 1636420226636, 1636420227250, 614, 263, 351, 0, 0, 0
298, 1, 1636420226864, 1636420227486, 622, 267, 355, 0, 0, 0
299, 1, 1636420226896, 1636420227522, 626, 269, 357, 0, 0, 0
300, 1, 1636420227252, 1636420227866, 614, 263, 351, 0, 0, 0
301, 1, 1636420227488, 1636420228114, 626, 269, 357, 0, 0, 0
302, 1, 1636420227524, 1636420228154, 630, 272, 358, 0, 0, 0
303, 1, 1636420227868, 1636420228490, 622, 270, 352, 0, 0, 0
304, 1, 1636420228116, 1636420228738, 622, 269, 353, 0, 0, 0
305, 1, 1636420228156, 1636420228774, 618, 266, 352, 0, 0, 0
306, 1, 1636420228492, 1636420229110, 618, 267, 351, 0, 0, 0
307, 1, 1636420228740, 1636420229362, 622, 266, 356, 0, 0, 0
308, 1, 1636420228776, 1636420229402, 626, 271, 355, 0, 1, 1
309, 1, 1636420229112, 1636420229730, 618, 263, 355, 0, 0, 0
310, 1, 1636420229364, 1636420229990, 626, 269, 357, 0, 0, 0
311, 1, 1636420229404, 1636420230026, 622, 266, 356, 0, 0, 0
312, 1, 1636420229732, 1636420230354, 622, 267, 355, 0, 1, 1
313, 1, 1636420229992, 1636420230614, 622, 265, 357, 0, 0, 0
314, 1, 1636420230028, 1636420230650, 622, 266, 356, 0, 0, 0
315, 1, 1636420230356, 1636420230974, 618, 267, 351, 0, 0, 0
316, 1, 1636420230616, 1636420231238, 622, 269, 353, 0, 0, 0
317, 1, 1636420230652, 1636420231278, 626, 267, 359, 0, 1, 1
318, 1, 1636420230976, 1636420231590, 614, 263, 351, 0, 1, 1
319, 1, 1636420231240, 1636420231866, 626, 265, 361, 0, 0, 0
320, 1, 1636420231280, 1636420231902, 622, 267, 355, 0, 1, 1
321, 1, 1636420231592, 1636420232206, 614, 263, 351, 0, 0, 0
322, 1, 1636420231868, 1636420232490, 622, 265, 357, 0, 0, 0
323, 1, 1636420231904, 1636420232526, 622, 266, 356, 0, 0, 0
324, 1, 1636420232208, 1636420232822, 614, 263, 351, 0, 0, 0
325, 1, 1636420232492, 1636420233110, 618, 266, 352, 0, 0, 0
326, 1, 1636420232528, 1636420233154, 626, 269, 357, 0, 0, 0
327, 1, 1636420232824, 1636420233442, 618, 263, 355, 0, 0, 0
328, 1, 1636420233112, 1636420233734, 622, 266, 356, 0, 0, 0
329, 1, 1636420233156, 1636420233786, 630, 275, 355, 0, 0, 0
330, 1, 1636420233444, 1636420234058, 614, 262, 352, 0, 1, 1
331, 1, 1636420233736, 1636420234362, 626, 268, 358, 0, 0, 0
332, 1, 1636420233788, 1636420234410, 622, 266, 356, 0, 0, 0
333, 1, 1636420234060, 1636420234674, 614, 263, 351, 0, 1, 1
334, 1, 1636420234364, 1636420234990, 626, 270, 356, 0, 1, 1
335, 1, 1636420234412, 1636420235026, 614, 263, 351, 0, 1, 1
336, 1, 1636420234676, 1636420235290, 614, 263, 351, 0, 1, 1
337, 1, 1636420234992, 1636420235618, 626, 270, 356, 0, 0, 0
338, 1, 1636420235028, 1636420235650, 622, 266, 356, 0, 1, 1
339, 1, 1636420235292, 1636420235906, 614, 263, 351, 0, 0, 0
340, 1, 1636420235620, 1636420236242, 622, 268, 354, 0, 0, 0
341, 1, 1636420235652, 1636420236278, 626, 271, 355, 0, 1, 1
342, 1, 1636420235908, 1636420236526, 618, 266, 352, 0, 0, 0
343, 1, 1636420236244, 1636420236862, 618, 264, 354, 0, 0, 0
344, 1, 1636420236280, 1636420236898, 618, 266, 352, 0, 0, 0
345, 1, 1636420236528, 1636420237142, 614, 262, 352, 0, 0, 0
346, 1, 1636420236864, 1636420237482, 618, 266, 352, 0, 1, 1
347, 1, 1636420236900, 1636420237526, 626, 270, 356, 0, 0, 0
348, 1, 1636420237144, 1636420237758, 614, 263, 351, 0, 1, 1
349, 1, 1636420237484, 1636420238106, 622, 262, 360, 0, 0, 0
350, 1, 1636420237527, 1636420238154, 627, 269, 358, 0, 0, 0
351, 1, 1636420237760, 1636420238378, 618, 263, 355, 0, 1, 1
352, 1, 1636420238108, 1636420238734, 626, 270, 356, 0, 0, 0
353, 1, 1636420238156, 1636420238778, 622, 267, 355, 0, 0, 0
354, 1, 1636420238380, 1636420238994, 614, 263, 351, 0, 1, 1
355, 1, 1636420238736, 1636420239358, 622, 268, 354, 0, 0, 0
356, 1, 1636420238780, 1636420239402, 622, 269, 353, 0, 0, 0
357, 1, 1636420238996, 1636420239610, 614, 262, 352, 0, 1, 1
358, 1, 1636420239360, 1636420239986, 626, 268, 358, 0, 0, 0
359, 1, 1636420239404, 1636420240030, 626, 268, 358, 0, 1, 1
360, 1, 1636420239612, 1636420240230, 618, 262, 356, 0, 0, 0
361, 1, 1636420239988, 1636420240614, 626, 269, 357, 0, 1, 1
362, 1, 1636420240032, 1636420240658, 626, 269, 357, 0, 1, 1
363, 1, 1636420240232, 1636420240846, 614, 264, 350, 0, 0, 0
364, 1, 1636420240616, 1636420241238, 622, 265, 357, 0, 1, 1
365, 1, 1636420240661, 1636420241282, 621, 266, 355, 0, 0, 0
366, 1, 1636420240848, 1636420241466, 618, 263, 355, 0, 0, 0
367, 1, 1636420241240, 1636420241858, 618, 265, 353, 0, 0, 0
368, 1, 1636420241285, 1636420241910, 625, 270, 355, 0, 0, 0
369, 1, 1636420241468, 1636420242082, 614, 263, 351, 0, 0, 0
370, 1, 1636420241860, 1636420242486, 626, 266, 360, 0, 0, 0
371, 1, 1636420241912, 1636420242534, 622, 265, 357, 0, 1, 1
372, 1, 1636420242083, 1636420242698, 615, 262, 353, 0, 0, 0
373, 1, 1636420242488, 1636420243114, 626, 269, 357, 0, 0, 0
374, 1, 1636420242535, 1636420243162, 627, 265, 362, 0, 0, 0
375, 1, 1636420242700, 1636420243314, 614, 262, 352, 0, 0, 0
376, 1, 1636420243116, 1636420243742, 626, 268, 358, 0, 0, 0
377, 1, 1636420243164, 1636420243786, 622, 266, 356, 0, 1, 1
378, 1, 1636420243316, 1636420243930, 614, 263, 351, 0, 0, 0
379, 1, 1636420243744, 1636420244366, 622, 266, 356, 0, 1, 1
380, 1, 1636420243788, 1636420244410, 622, 266, 356, 0, 0, 0
381, 1, 1636420243932, 1636420244546, 614, 263, 351, 0, 1, 1
382, 1, 1636420244368, 1636420244994, 626, 268, 358, 0, 0, 0
383, 1, 1636420244412, 1636420245034, 622, 266, 356, 0, 1, 1
384, 1, 1636420244548, 1636420245162, 614, 263, 351, 0, 0, 0
385, 1, 1636420244996, 1636420245618, 622, 266, 356, 0, 1, 1
386, 1, 1636420245036, 1636420245658, 622, 266, 356, 0, 0, 0
387, 1, 1636420245164, 1636420245782, 618, 267, 351, 0, 1, 1
388, 1, 1636420245620, 1636420246246, 626, 266, 360, 0, 0, 0
389, 1, 1636420245660, 1636420246278, 618, 265, 353, 0, 0, 0
390, 1, 1636420245784, 1636420246402, 618, 267, 351, 0, 0, 0
391, 1, 1636420246248, 1636420246878, 630, 269, 361, 0, 0, 0
392, 1, 1636420246280, 1636420246902, 622, 266, 356, 0, 0, 0
393, 1, 1636420246404, 1636420247026, 622, 271, 351, 0, 1, 1
394, 1, 1636420246880, 1636420247494, 614, 263, 351, 0, 0, 0
395, 1, 1636420246904, 1636420247526, 622, 266, 356, 0, 0, 0
396, 1, 1636420247028, 1636420247642, 614, 264, 350, 0, 1, 1
397, 1, 1636420247496, 1636420248122, 626, 270, 356, 0, 0, 0
398, 1, 1636420247528, 1636420248154, 626, 269, 357, 0, 1, 1
399, 1, 1636420247644, 1636420248262, 618, 263, 355, 0, 0, 0
400, 1, 1636420248125, 1636420248746, 621, 269, 352, 0, 0, 0
401, 1, 1636420248156, 1636420248774, 618, 266, 352, 0, 0, 0
402, 1, 1636420248264, 1636420248878, 614, 263, 351, 0, 0, 0
403, 1, 1636420248748, 1636420249370, 622, 266, 356, 0, 0, 0
404, 1, 1636420248777, 1636420249402, 625, 269, 356, 0, 0, 0
405, 1, 1636420248879, 1636420249494, 615, 263, 352, 0, 1, 1
406, 1, 1636420249372, 1636420249994, 622, 265, 357, 0, 0, 0
407, 1, 1636420249405, 1636420250038, 633, 268, 365, 0, 0, 0
408, 1, 1636420249495, 1636420250111, 616, 263, 353, 0, 0, 0
409, 1, 1636420249996, 1636420250618, 622, 264, 358, 0, 0, 0
410, 1, 1636420250040, 1636420250658, 618, 266, 352, 0, 0, 0
411, 1, 1636420250113, 1636420250726, 613, 262, 351, 0, 1, 1
412, 1, 1636420250620, 1636420251242, 622, 266, 356, 0, 0, 0
413, 1, 1636420250660, 1636420251286, 626, 269, 357, 0, 0, 0
414, 1, 1636420250728, 1636420251342, 614, 263, 351, 0, 1, 1
415, 1, 1636420251244, 1636420251862, 618, 263, 355, 0, 0, 0
416, 1, 1636420251288, 1636420251910, 622, 265, 357, 0, 0, 0
417, 1, 1636420251344, 1636420251958, 614, 263, 351, 0, 1, 1
418, 1, 1636420251865, 1636420252486, 621, 266, 355, 0, 0, 0
419, 1, 1636420251913, 1636420252530, 617, 266, 351, 0, 0, 0
420, 1, 1636420251960, 1636420252574, 614, 263, 351, 0, 1, 1
421, 1, 1636420252489, 1636420253110, 621, 265, 356, 0, 1, 1
422, 1, 1636420252532, 1636420253154, 622, 266, 356, 0, 1, 1
423, 1, 1636420252576, 1636420253190, 614, 263, 351, 0, 0, 0
424, 1, 1636420253112, 1636420253738, 626, 269, 357, 0, 0, 0
425, 1, 1636420253156, 1636420253778, 622, 267, 355, 0, 0, 0
426, 1, 1636420253192, 1636420253806, 614, 263, 351, 0, 0, 0
427, 1, 1636420253740, 1636420254366, 626, 266, 360, 0, 0, 0
428, 1, 1636420253780, 1636420254402, 622, 266, 356, 0, 1, 1
429, 1, 1636420253808, 1636420254422, 614, 262, 352, 0, 0, 0
430, 1, 1636420254368, 1636420254990, 622, 266, 356, 0, 1, 1
431, 1, 1636420254404, 1636420255026, 622, 267, 355, 0, 1, 1
432, 1, 1636420254425, 1636420255038, 613, 261, 352, 0, 0, 0
433, 1, 1636420254992, 1636420255618, 626, 269, 357, 0, 0, 0
434, 1, 1636420255028, 1636420255650, 622, 266, 356, 0, 1, 1
435, 1, 1636420255040, 1636420255662, 622, 267, 355, 0, 1, 1
436, 1, 1636420255619, 1636420256242, 623, 266, 357, 0, 1, 1
437, 1, 1636420255652, 1636420256274, 622, 268, 354, 0, 1, 1
438, 1, 1636420255664, 1636420256278, 614, 263, 351, 0, 0, 0
439, 1, 1636420256244, 1636420256870, 626, 265, 361, 0, 0, 0
440, 1, 1636420256276, 1636420256894, 618, 266, 352, 0, 0, 0
441, 1, 1636420256279, 1636420256898, 619, 263, 356, 0, 1, 1
442, 1, 1636420256872, 1636420257490, 618, 263, 355, 0, 0, 0
444, 1, 1636420256899, 1636420257514, 615, 263, 352, 0, 1, 1
443, 1, 1636420256896, 1636420257518, 622, 263, 359, 0, 1, 1
445, 1, 1636420257492, 1636420258114, 622, 265, 357, 0, 0, 0
447, 1, 1636420257520, 1636420258142, 622, 266, 356, 0, 0, 0
446, 1, 1636420257516, 1636420258142, 626, 266, 360, 0, 0, 0
448, 1, 1636420258115, 1636420258742, 627, 269, 358, 0, 0, 0
450, 1, 1636420258144, 1636420258762, 618, 266, 352, 0, 0, 0
449, 1, 1636420258143, 1636420258762, 619, 264, 355, 0, 1, 1
451, 1, 1636420258744, 1636420259366, 622, 265, 357, 0, 1, 1
452, 1, 1636420258763, 1636420259378, 615, 263, 352, 0, 1, 1
453, 1, 1636420258764, 1636420259382, 618, 267, 351, 0, 0, 0
454, 1, 1636420259368, 1636420259990, 622, 265, 357, 0, 0, 0
455, 1, 1636420259380, 1636420259994, 614, 262, 352, 0, 0, 0
456, 1, 1636420259384, 1636420260002, 618, 262, 356, 0, 0, 0
458, 1, 1636420259996, 1636420260610, 614, 262, 352, 0, 0, 0
457, 1, 1636420259992, 1636420260614, 622, 265, 357, 0, 0, 0
459, 1, 1636420260004, 1636420260630, 626, 265, 361, 0, 0, 0
460, 1, 1636420260611, 1636420261230, 619, 262, 357, 0, 0, 0
461, 1, 1636420260615, 1636420261242, 627, 270, 357, 0, 0, 0
462, 1, 1636420260632, 1636420261266, 634, 273, 361, 0, 0, 0
463, 1, 1636420261232, 1636420261850, 618, 263, 355, 0, 0, 0
464, 1, 1636420261244, 1636420261874, 630, 269, 361, 0, 0, 0
465, 1, 1636420261269, 1636420261894, 625, 270, 355, 0, 0, 0
466, 1, 1636420261852, 1636420262466, 614, 263, 351, 0, 0, 0
467, 1, 1636420261876, 1636420262498, 622, 266, 356, 0, 0, 0
468, 1, 1636420261896, 1636420262522, 626, 265, 361, 0, 0, 0
469, 1, 1636420262468, 1636420263082, 614, 262, 352, 0, 0, 0
470, 1, 1636420262500, 1636420263126, 626, 268, 358, 0, 0, 0
471, 1, 1636420262524, 1636420263146, 622, 266, 356, 0, 0, 0
472, 1, 1636420263084, 1636420263698, 614, 261, 353, 0, 0, 0
473, 1, 1636420263128, 1636420263750, 622, 265, 357, 0, 0, 0
474, 1, 1636420263148, 1636420263774, 626, 269, 357, 0, 0, 0
475, 1, 1636420263700, 1636420264314, 614, 263, 351, 0, 0, 0
476, 1, 1636420263752, 1636420264374, 622, 264, 358, 0, 0, 0
477, 1, 1636420263776, 1636420264402, 626, 270, 356, 0, 0, 0
478, 1, 1636420264316, 1636420264930, 614, 262, 352, 0, 1, 1
479, 1, 1636420264376, 1636420264998, 622, 266, 356, 0, 0, 0
480, 1, 1636420264405, 1636420265026, 621, 265, 356, 0, 0, 0
481, 1, 1636420264932, 1636420265546, 614, 263, 351, 0, 0, 0
482, 1, 1636420265000, 1636420265626, 626, 269, 357, 0, 0, 0
483, 1, 1636420265028, 1636420265650, 622, 266, 356, 0, 0, 0
484, 1, 1636420265548, 1636420266162, 614, 263, 351, 0, 1, 1
485, 1, 1636420265627, 1636420266254, 627, 268, 359, 0, 0, 0
486, 1, 1636420265652, 1636420266278, 626, 266, 360, 0, 1, 1
487, 1, 1636420266164, 1636420266778, 614, 263, 351, 0, 1, 1
488, 1, 1636420266256, 1636420266874, 618, 262, 356, 0, 0, 0
489, 1, 1636420266280, 1636420266898, 618, 266, 352, 0, 0, 0
490, 1, 1636420266780, 1636420267394, 614, 263, 351, 0, 0, 0
491, 1, 1636420266876, 1636420267502, 626, 268, 358, 0, 0, 0
492, 1, 1636420266900, 1636420267526, 626, 266, 360, 0, 1, 1
493, 1, 1636420267396, 1636420268014, 618, 262, 356, 0, 0, 0
494, 1, 1636420267504, 1636420268130, 626, 265, 361, 0, 0, 0
495, 1, 1636420267528, 1636420268142, 614, 263, 351, 0, 1, 1
496, 1, 1636420268016, 1636420268630, 614, 262, 352, 0, 0, 0
497, 1, 1636420268132, 1636420268754, 622, 266, 356, 0, 0, 0
498, 1, 1636420268144, 1636420268758, 614, 263, 351, 0, 0, 0
499, 1, 1636420268632, 1636420269246, 614, 263, 351, 0, 1, 1
500, 1, 1636420268756, 1636420269374, 618, 265, 353, 0, 0, 0
501, 1, 1636420268760, 1636420269374, 614, 267, 347, 0, 1, 1
502, 1, 1636420269248, 1636420269862, 614, 261, 353, 0, 0, 0
504, 1, 1636420269376, 1636420269994, 618, 262, 356, 0, 0, 0
503, 1, 1636420269376, 1636420269994, 618, 260, 358, 0, 1, 1
505, 1, 1636420269864, 1636420270479, 615, 263, 352, 0, 0, 0
506, 1, 1636420269996, 1636420270622, 626, 272, 354, 0, 0, 0
507, 1, 1636420269997, 1636420270626, 629, 269, 360, 0, 1, 1
508, 1, 1636420270480, 1636420271098, 618, 263, 355, 0, 1, 1
509, 1, 1636420270624, 1636420271246, 622, 266, 356, 0, 0, 0
510, 1, 1636420270627, 1636420271250, 623, 269, 354, 0, 0, 0
511, 1, 1636420271100, 1636420271714, 614, 263, 351, 0, 0, 0
512, 1, 1636420271247, 1636420271870, 623, 266, 357, 0, 1, 1
513, 1, 1636420271252, 1636420271870, 618, 266, 352, 0, 0, 0
514, 1, 1636420271716, 1636420272334, 618, 263, 355, 0, 1, 1
516, 1, 1636420271872, 1636420272494, 622, 265, 357, 0, 0, 0
515, 1, 1636420271872, 1636420272494, 622, 265, 357, 0, 1, 1
517, 1, 1636420272336, 1636420272950, 614, 263, 351, 0, 1, 1
519, 1, 1636420272497, 1636420273118, 621, 264, 357, 0, 0, 0
518, 1, 1636420272496, 1636420273122, 626, 269, 357, 0, 1, 1
520, 1, 1636420272953, 1636420273566, 613, 262, 351, 0, 0, 0
521, 1, 1636420273120, 1636420273746, 626, 269, 357, 0, 0, 0
522, 1, 1636420273124, 1636420273746, 622, 265, 357, 0, 0, 0
523, 1, 1636420273569, 1636420274182, 613, 262, 351, 0, 0, 0
525, 1, 1636420273748, 1636420274370, 622, 265, 357, 0, 1, 1
524, 1, 1636420273748, 1636420274374, 626, 268, 358, 0, 0, 0
526, 1, 1636420274372, 1636420274978, 606, 261, 345, 0, 0, 0
527, 1, 1636420274376, 1636420274982, 606, 260, 346, 0, 0, 0
528, 1, 1636420274980, 1636420275602, 622, 265, 357, 0, 0, 0
529, 1, 1636420274984, 1636420275602, 618, 266, 352, 0, 0, 0
530, 1, 1636420275604, 1636420276226, 622, 264, 358, 0, 0, 0
531, 1, 1636420275604, 1636420276226, 622, 264, 358, 0, 0, 0
533, 1, 1636420276228, 1636420276854, 626, 269, 357, 0, 1, 1
532, 1, 1636420276228, 1636420276854, 626, 267, 359, 0, 0, 0
534, 1, 1636420276856, 1636420277478, 622, 265, 357, 0, 0, 0
535, 1, 1636420276857, 1636420277478, 621, 264, 357, 0, 1, 1
537, 1, 1636420277481, 1636420278102, 621, 266, 355, 0, 0, 0
536, 1, 1636420277480, 1636420278102, 622, 264, 358, 0, 0, 0
538, 1, 1636420278104, 1636420278726, 622, 268, 354, 0, 0, 0
539, 1, 1636420278104, 1636420278730, 626, 266, 360, 0, 1, 1
541, 1, 1636420278732, 1636420279354, 622, 266, 356, 0, 0, 0
540, 1, 1636420278728, 1636420279358, 630, 273, 357, 0, 0, 0
542, 1, 1636420279356, 1636420279974, 618, 265, 353, 0, 0, 0
543, 1, 1636420279360, 1636420279978, 618, 265, 353, 0, 0, 0
544, 1, 1636420279976, 1636420280602, 626, 268, 358, 0, 0, 0
545, 1, 1636420279980, 1636420280602, 622, 266, 356, 0, 0, 0
547, 1, 1636420280605, 1636420281230, 625, 266, 359, 0, 0, 0
546, 1, 1636420280604, 1636420281230, 626, 268, 358, 0, 0, 0
549, 1, 1636420281232, 1636420281854, 622, 264, 358, 0, 1, 1
548, 1, 1636420281232, 1636420281858, 626, 269, 357, 0, 0, 0
550, 1, 1636420281856, 1636420282478, 622, 266, 356, 0, 0, 0
551, 1, 1636420281860, 1636420282486, 626, 265, 361, 0, 0, 0
552, 1, 1636420282480, 1636420283102, 622, 266, 356, 0, 1, 1
553, 1, 1636420282488, 1636420283110, 622, 265, 357, 0, 0, 0
554, 1, 1636420283104, 1636420283726, 622, 265, 357, 0, 0, 0
555, 1, 1636420283112, 1636420283734, 622, 266, 356, 0, 0, 0
556, 1, 1636420283728, 1636420284354, 626, 268, 358, 0, 0, 0
557, 1, 1636420283736, 1636420284358, 622, 267, 355, 0, 0, 0
558, 1, 1636420284357, 1636420284978, 621, 266, 355, 0, 0, 0
559, 1, 1636420284360, 1636420284982, 622, 263, 359, 0, 1, 1
560, 1, 1636420284980, 1636420285602, 622, 266, 356, 0, 0, 0
561, 1, 1636420284984, 1636420285606, 622, 266, 356, 0, 1, 1
563, 1, 1636420285608, 1636420286226, 618, 262, 356, 0, 0, 0
562, 1, 1636420285604, 1636420286226, 622, 266, 356, 0, 0, 0
564, 1, 1636420286228, 1636420286846, 618, 263, 355, 0, 0, 0
565, 1, 1636420286229, 1636420286850, 621, 270, 351, 0, 0, 0
566, 1, 1636420286849, 1636420287470, 621, 265, 356, 0, 0, 0
567, 1, 1636420286852, 1636420287474, 622, 266, 356, 0, 1, 1
569, 1, 1636420287476, 1636420288098, 622, 266, 356, 0, 1, 1
568, 1, 1636420287472, 1636420288098, 626, 267, 359, 0, 0, 0
570, 1, 1636420288100, 1636420288726, 626, 269, 357, 0, 1, 1
571, 1, 1636420288100, 1636420288726, 626, 269, 357, 0, 1, 1
572, 1, 1636420288729, 1636420289354, 625, 269, 356, 0, 0, 0
573, 1, 1636420289356, 1636420289978, 622, 267, 355, 0, 1, 1
574, 1, 1636420289980, 1636420290602, 622, 266, 356, 0, 0, 0
575, 1, 1636420290604, 1636420291226, 622, 265, 357, 0, 0, 0
576, 1, 1636420291228, 1636420291850, 622, 264, 358, 0, 0, 0
577, 1, 1636420291853, 1636420292478, 625, 268, 357, 0, 0, 0
578, 1, 1636420292481, 1636420293102, 621, 265, 356, 0, 0, 0
579, 1, 1636420293105, 1636420293726, 621, 266, 355, 0, 1, 1
580, 1, 1636420293728, 1636420294346, 618, 265, 353, 0, 0, 0
581, 1, 1636420294348, 1636420294970, 622, 266, 356, 0, 0, 0
582, 1, 1636420294972, 1636420295598, 626, 269, 357, 0, 0, 0
583, 1, 1636420295599, 1636420296226, 627, 269, 358, 0, 0, 0
584, 1, 1636420296228, 1636420296854, 626, 268, 358, 0, 0, 0
585, 1, 1636420296856, 1636420297478, 622, 265, 357, 0, 0, 0
586, 1, 1636420297481, 1636420298098, 617, 266, 351, 0, 1, 1
587, 1, 1636420298100, 1636420298722, 622, 266, 356, 0, 1, 1
588, 1, 1636420298724, 1636420299342, 618, 263, 355, 0, 0, 0
589, 1, 1636420299344, 1636420299966, 622, 265, 357, 0, 0, 0
590, 1, 1636420299968, 1636420300590, 622, 266, 356, 0, 0, 0
591, 1, 1636420300592, 1636420301210, 618, 264, 354, 0, 0, 0
592, 1, 1636420301213, 1636420301830, 617, 263, 354, 0, 0, 0
593, 1, 1636420301832, 1636420302454, 622, 266, 356, 0, 1, 1
594, 1, 1636420302456, 1636420303078, 622, 263, 359, 0, 0, 0
595, 1, 1636420303081, 1636420303702, 621, 266, 355, 0, 0, 0
596, 1, 1636420303704, 1636420304326, 622, 265, 357, 0, 1, 1
597, 1, 1636420304329, 1636420304954, 625, 268, 357, 0, 0, 0
598, 1, 1636420304956, 1636420305578, 622, 266, 356, 0, 1, 1
599, 1, 1636420305580, 1636420306202, 622, 264, 358, 0, 0, 0
600, 1, 1636420306204, 1636420306822, 618, 262, 356, 0, 1, 1
601, 1, 1636420525476, 1636420526342, 866, 345, 521, 6, 0, 6
602, 1, 1636420526049, 1636420526846, 797, 271, 526, 0, 2, 2
603, 1, 1636420526471, 1636420527266, 795, 268, 527, 1, 1, 2
604, 1, 1636420526547, 1636420527342, 795, 270, 525, 0, 1, 1
605, 1, 1636420527046, 1636420527842, 796, 270, 526, 2, 0, 2
606, 1, 1636420527326, 1636420528134, 808, 266, 542, 1, 0, 1
607, 1, 1636420527465, 1636420528258, 793, 264, 529, 1, 0, 1
608, 1, 1636420527544, 1636420528350, 806, 272, 534, 3, 1, 4
609, 1, 1636420528041, 1636420528842, 801, 271, 530, 2, 1, 3
610, 1, 1636420528246, 1636420529046, 800, 269, 531, 0, 1, 1
611, 1, 1636420528277, 1636420529078, 801, 267, 534, 2, 0, 2
612, 1, 1636420528468, 1636420529270, 802, 273, 529, 1, 1, 2
613, 1, 1636420528544, 1636420529346, 802, 270, 532, 1, 0, 1
614, 1, 1636420528842, 1636420529642, 800, 269, 531, 0, 1, 1
615, 1, 1636420529056, 1636420529862, 806, 273, 533, 1, 0, 1
616, 1, 1636420529191, 1636420529942, 751, 269, 482, 1, 0, 1
617, 1, 1636420529277, 1636420529950, 673, 270, 403, 2, 0, 2
618, 1, 1636420529478, 1636420530098, 620, 268, 352, 2, 0, 2
619, 1, 1636420529559, 1636420530182, 623, 265, 358, 0, 1, 1
621, 1, 1636420529788, 1636420530410, 622, 261, 361, 1, 0, 1
620, 1, 1636420529726, 1636420530410, 684, 270, 414, 2, 0, 2
622, 1, 1636420530066, 1636420530686, 620, 261, 359, 0, 0, 0
623, 1, 1636420530182, 1636420530806, 624, 271, 353, 0, 3, 3
624, 1, 1636420530279, 1636420530902, 623, 271, 352, 1, 1, 2
626, 1, 1636420530456, 1636420531074, 618, 263, 355, 1, 0, 1
625, 1, 1636420530426, 1636420531102, 676, 270, 406, 1, 1, 2
628, 1, 1636420530664, 1636420531286, 622, 270, 352, 0, 1, 1
629, 1, 1636420530774, 1636420531398, 624, 267, 357, 0, 1, 1
632, 1, 1636420531186, 1636420531810, 624, 269, 355, 0, 1, 1
631, 1, 1636420531162, 1636420531838, 676, 272, 404, 0, 0, 0
634, 1, 1636420531366, 1636420531990, 624, 270, 354, 1, 0, 1
635, 1, 1636420531470, 1636420532110, 640, 286, 354, 1, 1, 2
636, 1, 1636420531650, 1636420532270, 620, 266, 354, 1, 0, 1
637, 1, 1636420531779, 1636420532402, 623, 267, 356, 1, 0, 1
638, 1, 1636420531850, 1636420532522, 672, 266, 406, 0, 1, 1
639, 1, 1636420532103, 1636420532730, 627, 269, 358, 0, 1, 1
641, 1, 1636420532353, 1636420532982, 629, 271, 358, 0, 2, 2
642, 1, 1636420532475, 1636420533106, 631, 269, 362, 1, 0, 1
643, 1, 1636420532654, 1636420533274, 620, 267, 353, 0, 1, 1
644, 1, 1636420532790, 1636420533418, 628, 270, 358, 2, 1, 3
646, 1, 1636420533090, 1636420533710, 620, 267, 353, 0, 1, 1
647, 1, 1636420533383, 1636420534018, 635, 275, 360, 0, 2, 2
648, 1, 1636420533494, 1636420534118, 624, 269, 355, 2, 0, 2
649, 1, 1636420533498, 1636420534174, 676, 271, 405, 1, 2, 3
651, 1, 1636420533776, 1636420534402, 626, 273, 353, 2, 0, 2
653, 1, 1636420534094, 1636420534718, 624, 269, 355, 0, 2, 2
652, 1, 1636420534050, 1636420534726, 676, 269, 407, 0, 1, 1
655, 1, 1636420534437, 1636420535070, 633, 270, 363, 1, 1, 2
656, 1, 1636420534494, 1636420535118, 624, 267, 357, 1, 1, 2
658, 1, 1636420534780, 1636420535406, 626, 269, 357, 1, 0, 1
657, 1, 1636420534738, 1636420535418, 680, 274, 406, 0, 1, 1
659, 1, 1636420534988, 1636420535614, 626, 270, 356, 0, 0, 0
661, 1, 1636420535362, 1636420536038, 676, 265, 411, 1, 0, 1
662, 1, 1636420535416, 1636420536038, 622, 269, 353, 2, 0, 2
663, 1, 1636420535464, 1636420536086, 622, 265, 357, 1, 0, 1
664, 1, 1636420535674, 1636420536298, 624, 271, 353, 0, 0, 0
666, 1, 1636420535974, 1636420536606, 632, 268, 364, 2, 1, 3
667, 1, 1636420536014, 1636420536702, 688, 274, 414, 0, 0, 0
668, 1, 1636420536302, 1636420536930, 628, 274, 354, 0, 0, 0
669, 1, 1636420536419, 1636420537038, 619, 268, 351, 0, 0, 0
670, 1, 1636420536455, 1636420537074, 619, 266, 353, 0, 0, 0
672, 1, 1636420536659, 1636420537290, 631, 270, 361, 0, 0, 0
671, 1, 1636420536622, 1636420537298, 676, 265, 411, 0, 0, 0
673, 1, 1636420536951, 1636420537570, 619, 266, 353, 1, 0, 1
674, 1, 1636420537004, 1636420537626, 622, 266, 356, 1, 0, 1
675, 1, 1636420537288, 1636420537910, 622, 271, 351, 2, 1, 3
676, 1, 1636420537302, 1636420537974, 672, 271, 401, 0, 1, 1
677, 1, 1636420537419, 1636420538042, 623, 272, 351, 1, 1, 2
679, 1, 1636420537555, 1636420538178, 623, 266, 357, 0, 0, 0
680, 1, 1636420537690, 1636420538306, 616, 261, 355, 1, 0, 1
681, 1, 1636420537936, 1636420538554, 618, 267, 351, 0, 1, 1
682, 1, 1636420537998, 1636420538662, 664, 266, 398, 1, 0, 1
684, 1, 1636420538240, 1636420538862, 622, 269, 353, 0, 0, 0
685, 1, 1636420538292, 1636420538906, 614, 262, 352, 0, 0, 0
686, 1, 1636420538418, 1636420539042, 624, 270, 354, 1, 1, 2
687, 1, 1636420538541, 1636420539162, 621, 267, 354, 0, 2, 2
689, 1, 1636420538933, 1636420539550, 617, 263, 354, 1, 1, 2
690, 1, 1636420538971, 1636420539586, 615, 262, 353, 1, 0, 1
691, 1, 1636420539130, 1636420539798, 668, 266, 402, 0, 2, 2
692, 1, 1636420539227, 1636420539850, 623, 270, 353, 1, 0, 1
694, 1, 1636420539387, 1636420540010, 623, 266, 357, 1, 1, 2
696, 1, 1636420539546, 1636420540162, 616, 262, 354, 0, 0, 0
695, 1, 1636420539518, 1636420540194, 676, 266, 410, 0, 0, 0
697, 1, 1636420539914, 1636420540546, 632, 270, 362, 1, 0, 1
699, 1, 1636420540055, 1636420540682, 627, 270, 357, 1, 1, 2
700, 1, 1636420540231, 1636420540854, 623, 271, 352, 1, 1, 2
627, 2, 1636420530583, 1636420540996, 10413, 224, 10189, 1, 1, 2
701, 1, 1636420540395, 1636420541018, 623, 271, 352, 1, 2, 3
702, 1, 1636420540458, 1636420541078, 620, 266, 354, 0, 0, 0
630, 2, 1636420531044, 1636420541177, 10133, 1, 10132, 1, 1, 2
633, 2, 1636420531303, 1636420541438, 10135, 1, 10134, 2, 1, 3
704, 1, 1636420540997, 1636420541629, 632, 317, 315, 0, 48, 48
705, 1, 1636420541040, 1636420541706, 666, 311, 355, 1, 46, 47
706, 1, 1636420541178, 1636420541882, 704, 306, 398, 0, 41, 41
708, 1, 1636420541391, 1636420542010, 619, 263, 356, 0, 0, 0
709, 1, 1636420541444, 1636420542058, 614, 262, 352, 0, 0, 0
640, 2, 1636420532210, 1636420542345, 10135, 1, 10134, 0, 0, 0
711, 1, 1636420542071, 1636420542698, 627, 275, 352, 0, 12, 12
712, 1, 1636420542094, 1636420542710, 616, 262, 354, 1, 0, 1
645, 2, 1636420532804, 1636420542938, 10134, 1, 10133, 0, 1, 1
713, 1, 1636420542384, 1636420543010, 626, 270, 356, 0, 1, 1
714, 1, 1636420542478, 1636420543106, 628, 273, 355, 0, 1, 1
715, 1, 1636420543080, 1636420543706, 626, 269, 357, 1, 1, 2
650, 2, 1636420533678, 1636420543812, 10134, 0, 10134, 0, 0, 0
717, 1, 1636420543413, 1636420544078, 665, 308, 357, 1, 40, 41
654, 2, 1636420534415, 1636420544548, 10133, 1, 10132, 2, 0, 2
719, 1, 1636420544071, 1636420544698, 627, 271, 356, 2, 2, 4
720, 1, 1636420544414, 1636420545086, 672, 316, 356, 0, 0, 0
660, 2, 1636420535119, 1636420545253, 10134, 1, 10133, 1, 1, 2
721, 1, 1636420545070, 1636420545694, 624, 270, 354, 1, 7, 8
665, 2, 1636420535805, 1636420545940, 10135, 0, 10135, 1, 0, 1
722, 1, 1636420545398, 1636420546030, 632, 271, 361, 0, 1, 1
723, 1, 1636420546035, 1636420546658, 623, 270, 353, 0, 1, 1
724, 1, 1636420546368, 1636420546994, 626, 266, 360, 1, 1, 2
678, 2, 1636420537443, 1636420547576, 10133, 1, 10132, 1, 0, 1
725, 1, 1636420547068, 1636420547690, 622, 270, 352, 0, 1, 1
726, 1, 1636420547335, 1636420547958, 623, 268, 355, 1, 0, 1
683, 2, 1636420538027, 1636420548165, 10138, 1, 10137, 0, 1, 1
727, 1, 1636420548097, 1636420548746, 649, 272, 377, 2, 2, 4
688, 2, 1636420538700, 1636420548832, 10132, 1, 10131, 1, 0, 1
728, 1, 1636420548336, 1636420548962, 626, 272, 354, 0, 2, 2
693, 2, 1636420539302, 1636420549436, 10134, 0, 10134, 0, 0, 0
729, 1, 1636420549130, 1636420549790, 660, 303, 357, 0, 37, 37
730, 1, 1636420549350, 1636420549970, 620, 265, 355, 0, 1, 1
698, 2, 1636420539980, 1636420550113, 10133, 0, 10133, 0, 0, 0
703, 2, 1636420540557, 1636420550693, 10136, 0, 10136, 0, 1, 1
731, 1, 1636420550152, 1636420550770, 618, 268, 350, 1, 2, 3
732, 1, 1636420550368, 1636420550994, 626, 271, 355, 0, 0, 0
707, 2, 1636420541255, 1636420551389, 10134, 1, 10133, 1, 1, 2
733, 1, 1636420551132, 1636420551750, 618, 266, 352, 0, 0, 0
740, 1, 1636420551150, 1636420551834, 684, 275, 409, 3, 9, 12
737, 1, 1636420551147, 1636420551842, 695, 294, 401, 1, 30, 31
748, 1, 1636420551336, 1636420551966, 630, 267, 363, 1, 1, 2
710, 2, 1636420541947, 1636420552080, 10133, 1, 10132, 0, 1, 1
751, 1, 1636420552100, 1636420552726, 626, 270, 356, 0, 1, 1
750, 1, 1636420552094, 1636420552726, 632, 274, 358, 0, 2, 2
752, 1, 1636420552128, 1636420552750, 622, 269, 353, 0, 1, 1
754, 1, 1636420552311, 1636420552934, 623, 270, 353, 0, 1, 1
716, 2, 1636420543096, 1636420553228, 10132, 1, 10131, 0, 1, 1
755, 1, 1636420553085, 1636420553710, 625, 270, 355, 2, 0, 2
718, 1, 1636420543502, 1636420553722, 10220, 9862, 358, 1, 0, 1
756, 1, 1636420553091, 1636420553722, 631, 272, 359, 0, 0, 0
758, 1, 1636420553327, 1636420553946, 619, 266, 353, 1, 0, 1
757, 1, 1636420553153, 1636420553978, 825, 442, 383, 1, 0, 1
761, 1, 1636420554061, 1636420554690, 629, 275, 354, 0, 1, 1
762, 1, 1636420554075, 1636420554694, 619, 266, 353, 0, 0, 0
763, 1, 1636420554165, 1636420554786, 621, 267, 354, 1, 0, 1
764, 1, 1636420554334, 1636420554954, 620, 268, 352, 2, 1, 3
765, 1, 1636420555046, 1636420555670, 624, 270, 354, 1, 0, 1
766, 1, 1636420555053, 1636420555678, 625, 266, 359, 1, 0, 1
767, 1, 1636420555178, 1636420555802, 624, 267, 357, 2, 0, 2
768, 1, 1636420555319, 1636420555942, 623, 268, 355, 0, 0, 0
769, 1, 1636420556019, 1636420556642, 623, 272, 351, 1, 2, 3
770, 1, 1636420556078, 1636420556702, 624, 272, 352, 1, 1, 2
771, 1, 1636420556175, 1636420556798, 623, 269, 354, 0, 1, 1
772, 1, 1636420556289, 1636420556918, 629, 272, 357, 0, 1, 1
773, 1, 1636420557053, 1636420557678, 625, 270, 355, 2, 1, 3
774, 1, 1636420557107, 1636420557730, 623, 270, 353, 1, 1, 2
775, 1, 1636420557148, 1636420557778, 630, 274, 356, 1, 1, 2
776, 1, 1636420557261, 1636420557886, 625, 270, 355, 0, 0, 0
777, 1, 1636420558082, 1636420558702, 620, 267, 353, 0, 2, 2
778, 1, 1636420558117, 1636420558746, 629, 267, 362, 1, 1, 2
779, 1, 1636420558140, 1636420558762, 622, 270, 352, 1, 0, 1
780, 1, 1636420558266, 1636420558898, 632, 269, 363, 1, 0, 1
781, 1, 1636420559096, 1636420559726, 630, 269, 361, 0, 1, 1
782, 1, 1636420559114, 1636420559738, 624, 268, 356, 0, 0, 0
783, 1, 1636420559170, 1636420559794, 624, 270, 354, 0, 2, 2
784, 1, 1636420559237, 1636420559862, 625, 266, 359, 0, 1, 1
785, 1, 1636420560101, 1636420560722, 621, 266, 355, 0, 0, 0
786, 1, 1636420560139, 1636420560758, 619, 267, 352, 0, 2, 2
787, 1, 1636420560144, 1636420560762, 618, 266, 352, 2, 0, 2
788, 1, 1636420560270, 1636420560894, 624, 270, 354, 0, 1, 1
736, 2, 1636420551147, 1636420561320, 10173, 2, 10171, 1, 1, 2
741, 2, 1636420551151, 1636420561367, 10216, 2, 10214, 3, 0, 3
744, 2, 1636420551154, 1636420561412, 10258, 3, 10255, 3, 1, 4
739, 2, 1636420551150, 1636420561456, 10306, 3, 10303, 3, 1, 4
746, 2, 1636420551154, 1636420561504, 10350, 1, 10349, 3, 0, 3
747, 2, 1636420551158, 1636420561552, 10394, 2, 10392, 2, 1, 3
745, 2, 1636420551154, 1636420561600, 10446, 2, 10444, 2, 0, 2
735, 2, 1636420551147, 1636420561648, 10501, 0, 10501, 0, 0, 0
734, 2, 1636420551146, 1636420561696, 10550, 1, 10549, 1, 0, 1
742, 2, 1636420551151, 1636420561744, 10593, 0, 10593, 0, 0, 0
738, 2, 1636420551148, 1636420561792, 10644, 1, 10643, 0, 0, 0
743, 2, 1636420551152, 1636420561938, 10786, 464, 10322, 0, 0, 0
749, 2, 1636420551574, 1636420561985, 10411, 1, 10410, 1, 1, 2
789, 1, 1636420561099, 1636420562350, 1251, 889, 362, 0, 627, 627
790, 1, 1636420561123, 1636420562438, 1315, 294, 1021, 4, 23, 27
791, 1, 1636420561137, 1636420562438, 1301, 279, 1022, 2, 9, 11
753, 2, 1636420552266, 1636420562440, 10174, 1, 10173, 0, 0, 0
792, 1, 1636420561260, 1636420562530, 1270, 937, 333, 667, 4, 671
794, 1, 1636420562074, 1636420562734, 660, 267, 393, 2, 1, 3
806, 1, 1636420562352, 1636420563014, 662, 262, 400, 0, 0, 0
807, 1, 1636420562442, 1636420563102, 660, 266, 394, 0, 1, 1
808, 1, 1636420562457, 1636420563122, 665, 266, 399, 1, 0, 1
809, 1, 1636420562531, 1636420563190, 659, 263, 396, 0, 1, 1
759, 2, 1636420553406, 1636420563584, 10178, 0, 10178, 0, 0, 0
810, 1, 1636420563055, 1636420563682, 627, 272, 355, 1, 3, 4
811, 1, 1636420563371, 1636420564034, 663, 309, 354, 1, 40, 41
812, 1, 1636420563420, 1636420564034, 614, 262, 352, 0, 0, 0
760, 1, 1636420553742, 1636420564074, 10332, 9931, 401, 1, 1, 2
813, 1, 1636420563465, 1636420564122, 657, 271, 386, 2, 0, 2
814, 1, 1636420563586, 1636420564162, 576, 267, 309, 0, 1, 1
816, 1, 1636420564048, 1636420564670, 622, 270, 352, 0, 1, 1
818, 1, 1636420564373, 1636420565002, 629, 274, 355, 0, 1, 1
819, 1, 1636420564409, 1636420565034, 625, 265, 360, 0, 0, 0
820, 1, 1636420564461, 1636420565090, 629, 270, 359, 0, 2, 2
821, 1, 1636420564571, 1636420565194, 623, 270, 353, 1, 0, 1
822, 1, 1636420565019, 1636420565642, 623, 270, 353, 0, 1, 1
823, 1, 1636420565362, 1636420565994, 632, 271, 361, 1, 1, 2
824, 1, 1636420565426, 1636420566050, 624, 267, 357, 1, 1, 2
825, 1, 1636420565456, 1636420566078, 622, 270, 352, 1, 0, 1
826, 1, 1636420565577, 1636420566198, 621, 266, 355, 1, 0, 1
827, 1, 1636420565996, 1636420566618, 622, 270, 352, 1, 1, 2
828, 1, 1636420566336, 1636420566966, 630, 273, 357, 0, 1, 1
829, 1, 1636420566455, 1636420567074, 619, 265, 354, 0, 0, 0
830, 1, 1636420566472, 1636420567106, 634, 275, 359, 1, 1, 2
831, 1, 1636420566581, 1636420567206, 625, 269, 356, 0, 1, 1
832, 1, 1636420567027, 1636420567650, 623, 268, 355, 1, 1, 2
833, 1, 1636420567338, 1636420567962, 624, 268, 356, 3, 1, 4
834, 1, 1636420567455, 1636420568082, 627, 271, 356, 1, 1, 2
835, 1, 1636420567506, 1636420568130, 624, 266, 358, 2, 0, 2
836, 1, 1636420567607, 1636420568222, 615, 262, 353, 1, 0, 1
837, 1, 1636420568031, 1636420568662, 631, 275, 356, 2, 1, 3
838, 1, 1636420568340, 1636420568966, 626, 269, 357, 1, 1, 2
839, 1, 1636420568443, 1636420569066, 623, 267, 356, 1, 1, 2
840, 1, 1636420568506, 1636420569134, 628, 267, 361, 0, 1, 1
841, 1, 1636420568639, 1636420569262, 623, 269, 354, 0, 1, 1
842, 1, 1636420569053, 1636420569678, 625, 270, 355, 0, 1, 1
843, 1, 1636420569321, 1636420569942, 621, 266, 355, 0, 1, 1
844, 1, 1636420569465, 1636420570086, 621, 267, 354, 1, 1, 2
845, 1, 1636420569494, 1636420570118, 624, 270, 354, 0, 0, 0
846, 1, 1636420569618, 1636420570238, 620, 266, 354, 0, 1, 1
847, 1, 1636420570056, 1636420570674, 618, 266, 352, 0, 0, 0
848, 1, 1636420570310, 1636420570938, 628, 274, 354, 0, 1, 1
849, 1, 1636420570486, 1636420571110, 624, 269, 355, 0, 0, 0
850, 1, 1636420570516, 1636420571158, 642, 268, 374, 0, 0, 0
851, 1, 1636420570598, 1636420571222, 624, 269, 355, 0, 0, 0
852, 1, 1636420571046, 1636420571674, 628, 275, 353, 1, 1, 2
853, 1, 1636420571283, 1636420571906, 623, 268, 355, 1, 0, 1
854, 1, 1636420571468, 1636420572082, 614, 262, 352, 1, 0, 1
855, 1, 1636420571517, 1636420572142, 625, 267, 358, 0, 1, 1
856, 1, 1636420571577, 1636420572206, 629, 271, 358, 0, 0, 0
793, 2, 1636420562074, 1636420572248, 10174, 1, 10173, 1, 0, 1
805, 2, 1636420562084, 1636420572296, 10212, 3, 10209, 1, 2, 3
803, 2, 1636420562083, 1636420572344, 10261, 2, 10259, 0, 1, 1
801, 2, 1636420562083, 1636420572392, 10309, 3, 10306, 3, 2, 5
798, 2, 1636420562082, 1636420572440, 10358, 2, 10356, 3, 1, 4
800, 2, 1636420562082, 1636420572488, 10406, 3, 10403, 0, 3, 3
802, 2, 1636420562083, 1636420572540, 10457, 1, 10456, 4, 1, 5
804, 2, 1636420562084, 1636420572584, 10500, 3, 10497, 5, 1, 6
799, 2, 1636420562082, 1636420572632, 10550, 3, 10547, 5, 1, 6
797, 2, 1636420562078, 1636420572680, 10602, 1, 10601, 2, 0, 2
796, 2, 1636420562078, 1636420572729, 10651, 0, 10651, 0, 0, 0
795, 2, 1636420562075, 1636420572776, 10701, 0, 10701, 0, 0, 0
858, 1, 1636420572032, 1636420573230, 1198, 842, 356, 5, 573, 578
859, 1, 1636420572778, 1636420573354, 576, 266, 310, 4, 1, 5
861, 1, 1636420572779, 1636420573362, 583, 265, 318, 4, 0, 4
860, 1, 1636420572778, 1636420573370, 592, 271, 321, 1, 0, 1
862, 1, 1636420572779, 1636420573438, 659, 263, 396, 0, 0, 0
863, 1, 1636420572866, 1636420573526, 660, 266, 394, 0, 1, 1
875, 1, 1636420573249, 1636420573918, 669, 266, 403, 1, 0, 1
876, 1, 1636420573364, 1636420574033, 669, 266, 403, 0, 1, 1
877, 1, 1636420573506, 1636420574126, 620, 265, 355, 1, 0, 1
878, 1, 1636420573508, 1636420574134, 626, 267, 359, 1, 0, 1
815, 2, 1636420563982, 1636420574156, 10174, 0, 10174, 0, 0, 0
817, 2, 1636420564076, 1636420574252, 10176, 0, 10176, 0, 0, 0
881, 1, 1636420574253, 1636420574878, 625, 274, 351, 1, 0, 1
883, 1, 1636420574353, 1636420574974, 621, 266, 355, 1, 1, 2
885, 1, 1636420574497, 1636420575122, 625, 268, 357, 0, 0, 0
886, 1, 1636420574539, 1636420575158, 619, 266, 353, 0, 0, 0
887, 1, 1636420575203, 1636420575826, 623, 269, 354, 0, 0, 0
888, 1, 1636420575347, 1636420575970, 623, 272, 351, 0, 1, 1
889, 1, 1636420575493, 1636420576118, 625, 270, 355, 1, 1, 2
890, 1, 1636420575524, 1636420576146, 622, 269, 353, 1, 0, 1
891, 1, 1636420576232, 1636420576854, 622, 269, 353, 0, 1, 1
892, 1, 1636420576348, 1636420576974, 626, 274, 352, 2, 0, 2
893, 1, 1636420576521, 1636420577150, 629, 270, 359, 0, 2, 2
894, 1, 1636420576526, 1636420577150, 624, 266, 358, 1, 0, 1
895, 1, 1636420577267, 1636420577886, 619, 266, 353, 0, 0, 0
896, 1, 1636420577357, 1636420577978, 621, 266, 355, 0, 0, 0
897, 1, 1636420577526, 1636420578150, 624, 265, 359, 0, 0, 0
898, 1, 1636420577555, 1636420578174, 619, 265, 354, 0, 0, 0
899, 1, 1636420578254, 1636420578878, 624, 270, 354, 1, 1, 2
900, 1, 1636420578375, 1636420578998, 623, 266, 357, 0, 0, 0
901, 1, 1636420578509, 1636420579134, 625, 268, 357, 0, 1, 1
902, 1, 1636420578556, 1636420579174, 618, 268, 350, 1, 1, 2
903, 1, 1636420579223, 1636420579846, 623, 271, 352, 1, 2, 3
904, 1, 1636420579344, 1636420579966, 622, 264, 358, 1, 0, 1
905, 1, 1636420579498, 1636420580122, 624, 268, 356, 0, 0, 0
906, 1, 1636420579546, 1636420580178, 632, 269, 363, 0, 0, 0
907, 1, 1636420580190, 1636420580814, 624, 271, 353, 0, 2, 2
908, 1, 1636420580323, 1636420580942, 619, 267, 352, 1, 1, 2
910, 1, 1636420580544, 1636420581174, 630, 268, 362, 0, 0, 0
909, 1, 1636420580471, 1636420581214, 743, 388, 355, 0, 1, 1
911, 1, 1636420581189, 1636420581810, 621, 265, 356, 1, 1, 2
912, 1, 1636420581334, 1636420581958, 624, 271, 353, 0, 1, 1
913, 1, 1636420581450, 1636420582078, 628, 268, 360, 0, 0, 0
914, 1, 1636420581509, 1636420582130, 621, 266, 355, 1, 0, 1
857, 2, 1636420571970, 1636420582152, 10182, 1, 10181, 0, 0, 0
880, 1, 1636420573830, 1636420582646, 8816, 8455, 361, 2, 1, 3
915, 1, 1636420582204, 1636420582826, 622, 270, 352, 0, 1, 1
917, 1, 1636420582365, 1636420582990, 625, 271, 354, 2, 1, 3
864, 2, 1636420572866, 1636420583045, 10179, 1, 10178, 0, 1, 1
918, 1, 1636420582448, 1636420583070, 622, 270, 352, 0, 0, 0
867, 2, 1636420572870, 1636420583092, 10222, 3, 10219, 0, 0, 0
919, 1, 1636420582484, 1636420583118, 634, 275, 359, 0, 0, 0
868, 2, 1636420572870, 1636420583140, 10270, 3, 10267, 1, 0, 1
870, 2, 1636420572871, 1636420583188, 10317, 3, 10314, 0, 0, 0
873, 2, 1636420572872, 1636420583236, 10364, 2, 10362, 1, 1, 2
872, 2, 1636420572872, 1636420583280, 10408, 2, 10406, 1, 1, 2
874, 2, 1636420572872, 1636420583328, 10456, 1, 10455, 1, 1, 2
866, 2, 1636420572867, 1636420583372, 10505, 2, 10503, 1, 1, 2
871, 2, 1636420572871, 1636420583416, 10545, 2, 10543, 2, 1, 3
865, 2, 1636420572867, 1636420583464, 10597, 1, 10596, 0, 1, 1
869, 2, 1636420572871, 1636420583513, 10642, 2, 10640, 3, 0, 3
920, 1, 1636420582671, 1636420583786, 1115, 715, 400, 0, 450, 450
879, 2, 1636420573792, 1636420583928, 10136, 0, 10136, 0, 0, 0
922, 1, 1636420583514, 1636420584098, 584, 272, 312, 1, 1, 2
921, 1, 1636420583514, 1636420584098, 584, 271, 313, 2, 1, 3
924, 1, 1636420583518, 1636420584194, 676, 279, 397, 3, 12, 15
923, 1, 1636420583516, 1636420584194, 678, 278, 400, 3, 11, 14
925, 1, 1636420583598, 1636420584282, 684, 291, 393, 1, 28, 29
936, 1, 1636420583788, 1636420584458, 670, 262, 408, 0, 0, 0
882, 2, 1636420574286, 1636420584460, 10174, 1, 10173, 2, 0, 2
930, 1, 1636420583605, 1636420584546, 941, 544, 397, 3, 2, 5
884, 2, 1636420574438, 1636420584615, 10177, 0, 10177, 1, 0, 1
937, 1, 1636420584107, 1636420584814, 707, 265, 442, 0, 0, 0
938, 1, 1636420584219, 1636420584882, 663, 262, 401, 1, 0, 1
939, 1, 1636420584362, 1636420584994, 632, 264, 368, 1, 0, 1
916, 1, 1636420582282, 1636420585106, 2824, 2426, 398, 0, 1, 1
940, 1, 1636420584503, 1636420585146, 643, 263, 380, 2, 0, 2
941, 1, 1636420584505, 1636420585154, 649, 273, 376, 2, 1, 3
946, 1, 1636420584788, 1636420585402, 614, 262, 352, 0, 0, 0
947, 1, 1636420585063, 1636420585698, 635, 273, 362, 1, 1, 2
949, 1, 1636420585194, 1636420585818, 624, 266, 358, 1, 1, 2
950, 1, 1636420585390, 1636420586018, 628, 269, 359, 0, 0, 0
952, 1, 1636420585510, 1636420586134, 624, 268, 356, 0, 0, 0
953, 1, 1636420585756, 1636420586382, 626, 271, 355, 0, 2, 2
954, 1, 1636420586034, 1636420586653, 619, 265, 354, 1, 0, 1
955, 1, 1636420586209, 1636420586830, 621, 266, 355, 0, 0, 0
956, 1, 1636420586386, 1636420587006, 620, 262, 358, 2, 0, 2
957, 1, 1636420586519, 1636420587142, 623, 269, 354, 1, 1, 2
958, 1, 1636420586788, 1636420587410, 622, 266, 356, 1, 1, 2
960, 1, 1636420587217, 1636420587838, 621, 265, 356, 0, 0, 0
961, 1, 1636420587366, 1636420587998, 632, 273, 359, 0, 0, 0
962, 1, 1636420587537, 1636420588154, 617, 262, 355, 1, 0, 1
963, 1, 1636420587793, 1636420588414, 621, 266, 355, 0, 1, 1
964, 1, 1636420588203, 1636420588826, 623, 270, 353, 0, 1, 1
966, 1, 1636420588507, 1636420589134, 627, 269, 358, 0, 0, 0
967, 1, 1636420588810, 1636420589438, 628, 270, 358, 0, 1, 1
968, 1, 1636420589172, 1636420589794, 622, 270, 352, 0, 1, 1
969, 1, 1636420589486, 1636420590114, 628, 268, 360, 0, 0, 0
970, 1, 1636420589813, 1636420590438, 625, 271, 354, 2, 0, 2
971, 1, 1636420590140, 1636420590754, 614, 262, 352, 2, 0, 2
972, 1, 1636420590497, 1636420591126, 629, 274, 355, 0, 0, 0
973, 1, 1636420590809, 1636420591426, 617, 263, 354, 0, 1, 1
974, 1, 1636420591175, 1636420591798, 623, 268, 355, 0, 3, 3
975, 1, 1636420591504, 1636420592130, 626, 269, 357, 0, 0, 0
976, 1, 1636420591789, 1636420592414, 625, 269, 356, 0, 0, 0
977, 1, 1636420592165, 1636420592790, 625, 266, 359, 0, 1, 1
978, 1, 1636420592485, 1636420593118, 633, 269, 364, 1, 1, 2
979, 1, 1636420592825, 1636420593450, 625, 268, 357, 0, 2, 2
928, 2, 1636420583604, 1636420593776, 10172, 0, 10172, 0, 0, 0
980, 1, 1636420593197, 1636420593822, 625, 270, 355, 1, 1, 2
935, 2, 1636420583607, 1636420593824, 10217, 1, 10216, 1, 0, 1
933, 2, 1636420583606, 1636420593873, 10267, 1, 10266, 0, 2, 2
929, 2, 1636420583604, 1636420593920, 10316, 3, 10313, 3, 0, 3
934, 2, 1636420583607, 1636420593968, 10361, 1, 10360, 1, 0, 1
932, 2, 1636420583606, 1636420594017, 10411, 3, 10408, 1, 2, 3
926, 2, 1636420583603, 1636420594064, 10461, 3, 10458, 4, 0, 4
927, 2, 1636420583604, 1636420594112, 10508, 4, 10504, 3, 0, 3
931, 2, 1636420583605, 1636420594161, 10556, 3, 10553, 2, 2, 4
981, 1, 1636420593501, 1636420594514, 1013, 274, 739, 0, 7, 7
942, 2, 1636420584548, 1636420594708, 10160, 1, 10159, 1, 0, 1
982, 1, 1636420594161, 1636420594746, 585, 270, 315, 0, 1, 1
943, 2, 1636420584560, 1636420594756, 10196, 1, 10195, 0, 1, 1
944, 2, 1636420584617, 1636420594804, 10187, 0, 10187, 0, 0, 0
983, 1, 1636420594197, 1636420594862, 665, 269, 396, 0, 0, 0
945, 2, 1636420584754, 1636420594936, 10182, 1, 10181, 1, 0, 1
951, 1, 1636420585472, 1636420595294, 9822, 9467, 355, 1, 51, 52
987, 1, 1636420594459, 1636420595294, 835, 387, 448, 1, 123, 124
993, 1, 1636420594516, 1636420595294, 778, 380, 398, 3, 115, 118
948, 2, 1636420585122, 1636420595300, 10178, 0, 10178, 1, 1, 2
994, 1, 1636420594805, 1636420595474, 669, 271, 398, 1, 3, 4
996, 1, 1636420595058, 1636420595746, 688, 294, 394, 0, 27, 27
999, 1, 1636420595195, 1636420595830, 635, 262, 373, 0, 0, 0
1000, 1, 1636420595302, 1636420595966, 664, 266, 398, 0, 0, 0
997, 1, 1636420595062, 1636420596014, 952, 558, 394, 0, 0, 0
1003, 1, 1636420595497, 1636420596122, 625, 269, 356, 0, 0, 0
1001, 1, 1636420595407, 1636420596282, 875, 519, 356, 1, 1, 2
1004, 1, 1636420595812, 1636420596430, 618, 266, 352, 1, 0, 1
1005, 1, 1636420596001, 1636420596622, 621, 265, 356, 1, 0, 1
1007, 1, 1636420596230, 1636420596846, 616, 263, 353, 0, 0, 0
1008, 1, 1636420596318, 1636420596942, 624, 266, 358, 0, 0, 0
1009, 1, 1636420596398, 1636420597022, 624, 270, 354, 1, 0, 1
1010, 1, 1636420596503, 1636420597130, 627, 270, 357, 0, 0, 0
959, 2, 1636420587035, 1636420597168, 10133, 0, 10133, 1, 0, 1
1011, 1, 1636420596812, 1636420597434, 622, 270, 352, 0, 5, 5
1012, 1, 1636420596978, 1636420597614, 636, 282, 354, 1, 15, 16
1013, 1, 1636420597242, 1636420597874, 632, 275, 357, 1, 1, 2
1015, 1, 1636420597324, 1636420597950, 626, 270, 356, 0, 0, 0
1014, 1, 1636420597298, 1636420597966, 668, 265, 403, 0, 1, 1
1016, 1, 1636420597376, 1636420598010, 634, 270, 364, 0, 2, 2
1017, 1, 1636420597512, 1636420598134, 622, 270, 352, 2, 0, 2
1018, 1, 1636420597812, 1636420598434, 622, 270, 352, 1, 1, 2
965, 2, 1636420588400, 1636420598532, 10132, 1, 10131, 1, 0, 1
1019, 1, 1636420597994, 1636420598618, 624, 271, 353, 1, 1, 2
1020, 1, 1636420598259, 1636420598886, 627, 275, 352, 1, 9, 10
1021, 1, 1636420598273, 1636420598893, 620, 262, 358, 2, 0, 2
1022, 1, 1636420598328, 1636420598981, 653, 298, 355, 3, 31, 34
1023, 1, 1636420598392, 1636420599010, 618, 266, 352, 1, 0, 1
1006, 1, 1636420596019, 1636420599022, 3003, 2607, 396, 1, 0, 1
1024, 1, 1636420598533, 1636420599150, 617, 262, 355, 2, 0, 2
1025, 1, 1636420598662, 1636420599414, 752, 355, 397, 1, 1, 2
1026, 1, 1636420598800, 1636420599422, 622, 263, 359, 0, 1, 1
1027, 1, 1636420598999, 1636420599618, 619, 266, 353, 2, 0, 2
1028, 1, 1636420599038, 1636420599706, 668, 268, 400, 0, 0, 0
1029, 1, 1636420599228, 1636420599846, 618, 267, 351, 1, 0, 1
1030, 1, 1636420599287, 1636420599910, 623, 264, 359, 1, 0, 1
1031, 1, 1636420599335, 1636420599950, 615, 261, 354, 1, 0, 1
1032, 1, 1636420599400, 1636420600014, 614, 262, 352, 0, 0, 0
1033, 1, 1636420599528, 1636420600150, 622, 269, 353, 1, 0, 1
1034, 1, 1636420599629, 1636420600422, 793, 437, 356, 0, 1, 1
1035, 1, 1636420599821, 1636420600442, 621, 262, 359, 0, 1, 1
1036, 1, 1636420600007, 1636420600622, 615, 263, 352, 0, 1, 1
1037, 1, 1636420600023, 1636420600642, 619, 267, 352, 2, 0, 2
1038, 1, 1636420600205, 1636420600826, 621, 267, 354, 0, 1, 1
1039, 1, 1636420600284, 1636420600906, 622, 271, 351, 1, 0, 1
1040, 1, 1636420600367, 1636420600990, 623, 262, 361, 0, 1, 1
1041, 1, 1636420600406, 1636420601026, 620, 262, 358, 1, 0, 1
1042, 1, 1636420600542, 1636420601166, 624, 271, 353, 2, 0, 2
1043, 1, 1636420600637, 1636420601434, 797, 443, 354, 1, 1, 2
1044, 1, 1636420600844, 1636420601462, 618, 267, 351, 0, 0, 0
1045, 1, 1636420600988, 1636420601606, 618, 260, 358, 0, 0, 0
1046, 1, 1636420601022, 1636420601646, 624, 263, 361, 1, 0, 1
1047, 1, 1636420601215, 1636420601830, 615, 262, 353, 0, 0, 0
1048, 1, 1636420601291, 1636420601906, 615, 263, 352, 1, 0, 1
1050, 1, 1636420601409, 1636420602030, 621, 265, 356, 0, 0, 0
1051, 1, 1636420601539, 1636420602162, 623, 270, 353, 1, 1, 2
1052, 1, 1636420601634, 1636420602434, 800, 446, 354, 1, 1, 2
1053, 1, 1636420601825, 1636420602446, 621, 267, 354, 1, 0, 1
1054, 1, 1636420601988, 1636420602614, 626, 269, 357, 0, 1, 1
1055, 1, 1636420602018, 1636420602638, 620, 262, 358, 1, 0, 1
1056, 1, 1636420602249, 1636420602870, 621, 263, 358, 1, 0, 1
1057, 1, 1636420602266, 1636420602886, 620, 265, 355, 0, 0, 0
1058, 1, 1636420602405, 1636420603030, 625, 265, 360, 1, 0, 1
1059, 1, 1636420602547, 1636420603170, 623, 268, 355, 1, 0, 1
1060, 1, 1636420602647, 1636420603446, 799, 442, 357, 2, 1, 3
1061, 1, 1636420602828, 1636420603454, 626, 269, 357, 0, 0, 0
1062, 1, 1636420603005, 1636420603622, 617, 267, 350, 1, 2, 3
1063, 1, 1636420603017, 1636420603642, 625, 266, 359, 0, 1, 1
1064, 1, 1636420603230, 1636420603858, 628, 270, 358, 0, 0, 0
1065, 1, 1636420603254, 1636420603882, 628, 270, 358, 0, 0, 0
1066, 1, 1636420603392, 1636420604010, 618, 266, 352, 1, 2, 3
1067, 1, 1636420603518, 1636420604146, 628, 269, 359, 1, 0, 1
1068, 1, 1636420603639, 1636420604422, 783, 417, 366, 1, 1, 2
1069, 1, 1636420603862, 1636420604486, 624, 269, 355, 1, 0, 1
984, 2, 1636420594458, 1636420604636, 10178, 1, 10177, 3, 0, 3
1070, 1, 1636420604029, 1636420604646, 617, 262, 355, 1, 1, 2
1071, 1, 1636420604050, 1636420604674, 624, 266, 358, 0, 0, 0
991, 2, 1636420594463, 1636420604684, 10221, 1, 10220, 1, 1, 2
990, 2, 1636420594463, 1636420604732, 10269, 4, 10265, 4, 0, 4
989, 2, 1636420594462, 1636420604776, 10314, 4, 10310, 5, 0, 5
992, 2, 1636420594466, 1636420604820, 10354, 0, 10354, 0, 0, 0
988, 2, 1636420594462, 1636420604864, 10402, 3, 10399, 2, 0, 2
985, 2, 1636420594458, 1636420604912, 10454, 2, 10452, 2, 0, 2
986, 2, 1636420594459, 1636420604960, 10501, 1, 10500, 1, 0, 1
995, 2, 1636420594937, 1636420605112, 10175, 0, 10175, 0, 0, 0
1072, 1, 1636420604251, 1636420605230, 979, 297, 682, 1, 31, 32
998, 2, 1636420595066, 1636420605244, 10178, 1, 10177, 1, 0, 1
1074, 1, 1636420604416, 1636420605410, 994, 638, 356, 1, 373, 374
1075, 1, 1636420604506, 1636420605510, 1004, 423, 581, 2, 12, 14
1073, 1, 1636420604264, 1636420605514, 1250, 893, 357, 1, 12, 13
1077, 1, 1636420604961, 1636420605606, 645, 335, 310, 2, 66, 68
1002, 2, 1636420595431, 1636420605611, 10180, 0, 10180, 0, 0, 0
1078, 1, 1636420605029, 1636420605698, 669, 318, 351, 1, 48, 49
1079, 1, 1636420605054, 1636420605698, 644, 275, 369, 1, 2, 3
1076, 1, 1636420604637, 1636420605774, 1137, 545, 592, 0, 2, 2
1089, 1, 1636420605250, 1636420605970, 720, 310, 410, 1, 43, 44
1091, 1, 1636420605416, 1636420606090, 674, 269, 405, 0, 1, 1
1049, 1, 1636420601346, 1636420606106, 4760, 4396, 364, 0, 1, 1
1092, 1, 1636420605512, 1636420606194, 682, 265, 417, 0, 0, 0
1093, 1, 1636420605515, 1636420606202, 687, 271, 416, 3, 0, 3
1096, 1, 1636420605828, 1636420606442, 614, 262, 352, 1, 0, 1
1095, 1, 1636420605775, 1636420606462, 687, 290, 397, 1, 1, 2
1097, 1, 1636420606018, 1636420606638, 620, 266, 354, 2, 1, 3
1098, 1, 1636420606025, 1636420606642, 617, 262, 355, 1, 0, 1
1099, 1, 1636420606108, 1636420606778, 670, 271, 399, 3, 1, 4
1100, 1, 1636420606225, 1636420606850, 625, 269, 356, 1, 0, 1
1101, 1, 1636420606415, 1636420607030, 615, 262, 353, 2, 0, 2
1102, 1, 1636420606496, 1636420607122, 626, 274, 352, 1, 0, 1
1103, 1, 1636420606510, 1636420607134, 624, 266, 358, 0, 1, 1
1104, 1, 1636420606775, 1636420607398, 623, 269, 354, 0, 0, 0
1105, 1, 1636420606848, 1636420607462, 614, 263, 351, 2, 1, 3
1106, 1, 1636420607021, 1636420607642, 621, 265, 356, 1, 0, 1
1107, 1, 1636420607034, 1636420607650, 616, 261, 355, 0, 0, 0
1108, 1, 1636420607084, 1636420607710, 626, 261, 365, 0, 0, 0
1109, 1, 1636420607231, 1636420607846, 615, 262, 353, 0, 0, 0
1110, 1, 1636420607441, 1636420608062, 621, 267, 354, 1, 1, 2
1111, 1, 1636420607476, 1636420608094, 618, 267, 351, 0, 0, 0
1112, 1, 1636420607503, 1636420608126, 623, 266, 357, 1, 0, 1
1113, 1, 1636420607741, 1636420608362, 621, 265, 356, 0, 0, 0
1114, 1, 1636420607865, 1636420608486, 621, 267, 354, 0, 1, 1
1116, 1, 1636420608045, 1636420608662, 617, 266, 351, 0, 1, 1
1117, 1, 1636420608112, 1636420608730, 618, 266, 352, 1, 1, 2
1115, 1, 1636420608034, 1636420608750, 716, 362, 354, 0, 0, 0
1118, 1, 1636420608200, 1636420608822, 622, 270, 352, 0, 0, 0
1119, 1, 1636420608476, 1636420609098, 622, 266, 356, 1, 0, 1
1120, 1, 1636420608495, 1636420609114, 619, 266, 353, 0, 0, 0
1121, 1, 1636420608515, 1636420609142, 627, 267, 360, 1, 1, 2
1122, 1, 1636420608747, 1636420609378, 631, 275, 356, 0, 2, 2
1123, 1, 1636420608847, 1636420609470, 623, 266, 357, 1, 0, 1
1124, 1, 1636420609035, 1636420609654, 619, 268, 351, 0, 1, 1
1125, 1, 1636420609056, 1636420609674, 618, 261, 357, 0, 0, 0
1126, 1, 1636420609120, 1636420609742, 622, 267, 355, 0, 2, 2
1128, 1, 1636420609464, 1636420610090, 626, 269, 357, 1, 0, 1
1129, 1, 1636420609465, 1636420610094, 629, 269, 360, 1, 0, 1
1130, 1, 1636420609507, 1636420610126, 619, 266, 353, 1, 0, 1
1131, 1, 1636420609715, 1636420610366, 651, 294, 357, 2, 1, 3
1132, 1, 1636420609836, 1636420610450, 614, 262, 352, 0, 0, 0
1133, 1, 1636420610023, 1636420610646, 623, 271, 352, 0, 1, 1
1134, 1, 1636420610059, 1636420610686, 627, 265, 362, 0, 0, 0
1135, 1, 1636420610129, 1636420610754, 625, 271, 354, 1, 2, 3
1136, 1, 1636420610433, 1636420611058, 625, 270, 355, 2, 0, 2
1138, 1, 1636420610525, 1636420611154, 629, 271, 358, 0, 0, 0
1140, 1, 1636420610836, 1636420611450, 614, 262, 352, 1, 0, 1
1141, 1, 1636420611044, 1636420611662, 618, 266, 352, 1, 0, 1
1142, 1, 1636420611056, 1636420611722, 666, 313, 353, 0, 0, 0
1143, 1, 1636420611123, 1636420611746, 623, 270, 353, 1, 2, 3
1144, 1, 1636420611400, 1636420612018, 618, 266, 352, 0, 1, 1
1145, 1, 1636420611549, 1636420612166, 617, 267, 350, 1, 0, 1
1146, 1, 1636420611828, 1636420612446, 618, 266, 352, 0, 0, 0
1147, 1, 1636420612047, 1636420612666, 619, 265, 354, 1, 0, 1
1148, 1, 1636420612077, 1636420612694, 617, 263, 354, 0, 1, 1
1149, 1, 1636420612149, 1636420612766, 617, 262, 355, 0, 0, 0
1150, 1, 1636420612368, 1636420612986, 618, 266, 352, 1, 0, 1
1151, 1, 1636420612530, 1636420613154, 624, 270, 354, 0, 1, 1
1152, 1, 1636420612821, 1636420613446, 625, 270, 355, 2, 0, 2
1153, 1, 1636420613042, 1636420613666, 624, 270, 354, 2, 0, 2
1154, 1, 1636420613051, 1636420613666, 615, 262, 353, 2, 0, 2
1155, 1, 1636420613153, 1636420613778, 625, 265, 360, 0, 0, 0
1156, 1, 1636420613390, 1636420614010, 620, 262, 358, 1, 0, 1
1157, 1, 1636420613537, 1636420614158, 621, 267, 354, 0, 0, 0
1158, 1, 1636420613812, 1636420614434, 622, 269, 353, 0, 0, 0
1159, 1, 1636420614013, 1636420614634, 621, 267, 354, 0, 1, 1
1160, 1, 1636420614080, 1636420614698, 618, 268, 350, 0, 0, 0
1161, 1, 1636420614148, 1636420614766, 618, 265, 353, 0, 0, 0
1162, 1, 1636420614408, 1636420615034, 626, 269, 357, 2, 0, 2
1163, 1, 1636420614509, 1636420615126, 617, 266, 351, 0, 0, 0
1087, 2, 1636420605247, 1636420615380, 10133, 0, 10133, 0, 0, 0
1083, 2, 1636420605246, 1636420615424, 10178, 1, 10177, 0, 1, 1
1164, 1, 1636420614823, 1636420615442, 619, 266, 353, 1, 0, 1
1084, 2, 1636420605246, 1636420615468, 10222, 0, 10222, 1, 0, 1
1085, 2, 1636420605247, 1636420615512, 10265, 1, 10264, 0, 1, 1
1082, 2, 1636420605246, 1636420615560, 10314, 0, 10314, 0, 0, 0
1081, 2, 1636420605245, 1636420615604, 10359, 0, 10359, 0, 0, 0
1080, 2, 1636420605245, 1636420615648, 10403, 0, 10403, 1, 0, 1
1086, 2, 1636420605247, 1636420615691, 10444, 1, 10443, 1, 0, 1
1088, 2, 1636420605248, 1636420615736, 10488, 0, 10488, 0, 0, 0
1090, 2, 1636420605375, 1636420615784, 10409, 0, 10409, 0, 0, 0
1165, 1, 1636420615033, 1636420616062, 1029, 660, 369, 0, 392, 392
1166, 1, 1636420615082, 1636420616142, 1060, 615, 445, 49, 303, 352
1167, 1, 1636420615180, 1636420616182, 1002, 562, 440, 1, 290, 291
1094, 1, 1636420605738, 1636420616270, 10532, 10134, 398, 1, 0, 1
1168, 1, 1636420615604, 1636420616334, 730, 321, 409, 1, 49, 50
1169, 1, 1636420615785, 1636420616362, 577, 264, 313, 2, 1, 3
1170, 1, 1636420615823, 1636420616486, 663, 270, 393, 1, 0, 1
1181, 1, 1636420616064, 1636420616734, 670, 270, 400, 0, 1, 1
1182, 1, 1636420616165, 1636420616830, 665, 267, 398, 1, 1, 2
1183, 1, 1636420616184, 1636420616850, 666, 269, 397, 1, 0, 1
1185, 1, 1636420616373, 1636420617102, 729, 333, 396, 0, 1, 1
1186, 1, 1636420616500, 1636420617374, 874, 515, 359, 1, 1, 2
1187, 1, 1636420616806, 1636420617430, 624, 266, 358, 0, 1, 1
1188, 1, 1636420617050, 1636420617678, 628, 269, 359, 0, 0, 0
1189, 1, 1636420617192, 1636420617810, 618, 267, 351, 1, 0, 1
1190, 1, 1636420617212, 1636420617838, 626, 270, 356, 0, 1, 1
1191, 1, 1636420617400, 1636420618082, 682, 329, 353, 2, 0, 2
1192, 1, 1636420617495, 1636420618110, 615, 262, 353, 1, 0, 1
1193, 1, 1636420617785, 1636420618406, 621, 267, 354, 1, 1, 2
1194, 1, 1636420618053, 1636420618670, 617, 262, 355, 1, 0, 1
1195, 1, 1636420618225, 1636420618850, 625, 266, 359, 1, 0, 1
1196, 1, 1636420618246, 1636420618874, 628, 268, 360, 2, 1, 3
1198, 1, 1636420618467, 1636420619090, 623, 268, 355, 0, 0, 0
1197, 1, 1636420618419, 1636420619118, 699, 342, 357, 0, 0, 0
1127, 2, 1636420609170, 1636420619308, 10138, 0, 10138, 1, 0, 1
1199, 1, 1636420618802, 1636420619426, 624, 270, 354, 2, 0, 2
1200, 1, 1636420619056, 1636420619678, 622, 269, 353, 1, 0, 1
1201, 1, 1636420619210, 1636420619850, 640, 275, 365, 1, 1, 2
1202, 1, 1636420619309, 1636420619890, 581, 269, 312, 0, 1, 1
1205, 1, 1636420619449, 1636420620078, 629, 267, 362, 1, 1, 2
1204, 1, 1636420619438, 1636420620114, 676, 274, 402, 2, 0, 2
1203, 1, 1636420619413, 1636420620114, 701, 347, 354, 2, 0, 2
1206, 1, 1636420619834, 1636420620450, 616, 262, 354, 2, 0, 2
1137, 2, 1636420610451, 1636420620588, 10137, 0, 10137, 0, 0, 0
1207, 1, 1636420620041, 1636420620666, 625, 270, 355, 2, 1, 3
1139, 2, 1636420610711, 1636420620844, 10133, 1, 10132, 0, 1, 1
1208, 1, 1636420620181, 1636420620862, 681, 271, 410, 1, 1, 2
1209, 1, 1636420620263, 1636420620882, 619, 262, 357, 2, 0, 2
1210, 1, 1636420620400, 1636420621038, 638, 285, 353, 1, 15, 16
1212, 1, 1636420620421, 1636420621046, 625, 266, 359, 1, 0, 1
1211, 1, 1636420620410, 1636420621138, 728, 352, 376, 1, 0, 1
1213, 1, 1636420620722, 1636420621426, 704, 269, 435, 0, 1, 1
1214, 1, 1636420620852, 1636420621470, 618, 263, 355, 0, 1, 1
1216, 1, 1636420621037, 1636420621654, 617, 263, 354, 0, 0, 0
1217, 1, 1636420621152, 1636420621770, 618, 262, 356, 1, 0, 1
1218, 1, 1636420621294, 1636420621914, 620, 265, 355, 0, 0, 0
1219, 1, 1636420621384, 1636420622006, 622, 271, 351, 0, 0, 0
1220, 1, 1636420621392, 1636420622042, 650, 297, 353, 1, 0, 1
1221, 1, 1636420621431, 1636420622054, 623, 266, 357, 1, 1, 2
1222, 1, 1636420621698, 1636420622318, 620, 266, 354, 2, 0, 2
1223, 1, 1636420621820, 1636420622442, 622, 270, 352, 1, 0, 1
1224, 1, 1636420622056, 1636420622678, 622, 265, 357, 0, 0, 0
1225, 1, 1636420622156, 1636420622774, 618, 262, 356, 0, 0, 0
1226, 1, 1636420622308, 1636420622926, 618, 266, 352, 1, 1, 2
1227, 1, 1636420622350, 1636420622970, 620, 266, 354, 1, 0, 1
1228, 1, 1636420622425, 1636420623054, 629, 269, 360, 0, 0, 0
1229, 1, 1636420622467, 1636420623094, 627, 269, 358, 1, 1, 2
1230, 1, 1636420622713, 1636420623342, 629, 269, 360, 0, 1, 1
1231, 1, 1636420622847, 1636420623466, 619, 267, 352, 2, 0, 2
1232, 1, 1636420623058, 1636420623682, 624, 269, 355, 1, 0, 1
1233, 1, 1636420623124, 1636420623742, 618, 262, 356, 0, 0, 0
1234, 1, 1636420623334, 1636420623954, 620, 266, 354, 0, 1, 1
1235, 1, 1636420623383, 1636420624010, 627, 262, 365, 0, 0, 0
1236, 1, 1636420623395, 1636420624014, 619, 267, 352, 2, 0, 2
1237, 1, 1636420623466, 1636420624094, 628, 266, 362, 0, 1, 1
1238, 1, 1636420623721, 1636420624346, 625, 272, 353, 2, 2, 4
1239, 1, 1636420623856, 1636420624482, 626, 274, 352, 1, 0, 1
1240, 1, 1636420624040, 1636420624662, 622, 265, 357, 1, 0, 1
1241, 1, 1636420624134, 1636420624750, 616, 262, 354, 1, 0, 1
1242, 1, 1636420624356, 1636420624974, 618, 263, 355, 0, 0, 0
1243, 1, 1636420624370, 1636420624994, 624, 270, 354, 1, 0, 1
1244, 1, 1636420624406, 1636420625034, 628, 269, 359, 2, 0, 2
1245, 1, 1636420624434, 1636420625050, 616, 263, 353, 0, 1, 1
1246, 1, 1636420624720, 1636420625342, 622, 270, 352, 0, 0, 0
1247, 1, 1636420624864, 1636420625486, 622, 269, 353, 0, 0, 0
1248, 1, 1636420625029, 1636420625654, 625, 270, 355, 0, 1, 1
1249, 1, 1636420625108, 1636420625730, 622, 270, 352, 0, 0, 0
1250, 1, 1636420625349, 1636420625974, 625, 270, 355, 1, 0, 1
1252, 1, 1636420625396, 1636420626014, 618, 266, 352, 1, 0, 1
1171, 2, 1636420615874, 1636420626049, 10175, 0, 10175, 0, 0, 0
1253, 1, 1636420625425, 1636420626050, 625, 267, 358, 1, 0, 1
1180, 2, 1636420615882, 1636420626096, 10214, 2, 10212, 1, 1, 2
1174, 2, 1636420615875, 1636420626140, 10265, 2, 10263, 2, 1, 3
1178, 2, 1636420615878, 1636420626188, 10310, 1, 10309, 0, 0, 0
1175, 2, 1636420615875, 1636420626236, 10361, 3, 10358, 4, 0, 4
1172, 2, 1636420615874, 1636420626284, 10410, 3, 10407, 4, 1, 5
1173, 2, 1636420615874, 1636420626332, 10458, 2, 10456, 5, 0, 5
1179, 2, 1636420615882, 1636420626376, 10494, 0, 10494, 2, 0, 2
1176, 2, 1636420615875, 1636420626424, 10549, 1, 10548, 1, 0, 1
1177, 2, 1636420615875, 1636420626472, 10597, 1, 10596, 2, 0, 2
1184, 2, 1636420616272, 1636420626520, 10248, 1, 10247, 0, 0, 0
1254, 1, 1636420625688, 1636420626786, 1098, 272, 826, 1, 7, 8
1255, 1, 1636420625859, 1636420626974, 1115, 288, 827, 1, 17, 18
1256, 1, 1636420626002, 1636420627062, 1060, 270, 790, 2, 1, 3
1259, 1, 1636420626522, 1636420627102, 580, 266, 314, 1, 1, 2
1258, 1, 1636420626521, 1636420627102, 581, 267, 314, 2, 1, 3
1257, 1, 1636420626473, 1636420627134, 661, 265, 396, 0, 0, 0
1272, 1, 1636420626788, 1636420627450, 662, 265, 397, 0, 0, 0
1273, 1, 1636420626975, 1636420627630, 655, 263, 392, 2, 1, 3
1274, 1, 1636420627064, 1636420627726, 662, 267, 395, 0, 0, 0
1275, 1, 1636420627104, 1636420627766, 662, 262, 400, 0, 0, 0
1277, 1, 1636420627449, 1636420628074, 625, 268, 357, 1, 0, 1
1279, 1, 1636420627978, 1636420628594, 616, 264, 352, 1, 1, 2
1280, 1, 1636420628064, 1636420628678, 614, 262, 352, 0, 0, 0
1281, 1, 1636420628119, 1636420628734, 615, 262, 353, 0, 0, 0
1282, 1, 1636420628478, 1636420629102, 624, 269, 355, 2, 0, 2
1283, 1, 1636420628997, 1636420629618, 621, 267, 354, 0, 1, 1
1284, 1, 1636420629039, 1636420629658, 619, 266, 353, 0, 0, 0
1285, 1, 1636420629123, 1636420629738, 615, 262, 353, 0, 0, 0
1286, 1, 1636420629483, 1636420630102, 619, 266, 353, 0, 0, 0
1287, 1, 1636420630021, 1636420630642, 621, 265, 356, 0, 0, 0
1288, 1, 1636420630031, 1636420630650, 619, 266, 353, 0, 0, 0
1289, 1, 1636420630143, 1636420630762, 619, 262, 357, 0, 0, 0
1290, 1, 1636420630503, 1636420631130, 627, 270, 357, 1, 0, 1
1215, 2, 1636420620974, 1636420631339, 10365, 144, 10221, 0, 0, 0
1291, 1, 1636420631002, 1636420631694, 692, 339, 353, 0, 74, 74
1292, 1, 1636420631067, 1636420631694, 627, 274, 353, 0, 5, 5
1278, 1, 1636420627777, 1636420631782, 4005, 3650, 355, 1, 2, 3
1293, 1, 1636420631169, 1636420631866, 697, 261, 436, 0, 0, 0
1294, 1, 1636420631426, 1636420632086, 660, 261, 399, 1, 0, 1
1295, 1, 1636420631530, 1636420632146, 616, 262, 354, 1, 0, 1
1296, 1, 1636420631783, 1636420632446, 663, 265, 398, 1, 0, 1
1298, 1, 1636420632076, 1636420632702, 626, 270, 356, 0, 1, 1
1297, 1, 1636420632020, 1636420632710, 690, 334, 356, 0, 1, 1
1299, 1, 1636420632175, 1636420632790, 615, 261, 354, 0, 0, 0
1300, 1, 1636420632363, 1636420632978, 615, 262, 353, 0, 0, 0
1301, 1, 1636420632562, 1636420633186, 624, 267, 357, 0, 1, 1
1302, 1, 1636420632751, 1636420633374, 623, 270, 353, 0, 1, 1
1303, 1, 1636420633038, 1636420633658, 620, 262, 358, 0, 0, 0
1304, 1, 1636420633094, 1636420633718, 624, 269, 355, 0, 0, 0
1305, 1, 1636420633163, 1636420633782, 619, 267, 352, 0, 0, 0
1306, 1, 1636420633399, 1636420634018, 619, 266, 353, 0, 0, 0
1307, 1, 1636420633541, 1636420634166, 625, 266, 359, 0, 0, 0
1308, 1, 1636420633762, 1636420634378, 616, 262, 354, 0, 0, 0
1310, 1, 1636420634063, 1636420634682, 619, 267, 352, 1, 0, 1
1309, 1, 1636420634060, 1636420634690, 630, 277, 353, 0, 0, 0
1311, 1, 1636420634143, 1636420634762, 619, 265, 354, 0, 0, 0
1312, 1, 1636420634399, 1636420635014, 615, 263, 352, 2, 0, 2
1313, 1, 1636420634521, 1636420635146, 625, 269, 356, 0, 0, 0
1314, 1, 1636420634737, 1636420635358, 621, 270, 351, 1, 1, 2
1251, 2, 1636420625365, 1636420635500, 10135, 0, 10135, 1, 0, 1
1315, 1, 1636420635032, 1636420635646, 614, 263, 351, 1, 1, 2
1316, 1, 1636420635042, 1636420635670, 628, 265, 363, 0, 0, 0
1317, 1, 1636420635122, 1636420635770, 648, 291, 357, 2, 28, 30
1318, 1, 1636420635392, 1636420636034, 642, 263, 379, 1, 1, 2
1319, 1, 1636420635501, 1636420636118, 617, 262, 355, 0, 0, 0
1320, 1, 1636420635753, 1636420636374, 621, 266, 355, 1, 0, 1
1321, 1, 1636420636045, 1636420636670, 625, 270, 355, 1, 1, 2
1322, 1, 1636420636053, 1636420636686, 633, 269, 364, 0, 0, 0
1260, 2, 1636420626525, 1636420636708, 10183, 2, 10181, 2, 1, 3
1323, 1, 1636420636140, 1636420636758, 618, 266, 352, 0, 1, 1
1261, 2, 1636420626610, 1636420636788, 10178, 1, 10177, 1, 1, 2
1271, 2, 1636420626620, 1636420636836, 10216, 1, 10215, 0, 1, 1
1269, 2, 1636420626619, 1636420636880, 10261, 1, 10260, 0, 1, 1
1266, 2, 1636420626614, 1636420636928, 10314, 1, 10313, 2, 0, 2
1268, 2, 1636420626619, 1636420636972, 10353, 2, 10351, 1, 1, 2
1324, 1, 1636420636382, 1636420636998, 616, 262, 354, 0, 0, 0
1270, 2, 1636420626619, 1636420637020, 10401, 1, 10400, 0, 1, 1
1267, 2, 1636420626618, 1636420637068, 10450, 1, 10449, 2, 1, 3
1265, 2, 1636420626614, 1636420637112, 10498, 1, 10497, 3, 0, 3
1264, 2, 1636420626611, 1636420637160, 10549, 2, 10547, 2, 0, 2
1262, 2, 1636420626610, 1636420637204, 10594, 1, 10593, 0, 0, 0
1263, 2, 1636420626611, 1636420637248, 10637, 2, 10635, 2, 1, 3
1325, 1, 1636420636531, 1636420637610, 1079, 723, 356, 0, 453, 453
1276, 1, 1636420627305, 1636420637702, 10397, 9672, 725, 2, 135, 137
1326, 1, 1636420636789, 1636420637790, 1001, 272, 729, 1, 6, 7
1328, 1, 1636420637250, 1636420637826, 576, 267, 309, 0, 2, 2
1329, 1, 1636420637250, 1636420637826, 576, 264, 312, 1, 2, 3
1327, 1, 1636420637249, 1636420637826, 577, 264, 313, 2, 1, 3
1342, 1, 1636420637612, 1636420638278, 666, 269, 397, 0, 1, 1
1343, 1, 1636420637614, 1636420638286, 672, 273, 399, 0, 0, 0
1345, 1, 1636420637792, 1636420638450, 658, 262, 396, 1, 0, 1
1344, 1, 1636420637703, 1636420638550, 847, 447, 400, 2, 0, 2
1346, 1, 1636420638045, 1636420638678, 633, 274, 359, 0, 1, 1
1347, 1, 1636420638070, 1636420638694, 624, 262, 362, 0, 0, 0
1348, 1, 1636420638134, 1636420638754, 620, 263, 357, 0, 0, 0
1349, 1, 1636420638567, 1636420639186, 619, 266, 353, 0, 0, 0
1350, 1, 1636420638623, 1636420639254, 631, 270, 361, 1, 1, 2
1352, 1, 1636420638785, 1636420639410, 625, 270, 355, 1, 0, 1
1351, 1, 1636420638690, 1636420639454, 764, 410, 354, 2, 0, 2
1353, 1, 1636420639061, 1636420639690, 629, 270, 359, 1, 0, 1
1354, 1, 1636420639105, 1636420639726, 621, 261, 360, 0, 0, 0
1355, 1, 1636420639147, 1636420639762, 615, 262, 353, 0, 0, 0
1356, 1, 1636420639577, 1636420640202, 625, 271, 354, 0, 2, 2
1357, 1, 1636420639616, 1636420640238, 622, 264, 358, 1, 0, 1
1359, 1, 1636420639759, 1636420640382, 623, 271, 352, 1, 2, 3
1358, 1, 1636420639712, 1636420640466, 754, 403, 351, 0, 0, 0
1360, 1, 1636420640089, 1636420640714, 625, 269, 356, 0, 0, 0
1362, 1, 1636420640131, 1636420640762, 631, 275, 356, 0, 0, 0
1363, 1, 1636420640553, 1636420641182, 629, 272, 357, 1, 0, 1
1364, 1, 1636420640643, 1636420641270, 627, 275, 352, 0, 1, 1
1366, 1, 1636420640762, 1636420641386, 624, 270, 354, 0, 1, 1
1365, 1, 1636420640697, 1636420641446, 749, 396, 353, 2, 1, 3
1367, 1, 1636420641085, 1636420641706, 621, 262, 359, 2, 0, 2
1368, 1, 1636420641141, 1636420641754, 613, 263, 350, 2, 0, 2
1369, 1, 1636420641558, 1636420642182, 624, 270, 354, 1, 1, 2
1370, 1, 1636420641645, 1636420642270, 625, 266, 359, 2, 0, 2
1371, 1, 1636420641694, 1636420642358, 664, 270, 394, 0, 0, 0
1373, 1, 1636420641773, 1636420642394, 621, 266, 355, 0, 1, 1
1374, 1, 1636420642066, 1636420642686, 620, 266, 354, 0, 1, 1
1375, 1, 1636420642153, 1636420642774, 621, 262, 359, 0, 0, 0
1376, 1, 1636420642559, 1636420643178, 619, 265, 354, 0, 0, 0
1377, 1, 1636420642630, 1636420643254, 624, 269, 355, 0, 0, 0
1378, 1, 1636420642639, 1636420643262, 623, 270, 353, 1, 0, 1
1379, 1, 1636420642775, 1636420643394, 619, 265, 354, 0, 0, 0
1381, 1, 1636420643150, 1636420643770, 620, 266, 354, 0, 0, 0
1383, 1, 1636420643648, 1636420644274, 626, 265, 361, 0, 0, 0
1384, 1, 1636420643664, 1636420644294, 630, 267, 363, 2, 0, 2
1385, 1, 1636420643746, 1636420644362, 616, 262, 354, 0, 0, 0
1386, 1, 1636420644159, 1636420644778, 619, 265, 354, 1, 0, 1
1387, 1, 1636420644630, 1636420645262, 632, 270, 362, 1, 1, 2
1388, 1, 1636420644677, 1636420645294, 617, 263, 354, 0, 1, 1
1389, 1, 1636420644760, 1636420645386, 626, 268, 358, 0, 0, 0
1390, 1, 1636420645130, 1636420645754, 624, 262, 362, 0, 0, 0
1391, 1, 1636420645602, 1636420646230, 628, 269, 359, 0, 0, 0
1392, 1, 1636420645663, 1636420646286, 623, 271, 352, 0, 0, 0
1393, 1, 1636420645744, 1636420646362, 618, 266, 352, 0, 0, 0
1394, 1, 1636420646118, 1636420646746, 628, 270, 358, 2, 0, 2
1395, 1, 1636420646570, 1636420647194, 624, 269, 355, 1, 0, 1
1396, 1, 1636420646681, 1636420647302, 621, 266, 355, 0, 2, 2
1397, 1, 1636420646769, 1636420647394, 625, 270, 355, 2, 1, 3
1331, 2, 1636420637338, 1636420647512, 10174, 1, 10173, 2, 0, 2
1339, 2, 1636420637344, 1636420647555, 10211, 4, 10207, 3, 0, 3
1340, 2, 1636420637346, 1636420647600, 10254, 2, 10252, 3, 0, 3
1335, 2, 1636420637342, 1636420647645, 10303, 2, 10301, 3, 0, 3
1336, 2, 1636420637343, 1636420647692, 10349, 2, 10347, 9, 0, 9
1338, 2, 1636420637343, 1636420647740, 10397, 1, 10396, 0, 1, 1
1337, 2, 1636420637343, 1636420647788, 10445, 1, 10444, 2, 0, 2
1334, 2, 1636420637339, 1636420647836, 10497, 1, 10496, 1, 2, 3
1332, 2, 1636420637339, 1636420647880, 10541, 2, 10539, 3, 0, 3
1333, 2, 1636420637339, 1636420647928, 10589, 2, 10587, 4, 0, 4
1341, 2, 1636420637382, 1636420647976, 10594, 0, 10594, 1, 0, 1
1330, 2, 1636420637338, 1636420648024, 10686, 0, 10686, 1, 0, 1
1398, 1, 1636420647115, 1636420648290, 1175, 772, 403, 0, 507, 507
1380, 1, 1636420643067, 1636420648506, 5439, 5086, 353, 0, 0, 0
1400, 1, 1636420648026, 1636420648602, 576, 267, 309, 1, 1, 2
1399, 1, 1636420648025, 1636420648602, 577, 262, 315, 1, 0, 1
1405, 1, 1636420648116, 1636420648794, 678, 279, 399, 2, 1, 3
1414, 1, 1636420648292, 1636420648954, 662, 263, 399, 1, 0, 1
1415, 1, 1636420648508, 1636420649174, 666, 271, 395, 1, 0, 1
1416, 1, 1636420648670, 1636420649294, 624, 266, 358, 0, 0, 0
1417, 1, 1636420648756, 1636420649378, 622, 269, 353, 0, 0, 0
1418, 1, 1636420649055, 1636420649678, 623, 269, 354, 0, 0, 0
1419, 1, 1636420649275, 1636420649898, 623, 266, 357, 0, 0, 0
1420, 1, 1636420649518, 1636420650142, 624, 267, 357, 1, 1, 2
1361, 2, 1636420640103, 1636420650236, 10133, 1, 10132, 0, 1, 1
1421, 1, 1636420649636, 1636420650254, 618, 266, 352, 0, 0, 0
1422, 1, 1636420649782, 1636420650406, 624, 269, 355, 0, 0, 0
1423, 1, 1636420650065, 1636420650686, 621, 262, 359, 0, 0, 0
1424, 1, 1636420650281, 1636420650902, 621, 262, 359, 1, 0, 1
1425, 1, 1636420650366, 1636420651022, 656, 263, 393, 1, 1, 2
1426, 1, 1636420650532, 1636420651158, 626, 269, 357, 0, 1, 1
1427, 1, 1636420650655, 1636420651282, 627, 274, 353, 2, 0, 2
1428, 1, 1636420650771, 1636420651386, 615, 262, 353, 0, 0, 0
1429, 1, 1636420651041, 1636420651666, 625, 268, 357, 0, 0, 0
1430, 1, 1636420651274, 1636420651890, 616, 262, 354, 1, 0, 1
1431, 1, 1636420651323, 1636420651942, 619, 266, 353, 0, 0, 0
1372, 2, 1636420641713, 1636420652099, 10386, 204, 10182, 1, 0, 1
1432, 1, 1636420651529, 1636420652154, 625, 269, 356, 1, 0, 1
1433, 1, 1636420651648, 1636420652262, 614, 263, 351, 1, 0, 1
1434, 1, 1636420651753, 1636420652458, 705, 346, 359, 1, 77, 78
1382, 1, 1636420643534, 1636420652542, 9008, 8655, 353, 0, 6, 6
1435, 1, 1636420652099, 1636420652814, 715, 402, 313, 0, 0, 0
1436, 1, 1636420652186, 1636420652846, 660, 268, 392, 0, 1, 1
1438, 1, 1636420652357, 1636420652978, 621, 262, 359, 1, 0, 1
1439, 1, 1636420652537, 1636420653158, 621, 263, 358, 1, 0, 1
1440, 1, 1636420652544, 1636420653206, 662, 266, 396, 1, 0, 1
1442, 1, 1636420652737, 1636420653362, 625, 269, 356, 0, 0, 0
1443, 1, 1636420653077, 1636420653702, 625, 270, 355, 1, 0, 1
1444, 1, 1636420653141, 1636420653758, 617, 262, 355, 1, 0, 1
1445, 1, 1636420653329, 1636420653954, 625, 266, 359, 0, 1, 1
1446, 1, 1636420653507, 1636420654122, 615, 261, 354, 0, 1, 1
1447, 1, 1636420653514, 1636420654134, 620, 266, 354, 0, 1, 1
1448, 1, 1636420653731, 1636420654358, 627, 270, 357, 0, 0, 0
1449, 1, 1636420654053, 1636420654674, 621, 262, 359, 1, 0, 1
1450, 1, 1636420654140, 1636420654754, 614, 262, 352, 2, 0, 2
1451, 1, 1636420654301, 1636420654922, 621, 262, 359, 0, 0, 0
1452, 1, 1636420654499, 1636420655114, 615, 263, 352, 2, 1, 3
1453, 1, 1636420654517, 1636420655150, 633, 269, 364, 0, 0, 0
1454, 1, 1636420654709, 1636420655334, 625, 266, 359, 0, 1, 1
1455, 1, 1636420655059, 1636420655682, 623, 266, 357, 0, 0, 0
1456, 1, 1636420655106, 1636420655722, 616, 263, 353, 0, 0, 0
1457, 1, 1636420655268, 1636420655882, 614, 263, 351, 1, 0, 1
1458, 1, 1636420655472, 1636420656090, 618, 266, 352, 2, 0, 2
1459, 1, 1636420655535, 1636420656158, 623, 270, 353, 0, 1, 1
1460, 1, 1636420655744, 1636420656362, 618, 263, 355, 1, 0, 1
1461, 1, 1636420656095, 1636420656714, 619, 265, 354, 0, 0, 0
1462, 1, 1636420656126, 1636420656746, 620, 266, 354, 1, 0, 1
1464, 1, 1636420656472, 1636420657098, 626, 271, 355, 1, 0, 1
1465, 1, 1636420656537, 1636420657154, 617, 262, 355, 1, 0, 1
1466, 1, 1636420656713, 1636420657338, 625, 267, 358, 0, 1, 1
1467, 1, 1636420657065, 1636420657686, 621, 265, 356, 0, 0, 0
1468, 1, 1636420657137, 1636420657762, 625, 269, 356, 1, 0, 1
1469, 1, 1636420657450, 1636420658074, 624, 269, 355, 0, 0, 0
1401, 2, 1636420648026, 1636420658124, 10098, 1, 10097, 0, 1, 1
1470, 1, 1636420657517, 1636420658134, 617, 262, 355, 0, 0, 0
1404, 2, 1636420648115, 1636420658291, 10176, 2, 10174, 3, 0, 3
1407, 2, 1636420648122, 1636420658335, 10213, 2, 10211, 1, 1, 2
1411, 2, 1636420648124, 1636420658379, 10255, 2, 10253, 2, 0, 2
1408, 2, 1636420648123, 1636420658424, 10301, 1, 10300, 1, 1, 2
1413, 2, 1636420648124, 1636420658468, 10344, 0, 10344, 1, 0, 1
1409, 2, 1636420648123, 1636420658516, 10393, 1, 10392, 1, 1, 2
1410, 2, 1636420648123, 1636420658564, 10441, 1, 10440, 1, 0, 1
1412, 2, 1636420648124, 1636420658608, 10484, 1, 10483, 2, 0, 2
1406, 2, 1636420648122, 1636420658656, 10534, 0, 10534, 0, 0, 0
1402, 2, 1636420648114, 1636420658704, 10590, 1, 10589, 0, 1, 1
1403, 2, 1636420648115, 1636420658752, 10637, 1, 10636, 1, 0, 1
1471, 1, 1636420658048, 1636420659202, 1154, 299, 855, 1, 31, 32
1472, 1, 1636420658139, 1636420659202, 1063, 710, 353, 1, 443, 444
1473, 1, 1636420658380, 1636420659302, 922, 268, 654, 1, 2, 3
1475, 1, 1636420658753, 1636420659326, 573, 262, 311, 0, 0, 0
1477, 1, 1636420658842, 1636420659510, 668, 266, 402, 0, 1, 1
1474, 1, 1636420658753, 1636420659566, 813, 501, 312, 2, 0, 2
1487, 1, 1636420659204, 1636420659866, 662, 267, 395, 2, 0, 2
1488, 1, 1636420659204, 1636420659866, 662, 266, 396, 1, 0, 1
1490, 1, 1636420659430, 1636420660054, 624, 267, 357, 0, 0, 0
1489, 1, 1636420659304, 1636420660134, 830, 438, 392, 1, 1, 2
1491, 1, 1636420659567, 1636420660234, 667, 268, 399, 0, 1, 1
1492, 1, 1636420659797, 1636420660410, 613, 262, 351, 2, 0, 2
1494, 1, 1636420660186, 1636420660806, 620, 266, 354, 0, 1, 1
1495, 1, 1636420660311, 1636420660938, 627, 269, 358, 0, 1, 1
1496, 1, 1636420660394, 1636420661014, 620, 267, 353, 0, 1, 1
1497, 1, 1636420660570, 1636420661190, 620, 265, 355, 2, 0, 2
1498, 1, 1636420660800, 1636420661422, 622, 270, 352, 0, 0, 0
1499, 1, 1636420661201, 1636420661822, 621, 265, 356, 0, 0, 0
1500, 1, 1636420661277, 1636420661898, 621, 266, 355, 0, 0, 0
1501, 1, 1636420661359, 1636420661978, 619, 266, 353, 1, 0, 1
1502, 1, 1636420661550, 1636420662166, 616, 262, 354, 0, 0, 0
1437, 2, 1636420652258, 1636420662392, 10134, 1, 10133, 0, 0, 0
1503, 1, 1636420661804, 1636420662422, 618, 265, 353, 0, 0, 0
1441, 2, 1636420652632, 1636420662768, 10136, 0, 10136, 0, 1, 1
1504, 1, 1636420662185, 1636420662834, 649, 298, 351, 0, 34, 34
1505, 1, 1636420662244, 1636420662874, 630, 271, 359, 2, 0, 2
1506, 1, 1636420662392, 1636420663034, 642, 288, 354, 0, 26, 26
1508, 1, 1636420662529, 1636420663158, 629, 274, 355, 0, 0, 0
1509, 1, 1636420662812, 1636420663434, 622, 269, 353, 0, 1, 1
1511, 1, 1636420663194, 1636420663814, 620, 263, 357, 1, 0, 1
1512, 1, 1636420663252, 1636420663870, 618, 267, 351, 2, 1, 3
1513, 1, 1636420663373, 1636420663994, 621, 266, 355, 0, 0, 0
1514, 1, 1636420663530, 1636420664150, 620, 266, 354, 1, 0, 1
1515, 1, 1636420663815, 1636420664438, 623, 271, 352, 1, 0, 1
1516, 1, 1636420664177, 1636420664798, 621, 263, 358, 1, 0, 1
1517, 1, 1636420664247, 1636420664874, 627, 269, 358, 1, 1, 2
1518, 1, 1636420664344, 1636420664962, 618, 267, 351, 1, 2, 3
1519, 1, 1636420664544, 1636420665166, 622, 268, 354, 0, 0, 0
1520, 1, 1636420664811, 1636420665430, 619, 267, 352, 1, 1, 2
1521, 1, 1636420665209, 1636420665826, 617, 263, 354, 0, 0, 0
1522, 1, 1636420665232, 1636420665846, 614, 263, 351, 0, 0, 0
1523, 1, 1636420665323, 1636420665942, 619, 265, 354, 0, 0, 0
1524, 1, 1636420665572, 1636420666194, 622, 268, 354, 0, 0, 0
1463, 2, 1636420656257, 1636420666392, 10135, 1, 10134, 0, 1, 1
1525, 1, 1636420665791, 1636420666414, 623, 265, 358, 0, 0, 0
1526, 1, 1636420666199, 1636420666838, 639, 287, 352, 1, 18, 19
1527, 1, 1636420666234, 1636420666862, 628, 271, 357, 2, 0, 2
1530, 1, 1636420666542, 1636420667162, 620, 265, 355, 0, 0, 0
1529, 1, 1636420666522, 1636420667190, 668, 266, 402, 0, 1, 1
1531, 1, 1636420666828, 1636420667446, 618, 266, 352, 0, 0, 0
1532, 1, 1636420667223, 1636420667842, 619, 265, 354, 0, 0, 0
1533, 1, 1636420667227, 1636420667846, 619, 263, 356, 1, 0, 1
1534, 1, 1636420667477, 1636420668098, 621, 266, 355, 1, 0, 1
1535, 1, 1636420667526, 1636420668146, 620, 266, 354, 0, 1, 1
1536, 1, 1636420667794, 1636420668414, 620, 262, 358, 1, 0, 1
1537, 1, 1636420668209, 1636420668830, 621, 265, 356, 1, 0, 1
1538, 1, 1636420668234, 1636420668858, 624, 270, 354, 2, 0, 2
1476, 2, 1636420658842, 1636420669028, 10186, 3, 10183, 2, 2, 4
1486, 2, 1636420658847, 1636420669076, 10229, 3, 10226, 3, 0, 3
1539, 1, 1636420668487, 1636420669110, 623, 270, 353, 0, 1, 1
1479, 2, 1636420658843, 1636420669120, 10277, 2, 10275, 1, 1, 2
1540, 1, 1636420668519, 1636420669142, 623, 266, 357, 0, 0, 0
1480, 2, 1636420658843, 1636420669164, 10321, 4, 10317, 3, 1, 4
1485, 2, 1636420658847, 1636420669208, 10361, 2, 10359, 1, 1, 2
1478, 2, 1636420658843, 1636420669252, 10409, 0, 10409, 0, 0, 0
1482, 2, 1636420658844, 1636420669299, 10455, 3, 10452, 1, 2, 3
1483, 2, 1636420658846, 1636420669344, 10498, 4, 10494, 2, 2, 4
1481, 2, 1636420658844, 1636420669388, 10544, 4, 10540, 5, 0, 5
1484, 2, 1636420658846, 1636420669432, 10586, 5, 10581, 5, 0, 5
1541, 1, 1636420668779, 1636420669798, 1019, 664, 355, 0, 392, 392
1493, 1, 1636420660182, 1636420669914, 9732, 9379, 353, 0, 1, 1
1542, 1, 1636420669434, 1636420670010, 576, 267, 309, 3, 1, 4
1543, 1, 1636420669434, 1636420670014, 580, 269, 311, 0, 1, 1
1544, 1, 1636420669487, 1636420670110, 623, 266, 357, 0, 0, 0
1545, 1, 1636420669515, 1636420670142, 627, 274, 353, 2, 0, 2
1547, 1, 1636420669523, 1636420670178, 655, 262, 393, 2, 0, 2
1556, 1, 1636420669817, 1636420670478, 661, 263, 398, 2, 0, 2
1557, 1, 1636420669915, 1636420670574, 659, 263, 396, 0, 1, 1
1558, 1, 1636420670164, 1636420670786, 622, 266, 356, 1, 0, 1
1559, 1, 1636420670218, 1636420670842, 624, 267, 357, 1, 0, 1
1560, 1, 1636420670479, 1636420671094, 615, 262, 353, 0, 0, 0
1562, 1, 1636420670503, 1636420671126, 623, 271, 352, 2, 1, 3
1561, 1, 1636420670503, 1636420671130, 627, 270, 357, 3, 0, 3
1563, 1, 1636420670818, 1636420671434, 616, 263, 353, 3, 0, 3
1564, 1, 1636420670921, 1636420671538, 617, 262, 355, 0, 0, 0
1565, 1, 1636420671142, 1636420671766, 624, 266, 358, 0, 1, 1
1566, 1, 1636420671233, 1636420671858, 625, 268, 357, 1, 0, 1
1567, 1, 1636420671446, 1636420672066, 620, 267, 353, 1, 0, 1
1568, 1, 1636420671504, 1636420672118, 614, 264, 350, 1, 1, 2
1569, 1, 1636420671808, 1636420672426, 618, 263, 355, 2, 0, 2
1570, 1, 1636420671903, 1636420672526, 623, 262, 361, 0, 0, 0
1507, 2, 1636420662522, 1636420672700, 10178, 0, 10178, 0, 0, 0
1571, 1, 1636420672177, 1636420672802, 625, 265, 360, 0, 0, 0
1572, 1, 1636420672217, 1636420672846, 629, 266, 363, 0, 1, 1
1573, 1, 1636420672438, 1636420673066, 628, 273, 355, 0, 1, 1
1510, 2, 1636420662898, 1636420673076, 10178, 1, 10177, 0, 1, 1
1574, 1, 1636420672496, 1636420673142, 646, 294, 352, 0, 31, 31
1575, 1, 1636420672782, 1636420673430, 648, 294, 354, 0, 27, 27
1576, 1, 1636420672834, 1636420673522, 688, 293, 395, 1, 27, 28
1577, 1, 1636420672917, 1636420673538, 621, 266, 355, 1, 0, 1
1578, 1, 1636420673155, 1636420673774, 619, 266, 353, 0, 1, 1
1580, 1, 1636420673222, 1636420673838, 616, 262, 354, 0, 0, 0
1579, 1, 1636420673206, 1636420673866, 660, 263, 397, 0, 1, 1
1581, 1, 1636420673425, 1636420674038, 613, 262, 351, 2, 0, 2
1582, 1, 1636420673515, 1636420674134, 619, 263, 356, 0, 1, 1
1583, 1, 1636420673781, 1636420674398, 617, 262, 355, 1, 1, 2
1584, 1, 1636420673782, 1636420674398, 616, 263, 353, 2, 1, 3
1585, 1, 1636420673946, 1636420674566, 620, 265, 355, 0, 0, 0
1586, 1, 1636420674143, 1636420674762, 619, 266, 353, 1, 0, 1
1587, 1, 1636420674187, 1636420674810, 623, 266, 357, 2, 0, 2
1588, 1, 1636420674453, 1636420675074, 621, 266, 355, 0, 1, 1
1589, 1, 1636420674530, 1636420675154, 624, 266, 358, 0, 1, 1
1590, 1, 1636420674750, 1636420675374, 624, 271, 353, 2, 0, 2
1591, 1, 1636420674818, 1636420675442, 624, 269, 355, 0, 0, 0
1592, 1, 1636420674920, 1636420675538, 618, 266, 352, 1, 0, 1
1593, 1, 1636420675177, 1636420675798, 621, 266, 355, 0, 1, 1
1594, 1, 1636420675218, 1636420675842, 624, 271, 353, 1, 1, 2
1595, 1, 1636420675422, 1636420676038, 616, 262, 354, 0, 0, 0
1596, 1, 1636420675529, 1636420676150, 621, 267, 354, 0, 1, 1
1598, 1, 1636420675790, 1636420676406, 616, 263, 353, 2, 0, 2
1528, 2, 1636420666313, 1636420676480, 10167, 1, 10166, 1, 0, 1
1599, 1, 1636420675898, 1636420676514, 616, 262, 354, 0, 0, 0
1600, 1, 1636420676150, 1636420676770, 620, 266, 354, 1, 0, 1
1601, 1, 1636420676244, 1636420676862, 618, 266, 352, 0, 1, 1
1602, 1, 1636420676481, 1636420677062, 581, 270, 311, 0, 1, 1
1603, 1, 1636420676513, 1636420677130, 617, 262, 355, 1, 0, 1
1604, 1, 1636420676615, 1636420677278, 663, 265, 398, 0, 0, 0
1605, 1, 1636420676783, 1636420677406, 623, 270, 353, 0, 0, 0
1606, 1, 1636420676927, 1636420677542, 615, 262, 353, 1, 0, 1
1607, 1, 1636420677121, 1636420677750, 629, 270, 359, 0, 1, 1
1608, 1, 1636420677213, 1636420677834, 621, 267, 354, 2, 1, 3
1609, 1, 1636420677433, 1636420678050, 617, 263, 354, 2, 0, 2
1610, 1, 1636420677513, 1636420678134, 621, 266, 355, 0, 0, 0
1611, 1, 1636420677571, 1636420678190, 619, 265, 354, 1, 0, 1
1612, 1, 1636420677750, 1636420678370, 620, 266, 354, 1, 0, 1
1613, 1, 1636420677897, 1636420678522, 625, 269, 356, 1, 0, 1
1614, 1, 1636420678118, 1636420678742, 624, 269, 355, 1, 1, 2
1615, 1, 1636420678200, 1636420679006, 806, 453, 353, 2, 0, 2
1616, 1, 1636420678425, 1636420679046, 621, 267, 354, 1, 1, 2
1617, 1, 1636420678505, 1636420679134, 629, 267, 362, 0, 0, 0
1618, 1, 1636420678581, 1636420679210, 629, 274, 355, 1, 1, 2
1620, 1, 1636420678901, 1636420679522, 621, 267, 354, 1, 0, 1
1551, 2, 1636420669524, 1636420679700, 10176, 2, 10174, 3, 1, 4
1552, 2, 1636420669525, 1636420679744, 10219, 1, 10218, 0, 0, 0
1555, 2, 1636420669531, 1636420679792, 10261, 1, 10260, 1, 0, 1
1622, 1, 1636420679188, 1636420679806, 618, 267, 351, 2, 2, 4
1554, 2, 1636420669530, 1636420679836, 10306, 2, 10304, 2, 1, 3
1549, 2, 1636420669524, 1636420679880, 10356, 1, 10355, 1, 1, 2
1550, 2, 1636420669524, 1636420679928, 10404, 2, 10402, 1, 1, 2
1548, 2, 1636420669523, 1636420679975, 10452, 1, 10451, 1, 1, 2
1546, 2, 1636420669522, 1636420680020, 10498, 1, 10497, 0, 0, 0
1553, 2, 1636420669525, 1636420680068, 10543, 1, 10542, 1, 0, 1
1623, 1, 1636420679453, 1636420680430, 977, 619, 358, 0, 353, 353
1624, 1, 1636420679525, 1636420680518, 993, 637, 356, 1, 368, 369
1625, 1, 1636420679558, 1636420680522, 964, 609, 355, 0, 337, 337
1626, 1, 1636420680070, 1636420680650, 580, 266, 314, 0, 2, 2
1636, 1, 1636420680181, 1636420680806, 625, 270, 355, 0, 0, 0
1637, 1, 1636420680454, 1636420681114, 660, 266, 394, 0, 0, 0
1638, 1, 1636420680525, 1636420681186, 661, 265, 396, 0, 0, 0
1639, 1, 1636420680560, 1636420681226, 666, 270, 396, 1, 0, 1
1640, 1, 1636420680914, 1636420681538, 624, 270, 354, 0, 1, 1
1641, 1, 1636420681159, 1636420681782, 623, 269, 354, 0, 1, 1
1642, 1, 1636420681430, 1636420682046, 616, 263, 353, 0, 0, 0
1644, 1, 1636420681581, 1636420682206, 625, 270, 355, 0, 1, 1
1643, 1, 1636420681558, 1636420682330, 772, 406, 366, 1, 1, 2
1645, 1, 1636420681947, 1636420682562, 615, 262, 353, 0, 0, 0
1646, 1, 1636420682194, 1636420682818, 624, 266, 358, 0, 1, 1
1647, 1, 1636420682404, 1636420683018, 614, 261, 353, 0, 0, 0
1648, 1, 1636420682555, 1636420683174, 619, 266, 353, 1, 1, 2
1649, 1, 1636420682556, 1636420683174, 618, 267, 351, 2, 1, 3
1650, 1, 1636420682915, 1636420683530, 615, 262, 353, 0, 0, 0
1651, 1, 1636420683172, 1636420683798, 626, 271, 355, 0, 1, 1
1652, 1, 1636420683383, 1636420684006, 623, 270, 353, 0, 0, 0
1653, 1, 1636420683560, 1636420684182, 622, 269, 353, 1, 0, 1
1654, 1, 1636420683591, 1636420684210, 619, 267, 352, 2, 1, 3
1655, 1, 1636420684383, 1636420685002, 619, 265, 354, 0, 1, 1
1656, 1, 1636420684586, 1636420685210, 624, 271, 353, 0, 1, 1
1657, 1, 1636420684606, 1636420685230, 624, 270, 354, 1, 1, 2
1597, 2, 1636420675764, 1636420685896, 10132, 0, 10132, 0, 0, 0
1659, 1, 1636420685575, 1636420686202, 627, 269, 358, 1, 0, 1
1660, 1, 1636420685605, 1636420686250, 645, 290, 355, 1, 23, 24
1661, 1, 1636420686030, 1636420686698, 668, 270, 398, 1, 1, 2
1662, 1, 1636420686562, 1636420687186, 624, 270, 354, 0, 0, 0
1663, 1, 1636420686581, 1636420687210, 629, 269, 360, 0, 0, 0
1664, 1, 1636420686979, 1636420687602, 623, 266, 357, 1, 0, 1
1665, 1, 1636420687528, 1636420688150, 622, 266, 356, 0, 1, 1
1666, 1, 1636420687595, 1636420688222, 627, 268, 359, 0, 0, 0
1667, 1, 1636420687956, 1636420688574, 618, 266, 352, 1, 0, 1
1619, 2, 1636420678741, 1636420688876, 10135, 0, 10135, 0, 0, 0
1668, 1, 1636420688522, 1636420689146, 624, 270, 354, 1, 0, 1
1669, 1, 1636420688587, 1636420689230, 643, 291, 352, 1, 23, 24
1621, 2, 1636420679110, 1636420689248, 10138, 0, 10138, 0, 0, 0
1670, 1, 1636420688931, 1636420689546, 615, 262, 353, 0, 0, 0
1671, 1, 1636420689006, 1636420689694, 688, 289, 399, 0, 23, 23
1672, 1, 1636420689378, 1636420690038, 660, 263, 397, 1, 0, 1
1673, 1, 1636420689500, 1636420690118, 618, 263, 355, 0, 0, 0
1674, 1, 1636420689587, 1636420690210, 623, 268, 355, 0, 0, 0
1630, 2, 1636420680159, 1636420690339, 10180, 2, 10178, 3, 1, 4
1632, 2, 1636420680160, 1636420690384, 10224, 4, 10220, 3, 1, 4
1631, 2, 1636420680159, 1636420690428, 10269, 3, 10266, 3, 1, 4
1627, 2, 1636420680158, 1636420690472, 10314, 2, 10312, 1, 1, 2
1635, 2, 1636420680161, 1636420690520, 10359, 1, 10358, 2, 0, 2
1634, 2, 1636420680160, 1636420690563, 10403, 2, 10401, 3, 2, 5
1633, 2, 1636420680160, 1636420690608, 10448, 2, 10446, 4, 0, 4
1629, 2, 1636420680159, 1636420690656, 10497, 3, 10494, 3, 2, 5
1628, 2, 1636420680158, 1636420690704, 10546, 1, 10545, 3, 0, 3
1675, 1, 1636420689951, 1636420690970, 1019, 301, 718, 1, 35, 36
1676, 1, 1636420689961, 1636420690970, 1009, 280, 729, 1, 10, 11
1677, 1, 1636420690340, 1636420691238, 898, 266, 632, 3, 1, 4
1678, 1, 1636420690705, 1636420691282, 577, 267, 310, 1, 3, 4
1679, 1, 1636420690705, 1636420691286, 581, 266, 315, 1, 2, 3
1683, 1, 1636420690795, 1636420691450, 655, 262, 393, 1, 0, 1
1689, 1, 1636420690971, 1636420691634, 663, 268, 395, 2, 1, 3
1690, 1, 1636420690972, 1636420691634, 662, 267, 395, 2, 0, 2
1691, 1, 1636420691336, 1636420691962, 626, 270, 356, 1, 0, 1
1692, 1, 1636420691515, 1636420692146, 631, 276, 355, 2, 0, 2
1693, 1, 1636420691583, 1636420692206, 623, 269, 354, 0, 0, 0
1694, 1, 1636420691761, 1636420692386, 625, 270, 355, 1, 1, 2
1695, 1, 1636420691969, 1636420692590, 621, 265, 356, 0, 0, 0
1696, 1, 1636420691995, 1636420692614, 619, 266, 353, 1, 0, 1
1697, 1, 1636420692312, 1636420692934, 622, 265, 357, 0, 0, 0
1698, 1, 1636420692611, 1636420693234, 623, 266, 357, 1, 0, 1
1699, 1, 1636420692766, 1636420693394, 628, 269, 359, 1, 0, 1
1700, 1, 1636420692936, 1636420693550, 614, 264, 350, 1, 0, 1
1701, 1, 1636420692995, 1636420693658, 663, 311, 352, 0, 1, 1
1702, 1, 1636420693328, 1636420693946, 618, 265, 353, 0, 0, 0
1703, 1, 1636420693585, 1636420694214, 629, 265, 364, 0, 0, 0
1704, 1, 1636420693783, 1636420694406, 623, 264, 359, 0, 0, 0
1705, 1, 1636420693947, 1636420694566, 619, 266, 353, 1, 0, 1
1706, 1, 1636420693992, 1636420694610, 618, 267, 351, 2, 1, 3
1707, 1, 1636420694361, 1636420694990, 629, 269, 360, 0, 1, 1
1708, 1, 1636420694571, 1636420695198, 627, 270, 357, 0, 0, 0
1709, 1, 1636420694786, 1636420695410, 624, 271, 353, 1, 1, 2
1658, 2, 1636420685397, 1636420695532, 10135, 1, 10134, 0, 0, 0
1710, 1, 1636420694943, 1636420695562, 619, 265, 354, 0, 0, 0
1711, 1, 1636420694960, 1636420695578, 618, 267, 351, 1, 1, 2
1712, 1, 1636420695332, 1636420695978, 646, 295, 351, 0, 28, 28
1713, 1, 1636420695573, 1636420696202, 629, 270, 359, 0, 1, 1
1714, 1, 1636420695662, 1636420696326, 664, 265, 399, 0, 0, 0
1715, 1, 1636420695782, 1636420696402, 620, 266, 354, 1, 1, 2
1716, 1, 1636420695928, 1636420696550, 622, 269, 353, 0, 0, 0
1717, 1, 1636420695960, 1636420696582, 622, 269, 353, 1, 0, 1
1718, 1, 1636420696353, 1636420696978, 625, 271, 354, 1, 0, 1
1719, 1, 1636420696573, 1636420697198, 625, 267, 358, 0, 0, 0
1720, 1, 1636420696612, 1636420697238, 626, 270, 356, 2, 0, 2
1721, 1, 1636420696769, 1636420697390, 621, 265, 356, 0, 0, 0
1722, 1, 1636420696902, 1636420697522, 620, 266, 354, 0, 0, 0
1723, 1, 1636420696930, 1636420697546, 616, 262, 354, 0, 0, 0
1724, 1, 1636420697389, 1636420698014, 625, 269, 356, 0, 0, 0
1725, 1, 1636420697576, 1636420698198, 622, 266, 356, 1, 0, 1
1726, 1, 1636420697590, 1636420698214, 624, 268, 356, 1, 1, 2
1727, 1, 1636420697805, 1636420698430, 625, 270, 355, 1, 0, 1
1728, 1, 1636420697904, 1636420698522, 618, 267, 351, 1, 0, 1
1729, 1, 1636420697923, 1636420698554, 631, 278, 353, 1, 0, 1
1730, 1, 1636420698388, 1636420699006, 618, 265, 353, 0, 0, 0
1731, 1, 1636420698571, 1636420699194, 623, 266, 357, 0, 1, 1
1732, 1, 1636420698579, 1636420699198, 619, 267, 352, 0, 1, 1
1733, 1, 1636420698772, 1636420699462, 690, 338, 352, 2, 0, 2
1734, 1, 1636420698899, 1636420699514, 615, 261, 354, 0, 0, 0
1735, 1, 1636420698911, 1636420699530, 619, 262, 357, 0, 0, 0
1736, 1, 1636420699372, 1636420699990, 618, 267, 351, 1, 0, 1
1737, 1, 1636420699580, 1636420700206, 626, 271, 355, 2, 0, 2
1738, 1, 1636420699587, 1636420700217, 630, 266, 364, 0, 0, 0
1739, 1, 1636420699749, 1636420700374, 625, 269, 356, 2, 0, 2
1740, 1, 1636420699904, 1636420700518, 614, 261, 353, 0, 1, 1
1741, 1, 1636420699934, 1636420700558, 624, 262, 362, 1, 0, 1
1686, 2, 1636420690798, 1636420700972, 10174, 1, 10173, 4, 0, 4
1742, 1, 1636420700372, 1636420700994, 622, 269, 353, 1, 0, 1
1687, 2, 1636420690798, 1636420701020, 10222, 0, 10222, 0, 0, 0
1682, 2, 1636420690795, 1636420701068, 10273, 1, 10272, 0, 1, 1
1680, 2, 1636420690794, 1636420701116, 10322, 1, 10321, 1, 1, 2
1684, 2, 1636420690796, 1636420701164, 10368, 1, 10367, 2, 0, 2
1685, 2, 1636420690796, 1636420701212, 10416, 0, 10416, 0, 0, 0
1688, 2, 1636420690798, 1636420701259, 10461, 0, 10461, 2, 0, 2
1681, 2, 1636420690795, 1636420701304, 10509, 1, 10508, 4, 0, 4
1743, 1, 1636420700561, 1636420701570, 1009, 653, 356, 0, 379, 379
1744, 1, 1636420700765, 1636420701754, 989, 296, 693, 1, 32, 33
1745, 1, 1636420700877, 1636420701842, 965, 604, 361, 334, 3, 337
1746, 1, 1636420700905, 1636420701842, 937, 602, 335, 2, 336, 338
1747, 1, 1636420701371, 1636420701990, 619, 266, 353, 1, 0, 1
1756, 1, 1636420701592, 1636420702258, 666, 267, 399, 0, 0, 0
1757, 1, 1636420701765, 1636420702434, 669, 268, 401, 1, 0, 1
1759, 1, 1636420701909, 1636420702530, 621, 267, 354, 0, 0, 0
1758, 1, 1636420701877, 1636420702538, 661, 266, 395, 1, 0, 1
1760, 1, 1636420702403, 1636420703030, 627, 269, 358, 1, 0, 1
1761, 1, 1636420702612, 1636420703238, 626, 274, 352, 1, 0, 1
1762, 1, 1636420702748, 1636420703374, 626, 269, 357, 0, 0, 0
1763, 1, 1636420702869, 1636420703494, 625, 266, 359, 1, 0, 1
1764, 1, 1636420702893, 1636420703766, 873, 517, 356, 0, 0, 0
1765, 1, 1636420703388, 1636420704010, 622, 269, 353, 0, 0, 0
1766, 1, 1636420703594, 1636420704222, 628, 270, 358, 0, 1, 1
1767, 1, 1636420703717, 1636420704350, 633, 271, 362, 0, 1, 1
1768, 1, 1636420703886, 1636420704510, 624, 267, 357, 0, 1, 1
1769, 1, 1636420703899, 1636420704514, 615, 262, 353, 0, 0, 0
1770, 1, 1636420704402, 1636420705030, 628, 270, 358, 2, 1, 3
1772, 1, 1636420704702, 1636420705330, 628, 270, 358, 1, 0, 1
1773, 1, 1636420704863, 1636420705490, 627, 272, 355, 0, 3, 3
1774, 1, 1636420704918, 1636420705546, 628, 271, 357, 0, 0, 0
1775, 1, 1636420705431, 1636420706054, 623, 267, 356, 0, 1, 1
1776, 1, 1636420705702, 1636420706326, 624, 268, 356, 0, 0, 0
1777, 1, 1636420705894, 1636420706522, 628, 266, 362, 0, 0, 0
1779, 1, 1636420706404, 1636420707026, 622, 269, 353, 0, 1, 1
1781, 1, 1636420706920, 1636420707546, 626, 270, 356, 0, 1, 1
1782, 1, 1636420707389, 1636420708014, 625, 268, 357, 0, 0, 0
1783, 1, 1636420707910, 1636420708534, 624, 269, 355, 1, 0, 1
1784, 1, 1636420708391, 1636420709014, 623, 269, 354, 2, 0, 2
1785, 1, 1636420708897, 1636420709522, 625, 269, 356, 1, 1, 2
1786, 1, 1636420709366, 1636420709986, 620, 266, 354, 0, 1, 1
1787, 1, 1636420709863, 1636420710486, 623, 268, 355, 0, 0, 0
1788, 1, 1636420710369, 1636420710990, 621, 266, 355, 1, 0, 1
1789, 1, 1636420710857, 1636420711486, 629, 269, 360, 0, 0, 0
1753, 2, 1636420701396, 1636420711576, 10180, 5, 10175, 4, 2, 6
1750, 2, 1636420701395, 1636420711620, 10225, 2, 10223, 0, 2, 2
1752, 2, 1636420701396, 1636420711664, 10268, 2, 10266, 1, 1, 2
1755, 2, 1636420701397, 1636420711708, 10311, 2, 10309, 1, 1, 2
1754, 2, 1636420701397, 1636420711756, 10359, 4, 10355, 3, 1, 4
1748, 2, 1636420701395, 1636420711804, 10409, 1, 10408, 3, 0, 3
1751, 2, 1636420701396, 1636420711852, 10456, 3, 10453, 5, 0, 5
1749, 2, 1636420701395, 1636420711896, 10501, 1, 10500, 2, 1, 3
1790, 1, 1636420711364, 1636420712346, 982, 308, 674, 2, 41, 43
1791, 1, 1636420711896, 1636420712474, 578, 266, 312, 0, 0, 0
1800, 1, 1636420712364, 1636420713034, 670, 270, 400, 0, 1, 1
1771, 2, 1636420704583, 1636420714716, 10133, 0, 10133, 0, 0, 0
1778, 1, 1636420705928, 1636420715206, 9278, 8927, 351, 0, 0, 0
1801, 1, 1636420714850, 1636420715514, 664, 268, 396, 0, 0, 0
1802, 1, 1636420715207, 1636420715870, 663, 264, 399, 0, 0, 0
1803, 1, 1636420715793, 1636420716414, 621, 263, 358, 2, 0, 2
1804, 1, 1636420716186, 1636420716810, 624, 270, 354, 0, 1, 1
1780, 2, 1636420706716, 1636420716848, 10132, 1, 10131, 1, 0, 1
1805, 1, 1636420716849, 1636420717470, 621, 265, 356, 0, 0, 0
1806, 1, 1636420716982, 1636420717646, 664, 268, 396, 0, 0, 0
1807, 1, 1636420717205, 1636420717822, 617, 262, 355, 0, 0, 0
1808, 1, 1636420717809, 1636420718434, 625, 271, 354, 1, 2, 3
1809, 1, 1636420717934, 1636420718558, 624, 267, 357, 0, 0, 0
1810, 1, 1636420718224, 1636420718842, 618, 267, 351, 0, 1, 1
1811, 1, 1636420718804, 1636420719422, 618, 267, 351, 0, 2, 2
1812, 1, 1636420718911, 1636420719538, 627, 269, 358, 0, 0, 0
1813, 1, 1636420719219, 1636420719842, 623, 271, 352, 0, 0, 0
1814, 1, 1636420719839, 1636420720454, 615, 263, 352, 0, 1, 1
1815, 1, 1636420719900, 1636420720526, 626, 269, 357, 0, 0, 0
1816, 1, 1636420720199, 1636420720814, 615, 262, 353, 1, 0, 1
1817, 1, 1636420720850, 1636420721470, 620, 267, 353, 1, 0, 1
1818, 1, 1636420720909, 1636420721538, 629, 268, 361, 0, 0, 0
1796, 2, 1636420711987, 1636420722160, 10173, 1, 10172, 2, 0, 2
1794, 2, 1636420711987, 1636420722203, 10216, 2, 10214, 0, 2, 2
1799, 2, 1636420711988, 1636420722247, 10259, 1, 10258, 0, 0, 0
1795, 2, 1636420711987, 1636420722292, 10305, 1, 10304, 0, 1, 1
1793, 2, 1636420711986, 1636420722340, 10354, 1, 10353, 2, 0, 2
1798, 2, 1636420711988, 1636420722388, 10400, 2, 10398, 1, 1, 2
1797, 2, 1636420711988, 1636420722436, 10448, 0, 10448, 0, 0, 0
1792, 2, 1636420711982, 1636420722484, 10502, 1, 10501, 0, 0, 0
1821, 1, 1636420721883, 1636420722842, 959, 280, 679, 1, 12, 13
1820, 1, 1636420721868, 1636420722842, 974, 295, 679, 0, 29, 29
1819, 1, 1636420721199, 1636420722974, 1775, 1418, 357, 0, 0, 0
1824, 1, 1636420722575, 1636420723242, 667, 269, 398, 0, 0, 0
1830, 1, 1636420722867, 1636420723522, 655, 263, 392, 1, 0, 1
1831, 1, 1636420722884, 1636420723558, 674, 276, 398, 1, 1, 2
1832, 1, 1636420722976, 1636420723638, 662, 266, 396, 1, 0, 1
1833, 1, 1636420723534, 1636420724158, 624, 269, 355, 0, 0, 0
1834, 1, 1636420723846, 1636420724466, 620, 266, 354, 1, 1, 2
1835, 1, 1636420723907, 1636420724526, 619, 266, 353, 0, 1, 1
1836, 1, 1636420723985, 1636420724610, 625, 270, 355, 1, 0, 1
1837, 1, 1636420724551, 1636420725174, 623, 271, 352, 1, 0, 1
1838, 1, 1636420724857, 1636420725478, 621, 266, 355, 0, 1, 1
1839, 1, 1636420724906, 1636420725526, 620, 265, 355, 0, 0, 0
1840, 1, 1636420724999, 1636420725618, 619, 267, 352, 0, 0, 0
1841, 1, 1636420725554, 1636420726174, 620, 267, 353, 1, 0, 1
1842, 1, 1636420725887, 1636420726506, 619, 264, 355, 1, 0, 1
1843, 1, 1636420725888, 1636420726506, 618, 266, 352, 3, 0, 3
1844, 1, 1636420725996, 1636420726610, 614, 262, 352, 0, 0, 0
1845, 1, 1636420726550, 1636420727170, 620, 267, 353, 1, 0, 1
1846, 1, 1636420726879, 1636420727502, 623, 269, 354, 0, 0, 0
1847, 1, 1636420726889, 1636420727514, 625, 270, 355, 0, 0, 0
1848, 1, 1636420727027, 1636420727646, 619, 266, 353, 0, 0, 0
1849, 1, 1636420727538, 1636420728162, 624, 268, 356, 0, 0, 0
1850, 1, 1636420727911, 1636420728538, 627, 274, 353, 1, 1, 2
1851, 1, 1636420727912, 1636420728538, 626, 275, 351, 2, 1, 3
1852, 1, 1636420727999, 1636420728614, 615, 264, 351, 1, 1, 2
1855, 1, 1636420728924, 1636420729546, 622, 266, 356, 0, 0, 0
1854, 1, 1636420728923, 1636420729546, 623, 267, 356, 1, 0, 1
1856, 1, 1636420728989, 1636420729606, 617, 262, 355, 0, 0, 0
1857, 1, 1636420729921, 1636420730546, 625, 270, 355, 1, 1, 2
1858, 1, 1636420729940, 1636420730554, 614, 262, 352, 0, 0, 0
1859, 1, 1636420729962, 1636420730582, 620, 267, 353, 1, 1, 2
1860, 1, 1636420730900, 1636420731526, 626, 270, 356, 0, 0, 0
1861, 1, 1636420730933, 1636420731550, 617, 262, 355, 0, 0, 0
1862, 1, 1636420730956, 1636420731578, 622, 270, 352, 1, 1, 2
1863, 1, 1636420731901, 1636420732518, 617, 267, 350, 1, 1, 2
1864, 1, 1636420731905, 1636420732526, 621, 267, 354, 1, 0, 1
1865, 1, 1636420731961, 1636420732586, 625, 271, 354, 1, 1, 2
1828, 2, 1636420722576, 1636420732752, 10176, 0, 10176, 0, 0, 0
1823, 2, 1636420722575, 1636420732796, 10221, 0, 10221, 0, 0, 0
1829, 2, 1636420722577, 1636420732844, 10267, 1, 10266, 1, 0, 1
1825, 2, 1636420722575, 1636420732892, 10317, 1, 10316, 1, 0, 1
1822, 2, 1636420722574, 1636420732940, 10366, 0, 10366, 1, 0, 1
1826, 2, 1636420722576, 1636420732988, 10412, 0, 10412, 2, 0, 2
1827, 2, 1636420722576, 1636420733035, 10459, 0, 10459, 1, 0, 1
1853, 1, 1636420728574, 1636420733526, 4952, 4599, 353, 3, 0, 3
1866, 1, 1636420733036, 1636420733610, 574, 263, 311, 1, 1, 2
1868, 1, 1636420733037, 1636420733618, 581, 271, 310, 2, 1, 3
1867, 1, 1636420733036, 1636420733886, 850, 535, 315, 1, 1, 2
1876, 1, 1636420733547, 1636420734210, 663, 268, 395, 1, 0, 1
1877, 1, 1636420733867, 1636420734490, 623, 269, 354, 0, 1, 1
1878, 1, 1636420733919, 1636420734582, 663, 269, 394, 1, 0, 1
1879, 1, 1636420733996, 1636420734622, 626, 269, 357, 1, 0, 1
1880, 1, 1636420734519, 1636420735138, 619, 267, 352, 0, 1, 1
1881, 1, 1636420734831, 1636420735446, 615, 263, 352, 2, 0, 2
1882, 1, 1636420734904, 1636420735522, 618, 265, 353, 0, 0, 0
1883, 1, 1636420735027, 1636420735650, 623, 264, 359, 0, 0, 0
1884, 1, 1636420735549, 1636420736174, 625, 269, 356, 0, 0, 0
1885, 1, 1636420735829, 1636420736450, 621, 266, 355, 1, 0, 1
1886, 1, 1636420735928, 1636420736542, 614, 263, 351, 1, 1, 2
1887, 1, 1636420736007, 1636420736626, 619, 266, 353, 1, 0, 1
1888, 1, 1636420736584, 1636420737214, 630, 270, 360, 1, 0, 1
1889, 1, 1636420736863, 1636420737482, 619, 267, 352, 0, 0, 0
1890, 1, 1636420736934, 1636420737558, 624, 266, 358, 0, 0, 0
1891, 1, 1636420736987, 1636420737606, 619, 267, 352, 1, 0, 1
1892, 1, 1636420737551, 1636420738174, 623, 269, 354, 0, 0, 0
1893, 1, 1636420737835, 1636420738458, 623, 266, 357, 0, 0, 0
1894, 1, 1636420737956, 1636420738570, 614, 265, 349, 1, 1, 2
1895, 1, 1636420737966, 1636420738594, 628, 270, 358, 0, 0, 0
1896, 1, 1636420738520, 1636420739146, 626, 269, 357, 0, 0, 0
1897, 1, 1636420738806, 1636420739430, 624, 271, 353, 1, 0, 1
1898, 1, 1636420738946, 1636420739566, 620, 264, 356, 0, 1, 1
1899, 1, 1636420738973, 1636420739602, 629, 269, 360, 1, 0, 1
1900, 1, 1636420739487, 1636420740114, 627, 271, 356, 0, 2, 2
1901, 1, 1636420739773, 1636420740398, 625, 271, 354, 0, 1, 1
1902, 1, 1636420739948, 1636420740566, 618, 266, 352, 0, 0, 0
1903, 1, 1636420739977, 1636420740594, 617, 261, 356, 0, 0, 0
1904, 1, 1636420740487, 1636420741114, 627, 269, 358, 0, 0, 0
1906, 1, 1636420740970, 1636420741598, 628, 267, 361, 1, 1, 2
1907, 1, 1636420740987, 1636420741606, 619, 262, 357, 1, 0, 1
1910, 1, 1636420741992, 1636420742606, 614, 263, 351, 1, 1, 2
1909, 1, 1636420741983, 1636420742606, 623, 270, 353, 0, 0, 0
1869, 2, 1636420733154, 1636420743328, 10174, 1, 10173, 1, 0, 1
1874, 2, 1636420733162, 1636420743376, 10214, 1, 10213, 0, 1, 1
1875, 2, 1636420733162, 1636420743420, 10258, 1, 10257, 1, 1, 2
1872, 2, 1636420733158, 1636420743463, 10305, 1, 10304, 1, 0, 1
1873, 2, 1636420733158, 1636420743508, 10350, 1, 10349, 2, 0, 2
1871, 2, 1636420733154, 1636420743556, 10402, 0, 10402, 0, 0, 0
1870, 2, 1636420733154, 1636420743604, 10450, 0, 10450, 0, 0, 0
1912, 1, 1636420743000, 1636420743870, 870, 517, 353, 0, 252, 252
1911, 1, 1636420742974, 1636420743870, 896, 540, 356, 0, 271, 271
1913, 1, 1636420743694, 1636420744358, 664, 267, 397, 2, 0, 2
1920, 1, 1636420743983, 1636420744602, 619, 267, 352, 1, 0, 1
1922, 1, 1636420744679, 1636420745302, 623, 270, 353, 0, 0, 0
1923, 1, 1636420744997, 1636420745622, 625, 269, 356, 0, 1, 1
1924, 1, 1636420745712, 1636420746330, 618, 268, 350, 0, 3, 3
1925, 1, 1636420745993, 1636420746618, 625, 269, 356, 0, 0, 0
1926, 1, 1636420746737, 1636420747354, 617, 262, 355, 0, 0, 0
1927, 1, 1636420747002, 1636420747626, 624, 266, 358, 1, 0, 1
1928, 1, 1636420747716, 1636420748342, 626, 273, 353, 0, 1, 1
1929, 1, 1636420747973, 1636420748598, 625, 265, 360, 0, 0, 0
1930, 1, 1636420748714, 1636420749342, 628, 268, 360, 0, 0, 0
1931, 1, 1636420748961, 1636420749594, 633, 273, 360, 1, 0, 1
1932, 1, 1636420749738, 1636420750362, 624, 271, 353, 0, 1, 1
1905, 2, 1636420740764, 1636420750896, 10132, 0, 10132, 0, 0, 0
1934, 1, 1636420750742, 1636420751366, 624, 271, 353, 1, 0, 1
1908, 2, 1636420741501, 1636420751636, 10135, 1, 10134, 1, 0, 1
1935, 1, 1636420751026, 1636420751690, 664, 267, 397, 0, 0, 0
1936, 1, 1636420751755, 1636420752370, 615, 263, 352, 0, 1, 1
1937, 1, 1636420751770, 1636420752430, 660, 267, 393, 1, 0, 1
1938, 1, 1636420751984, 1636420752606, 622, 269, 353, 1, 0, 1
1939, 1, 1636420752722, 1636420753346, 624, 270, 354, 1, 0, 1
1940, 1, 1636420752740, 1636420753362, 622, 266, 356, 0, 0, 0
1941, 1, 1636420752994, 1636420753610, 616, 262, 354, 1, 0, 1
1915, 2, 1636420743695, 1636420753876, 10181, 2, 10179, 1, 1, 2
1918, 2, 1636420743695, 1636420753920, 10225, 2, 10223, 1, 1, 2
1919, 2, 1636420743696, 1636420753968, 10272, 2, 10270, 1, 1, 2
1914, 2, 1636420743694, 1636420754012, 10318, 1, 10317, 2, 0, 2
1916, 2, 1636420743695, 1636420754056, 10361, 3, 10358, 3, 0, 3
1917, 2, 1636420743695, 1636420754100, 10405, 2, 10403, 1, 2, 3
1921, 2, 1636420744000, 1636420754143, 10143, 1, 10142, 1, 0, 1
1943, 1, 1636420753712, 1636420754590, 878, 527, 351, 2, 258, 260
1933, 1, 1636420749951, 1636420754590, 4639, 4286, 353, 2, 2, 4
1942, 1, 1636420753699, 1636420754602, 903, 271, 632, 3, 2, 5
1944, 1, 1636420754144, 1636420754726, 582, 263, 319, 0, 1, 1
1945, 1, 1636420754262, 1636420754918, 656, 262, 394, 0, 0, 0
1952, 1, 1636420754609, 1636420755278, 669, 267, 402, 1, 1, 2
1953, 1, 1636420754699, 1636420755326, 627, 270, 357, 0, 1, 1
1954, 1, 1636420754706, 1636420755330, 624, 263, 361, 1, 0, 1
1955, 1, 1636420754985, 1636420755602, 617, 263, 354, 1, 0, 1
1956, 1, 1636420755196, 1636420755818, 622, 266, 356, 1, 0, 1
1957, 1, 1636420755600, 1636420756222, 622, 266, 356, 1, 1, 2
1958, 1, 1636420755676, 1636420756298, 622, 270, 352, 2, 0, 2
1959, 1, 1636420755707, 1636420756334, 627, 268, 359, 1, 2, 3
1960, 1, 1636420756019, 1636420756634, 615, 262, 353, 2, 0, 2
1961, 1, 1636420756231, 1636420756858, 627, 270, 357, 0, 0, 0
1962, 1, 1636420756606, 1636420757230, 624, 265, 359, 0, 0, 0
1963, 1, 1636420756685, 1636420757310, 625, 270, 355, 0, 1, 1
1964, 1, 1636420756696, 1636420757318, 622, 267, 355, 1, 1, 2
1965, 1, 1636420757010, 1636420757630, 620, 266, 354, 0, 0, 0
1966, 1, 1636420757203, 1636420757826, 623, 270, 353, 0, 1, 1
1967, 1, 1636420757599, 1636420758226, 627, 274, 353, 1, 0, 1
1968, 1, 1636420757669, 1636420758294, 625, 270, 355, 0, 1, 1
1969, 1, 1636420757695, 1636420758318, 623, 271, 352, 0, 1, 1
1970, 1, 1636420758015, 1636420758638, 623, 266, 357, 1, 0, 1
1971, 1, 1636420758174, 1636420758902, 728, 374, 354, 0, 1, 1
1974, 1, 1636420758682, 1636420759302, 620, 268, 352, 1, 1, 2
1973, 1, 1636420758673, 1636420759310, 637, 273, 364, 0, 0, 0
1975, 1, 1636420759052, 1636420759678, 626, 270, 356, 0, 2, 2
1976, 1, 1636420759163, 1636420759786, 623, 270, 353, 1, 0, 1
1978, 1, 1636420759658, 1636420760282, 624, 268, 356, 0, 1, 1
1977, 1, 1636420759657, 1636420760282, 625, 270, 355, 2, 1, 3
1979, 1, 1636420760051, 1636420760670, 619, 267, 352, 0, 0, 0
1981, 1, 1636420760639, 1636420761262, 623, 270, 353, 0, 0, 0
1982, 1, 1636420760648, 1636420761274, 626, 271, 355, 1, 0, 1
1983, 1, 1636420761034, 1636420761662, 628, 270, 358, 1, 0, 1
1984, 1, 1636420761640, 1636420762266, 626, 269, 357, 1, 0, 1
1985, 1, 1636420761656, 1636420762286, 630, 271, 359, 1, 0, 1
1986, 1, 1636420762057, 1636420762682, 625, 271, 354, 0, 2, 2
1987, 1, 1636420762630, 1636420763250, 620, 265, 355, 1, 0, 1
1988, 1, 1636420762663, 1636420763286, 623, 270, 353, 0, 1, 1
1989, 1, 1636420763050, 1636420763682, 632, 270, 362, 2, 0, 2
1990, 1, 1636420763614, 1636420764242, 628, 269, 359, 0, 0, 0
1991, 1, 1636420763675, 1636420764298, 623, 269, 354, 1, 0, 1
1950, 2, 1636420754274, 1636420764448, 10174, 1, 10173, 0, 1, 1
1948, 2, 1636420754271, 1636420764492, 10221, 2, 10219, 2, 0, 2
1949, 2, 1636420754271, 1636420764536, 10265, 1, 10264, 1, 0, 1
1951, 2, 1636420754274, 1636420764584, 10310, 0, 10310, 1, 0, 1
1947, 2, 1636420754270, 1636420764632, 10362, 2, 10360, 2, 0, 2
1946, 2, 1636420754270, 1636420764680, 10410, 2, 10408, 2, 0, 2
1992, 1, 1636420764071, 1636420764946, 875, 289, 586, 0, 19, 19
1993, 1, 1636420764681, 1636420765262, 581, 270, 311, 0, 2, 2
1994, 1, 1636420764693, 1636420765314, 621, 267, 354, 0, 0, 0
2001, 1, 1636420765070, 1636420765702, 632, 273, 359, 0, 1, 1
2002, 1, 1636420765609, 1636420766234, 625, 268, 357, 0, 0, 0
2003, 1, 1636420765722, 1636420766346, 624, 270, 354, 1, 0, 1
2004, 1, 1636420766085, 1636420766710, 625, 267, 358, 0, 1, 1
2005, 1, 1636420766590, 1636420767218, 628, 270, 358, 0, 1, 1
2006, 1, 1636420766728, 1636420767350, 622, 268, 354, 0, 0, 0
2007, 1, 1636420767115, 1636420767738, 623, 267, 356, 0, 1, 1
2008, 1, 1636420767592, 1636420768214, 622, 267, 355, 0, 0, 0
2009, 1, 1636420767733, 1636420768358, 625, 270, 355, 1, 1, 2
1972, 2, 1636420758569, 1636420768704, 10135, 1, 10134, 1, 0, 1
2010, 1, 1636420768088, 1636420768710, 622, 270, 352, 0, 0, 0
2011, 1, 1636420768614, 1636420769230, 616, 260, 356, 0, 1, 1
2012, 1, 1636420768759, 1636420769378, 619, 267, 352, 0, 1, 1
2014, 1, 1636420769073, 1636420769690, 617, 267, 350, 1, 1, 2
2015, 1, 1636420769625, 1636420770254, 629, 271, 358, 0, 0, 0
1980, 2, 1636420760154, 1636420770288, 10134, 1, 10133, 0, 1, 1
2016, 1, 1636420769790, 1636420770414, 624, 267, 357, 1, 1, 2
2017, 1, 1636420770102, 1636420770734, 632, 279, 353, 1, 11, 12
2018, 1, 1636420770418, 1636420771078, 660, 268, 392, 0, 1, 1
2020, 1, 1636420770769, 1636420771390, 621, 267, 354, 1, 1, 2
2021, 1, 1636420771374, 1636420771994, 620, 266, 354, 1, 0, 1
2022, 1, 1636420771749, 1636420772374, 625, 269, 356, 0, 0, 0
2023, 1, 1636420772384, 1636420773010, 626, 272, 354, 1, 0, 1
2024, 1, 1636420772728, 1636420773346, 618, 266, 352, 2, 0, 2
2025, 1, 1636420773360, 1636420773982, 622, 266, 356, 0, 0, 0
2026, 1, 1636420773760, 1636420774382, 622, 269, 353, 1, 0, 1
1997, 2, 1636420764771, 1636420774952, 10181, 1, 10180, 2, 0, 2
2027, 1, 1636420774376, 1636420774998, 622, 269, 353, 0, 0, 0
1995, 2, 1636420764770, 1636420775000, 10230, 2, 10228, 0, 2, 2
1998, 2, 1636420764771, 1636420775044, 10273, 1, 10272, 2, 0, 2
2000, 2, 1636420764772, 1636420775092, 10320, 1, 10319, 1, 0, 1
1999, 2, 1636420764771, 1636420775136, 10365, 2, 10363, 4, 0, 4
1996, 2, 1636420764770, 1636420775180, 10410, 3, 10407, 4, 0, 4
2028, 1, 1636420774737, 1636420775626, 889, 305, 584, 0, 41, 41
2019, 1, 1636420770640, 1636420775670, 5030, 4678, 352, 0, 1, 1
2033, 1, 1636420775271, 1636420775934, 663, 267, 396, 0, 1, 1
2035, 1, 1636420775390, 1636420776010, 620, 266, 354, 0, 0, 0
2036, 1, 1636420775672, 1636420776330, 658, 262, 396, 0, 0, 0
2037, 1, 1636420775741, 1636420776362, 621, 267, 354, 1, 0, 1
2038, 1, 1636420776242, 1636420776866, 624, 270, 354, 0, 1, 1
2039, 1, 1636420776364, 1636420776982, 618, 265, 353, 1, 0, 1
2040, 1, 1636420776647, 1636420777266, 619, 267, 352, 1, 0, 1
2041, 1, 1636420776753, 1636420777382, 629, 270, 359, 1, 0, 1
2042, 1, 1636420777272, 1636420777894, 622, 267, 355, 1, 1, 2
2043, 1, 1636420777400, 1636420778022, 622, 264, 358, 0, 0, 0
2044, 1, 1636420777616, 1636420778238, 622, 267, 355, 0, 0, 0
2045, 1, 1636420777736, 1636420778350, 614, 261, 353, 0, 1, 1
2046, 1, 1636420778241, 1636420778862, 621, 266, 355, 0, 0, 0
2013, 2, 1636420768834, 1636420779008, 10174, 0, 10174, 0, 0, 0
2047, 1, 1636420778436, 1636420779050, 614, 262, 352, 0, 0, 0
2048, 1, 1636420778595, 1636420779214, 619, 267, 352, 1, 1, 2
2049, 1, 1636420778753, 1636420779374, 621, 267, 354, 1, 0, 1
2050, 1, 1636420779138, 1636420779806, 668, 269, 399, 0, 1, 1
2051, 1, 1636420779238, 1636420779858, 620, 267, 353, 0, 1, 1
2052, 1, 1636420779405, 1636420780030, 625, 266, 359, 1, 1, 2
2053, 1, 1636420779598, 1636420780230, 632, 270, 362, 0, 0, 0
2054, 1, 1636420779767, 1636420780382, 615, 263, 352, 0, 0, 0
2055, 1, 1636420780092, 1636420780710, 618, 265, 353, 0, 0, 0
2056, 1, 1636420780263, 1636420780886, 623, 271, 352, 2, 0, 2
2057, 1, 1636420780388, 1636420781006, 618, 267, 351, 1, 0, 1
2058, 1, 1636420780612, 1636420781234, 622, 271, 351, 0, 1, 1
2059, 1, 1636420780748, 1636420781370, 622, 266, 356, 0, 0, 0
2060, 1, 1636420781129, 1636420781750, 621, 266, 355, 1, 0, 1
2061, 1, 1636420781267, 1636420781886, 619, 262, 357, 1, 0, 1
2062, 1, 1636420781388, 1636420782002, 614, 263, 351, 0, 0, 0
2063, 1, 1636420781623, 1636420782242, 619, 267, 352, 0, 0, 0
2064, 1, 1636420781757, 1636420782386, 629, 273, 356, 1, 0, 1
2065, 1, 1636420782101, 1636420782730, 629, 269, 360, 0, 0, 0
2066, 1, 1636420782280, 1636420782898, 618, 267, 351, 1, 1, 2
2067, 1, 1636420782367, 1636420782986, 619, 267, 352, 2, 0, 2
2068, 1, 1636420782622, 1636420783242, 620, 267, 353, 1, 2, 3
2069, 1, 1636420782755, 1636420783378, 623, 268, 355, 1, 0, 1
2070, 1, 1636420783071, 1636420783686, 615, 263, 352, 1, 0, 1
2071, 1, 1636420783265, 1636420783882, 617, 266, 351, 0, 0, 0
2072, 1, 1636420783389, 1636420784010, 621, 266, 355, 0, 0, 0
2073, 1, 1636420783650, 1636420784266, 616, 262, 354, 0, 0, 0
2074, 1, 1636420783743, 1636420784362, 619, 265, 354, 0, 0, 0
2075, 1, 1636420784051, 1636420784674, 623, 266, 357, 0, 0, 0
2076, 1, 1636420784239, 1636420784858, 619, 263, 356, 0, 0, 0
2077, 1, 1636420784373, 1636420784994, 621, 266, 355, 1, 0, 1
2078, 1, 1636420784657, 1636420785286, 629, 275, 354, 1, 0, 1
2079, 1, 1636420784740, 1636420785358, 618, 266, 352, 0, 0, 0
2029, 2, 1636420775270, 1636420785453, 10183, 3, 10180, 4, 2, 6
2031, 2, 1636420775270, 1636420785500, 10230, 2, 10228, 3, 0, 3
2034, 2, 1636420775271, 1636420785548, 10277, 2, 10275, 2, 0, 2
2032, 2, 1636420775271, 1636420785596, 10325, 1, 10324, 1, 0, 1
2030, 2, 1636420775270, 1636420785644, 10374, 1, 10373, 3, 0, 3
2081, 1, 1636420785216, 1636420786002, 786, 426, 360, 0, 155, 155
2082, 1, 1636420785388, 1636420786174, 786, 264, 522, 0, 1, 1
2083, 1, 1636420785686, 1636420786302, 616, 262, 354, 1, 0, 1
2085, 1, 1636420785740, 1636420786358, 618, 262, 356, 0, 0, 0
2084, 1, 1636420785734, 1636420786402, 668, 270, 398, 0, 0, 0
2090, 1, 1636420786209, 1636420786834, 625, 272, 353, 0, 1, 1
2091, 1, 1636420786400, 1636420787018, 618, 263, 355, 0, 1, 1
2092, 1, 1636420786685, 1636420787306, 621, 262, 359, 0, 0, 0
2093, 1, 1636420786706, 1636420787330, 624, 267, 357, 0, 0, 0
2094, 1, 1636420786713, 1636420787334, 621, 262, 359, 0, 0, 0
2095, 1, 1636420787230, 1636420787854, 624, 267, 357, 0, 1, 1
2096, 1, 1636420787383, 1636420788002, 619, 266, 353, 0, 0, 0
2097, 1, 1636420787695, 1636420788314, 619, 265, 354, 0, 0, 0
2098, 1, 1636420787702, 1636420788338, 636, 272, 364, 0, 0, 0
2099, 1, 1636420787711, 1636420788338, 627, 270, 357, 1, 0, 1
2100, 1, 1636420788228, 1636420788854, 626, 267, 359, 0, 0, 0
2101, 1, 1636420788368, 1636420788994, 626, 273, 353, 0, 0, 0
2102, 1, 1636420788667, 1636420789290, 623, 266, 357, 1, 0, 1
2103, 1, 1636420788696, 1636420789318, 622, 266, 356, 0, 0, 0
2104, 1, 1636420788714, 1636420789334, 620, 262, 358, 1, 0, 1
2105, 1, 1636420789215, 1636420789838, 623, 270, 353, 2, 0, 2
2106, 1, 1636420789370, 1636420789990, 620, 266, 354, 0, 0, 0
2107, 1, 1636420789631, 1636420790258, 627, 270, 357, 0, 0, 0
2108, 1, 1636420789708, 1636420790330, 622, 271, 351, 1, 2, 3
2109, 1, 1636420789732, 1636420790358, 626, 265, 361, 1, 0, 1
2110, 1, 1636420790192, 1636420790814, 622, 265, 357, 0, 0, 0
2111, 1, 1636420790596, 1636420791226, 630, 270, 360, 0, 1, 1
2112, 1, 1636420790700, 1636420791318, 618, 266, 352, 0, 1, 1
2113, 1, 1636420790717, 1636420791334, 617, 262, 355, 0, 0, 0
2114, 1, 1636420791181, 1636420791806, 625, 266, 359, 1, 0, 1
2115, 1, 1636420791599, 1636420792222, 623, 267, 356, 0, 1, 1
2116, 1, 1636420791685, 1636420792310, 625, 270, 355, 1, 0, 1
2117, 1, 1636420791752, 1636420792370, 618, 262, 356, 0, 0, 0
2118, 1, 1636420792190, 1636420792814, 624, 266, 358, 0, 0, 0
2119, 1, 1636420792571, 1636420793194, 623, 270, 353, 0, 1, 1
2120, 1, 1636420792701, 1636420793326, 625, 270, 355, 0, 0, 0
2121, 1, 1636420792738, 1636420793362, 624, 270, 354, 0, 0, 0
2122, 1, 1636420793168, 1636420793794, 626, 270, 356, 0, 0, 0
2123, 1, 1636420793542, 1636420794170, 628, 273, 355, 0, 0, 0
2124, 1, 1636420793730, 1636420794354, 624, 267, 357, 1, 0, 1
2125, 1, 1636420793756, 1636420794370, 614, 262, 352, 0, 0, 0
2126, 1, 1636420794151, 1636420794774, 623, 271, 352, 1, 1, 2
2127, 1, 1636420794511, 1636420795130, 619, 266, 353, 1, 0, 1
2080, 2, 1636420785044, 1636420795176, 10132, 1, 10131, 0, 1, 1
2128, 1, 1636420794730, 1636420795354, 624, 270, 354, 1, 1, 2
2129, 1, 1636420794734, 1636420795354, 620, 266, 354, 1, 0, 1
2130, 1, 1636420795177, 1636420795798, 621, 266, 355, 0, 0, 0
2086, 2, 1636420785774, 1636420795952, 10178, 0, 10178, 0, 0, 0
2131, 1, 1636420795306, 1636420795970, 664, 271, 393, 0, 0, 0
2087, 2, 1636420785846, 1636420796024, 10178, 1, 10177, 1, 1, 2
2088, 2, 1636420785847, 1636420796068, 10221, 0, 10221, 0, 0, 0
2089, 2, 1636420785850, 1636420796112, 10262, 1, 10261, 1, 0, 1
2134, 1, 1636420795733, 1636420796466, 733, 374, 359, 1, 109, 110
2133, 1, 1636420795718, 1636420796470, 752, 351, 401, 1, 83, 84
2135, 1, 1636420796145, 1636420796766, 621, 267, 354, 0, 0, 0
2137, 1, 1636420796263, 1636420796886, 623, 270, 353, 2, 0, 2
2136, 1, 1636420796242, 1636420796910, 668, 270, 398, 0, 0, 0
2140, 1, 1636420796318, 1636420797174, 856, 462, 394, 1, 1, 2
2141, 1, 1636420796725, 1636420797342, 617, 261, 356, 0, 0, 0
2142, 1, 1636420796739, 1636420797354, 615, 263, 352, 0, 0, 0
2139, 1, 1636420796314, 1636420797438, 1124, 725, 399, 1, 0, 1
2138, 1, 1636420796314, 1636420797702, 1388, 992, 396, 1, 0, 1
2143, 1, 1636420797127, 1636420797746, 619, 266, 353, 1, 0, 1
2144, 1, 1636420797200, 1636420797822, 622, 270, 352, 0, 0, 0
2145, 1, 1636420797273, 1636420797890, 617, 262, 355, 0, 0, 0
2146, 1, 1636420797280, 1636420798086, 806, 454, 352, 0, 1, 1
2147, 1, 1636420797456, 1636420798122, 666, 271, 395, 1, 1, 2
2149, 1, 1636420797745, 1636420798370, 625, 267, 358, 0, 0, 0
2148, 1, 1636420797719, 1636420798390, 671, 270, 401, 0, 0, 0
2150, 1, 1636420797772, 1636420798390, 618, 266, 352, 2, 0, 2
2151, 1, 1636420798135, 1636420798758, 623, 265, 358, 0, 0, 0
2152, 1, 1636420798168, 1636420798782, 614, 262, 352, 0, 0, 0
2153, 1, 1636420798249, 1636420798870, 621, 268, 353, 0, 1, 1
2154, 1, 1636420798278, 1636420799046, 768, 413, 355, 0, 0, 0
2155, 1, 1636420798480, 1636420799098, 618, 262, 356, 0, 0, 0
2157, 1, 1636420798737, 1636420799354, 617, 262, 355, 0, 0, 0
2156, 1, 1636420798736, 1636420799362, 626, 274, 352, 0, 0, 0
2158, 1, 1636420798745, 1636420799370, 625, 269, 356, 0, 0, 0
2159, 1, 1636420799158, 1636420799778, 620, 266, 354, 0, 0, 0
2160, 1, 1636420799183, 1636420799802, 619, 266, 353, 0, 0, 0
2161, 1, 1636420799266, 1636420799882, 616, 262, 354, 0, 0, 0
2162, 1, 1636420799295, 1636420800066, 771, 417, 354, 1, 0, 1
2163, 1, 1636420799459, 1636420800086, 627, 273, 354, 0, 0, 0
2164, 1, 1636420799705, 1636420800358, 653, 298, 355, 0, 0, 0
2166, 1, 1636420799748, 1636420800370, 622, 266, 356, 1, 0, 1
2168, 1, 1636420800168, 1636420800794, 626, 267, 359, 2, 0, 2
2167, 1, 1636420800167, 1636420800794, 627, 269, 358, 0, 0, 0
2170, 1, 1636420800299, 1636420800922, 623, 270, 353, 1, 1, 2
2169, 1, 1636420800274, 1636420801058, 784, 430, 354, 0, 1, 1
2171, 1, 1636420800457, 1636420801086, 629, 269, 360, 0, 0, 0
2172, 1, 1636420800676, 1636420801354, 678, 325, 353, 1, 0, 1
2174, 1, 1636420801155, 1636420801778, 623, 268, 355, 0, 0, 0
2175, 1, 1636420801186, 1636420801806, 620, 266, 354, 0, 1, 1
2177, 1, 1636420801274, 1636420801898, 624, 270, 354, 1, 1, 2
2176, 1, 1636420801254, 1636420802050, 796, 435, 361, 0, 0, 0
2178, 1, 1636420801485, 1636420802106, 621, 266, 355, 1, 0, 1
2179, 1, 1636420801686, 1636420802378, 692, 338, 354, 0, 1, 1
2180, 1, 1636420802185, 1636420802810, 625, 269, 356, 1, 0, 1
2181, 1, 1636420802215, 1636420802842, 627, 271, 356, 1, 1, 2
2183, 1, 1636420802280, 1636420802910, 630, 273, 357, 1, 0, 1
2182, 1, 1636420802253, 1636420803074, 821, 466, 355, 0, 0, 0
2184, 1, 1636420802489, 1636420803114, 625, 264, 361, 0, 0, 0
2185, 1, 1636420802715, 1636420803382, 667, 310, 357, 0, 0, 0
2187, 1, 1636420803221, 1636420803838, 617, 263, 354, 0, 0, 0
2186, 1, 1636420803220, 1636420803846, 626, 265, 361, 0, 0, 0
2189, 1, 1636420803297, 1636420803922, 625, 270, 355, 0, 1, 1
2188, 1, 1636420803261, 1636420804110, 849, 495, 354, 1, 0, 1
2190, 1, 1636420803502, 1636420804118, 616, 262, 354, 0, 0, 0
2191, 1, 1636420803743, 1636420804382, 639, 286, 353, 1, 0, 1
2192, 1, 1636420804207, 1636420804834, 627, 269, 358, 1, 0, 1
2193, 1, 1636420804241, 1636420804862, 621, 267, 354, 0, 0, 0
2195, 1, 1636420804297, 1636420804922, 625, 270, 355, 1, 0, 1
2194, 1, 1636420804258, 1636420805102, 844, 490, 354, 0, 0, 0
2132, 2, 1636420795499, 1636420805632, 10133, 0, 10133, 0, 0, 0
2198, 1, 1636420805175, 1636420805798, 623, 271, 352, 0, 2, 2
2200, 1, 1636420805267, 1636420805894, 627, 275, 352, 1, 10, 11
2201, 1, 1636420805280, 1636420805906, 626, 266, 360, 0, 0, 0
2199, 1, 1636420805252, 1636420806074, 822, 470, 352, 0, 10, 10
2202, 1, 1636420805766, 1636420806434, 668, 265, 403, 0, 0, 0
2203, 1, 1636420806142, 1636420806758, 616, 262, 354, 1, 0, 1
2205, 1, 1636420806298, 1636420806922, 624, 271, 353, 0, 2, 2
2206, 1, 1636420806305, 1636420806938, 633, 269, 364, 0, 0, 0
2204, 1, 1636420806246, 1636420807030, 784, 431, 353, 1, 1, 2
2207, 1, 1636420806719, 1636420807346, 627, 265, 362, 1, 0, 1
2208, 1, 1636420807111, 1636420807730, 619, 266, 353, 0, 0, 0
2211, 1, 1636420807277, 1636420807898, 621, 262, 359, 0, 0, 0
2210, 1, 1636420807274, 1636420807898, 624, 269, 355, 1, 0, 1
2209, 1, 1636420807247, 1636420807994, 747, 394, 353, 0, 0, 0
2212, 1, 1636420807729, 1636420808354, 625, 265, 360, 1, 0, 1
2214, 1, 1636420808256, 1636420808878, 622, 270, 352, 0, 0, 0
2216, 1, 1636420808296, 1636420808914, 618, 266, 352, 0, 0, 0
2217, 1, 1636420808705, 1636420809330, 625, 269, 356, 0, 1, 1
2218, 1, 1636420809236, 1636420809854, 618, 268, 350, 2, 1, 3
2165, 2, 1636420799722, 1636420809856, 10134, 0, 10134, 0, 1, 1
2219, 1, 1636420809279, 1636420809898, 619, 266, 353, 0, 1, 1
2220, 1, 1636420809721, 1636420810390, 669, 312, 357, 45, 0, 45
2222, 1, 1636420810242, 1636420810866, 624, 270, 354, 1, 0, 1
2173, 2, 1636420800782, 1636420810916, 10134, 1, 10133, 0, 0, 0
2223, 1, 1636420810313, 1636420810934, 621, 266, 355, 0, 0, 0
2224, 1, 1636420810745, 1636420811370, 625, 269, 356, 0, 0, 0
2225, 1, 1636420811050, 1636420811722, 672, 269, 403, 0, 0, 0
2226, 1, 1636420811221, 1636420811846, 625, 270, 355, 0, 1, 1
2227, 1, 1636420811343, 1636420811970, 627, 270, 357, 2, 0, 2
2228, 1, 1636420811720, 1636420812346, 626, 269, 357, 0, 0, 0
2229, 1, 1636420812025, 1636420812642, 617, 262, 355, 1, 0, 1
2230, 1, 1636420812227, 1636420812846, 619, 267, 352, 0, 2, 2
2231, 1, 1636420812316, 1636420812938, 622, 270, 352, 0, 1, 1
2232, 1, 1636420812727, 1636420813350, 623, 268, 355, 0, 0, 0
2233, 1, 1636420813057, 1636420813682, 625, 270, 355, 0, 0, 0
2234, 1, 1636420813242, 1636420813866, 624, 271, 353, 0, 0, 0
2235, 1, 1636420813762, 1636420814390, 628, 269, 359, 0, 0, 0
2196, 2, 1636420804488, 1636420814624, 10136, 1, 10135, 0, 0, 0
2236, 1, 1636420814042, 1636420814658, 616, 264, 352, 1, 0, 1
2197, 2, 1636420804714, 1636420814848, 10134, 0, 10134, 0, 0, 0
2237, 1, 1636420814232, 1636420814890, 658, 306, 352, 0, 44, 44
2238, 1, 1636420814762, 1636420815382, 620, 266, 354, 1, 0, 1
2239, 1, 1636420814978, 1636420815646, 668, 270, 398, 0, 1, 1
2241, 1, 1636420815034, 1636420815658, 624, 266, 358, 0, 0, 0
2242, 1, 1636420815254, 1636420815870, 616, 262, 354, 0, 0, 0
2240, 1, 1636420815014, 1636420815918, 904, 502, 402, 0, 1, 1
2243, 1, 1636420815745, 1636420816370, 625, 269, 356, 1, 0, 1
2244, 1, 1636420815937, 1636420816566, 629, 274, 355, 1, 0, 1
2246, 1, 1636420816002, 1636420816626, 624, 268, 356, 0, 0, 0
2245, 1, 1636420815969, 1636420816830, 861, 506, 355, 0, 1, 1
2247, 1, 1636420816266, 1636420816882, 616, 262, 354, 0, 0, 0
2248, 1, 1636420816770, 1636420817394, 624, 266, 358, 0, 0, 0
2249, 1, 1636420816924, 1636420817542, 618, 266, 352, 0, 0, 0
2251, 1, 1636420817007, 1636420817630, 623, 270, 353, 0, 1, 1
2250, 1, 1636420816962, 1636420817810, 848, 495, 353, 0, 2, 2
2252, 1, 1636420817247, 1636420817862, 615, 262, 353, 1, 0, 1
2213, 2, 1636420808133, 1636420818268, 10135, 1, 10134, 1, 0, 1
2253, 1, 1636420817762, 1636420818386, 624, 270, 354, 0, 1, 1
2215, 2, 1636420808267, 1636420818400, 10133, 0, 10133, 0, 1, 1
2254, 1, 1636420817948, 1636420818570, 622, 269, 353, 0, 0, 0
2256, 1, 1636420817997, 1636420818666, 669, 313, 356, 1, 41, 42
2255, 1, 1636420817968, 1636420818846, 878, 521, 357, 1, 6, 7
2257, 1, 1636420818277, 1636420818934, 657, 264, 393, 0, 1, 1
2258, 1, 1636420818402, 1636420819078, 676, 279, 397, 2, 0, 2
2259, 1, 1636420818530, 1636420819350, 820, 422, 398, 0, 0, 0
2260, 1, 1636420818783, 1636420819402, 619, 265, 354, 0, 0, 0
2261, 1, 1636420818970, 1636420819590, 620, 267, 353, 0, 0, 0
2263, 1, 1636420819012, 1636420819638, 626, 274, 352, 0, 0, 0
2262, 1, 1636420818974, 1636420819866, 892, 533, 359, 0, 0, 0
2264, 1, 1636420819267, 1636420819886, 619, 262, 357, 0, 0, 0
2265, 1, 1636420819350, 1636420819966, 616, 262, 354, 0, 0, 0
2221, 2, 1636420809986, 1636420820164, 10178, 1, 10177, 0, 0, 0
2266, 1, 1636420819483, 1636420820234, 751, 394, 357, 0, 1, 1
2267, 1, 1636420819768, 1636420820434, 666, 303, 363, 0, 30, 30
2268, 1, 1636420819952, 1636420820618, 666, 307, 359, 2, 39, 41
2270, 1, 1636420820003, 1636420820626, 623, 268, 355, 0, 0, 0
2271, 1, 1636420820259, 1636420820882, 623, 266, 357, 1, 0, 1
2273, 1, 1636420820322, 1636420820950, 628, 269, 359, 0, 0, 0
2272, 1, 1636420820294, 1636420820962, 668, 267, 401, 0, 0, 0
2274, 1, 1636420820473, 1636420821214, 741, 386, 355, 1, 0, 1
2275, 1, 1636420820780, 1636420821398, 618, 266, 352, 0, 0, 0
2276, 1, 1636420820971, 1636420821598, 627, 269, 358, 1, 0, 1
2277, 1, 1636420820997, 1636420821622, 625, 270, 355, 1, 0, 1
2278, 1, 1636420821247, 1636420821866, 619, 266, 353, 0, 0, 0
2279, 1, 1636420821256, 1636420821874, 618, 262, 356, 0, 0, 0
2280, 1, 1636420821312, 1636420821934, 622, 270, 352, 1, 0, 1
2281, 1, 1636420821465, 1636420822202, 737, 379, 358, 0, 1, 1
2282, 1, 1636420821810, 1636420822438, 628, 270, 358, 0, 0, 0
2283, 1, 1636420821999, 1636420822618, 619, 267, 352, 1, 0, 1
2285, 1, 1636420822256, 1636420822878, 622, 270, 352, 0, 0, 0
2286, 1, 1636420822285, 1636420822910, 625, 266, 359, 1, 0, 1
2287, 1, 1636420822321, 1636420822946, 625, 271, 354, 0, 0, 0
2288, 1, 1636420822468, 1636420823210, 742, 390, 352, 2, 0, 2
2289, 1, 1636420822783, 1636420823406, 623, 269, 354, 1, 0, 1
2290, 1, 1636420823008, 1636420823678, 670, 315, 355, 2, 1, 3
2291, 1, 1636420823232, 1636420823850, 618, 267, 351, 0, 1, 1
2292, 1, 1636420823257, 1636420823882, 625, 270, 355, 0, 0, 0
2293, 1, 1636420823298, 1636420823922, 624, 270, 354, 0, 1, 1
2294, 1, 1636420823464, 1636420824190, 726, 374, 352, 0, 1, 1
2295, 1, 1636420824008, 1636420824642, 634, 274, 360, 1, 0, 1
2297, 1, 1636420824231, 1636420824854, 623, 267, 356, 2, 0, 2
2296, 1, 1636420824228, 1636420824854, 626, 269, 357, 0, 0, 0
2298, 1, 1636420824282, 1636420824898, 616, 263, 353, 1, 0, 1
2299, 1, 1636420824445, 1636420825170, 725, 372, 353, 2, 1, 3
2301, 1, 1636420825195, 1636420825814, 619, 267, 352, 0, 2, 2
2302, 1, 1636420825202, 1636420825822, 620, 263, 357, 0, 0, 0
2303, 1, 1636420825290, 1636420825906, 616, 262, 354, 1, 0, 1
2305, 1, 1636420826166, 1636420826806, 640, 270, 370, 0, 0, 0
2307, 1, 1636420826288, 1636420826910, 622, 269, 353, 1, 0, 1
2308, 1, 1636420827163, 1636420827782, 619, 266, 353, 1, 0, 1
2310, 1, 1636420828201, 1636420828822, 621, 266, 355, 0, 0, 0
2311, 1, 1636420829173, 1636420829794, 621, 262, 359, 0, 0, 0
2269, 2, 1636420819970, 1636420830535, 10565, 381, 10184, 0, 1, 1
2312, 1, 1636420830144, 1636420830802, 658, 304, 354, 1, 34, 35
2300, 1, 1636420824989, 1636420830982, 5993, 5637, 356, 1, 6, 7
2313, 1, 1636420830622, 1636420831294, 672, 270, 402, 0, 0, 0
2314, 1, 1636420830984, 1636420831646, 662, 266, 396, 1, 0, 1
2315, 1, 1636420831111, 1636420831734, 623, 272, 351, 1, 1, 2
2284, 2, 1636420822004, 1636420832140, 10136, 1, 10135, 0, 1, 1
2316, 1, 1636420831557, 1636420832182, 625, 267, 358, 0, 2, 2
2317, 1, 1636420831985, 1636420832614, 629, 265, 364, 0, 0, 0
2319, 1, 1636420832271, 1636420832930, 659, 263, 396, 1, 0, 1
2321, 1, 1636420832965, 1636420833594, 629, 269, 360, 1, 1, 2
2322, 1, 1636420833230, 1636420833862, 632, 278, 354, 1, 0, 1
2323, 1, 1636420833962, 1636420834594, 632, 272, 360, 0, 0, 0
2324, 1, 1636420834256, 1636420834883, 627, 268, 359, 0, 0, 0
2325, 1, 1636420834948, 1636420835574, 626, 269, 357, 0, 0, 0
2326, 1, 1636420835241, 1636420835874, 633, 268, 365, 0, 0, 0
2304, 2, 1636420825464, 1636420835959, 10495, 267, 10228, 1, 0, 1
2306, 2, 1636420826186, 1636420836320, 10134, 0, 10134, 0, 1, 1
2327, 1, 1636420835960, 1636420836586, 626, 272, 354, 0, 3, 3
2329, 1, 1636420836230, 1636420836854, 624, 265, 359, 0, 0, 0
2330, 1, 1636420836450, 1636420837118, 668, 270, 398, 1, 0, 1
2309, 2, 1636420827269, 1636420837404, 10135, 1, 10134, 0, 0, 0
2331, 1, 1636420836930, 1636420837554, 624, 270, 354, 1, 0, 1
2332, 1, 1636420837198, 1636420837854, 656, 297, 359, 0, 31, 31
2333, 1, 1636420837404, 1636420838026, 622, 270, 352, 0, 0, 0
2335, 1, 1636420837937, 1636420838562, 625, 268, 357, 0, 0, 0
2336, 1, 1636420838233, 1636420838862, 629, 274, 355, 1, 0, 1
2337, 1, 1636420838414, 1636420839038, 624, 270, 354, 0, 0, 0
2338, 1, 1636420838949, 1636420839574, 625, 266, 359, 0, 0, 0
2339, 1, 1636420839203, 1636420839826, 623, 269, 354, 0, 1, 1
2340, 1, 1636420839390, 1636420840014, 624, 266, 358, 1, 0, 1
2341, 1, 1636420839941, 1636420840566, 625, 267, 358, 1, 1, 2
2342, 1, 1636420840236, 1636420840858, 622, 269, 353, 0, 1, 1
2343, 1, 1636420840407, 1636420841022, 615, 261, 354, 0, 0, 0
2344, 1, 1636420840944, 1636420841566, 622, 269, 353, 0, 0, 0
2345, 1, 1636420841225, 1636420841850, 625, 270, 355, 0, 0, 0
2346, 1, 1636420841440, 1636420842058, 618, 263, 355, 0, 0, 0
2318, 2, 1636420832140, 1636420842272, 10132, 0, 10132, 1, 0, 1
2347, 1, 1636420841959, 1636420842630, 671, 313, 358, 0, 47, 47
2320, 2, 1636420832533, 1636420842843, 10310, 133, 10177, 0, 1, 1
2348, 1, 1636420842219, 1636420842858, 639, 269, 370, 0, 0, 0
2350, 1, 1636420842432, 1636420843110, 678, 324, 354, 0, 54, 54
2349, 1, 1636420842402, 1636420843114, 712, 308, 404, 0, 42, 42
2328, 1, 1636420836047, 1636420843290, 7243, 6846, 397, 1, 2, 3
2352, 1, 1636420842950, 1636420843570, 620, 267, 353, 1, 0, 1
2351, 1, 1636420842930, 1636420843602, 672, 269, 403, 0, 0, 0
2353, 1, 1636420843255, 1636420843878, 623, 270, 353, 0, 0, 0
2355, 1, 1636420843352, 1636420843966, 614, 263, 351, 0, 0, 0
2354, 1, 1636420843329, 1636420843990, 661, 267, 394, 1, 0, 1
2356, 1, 1636420843456, 1636420844074, 618, 267, 351, 0, 1, 1
2357, 1, 1636420843888, 1636420844506, 618, 263, 355, 1, 0, 1
2358, 1, 1636420843959, 1636420844582, 623, 269, 354, 0, 0, 0
2359, 1, 1636420844265, 1636420844894, 629, 267, 362, 1, 0, 1
2360, 1, 1636420844336, 1636420844962, 626, 270, 356, 0, 1, 1
2361, 1, 1636420844375, 1636420845002, 627, 274, 353, 0, 1, 1
2362, 1, 1636420844470, 1636420845090, 620, 268, 352, 0, 1, 1
2363, 1, 1636420844856, 1636420845478, 622, 270, 352, 0, 1, 1
2364, 1, 1636420844930, 1636420845566, 636, 269, 367, 0, 0, 0
2365, 1, 1636420845284, 1636420845906, 622, 268, 354, 0, 0, 0
2366, 1, 1636420845326, 1636420845950, 624, 271, 353, 2, 0, 2
2367, 1, 1636420845352, 1636420845982, 630, 274, 356, 0, 0, 0
2368, 1, 1636420845469, 1636420846094, 625, 267, 358, 0, 1, 1
2369, 1, 1636420845840, 1636420846470, 630, 272, 358, 0, 0, 0
2370, 1, 1636420845896, 1636420846522, 626, 268, 358, 1, 0, 1
2371, 1, 1636420846253, 1636420846874, 621, 266, 355, 0, 0, 0
2372, 1, 1636420846357, 1636420846978, 621, 266, 355, 2, 0, 2
2373, 1, 1636420846357, 1636420846978, 621, 265, 356, 1, 0, 1
2374, 1, 1636420846452, 1636420847070, 618, 265, 353, 0, 0, 0
2375, 1, 1636420846859, 1636420847482, 623, 266, 357, 1, 0, 1
2376, 1, 1636420846893, 1636420847510, 617, 265, 352, 1, 0, 1
2334, 2, 1636420837534, 1636420847712, 10178, 0, 10178, 0, 0, 0
2378, 1, 1636420847348, 1636420847978, 630, 276, 354, 0, 6, 6
2379, 1, 1636420847359, 1636420847978, 619, 265, 354, 1, 2, 3
2380, 1, 1636420847452, 1636420848066, 614, 262, 352, 0, 0, 0
2382, 1, 1636420847848, 1636420848466, 618, 267, 351, 1, 0, 1
2381, 1, 1636420847842, 1636420848506, 664, 267, 397, 0, 0, 0
2383, 1, 1636420847893, 1636420848510, 617, 263, 354, 0, 0, 0
2385, 1, 1636420848351, 1636420848970, 619, 266, 353, 0, 0, 0
2384, 1, 1636420848347, 1636420848970, 623, 271, 352, 0, 1, 1
2386, 1, 1636420848431, 1636420849050, 619, 266, 353, 0, 0, 0
2387, 1, 1636420848808, 1636420849430, 622, 266, 356, 0, 1, 1
2389, 1, 1636420848865, 1636420849490, 625, 270, 355, 0, 1, 1
2390, 1, 1636420849348, 1636420849966, 618, 266, 352, 1, 0, 1
2391, 1, 1636420849357, 1636420849982, 625, 267, 358, 0, 0, 0
2392, 1, 1636420849453, 1636420850074, 621, 263, 358, 0, 0, 0
2393, 1, 1636420849798, 1636420850418, 620, 266, 354, 0, 0, 0
2394, 1, 1636420849847, 1636420850470, 623, 269, 354, 0, 0, 0
2395, 1, 1636420850359, 1636420850982, 623, 270, 353, 1, 0, 1
2396, 1, 1636420850392, 1636420851010, 618, 266, 352, 0, 0, 0
2397, 1, 1636420850437, 1636420851054, 617, 262, 355, 0, 0, 0
2398, 1, 1636420850792, 1636420851410, 618, 266, 352, 1, 0, 1
2399, 1, 1636420850819, 1636420851442, 623, 269, 354, 1, 0, 1
2400, 1, 1636420851362, 1636420851982, 620, 265, 355, 0, 0, 0
2401, 1, 1636420851377, 1636420852010, 633, 274, 359, 0, 0, 0
2402, 1, 1636420851471, 1636420852090, 619, 267, 352, 0, 1, 1
2403, 1, 1636420851783, 1636420852402, 619, 265, 354, 0, 1, 1
2404, 1, 1636420851828, 1636420852450, 622, 270, 352, 1, 0, 1
2405, 1, 1636420852345, 1636420852966, 621, 266, 355, 0, 0, 0
2406, 1, 1636420852357, 1636420852990, 633, 274, 359, 2, 0, 2
2407, 1, 1636420852781, 1636420853410, 629, 269, 360, 0, 0, 0
2408, 1, 1636420852837, 1636420853462, 625, 270, 355, 0, 1, 1
2410, 1, 1636420853369, 1636420853994, 625, 269, 356, 0, 1, 1
2411, 1, 1636420853782, 1636420854414, 632, 273, 359, 0, 0, 0
2412, 1, 1636420853855, 1636420854486, 631, 268, 363, 0, 0, 0
2413, 1, 1636420854361, 1636420854986, 625, 269, 356, 1, 0, 1
2414, 1, 1636420854747, 1636420855378, 631, 276, 355, 1, 1, 2
2415, 1, 1636420854835, 1636420855458, 623, 269, 354, 1, 0, 1
2416, 1, 1636420855383, 1636420856006, 623, 270, 353, 2, 0, 2
2417, 1, 1636420855718, 1636420856342, 624, 271, 353, 1, 0, 1
2419, 1, 1636420856369, 1636420856994, 625, 271, 354, 2, 0, 2
2420, 1, 1636420856685, 1636420857310, 625, 266, 359, 0, 1, 1
2377, 2, 1636420847232, 1636420857364, 10132, 0, 10132, 0, 0, 0
2421, 1, 1636420857382, 1636420858010, 628, 269, 359, 1, 0, 1
2422, 1, 1636420857494, 1636420858162, 668, 268, 400, 0, 0, 0
2388, 2, 1636420848840, 1636420858972, 10132, 0, 10132, 0, 0, 0
2424, 1, 1636420858449, 1636420859078, 629, 270, 359, 1, 0, 1
2426, 1, 1636420859447, 1636420860074, 627, 270, 357, 0, 2, 2
2427, 1, 1636420860427, 1636420861054, 627, 270, 357, 1, 0, 1
2428, 1, 1636420861434, 1636420862058, 624, 270, 354, 1, 1, 2
2429, 1, 1636420862412, 1636420863046, 634, 274, 360, 1, 0, 1
2409, 2, 1636420853348, 1636420863480, 10132, 0, 10132, 0, 0, 0
2430, 1, 1636420863427, 1636420864058, 631, 265, 366, 1, 0, 1
2431, 1, 1636420863610, 1636420864278, 668, 269, 399, 1, 0, 1
2432, 1, 1636420864436, 1636420865058, 622, 270, 352, 1, 0, 1
2433, 1, 1636420864564, 1636420865186, 622, 270, 352, 1, 0, 1
2418, 2, 1636420855814, 1636420865949, 10135, 0, 10135, 0, 1, 1
2434, 1, 1636420865428, 1636420866058, 630, 268, 362, 0, 0, 0
2435, 1, 1636420865544, 1636420866214, 670, 270, 400, 0, 1, 1
2436, 1, 1636420866078, 1636420866750, 672, 270, 402, 0, 1, 1
2437, 1, 1636420866438, 1636420867065, 627, 269, 358, 1, 0, 1
2438, 1, 1636420866536, 1636420867158, 622, 270, 352, 2, 0, 2
2439, 1, 1636420867032, 1636420867650, 618, 263, 355, 1, 1, 2
2423, 2, 1636420857676, 1636420867807, 10131, 0, 10131, 0, 0, 0
2440, 1, 1636420867451, 1636420868074, 623, 269, 354, 1, 0, 1
2441, 1, 1636420867544, 1636420868166, 622, 269, 353, 0, 0, 0
2442, 1, 1636420867938, 1636420868610, 672, 269, 403, 0, 0, 0
2443, 1, 1636420868003, 1636420868622, 619, 267, 352, 1, 1, 2
2444, 1, 1636420868449, 1636420869078, 629, 275, 354, 1, 1, 2
2445, 1, 1636420868522, 1636420869150, 628, 268, 360, 0, 0, 0
2425, 2, 1636420859102, 1636420869280, 10178, 1, 10177, 0, 0, 0
2446, 1, 1636420868893, 1636420869546, 653, 297, 356, 1, 30, 31
2447, 1, 1636420868969, 1636420869638, 669, 310, 359, 1, 43, 44
2448, 1, 1636420869410, 1636420870082, 672, 268, 404, 0, 0, 0
2449, 1, 1636420869467, 1636420870090, 623, 266, 357, 0, 0, 0
2450, 1, 1636420869530, 1636420870158, 628, 274, 354, 0, 1, 1
2451, 1, 1636420869893, 1636420870518, 625, 266, 359, 0, 0, 0
2452, 1, 1636420869977, 1636420870602, 625, 269, 356, 0, 0, 0
2453, 1, 1636420870390, 1636420871014, 624, 268, 356, 2, 0, 2
2454, 1, 1636420870439, 1636420871058, 619, 266, 353, 0, 0, 0
2455, 1, 1636420870541, 1636420871170, 629, 266, 363, 1, 0, 1
2456, 1, 1636420870868, 1636420871486, 618, 265, 353, 0, 0, 0
2457, 1, 1636420870955, 1636420871578, 623, 268, 355, 1, 1, 2
2458, 1, 1636420871380, 1636420872002, 622, 265, 357, 0, 0, 0
2459, 1, 1636420871427, 1636420872050, 623, 268, 355, 0, 0, 0
2460, 1, 1636420871524, 1636420872142, 618, 266, 352, 1, 0, 1
2461, 1, 1636420871896, 1636420872522, 626, 269, 357, 0, 1, 1
2462, 1, 1636420871964, 1636420872578, 614, 261, 353, 0, 0, 0
2463, 1, 1636420872374, 1636420872994, 620, 266, 354, 1, 0, 1
2464, 1, 1636420872424, 1636420873042, 618, 267, 351, 0, 0, 0
2465, 1, 1636420872541, 1636420873162, 621, 266, 355, 1, 0, 1
2466, 1, 1636420872897, 1636420873526, 629, 275, 354, 0, 1, 1
2467, 1, 1636420872977, 1636420873598, 621, 265, 356, 1, 0, 1
2468, 1, 1636420873374, 1636420873998, 624, 269, 355, 1, 0, 1
2469, 1, 1636420873424, 1636420874042, 618, 267, 351, 0, 1, 1
2470, 1, 1636420873555, 1636420874178, 623, 271, 352, 1, 1, 2
2471, 1, 1636420873867, 1636420874494, 627, 270, 357, 1, 0, 1
2472, 1, 1636420873968, 1636420874594, 626, 265, 361, 0, 0, 0
2473, 1, 1636420874385, 1636420875006, 621, 266, 355, 0, 1, 1
2474, 1, 1636420874397, 1636420875022, 625, 265, 360, 0, 0, 0
2475, 1, 1636420874553, 1636420875178, 625, 270, 355, 0, 0, 0
2476, 1, 1636420874874, 1636420875502, 628, 265, 363, 0, 0, 0
2477, 1, 1636420874972, 1636420875598, 626, 270, 356, 0, 0, 0
2478, 1, 1636420875379, 1636420875998, 619, 266, 353, 0, 0, 0
2479, 1, 1636420875402, 1636420876026, 624, 269, 355, 1, 0, 1
2480, 1, 1636420875560, 1636420876178, 618, 266, 352, 0, 0, 0
2481, 1, 1636420875911, 1636420876534, 623, 266, 357, 1, 0, 1
2482, 1, 1636420875987, 1636420876610, 623, 267, 356, 0, 0, 0
2483, 1, 1636420876350, 1636420876966, 616, 262, 354, 0, 0, 0
2484, 1, 1636420876371, 1636420876990, 619, 267, 352, 0, 1, 1
2485, 1, 1636420876534, 1636420877158, 624, 266, 358, 1, 0, 1
2486, 1, 1636420876910, 1636420877530, 620, 262, 358, 0, 0, 0
2487, 1, 1636420876985, 1636420877602, 617, 262, 355, 0, 0, 0
2488, 1, 1636420877325, 1636420877950, 625, 270, 355, 2, 0, 2
2490, 1, 1636420877522, 1636420878150, 628, 270, 358, 0, 0, 0
2491, 1, 1636420877894, 1636420878518, 624, 266, 358, 1, 0, 1
2492, 1, 1636420878016, 1636420878638, 622, 271, 351, 1, 1, 2
2493, 1, 1636420878289, 1636420878918, 629, 270, 359, 0, 0, 0
2494, 1, 1636420878519, 1636420879146, 627, 266, 361, 0, 0, 0
2495, 1, 1636420878919, 1636420879546, 627, 270, 357, 1, 1, 2
2496, 1, 1636420878987, 1636420879614, 627, 270, 357, 0, 0, 0
2497, 1, 1636420879291, 1636420879914, 623, 270, 353, 1, 0, 1
2498, 1, 1636420879491, 1636420880114, 623, 266, 357, 0, 0, 0
2499, 1, 1636420879911, 1636420880534, 623, 270, 353, 0, 1, 1
2500, 1, 1636420879976, 1636420880598, 622, 268, 354, 0, 0, 0
2501, 1, 1636420880263, 1636420880886, 623, 269, 354, 0, 0, 0
2502, 1, 1636420880468, 1636420881082, 614, 265, 349, 0, 0, 0
2503, 1, 1636420880934, 1636420881558, 624, 267, 357, 0, 0, 0
2504, 1, 1636420880972, 1636420881594, 622, 271, 351, 0, 1, 1
2505, 1, 1636420881234, 1636420881858, 624, 271, 353, 1, 0, 1
2506, 1, 1636420881466, 1636420882086, 620, 266, 354, 0, 0, 0
2507, 1, 1636420881944, 1636420882562, 618, 265, 353, 0, 0, 0
2508, 1, 1636420882201, 1636420882826, 625, 270, 355, 0, 1, 1
2509, 1, 1636420882438, 1636420883054, 616, 262, 354, 0, 0, 0
2510, 1, 1636420882920, 1636420883546, 626, 270, 356, 0, 0, 0
2512, 1, 1636420883412, 1636420884034, 622, 267, 355, 1, 1, 2
2513, 1, 1636420883902, 1636420884530, 628, 270, 358, 1, 0, 1
2514, 1, 1636420884378, 1636420885002, 624, 269, 355, 0, 0, 0
2515, 1, 1636420884873, 1636420885498, 625, 270, 355, 0, 2, 2
2516, 1, 1636420885413, 1636420886034, 621, 266, 355, 0, 1, 1
2517, 1, 1636420885838, 1636420886462, 624, 269, 355, 1, 0, 1
2518, 1, 1636420886384, 1636420887006, 622, 267, 355, 1, 1, 2
2519, 1, 1636420886803, 1636420887422, 619, 266, 353, 0, 0, 0
2489, 2, 1636420877350, 1636420887483, 10133, 0, 10133, 0, 0, 0
2520, 1, 1636420887355, 1636420888010, 655, 261, 394, 0, 0, 0
2521, 1, 1636420887614, 1636420888274, 660, 263, 397, 0, 0, 0
2522, 1, 1636420887840, 1636420888454, 614, 262, 352, 0, 0, 0
2523, 1, 1636420888322, 1636420888946, 624, 270, 354, 0, 0, 0
2524, 1, 1636420888568, 1636420889181, 613, 263, 350, 0, 2, 2
2525, 1, 1636420888839, 1636420889454, 615, 264, 351, 0, 1, 1
2527, 1, 1636420889540, 1636420890154, 614, 264, 350, 1, 2, 3
2528, 1, 1636420889832, 1636420890446, 614, 263, 351, 0, 0, 0
2529, 1, 1636420890504, 1636420891118, 614, 263, 351, 1, 0, 1
2530, 1, 1636420890811, 1636420891430, 619, 265, 354, 0, 0, 0
2531, 1, 1636420891536, 1636420892150, 614, 262, 352, 0, 0, 0
2533, 1, 1636420892519, 1636420893146, 627, 275, 352, 0, 1, 1
2511, 2, 1636420883192, 1636420893323, 10131, 0, 10131, 0, 0, 0
2534, 1, 1636420893454, 1636420894117, 663, 265, 398, 0, 0, 0
2535, 1, 1636420893527, 1636420894146, 619, 265, 354, 0, 0, 0
2536, 1, 1636420894411, 1636420895030, 619, 266, 353, 0, 0, 0
2537, 1, 1636420894539, 1636420895158, 619, 264, 355, 0, 0, 0
2538, 1, 1636420895436, 1636420896066, 630, 270, 360, 0, 2, 2
2539, 1, 1636420895530, 1636420896154, 624, 267, 357, 1, 2, 3
2540, 1, 1636420896409, 1636420897042, 633, 269, 364, 1, 0, 1
2541, 1, 1636420896533, 1636420897158, 625, 270, 355, 1, 0, 1
2542, 1, 1636420897414, 1636420898038, 624, 267, 357, 0, 1, 1
2543, 1, 1636420897548, 1636420898174, 626, 270, 356, 0, 1, 1
2544, 1, 1636420898414, 1636420899042, 628, 269, 359, 1, 0, 1
2545, 1, 1636420898545, 1636420899310, 765, 409, 356, 1, 0, 1
2526, 2, 1636420889313, 1636420899448, 10135, 0, 10135, 1, 0, 1
2546, 1, 1636420899390, 1636420900042, 652, 281, 371, 0, 1, 1
2547, 1, 1636420899567, 1636420900190, 623, 268, 355, 0, 0, 0
2548, 1, 1636420899578, 1636420900246, 668, 266, 402, 0, 0, 0
2549, 1, 1636420900410, 1636420901030, 620, 266, 354, 0, 0, 0
2550, 1, 1636420900532, 1636420901150, 618, 262, 356, 0, 0, 0
2551, 1, 1636420900538, 1636420901158, 620, 262, 358, 1, 0, 1
2532, 2, 1636420891800, 1636420901932, 10132, 0, 10132, 0, 0, 0
2552, 1, 1636420901446, 1636420902074, 628, 269, 359, 0, 0, 0
2553, 1, 1636420901526, 1636420902198, 672, 315, 357, 0, 47, 47
2554, 1, 1636420901557, 1636420902198, 641, 285, 356, 1, 22, 23
2555, 1, 1636420902062, 1636420902726, 664, 268, 396, 1, 1, 2
2556, 1, 1636420902421, 1636420903046, 625, 266, 359, 0, 0, 0
2557, 1, 1636420902498, 1636420903122, 624, 270, 354, 0, 0, 0
2558, 1, 1636420902553, 1636420903174, 621, 266, 355, 0, 0, 0
2559, 1, 1636420903020, 1636420903642, 622, 266, 356, 0, 1, 1
2560, 1, 1636420903404, 1636420904022, 618, 266, 352, 0, 0, 0
2561, 1, 1636420903468, 1636420904086, 618, 266, 352, 0, 0, 0
2562, 1, 1636420903569, 1636420904190, 621, 263, 358, 0, 0, 0
2563, 1, 1636420904030, 1636420904658, 628, 269, 359, 1, 0, 1
2564, 1, 1636420904404, 1636420905034, 630, 278, 352, 0, 0, 0
2565, 1, 1636420904441, 1636420905070, 629, 270, 359, 0, 0, 0
2566, 1, 1636420904570, 1636420905198, 628, 270, 358, 0, 1, 1
2567, 1, 1636420905007, 1636420905638, 631, 275, 356, 1, 0, 1
2568, 1, 1636420905441, 1636420906062, 621, 266, 355, 0, 0, 0
2569, 1, 1636420905545, 1636420906166, 621, 266, 355, 0, 0, 0
2570, 1, 1636420906012, 1636420906634, 622, 267, 355, 0, 0, 0
2571, 1, 1636420906412, 1636420907046, 634, 267, 367, 2, 0, 2
2572, 1, 1636420906551, 1636420907174, 623, 270, 353, 0, 1, 1
2573, 1, 1636420907013, 1636420907642, 629, 270, 359, 1, 1, 2
2574, 1, 1636420907397, 1636420908022, 625, 269, 356, 0, 1, 1
2575, 1, 1636420907586, 1636420908210, 624, 268, 356, 1, 1, 2
2576, 1, 1636420907984, 1636420908606, 622, 271, 351, 1, 2, 3
2577, 1, 1636420908362, 1636420908986, 624, 270, 354, 1, 1, 2
2578, 1, 1636420908586, 1636420909210, 624, 268, 356, 1, 1, 2
2579, 1, 1636420908990, 1636420909614, 624, 269, 355, 0, 0, 0
2580, 1, 1636420909396, 1636420910018, 622, 269, 353, 1, 0, 1
2581, 1, 1636420909569, 1636420910194, 625, 269, 356, 1, 0, 1
2582, 1, 1636420910026, 1636420910650, 624, 269, 355, 0, 1, 1
2583, 1, 1636420910369, 1636420910994, 625, 268, 357, 0, 0, 0
2584, 1, 1636420910593, 1636420911218, 625, 267, 358, 1, 1, 2
2585, 1, 1636420911025, 1636420911650, 625, 266, 359, 0, 0, 0
2586, 1, 1636420911340, 1636420911962, 622, 267, 355, 2, 0, 2
2587, 1, 1636420912008, 1636420912630, 622, 269, 353, 0, 0, 0
2588, 1, 1636420912307, 1636420912934, 627, 270, 357, 0, 1, 1
2589, 1, 1636420913032, 1636420913658, 626, 270, 356, 0, 0, 0
2590, 2, 1636420913298, 1636420923435, 10137, 1, 10136, 1, 0, 1
2591, 1, 1636420923563, 1636420924234, 671, 270, 401, 0, 1, 1
2592, 1, 1636420924517, 1636420925142, 625, 269, 356, 1, 0, 1
2593, 1, 1636420925526, 1636420926150, 624, 271, 353, 3, 0, 3
2594, 1, 1636420926501, 1636420927126, 625, 269, 356, 1, 0, 1
2595, 1, 1636420927519, 1636420928146, 627, 269, 358, 1, 0, 1
2596, 1, 1636420928521, 1636420929146, 625, 269, 356, 0, 1, 1
2597, 1, 1636420929496, 1636420930122, 626, 270, 356, 1, 1, 2
2598, 1, 1636420930502, 1636420931126, 624, 270, 354, 1, 0, 1
2599, 1, 1636420931538, 1636420932166, 628, 269, 359, 0, 0, 0
2600, 1, 1636420932538, 1636420933166, 628, 269, 359, 0, 0, 0
2601, 1, 1636421195312, 1636421195938, 626, 274, 352, 2, 0, 2
2602, 1, 1636421195940, 1636421196602, 662, 267, 395, 0, 2, 2
2603, 1, 1636421196160, 1636421196782, 622, 272, 350, 0, 2, 2
2604, 1, 1636421196604, 1636421197270, 666, 271, 395, 3, 2, 5
2605, 1, 1636421196784, 1636421197450, 666, 270, 396, 1, 0, 1
2606, 1, 1636421196881, 1636421197498, 617, 263, 354, 1, 1, 2
2607, 1, 1636421197272, 1636421197938, 666, 271, 395, 2, 1, 3
2609, 1, 1636421197494, 1636421198118, 624, 268, 356, 0, 0, 0
2608, 1, 1636421197452, 1636421198126, 674, 269, 405, 0, 1, 1
2610, 1, 1636421197499, 1636421198158, 659, 263, 396, 0, 1, 1
2611, 1, 1636421197940, 1636421198610, 670, 268, 402, 0, 0, 0
2613, 1, 1636421198126, 1636421198746, 620, 267, 353, 2, 0, 2
2612, 1, 1636421198120, 1636421198786, 666, 266, 400, 1, 0, 1
2614, 1, 1636421198127, 1636421198794, 667, 271, 396, 1, 0, 1
2615, 1, 1636421198160, 1636421198822, 662, 263, 399, 1, 0, 1
2616, 1, 1636421198612, 1636421199278, 666, 270, 396, 1, 0, 1
2617, 1, 1636421198674, 1636421199302, 628, 273, 355, 1, 0, 1
2618, 1, 1636421198748, 1636421199414, 666, 264, 402, 0, 0, 0
2619, 1, 1636421198788, 1636421199454, 666, 269, 397, 1, 0, 1
2620, 1, 1636421198796, 1636421199458, 662, 263, 399, 1, 0, 1
2621, 1, 1636421198824, 1636421199494, 670, 271, 399, 2, 0, 2
2623, 1, 1636421199318, 1636421199942, 624, 271, 353, 3, 0, 3
2622, 1, 1636421199280, 1636421199950, 670, 274, 396, 0, 0, 0
2624, 1, 1636421199319, 1636421199986, 667, 269, 398, 1, 0, 1
2625, 1, 1636421199416, 1636421200082, 666, 269, 397, 1, 0, 1
2627, 1, 1636421199460, 1636421200122, 662, 266, 396, 0, 0, 0
2626, 1, 1636421199456, 1636421200122, 666, 271, 395, 1, 0, 1
2628, 1, 1636421199496, 1636421200162, 666, 268, 398, 0, 0, 0
2631, 1, 1636421199977, 1636421200602, 625, 274, 351, 0, 1, 1
2629, 1, 1636421199944, 1636421200610, 666, 266, 400, 0, 1, 1
2630, 1, 1636421199952, 1636421200626, 674, 270, 404, 0, 0, 0
2632, 1, 1636421199988, 1636421200654, 666, 270, 396, 0, 0, 0
2633, 1, 1636421200083, 1636421200750, 667, 269, 398, 1, 0, 1
2635, 1, 1636421200124, 1636421200786, 662, 265, 397, 1, 0, 1
2634, 1, 1636421200123, 1636421200786, 663, 266, 397, 1, 0, 1
2636, 1, 1636421200164, 1636421200826, 662, 262, 400, 0, 0, 0
2637, 1, 1636421200546, 1636421201170, 624, 271, 353, 3, 0, 3
2639, 1, 1636421200611, 1636421201278, 667, 271, 396, 0, 5, 5
2638, 1, 1636421200604, 1636421201286, 682, 278, 404, 1, 0, 1
2641, 1, 1636421200656, 1636421201318, 662, 266, 396, 1, 2, 3
2642, 1, 1636421200752, 1636421201410, 658, 266, 392, 1, 0, 1
2640, 1, 1636421200628, 1636421201442, 814, 418, 396, 0, 1, 1
2643, 1, 1636421200788, 1636421201462, 674, 279, 395, 5, 1, 6
2644, 1, 1636421200789, 1636421201462, 673, 272, 401, 0, 0, 0
2645, 1, 1636421200827, 1636421201502, 675, 266, 409, 0, 0, 0
2646, 1, 1636421201073, 1636421201714, 641, 288, 353, 2, 2, 4
2647, 1, 1636421201172, 1636421201842, 670, 271, 399, 0, 1, 1
2648, 1, 1636421201279, 1636421201945, 666, 269, 397, 1, 0, 1
2649, 1, 1636421201288, 1636421201950, 662, 270, 392, 0, 1, 1
2650, 1, 1636421201320, 1636421201990, 670, 274, 396, 0, 1, 1
2651, 1, 1636421201412, 1636421202078, 666, 271, 395, 0, 0, 0
2652, 1, 1636421201444, 1636421202102, 658, 261, 397, 0, 0, 0
2654, 1, 1636421201464, 1636421202130, 666, 266, 400, 0, 0, 0
2653, 1, 1636421201464, 1636421202130, 666, 267, 399, 2, 0, 2
2655, 1, 1636421201503, 1636421202174, 671, 270, 401, 0, 1, 1
2656, 1, 1636421201716, 1636421202378, 662, 267, 395, 1, 0, 1
2657, 1, 1636421201844, 1636421202514, 670, 270, 400, 1, 0, 1
2658, 1, 1636421201947, 1636421202614, 667, 269, 398, 2, 0, 2
2659, 1, 1636421201952, 1636421202614, 662, 269, 393, 1, 1, 2
2660, 1, 1636421201991, 1636421202658, 667, 271, 396, 1, 0, 1
2661, 1, 1636421202080, 1636421202742, 662, 267, 395, 0, 0, 0
2662, 1, 1636421202104, 1636421202770, 666, 266, 400, 0, 0, 0
2664, 1, 1636421202133, 1636421202794, 661, 266, 395, 1, 0, 1
2663, 1, 1636421202132, 1636421202794, 662, 267, 395, 2, 0, 2
2665, 1, 1636421202176, 1636421202838, 662, 263, 399, 1, 0, 1
2666, 1, 1636421202380, 1636421203050, 670, 270, 400, 0, 0, 0
2667, 1, 1636421202516, 1636421203182, 666, 269, 397, 1, 0, 1
2668, 1, 1636421202615, 1636421203274, 659, 262, 397, 1, 0, 1
2669, 1, 1636421202616, 1636421203274, 658, 266, 392, 0, 0, 0
2670, 1, 1636421202660, 1636421203326, 666, 267, 399, 1, 0, 1
2671, 1, 1636421202744, 1636421203410, 666, 267, 399, 0, 1, 1
2672, 1, 1636421202771, 1636421203438, 667, 270, 397, 1, 0, 1
2674, 1, 1636421202796, 1636421203458, 662, 263, 399, 0, 2, 2
2673, 1, 1636421202795, 1636421203466, 671, 270, 401, 0, 0, 0
2675, 1, 1636421202839, 1636421203502, 663, 267, 396, 0, 1, 1
2677, 1, 1636421203052, 1636421203718, 666, 268, 398, 0, 0, 0
2676, 1, 1636421202876, 1636421203722, 846, 491, 355, 0, 1, 1
2678, 1, 1636421203184, 1636421203854, 670, 275, 395, 2, 2, 4
2679, 1, 1636421203276, 1636421203942, 666, 271, 395, 2, 2, 4
2680, 1, 1636421203276, 1636421203942, 666, 268, 398, 0, 1, 1
2681, 1, 1636421203328, 1636421203994, 666, 270, 396, 1, 0, 1
2682, 1, 1636421203411, 1636421204070, 659, 266, 393, 0, 0, 0
2683, 1, 1636421203440, 1636421204114, 674, 269, 405, 0, 0, 0
2684, 1, 1636421203460, 1636421204126, 666, 262, 404, 0, 0, 0
2685, 1, 1636421203468, 1636421204150, 682, 278, 404, 0, 0, 0
2686, 1, 1636421203503, 1636421204170, 667, 262, 405, 0, 1, 1
2687, 1, 1636421203720, 1636421204382, 662, 266, 396, 1, 0, 1
2688, 1, 1636421203724, 1636421204390, 666, 270, 396, 1, 0, 1
2689, 1, 1636421203856, 1636421204514, 658, 263, 395, 0, 1, 1
2692, 1, 1636421203959, 1636421204590, 631, 271, 360, 0, 1, 1
2690, 1, 1636421203944, 1636421204610, 666, 271, 395, 2, 0, 2
2691, 1, 1636421203944, 1636421204610, 666, 271, 395, 1, 2, 3
2694, 1, 1636421204072, 1636421204734, 662, 266, 396, 1, 0, 1
2696, 1, 1636421204128, 1636421204806, 678, 278, 400, 0, 0, 0
2697, 1, 1636421204151, 1636421204814, 663, 266, 397, 0, 0, 0
2698, 1, 1636421204171, 1636421204838, 667, 267, 400, 1, 0, 1
2693, 1, 1636421203995, 1636421204862, 867, 462, 405, 0, 0, 0
2700, 1, 1636421204384, 1636421205050, 666, 269, 397, 0, 0, 0
2701, 1, 1636421204392, 1636421205058, 666, 270, 396, 1, 0, 1
2702, 1, 1636421204516, 1636421205190, 674, 276, 398, 0, 3, 3
2703, 1, 1636421204608, 1636421205266, 658, 263, 395, 1, 1, 2
2705, 1, 1636421204612, 1636421205282, 670, 267, 403, 1, 0, 1
2706, 1, 1636421204736, 1636421205398, 662, 270, 392, 0, 1, 1
2708, 1, 1636421204808, 1636421205486, 678, 278, 400, 0, 0, 0
2711, 1, 1636421204863, 1636421205534, 671, 271, 400, 3, 0, 3
2710, 1, 1636421204839, 1636421205542, 703, 294, 409, 1, 0, 1
2712, 1, 1636421205052, 1636421205722, 670, 270, 400, 0, 0, 0
2713, 1, 1636421205060, 1636421205730, 670, 273, 397, 0, 1, 1
2714, 1, 1636421205192, 1636421205862, 670, 274, 396, 1, 0, 1
2715, 1, 1636421205267, 1636421205942, 675, 279, 396, 0, 0, 0
2718, 1, 1636421205401, 1636421206070, 669, 266, 403, 1, 0, 1
2719, 1, 1636421205488, 1636421206150, 662, 265, 397, 1, 0, 1
2720, 1, 1636421205535, 1636421206202, 667, 270, 397, 0, 0, 0
2722, 1, 1636421205723, 1636421206390, 667, 266, 401, 0, 0, 0
2723, 1, 1636421205732, 1636421206398, 666, 269, 397, 1, 0, 1
2725, 1, 1636421205943, 1636421206614, 671, 274, 397, 0, 0, 0
2727, 1, 1636421206072, 1636421206734, 662, 266, 396, 1, 0, 1
2729, 1, 1636421206204, 1636421206866, 662, 265, 397, 0, 0, 0
2731, 1, 1636421206400, 1636421207074, 674, 273, 401, 0, 0, 0
2733, 1, 1636421206615, 1636421207282, 667, 270, 397, 1, 0, 1
2735, 1, 1636421206868, 1636421207546, 678, 282, 396, 0, 0, 0
2736, 1, 1636421207076, 1636421207750, 674, 273, 401, 1, 1, 2
2738, 1, 1636421207283, 1636421207950, 667, 271, 396, 0, 1, 1
2741, 1, 1636421207752, 1636421208418, 666, 269, 397, 1, 1, 2
2742, 1, 1636421207952, 1636421208618, 666, 270, 396, 0, 1, 1
2745, 1, 1636421208620, 1636421209290, 670, 271, 399, 1, 1, 2
2695, 2, 1636421204115, 1636421214296, 10181, 0, 10181, 0, 0, 0
2704, 2, 1636421204612, 1636421214788, 10176, 1, 10175, 2, 0, 2
2699, 2, 1636421204335, 1636421214927, 10592, 347, 10245, 0, 0, 0
2707, 2, 1636421204802, 1636421214971, 10169, 0, 10169, 0, 0, 0
2709, 2, 1636421204814, 1636421215015, 10201, 0, 10201, 0, 0, 0
2716, 2, 1636421205284, 1636421215460, 10176, 1, 10175, 0, 0, 0
2717, 2, 1636421205346, 1636421215508, 10162, 1, 10161, 0, 1, 1
2721, 2, 1636421205543, 1636421215720, 10177, 0, 10177, 0, 1, 1
2749, 1, 1636421215061, 1636421215774, 713, 315, 398, 1, 46, 47
2748, 1, 1636421215060, 1636421215774, 714, 315, 399, 0, 46, 46
2724, 2, 1636421205865, 1636421216043, 10178, 0, 10178, 0, 0, 0
2726, 2, 1636421205955, 1636421216087, 10132, 1, 10131, 1, 0, 1
2728, 2, 1636421206152, 1636421216328, 10176, 1, 10175, 0, 0, 0
2752, 1, 1636421215776, 1636421216442, 666, 270, 396, 1, 3, 4
2751, 1, 1636421215776, 1636421216442, 666, 272, 394, 3, 3, 6
2730, 2, 1636421206392, 1636421216568, 10176, 0, 10176, 0, 0, 0
2732, 2, 1636421206550, 1636421216683, 10133, 0, 10133, 0, 0, 0
2734, 2, 1636421206736, 1636421216912, 10176, 1, 10175, 0, 0, 0
2755, 1, 1636421216444, 1636421217178, 734, 297, 437, 1, 30, 31
2754, 1, 1636421216443, 1636421217178, 735, 298, 437, 1, 30, 31
2737, 2, 1636421207078, 1636421217212, 10134, 0, 10134, 0, 0, 0
2740, 2, 1636421207574, 1636421217707, 10133, 0, 10133, 0, 0, 0
2739, 2, 1636421207548, 1636421217751, 10203, 0, 10203, 1, 0, 1
2758, 1, 1636421217214, 1636421217886, 672, 269, 403, 1, 1, 2
2759, 1, 1636421217214, 1636421217886, 672, 271, 401, 3, 0, 3
2762, 1, 1636421217888, 1636421218558, 670, 269, 401, 0, 0, 0
2744, 2, 1636421208452, 1636421218584, 10132, 1, 10131, 0, 2, 2
2743, 2, 1636421208420, 1636421218628, 10208, 1, 10207, 1, 1, 2
2763, 1, 1636421218628, 1636421219254, 626, 269, 357, 0, 0, 0
2746, 2, 1636421209292, 1636421219475, 10183, 0, 10183, 1, 0, 1
2764, 1, 1636421219255, 1636421219922, 667, 270, 397, 0, 3, 3
2747, 2, 1636421214427, 1636421224604, 10177, 0, 10177, 0, 0, 0
2750, 2, 1636421215122, 1636421225300, 10178, 0, 10178, 0, 0, 0
2753, 2, 1636421215850, 1636421226028, 10178, 0, 10178, 0, 0, 0
2756, 2, 1636421216458, 1636421226656, 10198, 0, 10198, 1, 0, 1
2757, 2, 1636421217046, 1636421227260, 10214, 1, 10213, 0, 0, 0
2760, 2, 1636421217858, 1636421228036, 10178, 1, 10177, 0, 0, 0
2761, 2, 1636421217887, 1636421228079, 10192, 1, 10191, 1, 0, 1
2765, 1, 1636421219924, 1636421228530, 8606, 8206, 400, 0, 2, 2
2784, 1, 1636421228198, 1636421228866, 668, 271, 397, 1, 0, 1
2772, 2, 1636421224965, 1636421235143, 10178, 5, 10173, 4, 1, 5
2776, 2, 1636421224967, 1636421235187, 10220, 2, 10218, 0, 1, 1
2768, 2, 1636421224963, 1636421235232, 10269, 6, 10263, 4, 1, 5
2766, 2, 1636421224963, 1636421235276, 10313, 5, 10308, 3, 3, 6
2775, 2, 1636421224967, 1636421235320, 10353, 4, 10349, 3, 2, 5
2773, 2, 1636421224966, 1636421235368, 10402, 2, 10400, 3, 0, 3
2777, 2, 1636421224967, 1636421235416, 10449, 3, 10446, 2, 2, 4
2767, 2, 1636421224963, 1636421235464, 10501, 5, 10496, 6, 2, 8
2770, 2, 1636421224964, 1636421235507, 10543, 5, 10538, 5, 3, 8
2769, 2, 1636421224964, 1636421235551, 10587, 3, 10584, 2, 1, 3
2778, 2, 1636421224968, 1636421235596, 10628, 7, 10621, 8, 3, 11
2771, 2, 1636421224964, 1636421235640, 10676, 2, 10674, 1, 2, 3
2774, 2, 1636421224967, 1636421235688, 10721, 2, 10719, 2, 1, 3
2779, 2, 1636421225430, 1636421235732, 10302, 1, 10301, 0, 1, 1
2785, 1, 1636421228532, 1636421236182, 7650, 7249, 401, 2, 5, 7
2780, 2, 1636421226158, 1636421236335, 10177, 1, 10176, 1, 0, 1
2787, 1, 1636421235818, 1636421236482, 664, 272, 392, 2, 0, 2
2793, 1, 1636421235823, 1636421236482, 659, 262, 397, 1, 0, 1
2788, 1, 1636421235818, 1636421236482, 664, 270, 394, 0, 1, 1
2791, 1, 1636421235823, 1636421236786, 963, 563, 400, 4, 33, 37
2781, 2, 1636421226787, 1636421236964, 10177, 1, 10176, 0, 0, 0
2802, 1, 1636421236466, 1636421237134, 668, 269, 399, 0, 0, 0
2804, 1, 1636421236484, 1636421237150, 666, 270, 396, 2, 1, 3
2805, 1, 1636421236484, 1636421237150, 666, 270, 396, 1, 1, 2
2803, 1, 1636421236484, 1636421237158, 674, 271, 403, 0, 1, 1
2806, 1, 1636421236788, 1636421237494, 706, 309, 397, 46, 0, 46
2782, 2, 1636421227394, 1636421237568, 10174, 0, 10174, 1, 0, 1
2807, 1, 1636421237094, 1636421237766, 672, 268, 404, 0, 0, 0
2811, 1, 1636421237159, 1636421237834, 675, 276, 399, 0, 10, 10
2808, 1, 1636421237136, 1636421237834, 698, 294, 404, 0, 26, 26
2809, 1, 1636421237152, 1636421237834, 682, 284, 398, 2, 18, 20
2812, 1, 1636421237496, 1636421238166, 670, 269, 401, 0, 0, 0
2783, 2, 1636421228166, 1636421238343, 10177, 0, 10177, 0, 0, 0
2813, 1, 1636421237706, 1636421238370, 664, 268, 396, 0, 0, 0
2814, 1, 1636421237768, 1636421238430, 662, 262, 400, 0, 0, 0
2816, 1, 1636421237836, 1636421238502, 666, 271, 395, 2, 1, 3
2817, 1, 1636421237837, 1636421238502, 665, 270, 395, 1, 0, 1
2815, 1, 1636421237836, 1636421238506, 670, 271, 399, 2, 1, 3
2818, 1, 1636421238168, 1636421238878, 710, 264, 446, 0, 0, 0
2819, 1, 1636421238372, 1636421239038, 666, 270, 396, 2, 1, 3
2786, 2, 1636421228868, 1636421239043, 10175, 0, 10175, 0, 0, 0
2820, 1, 1636421238432, 1636421239114, 682, 279, 403, 1, 0, 1
2821, 1, 1636421238474, 1636421239142, 668, 263, 405, 0, 0, 0
2824, 1, 1636421238507, 1636421239170, 663, 271, 392, 3, 1, 4
2823, 1, 1636421238504, 1636421239170, 666, 269, 397, 3, 0, 3
2822, 1, 1636421238504, 1636421239170, 666, 269, 397, 2, 0, 2
2810, 1, 1636421237152, 1636421239530, 2378, 1983, 395, 2, 0, 2
2825, 1, 1636421238879, 1636421239582, 703, 273, 430, 0, 1, 1
2826, 1, 1636421239045, 1636421239718, 673, 274, 399, 0, 1, 1
2827, 1, 1636421239116, 1636421239786, 670, 268, 402, 0, 0, 0
2828, 1, 1636421239144, 1636421239810, 666, 270, 396, 1, 0, 1
2831, 1, 1636421239172, 1636421239838, 666, 270, 396, 1, 1, 2
2830, 1, 1636421239172, 1636421239846, 674, 278, 396, 1, 1, 2
2829, 1, 1636421239172, 1636421239850, 678, 268, 410, 1, 0, 1
2832, 1, 1636421239182, 1636421240106, 924, 525, 399, 0, 0, 0
2834, 1, 1636421239583, 1636421240382, 799, 397, 402, 0, 0, 0
2835, 1, 1636421239720, 1636421240386, 666, 275, 391, 2, 0, 2
2836, 1, 1636421239788, 1636421240454, 666, 269, 397, 0, 0, 0
2837, 1, 1636421239812, 1636421240482, 670, 266, 404, 0, 0, 0
2838, 1, 1636421239839, 1636421240506, 667, 269, 398, 0, 0, 0
2839, 1, 1636421239847, 1636421240654, 807, 407, 400, 1, 0, 1
2840, 1, 1636421239851, 1636421240750, 899, 498, 401, 0, 0, 0
2841, 1, 1636421240108, 1636421240770, 662, 266, 396, 0, 0, 0
2843, 1, 1636421240388, 1636421241054, 666, 275, 391, 1, 1, 2
2842, 1, 1636421240383, 1636421241054, 671, 271, 400, 1, 1, 2
2844, 1, 1636421240456, 1636421241122, 666, 270, 396, 0, 1, 1
2845, 1, 1636421240484, 1636421241150, 666, 270, 396, 0, 0, 0
2847, 1, 1636421240656, 1636421241322, 666, 267, 399, 1, 1, 2
2848, 1, 1636421240751, 1636421241418, 667, 271, 396, 1, 1, 2
2849, 1, 1636421240771, 1636421241442, 671, 275, 396, 0, 0, 0
2850, 1, 1636421241056, 1636421241722, 666, 271, 395, 2, 0, 2
2852, 1, 1636421241124, 1636421241794, 670, 274, 396, 0, 1, 1
2853, 1, 1636421241152, 1636421241818, 666, 266, 400, 1, 0, 1
2856, 1, 1636421241443, 1636421242110, 667, 267, 400, 2, 0, 2
2857, 1, 1636421241724, 1636421242394, 670, 271, 399, 1, 0, 1
2859, 1, 1636421241820, 1636421242486, 666, 270, 396, 0, 0, 0
2860, 1, 1636421242112, 1636421242778, 666, 269, 397, 0, 0, 0
2862, 1, 1636421242488, 1636421243154, 666, 268, 398, 0, 0, 0
2863, 1, 1636421242780, 1636421243442, 662, 266, 396, 0, 0, 0
2865, 1, 1636421243444, 1636421244110, 666, 270, 396, 1, 1, 2
2790, 2, 1636421235822, 1636421245996, 10174, 0, 10174, 0, 0, 0
2796, 2, 1636421235825, 1636421246044, 10219, 3, 10216, 4, 0, 4
2795, 2, 1636421235824, 1636421246087, 10263, 1, 10262, 2, 0, 2
2798, 2, 1636421235825, 1636421246132, 10307, 2, 10305, 1, 0, 1
2800, 2, 1636421235826, 1636421246175, 10349, 4, 10345, 3, 1, 4
2789, 2, 1636421235822, 1636421246220, 10398, 3, 10395, 3, 0, 3
2792, 2, 1636421235823, 1636421246264, 10441, 4, 10437, 3, 2, 5
2797, 2, 1636421235825, 1636421246307, 10482, 4, 10478, 3, 1, 4
2799, 2, 1636421235826, 1636421246352, 10526, 2, 10524, 5, 1, 6
2794, 2, 1636421235824, 1636421246395, 10571, 3, 10568, 3, 2, 5
2801, 2, 1636421236183, 1636421246440, 10257, 0, 10257, 0, 0, 0
2855, 1, 1636421241419, 1636421246934, 5515, 5122, 393, 0, 1, 1
2868, 1, 1636421246527, 1636421247194, 667, 270, 397, 2, 1, 3
2867, 1, 1636421246526, 1636421247194, 668, 270, 398, 1, 2, 3
2873, 1, 1636421246532, 1636421247466, 934, 530, 404, 2, 1, 3
2875, 1, 1636421246532, 1636421247466, 934, 538, 396, 0, 1, 1
2880, 1, 1636421247196, 1636421247866, 670, 272, 398, 4, 1, 5
2879, 1, 1636421247195, 1636421247866, 671, 269, 402, 1, 0, 1
2882, 1, 1636421247469, 1636421248138, 669, 274, 395, 1, 1, 2
2881, 1, 1636421247468, 1636421248138, 670, 272, 398, 1, 1, 2
2884, 1, 1636421247868, 1636421248530, 662, 266, 396, 1, 0, 1
2885, 1, 1636421248140, 1636421248814, 674, 271, 403, 2, 0, 2
2887, 1, 1636421248531, 1636421249198, 667, 269, 398, 0, 0, 0
2888, 1, 1636421248816, 1636421249490, 674, 270, 404, 1, 0, 1
2833, 2, 1636421239532, 1636421249711, 10179, 1, 10178, 0, 0, 0
2889, 1, 1636421249200, 1636421249870, 670, 270, 400, 0, 0, 0
2890, 1, 1636421249492, 1636421250158, 666, 271, 395, 0, 2, 2
2891, 1, 1636421249838, 1636421250502, 664, 269, 395, 0, 0, 0
2846, 2, 1636421240508, 1636421250688, 10180, 1, 10179, 0, 1, 1
2892, 1, 1636421249872, 1636421250770, 898, 500, 398, 0, 0, 0
2893, 1, 1636421250160, 1636421251042, 882, 486, 396, 0, 6, 6
2894, 1, 1636421250504, 1636421251174, 670, 271, 399, 1, 1, 2
2851, 2, 1636421241056, 1636421251232, 10176, 1, 10175, 0, 1, 1
2895, 1, 1636421250772, 1636421251442, 670, 271, 399, 1, 1, 2
2896, 1, 1636421250818, 1636421251498, 680, 280, 400, 0, 11, 11
2854, 2, 1636421241324, 1636421251499, 10175, 1, 10174, 0, 0, 0
2897, 1, 1636421251044, 1636421251706, 662, 266, 396, 1, 0, 1
2898, 1, 1636421251176, 1636421251858, 682, 281, 401, 1, 18, 19
2858, 2, 1636421241796, 1636421251972, 10176, 0, 10176, 0, 1, 1
2899, 1, 1636421251362, 1636421252034, 672, 268, 404, 2, 0, 2
2900, 1, 1636421251444, 1636421252110, 666, 266, 400, 0, 0, 0
2902, 1, 1636421251630, 1636421252326, 696, 296, 400, 0, 22, 22
2903, 1, 1636421251708, 1636421252426, 718, 315, 403, 2, 43, 45
2904, 1, 1636421251860, 1636421252550, 690, 271, 419, 1, 0, 1
2861, 2, 1636421242396, 1636421252568, 10172, 1, 10171, 0, 0, 0
2906, 1, 1636421252102, 1636421252770, 668, 270, 398, 0, 0, 0
2910, 1, 1636421252570, 1636421253234, 664, 269, 395, 0, 1, 1
2864, 2, 1636421243156, 1636421253332, 10176, 1, 10175, 1, 0, 1
2911, 1, 1636421252698, 1636421253362, 664, 269, 395, 1, 0, 1
2913, 1, 1636421253237, 1636421253910, 673, 270, 403, 0, 2, 2
2915, 1, 1636421253462, 1636421254134, 672, 268, 404, 0, 0, 0
2866, 2, 1636421244112, 1636421254288, 10176, 1, 10175, 0, 0, 0
2916, 1, 1636421253912, 1636421254578, 666, 271, 395, 0, 0, 0
2918, 1, 1636421254422, 1636421255090, 668, 270, 398, 0, 1, 1
2919, 1, 1636421254580, 1636421255246, 666, 271, 395, 0, 0, 0
2921, 1, 1636421255248, 1636421255918, 670, 269, 401, 0, 1, 1
2870, 2, 1636421246531, 1636421256704, 10173, 1, 10172, 2, 0, 2
2872, 2, 1636421246531, 1636421256747, 10216, 1, 10215, 2, 0, 2
2877, 2, 1636421246533, 1636421256791, 10258, 1, 10257, 0, 0, 0
2871, 2, 1636421246531, 1636421256836, 10305, 5, 10300, 3, 5, 8
2874, 2, 1636421246532, 1636421256880, 10348, 3, 10345, 2, 1, 3
2876, 2, 1636421246533, 1636421256927, 10394, 3, 10391, 3, 0, 3
2869, 2, 1636421246530, 1636421256972, 10442, 5, 10437, 1, 4, 5
2878, 2, 1636421246935, 1636421257382, 10447, 229, 10218, 1, 0, 1
2923, 1, 1636421257058, 1636421257738, 680, 287, 393, 3, 17, 20
2909, 1, 1636421252428, 1636421257830, 5402, 4994, 408, 0, 5, 5
2926, 1, 1636421257102, 1636421257838, 736, 334, 402, 1, 65, 66
2883, 2, 1636421247868, 1636421258044, 10176, 1, 10175, 1, 0, 1
2907, 1, 1636421252111, 1636421258110, 5999, 5597, 402, 0, 0, 0
2929, 1, 1636421257428, 1636421258118, 690, 287, 403, 1, 1, 2
2886, 2, 1636421248141, 1636421258319, 10178, 0, 10178, 0, 0, 0
2928, 1, 1636421257427, 1636421258406, 979, 576, 403, 0, 15, 15
2933, 1, 1636421257840, 1636421258506, 666, 269, 397, 0, 0, 0
2927, 1, 1636421257427, 1636421258674, 1247, 850, 397, 1, 6, 7
2935, 1, 1636421258120, 1636421258778, 658, 263, 395, 0, 0, 0
2936, 1, 1636421258174, 1636421258850, 676, 264, 412, 0, 0, 0
2937, 1, 1636421258408, 1636421259078, 670, 275, 395, 0, 0, 0
2938, 1, 1636421258451, 1636421259122, 671, 273, 398, 0, 0, 0
2939, 1, 1636421258508, 1636421259162, 654, 262, 392, 0, 0, 0
2940, 1, 1636421258675, 1636421259342, 667, 271, 396, 1, 0, 1
2941, 1, 1636421258780, 1636421259442, 662, 262, 400, 0, 0, 0
2943, 1, 1636421259079, 1636421259742, 663, 266, 397, 1, 0, 1
2945, 1, 1636421259164, 1636421259822, 658, 265, 393, 0, 0, 0
2946, 1, 1636421259344, 1636421260006, 662, 267, 395, 2, 0, 2
2947, 1, 1636421259443, 1636421260106, 663, 262, 401, 0, 0, 0
2948, 1, 1636421259743, 1636421260414, 671, 271, 400, 2, 1, 3
2949, 1, 1636421259824, 1636421260486, 662, 271, 391, 1, 1, 2
2950, 1, 1636421260008, 1636421260686, 678, 279, 399, 1, 1, 2
2951, 1, 1636421260108, 1636421260774, 666, 270, 396, 1, 0, 1
2952, 1, 1636421260416, 1636421261082, 666, 270, 396, 0, 1, 1
2953, 1, 1636421260487, 1636421261154, 667, 270, 397, 0, 0, 0
2954, 1, 1636421260688, 1636421261350, 662, 265, 397, 0, 0, 0
2955, 1, 1636421260776, 1636421261442, 666, 271, 395, 2, 0, 2
2901, 2, 1636421251501, 1636421261680, 10179, 0, 10179, 0, 0, 0
2956, 1, 1636421261084, 1636421261750, 666, 271, 395, 2, 0, 2
2957, 1, 1636421261156, 1636421261822, 666, 273, 393, 0, 0, 0
2958, 1, 1636421261352, 1636421262034, 682, 287, 395, 1, 15, 16
2959, 1, 1636421261444, 1636421262126, 682, 287, 395, 1, 19, 20
2905, 2, 1636421252036, 1636421262212, 10176, 1, 10175, 1, 0, 1
2960, 1, 1636421261752, 1636421262422, 670, 274, 396, 1, 0, 1
2961, 1, 1636421261810, 1636421262478, 668, 269, 399, 0, 0, 0
2962, 1, 1636421261824, 1636421262478, 654, 262, 392, 0, 0, 0
2908, 2, 1636421252328, 1636421262503, 10175, 0, 10175, 0, 0, 0
2963, 1, 1636421262036, 1636421262710, 674, 271, 403, 1, 1, 2
2964, 1, 1636421262127, 1636421262790, 663, 267, 396, 2, 1, 3
2912, 2, 1636421252772, 1636421262948, 10176, 1, 10175, 1, 0, 1
2965, 1, 1636421262342, 1636421263038, 696, 269, 427, 0, 1, 1
2966, 1, 1636421262424, 1636421263094, 670, 270, 400, 0, 0, 0
2968, 1, 1636421262505, 1636421263214, 709, 309, 400, 0, 39, 39
2969, 1, 1636421262635, 1636421263302, 667, 271, 396, 1, 0, 1
2970, 1, 1636421262712, 1636421263394, 682, 286, 396, 1, 19, 20
2914, 2, 1636421253364, 1636421263540, 10176, 0, 10176, 0, 0, 0
2972, 1, 1636421263040, 1636421263702, 662, 267, 395, 1, 1, 2
2973, 1, 1636421263082, 1636421263746, 664, 268, 396, 2, 2, 4
2975, 1, 1636421263216, 1636421263898, 682, 287, 395, 1, 16, 17
2976, 1, 1636421263305, 1636421263982, 677, 283, 394, 1, 14, 15
2917, 2, 1636421254136, 1636421264336, 10200, 0, 10200, 0, 1, 1
2978, 1, 1636421263670, 1636421264338, 668, 269, 399, 0, 0, 0
2979, 1, 1636421263704, 1636421264367, 663, 265, 398, 0, 0, 0
2980, 1, 1636421263748, 1636421264410, 662, 267, 395, 1, 0, 1
2981, 1, 1636421263900, 1636421264602, 702, 304, 398, 0, 42, 42
2982, 1, 1636421263983, 1636421264694, 711, 312, 399, 2, 43, 45
2983, 1, 1636421264339, 1636421265002, 663, 267, 396, 0, 0, 0
2984, 1, 1636421264368, 1636421265034, 666, 270, 396, 1, 0, 1
2985, 1, 1636421264412, 1636421265082, 670, 269, 401, 0, 0, 0
2986, 1, 1636421264466, 1636421265134, 668, 269, 399, 0, 0, 0
2920, 2, 1636421255092, 1636421265271, 10179, 1, 10178, 0, 1, 1
2987, 1, 1636421264603, 1636421265278, 675, 274, 401, 0, 2, 2
2988, 1, 1636421264696, 1636421265370, 674, 269, 405, 1, 0, 1
2989, 1, 1636421265004, 1636421265674, 670, 269, 401, 1, 1, 2
2990, 1, 1636421265036, 1636421265714, 678, 283, 395, 0, 19, 19
2991, 1, 1636421265084, 1636421265750, 666, 270, 396, 1, 0, 1
2922, 1, 1636421255921, 1636421265766, 9845, 9446, 399, 1, 1, 2
2992, 1, 1636421265136, 1636421265810, 674, 272, 402, 0, 1, 1
2993, 1, 1636421265280, 1636421265942, 662, 266, 396, 0, 0, 0
2994, 1, 1636421265372, 1636421266046, 674, 270, 404, 0, 0, 0
2995, 1, 1636421265402, 1636421266066, 664, 266, 398, 1, 1, 2
2996, 1, 1636421265676, 1636421266342, 666, 271, 395, 1, 0, 1
2997, 1, 1636421265715, 1636421266382, 667, 270, 397, 2, 0, 2
2998, 1, 1636421265752, 1636421266418, 666, 271, 395, 0, 2, 2
2999, 1, 1636421265768, 1636421266442, 674, 266, 408, 0, 0, 0
3000, 1, 1636421265812, 1636421266474, 662, 266, 396, 0, 0, 0
3001, 1, 1636421265944, 1636421266606, 662, 266, 396, 1, 0, 1
3002, 1, 1636421266048, 1636421266722, 674, 270, 404, 0, 0, 0
3003, 1, 1636421266067, 1636421266734, 667, 271, 396, 0, 1, 1
3004, 1, 1636421266344, 1636421267010, 666, 273, 393, 0, 1, 1
3005, 1, 1636421266383, 1636421267050, 667, 267, 400, 2, 0, 2
3006, 1, 1636421266420, 1636421267082, 662, 266, 396, 0, 0, 0
3007, 1, 1636421266443, 1636421267110, 667, 267, 400, 0, 0, 0
3008, 1, 1636421266475, 1636421267142, 667, 266, 401, 0, 0, 0
2924, 2, 1636421257062, 1636421267235, 10173, 1, 10172, 0, 0, 0
3009, 1, 1636421266607, 1636421267270, 663, 266, 397, 0, 0, 0
2925, 2, 1636421257062, 1636421267279, 10217, 1, 10216, 0, 1, 1
3010, 1, 1636421266724, 1636421267390, 666, 270, 396, 1, 0, 1
3011, 1, 1636421266737, 1636421267406, 669, 271, 398, 0, 1, 1
2930, 2, 1636421257466, 1636421267639, 10173, 0, 10173, 1, 0, 1
3012, 1, 1636421267011, 1636421267726, 715, 275, 440, 0, 11, 11
3013, 1, 1636421267051, 1636421267726, 675, 275, 400, 0, 10, 10
3014, 1, 1636421267084, 1636421267814, 730, 311, 419, 0, 1, 1
3015, 1, 1636421267112, 1636421267814, 702, 312, 390, 47, 2, 49
3016, 1, 1636421267144, 1636421267814, 670, 269, 401, 2, 3, 5
2931, 2, 1636421257740, 1636421267916, 10176, 0, 10176, 0, 1, 1
2932, 2, 1636421257832, 1636421268008, 10176, 1, 10175, 1, 1, 2
3018, 1, 1636421267392, 1636421268082, 690, 290, 400, 0, 26, 26
3019, 1, 1636421267408, 1636421268086, 678, 278, 400, 0, 14, 14
2934, 2, 1636421258112, 1636421268288, 10176, 0, 10176, 0, 0, 0
3023, 1, 1636421267728, 1636421268394, 666, 267, 399, 0, 0, 0
3026, 1, 1636421267816, 1636421268554, 738, 280, 458, 4, 7, 11
3025, 1, 1636421267816, 1636421268554, 738, 278, 460, 2, 7, 9
3027, 1, 1636421267816, 1636421268554, 738, 280, 458, 2, 7, 9
3028, 1, 1636421268046, 1636421268742, 696, 294, 402, 1, 29, 30
3030, 1, 1636421268087, 1636421268754, 667, 271, 396, 0, 0, 0
2942, 2, 1636421258852, 1636421269028, 10176, 0, 10176, 1, 0, 1
3032, 1, 1636421268396, 1636421269058, 662, 270, 392, 0, 0, 0
3036, 1, 1636421268557, 1636421269226, 669, 270, 399, 1, 1, 2
3034, 1, 1636421268556, 1636421269238, 682, 274, 408, 0, 2, 2
2944, 2, 1636421259124, 1636421269300, 10176, 1, 10175, 0, 2, 2
3038, 1, 1636421268756, 1636421269422, 666, 266, 400, 0, 0, 0
3040, 1, 1636421269158, 1636421269838, 680, 268, 412, 0, 0, 0
3041, 1, 1636421269228, 1636421269894, 666, 271, 395, 1, 0, 1
3042, 1, 1636421269240, 1636421269910, 670, 270, 400, 1, 0, 1
3043, 1, 1636421269424, 1636421270094, 670, 270, 400, 0, 1, 1
3044, 1, 1636421269430, 1636421270110, 680, 277, 403, 0, 0, 0
3045, 1, 1636421269840, 1636421270506, 666, 270, 396, 0, 1, 1
3047, 1, 1636421269913, 1636421270582, 669, 270, 399, 0, 0, 0
3048, 1, 1636421270096, 1636421270766, 670, 267, 403, 0, 1, 1
3049, 1, 1636421270112, 1636421270774, 662, 262, 400, 0, 0, 0
3050, 1, 1636421270507, 1636421271170, 663, 266, 397, 0, 0, 0
3051, 1, 1636421270584, 1636421271258, 674, 274, 400, 0, 0, 0
3053, 1, 1636421270776, 1636421271442, 666, 269, 397, 0, 0, 0
3054, 1, 1636421271172, 1636421271850, 678, 281, 397, 1, 0, 1
3055, 1, 1636421271261, 1636421271926, 665, 269, 396, 0, 0, 0
3056, 1, 1636421271444, 1636421272118, 674, 278, 396, 1, 0, 1
3057, 1, 1636421271852, 1636421272522, 670, 270, 400, 1, 0, 1
3058, 1, 1636421271928, 1636421272594, 666, 269, 397, 1, 0, 1
2967, 2, 1636421262505, 1636421272679, 10174, 1, 10173, 2, 0, 2
3059, 1, 1636421272121, 1636421272794, 673, 272, 401, 0, 0, 0
2971, 2, 1636421262792, 1636421272996, 10204, 0, 10204, 0, 0, 0
3060, 1, 1636421272524, 1636421273258, 734, 313, 421, 0, 46, 46
2974, 2, 1636421263095, 1636421273272, 10177, 0, 10177, 0, 1, 1
3062, 1, 1636421272796, 1636421273546, 750, 340, 410, 2, 7, 9
2977, 2, 1636421263395, 1636421273588, 10193, 1, 10192, 0, 0, 0
3065, 1, 1636421273273, 1636421273942, 669, 275, 394, 3, 7, 10
3037, 1, 1636421268744, 1636421274078, 5334, 4934, 400, 1, 0, 1
3067, 1, 1636421273590, 1636421274258, 668, 269, 399, 1, 1, 2
3069, 1, 1636421273944, 1636421274610, 666, 271, 395, 0, 1, 1
3070, 1, 1636421274080, 1636421274746, 666, 270, 396, 0, 1, 1
3071, 1, 1636421274260, 1636421274934, 674, 269, 405, 0, 0, 0
3072, 1, 1636421274612, 1636421275278, 666, 271, 395, 0, 1, 1
3073, 1, 1636421274748, 1636421275410, 662, 265, 397, 0, 0, 0
3074, 1, 1636421274936, 1636421275602, 666, 270, 396, 1, 0, 1
3075, 1, 1636421275280, 1636421275950, 670, 274, 396, 0, 1, 1
3076, 1, 1636421275411, 1636421276078, 667, 271, 396, 0, 0, 0
3077, 1, 1636421275604, 1636421276278, 674, 270, 404, 1, 0, 1
3078, 1, 1636421275952, 1636421276622, 670, 272, 398, 1, 2, 3
3079, 1, 1636421276080, 1636421276746, 666, 270, 396, 1, 0, 1
3080, 1, 1636421276280, 1636421276954, 674, 274, 400, 0, 0, 0
3081, 1, 1636421276624, 1636421277286, 662, 266, 396, 0, 0, 0
3082, 1, 1636421276747, 1636421277414, 667, 265, 402, 0, 0, 0
3017, 2, 1636421267280, 1636421277456, 10176, 1, 10175, 0, 1, 1
3083, 1, 1636421276957, 1636421277618, 661, 267, 394, 0, 0, 0
3021, 2, 1636421267658, 1636421277832, 10174, 1, 10173, 1, 1, 2
3020, 2, 1636421267654, 1636421277875, 10221, 0, 10221, 0, 0, 0
3022, 2, 1636421267728, 1636421277920, 10192, 1, 10191, 2, 0, 2
3024, 2, 1636421267770, 1636421277967, 10197, 1, 10196, 0, 1, 1
3084, 1, 1636421277287, 1636421277994, 707, 273, 434, 1, 1, 2
3029, 2, 1636421268084, 1636421278260, 10176, 0, 10176, 0, 0, 0
3031, 2, 1636421268138, 1636421278335, 10197, 0, 10197, 0, 0, 0
3085, 1, 1636421277458, 1636421278418, 960, 474, 486, 48, 14, 62
3033, 2, 1636421268418, 1636421278599, 10181, 0, 10181, 1, 0, 1
3089, 1, 1636421278010, 1636421278710, 700, 303, 397, 0, 36, 36
3087, 1, 1636421277620, 1636421278710, 1090, 687, 403, 0, 24, 24
3088, 1, 1636421277996, 1636421278710, 714, 269, 445, 0, 1, 1
3035, 2, 1636421268556, 1636421278740, 10184, 1, 10183, 2, 0, 2
3093, 1, 1636421278420, 1636421279094, 674, 278, 396, 0, 15, 15
3039, 2, 1636421269060, 1636421279232, 10172, 1, 10171, 1, 1, 2
3098, 1, 1636421278743, 1636421279414, 671, 271, 400, 2, 2, 4
3099, 1, 1636421278743, 1636421279414, 671, 271, 400, 1, 3, 4
3097, 1, 1636421278742, 1636421279414, 672, 267, 405, 0, 0, 0
3101, 1, 1636421279095, 1636421279770, 675, 273, 402, 2, 0, 2
3046, 2, 1636421269896, 1636421280071, 10175, 0, 10175, 0, 0, 0
3104, 1, 1636421279416, 1636421280082, 666, 267, 399, 3, 1, 4
3103, 1, 1636421279415, 1636421280082, 667, 265, 402, 1, 1, 2
3105, 1, 1636421279416, 1636421280082, 666, 265, 401, 1, 1, 2
3106, 1, 1636421279771, 1636421280434, 663, 266, 397, 0, 0, 0
3108, 1, 1636421280083, 1636421280746, 663, 271, 392, 1, 0, 1
3109, 1, 1636421280083, 1636421280750, 667, 270, 397, 2, 0, 2
3107, 1, 1636421280083, 1636421280750, 667, 271, 396, 1, 1, 2
3052, 2, 1636421270768, 1636421280943, 10175, 0, 10175, 0, 0, 0
3111, 1, 1636421280436, 1636421281106, 670, 266, 404, 0, 1, 1
3113, 1, 1636421280751, 1636421281418, 667, 271, 396, 3, 1, 4
3114, 1, 1636421280752, 1636421281418, 666, 269, 397, 0, 1, 1
3116, 1, 1636421281107, 1636421281774, 667, 268, 399, 1, 3, 4
3118, 1, 1636421281420, 1636421282086, 666, 267, 399, 0, 0, 0
3119, 1, 1636421281776, 1636421282442, 666, 268, 398, 0, 0, 0
3061, 2, 1636421272596, 1636421282772, 10176, 0, 10176, 0, 0, 0
3063, 2, 1636421272810, 1636421282984, 10174, 1, 10173, 0, 1, 1
3121, 1, 1636421282444, 1636421283126, 682, 287, 395, 1, 18, 19
3064, 2, 1636421273126, 1636421283320, 10194, 0, 10194, 0, 1, 1
3066, 2, 1636421273403, 1636421283579, 10176, 1, 10175, 0, 0, 0
3124, 1, 1636421283128, 1636421283794, 666, 270, 396, 2, 0, 2
3068, 2, 1636421273719, 1636421283896, 10177, 1, 10176, 0, 1, 1
3127, 1, 1636421283796, 1636421284478, 682, 275, 407, 0, 1, 1
3129, 1, 1636421284480, 1636421285146, 666, 269, 397, 0, 1, 1
3130, 1, 1636421285148, 1636421285814, 666, 266, 400, 1, 0, 1
3131, 1, 1636421285815, 1636421286482, 667, 271, 396, 0, 1, 1
3086, 2, 1636421277587, 1636421287772, 10185, 1, 10184, 0, 1, 1
3090, 2, 1636421278011, 1636421288192, 10181, 0, 10181, 0, 0, 0
3091, 2, 1636421278054, 1636421288235, 10181, 0, 10181, 0, 0, 0
3092, 2, 1636421278090, 1636421288308, 10218, 0, 10218, 0, 1, 1
3133, 1, 1636421287903, 1636421288598, 695, 290, 405, 1, 22, 23
3094, 2, 1636421278422, 1636421288644, 10222, 0, 10222, 1, 0, 1
3095, 2, 1636421278466, 1636421288691, 10225, 1, 10224, 1, 0, 1
3096, 2, 1636421278741, 1636421288915, 10174, 1, 10173, 3, 0, 3
3100, 2, 1636421278872, 1636421289047, 10175, 1, 10174, 2, 0, 2
3134, 1, 1636421288394, 1636421289182, 788, 342, 446, 0, 73, 73
3135, 1, 1636421288599, 1636421289314, 715, 310, 405, 2, 40, 42
3136, 1, 1636421288644, 1636421289314, 670, 273, 397, 1, 7, 8
3139, 1, 1636421288782, 1636421289490, 708, 351, 357, 46, 43, 89
3102, 2, 1636421279370, 1636421289544, 10174, 0, 10174, 1, 0, 1
3141, 1, 1636421289179, 1636421289846, 667, 269, 398, 1, 0, 1
3142, 1, 1636421289183, 1636421289850, 667, 266, 401, 0, 0, 0
3144, 1, 1636421289316, 1636421289986, 670, 274, 396, 1, 10, 11
3143, 1, 1636421289316, 1636421289990, 674, 278, 396, 0, 15, 15
3145, 1, 1636421289492, 1636421290158, 666, 271, 395, 0, 2, 2
3146, 1, 1636421289674, 1636421290342, 668, 274, 394, 2, 0, 2
3110, 2, 1636421280202, 1636421290379, 10177, 0, 10177, 0, 0, 0
3148, 1, 1636421289851, 1636421290522, 671, 268, 403, 1, 0, 1
3147, 1, 1636421289848, 1636421290522, 674, 270, 404, 2, 0, 2
3150, 1, 1636421289991, 1636421290654, 663, 270, 393, 2, 1, 3
3149, 1, 1636421289987, 1636421290654, 667, 269, 398, 1, 0, 1
3151, 1, 1636421290160, 1636421290826, 666, 270, 396, 0, 2, 2
3112, 2, 1636421280748, 1636421290923, 10175, 1, 10174, 1, 0, 1
3152, 1, 1636421290381, 1636421291050, 669, 265, 404, 0, 0, 0
3153, 1, 1636421290511, 1636421291190, 679, 280, 399, 0, 14, 14
3155, 1, 1636421290524, 1636421291194, 670, 274, 396, 2, 0, 2
3154, 1, 1636421290524, 1636421291194, 670, 272, 398, 1, 0, 1
3115, 2, 1636421281074, 1636421291251, 10177, 0, 10177, 1, 0, 1
3157, 1, 1636421290656, 1636421291326, 670, 275, 395, 1, 1, 2
3158, 1, 1636421290828, 1636421291522, 694, 283, 411, 0, 10, 10
3117, 2, 1636421281419, 1636421291596, 10177, 1, 10176, 2, 0, 2
3159, 1, 1636421291052, 1636421291722, 670, 270, 400, 1, 1, 2
3160, 1, 1636421291058, 1636421291726, 668, 269, 399, 0, 1, 1
3163, 1, 1636421291196, 1636421291866, 670, 269, 401, 1, 0, 1
3161, 1, 1636421291192, 1636421291866, 674, 269, 405, 0, 1, 1
3162, 1, 1636421291196, 1636421291874, 678, 275, 403, 3, 0, 3
3164, 1, 1636421291328, 1636421292002, 674, 275, 399, 1, 2, 3
3165, 1, 1636421291382, 1636421292054, 672, 270, 402, 0, 0, 0
3166, 1, 1636421291524, 1636421292194, 670, 270, 400, 1, 0, 1
3120, 2, 1636421282088, 1636421292264, 10176, 1, 10175, 0, 0, 0
3167, 1, 1636421291725, 1636421292390, 665, 269, 396, 0, 0, 0
3169, 1, 1636421291728, 1636421292398, 670, 271, 399, 0, 0, 0
3170, 1, 1636421291868, 1636421292530, 662, 268, 394, 2, 1, 3
3171, 1, 1636421291868, 1636421292530, 662, 266, 396, 1, 0, 1
3172, 1, 1636421291875, 1636421292538, 663, 267, 396, 0, 0, 0
3173, 1, 1636421292004, 1636421292706, 702, 306, 396, 1, 42, 43
3174, 1, 1636421292055, 1636421292722, 667, 262, 405, 0, 0, 0
3175, 1, 1636421292196, 1636421292858, 662, 266, 396, 0, 0, 0
3178, 1, 1636421292399, 1636421293066, 667, 270, 397, 0, 1, 1
3177, 1, 1636421292392, 1636421293066, 674, 271, 403, 0, 1, 1
3122, 2, 1636421282902, 1636421293076, 10174, 0, 10174, 0, 1, 1
3179, 1, 1636421292532, 1636421293198, 666, 269, 397, 1, 0, 1
3180, 1, 1636421292532, 1636421293198, 666, 270, 396, 1, 1, 2
3181, 1, 1636421292540, 1636421293202, 662, 266, 396, 0, 0, 0
3123, 2, 1636421283114, 1636421293291, 10177, 1, 10176, 0, 1, 1
3182, 1, 1636421292707, 1636421293370, 663, 267, 396, 1, 0, 1
3183, 1, 1636421292724, 1636421293434, 710, 265, 445, 0, 0, 0
3184, 1, 1636421292860, 1636421293558, 698, 301, 397, 0, 35, 35
3125, 2, 1636421283450, 1636421293628, 10178, 0, 10178, 0, 0, 0
3185, 1, 1636421293078, 1636421293742, 664, 265, 399, 1, 0, 1
3186, 1, 1636421293078, 1636421293746, 668, 269, 399, 1, 0, 1
3126, 2, 1636421283710, 1636421293887, 10177, 0, 10177, 0, 0, 0
3189, 1, 1636421293203, 1636421293898, 695, 285, 410, 1, 18, 19
3190, 1, 1636421293206, 1636421293898, 692, 289, 403, 4, 18, 22
3187, 1, 1636421293200, 1636421293898, 698, 289, 409, 4, 19, 23
3188, 1, 1636421293200, 1636421293898, 698, 290, 408, 2, 21, 23
3191, 1, 1636421293371, 1636421294082, 711, 306, 405, 1, 40, 41
3193, 1, 1636421293435, 1636421294154, 719, 266, 453, 0, 0, 0
3128, 2, 1636421284026, 1636421294204, 10178, 1, 10177, 0, 1, 1
3194, 1, 1636421293560, 1636421294242, 682, 281, 401, 0, 15, 15
3196, 1, 1636421293748, 1636421294470, 722, 313, 409, 2, 39, 41
3195, 1, 1636421293744, 1636421294470, 726, 315, 411, 4, 39, 43
3198, 1, 1636421293899, 1636421294570, 671, 269, 402, 3, 1, 4
3200, 1, 1636421293900, 1636421294574, 674, 270, 404, 5, 1, 6
3199, 1, 1636421293900, 1636421294574, 674, 269, 405, 3, 1, 4
3201, 1, 1636421293900, 1636421294574, 674, 269, 405, 2, 2, 4
3156, 1, 1636421290656, 1636421294698, 4042, 3641, 401, 1, 0, 1
3203, 1, 1636421294083, 1636421294786, 703, 267, 436, 1, 0, 1
3204, 1, 1636421294155, 1636421294830, 675, 269, 406, 1, 0, 1
3205, 1, 1636421294244, 1636421294906, 662, 266, 396, 1, 0, 1
3207, 1, 1636421294471, 1636421295134, 663, 270, 393, 1, 0, 1
3208, 1, 1636421294472, 1636421295142, 670, 266, 404, 1, 0, 1
3209, 1, 1636421294571, 1636421295234, 663, 262, 401, 0, 0, 0
3212, 1, 1636421294576, 1636421295242, 666, 271, 395, 2, 0, 2
3210, 1, 1636421294575, 1636421295250, 675, 273, 402, 2, 0, 2
3211, 1, 1636421294576, 1636421295254, 678, 271, 407, 4, 0, 4
3213, 1, 1636421294699, 1636421295370, 671, 278, 393, 0, 1, 1
3214, 1, 1636421294788, 1636421295454, 666, 270, 396, 0, 0, 0
3215, 1, 1636421294831, 1636421295490, 659, 263, 396, 0, 0, 0
3216, 1, 1636421294908, 1636421295570, 662, 267, 395, 0, 0, 0
3217, 1, 1636421295136, 1636421295794, 658, 266, 392, 0, 0, 0
3218, 1, 1636421295143, 1636421295798, 655, 262, 393, 0, 0, 0
3219, 1, 1636421295236, 1636421295894, 658, 263, 395, 0, 0, 0
3220, 1, 1636421295244, 1636421295914, 670, 273, 397, 0, 0, 0
3221, 1, 1636421295252, 1636421295926, 674, 275, 399, 2, 0, 2
3222, 1, 1636421295256, 1636421295930, 674, 272, 402, 1, 0, 1
3223, 1, 1636421295371, 1636421296030, 659, 266, 393, 0, 0, 0
3224, 1, 1636421295455, 1636421296122, 667, 266, 401, 0, 0, 0
3225, 1, 1636421295491, 1636421296158, 667, 266, 401, 1, 0, 1
3226, 1, 1636421295572, 1636421296234, 662, 268, 394, 1, 1, 2
3228, 1, 1636421295800, 1636421296462, 662, 269, 393, 0, 1, 1
3227, 1, 1636421295796, 1636421296470, 674, 269, 405, 0, 0, 0
3229, 1, 1636421295896, 1636421296558, 662, 263, 399, 1, 1, 2
3230, 1, 1636421295916, 1636421296582, 666, 269, 397, 0, 0, 0
3231, 1, 1636421295928, 1636421296598, 670, 274, 396, 2, 0, 2
3232, 1, 1636421295932, 1636421296598, 666, 269, 397, 1, 0, 1
3132, 2, 1636421286484, 1636421296659, 10175, 0, 10175, 1, 0, 1
3233, 1, 1636421296031, 1636421296698, 667, 270, 397, 0, 1, 1
3234, 1, 1636421296123, 1636421296790, 667, 270, 397, 1, 0, 1
3235, 1, 1636421296159, 1636421296830, 671, 266, 405, 1, 0, 1
3236, 1, 1636421296236, 1636421296926, 690, 291, 399, 0, 23, 23
3237, 1, 1636421296464, 1636421297126, 662, 267, 395, 1, 0, 1
3238, 1, 1636421296472, 1636421297138, 666, 270, 396, 0, 0, 0
3239, 1, 1636421296559, 1636421297238, 679, 266, 413, 0, 0, 0
3240, 1, 1636421296583, 1636421297250, 667, 266, 401, 0, 0, 0
3242, 1, 1636421296600, 1636421297270, 670, 270, 400, 0, 0, 0
3241, 1, 1636421296600, 1636421297270, 670, 273, 397, 1, 1, 2
3243, 1, 1636421296699, 1636421297358, 659, 267, 392, 1, 1, 2
3245, 1, 1636421296791, 1636421297450, 659, 262, 397, 0, 0, 0
3246, 1, 1636421296831, 1636421297514, 683, 274, 409, 0, 0, 0
3247, 1, 1636421296927, 1636421297594, 667, 265, 402, 0, 0, 0
3248, 1, 1636421297128, 1636421297790, 662, 270, 392, 0, 0, 0
3249, 1, 1636421297140, 1636421297814, 674, 271, 403, 1, 0, 1
3250, 1, 1636421297240, 1636421297902, 662, 266, 396, 1, 0, 1
3251, 1, 1636421297252, 1636421297922, 670, 270, 400, 1, 0, 1
3253, 1, 1636421297271, 1636421297942, 671, 269, 402, 1, 0, 1
3252, 1, 1636421297271, 1636421297942, 671, 271, 400, 1, 1, 2
3254, 1, 1636421297360, 1636421298014, 654, 258, 396, 0, 0, 0
3255, 1, 1636421297451, 1636421298118, 667, 263, 404, 1, 0, 1
3256, 1, 1636421297515, 1636421298190, 675, 270, 405, 0, 0, 0
3257, 1, 1636421297595, 1636421298262, 667, 266, 401, 0, 1, 1
3258, 1, 1636421297792, 1636421298462, 670, 273, 397, 1, 0, 1
3259, 1, 1636421297816, 1636421298478, 662, 262, 400, 0, 0, 0
3260, 1, 1636421297904, 1636421298566, 662, 262, 400, 0, 0, 0
3261, 1, 1636421297923, 1636421298590, 667, 267, 400, 0, 1, 1
3262, 1, 1636421297943, 1636421298618, 675, 270, 405, 1, 0, 1
3264, 1, 1636421298015, 1636421298682, 667, 271, 396, 1, 1, 2
3263, 1, 1636421297944, 1636421298746, 802, 406, 396, 2, 0, 2
3265, 1, 1636421298119, 1636421298782, 663, 266, 397, 1, 0, 1
3137, 2, 1636421288644, 1636421298820, 10176, 0, 10176, 0, 0, 0
3266, 1, 1636421298192, 1636421298858, 666, 271, 395, 1, 0, 1
3267, 1, 1636421298263, 1636421298938, 675, 270, 405, 0, 0, 0
3138, 2, 1636421288782, 1636421298963, 10181, 46, 10135, 47, 0, 47
3268, 1, 1636421298464, 1636421299178, 714, 268, 446, 2, 0, 2
3269, 1, 1636421298480, 1636421299178, 698, 302, 396, 1, 40, 41
3140, 2, 1636421289048, 1636421299224, 10176, 1, 10175, 1, 1, 2
3271, 1, 1636421298591, 1636421299266, 675, 279, 396, 1, 11, 12
3270, 1, 1636421298568, 1636421299266, 698, 302, 396, 1, 36, 37
3272, 1, 1636421298620, 1636421299326, 706, 297, 409, 0, 30, 30
3273, 1, 1636421298684, 1636421299358, 674, 271, 403, 2, 2, 4
3274, 1, 1636421298748, 1636421299418, 670, 266, 404, 0, 0, 0
3275, 1, 1636421298822, 1636421299490, 668, 261, 407, 2, 0, 2
3276, 1, 1636421298860, 1636421299578, 718, 303, 415, 0, 39, 39
3277, 1, 1636421298965, 1636421299670, 705, 305, 400, 0, 39, 39
3278, 1, 1636421299224, 1636421299850, 626, 270, 356, 4, 0, 4
3279, 1, 1636421299225, 1636421299850, 625, 267, 358, 0, 0, 0
3282, 1, 1636421299268, 1636421299934, 666, 270, 396, 2, 1, 3
3283, 1, 1636421299268, 1636421299946, 678, 279, 399, 2, 0, 2
3284, 1, 1636421299327, 1636421299998, 671, 267, 404, 0, 0, 0
3286, 1, 1636421299360, 1636421300030, 670, 270, 400, 2, 1, 3
3287, 1, 1636421299420, 1636421300086, 666, 266, 400, 1, 0, 1
3288, 1, 1636421299492, 1636421300162, 670, 271, 399, 1, 1, 2
3289, 1, 1636421299580, 1636421300250, 670, 271, 399, 0, 0, 0
3290, 1, 1636421299672, 1636421300338, 666, 262, 404, 0, 0, 0
3291, 1, 1636421299851, 1636421300518, 667, 275, 392, 2, 1, 3
3292, 1, 1636421299852, 1636421300518, 666, 274, 392, 2, 1, 3
3293, 1, 1636421299936, 1636421300606, 670, 271, 399, 2, 1, 3
3294, 1, 1636421299948, 1636421300618, 670, 266, 404, 0, 0, 0
3295, 1, 1636421300000, 1636421300666, 666, 269, 397, 1, 0, 1
3296, 1, 1636421300031, 1636421300694, 663, 270, 393, 0, 1, 1
3297, 1, 1636421300088, 1636421300762, 674, 271, 403, 1, 0, 1
3298, 1, 1636421300164, 1636421300830, 666, 265, 401, 0, 0, 0
3299, 1, 1636421300251, 1636421300918, 667, 266, 401, 0, 1, 1
3300, 1, 1636421300340, 1636421301006, 666, 266, 400, 0, 0, 0
3302, 1, 1636421300520, 1636421301178, 658, 266, 392, 0, 1, 1
3301, 1, 1636421300519, 1636421301182, 663, 271, 392, 1, 0, 1
3303, 1, 1636421300607, 1636421301278, 671, 267, 404, 1, 0, 1
3304, 1, 1636421300619, 1636421301290, 671, 270, 401, 0, 0, 0
3305, 1, 1636421300668, 1636421301342, 674, 274, 400, 1, 0, 1
3307, 1, 1636421300763, 1636421301434, 671, 269, 402, 1, 0, 1
3308, 1, 1636421300832, 1636421301494, 662, 267, 395, 1, 1, 2
3309, 1, 1636421300920, 1636421301586, 666, 266, 400, 1, 0, 1
3310, 1, 1636421301007, 1636421301678, 671, 266, 405, 1, 0, 1
3311, 1, 1636421301180, 1636421301850, 670, 276, 394, 0, 1, 1
3168, 2, 1636421291726, 1636421301903, 10177, 1, 10176, 2, 0, 2
3313, 1, 1636421301280, 1636421301946, 666, 266, 400, 0, 0, 0
3314, 1, 1636421301292, 1636421301962, 670, 271, 399, 0, 1, 1
3315, 1, 1636421301344, 1636421302010, 666, 267, 399, 2, 0, 2
3316, 1, 1636421301436, 1636421302106, 670, 271, 399, 1, 1, 2
3318, 1, 1636421301588, 1636421302258, 670, 270, 400, 0, 3, 3
3319, 1, 1636421301679, 1636421302354, 675, 277, 398, 0, 6, 6
3320, 1, 1636421301852, 1636421302522, 670, 270, 400, 0, 1, 1
3176, 2, 1636421292390, 1636421302564, 10174, 0, 10174, 1, 0, 1
3322, 1, 1636421301964, 1636421302630, 666, 270, 396, 0, 0, 0
3323, 1, 1636421302012, 1636421302682, 670, 269, 401, 0, 0, 0
3325, 1, 1636421302108, 1636421302774, 666, 271, 395, 0, 1, 1
3324, 1, 1636421302035, 1636421302922, 887, 490, 397, 0, 19, 19
3326, 1, 1636421302259, 1636421302930, 671, 270, 401, 1, 0, 1
3328, 1, 1636421302566, 1636421303238, 672, 274, 398, 0, 0, 0
3330, 1, 1636421302683, 1636421303346, 663, 267, 396, 0, 1, 1
3332, 1, 1636421302776, 1636421303442, 666, 265, 401, 0, 0, 0
3331, 1, 1636421302699, 1636421303506, 807, 409, 398, 1, 0, 1
3334, 1, 1636421302932, 1636421303594, 662, 267, 395, 1, 0, 1
3333, 1, 1636421302924, 1636421303594, 670, 269, 401, 1, 0, 1
3192, 2, 1636421293422, 1636421303600, 10178, 0, 10178, 0, 1, 1
3197, 2, 1636421293758, 1636421303935, 10177, 1, 10176, 1, 1, 2
3336, 1, 1636421303348, 1636421304050, 702, 302, 400, 0, 36, 36
3337, 1, 1636421303444, 1636421304146, 702, 274, 428, 1, 0, 1
3202, 2, 1636421294018, 1636421304195, 10177, 1, 10176, 0, 1, 1
3338, 1, 1636421303508, 1636421304198, 690, 289, 401, 0, 24, 24
3340, 1, 1636421303602, 1636421304290, 688, 291, 397, 3, 22, 25
3339, 1, 1636421303601, 1636421304290, 689, 295, 394, 2, 27, 29
3206, 1, 1636421294334, 1636421304678, 10344, 9947, 397, 0, 0, 0
3342, 1, 1636421304052, 1636421304722, 670, 261, 409, 0, 1, 1
3345, 1, 1636421304199, 1636421304858, 659, 262, 397, 0, 0, 0
3347, 1, 1636421304291, 1636421304958, 667, 270, 397, 2, 0, 2
3346, 1, 1636421304291, 1636421304958, 667, 271, 396, 2, 0, 2
3350, 1, 1636421304723, 1636421305394, 671, 269, 402, 0, 1, 1
3351, 1, 1636421304860, 1636421305526, 666, 268, 398, 0, 0, 0
3352, 1, 1636421304959, 1636421305622, 663, 266, 397, 1, 0, 1
3354, 1, 1636421305396, 1636421306058, 662, 266, 396, 0, 1, 1
3355, 1, 1636421305529, 1636421306198, 669, 270, 399, 0, 0, 0
3356, 1, 1636421305624, 1636421306290, 666, 262, 404, 0, 0, 0
3357, 1, 1636421306060, 1636421306726, 666, 269, 397, 0, 0, 0
3358, 1, 1636421306200, 1636421306866, 666, 270, 396, 0, 0, 0
3359, 1, 1636421306291, 1636421306954, 663, 268, 395, 1, 1, 2
3244, 2, 1636421296790, 1636421306964, 10174, 0, 10174, 0, 1, 1
3361, 1, 1636421306868, 1636421307542, 674, 270, 404, 0, 1, 1
3362, 1, 1636421306965, 1636421307626, 661, 267, 394, 1, 0, 1
3363, 1, 1636421307098, 1636421307762, 664, 270, 394, 0, 0, 0
3364, 1, 1636421307544, 1636421308210, 666, 270, 396, 0, 1, 1
3365, 1, 1636421307628, 1636421308294, 666, 269, 397, 2, 0, 2
3366, 1, 1636421307764, 1636421308430, 666, 270, 396, 1, 0, 1
3367, 1, 1636421308212, 1636421308878, 666, 269, 397, 0, 0, 0
3368, 1, 1636421308296, 1636421308962, 666, 269, 397, 1, 1, 2
3369, 1, 1636421308432, 1636421309098, 666, 269, 397, 0, 0, 0
3281, 2, 1636421299226, 1636421309404, 10178, 2, 10176, 2, 1, 3
3280, 2, 1636421299226, 1636421309447, 10221, 1, 10220, 0, 0, 0
3285, 2, 1636421299355, 1636421309531, 10176, 0, 10176, 0, 0, 0
3370, 1, 1636421308880, 1636421309554, 674, 270, 404, 0, 1, 1
3371, 1, 1636421308964, 1636421309710, 746, 309, 437, 0, 38, 38
3372, 1, 1636421309100, 1636421309806, 706, 310, 396, 0, 38, 38
3374, 1, 1636421309535, 1636421310202, 667, 271, 396, 1, 1, 2
3375, 1, 1636421309556, 1636421310222, 666, 270, 396, 0, 0, 0
3377, 1, 1636421309712, 1636421310374, 662, 266, 396, 0, 0, 0
3378, 1, 1636421309808, 1636421310466, 658, 262, 396, 1, 0, 1
3306, 2, 1636421300695, 1636421310868, 10173, 0, 10173, 0, 1, 1
3379, 1, 1636421310203, 1636421310878, 675, 274, 401, 1, 0, 1
3380, 1, 1636421310223, 1636421310894, 671, 268, 403, 0, 0, 0
3381, 1, 1636421310375, 1636421311046, 671, 269, 402, 0, 0, 0
3382, 1, 1636421310467, 1636421311134, 667, 270, 397, 1, 1, 2
3312, 2, 1636421301184, 1636421311359, 10175, 0, 10175, 0, 0, 0
3383, 1, 1636421310879, 1636421311546, 667, 268, 399, 0, 0, 0
3384, 1, 1636421310897, 1636421311566, 669, 270, 399, 1, 1, 2
3385, 1, 1636421310994, 1636421311654, 660, 265, 395, 0, 0, 0
3317, 2, 1636421301495, 1636421311675, 10180, 1, 10179, 0, 1, 1
3387, 1, 1636421311136, 1636421311802, 666, 270, 396, 0, 6, 6
3321, 2, 1636421301948, 1636421312124, 10176, 1, 10175, 1, 0, 1
3389, 1, 1636421311548, 1636421312214, 666, 268, 398, 0, 0, 0
3391, 1, 1636421311677, 1636421312386, 709, 270, 439, 1, 0, 1
3392, 1, 1636421311803, 1636421312478, 675, 278, 397, 1, 10, 11
3393, 1, 1636421311806, 1636421312482, 676, 273, 403, 0, 10, 10
3327, 2, 1636421302356, 1636421312532, 10176, 1, 10175, 0, 1, 1
3329, 2, 1636421302632, 1636421312808, 10176, 0, 10176, 0, 0, 0
3395, 1, 1636421312254, 1636421312922, 668, 268, 400, 1, 0, 1
3396, 1, 1636421312388, 1636421313074, 686, 275, 411, 0, 2, 2
3397, 1, 1636421312479, 1636421313162, 683, 286, 397, 0, 18, 18
3399, 1, 1636421312662, 1636421313338, 676, 264, 412, 1, 1, 2
3335, 2, 1636421303240, 1636421313416, 10176, 0, 10176, 0, 0, 0
3401, 1, 1636421312942, 1636421313614, 672, 269, 403, 0, 1, 1
3402, 1, 1636421313076, 1636421313770, 694, 299, 395, 1, 35, 36
3403, 1, 1636421313164, 1636421313862, 698, 302, 396, 1, 34, 35
3341, 2, 1636421303730, 1636421313908, 10178, 0, 10178, 0, 0, 0
3405, 1, 1636421313550, 1636421314210, 660, 265, 395, 1, 0, 1
3343, 2, 1636421304066, 1636421314243, 10177, 0, 10177, 0, 0, 0
3344, 2, 1636421304148, 1636421314323, 10175, 0, 10175, 0, 0, 0
3407, 1, 1636421313771, 1636421314442, 671, 267, 404, 0, 0, 0
3348, 2, 1636421304326, 1636421314503, 10177, 1, 10176, 1, 1, 2
3408, 1, 1636421313910, 1636421314598, 688, 290, 398, 0, 26, 26
3349, 2, 1636421304679, 1636421314856, 10177, 1, 10176, 1, 0, 1
3413, 1, 1636421314458, 1636421315126, 668, 269, 399, 0, 1, 1
3353, 2, 1636421304960, 1636421315136, 10176, 0, 10176, 1, 0, 1
3414, 1, 1636421314600, 1636421315302, 702, 306, 396, 0, 39, 39
3394, 1, 1636421312216, 1636421315346, 3130, 2734, 396, 1, 0, 1
3418, 1, 1636421315266, 1636421315942, 676, 273, 403, 0, 0, 0
3419, 1, 1636421315304, 1636421315978, 674, 274, 400, 0, 1, 1
3420, 1, 1636421315348, 1636421316022, 674, 271, 403, 1, 2, 3
3423, 1, 1636421316024, 1636421316698, 674, 274, 400, 1, 0, 1
3360, 2, 1636421306727, 1636421316905, 10178, 1, 10177, 1, 0, 1
3424, 1, 1636421316700, 1636421317366, 666, 269, 397, 2, 0, 2
3425, 1, 1636421317034, 1636421317698, 664, 268, 396, 0, 0, 0
3426, 1, 1636421317369, 1636421318034, 665, 265, 400, 0, 0, 0
3428, 1, 1636421318036, 1636421318714, 678, 270, 408, 1, 0, 1
3429, 1, 1636421318716, 1636421319382, 666, 268, 398, 0, 0, 0
3373, 2, 1636421309534, 1636421319711, 10177, 1, 10176, 0, 1, 1
3376, 2, 1636421309662, 1636421319840, 10178, 0, 10178, 0, 0, 0
3430, 1, 1636421319384, 1636421320106, 722, 325, 397, 2, 56, 58
3431, 1, 1636421320107, 1636421320774, 667, 271, 396, 0, 1, 1
3432, 1, 1636421320114, 1636421320786, 672, 266, 406, 0, 0, 0
3433, 1, 1636421320114, 1636421321058, 944, 542, 402, 1, 0, 1
3434, 1, 1636421320776, 1636421321446, 670, 270, 400, 0, 1, 1
3386, 2, 1636421311047, 1636421321462, 10415, 193, 10222, 0, 0, 0
3388, 2, 1636421311494, 1636421321667, 10173, 0, 10173, 0, 0, 0
3390, 2, 1636421311568, 1636421321767, 10199, 1, 10198, 1, 0, 1
3437, 1, 1636421321464, 1636421322126, 662, 266, 396, 1, 0, 1
3438, 1, 1636421321551, 1636421322246, 695, 270, 425, 0, 1, 1
3439, 1, 1636421321799, 1636421322462, 663, 269, 394, 0, 0, 0
3398, 2, 1636421312484, 1636421322659, 10175, 0, 10175, 0, 0, 0
3440, 1, 1636421322128, 1636421322798, 670, 271, 399, 2, 0, 2
3441, 1, 1636421322248, 1636421322926, 678, 280, 398, 0, 15, 15
3400, 2, 1636421312924, 1636421323099, 10175, 0, 10175, 0, 0, 0
3442, 1, 1636421322464, 1636421323134, 670, 267, 403, 0, 2, 2
3443, 1, 1636421322790, 1636421323462, 672, 273, 399, 1, 0, 1
3444, 1, 1636421322800, 1636421323462, 662, 265, 397, 1, 0, 1
3404, 2, 1636421313340, 1636421323516, 10176, 0, 10176, 0, 1, 1
3445, 1, 1636421322928, 1636421323638, 710, 267, 443, 0, 0, 0
3406, 2, 1636421313616, 1636421323792, 10176, 1, 10175, 0, 0, 0
3446, 1, 1636421323136, 1636421323802, 666, 269, 397, 1, 0, 1
3447, 1, 1636421323230, 1636421323894, 664, 265, 399, 0, 0, 0
3409, 2, 1636421314038, 1636421324211, 10173, 0, 10173, 0, 0, 0
3451, 1, 1636421323646, 1636421324330, 684, 271, 413, 2, 0, 2
3450, 1, 1636421323640, 1636421324330, 690, 271, 419, 1, 0, 1
3410, 2, 1636421314245, 1636421324420, 10175, 0, 10175, 0, 1, 1
3452, 1, 1636421323804, 1636421324478, 674, 275, 399, 0, 10, 10
3411, 2, 1636421314410, 1636421324592, 10182, 0, 10182, 1, 0, 1
3412, 2, 1636421314444, 1636421324635, 10191, 0, 10191, 0, 0, 0
3415, 2, 1636421314634, 1636421324816, 10182, 1, 10181, 0, 1, 1
3455, 1, 1636421324332, 1636421325082, 750, 350, 400, 1, 82, 83
3457, 1, 1636421324346, 1636421325082, 736, 286, 450, 1, 18, 19
3458, 1, 1636421324479, 1636421325174, 695, 270, 425, 0, 1, 1
3416, 1, 1636421314986, 1636421325306, 10320, 9904, 416, 1, 0, 1
3417, 2, 1636421315138, 1636421325315, 10177, 0, 10177, 0, 0, 0
3460, 1, 1636421324722, 1636421325398, 676, 269, 407, 1, 0, 1
3462, 1, 1636421324946, 1636421325674, 728, 327, 401, 1, 8, 9
3463, 1, 1636421325084, 1636421325766, 682, 287, 395, 1, 15, 16
3465, 1, 1636421325176, 1636421325846, 670, 264, 406, 0, 0, 0
3466, 1, 1636421325317, 1636421325990, 673, 267, 406, 1, 0, 1
3421, 2, 1636421315944, 1636421326120, 10176, 0, 10176, 1, 0, 1
3422, 2, 1636421315979, 1636421326163, 10184, 1, 10183, 1, 0, 1
3471, 1, 1636421325848, 1636421326522, 674, 277, 397, 0, 11, 11
3474, 1, 1636421326525, 1636421327190, 665, 270, 395, 0, 1, 1
3475, 1, 1636421327193, 1636421327858, 665, 270, 395, 0, 0, 0
3427, 2, 1636421317700, 1636421327875, 10175, 1, 10174, 0, 0, 0
3476, 1, 1636421327877, 1636421328546, 669, 268, 401, 1, 0, 1
3478, 1, 1636421328548, 1636421329222, 674, 268, 406, 0, 0, 0
3479, 1, 1636421329225, 1636421329894, 669, 269, 400, 0, 0, 0
3480, 1, 1636421329896, 1636421330562, 666, 270, 396, 0, 0, 0
3435, 2, 1636421320788, 1636421330964, 10176, 0, 10176, 0, 0, 0
3436, 2, 1636421321060, 1636421331236, 10176, 0, 10176, 0, 0, 0
3483, 1, 1636421331547, 1636421332210, 663, 270, 393, 0, 0, 0
3482, 1, 1636421331546, 1636421332214, 668, 265, 403, 0, 0, 0
3485, 1, 1636421331547, 1636421332478, 931, 535, 396, 1, 0, 1
3486, 1, 1636421332212, 1636421332878, 666, 269, 397, 1, 0, 1
3487, 1, 1636421332215, 1636421332882, 667, 266, 401, 0, 1, 1
3488, 1, 1636421332480, 1636421333154, 674, 279, 395, 0, 1, 1
3490, 1, 1636421332883, 1636421333542, 659, 262, 397, 1, 0, 1
3489, 1, 1636421332880, 1636421333546, 666, 267, 399, 2, 0, 2
3449, 2, 1636421323464, 1636421333639, 10175, 1, 10174, 2, 0, 2
3448, 2, 1636421323464, 1636421333688, 10224, 0, 10224, 0, 0, 0
3491, 1, 1636421333156, 1636421333822, 666, 271, 395, 1, 0, 1
3453, 2, 1636421323895, 1636421334071, 10176, 0, 10176, 0, 0, 0
3493, 1, 1636421333548, 1636421334226, 678, 319, 359, 50, 0, 50
3492, 1, 1636421333544, 1636421334226, 682, 318, 364, 49, 0, 49
3454, 2, 1636421323922, 1636421334242, 10320, 100, 10220, 0, 0, 0
3495, 1, 1636421333778, 1636421334510, 732, 330, 402, 0, 62, 62
3456, 2, 1636421324332, 1636421334511, 10179, 1, 10178, 1, 0, 1
3496, 1, 1636421333824, 1636421334598, 774, 379, 395, 0, 104, 104
3477, 1, 1636421328006, 1636421334694, 6688, 6289, 399, 0, 0, 0
3459, 2, 1636421324636, 1636421334772, 10136, 0, 10136, 1, 0, 1
3497, 1, 1636421334243, 1636421334874, 631, 269, 362, 1, 2, 3
3498, 1, 1636421334244, 1636421334902, 658, 261, 397, 1, 0, 1
3499, 1, 1636421334245, 1636421334906, 661, 268, 393, 4, 0, 4
3461, 2, 1636421324742, 1636421334920, 10178, 0, 10178, 0, 1, 1
3468, 1, 1636421325446, 1636421334962, 9516, 9114, 402, 0, 0, 0
3501, 1, 1636421334513, 1636421335218, 705, 306, 399, 0, 38, 38
3464, 2, 1636421325084, 1636421335260, 10176, 0, 10176, 1, 0, 1
3473, 1, 1636421326254, 1636421335282, 9028, 8625, 403, 0, 18, 18
3503, 1, 1636421334642, 1636421335310, 668, 270, 398, 2, 0, 2
3502, 1, 1636421334599, 1636421335310, 711, 271, 440, 1, 0, 1
3505, 1, 1636421334921, 1636421335538, 617, 267, 350, 1, 1, 2
3467, 2, 1636421325399, 1636421335575, 10176, 1, 10175, 0, 1, 1
3507, 1, 1636421334922, 1636421335614, 692, 296, 396, 0, 23, 23
3506, 1, 1636421334921, 1636421335618, 697, 302, 395, 3, 31, 34
3469, 2, 1636421325675, 1636421335851, 10176, 0, 10176, 0, 0, 0
3509, 1, 1636421335050, 1636421335878, 828, 434, 394, 0, 0, 0
3511, 1, 1636421335262, 1636421335938, 676, 275, 401, 0, 6, 6
3470, 2, 1636421325768, 1636421335943, 10175, 0, 10175, 0, 0, 0
3513, 1, 1636421335311, 1636421336026, 715, 315, 400, 2, 42, 44
3514, 1, 1636421335311, 1636421336146, 835, 435, 400, 2, 0, 2
3472, 2, 1636421325992, 1636421336211, 10219, 0, 10219, 0, 0, 0
3516, 1, 1636421335577, 1636421336234, 657, 262, 395, 0, 0, 0
3518, 1, 1636421335619, 1636421336302, 683, 283, 400, 0, 16, 16
3520, 1, 1636421335879, 1636421336566, 687, 294, 393, 1, 27, 28
3521, 1, 1636421335945, 1636421336662, 717, 314, 403, 1, 43, 44
3523, 1, 1636421336028, 1636421336694, 666, 272, 394, 0, 2, 2
3481, 1, 1636421330565, 1636421336714, 6149, 5747, 402, 2, 0, 2
3527, 1, 1636421336304, 1636421336974, 670, 274, 396, 0, 0, 0
3529, 1, 1636421336567, 1636421337226, 659, 267, 392, 1, 0, 1
3530, 1, 1636421336663, 1636421337330, 667, 267, 400, 0, 1, 1
3532, 1, 1636421336715, 1636421337386, 671, 272, 399, 0, 0, 0
3533, 1, 1636421336975, 1636421337642, 667, 271, 396, 1, 1, 2
3534, 1, 1636421337228, 1636421337890, 662, 269, 393, 0, 0, 0
3535, 1, 1636421337332, 1636421337998, 666, 270, 396, 1, 0, 1
3536, 1, 1636421337388, 1636421338054, 666, 270, 396, 1, 0, 1
3537, 1, 1636421337644, 1636421338310, 666, 270, 396, 0, 1, 1
3538, 1, 1636421337892, 1636421338562, 670, 270, 400, 0, 0, 0
3539, 1, 1636421338000, 1636421338666, 666, 271, 395, 2, 0, 2
3540, 1, 1636421338056, 1636421338722, 666, 268, 398, 0, 0, 0
3541, 1, 1636421338312, 1636421338974, 662, 267, 395, 1, 1, 2
3542, 1, 1636421338564, 1636421339230, 666, 269, 397, 0, 0, 0
3543, 1, 1636421338668, 1636421339330, 662, 266, 396, 1, 0, 1
3544, 1, 1636421338724, 1636421339390, 666, 270, 396, 0, 1, 1
3545, 1, 1636421338975, 1636421339638, 663, 267, 396, 0, 0, 0
3546, 1, 1636421339232, 1636421339894, 662, 271, 391, 0, 1, 1
3548, 1, 1636421339392, 1636421340062, 670, 269, 401, 0, 0, 0
3550, 1, 1636421339896, 1636421340558, 662, 270, 392, 0, 0, 0
3551, 1, 1636421340064, 1636421340734, 670, 268, 402, 1, 0, 1
3552, 1, 1636421340560, 1636421341222, 662, 271, 391, 0, 1, 1
3554, 1, 1636421341224, 1636421341894, 670, 269, 401, 1, 1, 2
3484, 2, 1636421331547, 1636421342134, 10587, 361, 10226, 0, 1, 1
3555, 1, 1636421341896, 1636421342578, 682, 287, 395, 0, 21, 21
3556, 1, 1636421342222, 1636421342894, 672, 269, 403, 0, 1, 1
3557, 1, 1636421342580, 1636421343246, 666, 271, 395, 0, 0, 0
3558, 1, 1636421342896, 1636421343562, 666, 269, 397, 0, 0, 0
3559, 1, 1636421343248, 1636421343910, 662, 267, 395, 1, 0, 1
3494, 2, 1636421333778, 1636421343956, 10178, 0, 10178, 1, 0, 1
3560, 1, 1636421343564, 1636421344226, 662, 266, 396, 1, 1, 2
3500, 2, 1636421334334, 1636421344512, 10178, 0, 10178, 0, 0, 0
3561, 1, 1636421343958, 1636421344622, 664, 271, 393, 0, 2, 2
3562, 1, 1636421344086, 1636421344778, 692, 291, 401, 1, 22, 23
3504, 2, 1636421334696, 1636421344871, 10175, 0, 10175, 0, 0, 0
3563, 1, 1636421344228, 1636421344894, 666, 270, 396, 1, 0, 1
3508, 2, 1636421334963, 1636421345140, 10177, 1, 10176, 1, 0, 1
3564, 1, 1636421344624, 1636421345322, 698, 302, 396, 1, 35, 36
3565, 1, 1636421344642, 1636421345326, 684, 277, 407, 1, 11, 12
3510, 2, 1636421335194, 1636421345367, 10173, 0, 10173, 0, 0, 0
3512, 2, 1636421335283, 1636421345459, 10176, 0, 10176, 0, 0, 0
3566, 1, 1636421344780, 1636421345498, 718, 268, 450, 0, 1, 1
3515, 2, 1636421335390, 1636421345564, 10174, 0, 10174, 0, 0, 0
3567, 1, 1636421344896, 1636421345634, 738, 340, 398, 0, 69, 69
3568, 1, 1636421345002, 1636421345730, 728, 272, 456, 1, 3, 4
3517, 2, 1636421335616, 1636421345792, 10176, 0, 10176, 0, 0, 0
3519, 2, 1636421335706, 1636421345896, 10190, 1, 10189, 0, 1, 1
3570, 1, 1636421345369, 1636421346058, 689, 332, 357, 1, 61, 62
3571, 1, 1636421345370, 1636421346058, 688, 286, 402, 0, 15, 15
3569, 1, 1636421345274, 1636421346058, 784, 378, 406, 48, 62, 110
3522, 2, 1636421335988, 1636421346164, 10176, 1, 10175, 1, 0, 1
3573, 1, 1636421345500, 1636421346178, 678, 278, 400, 1, 0, 1
3524, 2, 1636421336074, 1636421346259, 10185, 1, 10184, 1, 0, 1
3525, 2, 1636421336148, 1636421346323, 10175, 0, 10175, 0, 0, 0
3575, 1, 1636421345636, 1636421346346, 710, 285, 425, 0, 14, 14
3574, 1, 1636421345598, 1636421346346, 748, 347, 401, 3, 14, 17
3526, 2, 1636421336235, 1636421346411, 10176, 0, 10176, 0, 0, 0
3576, 1, 1636421345732, 1636421346434, 702, 271, 431, 1, 0, 1
3528, 2, 1636421336342, 1636421346519, 10177, 1, 10176, 0, 0, 0
3572, 1, 1636421345498, 1636421346614, 1116, 723, 393, 0, 0, 0
3580, 1, 1636421346060, 1636421346786, 726, 307, 419, 3, 41, 44
3578, 1, 1636421346059, 1636421346786, 727, 308, 419, 2, 37, 39
3579, 1, 1636421346060, 1636421346790, 730, 309, 421, 3, 34, 37
3531, 2, 1636421336695, 1636421346872, 10177, 0, 10177, 0, 0, 0
3581, 1, 1636421346180, 1636421346874, 694, 284, 410, 1, 10, 11
3583, 1, 1636421346348, 1636421347050, 702, 265, 437, 0, 2, 2
3584, 1, 1636421346436, 1636421347138, 702, 301, 401, 0, 39, 39
3587, 1, 1636421346607, 1636421347318, 711, 314, 397, 1, 48, 49
3589, 1, 1636421346651, 1636421347318, 667, 270, 397, 2, 4, 6
3591, 1, 1636421346788, 1636421347458, 670, 271, 399, 1, 0, 1
3590, 1, 1636421346788, 1636421347466, 678, 274, 404, 0, 0, 0
3593, 1, 1636421346876, 1636421347542, 666, 266, 400, 1, 1, 2
3594, 1, 1636421347002, 1636421347677, 675, 272, 403, 1, 1, 2
3595, 1, 1636421347052, 1636421347722, 670, 274, 396, 1, 2, 3
3598, 1, 1636421347319, 1636421347986, 667, 266, 401, 1, 0, 1
3597, 1, 1636421347319, 1636421347986, 667, 270, 397, 1, 0, 1
3600, 1, 1636421347467, 1636421348126, 659, 262, 397, 0, 0, 0
3601, 1, 1636421347544, 1636421348214, 670, 274, 396, 1, 0, 1
3602, 1, 1636421347678, 1636421348342, 664, 266, 398, 2, 0, 2
3603, 1, 1636421347724, 1636421348390, 666, 270, 396, 1, 0, 1
3604, 1, 1636421347987, 1636421348658, 671, 271, 400, 3, 1, 4
3605, 1, 1636421347988, 1636421348658, 670, 268, 402, 1, 0, 1
3606, 1, 1636421348127, 1636421348790, 663, 270, 393, 2, 0, 2
3607, 1, 1636421348216, 1636421348882, 666, 269, 397, 0, 0, 0
3608, 1, 1636421348344, 1636421349014, 670, 271, 399, 0, 1, 1
3609, 1, 1636421348392, 1636421349054, 662, 266, 396, 0, 0, 0
3610, 1, 1636421348659, 1636421349326, 667, 270, 397, 1, 1, 2
3611, 1, 1636421348660, 1636421349330, 670, 270, 400, 1, 2, 3
3547, 2, 1636421339332, 1636421349507, 10175, 0, 10175, 1, 0, 1
3613, 1, 1636421348883, 1636421349546, 663, 265, 398, 0, 0, 0
3614, 1, 1636421349016, 1636421349682, 666, 270, 396, 0, 0, 0
3615, 1, 1636421349056, 1636421349722, 666, 269, 397, 0, 0, 0
3549, 2, 1636421339640, 1636421349815, 10175, 1, 10174, 1, 0, 1
3616, 1, 1636421349328, 1636421349998, 670, 275, 395, 1, 2, 3
3618, 1, 1636421349548, 1636421350222, 674, 270, 404, 0, 1, 1
3619, 1, 1636421349642, 1636421350350, 708, 264, 444, 1, 0, 1
3622, 1, 1636421349946, 1636421350610, 664, 267, 397, 0, 1, 1
3623, 1, 1636421350000, 1636421350666, 666, 266, 400, 0, 0, 0
3624, 1, 1636421350223, 1636421350894, 671, 271, 400, 1, 1, 2
3553, 2, 1636421340736, 1636421350911, 10175, 0, 10175, 0, 0, 0
3625, 1, 1636421350352, 1636421351018, 666, 271, 395, 1, 1, 2
3627, 1, 1636421350667, 1636421351358, 691, 296, 395, 1, 26, 27
3628, 1, 1636421350913, 1636421351578, 665, 269, 396, 1, 1, 2
3631, 1, 1636421351359, 1636421352026, 667, 271, 396, 0, 0, 0
3632, 1, 1636421351580, 1636421352246, 666, 269, 397, 1, 0, 1
3633, 1, 1636421352028, 1636421352694, 666, 270, 396, 0, 0, 0
3634, 1, 1636421352218, 1636421352878, 660, 268, 392, 0, 0, 0
3637, 1, 1636421352249, 1636421352918, 669, 268, 401, 1, 0, 1
3638, 1, 1636421352696, 1636421353362, 666, 271, 395, 0, 2, 2
3639, 1, 1636421352880, 1636421353546, 666, 270, 396, 0, 0, 0
3640, 1, 1636421352919, 1636421353586, 667, 270, 397, 1, 0, 1
3641, 1, 1636421353364, 1636421354026, 662, 266, 396, 1, 0, 1
3642, 1, 1636421353548, 1636421354218, 670, 270, 400, 0, 0, 0
3643, 1, 1636421353587, 1636421354254, 667, 269, 398, 0, 0, 0
3645, 1, 1636421354220, 1636421354882, 662, 267, 395, 0, 0, 0
3646, 1, 1636421354257, 1636421354922, 665, 268, 397, 1, 0, 1
3647, 1, 1636421354883, 1636421355550, 667, 270, 397, 0, 0, 0
3648, 1, 1636421354924, 1636421355594, 670, 269, 401, 2, 0, 2
3577, 2, 1636421345922, 1636421356096, 10174, 1, 10173, 1, 1, 2
3649, 1, 1636421355552, 1636421356226, 674, 274, 400, 1, 0, 1
3650, 1, 1636421355596, 1636421356266, 670, 269, 401, 0, 0, 0
3582, 2, 1636421346348, 1636421356702, 10354, 90, 10264, 1, 0, 1
3585, 2, 1636421346520, 1636421356748, 10228, 1, 10227, 1, 0, 1
3588, 2, 1636421346615, 1636421356792, 10177, 9961, 216, 0, 5, 5
3586, 2, 1636421346607, 1636421356835, 10228, 1, 10227, 1, 0, 1
3592, 2, 1636421346791, 1636421356971, 10180, 0, 10180, 0, 0, 0
3652, 1, 1636421356228, 1636421357098, 870, 387, 483, 0, 118, 118
3653, 1, 1636421356268, 1636421357098, 830, 301, 529, 0, 33, 33
3596, 2, 1636421347139, 1636421357316, 10177, 0, 10177, 1, 1, 2
3599, 2, 1636421347460, 1636421357636, 10176, 0, 10176, 1, 0, 1
3659, 1, 1636421357100, 1636421357766, 666, 270, 396, 2, 0, 2
3660, 1, 1636421357102, 1636421357778, 676, 274, 402, 1, 0, 1
3661, 1, 1636421357450, 1636421358122, 672, 271, 401, 1, 1, 2
3662, 1, 1636421357766, 1636421358434, 668, 270, 398, 1, 0, 1
3664, 1, 1636421357780, 1636421358446, 666, 269, 397, 0, 0, 0
3665, 1, 1636421358124, 1636421358790, 666, 270, 396, 0, 0, 0
3612, 2, 1636421348792, 1636421358963, 10171, 1, 10170, 0, 0, 0
3666, 1, 1636421358436, 1636421359106, 670, 269, 401, 0, 1, 1
3667, 1, 1636421358448, 1636421359122, 674, 270, 404, 0, 0, 0
3668, 1, 1636421358792, 1636421359498, 706, 267, 439, 0, 0, 0
3617, 2, 1636421349331, 1636421359555, 10224, 0, 10224, 0, 0, 0
3670, 1, 1636421359108, 1636421359826, 718, 311, 407, 1, 42, 43
3671, 1, 1636421359124, 1636421359826, 702, 298, 404, 0, 30, 30
3620, 2, 1636421349684, 1636421359860, 10176, 0, 10176, 0, 0, 0
3621, 2, 1636421349724, 1636421359903, 10179, 1, 10178, 1, 0, 1
3672, 1, 1636421359500, 1636421360170, 670, 272, 398, 1, 6, 7
3673, 1, 1636421359682, 1636421360350, 668, 269, 399, 1, 3, 4
3674, 1, 1636421359906, 1636421360574, 668, 269, 399, 0, 1, 1
3676, 1, 1636421359995, 1636421360662, 667, 270, 397, 0, 0, 0
3677, 1, 1636421360034, 1636421360702, 668, 269, 399, 1, 1, 2
3626, 2, 1636421350612, 1636421360792, 10180, 0, 10180, 0, 0, 0
3679, 1, 1636421360351, 1636421361058, 707, 310, 397, 3, 40, 43
3629, 2, 1636421351020, 1636421361196, 10176, 0, 10176, 0, 0, 0
3630, 2, 1636421351043, 1636421361243, 10200, 0, 10200, 0, 0, 0
3681, 1, 1636421360665, 1636421361326, 661, 262, 399, 0, 0, 0
3635, 2, 1636421352218, 1636421362395, 10177, 1, 10176, 1, 0, 1
3636, 2, 1636421352222, 1636421362440, 10218, 1, 10217, 2, 0, 2
3658, 1, 1636421357099, 1636421362926, 5827, 5428, 399, 0, 0, 0
3688, 1, 1636421362790, 1636421363458, 668, 267, 401, 1, 0, 1
3690, 1, 1636421362928, 1636421363594, 666, 270, 396, 0, 0, 0
3689, 1, 1636421362791, 1636421363722, 931, 534, 397, 2, 0, 2
3691, 1, 1636421363459, 1636421364126, 667, 271, 396, 0, 0, 0
3644, 2, 1636421354028, 1636421364204, 10176, 1, 10175, 0, 1, 1
3692, 1, 1636421363596, 1636421364258, 662, 266, 396, 0, 0, 0
3693, 1, 1636421363724, 1636421364398, 674, 283, 391, 1, 1, 2
3694, 1, 1636421364128, 1636421364794, 666, 272, 394, 1, 2, 3
3695, 1, 1636421364260, 1636421364930, 670, 275, 395, 2, 0, 2
3696, 1, 1636421364334, 1636421364998, 664, 262, 402, 0, 0, 0
3697, 1, 1636421364400, 1636421365062, 662, 266, 396, 2, 0, 2
3698, 1, 1636421364796, 1636421365458, 662, 266, 396, 1, 0, 1
3701, 1, 1636421365064, 1636421365722, 658, 267, 391, 0, 1, 1
3702, 1, 1636421365460, 1636421366122, 662, 266, 396, 0, 0, 0
3703, 1, 1636421365723, 1636421366394, 671, 278, 393, 1, 1, 2
3651, 2, 1636421356226, 1636421366400, 10174, 1, 10173, 0, 0, 0
3704, 1, 1636421366124, 1636421366794, 670, 269, 401, 1, 0, 1
3705, 1, 1636421366401, 1636421367058, 657, 263, 394, 1, 1, 2
3655, 2, 1636421356882, 1636421367059, 10177, 0, 10177, 0, 0, 0
3656, 2, 1636421356922, 1636421367103, 10181, 0, 10181, 0, 0, 0
3657, 2, 1636421356922, 1636421367148, 10226, 0, 10226, 0, 0, 0
3654, 2, 1636421356879, 1636421367192, 10313, 0, 10313, 1, 0, 1
3707, 1, 1636421366796, 1636421367638, 842, 445, 397, 0, 178, 178
3708, 1, 1636421367193, 1636421367906, 713, 358, 355, 2, 0, 2
3663, 2, 1636421357768, 1636421367944, 10176, 0, 10176, 1, 0, 1
3713, 1, 1636421367640, 1636421368310, 670, 271, 399, 2, 0, 2
3714, 1, 1636421367946, 1636421368614, 668, 275, 393, 1, 1, 2
3716, 1, 1636421368312, 1636421368982, 670, 270, 400, 0, 1, 1
3669, 2, 1636421359090, 1636421369263, 10173, 0, 10173, 0, 0, 0
3717, 1, 1636421368616, 1636421369282, 666, 270, 396, 0, 0, 0
3718, 1, 1636421368984, 1636421369654, 670, 271, 399, 0, 2, 2
3719, 1, 1636421369284, 1636421369946, 662, 270, 392, 0, 1, 1
3675, 2, 1636421359906, 1636421370084, 10178, 1, 10177, 2, 0, 2
3678, 2, 1636421360172, 1636421370348, 10176, 0, 10176, 0, 0, 0
3680, 2, 1636421360576, 1636421370752, 10176, 0, 10176, 0, 0, 0
3682, 2, 1636421360704, 1636421370884, 10180, 1, 10179, 2, 0, 2
3723, 1, 1636421370214, 1636421370890, 676, 268, 408, 0, 0, 0
3683, 2, 1636421360922, 1636421371100, 10178, 0, 10178, 0, 1, 1
3684, 2, 1636421361060, 1636421371240, 10180, 1, 10179, 48, 0, 48
3724, 1, 1636421370478, 1636421371242, 764, 366, 398, 0, 82, 82
3685, 2, 1636421361328, 1636421371504, 10176, 0, 10176, 0, 0, 0
3725, 1, 1636421370884, 1636421371550, 666, 270, 396, 0, 1, 1
3687, 2, 1636421361350, 1636421371551, 10201, 1, 10200, 0, 0, 0
3726, 1, 1636421370892, 1636421371594, 702, 302, 400, 0, 35, 35
3686, 2, 1636421361334, 1636421371596, 10262, 1, 10261, 0, 0, 0
3729, 1, 1636421371244, 1636421372042, 798, 402, 396, 0, 137, 137
3728, 1, 1636421371240, 1636421372042, 802, 270, 532, 1, 2, 3
3732, 1, 1636421371599, 1636421372314, 715, 319, 396, 1, 2, 3
3733, 1, 1636421371687, 1636421372354, 667, 269, 398, 1, 0, 1
3736, 1, 1636421372044, 1636421372718, 674, 277, 397, 2, 0, 2
3739, 1, 1636421372356, 1636421373026, 670, 270, 400, 2, 0, 2
3740, 1, 1636421372720, 1636421373382, 662, 262, 400, 0, 1, 1
3742, 1, 1636421373383, 1636421374050, 667, 266, 401, 0, 1, 1
3743, 1, 1636421374052, 1636421374722, 670, 270, 400, 0, 0, 0
3699, 2, 1636421364932, 1636421375108, 10176, 0, 10176, 0, 0, 0
3700, 2, 1636421364999, 1636421375175, 10176, 0, 10176, 0, 0, 0
3744, 1, 1636421374724, 1636421375390, 666, 269, 397, 0, 1, 1
3745, 1, 1636421375262, 1636421375926, 664, 267, 397, 1, 0, 1
3747, 1, 1636421375392, 1636421376062, 670, 271, 399, 1, 1, 2
3706, 2, 1636421366530, 1636421376704, 10174, 1, 10173, 1, 0, 1
3749, 1, 1636421376064, 1636421376730, 666, 267, 399, 1, 1, 2
3750, 1, 1636421376731, 1636421377398, 667, 271, 396, 0, 1, 1
3709, 2, 1636421367278, 1636421377451, 10173, 1, 10172, 2, 0, 2
3712, 2, 1636421367283, 1636421377495, 10212, 0, 10212, 0, 0, 0
3711, 2, 1636421367279, 1636421377539, 10260, 0, 10260, 0, 0, 0
3710, 2, 1636421367278, 1636421377584, 10306, 0, 10306, 0, 0, 0
3715, 1, 1636421368075, 1636421378078, 10003, 9604, 399, 0, 1, 1
3752, 1, 1636421377400, 1636421378126, 726, 270, 456, 0, 0, 0
3753, 1, 1636421377670, 1636421378338, 668, 272, 396, 3, 1, 4
3756, 1, 1636421377674, 1636421378350, 676, 269, 407, 1, 0, 1
3755, 1, 1636421377674, 1636421378610, 936, 534, 402, 1, 0, 1
3758, 1, 1636421378128, 1636421378794, 666, 271, 395, 0, 0, 0
3759, 1, 1636421378339, 1636421379006, 667, 270, 397, 0, 1, 1
3760, 1, 1636421378351, 1636421379022, 671, 269, 402, 0, 0, 0
3761, 1, 1636421378612, 1636421379290, 678, 281, 397, 0, 1, 1
3762, 1, 1636421378796, 1636421379470, 674, 270, 404, 1, 0, 1
3720, 2, 1636421369394, 1636421379568, 10174, 1, 10173, 1, 0, 1
3763, 1, 1636421379007, 1636421379674, 667, 269, 398, 0, 0, 0
3764, 1, 1636421379024, 1636421379694, 670, 272, 398, 0, 0, 0
3721, 2, 1636421369657, 1636421379831, 10174, 0, 10174, 0, 0, 0
3765, 1, 1636421379292, 1636421379966, 674, 278, 396, 0, 1, 1
3722, 2, 1636421369948, 1636421380131, 10183, 1, 10182, 0, 0, 0
3766, 1, 1636421379472, 1636421380186, 714, 264, 450, 1, 0, 1
3768, 1, 1636421379696, 1636421380398, 702, 297, 405, 2, 30, 32
3767, 1, 1636421379676, 1636421380402, 726, 298, 428, 2, 31, 33
3771, 1, 1636421379968, 1636421380674, 706, 277, 429, 2, 0, 2
3770, 1, 1636421379962, 1636421380674, 712, 275, 437, 0, 1, 1
3772, 1, 1636421380187, 1636421380854, 667, 270, 397, 0, 1, 1
3773, 1, 1636421380262, 1636421380946, 684, 289, 395, 0, 0, 0
3774, 1, 1636421380400, 1636421381062, 662, 270, 392, 0, 0, 0
3775, 1, 1636421380403, 1636421381074, 671, 272, 399, 0, 1, 1
3727, 2, 1636421371014, 1636421381191, 10177, 1, 10176, 1, 0, 1
3776, 1, 1636421380676, 1636421381338, 662, 265, 397, 0, 1, 1
3778, 1, 1636421380856, 1636421381550, 694, 293, 401, 0, 30, 30
3730, 2, 1636421371418, 1636421381644, 10226, 1, 10225, 0, 0, 0
3780, 1, 1636421381063, 1636421381734, 671, 276, 395, 1, 0, 1
3781, 1, 1636421381075, 1636421381770, 695, 266, 429, 1, 0, 1
3731, 2, 1636421371599, 1636421381776, 10177, 2, 10175, 2, 1, 3
3734, 2, 1636421371687, 1636421381859, 10172, 0, 10172, 0, 0, 0
3735, 2, 1636421371688, 1636421381904, 10216, 1, 10215, 0, 0, 0
3782, 1, 1636421381322, 1636421382042, 720, 320, 400, 1, 54, 55
3783, 1, 1636421381340, 1636421382042, 702, 301, 401, 0, 39, 39
3737, 2, 1636421372045, 1636421382219, 10174, 0, 10174, 0, 0, 0
3784, 1, 1636421381552, 1636421382262, 710, 305, 405, 1, 39, 40
3787, 1, 1636421381778, 1636421382486, 708, 312, 396, 0, 44, 44
3786, 1, 1636421381778, 1636421382486, 708, 312, 396, 1, 47, 48
3785, 1, 1636421381776, 1636421382486, 710, 311, 399, 2, 43, 45
3738, 2, 1636421372316, 1636421382492, 10176, 1, 10175, 0, 1, 1
3791, 1, 1636421382044, 1636421382758, 714, 319, 395, 48, 2, 50
3792, 1, 1636421382044, 1636421382766, 722, 276, 446, 3, 1, 4
3790, 1, 1636421381994, 1636421382766, 772, 370, 402, 1, 1, 2
3793, 1, 1636421382263, 1636421382942, 679, 278, 401, 1, 10, 11
3795, 1, 1636421382493, 1636421383166, 673, 278, 395, 4, 0, 4
3796, 1, 1636421382493, 1636421383178, 685, 282, 403, 4, 0, 4
3741, 2, 1636421373027, 1636421383203, 10176, 0, 10176, 0, 0, 0
3800, 1, 1636421382768, 1636421383470, 702, 305, 397, 1, 38, 39
3801, 1, 1636421382768, 1636421383474, 706, 305, 401, 2, 35, 37
3802, 1, 1636421382944, 1636421383650, 706, 306, 400, 1, 42, 43
3803, 1, 1636421383205, 1636421383870, 665, 269, 396, 1, 1, 2
3805, 1, 1636421383335, 1636421384022, 687, 271, 416, 0, 1, 1
3807, 1, 1636421383476, 1636421384146, 670, 270, 400, 0, 1, 1
3808, 1, 1636421383651, 1636421384322, 671, 272, 399, 1, 0, 1
3809, 1, 1636421383872, 1636421384546, 674, 271, 403, 0, 1, 1
3810, 1, 1636421384023, 1636421384698, 675, 268, 407, 0, 0, 0
3811, 1, 1636421384147, 1636421384818, 671, 271, 400, 0, 1, 1
3812, 1, 1636421384323, 1636421384990, 667, 270, 397, 1, 0, 1
3813, 1, 1636421384547, 1636421385214, 667, 269, 398, 0, 0, 0
3814, 1, 1636421384700, 1636421385370, 670, 270, 400, 1, 0, 1
3746, 2, 1636421375306, 1636421385484, 10178, 1, 10177, 0, 1, 1
3815, 1, 1636421384820, 1636421385490, 670, 269, 401, 0, 0, 0
3748, 2, 1636421375928, 1636421386103, 10175, 1, 10174, 0, 0, 0
3819, 1, 1636421385492, 1636421386162, 670, 269, 401, 0, 0, 0
3820, 1, 1636421385614, 1636421386286, 672, 269, 403, 0, 0, 0
3821, 1, 1636421386164, 1636421386834, 670, 269, 401, 1, 0, 1
3823, 1, 1636421386288, 1636421386954, 666, 270, 396, 0, 0, 0
3751, 2, 1636421376834, 1636421387020, 10186, 1, 10185, 0, 0, 0
3824, 1, 1636421386836, 1636421387562, 726, 275, 451, 0, 0, 0
3825, 1, 1636421386956, 1636421387622, 666, 269, 397, 0, 0, 0
3826, 1, 1636421387138, 1636421387806, 668, 269, 399, 1, 0, 1
3754, 2, 1636421377670, 1636421387844, 10174, 1, 10173, 0, 1, 1
3827, 1, 1636421387564, 1636421388230, 666, 269, 397, 2, 0, 2
3757, 2, 1636421378080, 1636421388256, 10176, 0, 10176, 0, 0, 0
3828, 1, 1636421387624, 1636421388290, 666, 270, 396, 0, 2, 2
3829, 1, 1636421387846, 1636421388522, 676, 281, 395, 0, 11, 11
3830, 1, 1636421387974, 1636421388634, 660, 266, 394, 0, 0, 0
3831, 1, 1636421388258, 1636421388930, 672, 269, 403, 1, 0, 1
3832, 1, 1636421388291, 1636421388958, 667, 270, 397, 0, 0, 0
3834, 1, 1636421388524, 1636421389190, 666, 271, 395, 2, 1, 3
3835, 1, 1636421388635, 1636421389306, 671, 271, 400, 0, 1, 1
3836, 1, 1636421388932, 1636421389602, 670, 269, 401, 1, 0, 1
3837, 1, 1636421388960, 1636421389622, 662, 266, 396, 1, 0, 1
3838, 1, 1636421389192, 1636421389862, 670, 272, 398, 0, 0, 0
3769, 2, 1636421379698, 1636421389880, 10182, 0, 10182, 0, 0, 0
3839, 1, 1636421389308, 1636421389974, 666, 273, 393, 0, 2, 2
3840, 1, 1636421389604, 1636421390270, 666, 269, 397, 0, 0, 0
3841, 1, 1636421389623, 1636421390322, 699, 303, 396, 1, 38, 39
3842, 1, 1636421389882, 1636421390558, 676, 278, 398, 0, 0, 0
3843, 1, 1636421389975, 1636421390646, 671, 269, 402, 1, 0, 1
3777, 2, 1636421380676, 1636421390852, 10176, 1, 10175, 1, 0, 1
3845, 1, 1636421390272, 1636421390946, 674, 269, 405, 1, 0, 1
3846, 1, 1636421390324, 1636421390990, 666, 269, 397, 0, 0, 0
3779, 2, 1636421380947, 1636421391119, 10172, 0, 10172, 0, 0, 0
3847, 1, 1636421390560, 1636421391230, 670, 269, 401, 1, 0, 1
3848, 1, 1636421390648, 1636421391318, 670, 275, 395, 1, 0, 1
3849, 1, 1636421390948, 1636421391658, 710, 268, 442, 1, 0, 1
3851, 1, 1636421390992, 1636421391666, 674, 279, 395, 0, 0, 0
3852, 1, 1636421391232, 1636421391902, 670, 273, 397, 0, 0, 0
3854, 1, 1636421391319, 1636421391990, 671, 273, 398, 0, 0, 0
3788, 2, 1636421381951, 1636421392128, 10177, 1, 10176, 2, 0, 2
3789, 2, 1636421381994, 1636421392174, 10180, 0, 10180, 1, 0, 1
3855, 1, 1636421391660, 1636421392326, 666, 271, 395, 0, 0, 0
3856, 1, 1636421391668, 1636421392330, 662, 266, 396, 0, 0, 0
3794, 2, 1636421382350, 1636421392536, 10186, 0, 10186, 0, 0, 0
3857, 1, 1636421391904, 1636421392626, 722, 322, 400, 0, 45, 45
3797, 2, 1636421382494, 1636421392667, 10173, 1, 10172, 1, 1, 2
3858, 1, 1636421391992, 1636421392714, 722, 318, 404, 47, 0, 47
3798, 2, 1636421382624, 1636421392800, 10176, 1, 10175, 0, 1, 1
3859, 1, 1636421392262, 1636421392934, 672, 271, 401, 0, 2, 2
3799, 2, 1636421382760, 1636421392935, 10175, 0, 10175, 0, 0, 0
3862, 1, 1636421392332, 1636421393066, 734, 338, 396, 1, 71, 72
3860, 1, 1636421392298, 1636421393066, 768, 372, 396, 0, 107, 107
3861, 1, 1636421392328, 1636421393069, 741, 343, 398, 1, 78, 79
3863, 1, 1636421392670, 1636421393378, 708, 311, 397, 0, 45, 45
3865, 1, 1636421392716, 1636421393378, 662, 266, 396, 1, 3, 4
3864, 1, 1636421392670, 1636421393378, 708, 311, 397, 48, 0, 48
3804, 2, 1636421383206, 1636421393383, 10177, 0, 10177, 0, 0, 0
3868, 1, 1636421392937, 1636421393602, 665, 262, 403, 0, 0, 0
3806, 2, 1636421383471, 1636421393647, 10176, 0, 10176, 0, 0, 0
3867, 1, 1636421392936, 1636421393658, 722, 316, 406, 0, 6, 6
3871, 1, 1636421393069, 1636421393738, 669, 273, 396, 1, 6, 7
3872, 1, 1636421393071, 1636421393738, 667, 270, 397, 1, 7, 8
3870, 1, 1636421393068, 1636421393742, 674, 276, 398, 1, 6, 7
3874, 1, 1636421393385, 1636421394094, 709, 269, 440, 4, 1, 5
3873, 1, 1636421393385, 1636421394094, 709, 268, 441, 2, 4, 6
3875, 1, 1636421393386, 1636421394098, 712, 273, 439, 2, 2, 4
3876, 1, 1636421393515, 1636421394186, 671, 271, 400, 3, 1, 4
3878, 1, 1636421393660, 1636421394370, 710, 314, 396, 1, 0, 1
3881, 1, 1636421393743, 1636421394410, 667, 270, 397, 1, 0, 1
3880, 1, 1636421393741, 1636421394418, 677, 273, 404, 0, 1, 1
3882, 1, 1636421393783, 1636421394454, 671, 274, 397, 1, 0, 1
3879, 1, 1636421393740, 1636421394637, 897, 498, 399, 0, 0, 0
3883, 1, 1636421394096, 1636421394762, 666, 268, 398, 1, 0, 1
3884, 1, 1636421394096, 1636421394762, 666, 270, 396, 3, 1, 4
3886, 1, 1636421394188, 1636421394858, 670, 270, 400, 0, 1, 1
3888, 1, 1636421394411, 1636421395070, 659, 264, 395, 1, 2, 3
3889, 1, 1636421394420, 1636421395090, 670, 265, 405, 0, 0, 0
3890, 1, 1636421394456, 1636421395122, 666, 270, 396, 1, 1, 2
3816, 2, 1636421384992, 1636421395167, 10175, 0, 10175, 0, 0, 0
3891, 1, 1636421394639, 1636421395298, 659, 266, 393, 0, 0, 0
3817, 2, 1636421385216, 1636421395395, 10179, 0, 10179, 0, 0, 0
3892, 1, 1636421394763, 1636421395434, 671, 271, 400, 0, 10, 10
3894, 1, 1636421394859, 1636421395522, 663, 266, 397, 0, 0, 0
3818, 2, 1636421385372, 1636421395571, 10199, 0, 10199, 0, 0, 0
3895, 1, 1636421395072, 1636421395750, 678, 271, 407, 1, 6, 7
3897, 1, 1636421395168, 1636421395846, 678, 276, 402, 2, 0, 2
3899, 1, 1636421395300, 1636421396018, 718, 311, 407, 1, 44, 45
3898, 1, 1636421395298, 1636421396022, 724, 312, 412, 1, 43, 44
3903, 1, 1636421395702, 1636421396370, 668, 271, 397, 1, 1, 2
3822, 2, 1636421386234, 1636421396411, 10177, 0, 10177, 0, 0, 0
3904, 1, 1636421395752, 1636421396422, 670, 274, 396, 1, 0, 1
3906, 1, 1636421396019, 1636421396682, 663, 269, 394, 0, 0, 0
3908, 1, 1636421396413, 1636421397082, 669, 269, 400, 0, 1, 1
3909, 1, 1636421396423, 1636421397090, 667, 270, 397, 0, 0, 0
3910, 1, 1636421396542, 1636421397202, 660, 266, 394, 0, 0, 0
3911, 1, 1636421396684, 1636421397350, 666, 271, 395, 1, 0, 1
3912, 1, 1636421397084, 1636421397750, 666, 269, 397, 1, 0, 1
3913, 1, 1636421397091, 1636421397750, 659, 262, 397, 0, 0, 0
3914, 1, 1636421397203, 1636421397874, 671, 274, 397, 0, 0, 0
3915, 1, 1636421397352, 1636421398014, 662, 267, 395, 0, 1, 1
3917, 1, 1636421397753, 1636421398434, 681, 275, 406, 3, 1, 4
3916, 1, 1636421397752, 1636421398434, 682, 276, 406, 1, 2, 3
3918, 1, 1636421397875, 1636421398546, 671, 274, 397, 0, 0, 0
3833, 2, 1636421388386, 1636421398563, 10177, 0, 10177, 0, 0, 0
3919, 1, 1636421398016, 1636421398678, 662, 266, 396, 0, 0, 0
3921, 1, 1636421398436, 1636421399098, 662, 268, 394, 0, 1, 1
3920, 1, 1636421398435, 1636421399098, 663, 267, 396, 0, 1, 1
3922, 1, 1636421398564, 1636421399226, 662, 267, 395, 1, 2, 3
3923, 1, 1636421398680, 1636421399346, 666, 271, 395, 0, 1, 1
3925, 1, 1636421399099, 1636421399766, 667, 269, 398, 2, 0, 2
3927, 1, 1636421399228, 1636421399898, 670, 272, 398, 0, 0, 0
3928, 1, 1636421399348, 1636421400018, 670, 271, 399, 1, 0, 1
3844, 2, 1636421390002, 1636421400175, 10173, 1, 10172, 0, 1, 1
3929, 1, 1636421399768, 1636421400446, 678, 275, 403, 0, 6, 6
3930, 1, 1636421399900, 1636421400562, 662, 268, 394, 1, 0, 1
3932, 1, 1636421400306, 1636421400982, 676, 278, 398, 1, 0, 1
3933, 1, 1636421400448, 1636421401110, 662, 265, 397, 0, 0, 0
3850, 2, 1636421390982, 1636421401167, 10185, 1, 10184, 0, 0, 0
3934, 1, 1636421400564, 1636421401234, 670, 270, 400, 0, 0, 0
3853, 2, 1636421391254, 1636421401431, 10177, 1, 10176, 0, 1, 1
3935, 1, 1636421400984, 1636421401646, 662, 270, 392, 0, 0, 0
3936, 1, 1636421401112, 1636421401786, 674, 274, 400, 0, 6, 6
3937, 1, 1636421401235, 1636421401906, 671, 274, 397, 0, 0, 0
3938, 1, 1636421401294, 1636421401962, 668, 265, 403, 0, 0, 0
3939, 1, 1636421401562, 1636421402230, 668, 274, 394, 0, 1, 1
3940, 1, 1636421401647, 1636421402314, 667, 271, 396, 0, 0, 0
3941, 1, 1636421401788, 1636421402462, 674, 275, 399, 0, 0, 0
3942, 1, 1636421401908, 1636421402574, 666, 271, 395, 0, 1, 1
3943, 1, 1636421401964, 1636421402630, 666, 266, 400, 0, 0, 0
3944, 1, 1636421402231, 1636421402894, 663, 270, 393, 0, 0, 0
3945, 1, 1636421402315, 1636421402970, 655, 262, 393, 0, 0, 0
3866, 2, 1636421392802, 1636421402984, 10182, 1, 10181, 0, 2, 2
3946, 1, 1636421402463, 1636421403134, 671, 270, 401, 0, 1, 1
3869, 2, 1636421393067, 1636421403244, 10177, 0, 10177, 0, 1, 1
3947, 1, 1636421402576, 1636421403254, 678, 274, 404, 2, 0, 2
3948, 1, 1636421402632, 1636421403342, 710, 305, 405, 0, 38, 38
3949, 1, 1636421402896, 1636421403610, 714, 314, 400, 0, 0, 0
3950, 1, 1636421402985, 1636421403690, 705, 310, 395, 0, 38, 38
3951, 1, 1636421403118, 1636421403782, 664, 271, 393, 3, 0, 3
3877, 2, 1636421393651, 1636421403828, 10177, 1, 10176, 2, 0, 2
3953, 1, 1636421403255, 1636421403918, 663, 266, 397, 0, 0, 0
3954, 1, 1636421403344, 1636421404006, 662, 265, 397, 0, 0, 0
3955, 1, 1636421403382, 1636421404094, 712, 266, 446, 1, 0, 1
3956, 1, 1636421403611, 1636421404274, 663, 270, 393, 0, 1, 1
3885, 2, 1636421394100, 1636421404275, 10175, 0, 10175, 0, 0, 0
3957, 1, 1636421403691, 1636421404362, 671, 267, 404, 1, 1, 2
3958, 1, 1636421403829, 1636421404454, 625, 269, 356, 0, 1, 1
3887, 2, 1636421394372, 1636421404547, 10175, 0, 10175, 0, 0, 0
3960, 1, 1636421403958, 1636421404629, 671, 274, 397, 0, 6, 6
3959, 1, 1636421403920, 1636421404629, 709, 270, 439, 0, 2, 2
3961, 1, 1636421404008, 1636421404670, 662, 267, 395, 1, 1, 2
3962, 1, 1636421404096, 1636421404762, 666, 270, 396, 0, 1, 1
3963, 1, 1636421404277, 1636421404934, 657, 263, 394, 0, 1, 1
3893, 2, 1636421394764, 1636421404939, 10175, 1, 10174, 0, 1, 1
3964, 1, 1636421404363, 1636421405018, 655, 262, 393, 1, 0, 1
3965, 1, 1636421404407, 1636421405078, 671, 265, 406, 0, 0, 0
3896, 2, 1636421395092, 1636421405267, 10175, 0, 10175, 0, 0, 0
3968, 1, 1636421404631, 1636421405298, 667, 266, 401, 0, 3, 3
3967, 1, 1636421404630, 1636421405301, 671, 268, 403, 3, 3, 6
3969, 1, 1636421404671, 1636421405338, 667, 271, 396, 0, 1, 1
3970, 1, 1636421404678, 1636421405390, 712, 313, 399, 1, 39, 40
3900, 2, 1636421395435, 1636421405619, 10184, 1, 10183, 1, 0, 1
3972, 1, 1636421404942, 1636421405626, 684, 283, 401, 1, 18, 19
3901, 2, 1636421395522, 1636421405699, 10177, 0, 10177, 0, 0, 0
3973, 1, 1636421405020, 1636421405718, 698, 299, 399, 1, 31, 32
3902, 2, 1636421395524, 1636421405743, 10219, 1, 10218, 2, 0, 2
3975, 1, 1636421405079, 1636421405745, 666, 270, 396, 1, 0, 1
3978, 1, 1636421405340, 1636421406010, 670, 271, 399, 0, 1, 1
3976, 1, 1636421405299, 1636421406010, 711, 313, 398, 1, 48, 49
3977, 1, 1636421405303, 1636421406010, 707, 307, 400, 0, 43, 43
3905, 2, 1636421395848, 1636421406023, 10175, 0, 10175, 1, 0, 1
3979, 1, 1636421405392, 1636421406098, 706, 309, 397, 1, 43, 44
3980, 1, 1636421405398, 1636421406102, 704, 306, 398, 1, 36, 37
3907, 2, 1636421396023, 1636421406203, 10180, 0, 10180, 0, 0, 0
3981, 1, 1636421405627, 1636421406318, 691, 267, 424, 0, 1, 1
3983, 1, 1636421405746, 1636421406414, 668, 270, 398, 3, 0, 3
3982, 1, 1636421405744, 1636421406414, 670, 270, 400, 1, 1, 2
3986, 1, 1636421405831, 1636421406502, 671, 270, 401, 2, 0, 2
3985, 1, 1636421405831, 1636421406502, 671, 270, 401, 3, 0, 3
3987, 1, 1636421406025, 1636421406698, 673, 278, 395, 1, 0, 1
3988, 1, 1636421406025, 1636421406738, 713, 314, 399, 2, 0, 2
3990, 1, 1636421406100, 1636421406782, 682, 266, 416, 0, 1, 1
3992, 1, 1636421406154, 1636421406826, 672, 269, 403, 0, 0, 0
3993, 1, 1636421406320, 1636421407010, 690, 294, 396, 0, 0, 0
3995, 1, 1636421406415, 1636421407074, 659, 266, 393, 0, 0, 0
3997, 1, 1636421406503, 1636421407170, 667, 271, 396, 1, 1, 2
3998, 1, 1636421406503, 1636421407278, 775, 379, 396, 1, 0, 1
3999, 1, 1636421406699, 1636421407366, 667, 267, 400, 0, 0, 0
4000, 1, 1636421406739, 1636421407402, 663, 266, 397, 1, 0, 1
4002, 1, 1636421406828, 1636421407490, 662, 266, 396, 0, 1, 1
4003, 1, 1636421407011, 1636421407678, 667, 271, 396, 0, 1, 1
4004, 1, 1636421407076, 1636421407738, 662, 270, 392, 0, 1, 1
4005, 1, 1636421407172, 1636421407842, 670, 271, 399, 0, 0, 0
4007, 1, 1636421407368, 1636421408038, 670, 266, 404, 0, 0, 0
4008, 1, 1636421407404, 1636421408070, 666, 270, 396, 0, 1, 1
4009, 1, 1636421407492, 1636421408162, 670, 274, 396, 0, 0, 0
4010, 1, 1636421407680, 1636421408342, 662, 266, 396, 0, 0, 0
4012, 1, 1636421407844, 1636421408510, 666, 269, 397, 0, 1, 1
4013, 1, 1636421408039, 1636421408710, 671, 269, 402, 0, 0, 0
4014, 1, 1636421408072, 1636421408742, 670, 269, 401, 0, 0, 0
4015, 1, 1636421408164, 1636421408846, 682, 273, 409, 1, 0, 1
3924, 2, 1636421398695, 1636421408875, 10180, 1, 10179, 0, 1, 1
4016, 1, 1636421408344, 1636421409014, 670, 277, 393, 1, 0, 1
4017, 1, 1636421408512, 1636421409178, 666, 271, 395, 1, 0, 1
3926, 2, 1636421399100, 1636421409276, 10176, 1, 10175, 1, 0, 1
4019, 1, 1636421408744, 1636421409410, 666, 267, 399, 1, 0, 1
4018, 1, 1636421408712, 1636421409414, 702, 270, 432, 1, 1, 2
4020, 1, 1636421408877, 1636421409554, 677, 269, 408, 1, 0, 1
4021, 1, 1636421409006, 1636421409722, 716, 273, 443, 2, 0, 2
4022, 1, 1636421409016, 1636421409722, 706, 315, 391, 0, 44, 44
4023, 1, 1636421409180, 1636421409858, 678, 269, 409, 1, 0, 1
4024, 1, 1636421409406, 1636421410074, 668, 271, 397, 3, 0, 3
4026, 1, 1636421409415, 1636421410078, 663, 266, 397, 1, 0, 1
4025, 1, 1636421409412, 1636421410078, 666, 269, 397, 0, 0, 0
4027, 1, 1636421409556, 1636421410222, 666, 266, 400, 0, 0, 0
3931, 2, 1636421400019, 1636421410227, 10208, 0, 10208, 0, 0, 0
4029, 1, 1636421409724, 1636421410386, 662, 266, 396, 1, 0, 1
4028, 1, 1636421409723, 1636421410386, 663, 270, 393, 0, 0, 0
4030, 1, 1636421409859, 1636421410530, 671, 272, 399, 2, 1, 3
4033, 1, 1636421410080, 1636421410762, 682, 269, 413, 2, 0, 2
4034, 1, 1636421410229, 1636421410902, 673, 274, 399, 2, 0, 2
4036, 1, 1636421410388, 1636421411054, 666, 274, 392, 0, 0, 0
4037, 1, 1636421410388, 1636421411054, 666, 271, 395, 1, 1, 2
4038, 1, 1636421410532, 1636421411194, 662, 266, 396, 1, 0, 1
4039, 1, 1636421410763, 1636421411438, 675, 269, 406, 0, 0, 0
4040, 1, 1636421410904, 1636421411570, 666, 269, 397, 1, 0, 1
4042, 1, 1636421411056, 1636421411730, 674, 274, 400, 1, 1, 2
4041, 1, 1636421411056, 1636421411730, 674, 278, 396, 1, 0, 1
4043, 1, 1636421411196, 1636421411870, 674, 268, 406, 0, 0, 0
4044, 1, 1636421411440, 1636421412106, 666, 269, 397, 1, 1, 2
4045, 1, 1636421411572, 1636421412234, 662, 267, 395, 1, 0, 1
4046, 1, 1636421411731, 1636421412398, 667, 266, 401, 0, 0, 0
4047, 1, 1636421411732, 1636421412398, 666, 269, 397, 0, 0, 0
4048, 1, 1636421411871, 1636421412538, 667, 268, 399, 0, 0, 0
4049, 1, 1636421412108, 1636421412774, 666, 269, 397, 0, 0, 0
4050, 1, 1636421412236, 1636421412902, 666, 271, 395, 0, 1, 1
4051, 1, 1636421412400, 1636421413066, 666, 270, 396, 2, 0, 2
4052, 1, 1636421412400, 1636421413066, 666, 269, 397, 1, 0, 1
4053, 1, 1636421412540, 1636421413210, 670, 266, 404, 1, 0, 1
3952, 2, 1636421403136, 1636421413331, 10195, 0, 10195, 0, 0, 0
4054, 1, 1636421412776, 1636421413442, 666, 270, 396, 1, 1, 2
4055, 1, 1636421412904, 1636421413598, 694, 296, 398, 1, 30, 31
4056, 1, 1636421413068, 1636421413730, 662, 271, 391, 2, 1, 3
4057, 1, 1636421413068, 1636421413778, 710, 268, 442, 0, 0, 0
4059, 1, 1636421413444, 1636421414114, 670, 274, 396, 1, 0, 1
4060, 1, 1636421413462, 1636421414142, 680, 275, 405, 2, 0, 2
4062, 1, 1636421413732, 1636421414398, 666, 271, 395, 0, 1, 1
4063, 1, 1636421413780, 1636421414450, 670, 274, 396, 1, 1, 2
3966, 2, 1636421404455, 1636421414639, 10184, 0, 10184, 0, 0, 0
4064, 1, 1636421414116, 1636421414786, 670, 269, 401, 1, 0, 1
4065, 1, 1636421414144, 1636421414818, 674, 269, 405, 1, 0, 1
3971, 2, 1636421404764, 1636421414987, 10223, 0, 10223, 0, 0, 0
4066, 1, 1636421414400, 1636421415090, 690, 286, 404, 0, 22, 22
4067, 1, 1636421414452, 1636421415118, 666, 268, 398, 0, 0, 0
3974, 2, 1636421405070, 1636421415247, 10177, 1, 10176, 0, 0, 0
4068, 1, 1636421414774, 1636421415434, 660, 267, 393, 0, 0, 0
4070, 1, 1636421414820, 1636421415526, 706, 272, 434, 0, 0, 0
4072, 1, 1636421415114, 1636421415786, 672, 316, 356, 48, 0, 48
4073, 1, 1636421415120, 1636421415786, 666, 269, 397, 0, 1, 1
3984, 2, 1636421405788, 1636421415964, 10176, 1, 10175, 2, 0, 2
4074, 1, 1636421415378, 1636421416046, 668, 271, 397, 1, 1, 2
4075, 1, 1636421415435, 1636421416098, 663, 270, 393, 0, 0, 0
3989, 2, 1636421406025, 1636421416204, 10179, 0, 10179, 1, 0, 1
4076, 1, 1636421415528, 1636421416234, 706, 305, 401, 1, 39, 40
3991, 2, 1636421406103, 1636421416295, 10192, 1, 10191, 1, 0, 1
4077, 1, 1636421415788, 1636421416470, 682, 286, 396, 0, 23, 23
4078, 1, 1636421415788, 1636421416478, 690, 287, 403, 2, 19, 21
3994, 2, 1636421406338, 1636421416515, 10177, 0, 10177, 0, 0, 0
3996, 2, 1636421406415, 1636421416591, 10176, 0, 10176, 0, 0, 0
4079, 1, 1636421416048, 1636421416782, 734, 310, 424, 1, 36, 37
4081, 1, 1636421416099, 1636421416870, 771, 309, 462, 3, 39, 42
4080, 1, 1636421416094, 1636421416870, 776, 265, 511, 2, 1, 3
4082, 1, 1636421416236, 1636421416946, 710, 269, 441, 0, 1, 1
4001, 2, 1636421406784, 1636421416960, 10176, 1, 10175, 1, 0, 1
4083, 1, 1636421416386, 1636421417054, 668, 270, 398, 2, 2, 4
4086, 1, 1636421416519, 1636421417226, 707, 310, 397, 1, 40, 41
4088, 1, 1636421416722, 1636421417414, 692, 294, 398, 2, 24, 26
4006, 2, 1636421407280, 1636421417455, 10175, 1, 10174, 1, 0, 1
4091, 1, 1636421416872, 1636421417546, 674, 272, 402, 1, 0, 1
4092, 1, 1636421416963, 1636421417626, 663, 266, 397, 1, 0, 1
4093, 1, 1636421417056, 1636421417722, 666, 268, 398, 0, 2, 2
4094, 1, 1636421417090, 1636421417758, 668, 271, 397, 1, 0, 1
4011, 2, 1636421407739, 1636421417912, 10173, 0, 10173, 0, 0, 0
4096, 1, 1636421417458, 1636421418122, 664, 270, 394, 0, 0, 0
4098, 1, 1636421417586, 1636421418266, 680, 283, 397, 2, 14, 16
4099, 1, 1636421417628, 1636421418294, 666, 269, 397, 0, 1, 1
4100, 1, 1636421417724, 1636421418386, 662, 266, 396, 0, 0, 0
4101, 1, 1636421417761, 1636421418450, 689, 268, 421, 3, 0, 3
4103, 1, 1636421418123, 1636421418786, 663, 270, 393, 1, 0, 1
4104, 1, 1636421418268, 1636421418934, 666, 271, 395, 1, 0, 1
4105, 1, 1636421418388, 1636421419062, 674, 274, 400, 0, 0, 0
4106, 1, 1636421418452, 1636421419118, 666, 270, 396, 0, 2, 2
4107, 1, 1636421418789, 1636421419458, 669, 271, 398, 0, 2, 2
4108, 1, 1636421418936, 1636421419602, 666, 270, 396, 1, 0, 1
4109, 1, 1636421419064, 1636421419730, 666, 268, 398, 0, 0, 0
4110, 1, 1636421419120, 1636421419782, 662, 266, 396, 0, 0, 0
4111, 1, 1636421419461, 1636421420126, 665, 270, 395, 0, 0, 0
4032, 2, 1636421410080, 1636421420275, 10195, 0, 10195, 1, 0, 1
4031, 2, 1636421410076, 1636421420319, 10243, 1, 10242, 0, 1, 1
4113, 1, 1636421419732, 1636421420398, 666, 265, 401, 0, 0, 0
4114, 1, 1636421419784, 1636421420450, 666, 268, 398, 0, 0, 0
4035, 2, 1636421410350, 1636421420524, 10174, 1, 10173, 0, 1, 1
4115, 1, 1636421420128, 1636421420882, 754, 340, 414, 45, 26, 71
4116, 1, 1636421420400, 1636421421070, 670, 273, 397, 1, 0, 1
4117, 1, 1636421420406, 1636421421106, 700, 270, 430, 2, 0, 2
4119, 1, 1636421420452, 1636421421146, 694, 298, 396, 2, 0, 2
4120, 1, 1636421420654, 1636421421318, 664, 270, 394, 0, 0, 0
4121, 1, 1636421420884, 1636421421550, 666, 269, 397, 0, 0, 0
4122, 1, 1636421421072, 1636421421738, 666, 267, 399, 1, 0, 1
4124, 1, 1636421421147, 1636421421830, 683, 283, 400, 0, 3, 3
4125, 1, 1636421421320, 1636421421986, 666, 271, 395, 2, 0, 2
4126, 1, 1636421421552, 1636421422218, 666, 268, 398, 0, 0, 0
4127, 1, 1636421421740, 1636421422406, 666, 269, 397, 1, 0, 1
4128, 1, 1636421421832, 1636421422498, 666, 268, 398, 0, 0, 0
4130, 1, 1636421422220, 1636421422890, 670, 269, 401, 0, 0, 0
4131, 1, 1636421422408, 1636421423078, 670, 270, 400, 1, 1, 2
4132, 1, 1636421422500, 1636421423166, 666, 271, 395, 1, 1, 2
4058, 2, 1636421413211, 1636421423424, 10213, 1, 10212, 1, 0, 1
4133, 1, 1636421422892, 1636421423558, 666, 269, 397, 1, 0, 1
4061, 2, 1636421413600, 1636421423775, 10175, 0, 10175, 0, 0, 0
4134, 1, 1636421423080, 1636421423778, 698, 302, 396, 1, 34, 35
4135, 1, 1636421423168, 1636421423870, 702, 306, 396, 1, 38, 39
4136, 1, 1636421423554, 1636421424222, 668, 272, 396, 2, 4, 6
4137, 1, 1636421423560, 1636421424226, 666, 265, 401, 0, 0, 0
4139, 1, 1636421423872, 1636421424538, 666, 269, 397, 1, 0, 1
4140, 1, 1636421423906, 1636421424578, 672, 270, 402, 0, 1, 1
4141, 1, 1636421424223, 1636421424894, 671, 270, 401, 1, 1, 2
4069, 2, 1636421414788, 1636421424963, 10175, 0, 10175, 0, 0, 0
4144, 1, 1636421424580, 1636421425246, 666, 272, 394, 0, 1, 1
4071, 2, 1636421415091, 1636421425296, 10205, 0, 10205, 2, 1, 3
4145, 1, 1636421424896, 1636421425570, 674, 270, 404, 1, 0, 1
4146, 1, 1636421425094, 1636421425766, 672, 270, 402, 0, 0, 0
4147, 1, 1636421425248, 1636421425918, 670, 275, 395, 0, 0, 0
4148, 1, 1636421425426, 1636421426094, 668, 271, 397, 0, 2, 2
4149, 1, 1636421425572, 1636421426238, 666, 269, 397, 0, 0, 0
4151, 1, 1636421425920, 1636421426582, 662, 266, 396, 1, 0, 1
4084, 2, 1636421416426, 1636421426639, 10213, 2, 10211, 0, 2, 2
4085, 2, 1636421416518, 1636421426696, 10178, 1, 10177, 0, 1, 1
4087, 2, 1636421416678, 1636421426856, 10178, 0, 10178, 0, 0, 0
4153, 1, 1636421426239, 1636421426906, 667, 268, 399, 1, 2, 3
4089, 2, 1636421416784, 1636421426960, 10176, 0, 10176, 0, 0, 0
4090, 2, 1636421416872, 1636421427052, 10180, 1, 10179, 0, 1, 1
4154, 1, 1636421426583, 1636421427318, 735, 313, 422, 0, 46, 46
4095, 2, 1636421417227, 1636421427407, 10180, 0, 10180, 0, 0, 0
4157, 1, 1636421426907, 1636421427590, 683, 272, 411, 1, 1, 2
4158, 1, 1636421426986, 1636421427674, 688, 288, 400, 1, 20, 21
4097, 2, 1636421417547, 1636421427723, 10176, 0, 10176, 0, 0, 0
4159, 1, 1636421427086, 1636421427774, 688, 278, 410, 1, 12, 13
4160, 1, 1636421427182, 1636421427858, 676, 278, 398, 1, 10, 11
4161, 1, 1636421427319, 1636421427994, 675, 272, 403, 0, 11, 11
4162, 1, 1636421427538, 1636421428206, 668, 270, 398, 1, 0, 1
4102, 2, 1636421418038, 1636421428211, 10173, 0, 10173, 0, 0, 0
4163, 1, 1636421427592, 1636421428254, 662, 308, 354, 0, 46, 46
4164, 1, 1636421427675, 1636421428338, 663, 267, 396, 0, 0, 0
4165, 1, 1636421427776, 1636421428482, 706, 300, 406, 0, 34, 34
4167, 1, 1636421427859, 1636421428514, 655, 264, 391, 0, 1, 1
4166, 1, 1636421427854, 1636421428522, 668, 269, 399, 0, 0, 0
4168, 1, 1636421427995, 1636421428658, 663, 266, 397, 0, 0, 0
4169, 1, 1636421428213, 1636421428870, 657, 262, 395, 0, 0, 0
4171, 1, 1636421428339, 1636421429010, 671, 270, 401, 1, 0, 1
4170, 1, 1636421428338, 1636421429010, 672, 275, 397, 2, 0, 2
4172, 1, 1636421428484, 1636421429154, 670, 273, 397, 1, 0, 1
4173, 1, 1636421428515, 1636421429178, 663, 270, 393, 0, 1, 1
4174, 1, 1636421428523, 1636421429186, 663, 263, 400, 1, 0, 1
4175, 1, 1636421428871, 1636421429538, 667, 271, 396, 1, 1, 2
4176, 1, 1636421429011, 1636421429674, 663, 266, 397, 0, 0, 0
4177, 1, 1636421429011, 1636421429674, 663, 270, 393, 1, 0, 1
4112, 2, 1636421419604, 1636421429779, 10175, 0, 10175, 0, 0, 0
4179, 1, 1636421429180, 1636421429850, 670, 271, 399, 0, 0, 0
4180, 1, 1636421429187, 1636421429850, 663, 267, 396, 2, 0, 2
4181, 1, 1636421429540, 1636421430226, 686, 290, 396, 0, 23, 23
4182, 1, 1636421429675, 1636421430366, 691, 271, 420, 3, 0, 3
4184, 1, 1636421429852, 1636421430526, 674, 273, 401, 2, 0, 2
4186, 1, 1636421429910, 1636421430574, 664, 267, 397, 1, 1, 2
4118, 2, 1636421420410, 1636421430616, 10206, 2, 10204, 2, 0, 2
4187, 1, 1636421430228, 1636421430902, 674, 274, 400, 1, 0, 1
4188, 1, 1636421430368, 1636421431058, 690, 294, 396, 0, 31, 31
4189, 1, 1636421430528, 1636421431190, 662, 262, 400, 0, 0, 0
4190, 1, 1636421430618, 1636421431278, 660, 262, 398, 0, 0, 0
4123, 2, 1636421421107, 1636421431287, 10180, 1, 10179, 0, 1, 1
4192, 1, 1636421430904, 1636421431570, 666, 266, 400, 0, 0, 0
4193, 1, 1636421431060, 1636421431734, 674, 281, 393, 2, 10, 12
4194, 1, 1636421431192, 1636421431866, 674, 270, 404, 1, 0, 1
4195, 1, 1636421431288, 1636421431954, 666, 270, 396, 1, 1, 2
4129, 2, 1636421421987, 1636421432159, 10172, 1, 10171, 0, 0, 0
4197, 1, 1636421431572, 1636421432238, 666, 270, 396, 0, 0, 0
4198, 1, 1636421431736, 1636421432426, 690, 292, 398, 0, 23, 23
4199, 1, 1636421431868, 1636421432526, 658, 266, 392, 0, 0, 0
4200, 1, 1636421431955, 1636421432614, 659, 264, 395, 0, 0, 0
4201, 1, 1636421432239, 1636421432902, 663, 265, 398, 0, 0, 0
4202, 1, 1636421432294, 1636421432954, 660, 266, 394, 0, 0, 0
4203, 1, 1636421432428, 1636421433102, 674, 270, 404, 0, 0, 0
4204, 1, 1636421432527, 1636421433190, 663, 269, 394, 1, 0, 1
4205, 1, 1636421432616, 1636421433282, 666, 267, 399, 1, 1, 2
4206, 1, 1636421432904, 1636421433574, 670, 270, 400, 1, 0, 1
4207, 1, 1636421432956, 1636421433626, 670, 267, 403, 1, 1, 2
4208, 1, 1636421433103, 1636421433766, 663, 266, 397, 0, 0, 0
4209, 1, 1636421433192, 1636421433850, 658, 266, 392, 0, 0, 0
4210, 1, 1636421433284, 1636421433954, 670, 274, 396, 1, 0, 1
4138, 2, 1636421423780, 1636421433955, 10175, 1, 10174, 0, 0, 0
4211, 1, 1636421433576, 1636421434242, 666, 268, 398, 0, 0, 0
4212, 1, 1636421433628, 1636421434310, 682, 287, 395, 1, 19, 20
4142, 2, 1636421424227, 1636421434404, 10177, 0, 10177, 0, 1, 1
4213, 1, 1636421433767, 1636421434434, 667, 269, 398, 0, 0, 0
4214, 1, 1636421433851, 1636421434534, 683, 270, 413, 0, 0, 0
4215, 1, 1636421433957, 1636421434670, 713, 270, 443, 0, 0, 0
4143, 2, 1636421424540, 1636421434715, 10175, 1, 10174, 1, 0, 1
4216, 1, 1636421434086, 1636421434766, 680, 275, 405, 1, 7, 8
4217, 1, 1636421434245, 1636421434982, 737, 309, 428, 0, 39, 39
4220, 1, 1636421434534, 1636421435202, 668, 271, 397, 2, 1, 3
4222, 1, 1636421434716, 1636421435338, 622, 270, 352, 1, 1, 2
4223, 1, 1636421434767, 1636421435430, 663, 266, 397, 1, 0, 1
4224, 1, 1636421434846, 1636421435514, 668, 269, 399, 1, 0, 1
4226, 1, 1636421435204, 1636421435870, 666, 267, 399, 0, 2, 2
4150, 2, 1636421425768, 1636421435944, 10176, 0, 10176, 0, 0, 0
4227, 1, 1636421435340, 1636421436002, 662, 265, 397, 1, 0, 1
4228, 1, 1636421435431, 1636421436090, 659, 264, 395, 0, 1, 1
4229, 1, 1636421435515, 1636421436210, 695, 298, 397, 0, 30, 30
4152, 2, 1636421426096, 1636421436271, 10175, 1, 10174, 1, 1, 2
4230, 1, 1636421435872, 1636421436542, 670, 267, 403, 0, 2, 2
4231, 1, 1636421436004, 1636421436666, 662, 265, 397, 0, 0, 0
4233, 1, 1636421436091, 1636421436758, 667, 272, 395, 2, 1, 3
4234, 1, 1636421436212, 1636421436874, 662, 267, 395, 1, 2, 3
4155, 2, 1636421426786, 1636421437007, 10221, 1, 10220, 0, 0, 0
4156, 2, 1636421426856, 1636421437099, 10243, 2, 10241, 0, 0, 0
4236, 1, 1636421436544, 1636421437214, 670, 271, 399, 1, 0, 1
4237, 1, 1636421436667, 1636421437366, 699, 299, 400, 1, 28, 29
4238, 1, 1636421436759, 1636421437454, 695, 294, 401, 2, 28, 30
4239, 1, 1636421436876, 1636421437550, 674, 274, 400, 1, 2, 3
4240, 1, 1636421437138, 1636421437814, 676, 270, 406, 0, 0, 0
4241, 1, 1636421437216, 1636421437878, 662, 266, 396, 0, 0, 0
4242, 1, 1636421437230, 1636421437902, 672, 272, 400, 0, 1, 1
4244, 1, 1636421437455, 1636421438118, 663, 267, 396, 1, 0, 1
4245, 1, 1636421437552, 1636421438214, 662, 267, 395, 0, 1, 1
4246, 1, 1636421437816, 1636421438478, 662, 266, 396, 1, 0, 1
4247, 1, 1636421437880, 1636421438546, 666, 269, 397, 0, 0, 0
4248, 1, 1636421437904, 1636421438574, 670, 270, 400, 1, 0, 1
4249, 1, 1636421438120, 1636421438782, 662, 266, 396, 0, 0, 0
4250, 1, 1636421438216, 1636421438874, 658, 265, 393, 2, 1, 3
4251, 1, 1636421438479, 1636421439142, 663, 266, 397, 1, 0, 1
4252, 1, 1636421438548, 1636421439218, 670, 270, 400, 0, 0, 0
4178, 2, 1636421429156, 1636421439331, 10175, 1, 10174, 0, 0, 0
4254, 1, 1636421438876, 1636421439538, 662, 267, 395, 0, 1, 1
4255, 1, 1636421439144, 1636421439810, 666, 267, 399, 1, 0, 1
4183, 2, 1636421429675, 1636421439872, 10197, 0, 10197, 1, 0, 1
4185, 2, 1636421429852, 1636421440027, 10175, 1, 10174, 1, 0, 1
4256, 1, 1636421439462, 1636421440138, 676, 277, 399, 1, 6, 7
4257, 1, 1636421439812, 1636421440474, 662, 267, 395, 0, 1, 1
4258, 1, 1636421440027, 1636421440690, 663, 271, 392, 3, 0, 3
4259, 1, 1636421440140, 1636421440810, 670, 269, 401, 2, 0, 2
4260, 1, 1636421440158, 1636421440834, 676, 273, 403, 1, 0, 1
4191, 2, 1636421430746, 1636421440923, 10177, 0, 10177, 0, 0, 0
4261, 1, 1636421440475, 1636421441186, 711, 269, 442, 1, 0, 1
4262, 1, 1636421440692, 1636421441370, 678, 287, 391, 2, 17, 19
4264, 1, 1636421440836, 1636421441510, 674, 273, 401, 2, 2, 4
4263, 1, 1636421440812, 1636421441514, 702, 275, 427, 2, 3, 5
4196, 2, 1636421431419, 1636421441595, 10176, 1, 10175, 1, 0, 1
4265, 1, 1636421441058, 1636421441726, 668, 270, 398, 1, 0, 1
4266, 1, 1636421441189, 1636421441862, 673, 271, 402, 1, 2, 3
4267, 1, 1636421441371, 1636421442046, 675, 282, 393, 0, 10, 10
4268, 1, 1636421441511, 1636421442178, 667, 270, 397, 2, 0, 2
4269, 1, 1636421441516, 1636421442178, 662, 266, 396, 1, 0, 1
4271, 1, 1636421441728, 1636421442398, 670, 273, 397, 1, 1, 2
4272, 1, 1636421441864, 1636421442534, 670, 271, 399, 2, 2, 4
4275, 1, 1636421442180, 1636421442846, 666, 270, 396, 3, 0, 3
4274, 1, 1636421442179, 1636421442846, 667, 268, 399, 1, 0, 1
4276, 1, 1636421442399, 1636421443066, 667, 271, 396, 2, 1, 3
4277, 1, 1636421442536, 1636421443201, 665, 270, 395, 0, 1, 1
4279, 1, 1636421442848, 1636421443510, 662, 266, 396, 1, 1, 2
4278, 1, 1636421442848, 1636421443514, 666, 271, 395, 2, 1, 3
4280, 1, 1636421443068, 1636421443730, 662, 266, 396, 0, 0, 0
4281, 1, 1636421443203, 1636421443866, 663, 266, 397, 0, 0, 0
4282, 1, 1636421443512, 1636421444178, 666, 271, 395, 1, 0, 1
4283, 1, 1636421443515, 1636421444182, 667, 270, 397, 1, 0, 1
4284, 1, 1636421443732, 1636421444398, 666, 271, 395, 1, 1, 2
4218, 2, 1636421434312, 1636421444495, 10183, 2, 10181, 2, 0, 2
4285, 1, 1636421443867, 1636421444530, 663, 267, 396, 0, 2, 2
4219, 2, 1636421434436, 1636421444612, 10176, 1, 10175, 0, 1, 1
4221, 2, 1636421434536, 1636421444708, 10172, 1, 10171, 1, 1, 2
4287, 1, 1636421444183, 1636421444882, 699, 299, 400, 1, 32, 33
4286, 1, 1636421444179, 1636421444882, 703, 301, 402, 2, 32, 34
4288, 1, 1636421444399, 1636421445078, 679, 274, 405, 1, 0, 1
4225, 2, 1636421434984, 1636421445159, 10175, 0, 10175, 0, 0, 0
4290, 1, 1636421444630, 1636421445294, 664, 270, 394, 2, 1, 3
4292, 1, 1636421444842, 1636421445514, 672, 273, 399, 0, 6, 6
4293, 1, 1636421444883, 1636421445546, 663, 271, 392, 0, 1, 1
4294, 1, 1636421444883, 1636421445562, 679, 276, 403, 3, 1, 4
4295, 1, 1636421445079, 1636421445738, 659, 262, 397, 0, 0, 0
4297, 1, 1636421445296, 1636421445962, 666, 271, 395, 1, 2, 3
4296, 1, 1636421445295, 1636421445962, 667, 270, 397, 2, 1, 3
4298, 1, 1636421445516, 1636421446178, 662, 270, 392, 1, 0, 1
4299, 1, 1636421445548, 1636421446214, 666, 270, 396, 1, 0, 1
4300, 1, 1636421445564, 1636421446230, 666, 262, 404, 1, 0, 1
4232, 2, 1636421436074, 1636421446251, 10177, 1, 10176, 0, 0, 0
4301, 1, 1636421445739, 1636421446406, 667, 270, 397, 0, 2, 2
4235, 2, 1636421436406, 1636421446579, 10173, 0, 10173, 0, 0, 0
4302, 1, 1636421445963, 1636421446626, 663, 267, 396, 1, 0, 1
4303, 1, 1636421445964, 1636421446634, 670, 266, 404, 1, 0, 1
4304, 1, 1636421446180, 1636421446846, 666, 273, 393, 2, 2, 4
4305, 1, 1636421446253, 1636421446934, 681, 286, 395, 3, 14, 17
4306, 1, 1636421446253, 1636421446934, 681, 286, 395, 0, 16, 16
4308, 1, 1636421446407, 1636421447114, 707, 268, 439, 0, 1, 1
4309, 1, 1636421446627, 1636421447290, 663, 267, 396, 1, 0, 1
4310, 1, 1636421446636, 1636421447294, 658, 266, 392, 0, 0, 0
4312, 1, 1636421446848, 1636421447514, 666, 270, 396, 0, 0, 0
4243, 2, 1636421437367, 1636421447544, 10177, 0, 10177, 0, 0, 0
4313, 1, 1636421446936, 1636421447606, 670, 272, 398, 0, 1, 1
4315, 1, 1636421447115, 1636421447814, 699, 292, 407, 0, 18, 18
4317, 1, 1636421447295, 1636421447994, 699, 303, 396, 2, 34, 36
4316, 1, 1636421447292, 1636421447994, 702, 302, 400, 1, 34, 35
4318, 1, 1636421447545, 1636421448210, 665, 271, 394, 2, 1, 3
4320, 1, 1636421447674, 1636421448350, 676, 271, 405, 1, 0, 1
4321, 1, 1636421447815, 1636421448478, 663, 266, 397, 2, 0, 2
4323, 1, 1636421447996, 1636421448654, 658, 264, 394, 0, 2, 2
4322, 1, 1636421447996, 1636421448662, 666, 263, 403, 0, 1, 1
4253, 2, 1636421438575, 1636421448751, 10176, 0, 10176, 0, 0, 0
4324, 1, 1636421448212, 1636421448874, 662, 269, 393, 0, 1, 1
4325, 1, 1636421448351, 1636421449018, 667, 269, 398, 0, 3, 3
4328, 1, 1636421448663, 1636421449338, 675, 276, 399, 1, 2, 3
4327, 1, 1636421448655, 1636421449338, 683, 271, 412, 1, 1, 2
4329, 1, 1636421448876, 1636421449542, 666, 271, 395, 3, 0, 3
4330, 1, 1636421448882, 1636421449554, 672, 271, 401, 0, 1, 1
4331, 1, 1636421449020, 1636421449682, 662, 267, 395, 1, 0, 1
4334, 1, 1636421449556, 1636421450230, 674, 275, 399, 1, 1, 2
4335, 1, 1636421449684, 1636421450350, 666, 271, 395, 1, 1, 2
4336, 1, 1636421450232, 1636421450898, 666, 270, 396, 1, 0, 1
4337, 1, 1636421450351, 1636421451014, 663, 265, 398, 0, 0, 0
4339, 1, 1636421451016, 1636421451686, 670, 271, 399, 1, 2, 3
4270, 2, 1636421441727, 1636421451904, 10177, 1, 10176, 0, 1, 1
4273, 2, 1636421442047, 1636421452219, 10172, 1, 10171, 1, 0, 1
4341, 1, 1636421452035, 1636421452702, 667, 270, 397, 1, 1, 2
4342, 1, 1636421452346, 1636421453014, 668, 272, 396, 0, 2, 2
4343, 1, 1636421452704, 1636421453374, 670, 271, 399, 1, 1, 2
4344, 1, 1636421453016, 1636421453682, 666, 270, 396, 0, 1, 1
4345, 1, 1636421453376, 1636421454038, 662, 267, 395, 0, 0, 0
4346, 1, 1636421453683, 1636421454354, 671, 268, 403, 0, 0, 0
4347, 1, 1636421454040, 1636421454706, 666, 271, 395, 0, 1, 1
4289, 2, 1636421444532, 1636421454708, 10176, 1, 10175, 0, 1, 1
4291, 2, 1636421444742, 1636421454920, 10178, 0, 10178, 0, 0, 0
4348, 1, 1636421454355, 1636421455066, 711, 318, 393, 1, 46, 47
4349, 1, 1636421454709, 1636421455374, 665, 266, 399, 1, 1, 2
4351, 1, 1636421455054, 1636421455722, 668, 272, 396, 0, 1, 1
4352, 1, 1636421455068, 1636421455734, 666, 271, 395, 3, 0, 3
4353, 1, 1636421455376, 1636421456042, 666, 270, 396, 0, 0, 0
4354, 1, 1636421455723, 1636421456386, 663, 265, 398, 0, 0, 0
4355, 1, 1636421455735, 1636421456402, 667, 270, 397, 2, 0, 2
4307, 2, 1636421446382, 1636421456560, 10178, 1, 10177, 1, 0, 1
4356, 1, 1636421456043, 1636421456710, 667, 267, 400, 1, 0, 1
4311, 2, 1636421446710, 1636421456888, 10178, 0, 10178, 0, 1, 1
4358, 1, 1636421456403, 1636421457102, 699, 272, 427, 1, 1, 2
4314, 2, 1636421446936, 1636421457112, 10176, 1, 10175, 1, 0, 1
4359, 1, 1636421456690, 1636421457381, 691, 289, 402, 0, 19, 19
4360, 1, 1636421456712, 1636421457422, 710, 314, 396, 46, 0, 46
4361, 1, 1636421457018, 1636421457686, 668, 267, 401, 1, 0, 1
4319, 2, 1636421447608, 1636421457783, 10175, 1, 10174, 0, 1, 1
4363, 1, 1636421457242, 1636421457906, 664, 269, 395, 1, 0, 1
4364, 1, 1636421457383, 1636421458054, 671, 270, 401, 1, 0, 1
4365, 1, 1636421457424, 1636421458090, 666, 270, 396, 1, 0, 1
4366, 1, 1636421457688, 1636421458358, 670, 263, 407, 0, 1, 1
4367, 1, 1636421457908, 1636421458574, 666, 270, 396, 3, 0, 3
4368, 1, 1636421457910, 1636421458574, 664, 269, 395, 2, 1, 3
4326, 2, 1636421448480, 1636421458656, 10176, 1, 10175, 2, 0, 2
4369, 1, 1636421458055, 1636421458730, 675, 274, 401, 1, 0, 1
4370, 1, 1636421458092, 1636421458754, 662, 265, 397, 0, 0, 0
4371, 1, 1636421458360, 1636421459018, 658, 266, 392, 0, 0, 0
4373, 1, 1636421458576, 1636421459242, 666, 271, 395, 3, 1, 4
4372, 1, 1636421458576, 1636421459246, 670, 270, 400, 1, 0, 1
4374, 1, 1636421458732, 1636421459402, 670, 275, 395, 1, 0, 1
4375, 1, 1636421458756, 1636421459422, 666, 270, 396, 0, 1, 1
4332, 2, 1636421449340, 1636421459515, 10175, 1, 10174, 0, 1, 1
4333, 2, 1636421449340, 1636421459559, 10219, 1, 10218, 1, 0, 1
4377, 1, 1636421459020, 1636421459682, 662, 266, 396, 2, 0, 2
4378, 1, 1636421459244, 1636421459914, 670, 273, 397, 0, 7, 7
4379, 1, 1636421459247, 1636421459914, 667, 270, 397, 0, 7, 7
4380, 1, 1636421459403, 1636421460094, 691, 268, 423, 1, 1, 2
4382, 1, 1636421459646, 1636421460310, 664, 271, 393, 3, 0, 3
4383, 1, 1636421459684, 1636421460358, 674, 278, 396, 0, 0, 0
4384, 1, 1636421459915, 1636421460578, 663, 268, 395, 1, 1, 2
4385, 1, 1636421459916, 1636421460582, 666, 270, 396, 0, 1, 1
4386, 1, 1636421460096, 1636421460762, 666, 270, 396, 0, 0, 0
4387, 1, 1636421460313, 1636421460986, 673, 273, 400, 1, 1, 2
4388, 1, 1636421460360, 1636421461042, 682, 286, 396, 1, 0, 1
4338, 2, 1636421450900, 1636421461075, 10175, 0, 10175, 0, 0, 0
4389, 1, 1636421460580, 1636421461246, 666, 270, 396, 1, 0, 1
4390, 1, 1636421460584, 1636421461262, 678, 275, 403, 1, 1, 2
4391, 1, 1636421460764, 1636421461434, 670, 275, 395, 1, 2, 3
4392, 1, 1636421460987, 1636421461654, 667, 269, 398, 2, 0, 2
4393, 1, 1636421461077, 1636421461738, 661, 267, 394, 1, 1, 2
4340, 2, 1636421451688, 1636421461863, 10175, 0, 10175, 0, 0, 0
4394, 1, 1636421461206, 1636421461874, 668, 271, 397, 3, 0, 3
4395, 1, 1636421461247, 1636421461914, 667, 271, 396, 0, 1, 1
4397, 1, 1636421461436, 1636421462126, 690, 288, 402, 0, 26, 26
4399, 1, 1636421461739, 1636421462406, 667, 274, 393, 1, 0, 1
4400, 1, 1636421461876, 1636421462550, 674, 272, 402, 0, 3, 3
4402, 1, 1636421462128, 1636421462793, 665, 270, 395, 1, 0, 1
4403, 1, 1636421462408, 1636421463070, 662, 270, 392, 0, 1, 1
4404, 1, 1636421462552, 1636421463214, 662, 267, 395, 1, 0, 1
4405, 1, 1636421462794, 1636421463462, 668, 270, 398, 0, 1, 1
4406, 1, 1636421463072, 1636421463734, 662, 269, 393, 1, 0, 1
4407, 1, 1636421463216, 1636421463882, 666, 267, 399, 0, 0, 0
4408, 1, 1636421463464, 1636421464130, 666, 268, 398, 0, 0, 0
4409, 1, 1636421463736, 1636421464402, 666, 274, 392, 1, 1, 2
4410, 1, 1636421463884, 1636421464554, 670, 270, 400, 1, 0, 1
4350, 2, 1636421454839, 1636421465016, 10177, 0, 10177, 0, 1, 1
4413, 1, 1636421464557, 1636421465226, 669, 270, 399, 1, 0, 1
4414, 1, 1636421465146, 1636421465814, 668, 270, 398, 2, 0, 2
4415, 1, 1636421465228, 1636421465898, 670, 272, 398, 1, 0, 1
4416, 1, 1636421465816, 1636421466486, 670, 269, 401, 0, 0, 0
4357, 2, 1636421456387, 1636421466608, 10221, 1, 10220, 0, 2, 2
4362, 2, 1636421457113, 1636421467288, 10175, 1, 10174, 0, 0, 0
4419, 1, 1636421466738, 1636421467410, 672, 269, 403, 1, 0, 1
4421, 1, 1636421467418, 1636421468082, 664, 266, 398, 1, 0, 1
4420, 1, 1636421467412, 1636421468082, 670, 271, 399, 1, 1, 2
4422, 1, 1636421468084, 1636421468746, 662, 271, 391, 2, 1, 3
4423, 1, 1636421468084, 1636421468746, 662, 267, 395, 0, 2, 2
4376, 2, 1636421458786, 1636421468963, 10177, 0, 10177, 0, 0, 0
4424, 1, 1636421468748, 1636421469414, 666, 269, 397, 1, 0, 1
4381, 2, 1636421459423, 1636421469604, 10181, 0, 10181, 0, 1, 1
4426, 1, 1636421469094, 1636421469762, 668, 270, 398, 0, 2, 2
4429, 1, 1636421469764, 1636421470430, 666, 270, 396, 0, 1, 1
4396, 2, 1636421461264, 1636421471439, 10175, 1, 10174, 0, 0, 0
4398, 2, 1636421461656, 1636421471832, 10176, 0, 10176, 0, 0, 0
4401, 2, 1636421461915, 1636421472088, 10173, 1, 10172, 0, 1, 1
4417, 1, 1636421465900, 1636421472578, 6678, 6279, 399, 1, 1, 2
4431, 1, 1636421471962, 1636421472626, 664, 269, 395, 1, 0, 1
4432, 1, 1636421472580, 1636421473254, 674, 270, 404, 2, 0, 2
4433, 1, 1636421472629, 1636421473298, 669, 271, 398, 0, 3, 3
4434, 1, 1636421473256, 1636421473918, 662, 265, 397, 0, 0, 0
4435, 1, 1636421473300, 1636421473970, 670, 270, 400, 1, 0, 1
4411, 2, 1636421464132, 1636421474308, 10176, 0, 10176, 0, 0, 0
4412, 2, 1636421464404, 1636421474575, 10171, 0, 10171, 0, 0, 0
4436, 1, 1636421473920, 1636421474586, 666, 269, 397, 0, 1, 1
4437, 1, 1636421473972, 1636421474662, 690, 294, 396, 1, 26, 27
4440, 1, 1636421474664, 1636421475334, 670, 272, 398, 2, 1, 3
4442, 1, 1636421475336, 1636421476006, 670, 268, 402, 0, 0, 0
4443, 1, 1636421476009, 1636421476674, 665, 270, 395, 0, 0, 0
4418, 2, 1636421466488, 1636421476700, 10212, 1, 10211, 1, 1, 2
4444, 1, 1636421476830, 1636421477502, 672, 270, 402, 0, 1, 1
4445, 1, 1636421477505, 1636421478178, 673, 272, 401, 0, 0, 0
4446, 1, 1636421478181, 1636421478850, 669, 270, 399, 0, 2, 2
4425, 2, 1636421468748, 1636421478924, 10176, 0, 10176, 0, 0, 0
4427, 2, 1636421469416, 1636421479588, 10172, 1, 10171, 0, 0, 0
4448, 1, 1636421479054, 1636421479726, 672, 272, 400, 2, 2, 4
4428, 2, 1636421469738, 1636421479915, 10177, 0, 10177, 0, 0, 0
4449, 1, 1636421479714, 1636421480378, 664, 271, 393, 0, 1, 1
4450, 1, 1636421479728, 1636421480406, 678, 273, 405, 0, 0, 0
4430, 2, 1636421470432, 1636421480607, 10175, 1, 10174, 0, 0, 0
4451, 1, 1636421480046, 1636421480714, 668, 270, 398, 0, 0, 0
4452, 1, 1636421480380, 1636421481054, 674, 278, 396, 1, 10, 11
4453, 1, 1636421480408, 1636421481066, 658, 263, 395, 1, 0, 1
4454, 1, 1636421480715, 1636421481386, 671, 275, 396, 1, 0, 1
4455, 1, 1636421480738, 1636421481410, 672, 270, 402, 0, 0, 0
4456, 1, 1636421481055, 1636421481726, 671, 270, 401, 0, 0, 0
4457, 1, 1636421481068, 1636421481734, 666, 266, 400, 0, 0, 0
4459, 1, 1636421481412, 1636421482074, 662, 268, 394, 0, 1, 1
4460, 1, 1636421481727, 1636421482394, 667, 270, 397, 1, 0, 1
4461, 1, 1636421481735, 1636421482406, 671, 269, 402, 1, 0, 1
4462, 1, 1636421482076, 1636421482742, 666, 269, 397, 0, 0, 0
4463, 1, 1636421482396, 1636421483062, 666, 270, 396, 2, 0, 2
4464, 1, 1636421482407, 1636421483074, 667, 270, 397, 0, 0, 0
4466, 1, 1636421483064, 1636421483726, 662, 267, 395, 0, 1, 1
4467, 1, 1636421483076, 1636421483746, 670, 269, 401, 1, 0, 1
4468, 1, 1636421483728, 1636421484394, 666, 272, 394, 1, 1, 2
4438, 2, 1636421474438, 1636421484624, 10186, 1, 10185, 0, 2, 2
4469, 1, 1636421483747, 1636421484662, 915, 519, 396, 1, 1, 2
4439, 2, 1636421474588, 1636421484763, 10175, 0, 10175, 0, 0, 0
4441, 2, 1636421474710, 1636421484883, 10173, 0, 10173, 0, 0, 0
4470, 1, 1636421484663, 1636421485342, 679, 270, 409, 0, 0, 0
4471, 1, 1636421484764, 1636421485462, 698, 269, 429, 0, 0, 0
4472, 1, 1636421484894, 1636421485570, 676, 274, 402, 1, 0, 1
4473, 1, 1636421485014, 1636421485734, 720, 321, 399, 0, 0, 0
4474, 1, 1636421485343, 1636421486014, 671, 274, 397, 0, 0, 0
4475, 1, 1636421485464, 1636421486130, 666, 269, 397, 1, 0, 1
4476, 1, 1636421485572, 1636421486246, 674, 274, 400, 1, 1, 2
4477, 1, 1636421485735, 1636421486410, 675, 278, 397, 1, 1, 2
4478, 1, 1636421486016, 1636421486686, 670, 271, 399, 2, 0, 2
4480, 1, 1636421486248, 1636421486914, 666, 270, 396, 0, 1, 1
4483, 1, 1636421486916, 1636421487590, 674, 274, 400, 1, 1, 2
4484, 1, 1636421487592, 1636421488262, 670, 269, 401, 0, 1, 1
4485, 1, 1636421488264, 1636421488938, 674, 272, 402, 1, 2, 3
4447, 2, 1636421478852, 1636421489027, 10175, 1, 10174, 1, 1, 2
4486, 1, 1636421488941, 1636421489614, 673, 273, 400, 1, 1, 2
4487, 1, 1636421489158, 1636421489830, 672, 268, 404, 0, 1, 1
4488, 1, 1636421489832, 1636421490502, 670, 269, 401, 0, 1, 1
4489, 1, 1636421490504, 1636421491174, 670, 269, 401, 1, 1, 2
4458, 2, 1636421481388, 1636421491564, 10176, 0, 10176, 0, 0, 0
4490, 1, 1636421491176, 1636421491842, 666, 269, 397, 1, 1, 2
4491, 1, 1636421491694, 1636421492366, 672, 271, 401, 0, 1, 1
4492, 1, 1636421491844, 1636421492510, 666, 269, 397, 0, 0, 0
4465, 2, 1636421482744, 1636421492920, 10176, 0, 10176, 0, 0, 0
4493, 1, 1636421492368, 1636421493038, 670, 271, 399, 2, 0, 2
4494, 1, 1636421492512, 1636421493310, 798, 402, 396, 2, 0, 2
4495, 1, 1636421493039, 1636421493706, 667, 267, 400, 0, 1, 1
4496, 1, 1636421493054, 1636421493730, 676, 269, 407, 0, 0, 0
4497, 1, 1636421493312, 1636421493986, 674, 274, 400, 2, 0, 2
4499, 1, 1636421493732, 1636421494406, 674, 270, 404, 1, 0, 1
4500, 1, 1636421493988, 1636421494658, 670, 269, 401, 0, 0, 0
4501, 1, 1636421494408, 1636421495074, 666, 270, 396, 2, 1, 3
4502, 1, 1636421494660, 1636421495330, 670, 270, 400, 0, 1, 1
4503, 1, 1636421495076, 1636421495742, 666, 271, 395, 1, 0, 1
4504, 1, 1636421495332, 1636421495998, 666, 270, 396, 2, 1, 3
4479, 2, 1636421486132, 1636421496311, 10179, 1, 10178, 1, 0, 1
4505, 1, 1636421495744, 1636421496414, 670, 270, 400, 0, 0, 0
4481, 2, 1636421486411, 1636421496583, 10172, 0, 10172, 0, 0, 0
4506, 1, 1636421496000, 1636421496670, 670, 270, 400, 1, 2, 3
4482, 2, 1636421486688, 1636421496864, 10176, 1, 10175, 1, 0, 1
4507, 1, 1636421496416, 1636421497130, 714, 278, 436, 2, 6, 8
4508, 1, 1636421496438, 1636421497130, 692, 277, 415, 1, 6, 7
4510, 1, 1636421496714, 1636421497402, 688, 273, 415, 1, 0, 1
4511, 1, 1636421496994, 1636421497662, 668, 272, 396, 0, 1, 1
4512, 1, 1636421497132, 1636421497802, 670, 271, 399, 1, 0, 1
4513, 1, 1636421497132, 1636421497806, 674, 271, 403, 2, 0, 2
4514, 1, 1636421497403, 1636421498070, 667, 274, 393, 0, 0, 0
4515, 1, 1636421497664, 1636421498330, 666, 267, 399, 1, 1, 2
4516, 1, 1636421497804, 1636421498470, 666, 269, 397, 0, 0, 0
4517, 1, 1636421497808, 1636421498482, 674, 270, 404, 0, 0, 0
4518, 1, 1636421498072, 1636421498750, 678, 283, 395, 1, 1, 2
4519, 1, 1636421498331, 1636421499002, 671, 270, 401, 0, 0, 0
4520, 1, 1636421498471, 1636421499142, 671, 272, 399, 1, 2, 3
4523, 1, 1636421499004, 1636421499670, 666, 271, 395, 0, 1, 1
4524, 1, 1636421499143, 1636421499810, 667, 267, 400, 0, 2, 2
4525, 1, 1636421499672, 1636421500342, 670, 269, 401, 1, 0, 1
4526, 1, 1636421499812, 1636421500478, 666, 270, 396, 0, 0, 0
4527, 1, 1636421500344, 1636421501018, 674, 270, 404, 0, 0, 0
4529, 1, 1636421501020, 1636421501690, 670, 270, 400, 0, 0, 0
4498, 2, 1636421493708, 1636421503883, 10175, 0, 10175, 0, 0, 0
4530, 1, 1636421504014, 1636421504686, 672, 268, 404, 0, 0, 0
4531, 1, 1636421504688, 1636421505358, 670, 270, 400, 3, 0, 3
4532, 1, 1636421505360, 1636421506026, 666, 271, 395, 1, 1, 2
4533, 1, 1636421506028, 1636421506698, 670, 270, 400, 0, 0, 0
4509, 2, 1636421496672, 1636421506848, 10176, 0, 10176, 0, 0, 0
4534, 1, 1636421506699, 1636421507382, 683, 267, 416, 1, 0, 1
4535, 1, 1636421506978, 1636421507650, 672, 271, 401, 2, 1, 3
4536, 1, 1636421507384, 1636421508054, 670, 270, 400, 1, 0, 1
4537, 1, 1636421507652, 1636421508326, 674, 274, 400, 1, 0, 1
4521, 2, 1636421498484, 1636421508659, 10175, 0, 10175, 0, 0, 0
4538, 1, 1636421508055, 1636421508726, 671, 271, 400, 0, 2, 2
4522, 2, 1636421498752, 1636421508923, 10171, 0, 10171, 0, 0, 0
4539, 1, 1636421508329, 1636421509014, 685, 289, 396, 1, 22, 23
4540, 1, 1636421508728, 1636421509398, 670, 270, 400, 0, 0, 0
4541, 1, 1636421508790, 1636421509454, 664, 264, 400, 1, 0, 1
4542, 1, 1636421509015, 1636421509694, 679, 273, 406, 1, 0, 1
4543, 1, 1636421509058, 1636421509722, 664, 270, 394, 2, 0, 2
4544, 1, 1636421509399, 1636421510066, 667, 270, 397, 0, 0, 0
4545, 1, 1636421509456, 1636421510126, 670, 271, 399, 1, 1, 2
4546, 1, 1636421509696, 1636421510362, 666, 271, 395, 2, 0, 2
4547, 1, 1636421509724, 1636421510394, 670, 274, 396, 0, 0, 0
4528, 2, 1636421500480, 1636421510655, 10175, 0, 10175, 1, 0, 1
4548, 1, 1636421510068, 1636421510734, 666, 269, 397, 0, 0, 0
4549, 1, 1636421510128, 1636421510790, 662, 265, 397, 0, 0, 0
4550, 1, 1636421510363, 1636421511034, 671, 269, 402, 0, 0, 0
4551, 1, 1636421510396, 1636421511110, 714, 318, 396, 0, 43, 43
4552, 1, 1636421510736, 1636421511402, 666, 270, 396, 2, 0, 2
4553, 1, 1636421510786, 1636421511454, 668, 270, 398, 0, 0, 0
4554, 1, 1636421510792, 1636421511458, 666, 270, 396, 1, 0, 1
4555, 1, 1636421511036, 1636421511710, 674, 268, 406, 1, 0, 1
4556, 1, 1636421511112, 1636421511774, 662, 270, 392, 2, 0, 2
4558, 1, 1636421511456, 1636421512122, 666, 268, 398, 0, 0, 0
4559, 1, 1636421511460, 1636421512126, 666, 270, 396, 0, 0, 0
4560, 1, 1636421511775, 1636421512446, 671, 273, 398, 1, 0, 1
4562, 1, 1636421512128, 1636421512794, 666, 269, 397, 1, 1, 2
4561, 1, 1636421512124, 1636421512794, 670, 269, 401, 1, 1, 2
4563, 1, 1636421512447, 1636421513118, 671, 266, 405, 0, 1, 1
4565, 1, 1636421512796, 1636421513466, 670, 270, 400, 1, 1, 2
4564, 1, 1636421512796, 1636421513466, 670, 272, 398, 4, 0, 4
4566, 1, 1636421513119, 1636421513778, 659, 266, 393, 0, 0, 0
4567, 1, 1636421513468, 1636421514134, 666, 270, 396, 1, 0, 1
4568, 1, 1636421513468, 1636421514134, 666, 270, 396, 0, 1, 1
4569, 1, 1636421513780, 1636421514442, 662, 265, 397, 1, 0, 1
4570, 1, 1636421514136, 1636421514802, 666, 270, 396, 2, 0, 2
4571, 1, 1636421514136, 1636421514802, 666, 269, 397, 2, 0, 2
4572, 1, 1636421514444, 1636421515114, 670, 269, 401, 0, 1, 1
4573, 1, 1636421514803, 1636421515470, 667, 269, 398, 3, 0, 3
4574, 1, 1636421514804, 1636421515470, 666, 269, 397, 1, 0, 1
4575, 1, 1636421515116, 1636421515782, 666, 266, 400, 0, 0, 0
4576, 1, 1636421515472, 1636421516138, 666, 267, 399, 3, 0, 3
4577, 1, 1636421515783, 1636421516446, 663, 270, 393, 0, 1, 1
4557, 2, 1636421511404, 1636421521580, 10176, 1, 10175, 0, 2, 2
4580, 1, 1636421521710, 1636421522378, 668, 270, 398, 2, 0, 2
4581, 1, 1636421522380, 1636421523050, 670, 272, 398, 1, 2, 3
4582, 1, 1636421523052, 1636421523722, 670, 270, 400, 0, 1, 1
4583, 1, 1636421523724, 1636421524390, 666, 270, 396, 1, 0, 1
4584, 1, 1636421524392, 1636421525058, 666, 270, 396, 1, 0, 1
4585, 1, 1636421525060, 1636421525726, 666, 270, 396, 1, 0, 1
4578, 2, 1636421516140, 1636421526316, 10176, 1, 10175, 1, 0, 1
4586, 1, 1636421525728, 1636421526398, 670, 270, 400, 0, 1, 1
4579, 2, 1636421516448, 1636421526623, 10175, 0, 10175, 0, 0, 0
4587, 1, 1636421526446, 1636421527158, 712, 268, 444, 1, 0, 1
4588, 1, 1636421526754, 1636421527430, 676, 282, 394, 0, 0, 0
4589, 1, 1636421527160, 1636421527834, 674, 271, 403, 1, 1, 2
4590, 1, 1636421527432, 1636421528102, 670, 279, 391, 1, 1, 2
4591, 1, 1636421527836, 1636421528502, 666, 271, 395, 3, 1, 4
4592, 1, 1636421528104, 1636421528774, 670, 277, 393, 0, 0, 0
4593, 1, 1636421528504, 1636421529170, 666, 271, 395, 2, 1, 3
4594, 1, 1636421528776, 1636421529458, 682, 279, 403, 1, 1, 2
4595, 1, 1636421529172, 1636421529838, 666, 269, 397, 1, 0, 1
4596, 1, 1636421529460, 1636421530122, 662, 270, 392, 1, 0, 1
4597, 1, 1636421529840, 1636421530506, 666, 270, 396, 2, 0, 2
4598, 1, 1636421530124, 1636421530790, 666, 269, 397, 0, 0, 0
4599, 1, 1636421530508, 1636421531174, 666, 270, 396, 2, 0, 2
4600, 1, 1636421530792, 1636421531454, 662, 269, 393, 0, 0, 0
4601, 1, 1636421835753, 1636421836386, 633, 273, 360, 0, 1, 1
4603, 1, 1636421836526, 1636421837150, 624, 268, 356, 0, 0, 0
4604, 1, 1636421837176, 1636421837798, 622, 266, 356, 0, 1, 1
4606, 1, 1636421837785, 1636421838414, 629, 270, 359, 0, 1, 1
4608, 1, 1636421838404, 1636421839030, 626, 272, 354, 2, 1, 3
4611, 1, 1636421839101, 1636421839726, 625, 271, 354, 3, 0, 3
4613, 1, 1636421839822, 1636421840446, 624, 270, 354, 0, 1, 1
4615, 1, 1636421840456, 1636421841082, 626, 270, 356, 0, 0, 0
4614, 1, 1636421840449, 1636421841114, 665, 269, 396, 0, 0, 0
4616, 1, 1636421841087, 1636421841710, 623, 270, 353, 0, 0, 0
4617, 1, 1636421841115, 1636421841786, 671, 271, 400, 1, 0, 1
4620, 1, 1636421841766, 1636421842394, 628, 270, 358, 0, 0, 0
4622, 1, 1636421842397, 1636421843070, 673, 269, 404, 0, 1, 1
4623, 1, 1636421843072, 1636421843738, 666, 271, 395, 0, 0, 0
4624, 1, 1636421843471, 1636421844098, 627, 270, 357, 2, 0, 2
4627, 1, 1636421844162, 1636421844794, 632, 274, 358, 0, 1, 1
4628, 1, 1636421844796, 1636421845470, 674, 269, 405, 0, 0, 0
4629, 1, 1636421845374, 1636421845998, 624, 269, 355, 0, 0, 0
4630, 1, 1636421845472, 1636421846142, 670, 270, 400, 0, 1, 1
4602, 2, 1636421836419, 1636421846595, 10176, 0, 10176, 0, 0, 0
4632, 1, 1636421846001, 1636421846626, 625, 271, 354, 2, 1, 3
4631, 1, 1636421845999, 1636421846666, 667, 271, 396, 0, 1, 1
4635, 1, 1636421846667, 1636421847330, 663, 271, 392, 1, 1, 2
4605, 2, 1636421837189, 1636421847363, 10174, 0, 10174, 0, 0, 0
4636, 1, 1636421846726, 1636421847394, 668, 271, 397, 0, 2, 2
4637, 1, 1636421846904, 1636421847530, 626, 276, 350, 1, 1, 2
4607, 2, 1636421837838, 1636421848016, 10178, 0, 10178, 0, 0, 0
4639, 1, 1636421847396, 1636421848062, 666, 271, 395, 0, 1, 1
4640, 1, 1636421847494, 1636421848166, 672, 273, 399, 1, 0, 1
4642, 1, 1636421847702, 1636421848370, 668, 269, 399, 1, 0, 1
4609, 2, 1636421838451, 1636421848628, 10177, 1, 10176, 1, 0, 1
4643, 1, 1636421848063, 1636421848734, 671, 270, 401, 1, 0, 1
4644, 1, 1636421848146, 1636421848814, 668, 267, 401, 0, 0, 0
4645, 1, 1636421848168, 1636421848838, 670, 271, 399, 2, 1, 3
4647, 1, 1636421848379, 1636421849010, 631, 270, 361, 0, 1, 1
4646, 1, 1636421848372, 1636421849074, 702, 306, 396, 0, 38, 38
4610, 2, 1636421839071, 1636421849243, 10172, 1, 10171, 0, 1, 1
4648, 1, 1636421848736, 1636421849402, 666, 271, 395, 0, 0, 0
4649, 1, 1636421848758, 1636421849426, 668, 271, 397, 1, 0, 1
4651, 1, 1636421848840, 1636421849510, 670, 275, 395, 1, 0, 1
4650, 1, 1636421848815, 1636421849522, 707, 296, 411, 0, 26, 26
4652, 1, 1636421848897, 1636421849526, 629, 266, 363, 0, 0, 0
4654, 1, 1636421849075, 1636421849782, 707, 272, 435, 0, 0, 0
4612, 2, 1636421839765, 1636421849939, 10174, 1, 10173, 0, 0, 0
4655, 1, 1636421849374, 1636421850038, 664, 269, 395, 1, 0, 1
4656, 1, 1636421849404, 1636421850074, 670, 269, 401, 0, 0, 0
4657, 1, 1636421849427, 1636421850098, 671, 269, 402, 0, 0, 0
4658, 1, 1636421849512, 1636421850206, 694, 290, 404, 1, 22, 23
4659, 1, 1636421849524, 1636421850206, 682, 276, 406, 0, 6, 6
4660, 1, 1636421849548, 1636421850386, 838, 487, 351, 0, 45, 45
4663, 1, 1636421850040, 1636421850702, 662, 266, 396, 0, 0, 0
4665, 1, 1636421850076, 1636421850734, 658, 264, 394, 0, 1, 1
4664, 1, 1636421850070, 1636421850734, 664, 267, 397, 0, 0, 0
4666, 1, 1636421850100, 1636421850762, 662, 263, 399, 0, 1, 1
4668, 1, 1636421850208, 1636421850870, 662, 266, 396, 0, 0, 0
4667, 1, 1636421850208, 1636421850878, 670, 274, 396, 0, 0, 0
4669, 1, 1636421850387, 1636421851054, 667, 274, 393, 0, 0, 0
4618, 2, 1636421841123, 1636421851296, 10173, 1, 10172, 0, 0, 0
4670, 1, 1636421850707, 1636421851370, 663, 270, 393, 0, 0, 0
4671, 1, 1636421850736, 1636421851402, 666, 269, 397, 0, 0, 0
4672, 1, 1636421850743, 1636421851406, 663, 266, 397, 0, 0, 0
4673, 1, 1636421850766, 1636421851438, 672, 274, 398, 1, 0, 1
4674, 1, 1636421850874, 1636421851566, 692, 284, 408, 0, 18, 18
4675, 1, 1636421850879, 1636421851570, 691, 279, 412, 0, 10, 10
4676, 1, 1636421851055, 1636421851738, 683, 291, 392, 0, 27, 27
4619, 2, 1636421841750, 1636421851923, 10173, 0, 10173, 0, 0, 0
4621, 2, 1636421841788, 1636421851967, 10179, 0, 10179, 0, 0, 0
4677, 1, 1636421851373, 1636421852042, 669, 269, 400, 1, 0, 1
4678, 1, 1636421851404, 1636421852070, 666, 270, 396, 0, 0, 0
4679, 1, 1636421851409, 1636421852086, 677, 269, 408, 1, 0, 1
4680, 1, 1636421851422, 1636421852094, 672, 275, 397, 1, 0, 1
4682, 1, 1636421851483, 1636421852110, 627, 270, 357, 1, 1, 2
4684, 1, 1636421851572, 1636421852322, 750, 267, 483, 2, 0, 2
4683, 1, 1636421851568, 1636421852322, 754, 354, 400, 0, 77, 77
4681, 1, 1636421851440, 1636421852410, 970, 574, 396, 1, 39, 40
4686, 1, 1636421852043, 1636421852706, 663, 270, 393, 1, 0, 1
4687, 1, 1636421852054, 1636421852718, 664, 271, 393, 1, 1, 2
4688, 1, 1636421852072, 1636421852738, 666, 270, 396, 0, 0, 0
4689, 1, 1636421852087, 1636421852758, 671, 270, 401, 1, 0, 1
4691, 1, 1636421852096, 1636421852774, 678, 273, 405, 0, 1, 1
4690, 1, 1636421852094, 1636421852998, 904, 503, 401, 1, 0, 1
4693, 1, 1636421852323, 1636421853002, 679, 278, 401, 2, 0, 2
4694, 1, 1636421852324, 1636421853002, 678, 277, 401, 0, 1, 1
4695, 1, 1636421852412, 1636421853078, 666, 270, 396, 1, 0, 1
4696, 1, 1636421852710, 1636421853377, 667, 265, 402, 0, 0, 0
4697, 1, 1636421852719, 1636421853394, 675, 270, 405, 0, 1, 1
4698, 1, 1636421852739, 1636421853414, 675, 271, 404, 0, 0, 0
4700, 1, 1636421852776, 1636421853450, 674, 271, 403, 0, 1, 1
4701, 1, 1636421853000, 1636421853658, 658, 263, 395, 0, 0, 0
4703, 1, 1636421853004, 1636421853666, 662, 262, 400, 2, 0, 2
4702, 1, 1636421853003, 1636421853670, 667, 271, 396, 2, 0, 2
4704, 1, 1636421853080, 1636421853746, 666, 266, 400, 0, 1, 1
4625, 2, 1636421843740, 1636421853916, 10176, 1, 10175, 1, 0, 1
4705, 1, 1636421853379, 1636421854042, 663, 270, 393, 0, 0, 0
4706, 1, 1636421853395, 1636421854062, 667, 270, 397, 0, 0, 0
4707, 1, 1636421853415, 1636421854086, 671, 270, 401, 0, 0, 0
4708, 1, 1636421853451, 1636421854114, 663, 266, 397, 0, 1, 1
4626, 2, 1636421844138, 1636421854315, 10177, 1, 10176, 0, 0, 0
4709, 1, 1636421853666, 1636421854362, 696, 299, 397, 2, 30, 32
4711, 1, 1636421853671, 1636421854366, 695, 294, 401, 2, 26, 28
4712, 1, 1636421853748, 1636421854454, 706, 272, 434, 2, 0, 2
4714, 1, 1636421854046, 1636421854714, 668, 270, 398, 1, 1, 2
4713, 1, 1636421854046, 1636421854762, 716, 321, 395, 1, 35, 36
4716, 1, 1636421854087, 1636421854762, 675, 280, 395, 4, 12, 16
4715, 1, 1636421854064, 1636421854766, 702, 299, 403, 1, 31, 32
4717, 1, 1636421854118, 1636421854782, 664, 270, 394, 0, 0, 0
4718, 1, 1636421854363, 1636421855038, 675, 274, 401, 0, 1, 1
4720, 1, 1636421854446, 1636421855118, 672, 271, 401, 0, 1, 1
4721, 1, 1636421854455, 1636421855118, 663, 263, 400, 1, 1, 2
4722, 1, 1636421854716, 1636421855378, 662, 267, 395, 1, 0, 1
4723, 1, 1636421854763, 1636421855422, 659, 265, 394, 0, 0, 0
4725, 1, 1636421854767, 1636421855434, 667, 266, 401, 1, 0, 1
4724, 1, 1636421854763, 1636421855442, 679, 279, 400, 0, 0, 0
4726, 1, 1636421854784, 1636421855450, 666, 271, 395, 0, 0, 0
4727, 1, 1636421855039, 1636421855710, 671, 274, 397, 0, 0, 0
4728, 1, 1636421855120, 1636421855794, 674, 274, 400, 0, 0, 0
4730, 1, 1636421855382, 1636421856046, 664, 270, 394, 1, 0, 1
4732, 1, 1636421855436, 1636421856102, 666, 270, 396, 2, 0, 2
4733, 1, 1636421855444, 1636421856118, 674, 274, 400, 0, 0, 0
4734, 1, 1636421855452, 1636421856130, 678, 274, 404, 0, 0, 0
4633, 2, 1636421846144, 1636421856327, 10183, 0, 10183, 0, 0, 0
4735, 1, 1636421855712, 1636421856382, 670, 270, 400, 0, 0, 0
4736, 1, 1636421855796, 1636421856462, 666, 269, 397, 1, 0, 1
4737, 1, 1636421856048, 1636421856718, 670, 269, 401, 0, 0, 0
4738, 1, 1636421856104, 1636421856774, 670, 273, 397, 0, 6, 6
4740, 1, 1636421856132, 1636421856802, 670, 269, 401, 0, 0, 0
4634, 2, 1636421846664, 1636421856840, 10176, 1, 10175, 2, 0, 2
4741, 1, 1636421856384, 1636421857106, 722, 269, 453, 0, 0, 0
4743, 1, 1636421856464, 1636421857130, 666, 269, 397, 3, 0, 3
4742, 1, 1636421856458, 1636421857130, 672, 270, 402, 2, 0, 2
4744, 1, 1636421856720, 1636421857426, 706, 275, 431, 1, 0, 1
4745, 1, 1636421856776, 1636421857438, 662, 266, 396, 0, 0, 0
4746, 1, 1636421856842, 1636421857510, 668, 270, 398, 1, 0, 1
4638, 2, 1636421847363, 1636421857539, 10176, 0, 10176, 1, 0, 1
4747, 1, 1636421856971, 1636421857638, 667, 273, 394, 0, 0, 0
4641, 2, 1636421847570, 1636421857747, 10177, 0, 10177, 1, 0, 1
4748, 1, 1636421857107, 1636421857806, 699, 302, 397, 0, 42, 42
4750, 1, 1636421857132, 1636421857806, 674, 276, 398, 2, 1, 3
4749, 1, 1636421857131, 1636421857806, 675, 276, 399, 2, 2, 4
4752, 1, 1636421857442, 1636421858114, 672, 263, 409, 1, 0, 1
4751, 1, 1636421857427, 1636421858122, 695, 271, 424, 1, 0, 1
4754, 1, 1636421857639, 1636421858326, 687, 270, 417, 0, 1, 1
4755, 1, 1636421857670, 1636421858334, 664, 270, 394, 0, 0, 0
4757, 1, 1636421857808, 1636421858470, 662, 265, 397, 1, 0, 1
4756, 1, 1636421857807, 1636421858478, 671, 274, 397, 3, 0, 3
4758, 1, 1636421857808, 1636421858486, 678, 274, 404, 3, 0, 3
4759, 1, 1636421857878, 1636421858606, 728, 329, 399, 0, 0, 0
4761, 1, 1636421858124, 1636421858790, 666, 270, 396, 1, 0, 1
4762, 1, 1636421858328, 1636421858986, 658, 266, 392, 1, 0, 1
4763, 1, 1636421858335, 1636421859002, 667, 270, 397, 1, 0, 1
4764, 1, 1636421858475, 1636421859142, 667, 270, 397, 2, 0, 2
4766, 1, 1636421858488, 1636421859162, 674, 273, 401, 0, 0, 0
4653, 2, 1636421849046, 1636421859223, 10177, 0, 10177, 0, 0, 0
4767, 1, 1636421858608, 1636421859282, 674, 275, 399, 0, 1, 1
4768, 1, 1636421858792, 1636421859490, 698, 299, 399, 1, 31, 32
4770, 1, 1636421859004, 1636421859670, 666, 270, 396, 0, 2, 2
4769, 1, 1636421858994, 1636421859670, 676, 282, 394, 2, 14, 16
4661, 2, 1636421849563, 1636421859743, 10180, 1, 10179, 0, 0, 0
4771, 1, 1636421859144, 1636421859806, 662, 262, 400, 0, 0, 0
4772, 1, 1636421859164, 1636421859822, 658, 263, 395, 0, 0, 0
4773, 1, 1636421859284, 1636421859950, 666, 266, 400, 0, 0, 0
4662, 2, 1636421849784, 1636421859987, 10203, 1, 10202, 1, 0, 1
4774, 1, 1636421859354, 1636421860022, 668, 269, 399, 0, 0, 0
4775, 1, 1636421859492, 1636421860190, 698, 302, 396, 0, 34, 34
4777, 1, 1636421859671, 1636421860342, 671, 277, 394, 0, 14, 14
4776, 1, 1636421859671, 1636421860342, 671, 275, 396, 1, 10, 11
4778, 1, 1636421859810, 1636421860518, 708, 263, 445, 0, 0, 0
4779, 1, 1636421859830, 1636421860526, 696, 268, 428, 2, 0, 2
4780, 1, 1636421859878, 1636421860566, 688, 267, 421, 2, 1, 3
4781, 1, 1636421859990, 1636421860662, 672, 275, 397, 2, 0, 2
4782, 1, 1636421860024, 1636421860694, 670, 274, 396, 0, 0, 0
4783, 1, 1636421860114, 1636421860830, 716, 318, 398, 0, 0, 0
4786, 1, 1636421860344, 1636421861006, 662, 267, 395, 0, 0, 0
4785, 1, 1636421860343, 1636421861006, 663, 266, 397, 1, 0, 1
4787, 1, 1636421860519, 1636421861190, 671, 270, 401, 2, 0, 2
4789, 1, 1636421860567, 1636421861242, 675, 275, 400, 1, 0, 1
4790, 1, 1636421860664, 1636421861330, 666, 266, 400, 0, 0, 0
4791, 1, 1636421860695, 1636421861362, 667, 270, 397, 1, 0, 1
4792, 1, 1636421860831, 1636421861514, 683, 282, 401, 1, 0, 1
4793, 1, 1636421861009, 1636421861674, 665, 270, 395, 2, 0, 2
4794, 1, 1636421861010, 1636421861678, 668, 269, 399, 0, 0, 0
4795, 1, 1636421861192, 1636421861866, 674, 269, 405, 0, 0, 0
4796, 1, 1636421861243, 1636421861910, 667, 267, 400, 0, 0, 0
4685, 2, 1636421851739, 1636421861911, 10172, 0, 10172, 0, 0, 0
4797, 1, 1636421861332, 1636421861998, 666, 266, 400, 0, 0, 0
4798, 1, 1636421861363, 1636421862034, 671, 266, 405, 2, 0, 2
4799, 1, 1636421861515, 1636421862190, 675, 274, 401, 0, 0, 0
4692, 2, 1636421852148, 1636421862323, 10175, 0, 10175, 0, 0, 0
4800, 1, 1636421861675, 1636421862362, 687, 291, 396, 0, 24, 24
4801, 1, 1636421861679, 1636421862366, 687, 282, 405, 2, 14, 16
4802, 1, 1636421861913, 1636421862590, 677, 281, 396, 2, 10, 12
4803, 1, 1636421861914, 1636421862590, 676, 278, 398, 1, 11, 12
4804, 1, 1636421861999, 1636421862674, 675, 278, 397, 2, 15, 17
4805, 1, 1636421862035, 1636421862702, 667, 269, 398, 0, 0, 0
4806, 1, 1636421862043, 1636421862706, 663, 266, 397, 0, 0, 0
4807, 1, 1636421862192, 1636421862858, 666, 309, 357, 0, 47, 47
4699, 2, 1636421852760, 1636421862935, 10175, 0, 10175, 0, 0, 0
4808, 1, 1636421862363, 1636421863026, 663, 271, 392, 2, 1, 3
4809, 1, 1636421862367, 1636421863034, 667, 271, 396, 0, 1, 1
4810, 1, 1636421862454, 1636421863130, 676, 270, 406, 0, 0, 0
4811, 1, 1636421862592, 1636421863298, 706, 299, 407, 0, 31, 31
4815, 1, 1636421862708, 1636421863382, 674, 283, 391, 3, 15, 18
4814, 1, 1636421862704, 1636421863382, 678, 281, 397, 1, 15, 16
4813, 1, 1636421862675, 1636421863382, 707, 311, 396, 0, 43, 43
4816, 1, 1636421862859, 1636421863562, 703, 306, 397, 1, 0, 1
4818, 1, 1636421863035, 1636421863706, 671, 274, 397, 1, 0, 1
4820, 1, 1636421863132, 1636421863794, 662, 265, 397, 0, 0, 0
4819, 1, 1636421863066, 1636421863830, 764, 367, 397, 0, 0, 0
4710, 2, 1636421853670, 1636421863848, 10178, 1, 10177, 1, 1, 2
4821, 1, 1636421863299, 1636421863966, 667, 266, 401, 0, 0, 0
4822, 1, 1636421863383, 1636421864046, 663, 270, 393, 1, 0, 1
4824, 1, 1636421863383, 1636421864050, 667, 270, 397, 3, 0, 3
4823, 1, 1636421863383, 1636421864054, 671, 268, 403, 0, 0, 0
4825, 1, 1636421863563, 1636421864234, 671, 275, 396, 0, 0, 0
4827, 1, 1636421863799, 1636421864470, 671, 274, 397, 0, 0, 0
4828, 1, 1636421863850, 1636421864526, 676, 266, 410, 0, 0, 0
4719, 2, 1636421854367, 1636421864543, 10176, 1, 10175, 0, 0, 0
4829, 1, 1636421863967, 1636421864634, 667, 266, 401, 0, 0, 0
4830, 1, 1636421863982, 1636421864650, 668, 266, 402, 0, 0, 0
4831, 1, 1636421864050, 1636421864710, 660, 266, 394, 0, 0, 0
4833, 1, 1636421864056, 1636421864722, 666, 267, 399, 0, 0, 0
4834, 1, 1636421864236, 1636421864902, 666, 268, 398, 0, 1, 1
4835, 1, 1636421864471, 1636421865142, 671, 271, 400, 0, 2, 2
4836, 1, 1636421864544, 1636421865214, 670, 274, 396, 1, 0, 1
4729, 2, 1636421855122, 1636421865299, 10177, 0, 10177, 0, 0, 0
4837, 1, 1636421864635, 1636421865306, 671, 274, 397, 1, 0, 1
4838, 1, 1636421864652, 1636421865318, 666, 266, 400, 0, 0, 0
4839, 1, 1636421864678, 1636421865350, 672, 267, 405, 0, 0, 0
4842, 1, 1636421864903, 1636421865574, 671, 274, 397, 1, 0, 1
4841, 1, 1636421864724, 1636421865586, 862, 462, 400, 0, 1, 1
4731, 2, 1636421855430, 1636421865603, 10173, 1, 10172, 0, 1, 1
4840, 1, 1636421864716, 1636421865654, 938, 547, 391, 1, 35, 36
4844, 1, 1636421865216, 1636421865886, 670, 270, 400, 0, 1, 1
4843, 1, 1636421865144, 1636421865962, 818, 392, 426, 0, 35, 35
4845, 1, 1636421865307, 1636421865982, 675, 275, 400, 1, 0, 1
4846, 1, 1636421865320, 1636421865986, 666, 272, 394, 0, 1, 1
4848, 1, 1636421865430, 1636421866234, 804, 364, 440, 0, 0, 0
4847, 1, 1636421865352, 1636421866254, 902, 503, 399, 0, 0, 0
4739, 2, 1636421856120, 1636421866295, 10175, 0, 10175, 0, 0, 0
4851, 1, 1636421865655, 1636421866326, 671, 271, 400, 0, 0, 0
4852, 1, 1636421865738, 1636421866502, 764, 370, 394, 1, 0, 1
4850, 1, 1636421865605, 1636421866566, 961, 561, 400, 2, 34, 36
4856, 1, 1636421865987, 1636421866650, 663, 266, 397, 0, 0, 0
4854, 1, 1636421865964, 1636421866654, 690, 289, 401, 1, 18, 19
4853, 1, 1636421865888, 1636421866774, 886, 490, 396, 1, 0, 1
4857, 1, 1636421866236, 1636421866910, 674, 274, 400, 1, 0, 1
4858, 1, 1636421866297, 1636421866962, 665, 266, 399, 0, 0, 0
4859, 1, 1636421866328, 1636421866986, 658, 268, 390, 1, 0, 1
4860, 1, 1636421866426, 1636421867090, 664, 267, 397, 1, 0, 1
4861, 1, 1636421866504, 1636421867178, 674, 281, 393, 0, 0, 0
4864, 1, 1636421866655, 1636421867330, 675, 274, 401, 0, 0, 0
4863, 1, 1636421866653, 1636421867374, 721, 322, 399, 1, 0, 1
4865, 1, 1636421866776, 1636421867446, 670, 275, 395, 1, 1, 2
4866, 1, 1636421866912, 1636421867586, 674, 270, 404, 2, 0, 2
4867, 1, 1636421866964, 1636421867646, 682, 270, 412, 0, 0, 0
4868, 1, 1636421866994, 1636421867662, 668, 270, 398, 0, 0, 0
4753, 2, 1636421857542, 1636421867715, 10173, 1, 10172, 2, 0, 2
4869, 1, 1636421867092, 1636421867762, 670, 267, 403, 0, 0, 0
4870, 1, 1636421867180, 1636421867854, 674, 274, 400, 0, 0, 0
4871, 1, 1636421867331, 1636421868002, 671, 269, 402, 0, 0, 0
4872, 1, 1636421867375, 1636421868074, 699, 299, 400, 1, 26, 27
4874, 1, 1636421867588, 1636421868294, 706, 268, 438, 0, 0, 0
4760, 2, 1636421858116, 1636421868295, 10179, 0, 10179, 0, 0, 0
4875, 1, 1636421867647, 1636421868310, 663, 265, 398, 0, 0, 0
4876, 1, 1636421867664, 1636421868326, 662, 270, 392, 0, 0, 0
4877, 1, 1636421867763, 1636421868438, 675, 269, 406, 0, 0, 0
4879, 1, 1636421867856, 1636421868566, 710, 314, 396, 0, 0, 0
4878, 1, 1636421867846, 1636421868590, 744, 345, 399, 0, 1, 1
4765, 2, 1636421858480, 1636421868659, 10179, 0, 10179, 0, 0, 0
4880, 1, 1636421868004, 1636421868670, 666, 261, 405, 0, 0, 0
4882, 1, 1636421868296, 1636421868958, 662, 266, 396, 0, 0, 0
4883, 1, 1636421868313, 1636421869014, 701, 298, 403, 1, 26, 27
4886, 1, 1636421868440, 1636421869106, 666, 271, 395, 1, 3, 4
4885, 1, 1636421868426, 1636421869238, 812, 415, 397, 0, 0, 0
4888, 1, 1636421868592, 1636421869266, 674, 269, 405, 0, 0, 0
4891, 1, 1636421868963, 1636421869634, 671, 270, 401, 1, 0, 1
4894, 1, 1636421869240, 1636421869902, 662, 266, 396, 0, 0, 0
4895, 1, 1636421869267, 1636421869926, 659, 266, 393, 1, 0, 1
4784, 2, 1636421860192, 1636421870367, 10175, 0, 10175, 0, 0, 0
4897, 1, 1636421869907, 1636421870574, 667, 270, 397, 1, 0, 1
4898, 1, 1636421869933, 1636421870634, 701, 305, 396, 1, 35, 36
4788, 2, 1636421860527, 1636421870704, 10177, 0, 10177, 0, 0, 0
4900, 1, 1636421870577, 1636421871250, 673, 272, 401, 0, 3, 3
4812, 2, 1636421862593, 1636421872771, 10178, 1, 10177, 0, 0, 0
4817, 2, 1636421863029, 1636421873207, 10178, 0, 10178, 0, 0, 0
4826, 2, 1636421863707, 1636421873896, 10189, 0, 10189, 0, 0, 0
4832, 2, 1636421864051, 1636421874228, 10177, 0, 10177, 0, 0, 0
4849, 2, 1636421865605, 1636421875779, 10174, 1, 10173, 0, 0, 0
4855, 2, 1636421865983, 1636421876160, 10177, 0, 10177, 0, 0, 0
4862, 2, 1636421866567, 1636421876744, 10177, 0, 10177, 0, 0, 0
4873, 2, 1636421867448, 1636421877623, 10175, 0, 10175, 1, 0, 1
4881, 2, 1636421868076, 1636421878251, 10175, 1, 10174, 0, 0, 0
4911, 1, 1636421877755, 1636421878426, 671, 271, 400, 0, 1, 1
4884, 2, 1636421868330, 1636421878508, 10178, 0, 10178, 0, 0, 0
4887, 2, 1636421868568, 1636421878748, 10180, 0, 10180, 0, 0, 0
4889, 2, 1636421868671, 1636421878847, 10176, 0, 10176, 0, 0, 0
4890, 2, 1636421868790, 1636421878968, 10178, 0, 10178, 0, 0, 0
4912, 1, 1636421878382, 1636421879110, 728, 296, 432, 0, 27, 27
4913, 1, 1636421878428, 1636421879110, 682, 287, 395, 0, 15, 15
4892, 2, 1636421869016, 1636421879191, 10175, 0, 10175, 0, 0, 0
4893, 2, 1636421869108, 1636421879283, 10175, 0, 10175, 0, 0, 0
4896, 2, 1636421869636, 1636421879812, 10176, 1, 10175, 1, 1, 2
4919, 1, 1636421879192, 1636421879822, 630, 270, 360, 3, 1, 4
4917, 1, 1636421879112, 1636421879822, 710, 270, 440, 3, 0, 3
4916, 1, 1636421879112, 1636421879822, 710, 270, 440, 1, 0, 1
4918, 1, 1636421879146, 1636421879822, 676, 270, 406, 1, 1, 2
4920, 1, 1636421879326, 1636421879990, 664, 267, 397, 2, 0, 2
4921, 1, 1636421879415, 1636421880094, 679, 274, 405, 1, 0, 1
4922, 1, 1636421879824, 1636421880486, 662, 266, 396, 0, 0, 0
4924, 1, 1636421879825, 1636421880490, 665, 266, 399, 0, 0, 0
4925, 1, 1636421879825, 1636421880490, 665, 268, 397, 2, 1, 3
4927, 1, 1636421879992, 1636421880662, 670, 270, 400, 0, 1, 1
4899, 2, 1636421870498, 1636421880671, 10173, 1, 10172, 0, 0, 0
4926, 1, 1636421879942, 1636421880762, 820, 421, 399, 0, 0, 0
4901, 2, 1636421870636, 1636421880812, 10176, 1, 10175, 0, 0, 0
4902, 2, 1636421870834, 1636421881011, 10177, 0, 10177, 0, 0, 0
4930, 1, 1636421880492, 1636421881170, 678, 280, 398, 0, 11, 11
4929, 1, 1636421880490, 1636421881170, 680, 282, 398, 1, 11, 12
4931, 1, 1636421880492, 1636421881170, 678, 283, 395, 2, 11, 13
4903, 2, 1636421871252, 1636421881427, 10175, 1, 10174, 1, 0, 1
4933, 1, 1636421880764, 1636421881458, 694, 297, 397, 0, 29, 29
4932, 1, 1636421880673, 1636421881458, 785, 379, 406, 2, 17, 19
4934, 1, 1636421880813, 1636421881478, 665, 269, 396, 1, 0, 1
4935, 1, 1636421880943, 1636421881606, 663, 270, 393, 0, 0, 0
4936, 1, 1636421881142, 1636421881810, 668, 270, 398, 0, 0, 0
4937, 1, 1636421881171, 1636421881874, 703, 301, 402, 1, 30, 31
4938, 1, 1636421881172, 1636421881874, 702, 303, 399, 2, 34, 36
4941, 1, 1636421881460, 1636421882130, 670, 275, 395, 0, 0, 0
4942, 1, 1636421881479, 1636421882146, 667, 270, 397, 0, 1, 1
4940, 1, 1636421881459, 1636421882154, 695, 291, 404, 1, 1, 2
4943, 1, 1636421881562, 1636421882222, 660, 266, 394, 0, 0, 0
4945, 1, 1636421881812, 1636421882482, 670, 268, 402, 0, 0, 0
4946, 1, 1636421881876, 1636421882542, 666, 271, 395, 1, 1, 2
4947, 1, 1636421881876, 1636421882550, 674, 271, 403, 2, 1, 3
4948, 1, 1636421882132, 1636421882798, 666, 261, 405, 1, 0, 1
4949, 1, 1636421882148, 1636421882810, 662, 266, 396, 0, 0, 0
4950, 1, 1636421882156, 1636421882822, 666, 266, 400, 0, 0, 0
4904, 2, 1636421872902, 1636421883080, 10178, 1, 10177, 0, 1, 1
4952, 1, 1636421882484, 1636421883150, 666, 266, 400, 0, 0, 0
4953, 1, 1636421882543, 1636421883210, 667, 270, 397, 0, 0, 0
4954, 1, 1636421882551, 1636421883218, 667, 270, 397, 0, 0, 0
4955, 1, 1636421882800, 1636421883470, 670, 269, 401, 0, 0, 0
4905, 2, 1636421873338, 1636421883511, 10173, 0, 10173, 0, 0, 0
4957, 1, 1636421882824, 1636421883526, 702, 307, 395, 0, 38, 38
4960, 1, 1636421883212, 1636421883878, 666, 271, 395, 1, 1, 2
4959, 1, 1636421883210, 1636421883882, 672, 271, 401, 2, 1, 3
4961, 1, 1636421883220, 1636421883886, 666, 263, 403, 0, 1, 1
4962, 1, 1636421883513, 1636421884178, 665, 269, 396, 0, 0, 0
4963, 1, 1636421883527, 1636421884194, 667, 269, 398, 1, 0, 1
4906, 2, 1636421874026, 1636421884200, 10174, 1, 10173, 0, 0, 0
4964, 1, 1636421883638, 1636421884310, 672, 270, 402, 0, 0, 0
4907, 2, 1636421874358, 1636421884536, 10178, 1, 10177, 0, 1, 1
4965, 1, 1636421883880, 1636421884558, 678, 282, 396, 1, 7, 8
4966, 1, 1636421883884, 1636421884558, 674, 277, 397, 1, 6, 7
4967, 1, 1636421883887, 1636421884562, 675, 272, 403, 0, 6, 6
4969, 1, 1636421884202, 1636421884890, 688, 290, 398, 1, 23, 24
4968, 1, 1636421884201, 1636421884894, 693, 294, 399, 1, 23, 24
4971, 1, 1636421884330, 1636421885002, 672, 270, 402, 0, 0, 0
4970, 1, 1636421884311, 1636421885154, 843, 451, 392, 1, 0, 1
4973, 1, 1636421884560, 1636421885226, 666, 271, 395, 1, 0, 1
4974, 1, 1636421884564, 1636421885226, 662, 266, 396, 0, 0, 0
4972, 1, 1636421884559, 1636421885226, 667, 269, 398, 1, 0, 1
4975, 1, 1636421884666, 1636421885330, 664, 263, 401, 0, 0, 0
4976, 1, 1636421884891, 1636421885562, 671, 270, 401, 2, 1, 3
4977, 1, 1636421884895, 1636421885562, 667, 270, 397, 1, 1, 2
4978, 1, 1636421885004, 1636421885826, 822, 426, 396, 0, 0, 0
4979, 1, 1636421885155, 1636421885826, 671, 278, 393, 0, 0, 0
4982, 1, 1636421885230, 1636421885898, 668, 268, 400, 0, 0, 0
4908, 2, 1636421875910, 1636421886087, 10177, 0, 10177, 1, 0, 1
4983, 1, 1636421885331, 1636421886098, 767, 370, 397, 0, 1, 1
4984, 1, 1636421885563, 1636421886226, 663, 266, 397, 0, 0, 0
4985, 1, 1636421885563, 1636421886226, 663, 266, 397, 2, 0, 2
4909, 2, 1636421876290, 1636421886467, 10177, 1, 10176, 0, 0, 0
4986, 1, 1636421885828, 1636421886538, 710, 310, 400, 1, 42, 43
4989, 1, 1636421886100, 1636421886822, 722, 326, 396, 2, 22, 24
4992, 1, 1636421886230, 1636421886914, 684, 278, 406, 3, 10, 13
4991, 1, 1636421886230, 1636421886914, 684, 276, 408, 0, 7, 7
4990, 1, 1636421886218, 1636421886922, 704, 301, 403, 1, 30, 31
4910, 2, 1636421876875, 1636421887052, 10177, 0, 10177, 0, 0, 0
4994, 1, 1636421886598, 1636421887270, 672, 271, 401, 0, 2, 2
4998, 1, 1636421886924, 1636421887590, 666, 270, 396, 2, 0, 2
4997, 1, 1636421886916, 1636421887590, 674, 272, 402, 1, 0, 1
4999, 1, 1636421887182, 1636421887846, 664, 271, 393, 1, 0, 1
5000, 1, 1636421887271, 1636421887934, 663, 267, 396, 0, 1, 1
5001, 1, 1636421887591, 1636421888266, 675, 275, 400, 1, 1, 2
5003, 1, 1636421887847, 1636421888514, 667, 271, 396, 2, 0, 2
5004, 1, 1636421887937, 1636421888602, 665, 271, 394, 0, 0, 0
4914, 2, 1636421878638, 1636421888836, 10198, 0, 10198, 0, 0, 0
4915, 2, 1636421878978, 1636421889156, 10178, 1, 10177, 0, 1, 1
5006, 1, 1636421888516, 1636421889198, 682, 283, 399, 0, 12, 12
5008, 1, 1636421888970, 1636421889630, 660, 268, 392, 1, 1, 2
5010, 1, 1636421889287, 1636421889954, 667, 268, 399, 0, 0, 0
4923, 2, 1636421879825, 1636421889999, 10174, 1, 10173, 0, 1, 1
4928, 2, 1636421880096, 1636421890271, 10175, 0, 10175, 0, 0, 0
5011, 1, 1636421889632, 1636421890294, 662, 271, 391, 1, 1, 2
5012, 1, 1636421890000, 1636421890630, 630, 274, 356, 0, 6, 6
5013, 1, 1636421890134, 1636421890902, 768, 364, 404, 0, 0, 0
5014, 1, 1636421890298, 1636421890962, 664, 270, 394, 0, 1, 1
5015, 1, 1636421890402, 1636421891178, 776, 373, 403, 1, 0, 1
5016, 1, 1636421890632, 1636421891302, 670, 271, 399, 0, 2, 2
4939, 2, 1636421881172, 1636421891352, 10180, 1, 10179, 1, 0, 1
5017, 1, 1636421890904, 1636421891618, 714, 272, 442, 0, 0, 0
4944, 2, 1636421881608, 1636421891788, 10180, 1, 10179, 1, 0, 1
5019, 1, 1636421891180, 1636421891886, 706, 268, 438, 1, 0, 1
5021, 1, 1636421891482, 1636421892150, 668, 270, 398, 0, 1, 1
5022, 1, 1636421891620, 1636421892326, 706, 268, 438, 2, 0, 2
4951, 2, 1636421882224, 1636421892403, 10179, 1, 10178, 0, 0, 0
5024, 1, 1636421891918, 1636421892582, 664, 270, 394, 1, 1, 2
5023, 1, 1636421891887, 1636421892594, 707, 307, 400, 1, 1, 2
4956, 2, 1636421882815, 1636421892987, 10172, 0, 10172, 0, 0, 0
5026, 1, 1636421892327, 1636421892990, 663, 271, 392, 1, 1, 2
5027, 1, 1636421892534, 1636421893198, 664, 269, 395, 2, 0, 2
5028, 1, 1636421892584, 1636421893254, 670, 272, 398, 1, 3, 4
5029, 1, 1636421892596, 1636421893262, 666, 268, 398, 0, 0, 0
4958, 2, 1636421883152, 1636421893328, 10176, 0, 10176, 0, 0, 0
5030, 1, 1636421892994, 1636421893686, 692, 299, 393, 0, 26, 26
5031, 1, 1636421893118, 1636421893786, 668, 275, 393, 0, 1, 1
5032, 1, 1636421893200, 1636421893870, 670, 275, 395, 0, 1, 1
5034, 1, 1636421893263, 1636421893966, 703, 307, 396, 1, 0, 1
5035, 1, 1636421893458, 1636421894126, 668, 270, 398, 0, 0, 0
5033, 1, 1636421893256, 1636421894238, 982, 582, 400, 0, 0, 0
5036, 1, 1636421893688, 1636421894358, 670, 270, 400, 0, 0, 0
5038, 1, 1636421893872, 1636421894538, 666, 269, 397, 0, 0, 0
5039, 1, 1636421893968, 1636421894630, 662, 265, 397, 0, 0, 0
5041, 1, 1636421894240, 1636421894910, 670, 270, 400, 0, 0, 0
5042, 1, 1636421894360, 1636421895026, 666, 271, 395, 0, 2, 2
5043, 1, 1636421894540, 1636421895206, 666, 265, 401, 0, 0, 0
5044, 1, 1636421894635, 1636421895302, 667, 269, 398, 0, 0, 0
4981, 2, 1636421885228, 1636421895408, 10180, 1, 10179, 1, 0, 1
4980, 2, 1636421885228, 1636421895455, 10227, 2, 10225, 3, 0, 3
5045, 1, 1636421894912, 1636421895590, 678, 271, 407, 0, 0, 0
5046, 1, 1636421895028, 1636421895722, 694, 300, 394, 0, 30, 30
5047, 1, 1636421895208, 1636421895906, 698, 298, 400, 1, 30, 31
5048, 1, 1636421895304, 1636421895994, 690, 314, 376, 49, 0, 49
4987, 2, 1636421885828, 1636421896003, 10175, 1, 10174, 2, 0, 2
4988, 2, 1636421885899, 1636421896075, 10176, 0, 10176, 0, 0, 0
5049, 1, 1636421895542, 1636421896210, 668, 269, 399, 0, 1, 1
5050, 1, 1636421895546, 1636421896214, 668, 266, 402, 1, 1, 2
5051, 1, 1636421895592, 1636421896270, 678, 279, 399, 1, 11, 12
5052, 1, 1636421895724, 1636421896430, 706, 311, 395, 3, 43, 46
5053, 1, 1636421895907, 1636421896610, 703, 268, 435, 1, 0, 1
5054, 1, 1636421896005, 1636421896702, 697, 302, 395, 1, 1, 2
4993, 2, 1636421886540, 1636421896715, 10175, 0, 10175, 0, 0, 0
5055, 1, 1636421896162, 1636421896826, 664, 272, 392, 0, 2, 2
5056, 1, 1636421896206, 1636421896874, 668, 269, 399, 1, 0, 1
5059, 1, 1636421896272, 1636421896982, 710, 311, 399, 0, 43, 43
4995, 2, 1636421886824, 1636421896999, 10175, 1, 10174, 0, 0, 0
4996, 2, 1636421886915, 1636421897095, 10180, 1, 10179, 2, 0, 2
5060, 1, 1636421896432, 1636421897106, 674, 274, 400, 0, 1, 1
5061, 1, 1636421896612, 1636421897298, 686, 270, 416, 2, 1, 3
5062, 1, 1636421896718, 1636421897390, 672, 270, 402, 1, 0, 1
5064, 1, 1636421896846, 1636421897542, 696, 277, 419, 1, 9, 10
5066, 1, 1636421897000, 1636421897678, 678, 270, 408, 0, 0, 0
5002, 2, 1636421887592, 1636421897767, 10175, 0, 10175, 1, 0, 1
5067, 1, 1636421897107, 1636421897778, 671, 278, 393, 1, 0, 1
5068, 1, 1636421897130, 1636421897810, 680, 282, 398, 0, 0, 0
5069, 1, 1636421897234, 1636421897906, 672, 271, 401, 0, 0, 0
5070, 1, 1636421897300, 1636421897966, 666, 270, 396, 0, 0, 0
5071, 1, 1636421897392, 1636421898062, 670, 267, 403, 1, 0, 1
5073, 1, 1636421897680, 1636421898346, 666, 270, 396, 0, 0, 0
5005, 2, 1636421888268, 1636421898443, 10175, 0, 10175, 0, 0, 0
5076, 1, 1636421897898, 1636421898566, 668, 271, 397, 0, 0, 0
5078, 1, 1636421897968, 1636421898642, 674, 270, 404, 1, 1, 2
5007, 2, 1636421888604, 1636421898779, 10175, 1, 10174, 1, 0, 1
5080, 1, 1636421898348, 1636421899046, 698, 290, 408, 0, 22, 22
5082, 1, 1636421898574, 1636421899246, 672, 270, 402, 1, 0, 1
5083, 1, 1636421898644, 1636421899318, 674, 273, 401, 1, 0, 1
5009, 2, 1636421889199, 1636421899375, 10176, 1, 10175, 1, 0, 1
5084, 1, 1636421898910, 1636421899582, 672, 271, 401, 1, 0, 1
5085, 1, 1636421899048, 1636421899734, 686, 286, 400, 0, 18, 18
5087, 1, 1636421899320, 1636421900006, 686, 290, 396, 0, 0, 0
5088, 1, 1636421899506, 1636421900174, 668, 271, 397, 0, 0, 0
5018, 2, 1636421890964, 1636421901136, 10172, 0, 10172, 0, 0, 0
5020, 1, 1636421891304, 1636421901630, 10326, 9921, 405, 0, 1, 1
5093, 1, 1636421901266, 1636421901930, 664, 270, 394, 1, 1, 2
5094, 1, 1636421901632, 1636421902302, 670, 270, 400, 0, 0, 0
5025, 2, 1636421892151, 1636421902328, 10177, 1, 10176, 0, 0, 0
5097, 1, 1636421902458, 1636421903134, 676, 271, 405, 0, 2, 2
5098, 1, 1636421903136, 1636421903802, 666, 272, 394, 2, 2, 4
5037, 2, 1636421893788, 1636421903968, 10180, 0, 10180, 1, 0, 1
5040, 2, 1636421894129, 1636421904304, 10175, 0, 10175, 0, 1, 1
5099, 1, 1636421903804, 1636421904502, 698, 267, 431, 1, 0, 1
5100, 1, 1636421904098, 1636421904770, 672, 269, 403, 0, 0, 0
5101, 1, 1636421904434, 1636421905106, 672, 273, 399, 1, 0, 1
5102, 1, 1636421904503, 1636421905170, 667, 271, 396, 1, 1, 2
5103, 1, 1636421904772, 1636421905442, 670, 270, 400, 1, 2, 3
5104, 1, 1636421905108, 1636421905774, 666, 269, 397, 0, 1, 1
5105, 1, 1636421905172, 1636421905842, 670, 270, 400, 0, 0, 0
5106, 1, 1636421905444, 1636421906110, 666, 270, 396, 0, 0, 0
5057, 2, 1636421896212, 1636421906387, 10175, 0, 10175, 0, 0, 0
5058, 2, 1636421896215, 1636421906431, 10216, 0, 10216, 1, 0, 1
5107, 1, 1636421905776, 1636421906446, 670, 271, 399, 0, 1, 1
5108, 1, 1636421905844, 1636421906510, 666, 269, 397, 0, 0, 0
5109, 1, 1636421906112, 1636421906786, 674, 278, 396, 0, 10, 10
5063, 2, 1636421896828, 1636421906999, 10171, 1, 10170, 1, 0, 1
5065, 2, 1636421896876, 1636421907087, 10211, 0, 10211, 0, 0, 0
5110, 1, 1636421906448, 1636421907118, 670, 271, 399, 0, 0, 0
5111, 1, 1636421906511, 1636421907178, 667, 271, 396, 0, 0, 0
5112, 1, 1636421906518, 1636421907190, 672, 271, 401, 2, 0, 2
5114, 1, 1636421906788, 1636421907462, 674, 274, 400, 0, 1, 1
5072, 2, 1636421897544, 1636421907719, 10175, 0, 10175, 0, 0, 0
5115, 1, 1636421907120, 1636421907794, 674, 277, 397, 0, 0, 0
5116, 1, 1636421907174, 1636421907838, 664, 267, 397, 1, 0, 1
5118, 1, 1636421907191, 1636421907862, 671, 270, 401, 1, 0, 1
5074, 2, 1636421897779, 1636421907951, 10172, 0, 10172, 0, 0, 0
5075, 2, 1636421897811, 1636421907995, 10184, 1, 10183, 0, 0, 0
5077, 2, 1636421897908, 1636421908087, 10179, 0, 10179, 0, 0, 0
5117, 1, 1636421907180, 1636421908102, 922, 526, 396, 1, 0, 1
5120, 1, 1636421907464, 1636421908166, 702, 305, 397, 0, 37, 37
5079, 2, 1636421898065, 1636421908239, 10174, 1, 10173, 0, 1, 1
5123, 1, 1636421907850, 1636421908534, 684, 272, 412, 2, 1, 3
5121, 1, 1636421907795, 1636421908534, 739, 273, 466, 0, 6, 6
5122, 1, 1636421907839, 1636421908534, 695, 272, 423, 1, 1, 2
5124, 1, 1636421907864, 1636421908546, 682, 316, 366, 44, 6, 50
5081, 2, 1636421898568, 1636421908743, 10175, 1, 10174, 0, 1, 1
5126, 1, 1636421908104, 1636421908778, 674, 269, 405, 1, 0, 1
5125, 1, 1636421908087, 1636421908778, 691, 268, 423, 1, 0, 1
5127, 1, 1636421908118, 1636421908826, 708, 274, 434, 0, 0, 0
5128, 1, 1636421908169, 1636421908830, 661, 262, 399, 0, 0, 0
5132, 1, 1636421908536, 1636421909198, 662, 266, 396, 1, 0, 1
5134, 1, 1636421908547, 1636421909210, 663, 263, 400, 0, 1, 1
5133, 1, 1636421908536, 1636421909210, 674, 268, 406, 1, 0, 1
5131, 1, 1636421908535, 1636421909214, 679, 270, 409, 2, 1, 3
5086, 2, 1636421899248, 1636421909423, 10175, 1, 10174, 0, 1, 1
5135, 1, 1636421908780, 1636421909438, 658, 262, 396, 1, 0, 1
5137, 1, 1636421908828, 1636421909494, 666, 270, 396, 0, 0, 0
5138, 1, 1636421908835, 1636421909522, 687, 285, 402, 1, 0, 1
5089, 2, 1636421899584, 1636421909759, 10175, 0, 10175, 0, 0, 0
5140, 1, 1636421909203, 1636421909870, 667, 275, 392, 0, 7, 7
5143, 1, 1636421909215, 1636421909878, 663, 266, 397, 1, 0, 1
5141, 1, 1636421909212, 1636421909878, 666, 269, 397, 0, 0, 0
5090, 2, 1636421899736, 1636421909907, 10171, 1, 10170, 0, 0, 0
5144, 1, 1636421909446, 1636421910114, 668, 271, 397, 0, 7, 7
5142, 1, 1636421909214, 1636421910170, 956, 562, 394, 0, 30, 30
5091, 2, 1636421900008, 1636421910183, 10175, 1, 10174, 0, 0, 0
5146, 1, 1636421909524, 1636421910202, 678, 282, 396, 0, 18, 18
5147, 1, 1636421909554, 1636421910262, 708, 263, 445, 0, 2, 2
5092, 2, 1636421900176, 1636421910351, 10175, 1, 10174, 0, 1, 1
5145, 1, 1636421909495, 1636421910450, 955, 551, 404, 0, 7, 7
5149, 1, 1636421909908, 1636421910618, 710, 309, 401, 1, 39, 40
5148, 1, 1636421909907, 1636421910618, 711, 269, 442, 1, 1, 2
5151, 1, 1636421909909, 1636421910618, 709, 310, 399, 2, 40, 42
5150, 1, 1636421909909, 1636421910714, 805, 407, 398, 2, 0, 2
5155, 1, 1636421910204, 1636421910890, 686, 273, 413, 4, 0, 4
5154, 1, 1636421910185, 1636421910890, 705, 270, 435, 0, 0, 0
5156, 1, 1636421910264, 1636421910934, 670, 273, 397, 3, 1, 4
5158, 1, 1636421910451, 1636421911122, 671, 270, 401, 0, 0, 0
5159, 1, 1636421910482, 1636421911142, 660, 265, 395, 0, 0, 0
5162, 1, 1636421910620, 1636421911278, 658, 263, 395, 1, 1, 2
5160, 1, 1636421910619, 1636421911282, 663, 263, 400, 0, 0, 0
5161, 1, 1636421910620, 1636421911282, 662, 263, 399, 1, 0, 1
5163, 1, 1636421910715, 1636421911378, 663, 267, 396, 0, 0, 0
5164, 1, 1636421910891, 1636421911558, 667, 265, 402, 1, 0, 1
5165, 1, 1636421910891, 1636421911558, 667, 265, 402, 0, 0, 0
5166, 1, 1636421910935, 1636421911610, 675, 277, 398, 0, 1, 1
5168, 1, 1636421911144, 1636421911810, 666, 270, 396, 0, 0, 0
5167, 1, 1636421911124, 1636421911878, 754, 354, 400, 0, 0, 0
5169, 1, 1636421911285, 1636421911950, 665, 270, 395, 0, 0, 0
5170, 1, 1636421911286, 1636421911962, 676, 274, 402, 2, 0, 2
5172, 1, 1636421911381, 1636421912046, 665, 267, 398, 0, 1, 1
5095, 2, 1636421901932, 1636421912103, 10171, 0, 10171, 0, 0, 0
5171, 1, 1636421911286, 1636421912142, 856, 460, 396, 2, 0, 2
5173, 1, 1636421911560, 1636421912238, 678, 275, 403, 1, 0, 1
5175, 1, 1636421911611, 1636421912286, 675, 274, 401, 0, 0, 0
5176, 1, 1636421911811, 1636421912474, 663, 266, 397, 0, 0, 0
5096, 2, 1636421902330, 1636421912507, 10177, 1, 10176, 0, 1, 1
5177, 1, 1636421911879, 1636421912554, 675, 274, 401, 1, 6, 7
5178, 1, 1636421911952, 1636421912641, 689, 269, 420, 1, 0, 1
5180, 1, 1636421912048, 1636421912714, 666, 270, 396, 1, 0, 1
5181, 1, 1636421912144, 1636421912814, 670, 270, 400, 0, 0, 0
5183, 1, 1636421912240, 1636421912902, 662, 267, 395, 0, 1, 1
5184, 1, 1636421912287, 1636421912954, 667, 266, 401, 0, 2, 2
5182, 1, 1636421912234, 1636421912978, 744, 350, 394, 0, 0, 0
5185, 1, 1636421912509, 1636421913182, 673, 278, 395, 0, 1, 1
5186, 1, 1636421912555, 1636421913222, 667, 266, 401, 0, 0, 0
5187, 1, 1636421912638, 1636421913310, 672, 270, 402, 1, 0, 1
5189, 1, 1636421912715, 1636421913386, 671, 275, 396, 0, 0, 0
5190, 1, 1636421912815, 1636421913486, 671, 275, 396, 1, 1, 2
5191, 1, 1636421912906, 1636421913578, 672, 272, 400, 0, 0, 0
5188, 1, 1636421912642, 1636421913582, 940, 542, 398, 2, 0, 2
5192, 1, 1636421912955, 1636421913626, 671, 271, 400, 0, 1, 1
5193, 1, 1636421912980, 1636421913642, 662, 270, 392, 1, 0, 1
5194, 1, 1636421913184, 1636421913842, 658, 262, 396, 0, 0, 0
5195, 1, 1636421913224, 1636421913886, 662, 262, 400, 1, 0, 1
5196, 1, 1636421913312, 1636421913982, 670, 273, 397, 1, 0, 1
5197, 1, 1636421913387, 1636421914050, 663, 270, 393, 1, 0, 1
5198, 1, 1636421913488, 1636421914154, 666, 270, 396, 0, 1, 1
5199, 1, 1636421913579, 1636421914250, 671, 267, 404, 2, 1, 3
5200, 1, 1636421913583, 1636421914250, 667, 266, 401, 1, 0, 1
5201, 1, 1636421913627, 1636421914290, 663, 263, 400, 0, 0, 0
5202, 1, 1636421913647, 1636421914314, 667, 270, 397, 0, 0, 0
5203, 1, 1636421913849, 1636421914514, 665, 269, 396, 0, 0, 0
5204, 1, 1636421913891, 1636421914554, 663, 267, 396, 1, 0, 1
5205, 1, 1636421913983, 1636421914658, 675, 270, 405, 0, 0, 0
5206, 1, 1636421914053, 1636421914718, 665, 271, 394, 0, 0, 0
5207, 1, 1636421914155, 1636421914818, 663, 267, 396, 1, 1, 2
5209, 1, 1636421914252, 1636421914910, 658, 264, 394, 2, 1, 3
5210, 1, 1636421914294, 1636421914958, 664, 267, 397, 0, 0, 0
5211, 1, 1636421914316, 1636421914970, 654, 262, 392, 0, 0, 0
5212, 1, 1636421914515, 1636421915174, 659, 262, 397, 0, 0, 0
5213, 1, 1636421914557, 1636421915226, 669, 270, 399, 0, 0, 0
5214, 1, 1636421914660, 1636421915330, 670, 270, 400, 0, 0, 0
5216, 1, 1636421914822, 1636421915486, 664, 271, 393, 0, 1, 1
5217, 1, 1636421914918, 1636421915581, 663, 270, 393, 1, 0, 1
5218, 1, 1636421914959, 1636421915626, 667, 271, 396, 0, 0, 0
5219, 1, 1636421914982, 1636421915650, 668, 269, 399, 0, 0, 0
5220, 1, 1636421915181, 1636421915850, 669, 269, 400, 2, 1, 3
5221, 1, 1636421915227, 1636421915894, 667, 267, 400, 0, 0, 0
5222, 1, 1636421915332, 1636421915998, 666, 270, 396, 0, 0, 0
5223, 1, 1636421915488, 1636421916150, 662, 266, 396, 0, 0, 0
5225, 1, 1636421915628, 1636421916298, 670, 270, 400, 2, 0, 2
5226, 1, 1636421915651, 1636421916310, 659, 266, 393, 0, 0, 0
5227, 1, 1636421915851, 1636421916522, 671, 271, 400, 1, 0, 1
5229, 1, 1636421916000, 1636421916666, 666, 270, 396, 2, 0, 2
5113, 2, 1636421906522, 1636421916703, 10181, 0, 10181, 0, 0, 0
5230, 1, 1636421916155, 1636421916822, 667, 267, 400, 0, 0, 0
5231, 1, 1636421916299, 1636421916970, 671, 272, 399, 0, 3, 3
5232, 1, 1636421916319, 1636421916978, 659, 266, 393, 0, 0, 0
5233, 1, 1636421916523, 1636421917182, 659, 263, 396, 0, 0, 0
5234, 1, 1636421916705, 1636421917374, 669, 273, 396, 0, 0, 0
5119, 2, 1636421907222, 1636421917399, 10177, 0, 10177, 0, 0, 0
5235, 1, 1636421916824, 1636421917490, 666, 269, 397, 0, 0, 0
5236, 1, 1636421916834, 1636421917502, 668, 266, 402, 0, 2, 2
5238, 1, 1636421916985, 1636421917782, 797, 398, 399, 0, 0, 0
5239, 1, 1636421917189, 1636421917858, 669, 266, 403, 0, 0, 0
5240, 1, 1636421917401, 1636421918070, 669, 269, 400, 0, 0, 0
5242, 1, 1636421917504, 1636421918166, 662, 266, 396, 0, 0, 0
5243, 1, 1636421917530, 1636421918198, 668, 270, 398, 0, 0, 0
5129, 2, 1636421908240, 1636421918415, 10175, 0, 10175, 0, 0, 0
5244, 1, 1636421917784, 1636421918442, 658, 267, 391, 0, 1, 1
5130, 2, 1636421908370, 1636421918690, 10320, 96, 10224, 0, 0, 0
5246, 1, 1636421918071, 1636421918770, 699, 303, 396, 3, 34, 37
5247, 1, 1636421918170, 1636421918954, 784, 294, 490, 0, 27, 27
5248, 1, 1636421918200, 1636421918954, 754, 359, 395, 1, 89, 90
5136, 2, 1636421908780, 1636421918955, 10175, 1, 10174, 1, 0, 1
5139, 2, 1636421908874, 1636421919051, 10177, 0, 10177, 0, 0, 0
5157, 1, 1636421910353, 1636421919142, 8789, 8393, 396, 0, 5, 5
5250, 1, 1636421918546, 1636421919238, 692, 280, 412, 2, 0, 2
5152, 1, 1636421910043, 1636421919410, 9367, 8960, 407, 0, 0, 0
5251, 1, 1636421918772, 1636421919506, 734, 338, 396, 1, 0, 1
5254, 1, 1636421918956, 1636421919630, 674, 269, 405, 0, 1, 1
5253, 1, 1636421918956, 1636421919630, 674, 271, 403, 1, 1, 2
5257, 1, 1636421919182, 1636421919850, 668, 268, 400, 0, 0, 0
5258, 1, 1636421919240, 1636421919910, 670, 270, 400, 0, 0, 0
5260, 1, 1636421919508, 1636421920178, 670, 275, 395, 3, 1, 4
5153, 2, 1636421910115, 1636421920296, 10181, 1, 10180, 0, 1, 1
5261, 1, 1636421919632, 1636421920302, 670, 269, 401, 1, 0, 1
5262, 1, 1636421919632, 1636421920302, 670, 268, 402, 0, 0, 0
5263, 1, 1636421919851, 1636421920562, 711, 311, 400, 0, 42, 42
5264, 1, 1636421919912, 1636421920578, 666, 269, 397, 0, 0, 0
5267, 1, 1636421920304, 1636421920970, 666, 267, 399, 1, 0, 1
5266, 1, 1636421920303, 1636421920970, 667, 270, 397, 0, 0, 0
5268, 1, 1636421920426, 1636421921094, 668, 271, 397, 1, 1, 2
5269, 1, 1636421920564, 1636421921226, 662, 266, 396, 0, 0, 0
5270, 1, 1636421920580, 1636421921242, 662, 262, 400, 0, 0, 0
5271, 1, 1636421920971, 1636421921638, 667, 269, 398, 2, 0, 2
5272, 1, 1636421920971, 1636421921642, 671, 269, 402, 2, 0, 2
5174, 2, 1636421911560, 1636421921739, 10179, 1, 10178, 0, 0, 0
5274, 1, 1636421921231, 1636421921894, 663, 266, 397, 1, 0, 1
5275, 1, 1636421921247, 1636421921914, 667, 261, 406, 1, 0, 1
5179, 2, 1636421911963, 1636421922147, 10184, 1, 10183, 2, 0, 2
5276, 1, 1636421921640, 1636421922318, 678, 268, 410, 1, 0, 1
5277, 1, 1636421921643, 1636421922322, 679, 273, 406, 2, 0, 2
5278, 1, 1636421921870, 1636421922534, 664, 269, 395, 1, 0, 1
5279, 1, 1636421921896, 1636421922594, 698, 296, 402, 0, 29, 29
5280, 1, 1636421921916, 1636421922594, 678, 278, 400, 1, 9, 10
5281, 1, 1636421922282, 1636421922950, 668, 269, 399, 0, 0, 0
5282, 1, 1636421922320, 1636421922986, 666, 271, 395, 1, 1, 2
5283, 1, 1636421922324, 1636421922990, 666, 270, 396, 0, 0, 0
5286, 1, 1636421922596, 1636421923274, 678, 275, 403, 1, 1, 2
5285, 1, 1636421922595, 1636421923274, 679, 274, 405, 2, 0, 2
5288, 1, 1636421922988, 1636421923654, 666, 270, 396, 1, 0, 1
5289, 1, 1636421922992, 1636421923654, 662, 266, 396, 0, 0, 0
5290, 1, 1636421923276, 1636421923942, 666, 268, 398, 1, 0, 1
5291, 1, 1636421923277, 1636421923950, 673, 273, 400, 1, 0, 1
5293, 1, 1636421923658, 1636421924322, 664, 265, 399, 0, 0, 0
5292, 1, 1636421923655, 1636421924326, 671, 269, 402, 0, 0, 0
5208, 2, 1636421914251, 1636421924427, 10176, 1, 10175, 1, 0, 1
5294, 1, 1636421923944, 1636421924614, 670, 268, 402, 0, 0, 0
5295, 1, 1636421923952, 1636421924626, 674, 277, 397, 0, 0, 0
5215, 2, 1636421914720, 1636421924891, 10171, 0, 10171, 0, 0, 0
5296, 1, 1636421924324, 1636421925006, 682, 271, 411, 1, 1, 2
5297, 1, 1636421924327, 1636421925010, 683, 271, 412, 1, 2, 3
5298, 1, 1636421924558, 1636421925250, 692, 290, 402, 0, 22, 22
5299, 1, 1636421924616, 1636421925286, 670, 271, 399, 1, 0, 1
5300, 1, 1636421924628, 1636421925338, 710, 314, 396, 1, 46, 47
5301, 1, 1636421925008, 1636421925670, 662, 267, 395, 3, 0, 3
5302, 1, 1636421925012, 1636421925674, 662, 262, 400, 1, 0, 1
5303, 1, 1636421925018, 1636421925682, 664, 266, 398, 0, 0, 0
5224, 2, 1636421915583, 1636421925763, 10180, 0, 10180, 0, 0, 0
5305, 1, 1636421925288, 1636421925958, 670, 270, 400, 2, 0, 2
5306, 1, 1636421925340, 1636421926026, 686, 292, 394, 0, 22, 22
5228, 2, 1636421915895, 1636421926072, 10177, 0, 10177, 0, 1, 1
5308, 1, 1636421925678, 1636421926346, 668, 270, 398, 1, 0, 1
5307, 1, 1636421925675, 1636421926346, 671, 269, 402, 1, 0, 1
5310, 1, 1636421925894, 1636421926562, 668, 271, 397, 1, 0, 1
5311, 1, 1636421925960, 1636421926650, 690, 267, 423, 1, 0, 1
5312, 1, 1636421926073, 1636421926698, 625, 270, 355, 0, 0, 0
5313, 1, 1636421926202, 1636421926870, 668, 271, 397, 0, 1, 1
5315, 1, 1636421926347, 1636421927010, 663, 262, 401, 0, 0, 0
5314, 1, 1636421926347, 1636421927010, 663, 267, 396, 2, 0, 2
5237, 2, 1636421916972, 1636421927147, 10175, 0, 10175, 0, 0, 0
5317, 1, 1636421926652, 1636421927314, 662, 265, 397, 0, 0, 0
5318, 1, 1636421926699, 1636421927366, 667, 266, 401, 0, 0, 0
5241, 2, 1636421917492, 1636421927667, 10175, 1, 10174, 0, 0, 0
5320, 1, 1636421927014, 1636421927681, 667, 266, 401, 1, 0, 1
5321, 1, 1636421927014, 1636421927681, 667, 267, 400, 0, 0, 0
5322, 1, 1636421927278, 1636421927946, 668, 269, 399, 0, 1, 1
5323, 1, 1636421927318, 1636421928022, 704, 306, 398, 0, 38, 38
5324, 1, 1636421927368, 1636421928030, 662, 265, 397, 1, 0, 1
5245, 2, 1636421917859, 1636421928035, 10176, 0, 10176, 0, 0, 0
5326, 1, 1636421927683, 1636421928390, 707, 264, 443, 1, 0, 1
5325, 1, 1636421927682, 1636421928394, 712, 306, 406, 1, 39, 40
5327, 1, 1636421927802, 1636421928482, 680, 283, 397, 1, 16, 17
5249, 2, 1636421918450, 1636421928623, 10173, 0, 10173, 0, 0, 0
5330, 1, 1636421928038, 1636421928698, 660, 263, 397, 2, 1, 3
5329, 1, 1636421928038, 1636421928698, 660, 263, 397, 2, 1, 3
5331, 1, 1636421928171, 1636421928838, 667, 266, 401, 1, 0, 1
5252, 2, 1636421918782, 1636421929000, 10218, 1, 10217, 0, 1, 1
5332, 1, 1636421928391, 1636421929070, 679, 281, 398, 0, 14, 14
5333, 1, 1636421928396, 1636421929070, 674, 277, 397, 2, 9, 11
5255, 2, 1636421919086, 1636421929263, 10177, 0, 10177, 0, 0, 0
5256, 2, 1636421919144, 1636421929319, 10175, 0, 10175, 0, 0, 0
5336, 1, 1636421928704, 1636421929370, 666, 271, 395, 3, 0, 3
5335, 1, 1636421928704, 1636421929370, 666, 269, 397, 1, 1, 2
5337, 1, 1636421928754, 1636421929446, 692, 298, 394, 1, 30, 31
5259, 2, 1636421919412, 1636421929587, 10175, 0, 10175, 1, 0, 1
5340, 1, 1636421929072, 1636421929770, 698, 300, 398, 1, 32, 33
5339, 1, 1636421929071, 1636421929770, 699, 299, 400, 0, 32, 32
5342, 1, 1636421929371, 1636421930038, 667, 268, 399, 2, 0, 2
5343, 1, 1636421929372, 1636421930038, 666, 265, 401, 1, 0, 1
5344, 1, 1636421929406, 1636421930078, 672, 269, 403, 1, 1, 2
5265, 2, 1636421920180, 1636421930384, 10204, 1, 10203, 1, 0, 1
5348, 1, 1636421929771, 1636421930438, 667, 271, 396, 1, 0, 1
5349, 1, 1636421929772, 1636421930438, 666, 270, 396, 2, 1, 3
5351, 1, 1636421930040, 1636421930738, 698, 302, 396, 2, 34, 36
5350, 1, 1636421930039, 1636421930742, 703, 302, 401, 2, 34, 36
5352, 1, 1636421930081, 1636421930750, 669, 270, 399, 1, 0, 1
5353, 1, 1636421930439, 1636421931106, 667, 271, 396, 3, 0, 3
5355, 1, 1636421930514, 1636421931182, 668, 269, 399, 0, 1, 1
5273, 2, 1636421921095, 1636421931271, 10176, 1, 10175, 0, 0, 0
5356, 1, 1636421930740, 1636421931406, 666, 268, 398, 1, 0, 1
5357, 1, 1636421930743, 1636421931410, 667, 270, 397, 0, 0, 0
5358, 1, 1636421930752, 1636421931414, 662, 270, 392, 0, 0, 0
5362, 1, 1636421931408, 1636421932074, 666, 270, 396, 1, 0, 1
5363, 1, 1636421931411, 1636421932082, 671, 274, 397, 1, 0, 1
5364, 1, 1636421931418, 1636421932090, 672, 270, 402, 1, 0, 1
5284, 2, 1636421922536, 1636421932712, 10176, 1, 10175, 0, 0, 0
5365, 1, 1636421932076, 1636421932746, 670, 270, 400, 0, 1, 1
5367, 1, 1636421932092, 1636421932758, 666, 269, 397, 0, 0, 0
5287, 2, 1636421922952, 1636421933128, 10176, 0, 10176, 0, 0, 0
5369, 1, 1636421932759, 1636421933422, 663, 270, 393, 1, 1, 2
5372, 1, 1636421933425, 1636421934098, 673, 271, 402, 1, 1, 2
5373, 1, 1636421934100, 1636421934766, 666, 269, 397, 1, 0, 1
5304, 2, 1636421925252, 1636421935427, 10175, 1, 10174, 2, 0, 2
5374, 1, 1636421934768, 1636421935442, 674, 269, 405, 1, 0, 1
5309, 2, 1636421925683, 1636421935855, 10172, 0, 10172, 0, 0, 0
5375, 1, 1636421935443, 1636421936122, 679, 284, 395, 0, 18, 18
5316, 2, 1636421926564, 1636421936740, 10176, 0, 10176, 0, 0, 0
5378, 1, 1636421936124, 1636421936794, 670, 270, 400, 1, 1, 2
5319, 2, 1636421926872, 1636421937047, 10175, 1, 10174, 0, 1, 1
5379, 1, 1636421936796, 1636421937498, 702, 306, 396, 1, 30, 31
5328, 2, 1636421927948, 1636421938128, 10180, 2, 10178, 1, 0, 1
5382, 1, 1636421937500, 1636421938170, 670, 274, 396, 1, 0, 1
5334, 2, 1636421928483, 1636421938671, 10188, 0, 10188, 0, 0, 0
5383, 1, 1636421938171, 1636421938838, 667, 269, 398, 0, 1, 1
5338, 2, 1636421928839, 1636421939047, 10208, 0, 10208, 0, 0, 0
5341, 2, 1636421929130, 1636421939307, 10177, 1, 10176, 0, 1, 1
5386, 1, 1636421938840, 1636421939514, 674, 269, 405, 1, 0, 1
5346, 2, 1636421929448, 1636421939632, 10184, 1, 10183, 1, 1, 2
5345, 2, 1636421929446, 1636421939679, 10233, 0, 10233, 0, 0, 0
5347, 2, 1636421929722, 1636421939895, 10173, 1, 10172, 0, 0, 0
5388, 1, 1636421939438, 1636421940162, 724, 324, 400, 1, 56, 57
5389, 1, 1636421939516, 1636421940254, 738, 350, 388, 49, 34, 83
5354, 2, 1636421930440, 1636421940616, 10176, 0, 10176, 0, 0, 0
5392, 1, 1636421940026, 1636421940694, 668, 270, 398, 1, 0, 1
5393, 1, 1636421940164, 1636421940882, 718, 269, 449, 0, 0, 0
5394, 1, 1636421940255, 1636421940922, 667, 271, 396, 1, 2, 3
5391, 1, 1636421939766, 1636421940970, 1204, 806, 398, 1, 6, 7
5359, 2, 1636421931107, 1636421941316, 10209, 1, 10208, 1, 1, 2
5360, 2, 1636421931184, 1636421941359, 10175, 1, 10174, 0, 1, 1
5395, 1, 1636421940696, 1636421941361, 665, 270, 395, 1, 1, 2
5396, 1, 1636421940746, 1636421941422, 676, 270, 406, 1, 1, 2
5361, 2, 1636421931402, 1636421941579, 10177, 1, 10176, 0, 0, 0
5398, 1, 1636421940923, 1636421941626, 703, 308, 395, 1, 38, 39
5397, 1, 1636421940883, 1636421941626, 743, 344, 399, 1, 77, 78
5399, 1, 1636421940972, 1636421941714, 742, 346, 396, 0, 73, 73
5400, 1, 1636421941363, 1636421942026, 663, 269, 394, 0, 1, 1
5402, 1, 1636421941450, 1636421942162, 712, 266, 446, 0, 1, 1
5366, 2, 1636421932083, 1636421942259, 10176, 0, 10176, 1, 0, 1
5405, 1, 1636421941628, 1636421942294, 666, 268, 398, 0, 0, 0
5404, 1, 1636421941628, 1636421942294, 666, 272, 394, 0, 0, 0
5407, 1, 1636421941715, 1636421942374, 659, 265, 394, 0, 0, 0
5406, 1, 1636421941710, 1636421942374, 664, 267, 397, 1, 0, 1
5408, 1, 1636421942029, 1636421942710, 681, 282, 399, 1, 14, 15
5368, 2, 1636421932747, 1636421942923, 10176, 1, 10175, 1, 0, 1
5411, 1, 1636421942296, 1636421942966, 670, 270, 400, 2, 0, 2
5410, 1, 1636421942296, 1636421942966, 670, 268, 402, 1, 0, 1
5370, 2, 1636421932843, 1636421943015, 10172, 0, 10172, 0, 0, 0
5413, 1, 1636421942381, 1636421943042, 661, 267, 394, 0, 1, 1
5412, 1, 1636421942376, 1636421943042, 666, 270, 396, 0, 0, 0
5414, 1, 1636421942390, 1636421943058, 668, 267, 401, 0, 1, 1
5415, 1, 1636421942711, 1636421943382, 671, 270, 401, 0, 0, 0
5371, 2, 1636421933258, 1636421943439, 10181, 0, 10181, 0, 0, 0
5417, 1, 1636421942968, 1636421943638, 670, 275, 395, 0, 0, 0
5418, 1, 1636421943044, 1636421943710, 666, 271, 395, 3, 0, 3
5419, 1, 1636421943047, 1636421943714, 667, 269, 398, 2, 0, 2
5420, 1, 1636421943054, 1636421943730, 676, 278, 398, 1, 1, 2
5422, 1, 1636421943146, 1636421943814, 668, 269, 399, 1, 0, 1
5423, 1, 1636421943383, 1636421944046, 663, 269, 394, 0, 0, 0
5424, 1, 1636421943570, 1636421944238, 668, 269, 399, 1, 0, 1
5425, 1, 1636421943640, 1636421944314, 674, 275, 399, 0, 1, 1
5426, 1, 1636421943712, 1636421944382, 670, 271, 399, 2, 0, 2
5427, 1, 1636421943715, 1636421944382, 667, 269, 398, 1, 0, 1
5429, 1, 1636421943816, 1636421944486, 670, 270, 400, 0, 0, 0
5430, 1, 1636421944049, 1636421944710, 661, 266, 395, 0, 1, 1
5431, 1, 1636421944240, 1636421944922, 682, 271, 411, 1, 0, 1
5432, 1, 1636421944315, 1636421944974, 659, 262, 397, 0, 0, 0
5433, 1, 1636421944384, 1636421945054, 670, 271, 399, 1, 1, 2
5434, 1, 1636421944384, 1636421945054, 670, 270, 400, 1, 0, 1
5435, 1, 1636421944488, 1636421945158, 670, 276, 394, 1, 2, 3
5436, 1, 1636421944716, 1636421945378, 662, 270, 392, 0, 0, 0
5437, 1, 1636421944924, 1636421945590, 666, 270, 396, 1, 0, 1
5438, 1, 1636421944982, 1636421945650, 668, 269, 399, 0, 0, 0
5439, 1, 1636421945056, 1636421945722, 666, 270, 396, 3, 0, 3
5440, 1, 1636421945056, 1636421945722, 666, 269, 397, 1, 1, 2
5376, 2, 1636421935558, 1636421945736, 10178, 0, 10178, 0, 1, 1
5441, 1, 1636421945160, 1636421945826, 666, 272, 394, 0, 0, 0
5442, 1, 1636421945382, 1636421946098, 716, 268, 448, 0, 1, 1
5377, 2, 1636421935986, 1636421946159, 10173, 0, 10173, 0, 0, 0
5443, 1, 1636421945592, 1636421946278, 686, 273, 413, 1, 2, 3
5444, 1, 1636421945652, 1636421946322, 670, 270, 400, 0, 0, 0
5446, 1, 1636421945738, 1636421946426, 688, 291, 397, 0, 22, 22
5445, 1, 1636421945738, 1636421946426, 688, 285, 403, 1, 22, 23
5447, 1, 1636421945828, 1636421946518, 690, 290, 400, 0, 23, 23
5448, 1, 1636421945866, 1636421946538, 672, 275, 397, 1, 1, 2
5449, 1, 1636421946099, 1636421946766, 667, 274, 393, 0, 0, 0
5450, 1, 1636421946279, 1636421946954, 675, 272, 403, 0, 0, 0
5451, 1, 1636421946294, 1636421946954, 660, 263, 397, 0, 0, 0
5452, 1, 1636421946323, 1636421946986, 663, 267, 396, 1, 0, 1
5380, 2, 1636421936870, 1636421947043, 10173, 1, 10172, 0, 1, 1
5454, 1, 1636421946428, 1636421947094, 666, 270, 396, 0, 1, 1
5453, 1, 1636421946428, 1636421947098, 670, 271, 399, 2, 0, 2
5455, 1, 1636421946520, 1636421947182, 662, 266, 396, 1, 1, 2
5456, 1, 1636421946540, 1636421947210, 670, 274, 396, 0, 0, 0
5381, 2, 1636421937178, 1636421947355, 10177, 0, 10177, 0, 0, 0
5457, 1, 1636421946768, 1636421947434, 666, 269, 397, 0, 0, 0
5459, 1, 1636421946956, 1636421947630, 674, 271, 403, 2, 0, 2
5458, 1, 1636421946956, 1636421947634, 678, 271, 407, 0, 1, 1
5460, 1, 1636421946989, 1636421947658, 669, 266, 403, 1, 0, 1
5461, 1, 1636421947096, 1636421947810, 714, 314, 400, 1, 42, 43
5462, 1, 1636421947099, 1636421947813, 714, 310, 404, 0, 38, 38
5463, 1, 1636421947174, 1636421947850, 676, 271, 405, 0, 0, 0
5465, 1, 1636421947212, 1636421947898, 686, 269, 417, 2, 0, 2
5464, 1, 1636421947186, 1636421947898, 712, 267, 445, 1, 0, 1
5466, 1, 1636421947436, 1636421948102, 666, 270, 396, 2, 0, 2
5467, 1, 1636421947490, 1636421948170, 680, 276, 404, 1, 1, 2
5468, 1, 1636421947631, 1636421948302, 671, 279, 392, 1, 1, 2
5469, 1, 1636421947635, 1636421948306, 671, 270, 401, 0, 1, 1
5470, 1, 1636421947659, 1636421948326, 667, 270, 397, 1, 0, 1
5384, 2, 1636421938258, 1636421948439, 10181, 1, 10180, 1, 0, 1
5471, 1, 1636421947811, 1636421948478, 667, 270, 397, 0, 1, 1
5472, 1, 1636421947814, 1636421948486, 672, 275, 397, 2, 0, 2
5473, 1, 1636421947851, 1636421948514, 663, 266, 397, 0, 0, 0
5475, 1, 1636421947900, 1636421948566, 666, 270, 396, 1, 1, 2
5474, 1, 1636421947900, 1636421948578, 678, 273, 405, 1, 0, 1
5476, 1, 1636421948104, 1636421948794, 690, 295, 395, 0, 26, 26
5477, 1, 1636421948171, 1636421948830, 659, 263, 396, 0, 1, 1
5479, 1, 1636421948307, 1636421948978, 671, 270, 401, 2, 0, 2
5478, 1, 1636421948303, 1636421948978, 675, 272, 403, 0, 0, 0
5385, 2, 1636421938798, 1636421948979, 10181, 0, 10181, 0, 0, 0
5480, 1, 1636421948328, 1636421949030, 702, 275, 427, 2, 2, 4
5481, 1, 1636421948479, 1636421949146, 667, 271, 396, 1, 0, 1
5482, 1, 1636421948487, 1636421949166, 679, 267, 412, 2, 0, 2
5483, 1, 1636421948518, 1636421949182, 664, 270, 394, 0, 0, 0
5486, 1, 1636421948581, 1636421949246, 665, 268, 397, 0, 2, 2
5485, 1, 1636421948570, 1636421949246, 676, 274, 402, 0, 9, 9
5484, 1, 1636421948568, 1636421949246, 678, 280, 398, 1, 11, 12
5387, 2, 1636421939178, 1636421949355, 10177, 0, 10177, 0, 0, 0
5487, 1, 1636421948795, 1636421949466, 671, 267, 404, 1, 1, 2
5488, 1, 1636421948837, 1636421949518, 681, 274, 407, 0, 1, 1
5490, 1, 1636421948981, 1636421949658, 677, 270, 407, 1, 0, 1
5489, 1, 1636421948980, 1636421949658, 678, 274, 404, 1, 0, 1
5491, 1, 1636421949032, 1636421949714, 682, 278, 404, 2, 6, 8
5492, 1, 1636421949106, 1636421949802, 696, 299, 397, 1, 31, 32
5493, 1, 1636421949148, 1636421949810, 662, 267, 395, 0, 0, 0
5494, 1, 1636421949168, 1636421949838, 670, 266, 404, 0, 0, 0
5495, 1, 1636421949184, 1636421949890, 706, 267, 439, 2, 0, 2
5498, 1, 1636421949249, 1636421949934, 685, 266, 419, 1, 0, 1
5496, 1, 1636421949248, 1636421949942, 694, 276, 418, 4, 1, 5
5390, 2, 1636421939762, 1636421949943, 10181, 0, 10181, 0, 0, 0
5497, 1, 1636421949248, 1636421949946, 698, 274, 424, 1, 1, 2
5499, 1, 1636421949468, 1636421950138, 670, 270, 400, 0, 0, 0
5500, 1, 1636421949482, 1636421950146, 664, 266, 398, 0, 0, 0
5501, 1, 1636421949520, 1636421950210, 690, 293, 397, 0, 22, 22
5503, 1, 1636421949660, 1636421950322, 662, 266, 396, 0, 0, 0
5502, 1, 1636421949659, 1636421950330, 671, 274, 397, 0, 0, 0
5504, 1, 1636421949716, 1636421950394, 678, 279, 399, 1, 11, 12
5506, 1, 1636421949815, 1636421950482, 667, 270, 397, 1, 2, 3
5505, 1, 1636421949803, 1636421950482, 679, 275, 404, 3, 1, 4
5507, 1, 1636421949839, 1636421950530, 691, 273, 418, 0, 2, 2
5508, 1, 1636421949891, 1636421950562, 671, 270, 401, 0, 0, 0
5509, 1, 1636421949945, 1636421950606, 661, 262, 399, 0, 0, 0
5510, 1, 1636421949946, 1636421950614, 668, 267, 401, 3, 0, 3
5511, 1, 1636421949948, 1636421950618, 670, 268, 402, 2, 1, 3
5512, 1, 1636421950070, 1636421950726, 656, 262, 394, 0, 0, 0
5513, 1, 1636421950139, 1636421950798, 659, 266, 393, 0, 0, 0
5514, 1, 1636421950147, 1636421950814, 667, 270, 397, 0, 0, 0
5515, 1, 1636421950211, 1636421950878, 667, 266, 401, 0, 0, 0
5516, 1, 1636421950325, 1636421950986, 661, 266, 395, 0, 0, 0
5517, 1, 1636421950331, 1636421950994, 663, 266, 397, 0, 0, 0
5518, 1, 1636421950395, 1636421951062, 667, 263, 404, 2, 0, 2
5520, 1, 1636421950484, 1636421951150, 666, 270, 396, 1, 0, 1
5519, 1, 1636421950484, 1636421951150, 666, 271, 395, 3, 0, 3
5521, 1, 1636421950532, 1636421951194, 662, 266, 396, 1, 0, 1
5522, 1, 1636421950563, 1636421951230, 667, 270, 397, 1, 0, 1
5523, 1, 1636421950611, 1636421951274, 663, 272, 391, 0, 1, 1
5524, 1, 1636421950616, 1636421951290, 674, 277, 397, 0, 0, 0
5525, 1, 1636421950620, 1636421951298, 678, 273, 405, 1, 0, 1
5526, 1, 1636421950727, 1636421951386, 659, 263, 396, 0, 0, 0
5527, 1, 1636421950806, 1636421951478, 672, 269, 403, 0, 1, 1
5528, 1, 1636421950815, 1636421951486, 671, 270, 401, 0, 0, 0
5529, 1, 1636421950879, 1636421951538, 659, 262, 397, 1, 0, 1
5401, 2, 1636421941424, 1636421951627, 10203, 1, 10202, 0, 1, 1
5531, 1, 1636421950997, 1636421951662, 665, 270, 395, 0, 0, 0
5530, 1, 1636421950991, 1636421951662, 671, 278, 393, 0, 0, 0
5403, 2, 1636421941494, 1636421951671, 10177, 0, 10177, 1, 0, 1
5532, 1, 1636421951064, 1636421951742, 678, 279, 399, 2, 1, 3
5533, 1, 1636421951151, 1636421951818, 667, 270, 397, 0, 0, 0
5534, 1, 1636421951152, 1636421951822, 670, 275, 395, 1, 0, 1
5535, 1, 1636421951198, 1636421951942, 744, 342, 402, 0, 71, 71
5536, 1, 1636421951231, 1636421951942, 711, 306, 405, 0, 44, 44
5538, 1, 1636421951291, 1636421952030, 739, 341, 398, 1, 76, 77
5539, 1, 1636421951300, 1636421952034, 734, 334, 400, 2, 68, 70
5537, 1, 1636421951278, 1636421952034, 756, 357, 399, 1, 84, 85
5540, 1, 1636421951393, 1636421952122, 729, 331, 398, 2, 59, 61
5542, 1, 1636421951487, 1636421952210, 723, 273, 450, 4, 1, 5
5543, 1, 1636421951546, 1636421952214, 668, 272, 396, 2, 1, 3
5541, 1, 1636421951480, 1636421952214, 734, 271, 463, 0, 1, 1
5544, 1, 1636421951675, 1636421952342, 667, 270, 397, 0, 0, 0
5545, 1, 1636421951675, 1636421952346, 671, 274, 397, 2, 1, 3
5409, 2, 1636421942164, 1636421952347, 10183, 0, 10183, 0, 0, 0
5546, 1, 1636421951744, 1636421952410, 666, 263, 403, 1, 0, 1
5548, 1, 1636421951802, 1636421952466, 664, 267, 397, 1, 0, 1
5549, 1, 1636421951819, 1636421952486, 667, 266, 401, 1, 0, 1
5550, 1, 1636421951824, 1636421952502, 678, 270, 408, 0, 0, 0
5551, 1, 1636421951943, 1636421952630, 687, 277, 410, 2, 0, 2
5552, 1, 1636421951944, 1636421952630, 686, 278, 408, 1, 1, 2
5554, 1, 1636421952035, 1636421952717, 682, 269, 413, 0, 0, 0
5555, 1, 1636421952036, 1636421952717, 681, 283, 398, 2, 1, 3
5553, 1, 1636421952032, 1636421952717, 685, 269, 416, 1, 0, 1
5556, 1, 1636421952124, 1636421952806, 682, 284, 398, 0, 10, 10
5558, 1, 1636421952215, 1636421952894, 679, 280, 399, 0, 0, 0
5557, 1, 1636421952211, 1636421952894, 683, 280, 403, 0, 0, 0
5559, 1, 1636421952216, 1636421952894, 678, 281, 397, 0, 0, 0
5560, 1, 1636421952348, 1636421953026, 678, 278, 400, 1, 1, 2
5561, 1, 1636421952348, 1636421953026, 678, 278, 400, 1, 1, 2
5562, 1, 1636421952411, 1636421953070, 659, 260, 399, 1, 1, 2
5563, 1, 1636421952468, 1636421953134, 666, 264, 402, 0, 0, 0
5416, 2, 1636421942968, 1636421953139, 10171, 1, 10170, 0, 1, 1
5566, 1, 1636421952504, 1636421953166, 662, 266, 396, 0, 0, 0
5565, 1, 1636421952487, 1636421953174, 687, 275, 412, 1, 1, 2
5421, 2, 1636421943060, 1636421953235, 10175, 0, 10175, 0, 0, 0
5567, 1, 1636421952631, 1636421953294, 663, 267, 396, 0, 2, 2
5568, 1, 1636421952631, 1636421953294, 663, 267, 396, 0, 0, 0
5571, 1, 1636421952719, 1636421953406, 687, 289, 398, 3, 24, 27
5569, 1, 1636421952719, 1636421953410, 691, 288, 403, 1, 25, 26
5570, 1, 1636421952719, 1636421953410, 691, 293, 398, 2, 25, 27
5572, 1, 1636421952808, 1636421953506, 698, 299, 399, 1, 29, 30
5574, 1, 1636421952895, 1636421953594, 699, 296, 403, 3, 29, 32
5573, 1, 1636421952895, 1636421953594, 699, 298, 401, 2, 23, 25
5575, 1, 1636421952896, 1636421953602, 706, 300, 406, 2, 28, 30
5576, 1, 1636421953028, 1636421953718, 690, 268, 422, 2, 1, 3
5577, 1, 1636421953029, 1636421953729, 700, 277, 423, 1, 1, 2
5579, 1, 1636421953141, 1636421953814, 673, 268, 405, 2, 1, 3
5581, 1, 1636421953175, 1636421953842, 667, 271, 396, 0, 1, 1
5580, 1, 1636421953171, 1636421953866, 695, 302, 393, 0, 0, 0
5428, 2, 1636421943732, 1636421953911, 10179, 0, 10179, 0, 0, 0
5582, 1, 1636421953270, 1636421953938, 668, 270, 398, 0, 0, 0
5584, 1, 1636421953297, 1636421953966, 669, 270, 399, 1, 0, 1
5583, 1, 1636421953297, 1636421953966, 669, 271, 398, 2, 0, 2
5586, 1, 1636421953407, 1636421954082, 675, 271, 404, 4, 1, 5
5588, 1, 1636421953412, 1636421954090, 678, 278, 400, 1, 2, 3
5587, 1, 1636421953411, 1636421954090, 679, 278, 401, 2, 2, 4
5589, 1, 1636421953507, 1636421954177, 670, 276, 394, 0, 14, 14
5590, 1, 1636421953595, 1636421954262, 667, 270, 397, 2, 2, 4
5591, 1, 1636421953595, 1636421954262, 667, 272, 395, 2, 1, 3
5593, 1, 1636421953719, 1636421954386, 667, 271, 396, 1, 0, 1
5594, 1, 1636421953731, 1636421954397, 666, 270, 396, 0, 0, 0
5595, 1, 1636421953816, 1636421954498, 682, 275, 407, 0, 1, 1
5596, 1, 1636421953843, 1636421954514, 671, 270, 401, 0, 0, 0
5600, 1, 1636421953968, 1636421954638, 670, 271, 399, 0, 1, 1
5599, 1, 1636421953968, 1636421954638, 670, 272, 398, 1, 1, 2
5604, 1, 1636421954091, 1636421954754, 663, 265, 398, 0, 1, 1
5603, 1, 1636421954091, 1636421954758, 667, 274, 393, 2, 0, 2
5602, 1, 1636421954084, 1636421954762, 678, 274, 404, 0, 2, 2
5605, 1, 1636421954179, 1636421954842, 663, 272, 391, 1, 2, 3
5607, 1, 1636421954264, 1636421954930, 666, 271, 395, 1, 0, 1
5606, 1, 1636421954264, 1636421954930, 666, 270, 396, 2, 0, 2
5608, 1, 1636421954387, 1636421955050, 663, 265, 398, 0, 1, 1
5609, 1, 1636421954399, 1636421955082, 683, 278, 405, 0, 0, 0
5610, 1, 1636421954498, 1636421955170, 672, 269, 403, 0, 0, 0
5611, 1, 1636421954516, 1636421955182, 666, 267, 399, 1, 0, 1
5613, 1, 1636421954640, 1636421955310, 670, 271, 399, 3, 0, 3
5612, 1, 1636421954639, 1636421955310, 671, 270, 401, 0, 1, 1
5614, 1, 1636421954758, 1636421955438, 680, 276, 404, 3, 1, 4
5616, 1, 1636421954763, 1636421955438, 675, 276, 399, 2, 2, 4
5615, 1, 1636421954760, 1636421955438, 678, 279, 399, 2, 1, 3
5617, 1, 1636421954847, 1636421955506, 659, 266, 393, 0, 0, 0
5618, 1, 1636421954932, 1636421955602, 670, 269, 401, 1, 0, 1
5619, 1, 1636421954932, 1636421955606, 674, 273, 401, 1, 1, 2
5620, 1, 1636421955053, 1636421955718, 665, 270, 395, 1, 0, 1
5621, 1, 1636421955083, 1636421955746, 663, 266, 397, 2, 0, 2
5622, 1, 1636421955172, 1636421955842, 670, 270, 400, 1, 0, 1
5623, 1, 1636421955183, 1636421955846, 663, 263, 400, 0, 0, 0
5625, 1, 1636421955312, 1636421955978, 666, 271, 395, 1, 1, 2
5627, 1, 1636421955439, 1636421956110, 671, 275, 396, 3, 0, 3
5628, 1, 1636421955440, 1636421956110, 670, 269, 401, 1, 0, 1
5626, 1, 1636421955439, 1636421956114, 675, 274, 401, 1, 0, 1
5629, 1, 1636421955514, 1636421956178, 664, 270, 394, 1, 0, 1
5630, 1, 1636421955603, 1636421956274, 671, 270, 401, 0, 0, 0
5631, 1, 1636421955607, 1636421956278, 671, 270, 401, 1, 0, 1
5632, 1, 1636421955719, 1636421956382, 663, 270, 393, 0, 1, 1
5633, 1, 1636421955749, 1636421956418, 669, 273, 396, 0, 0, 0
5634, 1, 1636421955843, 1636421956522, 679, 277, 402, 0, 0, 0
5635, 1, 1636421955849, 1636421956522, 673, 275, 398, 2, 0, 2
5636, 1, 1636421955980, 1636421956646, 666, 270, 396, 0, 1, 1
5639, 1, 1636421956115, 1636421956778, 663, 266, 397, 0, 0, 0
5637, 1, 1636421956112, 1636421956778, 666, 270, 396, 2, 0, 2
5638, 1, 1636421956112, 1636421956778, 666, 269, 397, 1, 0, 1
5640, 1, 1636421956181, 1636421956854, 673, 274, 399, 1, 0, 1
5641, 1, 1636421956275, 1636421956946, 671, 272, 399, 2, 1, 3
5642, 1, 1636421956280, 1636421956954, 674, 267, 407, 0, 1, 1
5643, 1, 1636421956385, 1636421957046, 661, 262, 399, 0, 0, 0
5644, 1, 1636421956420, 1636421957082, 662, 266, 396, 0, 0, 0
5645, 1, 1636421956523, 1636421957190, 667, 270, 397, 0, 0, 0
5646, 1, 1636421956523, 1636421957194, 671, 271, 400, 2, 1, 3
5647, 1, 1636421956647, 1636421957318, 671, 270, 401, 0, 0, 0
5648, 1, 1636421956779, 1636421957446, 667, 271, 396, 1, 1, 2
5650, 1, 1636421956781, 1636421957446, 665, 266, 399, 0, 0, 0
5651, 1, 1636421956856, 1636421957518, 662, 270, 392, 1, 0, 1
5652, 1, 1636421956948, 1636421957610, 662, 267, 395, 1, 1, 2
5653, 1, 1636421956956, 1636421957622, 666, 271, 395, 1, 0, 1
5654, 1, 1636421957051, 1636421957714, 663, 270, 393, 0, 0, 0
5656, 1, 1636421957192, 1636421957866, 674, 273, 401, 1, 1, 2
5657, 1, 1636421957195, 1636421957866, 671, 274, 397, 1, 1, 2
5658, 1, 1636421957319, 1636421957978, 659, 262, 397, 0, 0, 0
5660, 1, 1636421957447, 1636421958118, 671, 270, 401, 2, 0, 2
5659, 1, 1636421957447, 1636421958118, 671, 271, 400, 3, 0, 3
5661, 1, 1636421957523, 1636421958190, 667, 270, 397, 1, 0, 1
5662, 1, 1636421957614, 1636421958282, 668, 270, 398, 1, 1, 2
5663, 1, 1636421957624, 1636421958286, 662, 266, 396, 0, 0, 0
5664, 1, 1636421957717, 1636421958386, 669, 271, 398, 0, 1, 1
5666, 1, 1636421957868, 1636421958530, 662, 266, 396, 1, 0, 1
5665, 1, 1636421957868, 1636421958538, 670, 270, 400, 2, 0, 2
5667, 1, 1636421957985, 1636421958658, 673, 273, 400, 0, 1, 1
5668, 1, 1636421958120, 1636421958786, 666, 270, 396, 1, 1, 2
5669, 1, 1636421958120, 1636421958786, 666, 270, 396, 2, 0, 2
5670, 1, 1636421958192, 1636421958854, 662, 270, 392, 1, 0, 1
5671, 1, 1636421958283, 1636421958954, 671, 271, 400, 1, 1, 2
5672, 1, 1636421958289, 1636421958962, 673, 270, 403, 0, 0, 0
5673, 1, 1636421958388, 1636421959054, 666, 270, 396, 0, 0, 0
5674, 1, 1636421958535, 1636421959202, 667, 270, 397, 0, 0, 0
5675, 1, 1636421958540, 1636421959206, 666, 266, 400, 0, 0, 0
5676, 1, 1636421958659, 1636421959318, 659, 262, 397, 0, 0, 0
5678, 1, 1636421958787, 1636421959454, 667, 269, 398, 2, 0, 2
5677, 1, 1636421958787, 1636421959454, 667, 269, 398, 2, 0, 2
5679, 1, 1636421958858, 1636421959522, 664, 266, 398, 0, 0, 0
5680, 1, 1636421958955, 1636421959630, 675, 267, 408, 0, 0, 0
5681, 1, 1636421958964, 1636421959634, 670, 266, 404, 0, 0, 0
5682, 1, 1636421959055, 1636421959726, 671, 274, 397, 0, 0, 0
5683, 1, 1636421959203, 1636421959874, 671, 274, 397, 1, 0, 1
5684, 1, 1636421959207, 1636421959878, 671, 270, 401, 0, 0, 0
5685, 1, 1636421959325, 1636421959986, 661, 262, 399, 0, 0, 0
5686, 1, 1636421959456, 1636421960130, 674, 271, 403, 1, 0, 1
5688, 1, 1636421959525, 1636421960190, 665, 270, 395, 0, 0, 0
5690, 1, 1636421959635, 1636421960302, 667, 266, 401, 1, 0, 1
5689, 1, 1636421959632, 1636421960302, 670, 270, 400, 1, 0, 1
5692, 1, 1636421959875, 1636421960542, 667, 270, 397, 1, 0, 1
5693, 1, 1636421959880, 1636421960550, 670, 270, 400, 0, 0, 0
5694, 1, 1636421959991, 1636421960662, 671, 270, 401, 1, 0, 1
5695, 1, 1636421960132, 1636421960802, 670, 273, 397, 0, 0, 0
5696, 1, 1636421960192, 1636421960866, 674, 269, 405, 0, 0, 0
5697, 1, 1636421960304, 1636421960970, 666, 268, 398, 1, 0, 1
5698, 1, 1636421960304, 1636421960974, 670, 271, 399, 2, 0, 2
5699, 1, 1636421960543, 1636421961210, 667, 270, 397, 0, 0, 0
5700, 1, 1636421960552, 1636421961226, 674, 271, 403, 0, 1, 1
5702, 1, 1636421960804, 1636421961470, 666, 270, 396, 1, 0, 1
5703, 1, 1636421960867, 1636421961526, 659, 266, 393, 0, 0, 0
5704, 1, 1636421960972, 1636421961638, 666, 271, 395, 1, 1, 2
5706, 1, 1636421961211, 1636421961882, 671, 269, 402, 0, 0, 0
5707, 1, 1636421961228, 1636421961898, 670, 271, 399, 0, 0, 0
5547, 2, 1636421951767, 1636421961944, 10177, 1, 10176, 0, 1, 1
5708, 1, 1636421961472, 1636421962142, 670, 269, 401, 1, 0, 1
5709, 1, 1636421961534, 1636421962210, 676, 280, 396, 0, 10, 10
5710, 1, 1636421961639, 1636421962310, 671, 274, 397, 0, 0, 0
5711, 1, 1636421961884, 1636421962550, 666, 270, 396, 0, 0, 0
5712, 1, 1636421961946, 1636421962626, 680, 273, 407, 1, 0, 1
5564, 2, 1636421952483, 1636421962676, 10193, 1, 10192, 0, 1, 1
5715, 1, 1636421962211, 1636421962882, 671, 270, 401, 1, 0, 1
5716, 1, 1636421962311, 1636421962974, 663, 267, 396, 0, 0, 0
5578, 2, 1636421953078, 1636421963284, 10206, 1, 10205, 2, 2, 4
5718, 1, 1636421962628, 1636421963294, 666, 269, 397, 2, 0, 2
5585, 2, 1636421953366, 1636421963544, 10178, 0, 10178, 2, 0, 2
5720, 1, 1636421962883, 1636421963554, 671, 271, 400, 0, 3, 3
5592, 2, 1636421953604, 1636421963779, 10175, 0, 10175, 0, 0, 0
5722, 1, 1636421963296, 1636421963994, 698, 295, 403, 1, 30, 31
5597, 2, 1636421953912, 1636421964047, 10135, 0, 10135, 0, 0, 0
5723, 1, 1636421963414, 1636421964074, 660, 263, 397, 0, 0, 0
5598, 2, 1636421953940, 1636421964111, 10171, 0, 10171, 0, 0, 0
5601, 2, 1636421954042, 1636421964219, 10177, 0, 10177, 1, 0, 1
5726, 1, 1636421963910, 1636421964586, 676, 267, 409, 0, 1, 1
5727, 1, 1636421963996, 1636421964690, 694, 272, 422, 1, 2, 3
5729, 1, 1636421964220, 1636421964890, 670, 270, 400, 2, 1, 3
5733, 1, 1636421964692, 1636421965362, 670, 269, 401, 0, 0, 0
5624, 2, 1636421955311, 1636421965488, 10177, 1, 10176, 1, 1, 2
5736, 1, 1636421965618, 1636421966286, 668, 269, 399, 0, 1, 1
5649, 2, 1636421956780, 1636421966959, 10179, 1, 10178, 0, 1, 1
5655, 2, 1636421957086, 1636421967263, 10177, 1, 10176, 1, 0, 1
5738, 1, 1636421967086, 1636421967754, 668, 269, 399, 1, 0, 1
5739, 1, 1636421967394, 1636421968066, 672, 269, 403, 0, 0, 0
5687, 2, 1636421959456, 1636421969636, 10180, 0, 10180, 0, 0, 0
5691, 2, 1636421959727, 1636421969900, 10173, 1, 10172, 0, 0, 0
5742, 1, 1636421969766, 1636421970442, 676, 317, 359, 46, 0, 46
5743, 1, 1636421970026, 1636421970714, 688, 289, 399, 0, 0, 0
5701, 2, 1636421960663, 1636421970840, 10177, 0, 10177, 0, 1, 1
5705, 2, 1636421960976, 1636421971151, 10175, 0, 10175, 0, 0, 0
5746, 1, 1636421970970, 1636421971634, 664, 271, 393, 0, 1, 1
5747, 1, 1636421971282, 1636421971954, 672, 270, 402, 1, 0, 1
5713, 2, 1636421962078, 1636421972259, 10181, 0, 10181, 0, 0, 0
5714, 2, 1636421962143, 1636421972319, 10176, 1, 10175, 0, 1, 1
5717, 2, 1636421962552, 1636421972768, 10216, 1, 10215, 1, 0, 1
5719, 2, 1636421962810, 1636421972987, 10177, 1, 10176, 0, 0, 0
5750, 1, 1636421972406, 1636421973074, 668, 269, 399, 2, 0, 2
5751, 1, 1636421972450, 1636421973126, 676, 272, 404, 0, 6, 6
5721, 2, 1636421962978, 1636421973151, 10173, 1, 10172, 0, 0, 0
5752, 1, 1636421972898, 1636421973594, 696, 298, 398, 0, 30, 30
5724, 2, 1636421963556, 1636421973727, 10171, 0, 10171, 0, 0, 0
5753, 1, 1636421973076, 1636421973746, 670, 273, 397, 0, 1, 1
5754, 1, 1636421973152, 1636421973818, 666, 268, 398, 0, 0, 0
5725, 2, 1636421963678, 1636421973867, 10189, 0, 10189, 0, 0, 0
5756, 1, 1636421973282, 1636421973990, 708, 316, 392, 0, 46, 46
5728, 2, 1636421964114, 1636421974307, 10193, 0, 10193, 0, 0, 0
5730, 2, 1636421964242, 1636421974416, 10174, 1, 10173, 0, 0, 0
5758, 1, 1636421973748, 1636421974446, 698, 270, 428, 0, 0, 0
5759, 1, 1636421973819, 1636421974486, 667, 269, 398, 0, 1, 1
5731, 2, 1636421964351, 1636421974527, 10176, 1, 10175, 0, 0, 0
5760, 1, 1636421973868, 1636421974570, 702, 267, 435, 1, 0, 1
5762, 1, 1636421973998, 1636421974686, 688, 284, 404, 1, 14, 15
5732, 2, 1636421964589, 1636421974763, 10174, 1, 10173, 0, 1, 1
5734, 2, 1636421964892, 1636421975067, 10175, 0, 10175, 0, 0, 0
5764, 1, 1636421974448, 1636421975118, 670, 274, 396, 0, 6, 6
5765, 1, 1636421974530, 1636421975206, 676, 279, 397, 0, 15, 15
5768, 1, 1636421974662, 1636421975342, 680, 270, 410, 0, 1, 1
5769, 1, 1636421974688, 1636421975354, 666, 270, 396, 0, 0, 0
5735, 2, 1636421965364, 1636421975575, 10211, 1, 10210, 0, 1, 1
5771, 1, 1636421975120, 1636421975790, 670, 274, 396, 0, 0, 0
5773, 1, 1636421975208, 1636421975878, 670, 268, 402, 1, 0, 1
5775, 1, 1636421975356, 1636421976030, 674, 268, 406, 0, 1, 1
5774, 1, 1636421975343, 1636421976030, 687, 278, 409, 1, 10, 11
5776, 1, 1636421975706, 1636421976370, 664, 267, 397, 0, 1, 1
5777, 1, 1636421975791, 1636421976458, 667, 269, 398, 0, 0, 0
5737, 2, 1636421966288, 1636421976463, 10175, 0, 10175, 0, 0, 0
5778, 1, 1636421975880, 1636421976550, 670, 274, 396, 0, 1, 1
5780, 1, 1636421976032, 1636421976730, 698, 301, 397, 1, 35, 36
5779, 1, 1636421976032, 1636421976730, 698, 300, 398, 1, 26, 27
5782, 1, 1636421976465, 1636421977134, 669, 267, 402, 0, 1, 1
5783, 1, 1636421976551, 1636421977218, 667, 269, 398, 2, 0, 2
5786, 1, 1636421976732, 1636421977402, 670, 270, 400, 2, 1, 3
5785, 1, 1636421976732, 1636421977402, 670, 269, 401, 2, 0, 2
5787, 1, 1636421977136, 1636421977806, 670, 274, 396, 0, 0, 0
5788, 1, 1636421977220, 1636421977890, 670, 274, 396, 0, 1, 1
5740, 2, 1636421967756, 1636421977932, 10176, 1, 10175, 2, 0, 2
5790, 1, 1636421977404, 1636421978073, 669, 268, 401, 1, 0, 1
5789, 1, 1636421977404, 1636421978074, 670, 269, 401, 2, 0, 2
5741, 2, 1636421968068, 1636421978244, 10176, 0, 10176, 0, 0, 0
5791, 1, 1636421977808, 1636421978510, 702, 266, 436, 0, 0, 0
5792, 1, 1636421977934, 1636421978598, 664, 267, 397, 0, 1, 1
5795, 1, 1636421978075, 1636421978782, 707, 270, 437, 1, 0, 1
5794, 1, 1636421978075, 1636421978786, 711, 276, 435, 3, 0, 3
5797, 1, 1636421978511, 1636421979178, 667, 274, 393, 0, 1, 1
5798, 1, 1636421978601, 1636421979270, 669, 270, 399, 0, 2, 2
5799, 1, 1636421978784, 1636421979450, 666, 266, 400, 1, 0, 1
5800, 1, 1636421978788, 1636421979462, 674, 275, 399, 1, 1, 2
5801, 1, 1636421979180, 1636421979850, 670, 270, 400, 0, 2, 2
5802, 1, 1636421979272, 1636421979938, 666, 271, 395, 0, 1, 1
5803, 1, 1636421979452, 1636421980118, 666, 265, 401, 1, 0, 1
5804, 1, 1636421979464, 1636421980138, 674, 270, 404, 1, 0, 1
5806, 1, 1636421979940, 1636421980606, 666, 270, 396, 0, 0, 0
5744, 2, 1636421970444, 1636421980620, 10176, 0, 10176, 0, 0, 0
5807, 1, 1636421980119, 1636421980786, 667, 270, 397, 0, 1, 1
5808, 1, 1636421980140, 1636421980810, 670, 269, 401, 0, 0, 0
5745, 2, 1636421970716, 1636421980928, 10212, 0, 10212, 0, 1, 1
5811, 1, 1636421980788, 1636421981462, 674, 269, 405, 2, 0, 2
5812, 1, 1636421980812, 1636421981510, 698, 270, 428, 0, 0, 0
5748, 2, 1636421971636, 1636421981812, 10176, 0, 10176, 0, 0, 0
5749, 2, 1636421971956, 1636421982131, 10175, 0, 10175, 0, 0, 0
5815, 1, 1636421981512, 1636421982186, 674, 269, 405, 0, 1, 1
5755, 2, 1636421973153, 1636421983332, 10179, 0, 10179, 0, 0, 0
5757, 2, 1636421973595, 1636421983775, 10180, 46, 10134, 45, 0, 45
5761, 2, 1636421973991, 1636421984167, 10176, 0, 10176, 0, 0, 0
5763, 2, 1636421974438, 1636421984615, 10177, 0, 10177, 0, 0, 0
5766, 2, 1636421974554, 1636421984728, 10174, 1, 10173, 0, 0, 0
5767, 2, 1636421974572, 1636421984775, 10203, 0, 10203, 1, 0, 1
5770, 2, 1636421974895, 1636421985068, 10173, 1, 10172, 45, 0, 45
5772, 2, 1636421975198, 1636421985371, 10173, 0, 10173, 0, 0, 0
5823, 1, 1636421984866, 1636421985530, 664, 265, 399, 1, 0, 1
5827, 1, 1636421985532, 1636421986198, 666, 269, 397, 0, 0, 0
5781, 2, 1636421976372, 1636421986555, 10183, 1, 10182, 1, 0, 1
5784, 2, 1636421976594, 1636421986771, 10177, 1, 10176, 2, 0, 2
5828, 1, 1636421986200, 1636421986910, 710, 315, 395, 1, 43, 44
5831, 1, 1636421986912, 1636421987578, 666, 269, 397, 0, 0, 0
5793, 2, 1636421978062, 1636421988236, 10174, 1, 10173, 1, 1, 2
5832, 1, 1636421987581, 1636421988250, 669, 270, 399, 0, 0, 0
5796, 2, 1636421978374, 1636421988552, 10178, 1, 10177, 1, 0, 1
5833, 1, 1636421988252, 1636421988922, 670, 270, 400, 0, 0, 0
5836, 1, 1636421988924, 1636421989598, 674, 270, 404, 0, 0, 0
5805, 2, 1636421979852, 1636421990028, 10176, 0, 10176, 0, 0, 0
5837, 1, 1636421989600, 1636421990294, 694, 297, 397, 1, 28, 29
5809, 2, 1636421980621, 1636421990804, 10183, 0, 10183, 0, 1, 1
5810, 2, 1636421980750, 1636421990928, 10178, 0, 10178, 0, 0, 0
5839, 1, 1636421990296, 1636421990966, 670, 269, 401, 1, 0, 1
5813, 2, 1636421981058, 1636421991231, 10173, 1, 10172, 0, 1, 1
5841, 1, 1636421990968, 1636421991638, 670, 269, 401, 1, 0, 1
5814, 2, 1636421981464, 1636421991639, 10175, 1, 10174, 1, 0, 1
5816, 2, 1636421981942, 1636421992123, 10181, 1, 10180, 1, 0, 1
5844, 1, 1636421991641, 1636421992306, 665, 269, 396, 1, 0, 1
5817, 2, 1636421982188, 1636421992367, 10179, 0, 10179, 0, 0, 0
5818, 2, 1636421982262, 1636421992439, 10177, 0, 10177, 0, 0, 0
5819, 2, 1636421983462, 1636421993640, 10178, 0, 10178, 1, 0, 1
5820, 2, 1636421983906, 1636421994084, 10178, 1, 10177, 0, 2, 2
5821, 2, 1636421984298, 1636421994475, 10177, 0, 10177, 0, 0, 0
5822, 2, 1636421984776, 1636421994952, 10176, 1, 10175, 0, 0, 0
5824, 2, 1636421984874, 1636421995047, 10173, 0, 10173, 0, 0, 0
5825, 2, 1636421985242, 1636421995419, 10177, 0, 10177, 0, 0, 0
5826, 2, 1636421985502, 1636421995675, 10173, 1, 10172, 0, 0, 0
5853, 1, 1636421995082, 1636421995778, 696, 295, 401, 1, 26, 27
5855, 1, 1636421995546, 1636421996218, 672, 270, 402, 0, 1, 1
5856, 1, 1636421995779, 1636421996450, 671, 269, 402, 0, 0, 0
5857, 1, 1636421995806, 1636421996494, 688, 294, 394, 0, 0, 0
5829, 2, 1636421986686, 1636421996864, 10178, 0, 10178, 0, 1, 1
5858, 1, 1636421996220, 1636421996882, 662, 267, 395, 2, 0, 2
5830, 2, 1636421986902, 1636421997079, 10177, 1, 10176, 0, 1, 1
5859, 1, 1636421996451, 1636421997130, 679, 278, 401, 0, 10, 10
5860, 1, 1636421996496, 1636421997166, 670, 270, 400, 2, 0, 2
5861, 1, 1636421996886, 1636421997554, 668, 270, 398, 0, 0, 0
5863, 1, 1636421997131, 1636421997798, 667, 270, 397, 1, 0, 1
5864, 1, 1636421997168, 1636421997838, 670, 274, 396, 0, 1, 1
5865, 1, 1636421997210, 1636421997878, 668, 270, 398, 1, 0, 1
5866, 1, 1636421997556, 1636421998222, 666, 270, 396, 0, 0, 0
5867, 1, 1636421997800, 1636421998470, 670, 271, 399, 0, 0, 0
5868, 1, 1636421997840, 1636421998510, 670, 267, 403, 1, 0, 1
5834, 2, 1636421988366, 1636421998539, 10173, 1, 10172, 1, 0, 1
5869, 1, 1636421997880, 1636421998546, 666, 270, 396, 0, 0, 0
5835, 2, 1636421988682, 1636421998859, 10177, 0, 10177, 0, 0, 0
5870, 1, 1636421998224, 1636421998898, 674, 273, 401, 0, 6, 6
5871, 1, 1636421998472, 1636421999150, 678, 279, 399, 0, 0, 0
5873, 1, 1636421998548, 1636421999214, 666, 271, 395, 0, 0, 0
5872, 1, 1636421998541, 1636421999214, 673, 278, 395, 1, 10, 11
5874, 1, 1636421998670, 1636421999330, 660, 266, 394, 0, 1, 1
5875, 1, 1636421998900, 1636421999570, 670, 266, 404, 0, 0, 0
5876, 1, 1636421998990, 1636421999654, 664, 267, 397, 0, 0, 0
5877, 1, 1636421999152, 1636421999822, 670, 274, 396, 0, 0, 0
5879, 1, 1636421999215, 1636421999882, 667, 269, 398, 0, 0, 0
5878, 1, 1636421999215, 1636421999882, 667, 262, 405, 0, 0, 0
5880, 1, 1636421999331, 1636422000002, 671, 273, 398, 0, 0, 0
5881, 1, 1636421999571, 1636422000238, 667, 274, 393, 0, 1, 1
5882, 1, 1636421999656, 1636422000318, 662, 265, 397, 1, 0, 1
5838, 2, 1636421990158, 1636422000335, 10177, 0, 10177, 0, 0, 0
5883, 1, 1636421999824, 1636422000490, 666, 270, 396, 0, 0, 0
5885, 1, 1636421999884, 1636422000602, 718, 271, 447, 3, 0, 3
5884, 1, 1636421999883, 1636422000602, 719, 268, 451, 0, 0, 0
5886, 1, 1636422000003, 1636422000698, 695, 290, 405, 0, 23, 23
5887, 1, 1636422000240, 1636422000914, 674, 267, 407, 0, 1, 1
5888, 1, 1636422000338, 1636422001014, 676, 269, 407, 0, 0, 0
5840, 2, 1636421990934, 1636422001111, 10177, 1, 10176, 0, 0, 0
5889, 1, 1636422000466, 1636422001134, 668, 268, 400, 0, 0, 0
5890, 1, 1636422000492, 1636422001158, 666, 270, 396, 1, 0, 1
5892, 1, 1636422000604, 1636422001270, 666, 270, 396, 1, 0, 1
5891, 1, 1636422000604, 1636422001270, 666, 271, 395, 3, 0, 3
5842, 2, 1636421991058, 1636422001279, 10221, 1, 10220, 0, 0, 0
5893, 1, 1636422000699, 1636422001466, 767, 370, 397, 1, 34, 35
5843, 2, 1636421991358, 1636422001531, 10173, 0, 10173, 0, 0, 0
5895, 1, 1636422001016, 1636422001742, 726, 322, 404, 1, 0, 1
5896, 1, 1636422001136, 1636422001822, 686, 276, 410, 2, 0, 2
5897, 1, 1636422001159, 1636422001886, 727, 295, 432, 0, 27, 27
5845, 2, 1636421991770, 1636422001947, 10177, 1, 10176, 1, 0, 1
5899, 1, 1636422001281, 1636422001982, 701, 308, 393, 3, 34, 37
5898, 1, 1636422001281, 1636422001982, 701, 301, 400, 1, 31, 32
5900, 1, 1636422001281, 1636422002014, 733, 337, 396, 0, 0, 0
5901, 1, 1636422001406, 1636422002102, 696, 264, 432, 0, 2, 2
5902, 1, 1636422001468, 1636422002138, 670, 270, 400, 0, 1, 1
5894, 1, 1636422000916, 1636422002302, 1386, 990, 396, 0, 19, 19
5903, 1, 1636422001658, 1636422002402, 744, 341, 403, 0, 22, 22
5904, 1, 1636422001744, 1636422002422, 678, 274, 404, 0, 0, 0
5847, 2, 1636421992307, 1636422002487, 10180, 1, 10179, 0, 0, 0
5846, 2, 1636421992254, 1636422002531, 10277, 0, 10277, 0, 0, 0
5906, 1, 1636422001887, 1636422002554, 667, 270, 397, 0, 0, 0
5908, 1, 1636422001984, 1636422002654, 670, 275, 395, 2, 0, 2
5907, 1, 1636422001983, 1636422002654, 671, 275, 396, 1, 0, 1
5909, 1, 1636422002015, 1636422002686, 671, 274, 397, 0, 1, 1
5848, 2, 1636421992530, 1636422002707, 10177, 1, 10176, 1, 1, 2
5849, 2, 1636421992570, 1636422002751, 10181, 1, 10180, 0, 1, 1
5910, 1, 1636422002082, 1636422002798, 716, 272, 444, 0, 6, 6
5911, 1, 1636422002104, 1636422002798, 694, 296, 398, 0, 30, 30
5912, 1, 1636422002140, 1636422002882, 742, 302, 440, 1, 38, 39
5913, 1, 1636422002303, 1636422003018, 715, 320, 395, 0, 53, 53
5914, 1, 1636422002403, 1636422003106, 703, 351, 352, 1, 84, 85
5915, 1, 1636422002424, 1636422003198, 774, 310, 464, 3, 2, 5
5917, 1, 1636422002618, 1636422003286, 668, 268, 400, 1, 1, 2
5920, 1, 1636422002656, 1636422003326, 670, 264, 406, 2, 0, 2
5921, 1, 1636422002754, 1636422003430, 676, 274, 402, 1, 0, 1
5922, 1, 1636422002799, 1636422003470, 671, 272, 399, 3, 0, 3
5924, 1, 1636422002842, 1636422003522, 680, 277, 403, 0, 0, 0
5926, 1, 1636422002884, 1636422003554, 670, 272, 398, 1, 2, 3
5925, 1, 1636422002878, 1636422003562, 684, 283, 401, 0, 0, 0
5927, 1, 1636422003019, 1636422003694, 675, 283, 392, 2, 0, 2
5923, 1, 1636422002800, 1636422003730, 930, 534, 396, 0, 1, 1
5929, 1, 1636422003200, 1636422003866, 666, 271, 395, 2, 0, 2
5850, 2, 1636421993770, 1636422003947, 10177, 1, 10176, 0, 0, 0
5930, 1, 1636422003287, 1636422003954, 667, 270, 397, 0, 0, 0
5931, 1, 1636422003327, 1636422003994, 667, 270, 397, 0, 0, 0
5928, 1, 1636422003107, 1636422003998, 891, 498, 393, 0, 0, 0
5935, 1, 1636422003556, 1636422004222, 666, 267, 399, 0, 1, 1
5936, 1, 1636422003564, 1636422004230, 666, 262, 404, 0, 0, 0
5934, 1, 1636422003523, 1636422004302, 779, 378, 401, 0, 37, 37
5851, 2, 1636421994214, 1636422004391, 10177, 1, 10176, 1, 0, 1
5938, 1, 1636422003732, 1636422004402, 670, 270, 400, 0, 0, 0
5939, 1, 1636422003868, 1636422004542, 674, 271, 403, 0, 0, 0
5940, 1, 1636422003955, 1636422004658, 703, 306, 397, 0, 31, 31
5941, 1, 1636422003995, 1636422004666, 671, 276, 395, 1, 2, 3
5942, 1, 1636422004000, 1636422004674, 674, 274, 400, 0, 0, 0
5943, 1, 1636422004078, 1636422004750, 672, 270, 402, 0, 6, 6
5852, 2, 1636421994606, 1636422004791, 10185, 0, 10185, 0, 0, 0
5945, 1, 1636422004231, 1636422004930, 699, 272, 427, 1, 0, 1
5944, 1, 1636422004223, 1636422004938, 715, 280, 435, 0, 1, 1
5947, 1, 1636422004404, 1636422005082, 678, 274, 404, 0, 0, 0
5948, 1, 1636422004522, 1636422005190, 668, 272, 396, 0, 2, 2
5949, 1, 1636422004544, 1636422005238, 694, 297, 397, 2, 30, 32
5854, 2, 1636421995178, 1636422005351, 10173, 0, 10173, 0, 0, 0
5952, 1, 1636422004676, 1636422005378, 702, 270, 432, 0, 1, 1
5953, 1, 1636422004794, 1636422005458, 664, 267, 397, 2, 1, 3
5950, 1, 1636422004659, 1636422005510, 851, 452, 399, 0, 0, 0
5954, 1, 1636422004922, 1636422005618, 696, 300, 396, 0, 30, 30
5956, 1, 1636422004940, 1636422005622, 682, 276, 406, 0, 2, 2
5955, 1, 1636422004931, 1636422005798, 867, 466, 401, 0, 19, 19
5957, 1, 1636422005083, 1636422005798, 715, 269, 446, 3, 0, 3
5958, 1, 1636422005191, 1636422005890, 699, 272, 427, 2, 1, 3
5959, 1, 1636422005240, 1636422005934, 694, 271, 423, 0, 1, 1
5960, 1, 1636422005379, 1636422006070, 691, 295, 396, 0, 0, 0
5961, 1, 1636422005461, 1636422006130, 669, 270, 399, 1, 0, 1
5962, 1, 1636422005486, 1636422006158, 672, 271, 401, 0, 1, 1
5963, 1, 1636422005511, 1636422006182, 671, 270, 401, 0, 0, 0
5965, 1, 1636422005624, 1636422006298, 674, 266, 408, 0, 0, 0
5964, 1, 1636422005620, 1636422006298, 678, 269, 409, 0, 0, 0
5966, 1, 1636422005799, 1636422006470, 671, 274, 397, 2, 0, 2
5967, 1, 1636422005800, 1636422006474, 674, 278, 396, 2, 0, 2
5968, 1, 1636422005891, 1636422006562, 671, 270, 401, 1, 1, 2
5969, 1, 1636422005935, 1636422006602, 667, 268, 399, 1, 0, 1
5970, 1, 1636422006071, 1636422006742, 671, 280, 391, 1, 0, 1
5971, 1, 1636422006132, 1636422006798, 666, 262, 404, 0, 0, 0
5972, 1, 1636422006159, 1636422006826, 667, 266, 401, 0, 0, 0
5973, 1, 1636422006183, 1636422006850, 667, 262, 405, 0, 0, 0
5974, 1, 1636422006299, 1636422006958, 659, 263, 396, 0, 0, 0
5976, 1, 1636422006471, 1636422007138, 667, 272, 395, 2, 1, 3
5977, 1, 1636422006475, 1636422007142, 667, 268, 399, 0, 2, 2
5862, 2, 1636421996994, 1636422007171, 10177, 0, 10177, 0, 0, 0
5978, 1, 1636422006563, 1636422007238, 675, 274, 401, 1, 1, 2
5980, 1, 1636422006744, 1636422007442, 698, 300, 398, 0, 30, 30
5981, 1, 1636422006799, 1636422007470, 671, 270, 401, 0, 0, 0
5982, 1, 1636422006827, 1636422007526, 699, 305, 394, 2, 38, 40
5983, 1, 1636422006852, 1636422007534, 682, 277, 405, 0, 14, 14
5984, 1, 1636422006965, 1636422007626, 661, 266, 395, 0, 0, 0
5986, 1, 1636422007174, 1636422007842, 668, 271, 397, 0, 0, 0
5985, 1, 1636422007173, 1636422007902, 729, 333, 396, 0, 0, 0
5987, 1, 1636422007239, 1636422007910, 671, 274, 397, 0, 0, 0
5988, 1, 1636422007302, 1636422007970, 668, 270, 398, 0, 0, 0
5990, 1, 1636422007472, 1636422008146, 674, 269, 405, 0, 0, 0
5989, 1, 1636422007443, 1636422008174, 731, 335, 396, 0, 0, 0
5992, 1, 1636422007535, 1636422008202, 667, 271, 396, 0, 0, 0
5993, 1, 1636422007632, 1636422008298, 666, 267, 399, 1, 0, 1
5991, 1, 1636422007527, 1636422008446, 919, 526, 393, 0, 1, 1
5994, 1, 1636422007843, 1636422008510, 667, 270, 397, 1, 0, 1
5995, 1, 1636422007903, 1636422008562, 659, 262, 397, 0, 0, 0
5996, 1, 1636422007912, 1636422008578, 666, 271, 395, 1, 0, 1
5997, 1, 1636422007972, 1636422008638, 666, 270, 396, 0, 0, 0
5998, 1, 1636422008148, 1636422008814, 666, 270, 396, 0, 0, 0
5999, 1, 1636422008175, 1636422008842, 667, 274, 393, 1, 0, 1
6000, 1, 1636422008203, 1636422008870, 667, 270, 397, 0, 0, 0
6001, 1, 1636422008299, 1636422008970, 671, 267, 404, 0, 0, 0
6002, 1, 1636422008447, 1636422009114, 667, 266, 401, 1, 0, 1
6003, 1, 1636422008511, 1636422009182, 671, 270, 401, 0, 0, 0
6004, 1, 1636422008569, 1636422009226, 657, 262, 395, 1, 0, 1
6005, 1, 1636422008580, 1636422009246, 666, 266, 400, 0, 0, 0
6006, 1, 1636422008639, 1636422009310, 671, 274, 397, 0, 0, 0
6007, 1, 1636422008816, 1636422009486, 670, 269, 401, 0, 0, 0
6008, 1, 1636422008844, 1636422009502, 658, 266, 392, 0, 0, 0
6009, 1, 1636422008872, 1636422009542, 670, 267, 403, 0, 1, 1
6010, 1, 1636422008971, 1636422009638, 667, 270, 397, 0, 0, 0
6011, 1, 1636422009116, 1636422009782, 666, 270, 396, 0, 0, 0
6012, 1, 1636422009183, 1636422009854, 671, 267, 404, 0, 1, 1
6014, 1, 1636422009247, 1636422009922, 675, 274, 401, 1, 0, 1
6015, 1, 1636422009312, 1636422009982, 670, 271, 399, 0, 0, 0
6018, 1, 1636422009543, 1636422010209, 666, 267, 399, 0, 1, 1
6016, 1, 1636422009488, 1636422010258, 770, 369, 401, 1, 0, 1
6019, 1, 1636422009639, 1636422010298, 659, 262, 397, 0, 0, 0
6020, 1, 1636422009784, 1636422010442, 658, 266, 392, 0, 0, 0
6021, 1, 1636422009855, 1636422010518, 663, 267, 396, 1, 0, 1
6022, 1, 1636422009924, 1636422010590, 666, 269, 397, 0, 0, 0
6023, 1, 1636422009984, 1636422010650, 666, 270, 396, 0, 0, 0
6025, 1, 1636422010260, 1636422010922, 662, 265, 397, 1, 0, 1
6026, 1, 1636422010305, 1636422010974, 669, 266, 403, 0, 0, 0
6027, 1, 1636422010450, 1636422011114, 664, 270, 394, 0, 0, 0
6029, 1, 1636422010591, 1636422011262, 671, 270, 401, 1, 0, 1
6030, 1, 1636422010652, 1636422011318, 666, 267, 399, 0, 0, 0
6031, 1, 1636422010925, 1636422011594, 669, 270, 399, 0, 0, 0
6032, 1, 1636422010975, 1636422011638, 663, 266, 397, 0, 0, 0
6033, 1, 1636422011116, 1636422011778, 662, 270, 392, 0, 0, 0
6034, 1, 1636422011264, 1636422011930, 666, 270, 396, 0, 0, 0
6035, 1, 1636422011320, 1636422011990, 670, 270, 400, 0, 2, 2
5905, 2, 1636422001824, 1636422012039, 10215, 1, 10214, 1, 0, 1
6037, 1, 1636422011642, 1636422012306, 664, 270, 394, 0, 0, 0
6038, 1, 1636422011782, 1636422012494, 712, 314, 398, 0, 43, 43
6040, 1, 1636422011992, 1636422012658, 666, 271, 395, 0, 1, 1
5916, 2, 1636422002556, 1636422012799, 10243, 0, 10243, 0, 0, 0
6041, 1, 1636422012170, 1636422012838, 668, 269, 399, 1, 0, 1
5919, 2, 1636422002655, 1636422012843, 10188, 3, 10185, 1, 1, 2
5918, 2, 1636422002622, 1636422012888, 10266, 48, 10218, 47, 1, 48
6043, 1, 1636422012496, 1636422013242, 746, 355, 391, 0, 87, 87
6044, 1, 1636422012660, 1636422013422, 762, 311, 451, 44, 0, 44
6045, 1, 1636422012889, 1636422013558, 669, 269, 400, 0, 1, 1
5932, 2, 1636422003431, 1636422013607, 10176, 0, 10176, 0, 0, 0
6048, 1, 1636422012979, 1636422013646, 667, 273, 394, 0, 0, 0
6046, 1, 1636422012978, 1636422013650, 672, 274, 398, 1, 1, 2
5933, 2, 1636422003471, 1636422013651, 10180, 0, 10180, 0, 0, 0
5937, 2, 1636422003695, 1636422013868, 10173, 0, 10173, 1, 0, 1
6050, 1, 1636422013424, 1636422014134, 710, 313, 397, 0, 45, 45
6051, 1, 1636422013559, 1636422014230, 671, 266, 405, 0, 0, 0
6053, 1, 1636422013653, 1636422014322, 669, 274, 395, 1, 1, 2
6052, 1, 1636422013652, 1636422014322, 670, 274, 396, 0, 0, 0
6055, 1, 1636422013778, 1636422014450, 672, 271, 401, 1, 0, 1
5946, 2, 1636422004304, 1636422014479, 10175, 0, 10175, 1, 0, 1
6057, 1, 1636422014136, 1636422014834, 698, 303, 395, 1, 39, 40
5951, 2, 1636422004667, 1636422014884, 10217, 1, 10216, 1, 1, 2
6059, 1, 1636422014324, 1636422015018, 694, 273, 421, 0, 2, 2
6061, 1, 1636422014482, 1636422015150, 668, 270, 398, 2, 0, 2
6062, 1, 1636422014610, 1636422015278, 668, 271, 397, 0, 1, 1
6066, 1, 1636422015152, 1636422015822, 670, 269, 401, 1, 0, 1
6067, 1, 1636422015280, 1636422015950, 670, 268, 402, 0, 0, 0
5975, 2, 1636422006300, 1636422016476, 10176, 0, 10176, 0, 0, 0
6069, 1, 1636422015952, 1636422016622, 670, 271, 399, 1, 2, 3
5979, 2, 1636422006603, 1636422016779, 10176, 0, 10176, 0, 0, 0
6013, 2, 1636422009235, 1636422019416, 10181, 0, 10181, 0, 0, 0
6017, 2, 1636422009509, 1636422019683, 10174, 0, 10174, 0, 0, 0
6024, 2, 1636422010210, 1636422020383, 10173, 0, 10173, 0, 0, 0
6028, 2, 1636422010522, 1636422020699, 10177, 0, 10177, 0, 0, 0
6036, 2, 1636422011595, 1636422021772, 10177, 0, 10177, 1, 0, 1
6039, 2, 1636422011932, 1636422022127, 10195, 0, 10195, 0, 0, 0
6042, 2, 1636422012308, 1636422022483, 10175, 0, 10175, 0, 0, 0
6047, 2, 1636422012979, 1636422023155, 10176, 0, 10176, 1, 0, 1
6049, 2, 1636422013243, 1636422023415, 10172, 0, 10172, 0, 0, 0
6054, 2, 1636422013739, 1636422023915, 10176, 1, 10175, 0, 0, 0
6080, 1, 1636422023286, 1636422023998, 712, 268, 444, 0, 0, 0
6056, 2, 1636422013998, 1636422024172, 10174, 1, 10173, 1, 0, 1
6058, 2, 1636422014231, 1636422024407, 10176, 0, 10176, 0, 0, 0
6060, 2, 1636422014324, 1636422024527, 10203, 1, 10202, 1, 0, 1
6082, 1, 1636422024000, 1636422024710, 710, 271, 439, 2, 0, 2
6083, 1, 1636422024042, 1636422024710, 668, 315, 353, 0, 47, 47
6084, 1, 1636422024302, 1636422024986, 684, 266, 418, 1, 0, 1
6063, 2, 1636422014836, 1636422025011, 10175, 0, 10175, 1, 0, 1
6064, 2, 1636422015014, 1636422025191, 10177, 1, 10176, 0, 0, 0
6085, 1, 1636422024542, 1636422025218, 676, 275, 401, 1, 0, 1
6065, 2, 1636422015020, 1636422025235, 10215, 0, 10215, 0, 0, 0
6086, 1, 1636422024658, 1636422025366, 708, 313, 395, 1, 42, 43
6088, 1, 1636422024712, 1636422025382, 670, 271, 399, 3, 0, 3
6089, 1, 1636422025013, 1636422025686, 673, 274, 399, 0, 8, 8
6091, 1, 1636422025243, 1636422025910, 667, 269, 398, 0, 0, 0
6092, 1, 1636422025322, 1636422025990, 668, 270, 398, 1, 0, 1
6093, 1, 1636422025330, 1636422025998, 668, 269, 399, 0, 0, 0
6068, 2, 1636422015824, 1636422026000, 10176, 1, 10175, 1, 1, 2
6094, 1, 1636422025368, 1636422026034, 666, 268, 398, 1, 0, 1
6097, 1, 1636422025911, 1636422026582, 671, 274, 397, 0, 1, 1
6099, 1, 1636422026001, 1636422026670, 669, 269, 400, 0, 1, 1
6098, 1, 1636422026001, 1636422026674, 673, 275, 398, 1, 2, 3
6100, 1, 1636422026036, 1636422026698, 662, 266, 396, 0, 1, 1
6070, 2, 1636422016606, 1636422026779, 10173, 1, 10172, 0, 0, 0
6101, 1, 1636422026134, 1636422026798, 664, 266, 398, 1, 0, 1
6071, 2, 1636422016624, 1636422026823, 10199, 1, 10198, 1, 0, 1
6072, 2, 1636422016910, 1636422027087, 10177, 0, 10177, 0, 0, 0
6102, 1, 1636422026584, 1636422027278, 694, 294, 400, 0, 21, 21
6104, 1, 1636422026675, 1636422027358, 683, 269, 414, 0, 1, 1
6106, 1, 1636422026824, 1636422027542, 718, 268, 450, 2, 0, 2
6107, 1, 1636422026910, 1636422027574, 664, 269, 395, 0, 0, 0
6108, 1, 1636422026955, 1636422027630, 675, 320, 355, 1, 46, 47
6109, 1, 1636422027218, 1636422027894, 676, 269, 407, 0, 0, 0
6110, 1, 1636422027280, 1636422027946, 666, 269, 397, 0, 0, 0
6111, 1, 1636422027360, 1636422028026, 666, 270, 396, 1, 0, 1
6112, 1, 1636422027543, 1636422028214, 671, 270, 401, 1, 0, 1
6113, 1, 1636422027576, 1636422028246, 670, 269, 401, 0, 1, 1
6114, 1, 1636422027632, 1636422028298, 666, 266, 400, 0, 0, 0
6115, 1, 1636422027896, 1636422028566, 670, 268, 402, 0, 0, 0
6116, 1, 1636422027948, 1636422028614, 666, 270, 396, 1, 0, 1
6117, 1, 1636422028028, 1636422028694, 666, 271, 395, 1, 1, 2
6118, 1, 1636422028215, 1636422028886, 671, 270, 401, 0, 0, 0
6120, 1, 1636422028300, 1636422028974, 674, 274, 400, 1, 0, 1
6122, 1, 1636422028615, 1636422029282, 667, 266, 401, 1, 0, 1
6123, 1, 1636422028695, 1636422029362, 667, 270, 397, 0, 0, 0
6124, 1, 1636422028887, 1636422029554, 667, 271, 396, 1, 1, 2
6125, 1, 1636422028976, 1636422029642, 666, 271, 395, 0, 0, 0
6073, 2, 1636422019547, 1636422029731, 10184, 1, 10183, 0, 0, 0
6126, 1, 1636422029284, 1636422029946, 662, 266, 396, 0, 1, 1
6074, 2, 1636422019814, 1636422029987, 10173, 0, 10173, 0, 0, 0
6127, 1, 1636422029364, 1636422030030, 666, 269, 397, 0, 1, 1
6128, 1, 1636422029556, 1636422030270, 714, 273, 441, 2, 0, 2
6129, 1, 1636422029644, 1636422030342, 698, 303, 395, 0, 31, 31
6130, 1, 1636422029862, 1636422030566, 704, 271, 433, 0, 2, 2
6131, 1, 1636422029990, 1636422030654, 664, 266, 398, 0, 0, 0
6075, 2, 1636422020514, 1636422030687, 10173, 0, 10173, 0, 0, 0
6132, 1, 1636422030031, 1636422030694, 663, 267, 396, 0, 1, 1
6133, 1, 1636422030114, 1636422030830, 716, 319, 397, 0, 0, 0
6134, 1, 1636422030271, 1636422030954, 683, 284, 399, 0, 14, 14
6076, 2, 1636422020831, 1636422031007, 10176, 0, 10176, 0, 0, 0
6135, 1, 1636422030343, 1636422031042, 699, 297, 402, 0, 30, 30
6136, 1, 1636422030568, 1636422031278, 710, 276, 434, 0, 6, 6
6137, 1, 1636422030689, 1636422031370, 681, 275, 406, 0, 7, 7
6138, 1, 1636422030699, 1636422031370, 671, 267, 404, 1, 1, 2
6139, 1, 1636422030818, 1636422031482, 664, 269, 395, 0, 0, 0
6140, 1, 1636422030832, 1636422031546, 714, 318, 396, 0, 1, 1
6141, 1, 1636422030955, 1636422031618, 663, 266, 397, 0, 0, 0
6142, 1, 1636422031044, 1636422031710, 666, 269, 397, 0, 1, 1
6143, 1, 1636422031138, 1636422031802, 664, 266, 398, 0, 0, 0
6145, 1, 1636422031371, 1636422032042, 671, 270, 401, 2, 0, 2
6146, 1, 1636422031372, 1636422032042, 670, 270, 400, 0, 0, 0
6077, 2, 1636422021902, 1636422032079, 10177, 0, 10177, 1, 0, 1
6147, 1, 1636422031484, 1636422032150, 666, 270, 396, 1, 0, 1
6149, 1, 1636422031622, 1636422032286, 664, 266, 398, 0, 0, 0
6150, 1, 1636422031711, 1636422032374, 663, 266, 397, 0, 0, 0
6078, 2, 1636422022258, 1636422032435, 10177, 0, 10177, 0, 0, 0
6151, 1, 1636422031803, 1636422032470, 667, 266, 401, 0, 0, 0
6152, 1, 1636422032081, 1636422032790, 709, 310, 399, 1, 39, 40
6079, 2, 1636422022614, 1636422032791, 10177, 0, 10177, 0, 0, 0
6155, 1, 1636422032214, 1636422032890, 676, 270, 406, 1, 2, 3
6156, 1, 1636422032288, 1636422032982, 694, 272, 422, 1, 0, 1
6157, 1, 1636422032379, 1636422033058, 679, 280, 399, 1, 10, 11
6159, 1, 1636422032566, 1636422033238, 672, 274, 398, 0, 7, 7
6161, 1, 1636422032892, 1636422033558, 666, 269, 397, 0, 0, 0
6162, 1, 1636422032922, 1636422033594, 672, 274, 398, 0, 1, 1
6163, 1, 1636422032983, 1636422033650, 667, 270, 397, 0, 0, 0
6081, 2, 1636422023546, 1636422033719, 10173, 0, 10173, 0, 0, 0
6164, 1, 1636422033060, 1636422033722, 662, 268, 394, 3, 0, 3
6165, 1, 1636422033239, 1636422033902, 663, 266, 397, 1, 0, 1
6167, 1, 1636422033595, 1636422034302, 707, 270, 437, 0, 0, 0
6169, 1, 1636422033726, 1636422034394, 668, 270, 398, 1, 0, 1
6170, 1, 1636422033850, 1636422034522, 672, 271, 401, 0, 1, 1
6087, 2, 1636422024712, 1636422034888, 10176, 0, 10176, 0, 0, 0
6174, 1, 1636422034524, 1636422035186, 662, 270, 392, 1, 1, 2
6090, 2, 1636422025142, 1636422035328, 10186, 1, 10185, 1, 1, 2
6095, 2, 1636422025384, 1636422035559, 10175, 0, 10175, 0, 0, 0
6175, 1, 1636422035018, 1636422035682, 664, 266, 398, 0, 0, 0
6096, 2, 1636422025687, 1636422035860, 10173, 0, 10173, 0, 0, 0
6177, 1, 1636422035458, 1636422036138, 680, 271, 409, 0, 0, 0
6179, 1, 1636422035690, 1636422036398, 708, 270, 438, 0, 0, 0
6178, 1, 1636422035684, 1636422036398, 714, 318, 396, 1, 0, 1
6180, 1, 1636422035990, 1636422036666, 676, 277, 399, 0, 0, 0
6181, 1, 1636422036139, 1636422036810, 671, 274, 397, 0, 0, 0
6103, 2, 1636422026672, 1636422036867, 10195, 0, 10195, 0, 0, 0
6105, 2, 1636422026703, 1636422036915, 10212, 1, 10211, 1, 0, 1
6183, 1, 1636422036400, 1636422037066, 666, 266, 400, 1, 0, 1
6182, 1, 1636422036400, 1636422037070, 670, 270, 400, 0, 0, 0
6184, 1, 1636422036668, 1636422037362, 694, 299, 395, 2, 26, 28
6186, 1, 1636422037002, 1636422037670, 668, 270, 398, 0, 0, 0
6187, 1, 1636422037042, 1636422037702, 660, 266, 394, 0, 0, 0
6189, 1, 1636422037072, 1636422037742, 670, 270, 400, 0, 0, 0
6190, 1, 1636422037363, 1636422038026, 663, 269, 394, 0, 0, 0
6191, 1, 1636422037672, 1636422038338, 666, 266, 400, 0, 0, 0
6192, 1, 1636422037704, 1636422038374, 670, 270, 400, 0, 0, 0
6119, 2, 1636422028248, 1636422038423, 10175, 1, 10174, 0, 1, 1
6121, 2, 1636422028568, 1636422038743, 10175, 1, 10174, 1, 0, 1
6195, 1, 1636422038339, 1636422039006, 667, 272, 395, 0, 2, 2
6196, 1, 1636422038376, 1636422039042, 666, 270, 396, 0, 1, 1
6197, 1, 1636422038554, 1636422039222, 668, 270, 398, 1, 0, 1
6198, 1, 1636422038874, 1636422039542, 668, 268, 400, 1, 0, 1
6200, 1, 1636422039044, 1636422039710, 666, 269, 397, 0, 0, 0
6201, 1, 1636422039224, 1636422039890, 666, 269, 397, 0, 0, 0
6202, 1, 1636422039544, 1636422040214, 670, 269, 401, 0, 0, 0
6203, 1, 1636422039711, 1636422040382, 671, 271, 400, 0, 0, 0
6204, 1, 1636422039892, 1636422040566, 674, 270, 404, 0, 0, 0
6205, 1, 1636422040215, 1636422040886, 671, 267, 404, 0, 0, 0
6206, 1, 1636422040383, 1636422041050, 667, 270, 397, 1, 0, 1
6144, 2, 1636422031279, 1636422041455, 10176, 0, 10176, 0, 0, 0
6148, 2, 1636422031547, 1636422041719, 10172, 0, 10172, 0, 0, 0
6209, 1, 1636422041052, 1636422041722, 670, 276, 394, 0, 7, 7
6210, 1, 1636422041586, 1636422042258, 672, 317, 355, 46, 0, 46
6153, 2, 1636422032081, 1636422042259, 10178, 1, 10177, 0, 0, 0
6154, 2, 1636422032152, 1636422042331, 10179, 0, 10179, 0, 0, 0
6211, 1, 1636422041723, 1636422042386, 663, 271, 392, 1, 1, 2
6212, 1, 1636422041850, 1636422042526, 676, 281, 395, 0, 0, 0
6158, 2, 1636422032471, 1636422042647, 10176, 0, 10176, 0, 0, 0
6213, 1, 1636422042261, 1636422042934, 673, 274, 399, 0, 0, 0
6160, 2, 1636422032793, 1636422042971, 10178, 1, 10177, 0, 0, 0
6214, 1, 1636422042389, 1636422043090, 701, 306, 395, 0, 43, 43
6215, 1, 1636422042422, 1636422043090, 668, 270, 398, 0, 6, 6
6216, 1, 1636422042462, 1636422043126, 664, 271, 393, 0, 1, 1
6217, 1, 1636422042527, 1636422043242, 715, 281, 434, 0, 15, 15
6218, 1, 1636422042778, 1636422043446, 668, 270, 398, 0, 0, 0
6219, 1, 1636422042973, 1636422043642, 669, 274, 395, 0, 0, 0
6221, 1, 1636422043092, 1636422043762, 670, 267, 403, 0, 1, 1
6220, 1, 1636422043092, 1636422043762, 670, 271, 399, 0, 1, 1
6166, 2, 1636422033560, 1636422043767, 10207, 0, 10207, 0, 0, 0
6222, 1, 1636422043102, 1636422043770, 668, 269, 399, 0, 0, 0
6223, 1, 1636422043128, 1636422043794, 666, 271, 395, 1, 0, 1
6168, 2, 1636422033652, 1636422043827, 10175, 0, 10175, 0, 0, 0
6224, 1, 1636422043243, 1636422043906, 663, 270, 393, 0, 0, 0
6171, 2, 1636422033905, 1636422044079, 10174, 1, 10173, 0, 1, 1
6225, 1, 1636422043447, 1636422044130, 683, 279, 404, 0, 11, 11
6227, 1, 1636422043769, 1636422044434, 665, 269, 396, 1, 2, 3
6228, 1, 1636422043769, 1636422044442, 673, 274, 399, 1, 0, 1
6229, 1, 1636422043771, 1636422044446, 675, 273, 402, 1, 0, 1
6172, 2, 1636422034303, 1636422044480, 10177, 0, 10177, 0, 1, 1
6230, 1, 1636422043828, 1636422044526, 698, 302, 396, 2, 34, 36
6173, 2, 1636422034396, 1636422044571, 10175, 0, 10175, 0, 0, 0
6232, 1, 1636422043914, 1636422044614, 700, 266, 434, 2, 0, 2
6233, 1, 1636422043958, 1636422044662, 704, 272, 432, 1, 0, 1
6234, 1, 1636422044131, 1636422044842, 711, 308, 403, 2, 36, 38
6235, 1, 1636422044210, 1636422044930, 720, 319, 401, 1, 44, 45
6236, 1, 1636422044482, 1636422045146, 664, 263, 401, 1, 0, 1
6238, 1, 1636422044482, 1636422045154, 672, 272, 400, 1, 2, 3
6240, 1, 1636422044610, 1636422045274, 664, 270, 394, 0, 1, 1
6241, 1, 1636422044615, 1636422045278, 663, 266, 397, 0, 1, 1
6242, 1, 1636422044664, 1636422045334, 670, 269, 401, 0, 0, 0
6243, 1, 1636422044702, 1636422045370, 668, 269, 399, 1, 0, 1
6176, 2, 1636422035190, 1636422045375, 10185, 0, 10185, 1, 0, 1
6245, 1, 1636422044931, 1636422045638, 707, 312, 395, 0, 42, 42
6246, 1, 1636422045147, 1636422045822, 675, 278, 397, 1, 10, 11
6247, 1, 1636422045155, 1636422045826, 671, 266, 405, 0, 0, 0
6249, 1, 1636422045281, 1636422045958, 677, 271, 406, 0, 1, 1
6248, 1, 1636422045276, 1636422045958, 682, 270, 412, 0, 1, 1
6250, 1, 1636422045376, 1636422046038, 662, 267, 395, 1, 0, 1
6251, 1, 1636422045377, 1636422046042, 665, 266, 399, 2, 0, 2
6252, 1, 1636422045506, 1636422046170, 664, 270, 394, 0, 0, 0
6253, 1, 1636422045639, 1636422046306, 667, 270, 397, 1, 0, 1
6255, 1, 1636422045827, 1636422046494, 667, 262, 405, 0, 0, 0
6254, 1, 1636422045824, 1636422046582, 758, 357, 401, 0, 1, 1
6258, 1, 1636422046043, 1636422046710, 667, 271, 396, 0, 0, 0
6259, 1, 1636422046043, 1636422046714, 671, 270, 401, 1, 0, 1
6260, 1, 1636422046172, 1636422046834, 662, 266, 396, 0, 0, 0
6257, 1, 1636422045960, 1636422046850, 890, 494, 396, 1, 0, 1
6185, 2, 1636422036812, 1636422047003, 10191, 0, 10191, 1, 0, 1
6262, 1, 1636422046495, 1636422047166, 671, 274, 397, 1, 1, 2
6188, 2, 1636422037067, 1636422047243, 10176, 0, 10176, 0, 0, 0
6263, 1, 1636422046584, 1636422047270, 686, 289, 397, 1, 19, 20
6264, 1, 1636422046712, 1636422047378, 666, 271, 395, 0, 2, 2
6265, 1, 1636422046716, 1636422047390, 674, 270, 404, 2, 0, 2
6266, 1, 1636422046838, 1636422047542, 704, 271, 433, 0, 0, 0
6268, 1, 1636422047134, 1636422047822, 688, 270, 418, 0, 0, 0
6269, 1, 1636422047168, 1636422047838, 670, 274, 396, 1, 1, 2
6193, 2, 1636422037744, 1636422047919, 10175, 0, 10175, 0, 0, 0
6271, 1, 1636422047374, 1636422048046, 672, 269, 403, 0, 0, 0
6272, 1, 1636422047379, 1636422048050, 671, 265, 406, 0, 0, 0
6273, 1, 1636422047391, 1636422048062, 671, 273, 398, 0, 0, 0
6194, 2, 1636422038029, 1636422048203, 10174, 0, 10174, 0, 0, 0
6275, 1, 1636422047823, 1636422048502, 679, 270, 409, 0, 0, 0
6279, 1, 1636422048052, 1636422048746, 694, 270, 424, 2, 0, 2
6280, 1, 1636422048064, 1636422048746, 682, 272, 410, 2, 0, 2
6278, 1, 1636422048050, 1636422048746, 696, 272, 424, 2, 2, 4
6277, 1, 1636422048048, 1636422048750, 702, 271, 431, 0, 2, 2
6281, 1, 1636422048334, 1636422049018, 684, 288, 396, 0, 0, 0
6282, 1, 1636422048503, 1636422049178, 675, 270, 405, 1, 0, 1
6199, 2, 1636422039008, 1636422049191, 10183, 0, 10183, 0, 0, 0
6285, 1, 1636422048748, 1636422049458, 710, 314, 396, 3, 38, 41
6284, 1, 1636422048748, 1636422049458, 710, 313, 397, 0, 44, 44
6286, 1, 1636422048752, 1636422049458, 706, 309, 397, 0, 38, 38
6287, 1, 1636422049020, 1636422049726, 706, 266, 440, 0, 0, 0
6289, 1, 1636422049322, 1636422049990, 668, 271, 397, 1, 0, 1
6292, 1, 1636422049460, 1636422050126, 666, 270, 396, 1, 0, 1
6290, 1, 1636422049459, 1636422050126, 667, 268, 399, 1, 0, 1
6293, 1, 1636422049728, 1636422050394, 666, 271, 395, 0, 0, 0
6294, 1, 1636422049992, 1636422050662, 670, 271, 399, 0, 1, 1
6207, 2, 1636422040568, 1636422050743, 10175, 0, 10175, 0, 0, 0
6296, 1, 1636422050128, 1636422050794, 666, 269, 397, 2, 0, 2
6295, 1, 1636422050128, 1636422050794, 666, 270, 396, 0, 0, 0
6208, 2, 1636422040888, 1636422051063, 10175, 1, 10174, 1, 0, 1
6297, 1, 1636422050396, 1636422051094, 698, 302, 396, 0, 34, 34
6298, 1, 1636422050664, 1636422051334, 670, 270, 400, 0, 0, 0
6300, 1, 1636422050795, 1636422051462, 667, 269, 398, 1, 0, 1
6299, 1, 1636422050795, 1636422051470, 675, 274, 401, 3, 0, 3
6301, 1, 1636422050874, 1636422051538, 664, 269, 395, 0, 1, 1
6302, 1, 1636422051096, 1636422051766, 670, 270, 400, 1, 0, 1
6303, 1, 1636422051194, 1636422051866, 672, 270, 402, 1, 0, 1
6304, 1, 1636422051335, 1636422052010, 675, 269, 406, 0, 0, 0
6305, 1, 1636422051464, 1636422052138, 674, 273, 401, 0, 1, 1
6306, 1, 1636422051472, 1636422052146, 674, 274, 400, 0, 0, 0
6307, 1, 1636422051540, 1636422052214, 674, 269, 405, 0, 1, 1
6308, 1, 1636422051768, 1636422052438, 670, 275, 395, 0, 0, 0
6309, 1, 1636422051868, 1636422052550, 682, 270, 412, 0, 0, 0
6310, 1, 1636422052011, 1636422052686, 675, 274, 401, 0, 0, 0
6311, 1, 1636422052140, 1636422052806, 666, 267, 399, 0, 0, 0
6312, 1, 1636422052148, 1636422052814, 666, 271, 395, 0, 1, 1
6313, 1, 1636422052216, 1636422052890, 674, 273, 401, 0, 0, 0
6314, 1, 1636422052440, 1636422053106, 666, 270, 396, 0, 0, 0
6315, 1, 1636422052551, 1636422053218, 667, 271, 396, 3, 0, 3
6316, 1, 1636422052687, 1636422053354, 667, 269, 398, 0, 0, 0
6317, 1, 1636422052808, 1636422053482, 674, 273, 401, 0, 0, 0
6318, 1, 1636422052816, 1636422053486, 670, 271, 399, 0, 0, 0
6319, 1, 1636422052892, 1636422053554, 662, 266, 396, 0, 0, 0
6320, 1, 1636422053108, 1636422053774, 666, 270, 396, 1, 0, 1
6226, 2, 1636422043644, 1636422053871, 10227, 0, 10227, 0, 0, 0
6321, 1, 1636422053220, 1636422053890, 670, 269, 401, 0, 1, 1
6322, 1, 1636422053356, 1636422054022, 666, 270, 396, 1, 1, 2
6231, 2, 1636422043909, 1636422054127, 10218, 0, 10218, 1, 0, 1
6323, 1, 1636422053484, 1636422054150, 666, 271, 395, 0, 1, 1
6324, 1, 1636422053488, 1636422054154, 666, 271, 395, 0, 0, 0
6325, 1, 1636422053559, 1636422054226, 667, 266, 401, 0, 2, 2
6326, 1, 1636422053776, 1636422054482, 706, 301, 405, 0, 34, 34
6327, 1, 1636422053892, 1636422054582, 690, 290, 400, 1, 18, 19
6237, 2, 1636422044482, 1636422054663, 10181, 1, 10180, 0, 1, 1
6328, 1, 1636422054002, 1636422054702, 700, 267, 433, 0, 1, 1
6239, 2, 1636422044573, 1636422054707, 10134, 0, 10134, 0, 0, 0
6329, 1, 1636422054024, 1636422054710, 686, 271, 415, 1, 0, 1
6331, 1, 1636422054155, 1636422054818, 663, 268, 395, 1, 0, 1
6330, 1, 1636422054152, 1636422054822, 670, 271, 399, 1, 1, 2
6332, 1, 1636422054228, 1636422054974, 746, 339, 407, 0, 65, 65
6244, 2, 1636422044843, 1636422055019, 10176, 0, 10176, 0, 0, 0
6333, 1, 1636422054258, 1636422055062, 804, 320, 484, 1, 1, 2
6334, 1, 1636422054484, 1636422055158, 674, 273, 401, 1, 6, 7
6335, 1, 1636422054584, 1636422055286, 702, 273, 429, 0, 0, 0
6336, 1, 1636422054709, 1636422055374, 665, 270, 395, 0, 2, 2
6337, 1, 1636422054711, 1636422055382, 671, 271, 400, 2, 0, 2
6338, 1, 1636422054798, 1636422055462, 664, 263, 401, 0, 0, 0
6339, 1, 1636422054822, 1636422055494, 672, 270, 402, 0, 0, 0
6341, 1, 1636422054834, 1636422055502, 668, 271, 397, 0, 1, 1
6342, 1, 1636422055020, 1636422055642, 622, 266, 356, 0, 1, 1
6343, 1, 1636422055064, 1636422055734, 670, 271, 399, 0, 1, 1
6344, 1, 1636422055150, 1636422055818, 668, 269, 399, 0, 0, 0
6345, 1, 1636422055159, 1636422055821, 662, 269, 393, 0, 1, 1
6346, 1, 1636422055288, 1636422055954, 666, 270, 396, 1, 0, 1
6347, 1, 1636422055375, 1636422056046, 671, 275, 396, 2, 0, 2
6348, 1, 1636422055383, 1636422056050, 667, 266, 401, 0, 0, 0
6349, 1, 1636422055464, 1636422056130, 666, 270, 396, 0, 0, 0
6256, 2, 1636422045959, 1636422056135, 10176, 0, 10176, 1, 0, 1
6351, 1, 1636422055503, 1636422056174, 671, 271, 400, 0, 0, 0
6352, 1, 1636422055644, 1636422056310, 666, 264, 402, 0, 1, 1
6353, 1, 1636422055735, 1636422056401, 666, 272, 394, 0, 8, 8
6261, 2, 1636422046307, 1636422056487, 10180, 0, 10180, 0, 0, 0
6354, 1, 1636422055819, 1636422056490, 671, 274, 397, 0, 7, 7
6356, 1, 1636422055956, 1636422056626, 670, 269, 401, 0, 0, 0
6358, 1, 1636422056051, 1636422056754, 703, 305, 398, 1, 39, 40
6357, 1, 1636422056047, 1636422056754, 707, 309, 398, 2, 35, 37
6360, 1, 1636422056176, 1636422056842, 666, 272, 394, 0, 3, 3
6359, 1, 1636422056138, 1636422056842, 704, 311, 393, 1, 45, 46
6362, 1, 1636422056312, 1636422056974, 662, 265, 397, 0, 0, 0
6267, 2, 1636422046852, 1636422057051, 10199, 0, 10199, 1, 0, 1
6363, 1, 1636422056402, 1636422057070, 668, 263, 405, 1, 0, 1
6361, 1, 1636422056266, 1636422057110, 844, 446, 398, 0, 1, 1
6364, 1, 1636422056492, 1636422057158, 666, 266, 400, 0, 0, 0
6366, 1, 1636422056627, 1636422057318, 691, 292, 399, 0, 22, 22
6365, 1, 1636422056618, 1636422057410, 792, 391, 401, 0, 30, 30
6368, 1, 1636422056756, 1636422057418, 662, 265, 397, 0, 0, 0
6270, 2, 1636422047272, 1636422057447, 10175, 0, 10175, 0, 0, 0
6369, 1, 1636422056844, 1636422057514, 670, 271, 399, 3, 1, 4
6370, 1, 1636422056844, 1636422057518, 674, 269, 405, 0, 1, 1
6371, 1, 1636422056977, 1636422057642, 665, 270, 395, 0, 0, 0
6274, 2, 1636422047543, 1636422057715, 10172, 0, 10172, 0, 0, 0
6372, 1, 1636422057071, 1636422057734, 663, 265, 398, 0, 1, 1
6373, 1, 1636422057111, 1636422057802, 691, 291, 400, 2, 26, 28
6374, 1, 1636422057159, 1636422057826, 667, 266, 401, 0, 1, 1
6375, 1, 1636422057182, 1636422057902, 720, 322, 398, 1, 47, 48
6376, 1, 1636422057320, 1636422057990, 670, 275, 395, 0, 0, 0
6276, 2, 1636422047840, 1636422058015, 10175, 0, 10175, 0, 0, 0
6378, 1, 1636422057449, 1636422058110, 661, 267, 394, 0, 1, 1
6377, 1, 1636422057449, 1636422058110, 661, 267, 394, 1, 1, 2
6379, 1, 1636422057515, 1636422058178, 663, 268, 395, 1, 1, 2
6380, 1, 1636422057519, 1636422058190, 671, 271, 400, 1, 0, 1
6382, 1, 1636422057644, 1636422058310, 666, 269, 397, 0, 0, 0
6383, 1, 1636422057737, 1636422058402, 665, 270, 395, 1, 0, 1
6384, 1, 1636422057803, 1636422058466, 663, 265, 398, 0, 0, 0
6385, 1, 1636422057827, 1636422058494, 667, 267, 400, 2, 0, 2
6386, 1, 1636422057846, 1636422058562, 716, 279, 437, 0, 0, 0
6387, 1, 1636422057903, 1636422058594, 691, 271, 420, 1, 1, 2
6388, 1, 1636422058017, 1636422058686, 669, 269, 400, 0, 0, 0
6389, 1, 1636422058115, 1636422058782, 667, 267, 400, 2, 0, 2
6390, 1, 1636422058116, 1636422058782, 666, 266, 400, 2, 0, 2
6393, 1, 1636422058192, 1636422058846, 654, 259, 395, 0, 0, 0
6392, 1, 1636422058181, 1636422058846, 665, 267, 398, 0, 1, 1
6283, 2, 1636422048748, 1636422058924, 10176, 1, 10175, 0, 0, 0
6395, 1, 1636422058403, 1636422059062, 659, 266, 393, 0, 0, 0
6396, 1, 1636422058469, 1636422059142, 673, 275, 398, 0, 2, 2
6397, 1, 1636422058495, 1636422059194, 699, 293, 406, 0, 27, 27
6398, 1, 1636422058563, 1636422059226, 663, 266, 397, 1, 0, 1
6399, 1, 1636422058596, 1636422059282, 686, 286, 400, 0, 19, 19
6288, 2, 1636422049193, 1636422059371, 10178, 0, 10178, 0, 0, 0
6401, 1, 1636422058783, 1636422059462, 679, 271, 408, 0, 0, 0
6402, 1, 1636422058783, 1636422059466, 683, 271, 412, 0, 0, 0
6403, 1, 1636422058847, 1636422059518, 671, 270, 401, 0, 0, 0
6291, 2, 1636422049460, 1636422059636, 10176, 0, 10176, 0, 0, 0
6406, 1, 1636422059069, 1636422059730, 661, 267, 394, 0, 1, 1
6407, 1, 1636422059143, 1636422059814, 671, 274, 397, 1, 10, 11
6408, 1, 1636422059195, 1636422059902, 707, 310, 397, 0, 43, 43
6409, 1, 1636422059229, 1636422059906, 677, 269, 408, 2, 1, 3
6410, 1, 1636422059284, 1636422059994, 710, 314, 396, 0, 44, 44
6411, 1, 1636422059463, 1636422060174, 711, 270, 441, 2, 1, 3
6412, 1, 1636422059467, 1636422060174, 707, 270, 437, 0, 1, 1
6413, 1, 1636422059502, 1636422060178, 676, 271, 405, 3, 0, 3
6414, 1, 1636422059519, 1636422060218, 699, 268, 431, 1, 1, 2
6415, 1, 1636422059735, 1636422060437, 702, 311, 391, 1, 0, 1
6417, 1, 1636422059816, 1636422060482, 666, 271, 395, 1, 1, 2
6419, 1, 1636422059907, 1636422060574, 667, 270, 397, 1, 1, 2
6418, 1, 1636422059904, 1636422060578, 674, 268, 406, 0, 1, 1
6420, 1, 1636422059995, 1636422060666, 671, 270, 401, 2, 1, 3
6423, 1, 1636422060179, 1636422060838, 659, 262, 397, 0, 0, 0
6421, 1, 1636422060175, 1636422060842, 667, 266, 401, 1, 0, 1
6422, 1, 1636422060175, 1636422060842, 667, 265, 402, 0, 0, 0
6424, 1, 1636422060219, 1636422060882, 663, 268, 395, 0, 1, 1
6426, 1, 1636422060483, 1636422061146, 663, 266, 397, 1, 0, 1
6427, 1, 1636422060575, 1636422061234, 659, 267, 392, 0, 1, 1
6428, 1, 1636422060579, 1636422061242, 663, 266, 397, 0, 0, 0
6429, 1, 1636422060667, 1636422061338, 671, 270, 401, 1, 0, 1
6432, 1, 1636422060845, 1636422061514, 669, 270, 399, 0, 0, 0
6430, 1, 1636422060843, 1636422061518, 675, 275, 400, 0, 1, 1
6431, 1, 1636422060843, 1636422061518, 675, 275, 400, 1, 0, 1
6434, 1, 1636422061150, 1636422061814, 664, 266, 398, 0, 1, 1
6435, 1, 1636422061241, 1636422061910, 669, 273, 396, 1, 0, 1
6437, 1, 1636422061340, 1636422062002, 662, 267, 395, 0, 0, 0
6438, 1, 1636422061516, 1636422062186, 670, 272, 398, 0, 0, 0
6439, 1, 1636422061519, 1636422062190, 671, 270, 401, 2, 1, 3
6441, 1, 1636422061816, 1636422062478, 662, 266, 396, 1, 0, 1
6442, 1, 1636422061912, 1636422062574, 662, 270, 392, 0, 0, 0
6443, 1, 1636422062006, 1636422062670, 664, 270, 394, 0, 0, 0
6444, 1, 1636422062188, 1636422062858, 670, 270, 400, 1, 0, 1
6445, 1, 1636422062192, 1636422062858, 666, 267, 399, 0, 1, 1
6447, 1, 1636422062578, 1636422063246, 668, 269, 399, 0, 0, 0
6448, 1, 1636422062672, 1636422063338, 666, 270, 396, 0, 0, 0
6450, 1, 1636422062859, 1636422063530, 671, 270, 401, 1, 0, 1
6451, 1, 1636422063248, 1636422063914, 666, 275, 391, 0, 1, 1
6453, 1, 1636422063532, 1636422064198, 666, 269, 397, 0, 0, 0
6455, 1, 1636422064200, 1636422064870, 670, 271, 399, 1, 0, 1
6340, 2, 1636422054823, 1636422065004, 10181, 0, 10181, 0, 0, 0
6456, 1, 1636422064872, 1636422065542, 670, 316, 354, 0, 45, 45
6350, 2, 1636422055496, 1636422065671, 10175, 1, 10174, 0, 0, 0
6457, 1, 1636422065134, 1636422065806, 672, 270, 402, 0, 1, 1
6355, 2, 1636422055825, 1636422066000, 10175, 0, 10175, 0, 1, 1
6459, 1, 1636422065802, 1636422066466, 664, 270, 394, 3, 0, 3
6460, 1, 1636422065808, 1636422066474, 666, 271, 395, 0, 0, 0
6461, 1, 1636422066130, 1636422066798, 668, 269, 399, 0, 1, 1
6367, 2, 1636422056756, 1636422066931, 10175, 2, 10173, 2, 0, 2
6462, 1, 1636422066468, 1636422067134, 666, 270, 396, 0, 1, 1
6463, 1, 1636422066475, 1636422067146, 671, 271, 400, 3, 0, 3
6464, 1, 1636422066800, 1636422067474, 674, 267, 407, 0, 0, 0
6465, 1, 1636422067062, 1636422067730, 668, 270, 398, 0, 0, 0
6381, 2, 1636422057578, 1636422067764, 10186, 1, 10185, 1, 0, 1
6466, 1, 1636422067136, 1636422067802, 666, 269, 397, 0, 1, 1
6467, 1, 1636422067148, 1636422067814, 666, 269, 397, 1, 0, 1
6468, 1, 1636422067476, 1636422068142, 666, 274, 392, 0, 0, 0
6391, 2, 1636422058150, 1636422068327, 10177, 0, 10177, 0, 0, 0
6469, 1, 1636422067765, 1636422068430, 665, 270, 395, 0, 0, 0
6470, 1, 1636422067804, 1636422068470, 666, 270, 396, 0, 0, 0
6471, 1, 1636422067816, 1636422068482, 666, 270, 396, 0, 0, 0
6394, 2, 1636422058312, 1636422068487, 10175, 1, 10174, 1, 0, 1
6472, 1, 1636422068144, 1636422068850, 706, 306, 400, 0, 33, 33
6400, 2, 1636422058688, 1636422068864, 10176, 0, 10176, 0, 1, 1
6404, 2, 1636422058859, 1636422069031, 10172, 0, 10172, 0, 0, 0
6473, 1, 1636422068431, 1636422069130, 699, 300, 399, 0, 30, 30
6474, 1, 1636422068488, 1636422069154, 666, 270, 396, 0, 1, 1
6475, 1, 1636422068488, 1636422069154, 666, 268, 398, 0, 0, 0
6405, 2, 1636422059054, 1636422069231, 10177, 0, 10177, 0, 0, 0
6476, 1, 1636422068618, 1636422069310, 692, 298, 394, 2, 30, 32
6477, 1, 1636422068866, 1636422069586, 720, 288, 432, 1, 18, 19
6478, 1, 1636422069032, 1636422069698, 666, 269, 397, 0, 0, 0
6479, 1, 1636422069132, 1636422069806, 674, 266, 408, 0, 0, 0
6482, 1, 1636422069162, 1636422069822, 660, 267, 393, 1, 1, 2
6480, 1, 1636422069156, 1636422069822, 666, 270, 396, 0, 1, 1
6481, 1, 1636422069156, 1636422069822, 666, 264, 402, 0, 0, 0
6416, 2, 1636422059766, 1636422069943, 10177, 1, 10176, 0, 0, 0
6483, 1, 1636422069312, 1636422069978, 666, 266, 400, 0, 0, 0
6484, 1, 1636422069588, 1636422070302, 714, 267, 447, 0, 0, 0
6485, 1, 1636422069700, 1636422070390, 690, 289, 401, 1, 22, 23
6486, 1, 1636422069808, 1636422070482, 674, 272, 402, 0, 0, 0
6487, 1, 1636422069824, 1636422070530, 706, 271, 435, 1, 1, 2
6489, 1, 1636422069825, 1636422070530, 705, 271, 434, 1, 1, 2
6490, 1, 1636422069980, 1636422070650, 670, 269, 401, 0, 0, 0
6425, 2, 1636422060438, 1636422070754, 10316, 96, 10220, 0, 0, 0
6491, 1, 1636422070304, 1636422071018, 714, 324, 390, 1, 53, 54
6433, 2, 1636422060885, 1636422071059, 10174, 1, 10173, 0, 1, 1
6492, 1, 1636422070392, 1636422071114, 722, 321, 401, 0, 53, 53
6493, 1, 1636422070483, 1636422071202, 719, 323, 396, 0, 53, 53
6495, 1, 1636422070652, 1636422071338, 686, 274, 412, 1, 0, 1
6436, 2, 1636422061245, 1636422071420, 10175, 0, 10175, 0, 0, 0
6496, 1, 1636422070838, 1636422071506, 668, 270, 398, 0, 1, 1
6440, 2, 1636422061520, 1636422071699, 10179, 0, 10179, 0, 0, 0
6498, 1, 1636422071116, 1636422071782, 666, 270, 396, 0, 1, 1
6499, 1, 1636422071204, 1636422071870, 666, 267, 399, 0, 0, 0
6500, 1, 1636422071339, 1636422072006, 667, 271, 396, 0, 0, 0
6502, 1, 1636422071784, 1636422072450, 666, 269, 397, 1, 1, 2
6503, 1, 1636422071830, 1636422072494, 664, 266, 398, 0, 0, 0
6446, 2, 1636422062483, 1636422072660, 10177, 0, 10177, 1, 0, 1
6504, 1, 1636422072007, 1636422072674, 667, 270, 397, 2, 0, 2
6449, 2, 1636422062859, 1636422073035, 10176, 1, 10175, 1, 0, 1
6505, 1, 1636422072451, 1636422073118, 667, 270, 397, 0, 1, 1
6506, 1, 1636422072496, 1636422073198, 702, 270, 432, 0, 0, 0
6507, 1, 1636422072676, 1636422073338, 662, 266, 396, 1, 0, 1
6452, 2, 1636422063340, 1636422073516, 10176, 0, 10176, 0, 0, 0
6508, 1, 1636422073120, 1636422073794, 674, 272, 402, 0, 0, 0
6509, 1, 1636422073200, 1636422073870, 670, 274, 396, 1, 6, 7
6454, 2, 1636422063915, 1636422074088, 10173, 0, 10173, 0, 0, 0
6511, 1, 1636422073872, 1636422074542, 670, 270, 400, 1, 0, 1
6512, 1, 1636422074543, 1636422075222, 679, 271, 408, 1, 1, 2
6458, 2, 1636422065543, 1636422075719, 10176, 0, 10176, 1, 0, 1
6513, 1, 1636422075224, 1636422075890, 666, 271, 395, 0, 0, 0
6514, 1, 1636422075854, 1636422076518, 664, 270, 394, 0, 0, 0
6515, 1, 1636422075891, 1636422076558, 667, 266, 401, 0, 0, 0
6488, 2, 1636422069824, 1636422080035, 10211, 3, 10208, 0, 1, 1
6494, 2, 1636422070532, 1636422080708, 10176, 0, 10176, 0, 0, 0
6497, 2, 1636422071060, 1636422081235, 10175, 0, 10175, 0, 0, 0
6518, 1, 1636422080838, 1636422081502, 664, 271, 393, 1, 1, 2
6501, 2, 1636422071508, 1636422081683, 10175, 0, 10175, 0, 0, 0
6522, 1, 1636422080839, 1636422081774, 935, 538, 397, 0, 1, 1
6528, 1, 1636422081814, 1636422082482, 668, 268, 400, 0, 0, 0
6529, 1, 1636422082484, 1636422083154, 670, 269, 401, 0, 0, 0
6530, 1, 1636422083155, 1636422083826, 671, 270, 401, 0, 1, 1
6510, 2, 1636422073796, 1636422083972, 10176, 1, 10175, 2, 1, 3
6531, 1, 1636422083828, 1636422084514, 686, 271, 415, 0, 0, 0
6533, 1, 1636422084516, 1636422085190, 674, 269, 405, 0, 0, 0
6534, 1, 1636422085192, 1636422085866, 674, 268, 406, 0, 0, 0
6535, 1, 1636422085867, 1636422086530, 663, 267, 396, 2, 0, 2
6516, 2, 1636422076520, 1636422086695, 10175, 1, 10174, 0, 0, 0
6537, 1, 1636422086826, 1636422087494, 668, 271, 397, 0, 0, 0
6538, 1, 1636422087496, 1636422088166, 670, 269, 401, 1, 0, 1
6539, 1, 1636422088168, 1636422088834, 666, 270, 396, 0, 1, 1
6540, 1, 1636422088836, 1636422089502, 666, 271, 395, 0, 0, 0
6541, 1, 1636422089504, 1636422090174, 670, 270, 400, 0, 1, 1
6517, 2, 1636422080167, 1636422090344, 10177, 0, 10177, 0, 1, 1
6542, 1, 1636422090176, 1636422090878, 702, 267, 435, 0, 0, 0
6524, 2, 1636422080840, 1636422091012, 10172, 1, 10171, 2, 0, 2
6523, 2, 1636422080840, 1636422091055, 10215, 0, 10215, 0, 0, 0
6520, 2, 1636422080839, 1636422091100, 10261, 1, 10260, 1, 0, 1
6519, 2, 1636422080838, 1636422091148, 10310, 1, 10309, 0, 1, 1
6521, 2, 1636422080839, 1636422091196, 10357, 0, 10357, 0, 0, 0
6525, 2, 1636422081366, 1636422091540, 10174, 0, 10174, 0, 1, 1
6526, 2, 1636422081503, 1636422091683, 10180, 0, 10180, 0, 0, 0
6543, 1, 1636422090880, 1636422091734, 854, 500, 354, 1, 229, 230
6527, 2, 1636422081776, 1636422091952, 10176, 0, 10176, 0, 1, 1
6549, 1, 1636422091810, 1636422092494, 684, 272, 412, 1, 0, 1
6550, 1, 1636422092082, 1636422092762, 680, 286, 394, 1, 0, 1
6551, 1, 1636422092496, 1636422093162, 666, 270, 396, 0, 0, 0
6552, 1, 1636422092764, 1636422093442, 678, 275, 403, 1, 1, 2
6553, 1, 1636422093164, 1636422093834, 670, 271, 399, 0, 1, 1
6554, 1, 1636422093444, 1636422094110, 666, 270, 396, 0, 0, 0
6532, 2, 1636422084102, 1636422094280, 10178, 1, 10177, 1, 0, 1
6555, 1, 1636422093835, 1636422094550, 715, 312, 403, 0, 44, 44
6556, 1, 1636422094112, 1636422094822, 710, 272, 438, 0, 0, 0
6557, 1, 1636422094552, 1636422095218, 666, 269, 397, 1, 0, 1
6558, 1, 1636422094824, 1636422095490, 666, 270, 396, 1, 0, 1
6559, 1, 1636422095220, 1636422095886, 666, 271, 395, 0, 2, 2
6560, 1, 1636422095492, 1636422096158, 666, 271, 395, 1, 0, 1
6561, 1, 1636422095888, 1636422096558, 670, 271, 399, 0, 0, 0
6536, 2, 1636422086533, 1636422096743, 10210, 0, 10210, 0, 0, 0
6562, 1, 1636422096159, 1636422096826, 667, 270, 397, 1, 1, 2
6544, 2, 1636422091282, 1636422101460, 10178, 0, 10178, 0, 0, 0
6547, 2, 1636422091690, 1636422101863, 10173, 1, 10172, 1, 0, 1
6546, 2, 1636422091686, 1636422101907, 10221, 0, 10221, 0, 0, 0
6545, 2, 1636422091686, 1636422101951, 10265, 1, 10264, 1, 0, 1
6548, 2, 1636422091735, 1636422101999, 10264, 0, 10264, 0, 0, 0
6564, 1, 1636422101590, 1636422102354, 764, 319, 445, 0, 50, 50
6565, 1, 1636422102042, 1636422102702, 660, 266, 394, 0, 1, 1
6569, 1, 1636422102355, 1636422103018, 663, 266, 397, 0, 0, 0
6570, 1, 1636422102708, 1636422103370, 662, 270, 392, 0, 1, 1
6571, 1, 1636422103021, 1636422103682, 661, 267, 394, 3, 0, 3
6572, 1, 1636422103374, 1636422104042, 668, 272, 396, 0, 2, 2
6573, 1, 1636422103687, 1636422104350, 663, 266, 397, 0, 0, 0
6574, 1, 1636422104044, 1636422104706, 662, 271, 391, 1, 0, 1
6575, 1, 1636422104353, 1636422105018, 665, 270, 395, 0, 0, 0
6576, 1, 1636422104710, 1636422105374, 664, 271, 393, 1, 0, 1
6577, 1, 1636422105019, 1636422105690, 671, 269, 402, 0, 1, 1
6578, 1, 1636422105376, 1636422106042, 666, 270, 396, 0, 1, 1
6579, 1, 1636422105691, 1636422106358, 667, 266, 401, 0, 0, 0
6580, 1, 1636422106044, 1636422106706, 662, 270, 392, 0, 0, 0
6563, 2, 1636422096870, 1636422107043, 10173, 0, 10173, 0, 0, 0
6566, 2, 1636422102042, 1636422112220, 10178, 0, 10178, 1, 0, 1
6568, 2, 1636422102086, 1636422112267, 10181, 1, 10180, 0, 1, 1
6567, 2, 1636422102043, 1636422112312, 10269, 1, 10268, 1, 0, 1
6583, 1, 1636422112402, 1636422113074, 672, 272, 400, 0, 0, 0
6584, 1, 1636422112442, 1636422113346, 904, 506, 398, 3, 0, 3
6585, 1, 1636422113076, 1636422113742, 666, 268, 398, 1, 0, 1
6586, 1, 1636422113348, 1636422114018, 670, 265, 405, 0, 0, 0
6587, 1, 1636422113744, 1636422114414, 670, 271, 399, 1, 0, 1
6588, 1, 1636422114020, 1636422114682, 662, 267, 395, 0, 1, 1
6589, 1, 1636422114416, 1636422115086, 670, 272, 398, 0, 2, 2
6590, 1, 1636422114686, 1636422115354, 668, 265, 403, 0, 0, 0
6591, 1, 1636422115088, 1636422115758, 670, 269, 401, 0, 1, 1
6592, 1, 1636422115355, 1636422116030, 675, 278, 397, 2, 0, 2
6593, 1, 1636422115759, 1636422116426, 667, 269, 398, 0, 1, 1
6581, 2, 1636422106360, 1636422116535, 10175, 0, 10175, 0, 0, 0
6594, 1, 1636422116032, 1636422116694, 662, 265, 397, 1, 0, 1
6582, 2, 1636422106710, 1636422116883, 10173, 0, 10173, 0, 0, 0
6595, 2, 1636422116428, 1636422126623, 10195, 0, 10195, 0, 0, 0
6596, 2, 1636422116666, 1636422126843, 10177, 0, 10177, 0, 0, 0
6597, 2, 1636422116699, 1636422126887, 10188, 0, 10188, 0, 0, 0
6598, 2, 1636422117014, 1636422127187, 10173, 0, 10173, 0, 0, 0
6599, 2, 1636422126754, 1636422136935, 10181, 45, 10136, 0, 44, 44
6600, 2, 1636422127006, 1636422137183, 10177, 1, 10176, 2, 0, 2
6601, 1, 1636422474538, 1636422475170, 632, 272, 360, 0, 0, 0
6602, 1, 1636422475014, 1636422475642, 628, 268, 360, 1, 0, 1
6604, 1, 1636422475570, 1636422476202, 632, 271, 361, 0, 1, 1
6606, 1, 1636422476098, 1636422476722, 624, 269, 355, 0, 0, 0
6608, 1, 1636422476669, 1636422477294, 625, 271, 354, 0, 1, 1
6610, 1, 1636422477266, 1636422477898, 632, 268, 364, 0, 0, 0
6612, 1, 1636422477787, 1636422478410, 623, 271, 352, 0, 1, 1
6614, 1, 1636422478398, 1636422479026, 628, 270, 358, 1, 0, 1
6616, 1, 1636422478935, 1636422479566, 631, 270, 361, 1, 2, 3
6618, 1, 1636422479403, 1636422480034, 631, 269, 362, 0, 0, 0
6621, 1, 1636422481046, 1636422481674, 628, 270, 358, 0, 1, 1
6622, 1, 1636422481561, 1636422482186, 625, 271, 354, 0, 0, 0
6624, 1, 1636422482128, 1636422482746, 618, 266, 352, 0, 1, 1
6626, 1, 1636422482718, 1636422483342, 624, 270, 354, 0, 1, 1
6628, 1, 1636422483262, 1636422483886, 624, 269, 355, 0, 0, 0
6630, 1, 1636422483772, 1636422484398, 626, 269, 357, 0, 1, 1
6632, 1, 1636422484382, 1636422485010, 628, 270, 358, 1, 0, 1
6603, 2, 1636422475295, 1636422485427, 10132, 1, 10131, 1, 0, 1
6634, 1, 1636422484966, 1636422485594, 628, 271, 357, 1, 0, 1
6605, 2, 1636422475767, 1636422485899, 10132, 0, 10132, 0, 0, 0
6637, 1, 1636422485562, 1636422486190, 628, 270, 358, 0, 0, 0
6636, 1, 1636422485558, 1636422486254, 696, 298, 398, 0, 30, 30
6607, 2, 1636422476325, 1636422486459, 10134, 0, 10134, 0, 0, 0
6639, 1, 1636422486030, 1636422486730, 700, 295, 405, 1, 26, 27
6640, 1, 1636422486310, 1636422486942, 632, 273, 359, 0, 0, 0
6641, 1, 1636422486316, 1636422486942, 626, 270, 356, 0, 0, 0
6609, 2, 1636422476858, 1636422486991, 10133, 1, 10132, 2, 0, 2
6643, 1, 1636422486590, 1636422487258, 668, 268, 400, 0, 2, 2
6644, 1, 1636422486788, 1636422487446, 658, 299, 359, 0, 31, 31
6611, 2, 1636422477452, 1636422487583, 10131, 0, 10131, 0, 0, 0
6647, 1, 1636422487132, 1636422487754, 622, 270, 352, 2, 0, 2
6646, 1, 1636422487122, 1636422487794, 672, 270, 402, 0, 2, 2
6648, 1, 1636422487352, 1636422487974, 622, 269, 353, 0, 0, 0
6613, 2, 1636422478022, 1636422488155, 10133, 1, 10132, 1, 1, 2
6649, 1, 1636422487589, 1636422488222, 633, 273, 360, 1, 0, 1
6650, 1, 1636422487718, 1636422488422, 704, 308, 396, 1, 38, 39
6651, 1, 1636422487884, 1636422488510, 626, 276, 350, 1, 7, 8
6615, 2, 1636422478571, 1636422488704, 10133, 0, 10133, 0, 0, 0
6653, 1, 1636422488167, 1636422488786, 619, 266, 353, 1, 0, 1
6654, 1, 1636422488286, 1636422488970, 684, 285, 399, 0, 14, 14
6656, 1, 1636422488476, 1636422489098, 622, 268, 354, 0, 0, 0
6617, 2, 1636422479152, 1636422489284, 10132, 1, 10131, 0, 1, 1
6657, 1, 1636422488704, 1636422489334, 630, 273, 357, 0, 0, 0
6658, 1, 1636422488834, 1636422489550, 716, 270, 446, 0, 0, 0
6660, 1, 1636422489047, 1636422489670, 623, 269, 354, 0, 0, 0
6619, 2, 1636422479688, 1636422489819, 10131, 1, 10130, 0, 0, 0
6661, 1, 1636422489292, 1636422489914, 622, 270, 352, 0, 0, 0
6662, 1, 1636422489414, 1636422490086, 672, 271, 401, 0, 2, 2
6664, 1, 1636422489592, 1636422490266, 674, 278, 396, 1, 10, 11
6620, 2, 1636422480190, 1636422490323, 10133, 0, 10133, 0, 0, 0
6665, 1, 1636422489861, 1636422490486, 625, 270, 355, 0, 0, 0
6666, 1, 1636422489950, 1636422490614, 664, 268, 396, 0, 0, 0
6668, 1, 1636422490178, 1636422490790, 612, 259, 353, 0, 0, 0
6669, 1, 1636422490399, 1636422491022, 623, 270, 353, 0, 0, 0
6670, 1, 1636422490454, 1636422491118, 664, 270, 394, 0, 0, 0
6672, 1, 1636422490716, 1636422491342, 626, 270, 356, 0, 0, 0
6673, 1, 1636422490992, 1636422491610, 618, 266, 352, 0, 0, 0
6675, 1, 1636422491221, 1636422491846, 625, 270, 355, 2, 0, 2
6623, 2, 1636422481801, 1636422491935, 10134, 1, 10133, 0, 1, 1
6676, 1, 1636422491531, 1636422492206, 675, 312, 363, 0, 43, 43
6625, 2, 1636422482346, 1636422492479, 10133, 0, 10133, 0, 0, 0
6678, 1, 1636422492035, 1636422492654, 619, 265, 354, 0, 0, 0
6679, 1, 1636422492066, 1636422492746, 680, 279, 401, 0, 9, 9
6627, 2, 1636422482924, 1636422493055, 10131, 0, 10131, 0, 0, 0
6681, 1, 1636422492610, 1636422493318, 708, 311, 397, 0, 42, 42
6682, 1, 1636422492827, 1636422493454, 627, 269, 358, 0, 0, 0
6629, 2, 1636422483476, 1636422493611, 10135, 0, 10135, 0, 0, 0
6684, 1, 1636422493186, 1636422493878, 692, 296, 396, 1, 26, 27
6685, 1, 1636422493369, 1636422493994, 625, 270, 355, 0, 0, 0
6631, 2, 1636422484021, 1636422494155, 10134, 1, 10133, 0, 1, 1
6686, 1, 1636422493641, 1636422494266, 625, 269, 356, 0, 0, 0
6687, 1, 1636422493742, 1636422494426, 684, 284, 400, 0, 10, 10
6688, 1, 1636422493945, 1636422494602, 657, 302, 355, 0, 34, 34
6633, 2, 1636422484557, 1636422494691, 10134, 0, 10134, 0, 0, 0
6689, 1, 1636422494184, 1636422494810, 626, 273, 353, 0, 0, 0
6690, 1, 1636422494286, 1636422494958, 672, 274, 398, 0, 0, 0
6692, 1, 1636422494504, 1636422495134, 630, 278, 352, 1, 14, 15
6635, 2, 1636422485135, 1636422495268, 10133, 0, 10133, 0, 1, 1
6693, 1, 1636422494747, 1636422495374, 627, 270, 357, 1, 0, 1
6694, 1, 1636422494822, 1636422495530, 708, 270, 438, 0, 1, 1
6696, 1, 1636422495048, 1636422495714, 666, 269, 397, 0, 1, 1
6638, 2, 1636422485720, 1636422495852, 10132, 0, 10132, 0, 0, 0
6697, 1, 1636422495311, 1636422495934, 623, 267, 356, 0, 1, 1
6698, 1, 1636422495402, 1636422496122, 720, 269, 451, 0, 0, 0
6700, 1, 1636422495582, 1636422496214, 632, 274, 358, 1, 0, 1
6642, 2, 1636422486316, 1636422496447, 10131, 0, 10131, 0, 0, 0
6701, 1, 1636422495852, 1636422496478, 626, 275, 351, 0, 0, 0
6702, 1, 1636422495982, 1636422496650, 668, 270, 398, 0, 0, 0
6704, 1, 1636422496159, 1636422496826, 667, 270, 397, 0, 0, 0
6705, 1, 1636422496389, 1636422497030, 641, 273, 368, 0, 0, 0
6645, 2, 1636422487067, 1636422497199, 10132, 1, 10131, 1, 1, 2
6706, 1, 1636422496582, 1636422497254, 672, 270, 402, 0, 0, 0
6708, 1, 1636422496744, 1636422497366, 622, 270, 352, 0, 0, 0
6709, 1, 1636422496962, 1636422497586, 624, 270, 354, 0, 1, 1
6712, 1, 1636422497337, 1636422497962, 625, 267, 358, 0, 1, 1
6711, 1, 1636422497330, 1636422498002, 672, 270, 402, 0, 1, 1
6652, 2, 1636422487919, 1636422498051, 10132, 0, 10132, 0, 0, 0
6713, 1, 1636422497559, 1636422498182, 623, 270, 353, 1, 0, 1
6655, 2, 1636422488379, 1636422498515, 10136, 0, 10136, 0, 0, 0
6715, 1, 1636422498092, 1636422498714, 622, 269, 353, 0, 1, 1
6716, 1, 1636422498152, 1636422498782, 630, 274, 356, 1, 1, 2
6717, 1, 1636422498182, 1636422498870, 688, 290, 398, 0, 21, 21
6659, 2, 1636422488954, 1636422499087, 10133, 1, 10132, 1, 0, 1
6719, 1, 1636422498646, 1636422499354, 708, 308, 400, 1, 38, 39
6720, 1, 1636422498908, 1636422499538, 630, 274, 356, 0, 5, 5
6721, 1, 1636422498940, 1636422499566, 626, 270, 356, 1, 0, 1
6663, 2, 1636422489488, 1636422499623, 10135, 0, 10135, 0, 0, 0
6723, 1, 1636422499222, 1636422499890, 668, 268, 400, 0, 0, 0
6724, 1, 1636422499404, 1636422500070, 666, 269, 397, 0, 0, 0
6667, 2, 1636422490080, 1636422500212, 10132, 0, 10132, 0, 0, 0
6727, 1, 1636422499754, 1636422500422, 668, 269, 399, 1, 0, 1
6728, 1, 1636422499980, 1636422500602, 622, 269, 353, 0, 0, 0
6671, 2, 1636422490649, 1636422500784, 10135, 1, 10134, 0, 1, 1
6730, 1, 1636422500342, 1636422501050, 708, 308, 400, 0, 39, 39
6731, 1, 1636422500512, 1636422501138, 626, 270, 356, 0, 3, 3
6674, 2, 1636422491186, 1636422501319, 10133, 0, 10133, 0, 0, 0
6733, 1, 1636422500914, 1636422501586, 672, 271, 401, 0, 3, 3
6734, 1, 1636422501098, 1636422501770, 672, 269, 403, 1, 0, 1
6677, 2, 1636422491791, 1636422501924, 10133, 0, 10133, 0, 0, 0
6736, 1, 1636422501450, 1636422502114, 664, 267, 397, 0, 1, 1
6737, 1, 1636422501672, 1636422502298, 626, 275, 351, 0, 0, 0
6680, 2, 1636422492324, 1636422502455, 10131, 0, 10131, 1, 0, 1
6739, 1, 1636422502054, 1636422502722, 668, 272, 396, 1, 2, 3
6740, 1, 1636422502211, 1636422502838, 627, 269, 358, 0, 0, 0
6683, 2, 1636422492834, 1636422502967, 10133, 0, 10133, 0, 0, 0
6742, 1, 1636422502586, 1636422503250, 664, 269, 395, 0, 0, 0
6743, 1, 1636422502818, 1636422503442, 624, 269, 355, 0, 0, 0
6745, 1, 1636422503098, 1636422503766, 668, 271, 397, 0, 1, 1
6746, 1, 1636422503350, 1636422503974, 624, 271, 353, 1, 1, 2
6748, 1, 1636422503858, 1636422504486, 628, 269, 359, 0, 1, 1
6691, 2, 1636422494428, 1636422504563, 10135, 0, 10135, 0, 0, 0
6695, 2, 1636422494972, 1636422505104, 10132, 0, 10132, 0, 0, 0
6751, 1, 1636422504694, 1636422505374, 680, 276, 404, 1, 7, 8
6699, 2, 1636422495533, 1636422505667, 10134, 0, 10134, 0, 0, 0
6752, 1, 1636422505234, 1636422505934, 700, 300, 400, 0, 30, 30
6753, 1, 1636422505455, 1636422506118, 663, 307, 356, 0, 38, 38
6703, 2, 1636422496098, 1636422506236, 10138, 0, 10138, 0, 1, 1
6754, 1, 1636422505798, 1636422506502, 704, 307, 397, 0, 38, 38
6755, 1, 1636422505996, 1636422506622, 626, 270, 356, 1, 1, 2
6707, 2, 1636422496638, 1636422506772, 10134, 1, 10133, 0, 0, 0
6757, 1, 1636422506366, 1636422507038, 672, 276, 396, 0, 6, 6
6758, 1, 1636422506561, 1636422507214, 653, 294, 359, 0, 34, 34
6710, 2, 1636422497200, 1636422507332, 10132, 0, 10132, 0, 1, 1
6760, 1, 1636422506902, 1636422507598, 696, 296, 400, 0, 27, 27
6761, 1, 1636422507127, 1636422507778, 651, 298, 353, 2, 30, 32
6714, 2, 1636422497748, 1636422507880, 10132, 0, 10132, 0, 1, 1
6763, 1, 1636422507462, 1636422508146, 684, 288, 396, 0, 18, 18
6764, 1, 1636422507663, 1636422508330, 667, 310, 357, 1, 42, 43
6718, 2, 1636422498347, 1636422508479, 10132, 0, 10132, 0, 0, 0
6766, 1, 1636422508010, 1636422508678, 668, 269, 399, 1, 0, 1
6767, 1, 1636422508224, 1636422508846, 622, 270, 352, 0, 0, 0
6722, 2, 1636422498942, 1636422509079, 10137, 0, 10137, 0, 0, 0
6769, 1, 1636422508610, 1636422509282, 672, 269, 403, 0, 0, 0
6770, 1, 1636422508768, 1636422509434, 666, 315, 351, 0, 47, 47
6725, 2, 1636422499698, 1636422509831, 10133, 0, 10133, 0, 0, 0
6726, 2, 1636422499732, 1636422509876, 10144, 0, 10144, 0, 0, 0
6772, 1, 1636422509210, 1636422509882, 672, 274, 398, 0, 0, 0
6773, 1, 1636422509369, 1636422509990, 621, 266, 355, 0, 0, 0
6729, 2, 1636422500212, 1636422510343, 10131, 0, 10131, 0, 0, 0
6776, 1, 1636422509967, 1636422510610, 643, 286, 357, 0, 22, 22
6775, 1, 1636422509966, 1636422510638, 672, 270, 402, 2, 0, 2
6777, 1, 1636422509994, 1636422510702, 708, 307, 401, 0, 38, 38
6732, 2, 1636422500784, 1636422510915, 10131, 0, 10131, 0, 0, 0
6779, 1, 1636422510474, 1636422511182, 708, 307, 401, 0, 39, 39
6780, 1, 1636422510725, 1636422511362, 637, 282, 355, 2, 14, 16
6781, 1, 1636422510753, 1636422511378, 625, 271, 354, 0, 1, 1
6735, 2, 1636422501320, 1636422511451, 10131, 1, 10130, 1, 0, 1
6783, 1, 1636422511046, 1636422511718, 672, 270, 402, 0, 2, 2
6784, 1, 1636422511234, 1636422511898, 664, 310, 354, 1, 42, 43
6738, 2, 1636422501924, 1636422512055, 10131, 1, 10130, 0, 1, 1
6786, 1, 1636422511560, 1636422512182, 622, 268, 354, 0, 0, 0
6787, 1, 1636422511582, 1636422512250, 668, 270, 398, 1, 0, 1
6788, 1, 1636422511807, 1636422512426, 619, 265, 354, 0, 0, 0
6741, 2, 1636422502464, 1636422512595, 10131, 0, 10131, 0, 0, 0
6789, 1, 1636422512056, 1636422512678, 622, 269, 353, 0, 0, 0
6790, 1, 1636422512183, 1636422512858, 675, 285, 390, 2, 14, 16
6791, 1, 1636422512343, 1636422512966, 623, 269, 354, 0, 0, 0
6792, 1, 1636422512353, 1636422512986, 633, 273, 360, 0, 0, 0
6744, 2, 1636422503003, 1636422513139, 10136, 1, 10135, 0, 0, 0
6793, 1, 1636422512622, 1636422513246, 624, 269, 355, 0, 0, 0
6794, 1, 1636422512726, 1636422513406, 680, 279, 401, 0, 14, 14
6795, 1, 1636422512839, 1636422513494, 655, 302, 353, 0, 34, 34
6796, 1, 1636422512945, 1636422513586, 641, 285, 356, 0, 18, 18
6747, 2, 1636422503611, 1636422513743, 10132, 0, 10132, 0, 0, 0
6797, 1, 1636422513148, 1636422513774, 626, 270, 356, 1, 0, 1
6798, 1, 1636422513150, 1636422513786, 636, 274, 362, 0, 1, 1
6799, 1, 1636422513270, 1636422513942, 672, 275, 397, 0, 1, 1
6800, 1, 1636422513416, 1636422514046, 630, 274, 356, 0, 0, 0
6801, 1, 1636422513486, 1636422514110, 624, 268, 356, 0, 0, 0
6749, 2, 1636422504142, 1636422514275, 10133, 0, 10133, 0, 0, 0
6802, 1, 1636422513633, 1636422514278, 645, 268, 377, 0, 0, 0
6803, 1, 1636422513749, 1636422514374, 625, 270, 355, 0, 0, 0
6804, 1, 1636422513874, 1636422514542, 668, 272, 396, 0, 7, 7
6805, 1, 1636422513944, 1636422514570, 626, 271, 355, 1, 0, 1
6807, 1, 1636422514030, 1636422514658, 628, 270, 358, 0, 0, 0
6750, 2, 1636422504651, 1636422514783, 10132, 0, 10132, 0, 0, 0
6806, 1, 1636422513947, 1636422514842, 895, 538, 357, 1, 0, 1
6808, 1, 1636422514211, 1636422514862, 651, 273, 378, 0, 0, 0
6809, 1, 1636422514292, 1636422514910, 618, 266, 352, 0, 0, 0
6810, 1, 1636422514406, 1636422515078, 672, 270, 402, 1, 0, 1
6811, 1, 1636422514426, 1636422515138, 712, 357, 355, 0, 29, 29
6813, 1, 1636422514637, 1636422515266, 629, 274, 355, 0, 1, 1
6814, 1, 1636422514784, 1636422515410, 626, 270, 356, 0, 1, 1
6812, 1, 1636422514543, 1636422515418, 875, 518, 357, 0, 0, 0
6815, 1, 1636422514839, 1636422515462, 623, 270, 353, 0, 0, 0
6816, 1, 1636422514844, 1636422515518, 674, 274, 400, 0, 0, 0
6817, 1, 1636422514918, 1636422515586, 668, 269, 399, 2, 0, 2
6818, 1, 1636422515006, 1636422515682, 676, 323, 353, 1, 0, 1
6820, 1, 1636422515170, 1636422515794, 624, 270, 354, 1, 0, 1
6821, 1, 1636422515227, 1636422515850, 623, 269, 354, 0, 0, 0
6819, 1, 1636422515082, 1636422515950, 868, 511, 357, 0, 0, 0
6823, 1, 1636422515445, 1636422516074, 629, 275, 354, 1, 0, 1
6822, 1, 1636422515419, 1636422516086, 667, 274, 393, 0, 0, 0
6824, 1, 1636422515553, 1636422516178, 625, 270, 355, 0, 0, 0
6825, 1, 1636422515632, 1636422516254, 622, 266, 356, 1, 0, 1
6827, 1, 1636422515679, 1636422516310, 631, 274, 357, 0, 0, 0
6756, 2, 1636422506243, 1636422516376, 10133, 1, 10132, 0, 0, 0
6828, 1, 1636422515807, 1636422516426, 619, 266, 353, 0, 0, 0
6829, 1, 1636422515952, 1636422516642, 690, 287, 403, 0, 19, 19
6830, 1, 1636422515977, 1636422516646, 669, 309, 360, 0, 39, 39
6831, 1, 1636422516025, 1636422516650, 625, 266, 359, 0, 0, 0
6833, 1, 1636422516238, 1636422516866, 628, 271, 357, 0, 1, 1
6759, 2, 1636422506788, 1636422516919, 10131, 1, 10130, 0, 0, 0
6834, 1, 1636422516376, 1636422516998, 622, 270, 352, 0, 1, 1
6835, 1, 1636422516416, 1636422517038, 622, 270, 352, 0, 0, 0
6836, 1, 1636422516494, 1636422517122, 628, 273, 355, 0, 0, 0
6837, 1, 1636422516506, 1636422517190, 684, 275, 409, 0, 6, 6
6838, 1, 1636422516603, 1636422517218, 615, 263, 352, 0, 0, 0
6840, 1, 1636422516768, 1636422517394, 626, 269, 357, 0, 0, 0
6762, 2, 1636422507357, 1636422517491, 10134, 0, 10134, 0, 0, 0
6841, 1, 1636422516841, 1636422517502, 661, 270, 391, 0, 0, 0
6842, 1, 1636422517023, 1636422517646, 623, 266, 357, 0, 0, 0
6843, 1, 1636422517050, 1636422517758, 708, 308, 400, 0, 38, 38
6844, 1, 1636422517166, 1636422517798, 632, 269, 363, 0, 0, 0
6845, 1, 1636422517211, 1636422517846, 635, 283, 352, 0, 18, 18
6846, 1, 1636422517265, 1636422517898, 633, 269, 364, 0, 1, 1
6765, 2, 1636422507923, 1636422518055, 10132, 0, 10132, 0, 0, 0
6848, 1, 1636422517419, 1636422518070, 651, 266, 385, 0, 1, 1
6847, 1, 1636422517291, 1636422518114, 823, 471, 352, 1, 0, 1
6849, 1, 1636422517553, 1636422518194, 641, 277, 364, 0, 0, 0
6851, 1, 1636422517635, 1636422518266, 631, 270, 361, 0, 0, 0
6850, 1, 1636422517622, 1636422518326, 704, 304, 400, 0, 42, 42
6852, 1, 1636422517809, 1636422518438, 629, 266, 363, 0, 0, 0
6853, 1, 1636422517817, 1636422518450, 633, 270, 363, 0, 0, 0
6854, 1, 1636422517966, 1636422518586, 620, 263, 357, 0, 0, 0
6768, 2, 1636422508480, 1636422518619, 10139, 0, 10139, 0, 0, 0
6855, 1, 1636422518056, 1636422518650, 594, 275, 319, 2, 0, 2
6856, 1, 1636422518080, 1636422518714, 634, 274, 360, 0, 0, 0
6857, 1, 1636422518115, 1636422518786, 671, 274, 397, 0, 0, 0
6859, 1, 1636422518207, 1636422518830, 623, 266, 357, 0, 1, 1
6858, 1, 1636422518186, 1636422518894, 708, 304, 404, 0, 34, 34
6860, 1, 1636422518346, 1636422518974, 628, 273, 355, 1, 6, 7
6861, 1, 1636422518383, 1636422519006, 623, 269, 354, 0, 0, 0
6862, 1, 1636422518436, 1636422519066, 630, 269, 361, 1, 6, 7
6771, 2, 1636422509016, 1636422519167, 10151, 0, 10151, 0, 0, 0
6863, 1, 1636422518620, 1636422519234, 614, 267, 347, 0, 0, 0
6864, 1, 1636422518621, 1636422519250, 629, 269, 360, 0, 0, 0
6866, 1, 1636422518769, 1636422519434, 665, 312, 353, 0, 42, 42
6867, 1, 1636422518803, 1636422519434, 631, 271, 360, 0, 1, 1
6865, 1, 1636422518746, 1636422519434, 688, 288, 400, 0, 18, 18
6868, 1, 1636422518879, 1636422519522, 643, 285, 358, 0, 26, 26
6870, 1, 1636422518948, 1636422519614, 666, 306, 360, 1, 38, 39
6871, 1, 1636422519007, 1636422519630, 623, 266, 357, 0, 0, 0
6774, 2, 1636422509556, 1636422519687, 10131, 0, 10131, 0, 0, 0
6872, 1, 1636422519168, 1636422519794, 626, 269, 357, 0, 0, 0
6873, 1, 1636422519190, 1636422519826, 636, 274, 362, 0, 0, 0
6874, 1, 1636422519237, 1636422519858, 621, 268, 353, 1, 1, 2
6875, 1, 1636422519298, 1636422519954, 656, 262, 394, 0, 0, 0
6877, 1, 1636422519420, 1636422520046, 626, 272, 354, 1, 7, 8
6876, 1, 1636422519405, 1636422520046, 641, 282, 359, 1, 10, 11
6878, 1, 1636422519505, 1636422520142, 637, 271, 366, 0, 0, 0
6879, 1, 1636422519576, 1636422520222, 646, 268, 378, 1, 1, 2
6880, 1, 1636422519616, 1636422520270, 654, 267, 387, 1, 0, 1
6778, 2, 1636422510161, 1636422520295, 10134, 1, 10133, 0, 0, 0
6881, 1, 1636422519688, 1636422520310, 622, 266, 356, 2, 0, 2
6882, 1, 1636422519755, 1636422520378, 623, 269, 354, 0, 0, 0
6883, 1, 1636422519812, 1636422520438, 626, 270, 356, 0, 0, 0
6884, 1, 1636422519822, 1636422520494, 672, 270, 402, 0, 0, 0
6885, 1, 1636422519945, 1636422520566, 621, 267, 354, 0, 1, 1
6886, 1, 1636422519988, 1636422520650, 662, 311, 351, 0, 42, 42
6887, 1, 1636422520045, 1636422520666, 621, 267, 354, 0, 0, 0
6888, 1, 1636422520058, 1636422520674, 616, 263, 353, 0, 0, 0
6889, 1, 1636422520196, 1636422520822, 626, 261, 365, 0, 0, 0
6890, 1, 1636422520236, 1636422520874, 638, 270, 368, 0, 0, 0
6782, 2, 1636422510765, 1636422520899, 10134, 1, 10133, 0, 1, 1
6891, 1, 1636422520320, 1636422520938, 618, 265, 353, 0, 0, 0
6893, 1, 1636422520406, 1636422521026, 620, 266, 354, 0, 0, 0
6894, 1, 1636422520426, 1636422521098, 672, 272, 400, 2, 2, 4
6895, 1, 1636422520468, 1636422521098, 630, 271, 359, 2, 1, 3
6897, 1, 1636422520583, 1636422521202, 619, 266, 353, 0, 0, 0
6898, 1, 1636422520619, 1636422521250, 631, 283, 348, 0, 15, 15
6896, 1, 1636422520548, 1636422521362, 814, 462, 352, 0, 0, 0
6899, 1, 1636422520760, 1636422521390, 630, 274, 356, 0, 2, 2
6900, 1, 1636422520781, 1636422521430, 649, 264, 385, 1, 1, 2
6902, 1, 1636422520901, 1636422521514, 613, 267, 346, 2, 1, 3
6903, 1, 1636422520991, 1636422521626, 635, 283, 352, 0, 0, 0
6785, 2, 1636422511520, 1636422521651, 10131, 0, 10131, 0, 0, 0
6904, 1, 1636422521031, 1636422521654, 623, 258, 365, 0, 0, 0
6905, 1, 1636422521034, 1636422521686, 652, 254, 398, 0, 0, 0
6907, 1, 1636422521187, 1636422521806, 619, 254, 365, 0, 0, 0
6908, 1, 1636422521204, 1636422521814, 610, 258, 352, 0, 0, 0
6909, 1, 1636422521272, 1636422521922, 650, 293, 357, 1, 27, 28
6906, 1, 1636422521109, 1636422521922, 813, 453, 360, 0, 26, 26
6911, 1, 1636422521398, 1636422522014, 616, 262, 354, 0, 0, 0
6910, 1, 1636422521363, 1636422522018, 655, 263, 392, 0, 0, 0
6913, 1, 1636422521554, 1636422522186, 632, 270, 362, 1, 2, 3
6914, 1, 1636422521574, 1636422522222, 648, 262, 386, 1, 0, 1
6917, 1, 1636422521793, 1636422522422, 629, 273, 356, 1, 0, 1
6918, 1, 1636422521799, 1636422522422, 623, 270, 353, 1, 0, 1
6916, 1, 1636422521782, 1636422522446, 664, 266, 398, 1, 0, 1
6919, 1, 1636422521829, 1636422522454, 625, 262, 363, 2, 0, 2
6915, 1, 1636422521663, 1636422522498, 835, 482, 353, 1, 0, 1
6920, 1, 1636422521924, 1636422522590, 666, 266, 400, 1, 0, 1
6921, 1, 1636422522003, 1636422522622, 619, 266, 353, 0, 1, 1
6922, 1, 1636422522004, 1636422522646, 642, 279, 363, 1, 0, 1
6923, 1, 1636422522072, 1636422522701, 629, 270, 359, 1, 0, 1
6925, 1, 1636422522187, 1636422522822, 635, 270, 365, 0, 0, 0
6926, 1, 1636422522354, 1636422522982, 628, 269, 359, 0, 0, 0
6927, 1, 1636422522384, 1636422523014, 630, 274, 356, 0, 0, 0
6929, 1, 1636422522541, 1636422523162, 621, 267, 354, 2, 0, 2
6928, 1, 1636422522499, 1636422523166, 667, 272, 395, 1, 1, 2
6930, 1, 1636422522598, 1636422523222, 624, 268, 356, 1, 2, 3
6931, 1, 1636422522601, 1636422523226, 625, 265, 360, 0, 0, 0
6932, 1, 1636422522636, 1636422523254, 618, 266, 352, 0, 0, 0
6934, 1, 1636422522795, 1636422523414, 619, 266, 353, 0, 0, 0
6935, 1, 1636422522818, 1636422523442, 624, 270, 354, 0, 0, 0
6936, 1, 1636422522884, 1636422523510, 626, 274, 352, 1, 0, 1
6937, 1, 1636422522982, 1636422523610, 628, 271, 357, 0, 1, 1
6938, 1, 1636422523160, 1636422523790, 630, 266, 364, 2, 0, 2
6939, 1, 1636422523172, 1636422523810, 638, 274, 364, 0, 0, 0
6941, 1, 1636422523348, 1636422523970, 622, 268, 354, 0, 0, 0
6942, 1, 1636422523394, 1636422524022, 628, 270, 358, 0, 0, 0
6943, 1, 1636422523415, 1636422524038, 623, 271, 352, 0, 0, 0
6944, 1, 1636422523446, 1636422524074, 628, 266, 362, 0, 0, 0
6945, 1, 1636422523583, 1636422524210, 627, 270, 357, 0, 0, 0
6947, 1, 1636422523680, 1636422524310, 630, 273, 357, 1, 0, 1
6948, 1, 1636422523778, 1636422524414, 636, 278, 358, 1, 0, 1
6949, 1, 1636422523975, 1636422524598, 623, 270, 353, 0, 1, 1
6950, 1, 1636422523984, 1636422524614, 630, 270, 360, 0, 0, 0
6951, 1, 1636422524142, 1636422524766, 624, 270, 354, 0, 1, 1
6952, 1, 1636422524179, 1636422524798, 619, 266, 353, 0, 0, 0
6953, 1, 1636422524210, 1636422524830, 620, 267, 353, 0, 1, 1
6955, 1, 1636422524378, 1636422525034, 656, 298, 358, 1, 0, 1
6956, 1, 1636422524480, 1636422525098, 618, 266, 352, 2, 0, 2
6957, 1, 1636422524582, 1636422525202, 620, 266, 354, 0, 0, 0
6959, 1, 1636422524778, 1636422525406, 628, 266, 362, 0, 0, 0
6960, 1, 1636422524926, 1636422525554, 628, 270, 358, 1, 0, 1
6961, 1, 1636422524967, 1636422525598, 631, 270, 361, 0, 0, 0
6962, 1, 1636422525009, 1636422525630, 621, 263, 358, 0, 1, 1
6826, 2, 1636422515646, 1636422525787, 10141, 1, 10140, 0, 0, 0
6963, 1, 1636422525179, 1636422525798, 619, 266, 353, 0, 0, 0
6964, 1, 1636422525280, 1636422525906, 626, 270, 356, 1, 0, 1
6965, 1, 1636422525379, 1636422526006, 627, 270, 357, 0, 0, 0
6966, 1, 1636422525578, 1636422526238, 660, 306, 354, 0, 35, 35
6832, 2, 1636422516221, 1636422526355, 10134, 1, 10133, 0, 0, 0
6967, 1, 1636422525722, 1636422526362, 640, 266, 374, 1, 0, 1
6968, 1, 1636422525788, 1636422526414, 626, 274, 352, 2, 0, 2
6969, 1, 1636422525816, 1636422526438, 622, 270, 352, 0, 0, 0
6971, 1, 1636422525976, 1636422526622, 646, 292, 354, 0, 26, 26
6972, 1, 1636422526087, 1636422526710, 623, 270, 353, 2, 2, 4
6973, 1, 1636422526195, 1636422526818, 623, 265, 358, 0, 0, 0
6839, 2, 1636422516752, 1636422526883, 10131, 0, 10131, 0, 0, 0
6974, 1, 1636422526384, 1636422527006, 622, 266, 356, 0, 0, 0
6976, 1, 1636422526531, 1636422527158, 627, 275, 352, 0, 1, 1
6977, 1, 1636422526569, 1636422527190, 621, 266, 355, 0, 0, 0
6978, 1, 1636422526623, 1636422527254, 631, 270, 361, 0, 0, 0
6979, 1, 1636422526782, 1636422527414, 632, 267, 365, 0, 1, 1
6981, 1, 1636422526992, 1636422527610, 618, 266, 352, 0, 0, 0
6983, 1, 1636422527191, 1636422527814, 623, 270, 353, 0, 1, 1
6984, 1, 1636422527329, 1636422527954, 625, 269, 356, 0, 1, 1
6985, 1, 1636422527385, 1636422528010, 625, 270, 355, 1, 1, 2
6987, 1, 1636422527576, 1636422528198, 622, 266, 356, 0, 0, 0
6988, 1, 1636422527792, 1636422528422, 630, 269, 361, 0, 0, 0
6990, 1, 1636422528145, 1636422528770, 625, 271, 354, 0, 1, 1
6991, 1, 1636422528182, 1636422528806, 624, 270, 354, 0, 0, 0
6992, 1, 1636422528375, 1636422529002, 627, 274, 353, 0, 0, 0
6869, 2, 1636422518917, 1636422529052, 10135, 0, 10135, 1, 0, 1
6993, 1, 1636422528593, 1636422529218, 625, 269, 356, 0, 0, 0
6994, 1, 1636422528942, 1636422529590, 648, 267, 381, 0, 0, 0
6995, 1, 1636422528981, 1636422529630, 649, 270, 379, 1, 0, 1
6996, 1, 1636422529181, 1636422529814, 633, 271, 362, 1, 0, 1
6998, 1, 1636422529399, 1636422530030, 631, 273, 358, 1, 0, 1
6999, 1, 1636422529729, 1636422530354, 625, 270, 355, 0, 0, 0
7000, 1, 1636422529783, 1636422530406, 623, 270, 353, 1, 0, 1
6892, 2, 1636422520373, 1636422530507, 10134, 0, 10134, 0, 0, 0
7001, 1, 1636422529995, 1636422530618, 623, 270, 353, 0, 0, 0
6901, 2, 1636422520841, 1636422530991, 10150, 1, 10149, 1, 0, 1
7003, 1, 1636422530534, 1636422531158, 624, 270, 354, 1, 0, 1
7004, 1, 1636422530590, 1636422531206, 616, 262, 354, 0, 0, 0
7005, 1, 1636422530638, 1636422531346, 708, 311, 397, 0, 42, 42
6912, 2, 1636422521411, 1636422531544, 10133, 0, 10133, 0, 0, 0
7007, 1, 1636422531122, 1636422531810, 688, 288, 400, 0, 18, 18
7008, 1, 1636422531341, 1636422531994, 653, 294, 359, 0, 27, 27
7010, 1, 1636422531393, 1636422532266, 873, 519, 354, 1, 0, 1
6924, 2, 1636422522169, 1636422532308, 10139, 1, 10138, 0, 2, 2
7011, 1, 1636422531674, 1636422532342, 668, 269, 399, 0, 1, 1
7012, 1, 1636422531879, 1636422532578, 699, 339, 360, 0, 38, 38
6933, 2, 1636422522725, 1636422532859, 10134, 0, 10134, 0, 0, 0
7014, 1, 1636422532309, 1636422532978, 669, 269, 400, 0, 0, 0
7015, 1, 1636422532424, 1636422533050, 626, 274, 352, 1, 0, 1
7017, 1, 1636422532676, 1636422533310, 634, 274, 360, 0, 6, 6
6940, 2, 1636422523300, 1636422533431, 10131, 0, 10131, 0, 0, 0
7019, 1, 1636422533112, 1636422533734, 622, 267, 355, 2, 0, 2
6946, 2, 1636422523614, 1636422533747, 10133, 0, 10133, 0, 0, 0
7020, 1, 1636422533221, 1636422533878, 657, 300, 357, 0, 33, 33
7021, 1, 1636422533479, 1636422534102, 623, 272, 351, 0, 2, 2
6954, 2, 1636422524242, 1636422534379, 10137, 0, 10137, 0, 0, 0
7024, 1, 1636422533915, 1636422534538, 623, 270, 353, 0, 0, 0
7023, 1, 1636422533878, 1636422534546, 668, 270, 398, 0, 0, 0
7025, 1, 1636422534030, 1636422534654, 624, 269, 355, 1, 0, 1
6958, 2, 1636422524771, 1636422534907, 10136, 0, 10136, 0, 0, 0
7027, 1, 1636422534510, 1636422535178, 668, 271, 397, 0, 0, 0
7028, 1, 1636422534628, 1636422535266, 638, 282, 356, 0, 18, 18
7029, 1, 1636422534700, 1636422535358, 658, 298, 360, 0, 30, 30
7031, 1, 1636422535038, 1636422535706, 668, 269, 399, 0, 0, 0
7032, 1, 1636422535267, 1636422535886, 619, 265, 354, 0, 0, 0
7033, 1, 1636422535425, 1636422536050, 625, 270, 355, 0, 0, 0
6970, 2, 1636422525918, 1636422536100, 10182, 0, 10182, 0, 0, 0
7034, 1, 1636422535508, 1636422536126, 618, 266, 352, 0, 0, 0
7035, 1, 1636422535790, 1636422536454, 664, 309, 355, 1, 42, 43
6975, 2, 1636422526490, 1636422536664, 10174, 1, 10173, 0, 0, 0
7036, 1, 1636422536100, 1636422536726, 626, 273, 353, 0, 0, 0
7038, 1, 1636422536237, 1636422536862, 625, 269, 356, 0, 0, 0
7037, 1, 1636422536231, 1636422536930, 699, 299, 400, 1, 30, 31
6980, 2, 1636422526884, 1636422537015, 10131, 0, 10131, 1, 0, 1
6982, 2, 1636422527014, 1636422537191, 10177, 0, 10177, 0, 0, 0
7040, 1, 1636422536580, 1636422537198, 618, 267, 351, 0, 1, 1
7041, 1, 1636422536798, 1636422537466, 668, 275, 393, 1, 3, 4
7042, 1, 1636422536870, 1636422537494, 624, 269, 355, 1, 0, 1
6986, 2, 1636422527415, 1636422537547, 10132, 1, 10131, 1, 0, 1
7043, 1, 1636422537016, 1636422537638, 622, 270, 352, 0, 2, 2
7045, 1, 1636422537146, 1636422537814, 668, 269, 399, 1, 0, 1
7046, 1, 1636422537322, 1636422537998, 676, 270, 406, 0, 6, 6
7047, 1, 1636422537386, 1636422538014, 628, 271, 357, 0, 0, 0
6989, 2, 1636422527988, 1636422538119, 10131, 1, 10130, 0, 1, 1
7048, 1, 1636422537555, 1636422538174, 619, 266, 353, 0, 0, 0
7050, 1, 1636422537678, 1636422538386, 708, 309, 399, 1, 35, 36
7051, 1, 1636422537790, 1636422538414, 624, 270, 354, 1, 0, 1
7052, 1, 1636422537896, 1636422538518, 622, 270, 352, 1, 0, 1
7053, 1, 1636422538120, 1636422538702, 582, 272, 310, 0, 2, 2
7055, 1, 1636422538250, 1636422538918, 668, 270, 398, 0, 0, 0
7056, 1, 1636422538351, 1636422538974, 623, 269, 354, 0, 0, 0
7057, 1, 1636422538432, 1636422539066, 634, 274, 360, 0, 0, 0
7058, 1, 1636422538606, 1636422539230, 624, 271, 353, 0, 1, 1
7059, 1, 1636422538693, 1636422539318, 625, 270, 355, 1, 1, 2
6997, 2, 1636422529182, 1636422539355, 10173, 0, 10173, 0, 0, 0
7060, 1, 1636422538879, 1636422539498, 619, 265, 354, 0, 0, 0
7061, 1, 1636422539001, 1636422539622, 621, 266, 355, 0, 0, 0
7062, 1, 1636422539167, 1636422539802, 635, 281, 354, 0, 14, 14
7063, 1, 1636422539230, 1636422539898, 668, 277, 391, 1, 1, 2
7064, 1, 1636422539402, 1636422540026, 624, 271, 353, 0, 0, 0
7066, 1, 1636422539499, 1636422540122, 623, 269, 354, 0, 0, 0
7065, 1, 1636422539486, 1636422540150, 664, 270, 394, 0, 1, 1
7067, 1, 1636422539695, 1636422540318, 623, 265, 358, 0, 0, 0
7002, 2, 1636422530191, 1636422540323, 10132, 0, 10132, 0, 0, 0
7068, 1, 1636422539799, 1636422540414, 615, 263, 352, 1, 0, 1
7069, 1, 1636422539962, 1636422540590, 628, 271, 357, 0, 1, 1
7070, 1, 1636422540035, 1636422540678, 643, 289, 354, 1, 22, 23
7071, 1, 1636422540202, 1636422540862, 660, 272, 388, 2, 0, 2
7072, 1, 1636422540248, 1636422540906, 658, 270, 388, 1, 0, 1
7006, 2, 1636422530791, 1636422540923, 10132, 0, 10132, 0, 0, 0
7075, 1, 1636422540492, 1636422541118, 626, 270, 356, 0, 0, 0
7074, 1, 1636422540454, 1636422541126, 672, 274, 398, 0, 0, 0
7076, 1, 1636422540604, 1636422541226, 622, 270, 352, 0, 1, 1
7077, 1, 1636422540761, 1636422541382, 621, 266, 355, 1, 0, 1
7009, 2, 1636422531374, 1636422541507, 10133, 1, 10132, 0, 1, 1
7079, 1, 1636422541010, 1636422541638, 628, 269, 359, 1, 0, 1
7080, 1, 1636422541039, 1636422541666, 627, 269, 358, 0, 0, 0
7081, 1, 1636422541058, 1636422541722, 664, 265, 399, 0, 0, 0
7082, 1, 1636422541204, 1636422541866, 662, 306, 356, 0, 38, 38
7083, 1, 1636422541291, 1636422541954, 663, 310, 353, 0, 38, 38
7085, 1, 1636422541567, 1636422542194, 627, 273, 354, 0, 0, 0
7013, 2, 1636422532140, 1636422542272, 10132, 0, 10132, 0, 0, 0
7086, 1, 1636422541638, 1636422542306, 668, 275, 393, 0, 1, 1
7087, 1, 1636422541804, 1636422542426, 622, 271, 351, 0, 1, 1
7089, 1, 1636422541855, 1636422542478, 623, 269, 354, 1, 0, 1
7016, 2, 1636422532438, 1636422542611, 10173, 0, 10173, 0, 0, 0
7090, 1, 1636422541992, 1636422542630, 638, 286, 352, 0, 18, 18
7091, 1, 1636422542099, 1636422542722, 623, 267, 356, 0, 1, 1
7088, 1, 1636422541823, 1636422542726, 903, 537, 366, 1, 22, 23
7092, 1, 1636422542375, 1636422542998, 623, 269, 354, 0, 0, 0
7094, 1, 1636422542402, 1636422543078, 676, 274, 402, 0, 0, 0
7018, 2, 1636422532990, 1636422543167, 10177, 1, 10176, 0, 0, 0
7095, 1, 1636422542612, 1636422543242, 630, 278, 352, 0, 0, 0
7093, 1, 1636422542387, 1636422543270, 883, 531, 352, 0, 0, 0
7096, 1, 1636422542651, 1636422543278, 627, 269, 358, 1, 0, 1
7098, 1, 1636422542738, 1636422543434, 696, 302, 394, 1, 31, 32
7099, 1, 1636422542795, 1636422543434, 639, 284, 355, 0, 14, 14
7100, 1, 1636422542905, 1636422543542, 637, 282, 355, 0, 0, 0
7022, 2, 1636422533562, 1636422543735, 10173, 0, 10173, 0, 0, 0
7101, 1, 1636422543168, 1636422543822, 654, 301, 353, 0, 1, 1
7103, 1, 1636422543272, 1636422543938, 666, 274, 392, 0, 0, 0
7104, 1, 1636422543298, 1636422544006, 708, 304, 404, 0, 34, 34
7105, 1, 1636422543416, 1636422544046, 630, 271, 359, 0, 1, 1
7106, 1, 1636422543451, 1636422544086, 635, 281, 354, 0, 14, 14
7107, 1, 1636422543497, 1636422544122, 625, 270, 355, 1, 0, 1
7026, 2, 1636422534264, 1636422544427, 10163, 0, 10163, 0, 0, 0
7110, 1, 1636422543866, 1636422544530, 664, 270, 394, 0, 1, 1
7111, 1, 1636422543943, 1636422544566, 623, 271, 352, 0, 1, 1
7112, 1, 1636422544055, 1636422544694, 639, 284, 355, 0, 18, 18
7113, 1, 1636422544073, 1636422544694, 621, 267, 354, 1, 1, 2
7115, 1, 1636422544253, 1636422544874, 621, 265, 356, 0, 0, 0
7030, 2, 1636422534815, 1636422544955, 10140, 0, 10140, 0, 0, 0
7116, 1, 1636422544295, 1636422544966, 671, 273, 398, 0, 0, 0
7117, 1, 1636422544558, 1636422545226, 668, 275, 393, 2, 0, 2
7118, 1, 1636422544627, 1636422545246, 619, 270, 349, 2, 0, 2
7119, 1, 1636422544756, 1636422545398, 642, 294, 348, 0, 26, 26
7120, 1, 1636422544844, 1636422545486, 642, 264, 378, 0, 0, 0
7121, 1, 1636422544885, 1636422545530, 645, 271, 374, 2, 0, 2
7122, 1, 1636422545060, 1636422545682, 622, 265, 357, 1, 0, 1
7124, 1, 1636422545104, 1636422545718, 614, 263, 351, 0, 1, 1
7123, 1, 1636422545082, 1636422545746, 664, 266, 398, 2, 0, 2
7125, 1, 1636422545315, 1636422545930, 615, 262, 353, 0, 0, 0
7126, 1, 1636422545423, 1636422546046, 623, 269, 354, 0, 0, 0
7128, 1, 1636422545650, 1636422546278, 628, 266, 362, 0, 0, 0
7129, 1, 1636422545680, 1636422546298, 618, 266, 352, 0, 0, 0
7039, 2, 1636422536313, 1636422546448, 10135, 0, 10135, 0, 1, 1
7130, 1, 1636422545846, 1636422546474, 628, 269, 359, 0, 0, 0
7132, 1, 1636422545899, 1636422546518, 619, 266, 353, 0, 0, 0
7134, 1, 1636422546240, 1636422546890, 650, 303, 347, 1, 34, 35
7135, 1, 1636422546448, 1636422547070, 622, 270, 352, 0, 0, 0
7136, 1, 1636422546487, 1636422547102, 615, 262, 353, 0, 1, 1
7044, 2, 1636422537022, 1636422547155, 10133, 0, 10133, 0, 0, 0
7137, 1, 1636422546578, 1636422547242, 664, 267, 397, 0, 1, 1
7139, 1, 1636422546697, 1636422547322, 625, 270, 355, 0, 0, 0
7140, 1, 1636422547029, 1636422547690, 661, 268, 393, 0, 1, 1
7049, 2, 1636422537656, 1636422547787, 10131, 0, 10131, 0, 0, 0
7141, 1, 1636422547245, 1636422547874, 629, 273, 356, 0, 0, 0
7142, 1, 1636422547286, 1636422547950, 664, 266, 398, 1, 0, 1
7144, 1, 1636422547343, 1636422547966, 623, 270, 353, 0, 0, 0
7145, 1, 1636422547503, 1636422548142, 639, 286, 353, 0, 18, 18
7054, 2, 1636422538175, 1636422548307, 10132, 0, 10132, 0, 0, 0
7146, 1, 1636422547828, 1636422548450, 622, 270, 352, 1, 0, 1
7147, 1, 1636422547914, 1636422548582, 668, 270, 398, 1, 0, 1
7148, 1, 1636422548050, 1636422548670, 620, 266, 354, 0, 0, 0
7149, 1, 1636422548051, 1636422548678, 627, 274, 353, 0, 0, 0
7150, 1, 1636422548156, 1636422548778, 622, 271, 351, 0, 0, 0
7151, 1, 1636422548317, 1636422548938, 621, 262, 359, 0, 0, 0
7152, 1, 1636422548438, 1636422549102, 664, 270, 394, 0, 1, 1
7153, 1, 1636422548634, 1636422549266, 632, 273, 359, 0, 0, 0
7154, 1, 1636422548677, 1636422549310, 633, 274, 359, 0, 1, 1
7156, 1, 1636422548858, 1636422549486, 628, 269, 359, 0, 0, 0
7157, 1, 1636422548943, 1636422549566, 623, 272, 351, 0, 1, 1
7159, 1, 1636422549204, 1636422549826, 622, 269, 353, 0, 0, 0
7160, 1, 1636422549449, 1636422550074, 625, 270, 355, 0, 0, 0
7163, 1, 1636422549736, 1636422550370, 634, 274, 360, 0, 1, 1
7073, 2, 1636422540325, 1636422550416, 10091, 0, 10091, 0, 0, 0
7078, 2, 1636422540823, 1636422550971, 10148, 1, 10147, 1, 0, 1
7166, 1, 1636422550537, 1636422551166, 629, 269, 360, 0, 0, 0
7167, 1, 1636422550546, 1636422551238, 692, 292, 400, 0, 22, 22
7084, 2, 1636422541389, 1636422551555, 10166, 0, 10166, 0, 0, 0
7168, 1, 1636422551098, 1636422551766, 668, 267, 401, 0, 1, 1
7169, 1, 1636422551304, 1636422551930, 626, 268, 358, 0, 0, 0
7170, 1, 1636422551347, 1636422552010, 663, 302, 361, 1, 34, 35
7171, 1, 1636422551682, 1636422552346, 664, 269, 395, 0, 1, 1
7172, 1, 1636422551860, 1636422552490, 630, 274, 356, 0, 0, 0
7174, 1, 1636422552147, 1636422552774, 627, 271, 356, 1, 1, 2
7097, 2, 1636422542727, 1636422552903, 10176, 0, 10176, 0, 0, 0
7175, 1, 1636422552447, 1636422553074, 627, 271, 356, 2, 1, 3
7102, 2, 1636422543171, 1636422553304, 10133, 0, 10133, 0, 1, 1
7177, 1, 1636422552962, 1636422553590, 628, 270, 358, 1, 2, 3
7108, 2, 1636422543583, 1636422553715, 10132, 0, 10132, 1, 0, 1
7109, 2, 1636422543736, 1636422553828, 10092, 1, 10091, 0, 2, 2
7180, 1, 1636422553438, 1636422554102, 664, 271, 393, 1, 0, 1
7114, 2, 1636422544207, 1636422554339, 10132, 0, 10132, 0, 0, 0
7181, 1, 1636422553756, 1636422554410, 654, 270, 384, 1, 0, 1
7182, 1, 1636422553846, 1636422554514, 668, 270, 398, 0, 0, 0
7183, 1, 1636422553958, 1636422554630, 672, 270, 402, 1, 0, 1
7184, 1, 1636422554191, 1636422554818, 627, 270, 357, 0, 0, 0
7185, 1, 1636422554470, 1636422555134, 664, 264, 400, 0, 0, 0
7186, 1, 1636422554556, 1636422555182, 626, 270, 356, 2, 0, 2
7187, 1, 1636422554607, 1636422555230, 623, 266, 357, 0, 0, 0
7188, 1, 1636422554709, 1636422555334, 625, 269, 356, 0, 0, 0
7189, 1, 1636422554989, 1636422555614, 625, 269, 356, 0, 0, 0
7127, 2, 1636422545544, 1636422555675, 10131, 0, 10131, 1, 0, 1
7190, 1, 1636422555235, 1636422555854, 619, 267, 352, 0, 0, 0
7191, 1, 1636422555360, 1636422555982, 622, 271, 351, 2, 0, 2
7131, 2, 1636422545857, 1636422555991, 10134, 0, 10134, 0, 0, 0
7193, 1, 1636422555506, 1636422556126, 620, 266, 354, 0, 0, 0
7133, 2, 1636422546120, 1636422556251, 10131, 0, 10131, 0, 0, 0
7194, 1, 1636422555801, 1636422556442, 641, 278, 363, 0, 15, 15
7195, 1, 1636422555806, 1636422556518, 712, 312, 400, 0, 43, 43
7197, 1, 1636422556119, 1636422556790, 671, 272, 399, 1, 1, 2
7198, 1, 1636422556167, 1636422556790, 623, 270, 353, 1, 1, 2
7138, 2, 1636422546663, 1636422556795, 10132, 0, 10132, 0, 0, 0
7199, 1, 1636422556318, 1636422556942, 624, 270, 354, 0, 1, 1
7200, 1, 1636422556382, 1636422557062, 680, 280, 400, 0, 10, 10
7201, 1, 1636422556565, 1636422557194, 629, 273, 356, 0, 0, 0
7143, 2, 1636422547292, 1636422557423, 10131, 1, 10130, 1, 0, 1
7203, 1, 1636422556870, 1636422557494, 624, 269, 355, 0, 0, 0
7205, 1, 1636422556977, 1636422557602, 625, 270, 355, 0, 0, 0
7204, 1, 1636422556930, 1636422557602, 672, 270, 402, 1, 0, 1
7207, 1, 1636422557145, 1636422557778, 633, 278, 355, 0, 10, 10
7209, 1, 1636422557550, 1636422558218, 668, 270, 398, 0, 0, 0
7210, 1, 1636422557668, 1636422558290, 622, 270, 352, 0, 0, 0
7211, 1, 1636422557690, 1636422558318, 628, 270, 358, 0, 0, 0
7212, 1, 1636422557776, 1636422558398, 622, 270, 352, 1, 0, 1
7213, 1, 1636422557955, 1636422558594, 639, 273, 366, 0, 0, 0
7214, 1, 1636422558318, 1636422558942, 624, 272, 352, 0, 1, 1
7155, 2, 1636422548856, 1636422558991, 10135, 1, 10134, 0, 0, 0
7215, 1, 1636422558481, 1636422559110, 629, 270, 359, 1, 0, 1
7216, 1, 1636422558503, 1636422559126, 623, 269, 354, 0, 0, 0
7158, 2, 1636422549113, 1636422559255, 10142, 0, 10142, 0, 0, 0
7218, 1, 1636422558748, 1636422559370, 622, 271, 351, 1, 1, 2
7161, 2, 1636422549491, 1636422559623, 10132, 1, 10131, 0, 0, 0
7162, 2, 1636422549654, 1636422559787, 10133, 0, 10133, 0, 0, 0
7219, 1, 1636422559122, 1636422559790, 668, 268, 400, 0, 0, 0
7220, 1, 1636422559130, 1636422559798, 668, 272, 396, 0, 0, 0
7222, 1, 1636422559290, 1636422559914, 624, 270, 354, 1, 0, 1
7223, 1, 1636422559390, 1636422560074, 684, 290, 394, 1, 18, 19
7164, 2, 1636422550021, 1636422560155, 10134, 0, 10134, 0, 0, 0
7224, 1, 1636422559540, 1636422560166, 626, 275, 351, 0, 0, 0
7165, 2, 1636422550245, 1636422560379, 10134, 0, 10134, 0, 0, 0
7225, 1, 1636422559788, 1636422560458, 670, 271, 399, 0, 1, 1
7226, 1, 1636422559882, 1636422560514, 632, 279, 353, 2, 6, 8
7228, 1, 1636422559927, 1636422560550, 623, 266, 357, 1, 0, 1
7227, 1, 1636422559918, 1636422560642, 724, 328, 396, 0, 60, 60
7229, 1, 1636422560084, 1636422560730, 646, 267, 379, 1, 1, 2
7230, 1, 1636422560156, 1636422560778, 622, 271, 351, 1, 1, 2
7232, 1, 1636422560324, 1636422560958, 634, 269, 365, 1, 0, 1
7231, 1, 1636422560286, 1636422560958, 672, 270, 402, 2, 0, 2
7234, 1, 1636422560517, 1636422561138, 621, 266, 355, 0, 0, 0
7233, 1, 1636422560510, 1636422561174, 664, 271, 393, 0, 1, 1
7236, 1, 1636422560691, 1636422561310, 619, 266, 353, 0, 0, 0
7237, 1, 1636422560719, 1636422561342, 623, 265, 358, 0, 1, 1
7235, 1, 1636422560676, 1636422561342, 666, 267, 399, 0, 2, 2
7238, 1, 1636422560880, 1636422561498, 618, 266, 352, 0, 0, 0
7239, 1, 1636422560939, 1636422561562, 623, 270, 353, 0, 1, 1
7240, 1, 1636422561049, 1636422561670, 621, 265, 356, 0, 0, 0
7241, 1, 1636422561136, 1636422561766, 630, 271, 359, 0, 1, 1
7242, 1, 1636422561265, 1636422561890, 625, 271, 354, 0, 0, 0
7243, 1, 1636422561330, 1636422561954, 624, 270, 354, 0, 0, 0
7244, 1, 1636422561465, 1636422562090, 625, 266, 359, 0, 0, 0
7246, 1, 1636422561503, 1636422562130, 627, 270, 357, 0, 0, 0
7173, 2, 1636422552121, 1636422562255, 10134, 1, 10133, 1, 0, 1
7247, 1, 1636422561687, 1636422562306, 619, 263, 356, 0, 0, 0
7245, 1, 1636422561478, 1636422562366, 888, 530, 358, 0, 0, 0
7248, 1, 1636422561751, 1636422562378, 627, 274, 353, 0, 0, 0
7249, 1, 1636422561862, 1636422562522, 660, 304, 356, 1, 34, 35
7250, 1, 1636422561933, 1636422562558, 625, 271, 354, 0, 0, 0
7251, 1, 1636422562062, 1636422562702, 640, 286, 354, 0, 18, 18
7176, 2, 1636422552672, 1636422562803, 10131, 1, 10130, 1, 0, 1
7253, 1, 1636422562277, 1636422562902, 625, 265, 360, 0, 0, 0
7254, 1, 1636422562319, 1636422562946, 627, 271, 356, 1, 0, 1
7252, 1, 1636422562117, 1636422562974, 857, 498, 359, 0, 1, 1
7256, 1, 1636422562390, 1636422563074, 684, 275, 409, 0, 6, 6
7257, 1, 1636422562476, 1636422563102, 626, 270, 356, 1, 0, 1
7178, 2, 1636422553034, 1636422563212, 10178, 1, 10177, 0, 1, 1
7259, 1, 1636422562658, 1636422563278, 620, 265, 355, 0, 0, 0
7260, 1, 1636422562748, 1636422563382, 634, 270, 364, 0, 0, 0
7179, 2, 1636422553304, 1636422563395, 10091, 0, 10091, 0, 0, 0
7261, 1, 1636422562877, 1636422563502, 625, 266, 359, 0, 0, 0
7262, 1, 1636422562934, 1636422563602, 668, 270, 398, 0, 0, 0
7265, 1, 1636422563113, 1636422563746, 633, 272, 361, 1, 6, 7
7266, 1, 1636422563146, 1636422563786, 640, 266, 374, 0, 0, 0
7267, 1, 1636422563290, 1636422563930, 640, 268, 372, 1, 0, 1
7269, 1, 1636422563451, 1636422564070, 619, 266, 353, 0, 0, 0
7271, 1, 1636422563542, 1636422564162, 620, 261, 359, 0, 0, 0
7270, 1, 1636422563526, 1636422564186, 660, 265, 395, 0, 0, 0
7273, 1, 1636422563694, 1636422564322, 628, 271, 357, 0, 0, 0
7274, 1, 1636422563921, 1636422564554, 633, 270, 363, 0, 0, 0
7275, 1, 1636422563955, 1636422564578, 623, 270, 353, 0, 0, 0
7276, 1, 1636422564085, 1636422564710, 625, 270, 355, 1, 0, 1
7277, 1, 1636422564235, 1636422564862, 627, 274, 353, 0, 1, 1
7278, 1, 1636422564292, 1636422564914, 622, 270, 352, 0, 0, 0
7279, 1, 1636422564326, 1636422564950, 624, 270, 354, 1, 1, 2
7280, 1, 1636422564507, 1636422565130, 623, 269, 354, 0, 1, 1
7281, 1, 1636422564716, 1636422565346, 630, 278, 352, 0, 1, 1
7282, 1, 1636422564741, 1636422565366, 625, 266, 359, 0, 1, 1
7283, 1, 1636422564868, 1636422565490, 622, 267, 355, 1, 1, 2
7192, 2, 1636422555422, 1636422565555, 10133, 0, 10133, 0, 0, 0
7284, 1, 1636422565051, 1636422565670, 619, 266, 353, 0, 0, 0
7285, 1, 1636422565105, 1636422565734, 629, 270, 359, 0, 0, 0
7286, 1, 1636422565130, 1636422565762, 632, 274, 358, 1, 0, 1
7287, 1, 1636422565294, 1636422565918, 624, 263, 361, 0, 0, 0
7288, 1, 1636422565509, 1636422566134, 625, 270, 355, 0, 0, 0
7196, 2, 1636422556040, 1636422566171, 10131, 0, 10131, 0, 0, 0
7289, 1, 1636422565556, 1636422566186, 630, 269, 361, 0, 0, 0
7290, 1, 1636422565672, 1636422566290, 618, 266, 352, 0, 0, 0
7291, 1, 1636422565690, 1636422566366, 676, 275, 401, 2, 0, 2
7292, 1, 1636422565839, 1636422566462, 623, 270, 353, 0, 0, 0
7293, 1, 1636422565892, 1636422566526, 634, 278, 356, 0, 9, 9
7294, 1, 1636422565937, 1636422566554, 617, 262, 355, 0, 0, 0
7295, 1, 1636422566086, 1636422566706, 620, 267, 353, 0, 0, 0
7202, 2, 1636422556589, 1636422566723, 10134, 0, 10134, 1, 0, 1
7297, 1, 1636422566311, 1636422566942, 631, 274, 357, 0, 0, 0
7298, 1, 1636422566322, 1636422566990, 668, 313, 355, 1, 43, 44
7296, 1, 1636422566302, 1636422566990, 688, 289, 399, 0, 19, 19
7299, 1, 1636422566448, 1636422567074, 626, 274, 352, 1, 14, 15
7300, 1, 1636422566481, 1636422567106, 625, 262, 363, 0, 0, 0
7206, 2, 1636422557103, 1636422567236, 10133, 0, 10133, 0, 0, 0
7301, 1, 1636422566654, 1636422567294, 640, 260, 380, 1, 1, 2
7302, 1, 1636422566724, 1636422567306, 582, 270, 312, 0, 0, 0
7303, 1, 1636422566738, 1636422567362, 624, 270, 354, 1, 0, 1
7305, 1, 1636422566877, 1636422567510, 633, 270, 363, 0, 1, 1
7208, 2, 1636422557424, 1636422567515, 10091, 1, 10090, 0, 1, 1
7304, 1, 1636422566854, 1636422567517, 663, 270, 393, 0, 0, 0
7306, 1, 1636422567061, 1636422567686, 625, 266, 359, 0, 0, 0
7308, 1, 1636422567123, 1636422567782, 659, 276, 383, 1, 6, 7
7307, 1, 1636422567117, 1636422567786, 669, 277, 392, 0, 7, 7
7309, 1, 1636422567261, 1636422567882, 621, 267, 354, 1, 0, 1
7310, 1, 1636422567291, 1636422567966, 675, 272, 403, 0, 0, 0
7311, 1, 1636422567366, 1636422568049, 683, 266, 417, 1, 2, 3
7313, 1, 1636422567470, 1636422568094, 624, 274, 350, 0, 1, 1
7312, 1, 1636422567448, 1636422568094, 646, 263, 383, 1, 0, 1
7315, 1, 1636422567621, 1636422568250, 629, 270, 359, 0, 0, 0
7317, 1, 1636422567688, 1636422568306, 618, 267, 351, 1, 2, 3
7314, 1, 1636422567537, 1636422568326, 789, 425, 364, 0, 1, 1
7316, 1, 1636422567647, 1636422568326, 679, 275, 404, 1, 1, 2
7318, 1, 1636422567874, 1636422568498, 624, 267, 357, 1, 0, 1
7320, 1, 1636422567929, 1636422568550, 621, 263, 358, 0, 0, 0
7319, 1, 1636422567923, 1636422568550, 627, 266, 361, 0, 0, 0
7321, 1, 1636422568048, 1636422568666, 618, 266, 352, 0, 0, 0
7217, 2, 1636422558571, 1636422568703, 10132, 0, 10132, 0, 0, 0
7322, 1, 1636422568083, 1636422568706, 623, 270, 353, 0, 0, 0
7323, 1, 1636422568123, 1636422568749, 626, 274, 352, 0, 0, 0
7324, 1, 1636422568243, 1636422568858, 615, 263, 352, 0, 0, 0
7325, 1, 1636422568286, 1636422568906, 620, 267, 353, 0, 0, 0
7327, 1, 1636422568409, 1636422569058, 649, 294, 355, 1, 26, 27
7329, 1, 1636422568476, 1636422569094, 618, 267, 351, 0, 0, 0
7330, 1, 1636422568704, 1636422569290, 586, 274, 312, 0, 0, 0
7331, 1, 1636422568728, 1636422569358, 630, 270, 360, 0, 0, 0
7332, 1, 1636422568737, 1636422569370, 633, 273, 360, 0, 0, 0
7221, 2, 1636422559267, 1636422569400, 10133, 0, 10133, 0, 0, 0
7334, 1, 1636422568840, 1636422569466, 626, 270, 356, 0, 0, 0
7333, 1, 1636422568834, 1636422569510, 676, 274, 402, 1, 0, 1
7337, 1, 1636422569061, 1636422569690, 629, 266, 363, 0, 0, 0
7338, 1, 1636422569079, 1636422569698, 619, 266, 353, 0, 0, 0
7339, 1, 1636422569218, 1636422569846, 628, 274, 354, 0, 6, 6
7340, 1, 1636422569282, 1636422569942, 660, 277, 383, 2, 1, 3
7341, 1, 1636422569453, 1636422570078, 625, 266, 359, 0, 0, 0
7343, 1, 1636422569526, 1636422570146, 620, 266, 354, 1, 0, 1
7344, 1, 1636422569530, 1636422570194, 664, 270, 394, 0, 0, 0
7345, 1, 1636422569588, 1636422570214, 626, 270, 356, 1, 1, 2
7346, 1, 1636422569624, 1636422570254, 630, 270, 360, 0, 0, 0
7347, 1, 1636422569867, 1636422570498, 631, 271, 360, 0, 0, 0
7348, 1, 1636422569886, 1636422570502, 616, 262, 354, 0, 0, 0
7349, 1, 1636422570005, 1636422570634, 629, 268, 361, 0, 0, 0
7350, 1, 1636422570072, 1636422570698, 626, 274, 352, 0, 1, 1
7351, 1, 1636422570237, 1636422570866, 629, 273, 356, 0, 0, 0
7352, 1, 1636422570297, 1636422570918, 621, 266, 355, 2, 0, 2
7353, 1, 1636422570310, 1636422570938, 628, 271, 357, 1, 0, 1
7354, 1, 1636422570373, 1636422570998, 625, 271, 354, 0, 1, 1
7355, 1, 1636422570436, 1636422571058, 622, 266, 356, 0, 0, 0
7356, 1, 1636422570668, 1636422571290, 622, 271, 351, 1, 1, 2
7357, 1, 1636422570680, 1636422571298, 618, 267, 351, 1, 0, 1
7358, 1, 1636422570798, 1636422571422, 624, 264, 360, 1, 0, 1
7359, 1, 1636422570856, 1636422571482, 626, 275, 351, 0, 1, 1
7360, 1, 1636422571053, 1636422571682, 629, 275, 354, 0, 0, 0
7362, 1, 1636422571114, 1636422571742, 628, 270, 358, 1, 1, 2
7363, 1, 1636422571170, 1636422571798, 628, 271, 357, 2, 0, 2
7364, 1, 1636422571229, 1636422571854, 625, 270, 355, 0, 0, 0
7365, 1, 1636422571468, 1636422572090, 622, 270, 352, 0, 0, 0
7366, 1, 1636422571479, 1636422572110, 631, 270, 361, 1, 1, 2
7367, 1, 1636422571583, 1636422572206, 623, 269, 354, 0, 0, 0
7368, 1, 1636422571659, 1636422572282, 623, 270, 353, 0, 0, 0
7369, 1, 1636422571846, 1636422572466, 620, 266, 354, 0, 0, 0
7370, 1, 1636422571916, 1636422572538, 622, 269, 353, 0, 0, 0
7255, 2, 1636422562368, 1636422572547, 10179, 0, 10179, 0, 0, 0
7371, 1, 1636422571972, 1636422572594, 622, 271, 351, 0, 0, 0
7372, 1, 1636422572042, 1636422572670, 628, 270, 358, 1, 0, 1
7258, 2, 1636422562536, 1636422572671, 10135, 1, 10134, 0, 0, 0
7374, 1, 1636422572284, 1636422572934, 650, 302, 348, 0, 34, 34
7375, 1, 1636422572398, 1636422573029, 631, 274, 357, 0, 6, 6
7376, 1, 1636422572461, 1636422573122, 661, 302, 359, 0, 37, 37
7263, 2, 1636422562975, 1636422573147, 10172, 0, 10172, 0, 0, 0
7264, 2, 1636422563062, 1636422573195, 10133, 0, 10133, 0, 0, 0
7377, 1, 1636422572671, 1636422573286, 615, 263, 352, 0, 0, 0
7379, 1, 1636422572716, 1636422573346, 630, 270, 360, 0, 0, 0
7380, 1, 1636422572760, 1636422573414, 654, 300, 354, 0, 34, 34
7382, 1, 1636422572827, 1636422573457, 630, 281, 349, 0, 15, 15
7381, 1, 1636422572798, 1636422573502, 704, 310, 394, 1, 38, 39
7268, 2, 1636422563342, 1636422573519, 10177, 0, 10177, 0, 0, 0
7383, 1, 1636422573097, 1636422573722, 625, 261, 364, 0, 1, 1
7272, 2, 1636422563661, 1636422573795, 10134, 0, 10134, 0, 0, 0
7384, 1, 1636422573196, 1636422573818, 622, 270, 352, 0, 0, 0
7385, 1, 1636422573270, 1636422573898, 628, 266, 362, 0, 0, 0
7387, 1, 1636422573326, 1636422573990, 664, 262, 402, 0, 0, 0
7388, 1, 1636422573445, 1636422574102, 657, 267, 390, 1, 0, 1
7391, 1, 1636422573567, 1636422574194, 627, 271, 356, 2, 1, 3
7390, 1, 1636422573558, 1636422574245, 687, 286, 401, 0, 18, 18
7392, 1, 1636422573621, 1636422574245, 624, 266, 358, 0, 0, 0
7389, 1, 1636422573520, 1636422574262, 742, 382, 360, 0, 1, 1
7393, 1, 1636422573650, 1636422574334, 684, 261, 423, 0, 1, 1
7394, 1, 1636422573907, 1636422574538, 631, 274, 357, 1, 0, 1
7395, 1, 1636422573926, 1636422574602, 676, 274, 402, 0, 0, 0
7396, 1, 1636422574008, 1636422574630, 622, 267, 355, 1, 0, 1
7398, 1, 1636422574090, 1636422574714, 624, 272, 352, 1, 1, 2
7399, 1, 1636422574244, 1636422574870, 626, 266, 360, 0, 0, 0
7397, 1, 1636422574069, 1636422574870, 801, 434, 367, 0, 0, 0
7402, 1, 1636422574368, 1636422574998, 630, 270, 360, 0, 0, 0
7403, 1, 1636422574404, 1636422575026, 622, 266, 356, 0, 0, 0
7404, 1, 1636422574425, 1636422575058, 633, 270, 363, 1, 0, 1
7405, 1, 1636422574688, 1636422575310, 622, 270, 352, 0, 0, 0
7406, 1, 1636422574708, 1636422575330, 622, 271, 351, 1, 2, 3
7407, 1, 1636422574794, 1636422575426, 632, 270, 362, 2, 0, 2
7408, 1, 1636422574871, 1636422575538, 667, 272, 395, 1, 2, 3
7410, 1, 1636422575048, 1636422575670, 622, 270, 352, 1, 0, 1
7411, 1, 1636422575169, 1636422575794, 625, 269, 356, 0, 1, 1
7412, 1, 1636422575201, 1636422575826, 625, 270, 355, 1, 0, 1
7413, 1, 1636422575231, 1636422575858, 627, 271, 356, 1, 1, 2
7416, 1, 1636422575589, 1636422576226, 637, 270, 367, 0, 1, 1
7417, 1, 1636422575683, 1636422576306, 623, 270, 353, 1, 1, 2
7418, 1, 1636422575850, 1636422576474, 624, 270, 354, 0, 1, 1
7419, 1, 1636422575974, 1636422576598, 624, 270, 354, 0, 0, 0
7420, 1, 1636422576013, 1636422576634, 621, 267, 354, 0, 0, 0
7421, 1, 1636422576041, 1636422576670, 629, 267, 362, 0, 1, 1
7422, 1, 1636422576395, 1636422577018, 623, 271, 352, 0, 2, 2
7423, 1, 1636422576475, 1636422577102, 627, 274, 353, 0, 2, 2
7424, 1, 1636422576660, 1636422577282, 622, 270, 352, 0, 2, 2
7425, 1, 1636422576789, 1636422577410, 621, 266, 355, 0, 1, 1
7427, 1, 1636422576840, 1636422577458, 618, 267, 351, 0, 0, 0
7428, 1, 1636422577196, 1636422577818, 622, 268, 354, 0, 0, 0
7429, 1, 1636422577261, 1636422577894, 633, 270, 363, 0, 0, 0
7430, 1, 1636422577459, 1636422578082, 623, 270, 353, 0, 0, 0
7431, 1, 1636422577587, 1636422578210, 623, 269, 354, 0, 1, 1
7326, 2, 1636422568338, 1636422578515, 10177, 0, 10177, 0, 0, 0
7328, 2, 1636422568437, 1636422578571, 10134, 0, 10134, 0, 0, 0
7433, 1, 1636422578007, 1636422578630, 623, 268, 355, 0, 0, 0
7434, 1, 1636422578056, 1636422578682, 626, 270, 356, 0, 0, 0
7335, 2, 1636422568878, 1636422579012, 10134, 1, 10133, 0, 0, 0
7436, 1, 1636422578401, 1636422579050, 649, 270, 379, 1, 0, 1
7336, 2, 1636422568939, 1636422579072, 10133, 0, 10133, 0, 0, 0
7438, 1, 1636422578698, 1636422579366, 668, 273, 395, 0, 6, 6
7437, 1, 1636422578658, 1636422579370, 712, 310, 402, 0, 42, 42
7439, 1, 1636422578806, 1636422579458, 652, 299, 353, 2, 23, 25
7440, 1, 1636422578868, 1636422579522, 654, 303, 351, 0, 30, 30
7342, 2, 1636422569519, 1636422579655, 10136, 0, 10136, 1, 0, 1
7442, 1, 1636422579199, 1636422579826, 627, 274, 353, 1, 0, 1
7441, 1, 1636422579158, 1636422579830, 672, 269, 403, 0, 0, 0
7443, 1, 1636422579202, 1636422579874, 672, 267, 405, 0, 2, 2
7444, 1, 1636422579414, 1636422580042, 628, 270, 358, 2, 0, 2
7447, 1, 1636422579663, 1636422580294, 631, 271, 360, 0, 1, 1
7445, 1, 1636422579465, 1636422580310, 845, 491, 354, 1, 0, 1
7448, 1, 1636422579786, 1636422580458, 672, 275, 397, 1, 1, 2
7449, 1, 1636422579912, 1636422580582, 670, 317, 353, 1, 0, 1
7451, 1, 1636422579984, 1636422580602, 618, 267, 351, 0, 0, 0
7452, 1, 1636422580199, 1636422580826, 627, 269, 358, 0, 0, 0
7450, 1, 1636422579963, 1636422580850, 887, 530, 357, 0, 0, 0
7453, 1, 1636422580312, 1636422580974, 662, 270, 392, 1, 0, 1
7454, 1, 1636422580475, 1636422581102, 627, 270, 357, 0, 0, 0
7455, 1, 1636422580543, 1636422581162, 619, 266, 353, 0, 0, 0
7361, 2, 1636422571112, 1636422581247, 10135, 1, 10134, 1, 0, 1
7456, 1, 1636422580709, 1636422581334, 625, 271, 354, 0, 0, 0
7457, 1, 1636422580775, 1636422581410, 635, 274, 361, 0, 0, 0
7458, 1, 1636422580851, 1636422581526, 675, 270, 405, 0, 0, 0
7459, 1, 1636422580995, 1636422581622, 627, 270, 357, 0, 0, 0
7460, 1, 1636422581102, 1636422581730, 628, 270, 358, 0, 0, 0
7461, 1, 1636422581276, 1636422581898, 622, 270, 352, 0, 0, 0
7462, 1, 1636422581328, 1636422581946, 618, 266, 352, 0, 0, 0
7463, 1, 1636422581378, 1636422582038, 660, 267, 393, 0, 1, 1
7464, 1, 1636422581505, 1636422582130, 625, 270, 355, 1, 0, 1
7465, 1, 1636422581561, 1636422582194, 633, 274, 359, 0, 1, 1
7466, 1, 1636422581650, 1636422582278, 628, 268, 360, 1, 0, 1
7373, 2, 1636422572262, 1636422582395, 10133, 0, 10133, 0, 0, 0
7467, 1, 1636422581807, 1636422582430, 623, 270, 353, 0, 0, 0
7469, 1, 1636422582073, 1636422582694, 621, 266, 355, 0, 0, 0
7470, 1, 1636422582112, 1636422582746, 634, 283, 351, 0, 17, 17
7471, 1, 1636422582146, 1636422582770, 624, 269, 355, 0, 0, 0
7378, 2, 1636422572682, 1636422582867, 10185, 0, 10185, 0, 0, 0
7472, 1, 1636422582317, 1636422582986, 669, 282, 387, 1, 0, 1
7473, 1, 1636422582396, 1636422583022, 626, 275, 351, 0, 0, 0
7475, 1, 1636422582526, 1636422583222, 696, 301, 395, 0, 34, 34
7476, 1, 1636422582596, 1636422583222, 626, 274, 352, 0, 6, 6
7386, 2, 1636422573282, 1636422583459, 10177, 0, 10177, 0, 0, 0
7477, 1, 1636422582877, 1636422583502, 625, 268, 357, 0, 0, 0
7478, 1, 1636422582917, 1636422583546, 629, 266, 363, 0, 0, 0
7479, 1, 1636422582959, 1636422583590, 631, 271, 360, 1, 0, 1
7480, 1, 1636422582998, 1636422583666, 668, 266, 402, 1, 0, 1
7481, 1, 1636422583115, 1636422583742, 627, 271, 356, 1, 0, 1
7482, 1, 1636422583156, 1636422583810, 654, 302, 352, 1, 38, 39
7483, 1, 1636422583286, 1636422583914, 628, 270, 358, 1, 0, 1
7484, 1, 1636422583411, 1636422584038, 627, 269, 358, 1, 0, 1
7485, 1, 1636422583590, 1636422584258, 668, 271, 397, 0, 1, 1
7486, 1, 1636422583693, 1636422584322, 629, 271, 358, 1, 0, 1
7487, 1, 1636422583712, 1636422584338, 626, 267, 359, 0, 0, 0
7488, 1, 1636422583746, 1636422584366, 620, 266, 354, 1, 0, 1
7489, 1, 1636422583751, 1636422584370, 619, 266, 353, 0, 0, 0
7400, 2, 1636422574316, 1636422584447, 10131, 0, 10131, 0, 0, 0
7401, 2, 1636422574360, 1636422584495, 10135, 0, 10135, 1, 0, 1
7490, 1, 1636422583929, 1636422584550, 621, 270, 351, 0, 0, 0
7491, 1, 1636422583948, 1636422584566, 618, 268, 350, 1, 1, 2
7492, 1, 1636422584071, 1636422584714, 643, 288, 355, 0, 22, 22
7493, 1, 1636422584213, 1636422584854, 641, 282, 359, 1, 10, 11
7494, 1, 1636422584350, 1636422584986, 636, 268, 368, 0, 0, 0
7409, 2, 1636422574907, 1636422585039, 10132, 1, 10131, 0, 0, 0
7495, 1, 1636422584496, 1636422585122, 626, 270, 356, 1, 0, 1
7496, 1, 1636422584525, 1636422585146, 621, 271, 350, 0, 0, 0
7497, 1, 1636422584539, 1636422585166, 627, 266, 361, 0, 0, 0
7498, 1, 1636422584558, 1636422585182, 624, 271, 353, 0, 0, 0
7499, 1, 1636422584586, 1636422585254, 668, 270, 398, 1, 0, 1
7500, 1, 1636422584622, 1636422585306, 684, 287, 397, 0, 18, 18
7502, 1, 1636422584733, 1636422585394, 661, 302, 359, 0, 38, 38
7501, 1, 1636422584730, 1636422585402, 672, 314, 358, 0, 42, 42
7503, 1, 1636422584866, 1636422585490, 624, 266, 358, 0, 0, 0
7504, 1, 1636422585040, 1636422585618, 578, 262, 316, 0, 0, 0
7415, 2, 1636422575504, 1636422585635, 10131, 1, 10130, 0, 1, 1
7414, 2, 1636422575503, 1636422585683, 10180, 1, 10179, 1, 0, 1
7505, 1, 1636422585161, 1636422585794, 633, 279, 354, 1, 1, 2
7506, 1, 1636422585174, 1636422585846, 672, 273, 399, 0, 0, 0
7507, 1, 1636422585306, 1636422585950, 644, 287, 357, 0, 23, 23
7510, 1, 1636422585339, 1636422586038, 699, 301, 398, 1, 31, 32
7511, 1, 1636422585351, 1636422586038, 687, 336, 351, 2, 14, 16
7508, 1, 1636422585324, 1636422586042, 718, 317, 401, 48, 1, 49
7509, 1, 1636422585327, 1636422586042, 715, 311, 404, 0, 39, 39
7513, 1, 1636422585523, 1636422586222, 699, 315, 384, 48, 2, 50
7514, 1, 1636422585525, 1636422586230, 705, 328, 377, 50, 0, 50
7515, 1, 1636422585684, 1636422586306, 622, 269, 353, 1, 1, 2
7512, 1, 1636422585388, 1636422586310, 922, 567, 355, 2, 1, 3
7516, 1, 1636422585770, 1636422586438, 668, 271, 397, 1, 1, 2
7518, 1, 1636422585814, 1636422586442, 628, 269, 359, 0, 0, 0
7517, 1, 1636422585770, 1636422586442, 672, 272, 400, 2, 0, 2
7520, 1, 1636422585957, 1636422586582, 625, 270, 355, 0, 1, 1
7519, 1, 1636422585933, 1636422586586, 653, 291, 362, 2, 0, 2
7521, 1, 1636422586092, 1636422586706, 614, 264, 350, 0, 2, 2
7524, 1, 1636422586137, 1636422586754, 617, 266, 351, 0, 0, 0
7523, 1, 1636422586130, 1636422586758, 628, 266, 362, 0, 0, 0
7522, 1, 1636422586128, 1636422586758, 630, 271, 359, 0, 0, 0
7426, 2, 1636422576798, 1636422586931, 10133, 0, 10133, 0, 0, 0
7527, 1, 1636422586325, 1636422586950, 625, 270, 355, 0, 0, 0
7526, 1, 1636422586311, 1636422586986, 675, 269, 406, 0, 0, 0
7525, 1, 1636422586151, 1636422587026, 875, 514, 361, 1, 1, 2
7529, 1, 1636422586466, 1636422587094, 628, 275, 353, 1, 1, 2
7530, 1, 1636422586525, 1636422587194, 669, 317, 352, 0, 39, 39
7532, 1, 1636422586629, 1636422587290, 661, 311, 350, 1, 38, 39
7533, 1, 1636422586741, 1636422587378, 637, 282, 355, 1, 13, 14
7534, 1, 1636422586771, 1636422587390, 619, 262, 357, 0, 0, 0
7531, 1, 1636422586531, 1636422587466, 935, 579, 356, 1, 1, 2
7535, 1, 1636422586875, 1636422587506, 631, 267, 364, 2, 0, 2
7536, 1, 1636422586931, 1636422587554, 623, 271, 352, 0, 0, 0
7537, 1, 1636422586931, 1636422587554, 623, 270, 353, 2, 0, 2
7538, 1, 1636422586942, 1636422587562, 620, 266, 354, 0, 0, 0
7539, 1, 1636422587027, 1636422587686, 659, 262, 397, 0, 0, 0
7540, 1, 1636422587062, 1636422587734, 672, 270, 402, 0, 0, 0
7541, 1, 1636422587109, 1636422587734, 625, 266, 359, 0, 0, 0
7432, 2, 1636422577632, 1636422587763, 10131, 1, 10130, 0, 1, 1
7542, 1, 1636422587141, 1636422587770, 629, 266, 363, 0, 0, 0
7543, 1, 1636422587280, 1636422587910, 630, 274, 356, 0, 0, 0
7544, 1, 1636422587322, 1636422587946, 624, 270, 354, 0, 0, 0
7545, 1, 1636422587426, 1636422588054, 628, 274, 354, 0, 0, 0
7546, 1, 1636422587467, 1636422588130, 663, 266, 397, 0, 0, 0
7547, 1, 1636422587528, 1636422588150, 622, 270, 352, 0, 0, 0
7548, 1, 1636422587566, 1636422588214, 648, 286, 362, 1, 19, 20
7549, 1, 1636422587661, 1636422588302, 641, 272, 369, 0, 0, 0
7552, 1, 1636422587765, 1636422588354, 589, 270, 319, 1, 0, 1
7435, 2, 1636422578255, 1636422588387, 10132, 0, 10132, 0, 0, 0
7550, 1, 1636422587764, 1636422588390, 626, 271, 355, 0, 0, 0
7551, 1, 1636422587765, 1636422588398, 633, 271, 362, 0, 1, 1
7553, 1, 1636422587819, 1636422588438, 619, 266, 353, 1, 0, 1
7554, 1, 1636422587829, 1636422588458, 629, 270, 359, 0, 0, 0
7557, 1, 1636422587937, 1636422588570, 633, 275, 358, 0, 2, 2
7555, 1, 1636422587894, 1636422588570, 676, 274, 402, 1, 1, 2
7558, 1, 1636422588085, 1636422588742, 657, 303, 354, 0, 40, 40
7559, 1, 1636422588117, 1636422588742, 625, 270, 355, 1, 2, 3
7560, 1, 1636422588240, 1636422588870, 630, 274, 356, 0, 0, 0
7561, 1, 1636422588256, 1636422588926, 670, 267, 403, 1, 0, 1
7562, 1, 1636422588320, 1636422588966, 646, 267, 379, 1, 0, 1
7563, 1, 1636422588388, 1636422589010, 622, 267, 355, 1, 2, 3
7564, 1, 1636422588451, 1636422589082, 631, 270, 361, 0, 0, 0
7566, 1, 1636422588519, 1636422589142, 623, 266, 357, 1, 0, 1
7567, 1, 1636422588522, 1636422589154, 632, 270, 362, 0, 0, 0
7568, 1, 1636422588554, 1636422589174, 620, 266, 354, 0, 0, 0
7565, 1, 1636422588518, 1636422589186, 668, 270, 398, 0, 0, 0
7570, 1, 1636422588639, 1636422589258, 619, 266, 353, 0, 0, 0
7571, 1, 1636422588646, 1636422589270, 624, 265, 359, 0, 0, 0
7572, 1, 1636422588752, 1636422589386, 634, 266, 368, 0, 0, 0
7573, 1, 1636422588880, 1636422589502, 622, 268, 354, 1, 2, 3
7574, 1, 1636422588929, 1636422589554, 625, 271, 354, 0, 1, 1
7575, 1, 1636422589039, 1636422589670, 631, 269, 362, 0, 0, 0
7577, 1, 1636422589117, 1636422589746, 629, 274, 355, 1, 0, 1
7446, 2, 1636422579595, 1636422589747, 10152, 0, 10152, 0, 0, 0
7578, 1, 1636422589165, 1636422589794, 629, 274, 355, 0, 1, 1
7579, 1, 1636422589249, 1636422589878, 629, 271, 358, 0, 1, 1
7580, 1, 1636422589273, 1636422589893, 620, 266, 354, 0, 0, 0
7581, 1, 1636422589303, 1636422589938, 635, 271, 364, 1, 0, 1
7582, 1, 1636422589334, 1636422589962, 628, 271, 357, 1, 0, 1
7583, 1, 1636422589369, 1636422590018, 649, 289, 360, 0, 26, 26
7585, 1, 1636422589450, 1636422590106, 656, 293, 363, 0, 31, 31
7584, 1, 1636422589432, 1636422590106, 674, 267, 407, 0, 0, 0
7586, 1, 1636422589552, 1636422590198, 646, 290, 356, 0, 22, 22
7587, 1, 1636422589684, 1636422590322, 638, 265, 373, 0, 0, 0
7588, 1, 1636422589749, 1636422590370, 621, 271, 350, 0, 1, 1
7589, 1, 1636422589828, 1636422590454, 626, 272, 354, 0, 0, 0
7590, 1, 1636422589878, 1636422590546, 668, 265, 403, 1, 0, 1
7591, 1, 1636422589928, 1636422590558, 630, 271, 359, 2, 1, 3
7592, 1, 1636422589967, 1636422590598, 631, 279, 352, 0, 1, 1
7593, 1, 1636422590040, 1636422590658, 618, 266, 352, 0, 1, 1
7594, 1, 1636422590058, 1636422590678, 620, 266, 354, 0, 0, 0
7595, 1, 1636422590109, 1636422590730, 621, 266, 355, 0, 0, 0
7596, 1, 1636422590135, 1636422590766, 631, 270, 361, 0, 0, 0
7597, 1, 1636422590161, 1636422590778, 617, 266, 351, 0, 0, 0
7598, 1, 1636422590229, 1636422590854, 625, 271, 354, 1, 1, 2
7599, 1, 1636422590257, 1636422590886, 629, 270, 359, 0, 0, 0
7600, 1, 1636422590344, 1636422590978, 634, 269, 365, 0, 0, 0
7601, 1, 1636422590487, 1636422591114, 627, 274, 353, 0, 0, 0
7602, 1, 1636422590524, 1636422591150, 626, 270, 356, 0, 0, 0
7603, 1, 1636422590625, 1636422591250, 625, 270, 355, 0, 0, 0
7604, 1, 1636422590633, 1636422591254, 621, 266, 355, 0, 0, 0
7605, 1, 1636422590723, 1636422591334, 611, 258, 353, 0, 0, 0
7606, 1, 1636422590768, 1636422591386, 618, 262, 356, 0, 0, 0
7607, 1, 1636422590826, 1636422591454, 628, 266, 362, 0, 0, 0
7608, 1, 1636422590854, 1636422591478, 624, 262, 362, 0, 0, 0
7609, 1, 1636422590911, 1636422591542, 631, 270, 361, 0, 0, 0
7610, 1, 1636422590935, 1636422591566, 631, 273, 358, 0, 0, 0
7611, 1, 1636422590944, 1636422591566, 622, 266, 356, 0, 0, 0
7612, 1, 1636422591041, 1636422591670, 629, 270, 359, 0, 0, 0
7613, 1, 1636422591070, 1636422591694, 624, 266, 358, 1, 0, 1
7614, 1, 1636422591131, 1636422591758, 627, 270, 357, 0, 0, 0
7615, 1, 1636422591285, 1636422591906, 621, 266, 355, 0, 0, 0
7616, 1, 1636422591325, 1636422591954, 629, 270, 359, 0, 0, 0
7468, 2, 1636422581889, 1636422592023, 10134, 0, 10134, 0, 0, 0
7617, 1, 1636422591411, 1636422592030, 619, 263, 356, 0, 0, 0
7618, 1, 1636422591419, 1636422592042, 623, 267, 356, 0, 1, 1
7619, 1, 1636422591529, 1636422592150, 621, 266, 355, 0, 0, 0
7620, 1, 1636422591566, 1636422592198, 632, 273, 359, 0, 0, 0
7621, 1, 1636422591616, 1636422592290, 674, 269, 405, 1, 0, 1
7622, 1, 1636422591666, 1636422592302, 636, 274, 362, 0, 0, 0
7623, 1, 1636422591711, 1636422592382, 671, 313, 358, 2, 42, 44
7625, 1, 1636422591749, 1636422592382, 633, 272, 361, 0, 6, 6
7624, 1, 1636422591741, 1636422592382, 641, 282, 359, 2, 14, 16
7626, 1, 1636422591830, 1636422592470, 640, 285, 355, 1, 18, 19
7627, 1, 1636422591877, 1636422592502, 625, 271, 354, 0, 1, 1
7628, 1, 1636422591916, 1636422592558, 642, 263, 379, 0, 0, 0
7474, 2, 1636422582436, 1636422592567, 10131, 0, 10131, 0, 0, 0
7629, 1, 1636422592099, 1636422592722, 623, 267, 356, 0, 0, 0
7630, 1, 1636422592122, 1636422592746, 624, 266, 358, 0, 0, 0
7634, 1, 1636422592313, 1636422592938, 625, 269, 356, 1, 0, 1
7636, 1, 1636422592414, 1636422593046, 632, 269, 363, 0, 0, 0
7637, 1, 1636422592461, 1636422593110, 649, 272, 377, 0, 1, 1
7638, 1, 1636422592503, 1636422593158, 655, 273, 382, 1, 0, 1
7640, 1, 1636422592569, 1636422593194, 625, 271, 354, 2, 1, 3
7639, 1, 1636422592568, 1636422593202, 634, 270, 364, 0, 0, 0
7641, 1, 1636422592641, 1636422593274, 633, 269, 364, 0, 0, 0
7642, 1, 1636422592684, 1636422593310, 626, 269, 357, 0, 0, 0
7645, 1, 1636422592889, 1636422593514, 625, 266, 359, 0, 0, 0
7646, 1, 1636422592926, 1636422593546, 620, 267, 353, 0, 0, 0
7647, 1, 1636422593097, 1636422593730, 633, 278, 355, 1, 0, 1
7649, 1, 1636422593271, 1636422593894, 623, 270, 353, 1, 0, 1
7652, 1, 1636422593348, 1636422593970, 622, 270, 352, 0, 0, 0
7653, 1, 1636422593447, 1636422594070, 623, 270, 353, 0, 1, 1
7654, 1, 1636422593476, 1636422594098, 622, 270, 352, 1, 0, 1
7655, 1, 1636422593674, 1636422594302, 628, 269, 359, 0, 0, 0
7656, 1, 1636422593742, 1636422594366, 624, 270, 354, 0, 0, 0
7657, 1, 1636422593902, 1636422594530, 628, 270, 358, 0, 0, 0
7658, 1, 1636422594072, 1636422594690, 618, 266, 352, 0, 0, 0
7659, 1, 1636422594163, 1636422594790, 627, 270, 357, 1, 0, 1
7660, 1, 1636422594245, 1636422594870, 625, 270, 355, 0, 1, 1
7661, 1, 1636422594262, 1636422594890, 628, 270, 358, 0, 0, 0
7662, 1, 1636422594460, 1636422595094, 634, 270, 364, 0, 0, 0
7663, 1, 1636422594539, 1636422595162, 623, 270, 353, 1, 0, 1
7664, 1, 1636422594704, 1636422595330, 626, 274, 352, 0, 0, 0
7665, 1, 1636422594856, 1636422595478, 622, 272, 350, 0, 1, 1
7666, 1, 1636422594953, 1636422595578, 625, 270, 355, 1, 0, 1
7667, 1, 1636422595050, 1636422595674, 624, 266, 358, 0, 1, 1
7669, 1, 1636422595245, 1636422595870, 625, 268, 357, 0, 1, 1
7670, 1, 1636422595353, 1636422595978, 625, 269, 356, 0, 0, 0
7671, 1, 1636422595514, 1636422596134, 620, 266, 354, 1, 1, 2
7672, 1, 1636422595661, 1636422596282, 621, 270, 351, 0, 0, 0
7673, 1, 1636422595737, 1636422596362, 625, 271, 354, 2, 0, 2
7528, 2, 1636422586332, 1636422596464, 10132, 0, 10132, 0, 0, 0
7674, 1, 1636422595864, 1636422596486, 622, 270, 352, 0, 0, 0
7676, 1, 1636422596143, 1636422596766, 623, 271, 352, 0, 1, 1
7677, 1, 1636422596313, 1636422596938, 625, 271, 354, 0, 0, 0
7678, 1, 1636422596476, 1636422597110, 634, 271, 363, 1, 2, 3
7679, 1, 1636422596534, 1636422597158, 624, 268, 356, 1, 1, 2
7680, 1, 1636422596598, 1636422597262, 664, 267, 397, 0, 0, 0
7681, 1, 1636422596662, 1636422597286, 624, 270, 354, 1, 1, 2
7682, 1, 1636422596928, 1636422597546, 618, 266, 352, 0, 0, 0
7684, 1, 1636422597271, 1636422597894, 623, 266, 357, 1, 0, 1
7685, 1, 1636422597320, 1636422597942, 622, 269, 353, 1, 1, 2
7686, 1, 1636422597363, 1636422597982, 619, 266, 353, 0, 1, 1
7556, 2, 1636422587906, 1636422598040, 10134, 0, 10134, 0, 0, 0
7687, 1, 1636422597477, 1636422598102, 625, 269, 356, 2, 0, 2
7688, 1, 1636422597724, 1636422598346, 622, 266, 356, 0, 0, 0
7689, 1, 1636422598085, 1636422598710, 625, 270, 355, 0, 1, 1
7569, 2, 1636422588624, 1636422598755, 10131, 0, 10131, 0, 0, 0
7691, 1, 1636422598147, 1636422598774, 627, 270, 357, 0, 0, 0
7693, 1, 1636422598266, 1636422598890, 624, 269, 355, 0, 0, 0
7694, 1, 1636422598510, 1636422599138, 628, 270, 358, 0, 0, 0
7576, 2, 1636422589053, 1636422599187, 10134, 0, 10134, 1, 0, 1
7695, 1, 1636422598883, 1636422599550, 667, 306, 361, 0, 41, 41
7696, 1, 1636422598886, 1636422599554, 668, 266, 402, 0, 0, 0
7697, 1, 1636422598955, 1636422599574, 619, 267, 352, 1, 0, 1
7698, 1, 1636422599051, 1636422599674, 623, 270, 353, 1, 1, 2
7701, 1, 1636422599646, 1636422600278, 632, 273, 359, 0, 0, 0
7702, 1, 1636422599677, 1636422600302, 625, 270, 355, 0, 1, 1
7703, 1, 1636422599765, 1636422600390, 625, 266, 359, 1, 1, 2
7704, 1, 1636422599847, 1636422600466, 619, 267, 352, 1, 0, 1
7705, 1, 1636422600455, 1636422601078, 623, 271, 352, 0, 0, 0
7706, 1, 1636422600475, 1636422601098, 623, 271, 352, 0, 0, 0
7707, 1, 1636422600557, 1636422601182, 625, 270, 355, 1, 0, 1
7708, 1, 1636422600633, 1636422601258, 625, 271, 354, 3, 0, 3
7709, 1, 1636422601242, 1636422601866, 624, 271, 353, 1, 0, 1
7710, 1, 1636422601261, 1636422601890, 629, 270, 359, 0, 0, 0
7711, 1, 1636422601357, 1636422601978, 621, 266, 355, 0, 0, 0
7631, 2, 1636422592154, 1636422602327, 10173, 0, 10173, 0, 0, 0
7633, 2, 1636422592215, 1636422602371, 10156, 1, 10155, 1, 0, 1
7632, 2, 1636422592211, 1636422602416, 10205, 1, 10204, 1, 0, 1
7635, 2, 1636422592365, 1636422602500, 10135, 0, 10135, 0, 0, 0
7713, 1, 1636422602034, 1636422602778, 744, 387, 357, 0, 114, 114
7644, 2, 1636422592715, 1636422602847, 10132, 0, 10132, 0, 0, 0
7715, 1, 1636422602150, 1636422602858, 708, 267, 441, 2, 3, 5
7643, 2, 1636422592698, 1636422602891, 10193, 0, 10193, 0, 0, 0
7716, 1, 1636422602506, 1636422603246, 740, 346, 394, 0, 79, 79
7717, 1, 1636422602507, 1636422603246, 739, 342, 397, 0, 78, 78
7718, 1, 1636422602507, 1636422603262, 755, 342, 413, 1, 75, 76
7719, 1, 1636422602634, 1636422603334, 700, 306, 394, 0, 45, 45
7648, 2, 1636422593216, 1636422603347, 10131, 0, 10131, 0, 0, 0
7650, 2, 1636422593294, 1636422603427, 10133, 1, 10132, 0, 1, 1
7651, 2, 1636422593325, 1636422603471, 10146, 1, 10145, 0, 1, 1
7720, 1, 1636422602892, 1636422603474, 582, 269, 313, 1, 0, 1
7721, 1, 1636422602953, 1636422603614, 661, 305, 356, 0, 35, 35
7722, 1, 1636422602978, 1636422603738, 760, 269, 491, 0, 0, 0
7723, 1, 1636422603010, 1636422603738, 728, 330, 398, 0, 63, 63
7725, 1, 1636422603264, 1636422604002, 738, 264, 474, 1, 0, 1
7724, 1, 1636422603263, 1636422604010, 747, 267, 480, 1, 0, 1
7726, 1, 1636422603264, 1636422604014, 750, 272, 478, 0, 0, 0
7727, 1, 1636422603473, 1636422604102, 629, 274, 355, 1, 0, 1
7729, 1, 1636422603559, 1636422604218, 659, 265, 394, 1, 0, 1
7728, 1, 1636422603558, 1636422604222, 664, 262, 402, 0, 0, 0
7730, 1, 1636422603586, 1636422604250, 664, 271, 393, 1, 1, 2
7731, 1, 1636422603644, 1636422604266, 622, 270, 352, 1, 0, 1
7733, 1, 1636422603758, 1636422604382, 624, 271, 353, 0, 0, 0
7732, 1, 1636422603739, 1636422604406, 667, 270, 397, 0, 0, 0
7734, 1, 1636422603767, 1636422604438, 671, 271, 400, 0, 0, 0
7736, 1, 1636422604066, 1636422604686, 620, 262, 358, 1, 0, 1
7735, 1, 1636422604066, 1636422604694, 628, 272, 356, 1, 2, 3
7737, 1, 1636422604069, 1636422604698, 629, 266, 363, 1, 0, 1
7738, 1, 1636422604184, 1636422604806, 622, 268, 354, 0, 0, 0
7739, 1, 1636422604318, 1636422604942, 624, 269, 355, 0, 1, 1
7740, 1, 1636422604323, 1636422604946, 623, 270, 353, 0, 0, 0
7741, 1, 1636422604340, 1636422604962, 622, 270, 352, 0, 0, 0
7742, 1, 1636422604438, 1636422605066, 628, 270, 358, 0, 0, 0
7743, 1, 1636422604540, 1636422605154, 614, 266, 348, 0, 0, 0
7744, 1, 1636422604544, 1636422605162, 618, 272, 346, 0, 2, 2
7668, 2, 1636422595058, 1636422605191, 10133, 1, 10132, 0, 0, 0
7745, 1, 1636422604575, 1636422605198, 623, 269, 354, 0, 0, 0
7748, 1, 1636422604860, 1636422605482, 622, 266, 356, 0, 0, 0
7747, 1, 1636422604858, 1636422605482, 624, 270, 354, 0, 0, 0
7751, 1, 1636422605107, 1636422605734, 627, 269, 358, 0, 0, 0
7750, 1, 1636422605103, 1636422605734, 631, 316, 315, 47, 0, 47
7753, 1, 1636422605252, 1636422605874, 622, 270, 352, 0, 0, 0
7756, 1, 1636422605355, 1636422605986, 631, 271, 360, 0, 0, 0
7754, 1, 1636422605322, 1636422605986, 664, 263, 401, 1, 0, 1
7757, 1, 1636422605368, 1636422605986, 618, 266, 352, 0, 0, 0
7675, 2, 1636422596046, 1636422606179, 10133, 0, 10133, 0, 0, 0
7758, 1, 1636422605665, 1636422606290, 625, 271, 354, 1, 1, 2
7759, 1, 1636422605674, 1636422606302, 628, 270, 358, 0, 0, 0
7761, 1, 1636422605916, 1636422606534, 618, 266, 352, 0, 1, 1
7762, 1, 1636422606037, 1636422606662, 625, 270, 355, 1, 1, 2
7763, 1, 1636422606083, 1636422606718, 635, 269, 366, 1, 0, 1
7764, 1, 1636422606180, 1636422606802, 622, 267, 355, 1, 0, 1
7765, 1, 1636422606181, 1636422606802, 621, 266, 355, 0, 1, 1
7766, 1, 1636422606310, 1636422606978, 668, 272, 396, 0, 0, 0
7767, 1, 1636422606460, 1636422607086, 626, 270, 356, 0, 0, 0
7768, 1, 1636422606466, 1636422607094, 628, 273, 355, 0, 0, 0
7683, 2, 1636422597108, 1636422607239, 10131, 0, 10131, 0, 0, 0
7769, 1, 1636422606722, 1636422607346, 624, 270, 354, 0, 0, 0
7770, 1, 1636422606821, 1636422607450, 629, 274, 355, 0, 0, 0
7771, 1, 1636422606893, 1636422607522, 629, 274, 355, 0, 0, 0
7772, 1, 1636422606958, 1636422607594, 636, 278, 358, 0, 14, 14
7773, 1, 1636422606966, 1636422607594, 628, 274, 354, 0, 6, 6
7774, 1, 1636422607069, 1636422607686, 617, 263, 354, 0, 0, 0
7775, 1, 1636422607245, 1636422607866, 621, 265, 356, 0, 0, 0
7776, 1, 1636422607256, 1636422607882, 626, 271, 355, 1, 0, 1
7777, 1, 1636422607370, 1636422608038, 668, 271, 397, 0, 1, 1
7778, 1, 1636422607514, 1636422608142, 628, 270, 358, 0, 0, 0
7779, 1, 1636422607626, 1636422608254, 628, 274, 354, 1, 1, 2
7690, 2, 1636422598121, 1636422608255, 10134, 1, 10133, 1, 0, 1
7780, 1, 1636422607681, 1636422608306, 625, 266, 359, 2, 0, 2
7692, 2, 1636422598166, 1636422608339, 10173, 0, 10173, 0, 0, 0
7781, 1, 1636422607751, 1636422608370, 619, 269, 350, 0, 0, 0
7782, 1, 1636422607755, 1636422608374, 619, 267, 352, 0, 0, 0
7785, 1, 1636422608060, 1636422608694, 634, 284, 350, 0, 22, 22
7784, 1, 1636422608049, 1636422608702, 653, 294, 359, 0, 25, 25
7786, 1, 1636422608125, 1636422608786, 661, 314, 347, 1, 0, 1
7787, 1, 1636422608340, 1636422608974, 634, 274, 360, 1, 0, 1
7789, 1, 1636422608432, 1636422609054, 622, 270, 352, 1, 0, 1
7788, 1, 1636422608430, 1636422609102, 672, 271, 401, 2, 0, 2
7791, 1, 1636422608490, 1636422609110, 620, 270, 350, 1, 0, 1
7790, 1, 1636422608466, 1636422609134, 668, 271, 397, 0, 1, 1
7792, 1, 1636422608568, 1636422609190, 622, 270, 352, 2, 0, 2
7793, 1, 1636422608570, 1636422609202, 632, 278, 354, 0, 0, 0
7699, 2, 1636422599311, 1636422609443, 10132, 1, 10131, 0, 0, 0
7795, 1, 1636422608862, 1636422609482, 620, 266, 354, 1, 0, 1
7794, 1, 1636422608861, 1636422609490, 629, 269, 360, 0, 0, 0
7700, 2, 1636422599318, 1636422609491, 10173, 0, 10173, 0, 0, 0
7796, 1, 1636422608923, 1636422609550, 627, 271, 356, 0, 0, 0
7797, 1, 1636422609110, 1636422609758, 648, 289, 359, 1, 19, 20
7798, 1, 1636422609188, 1636422609846, 658, 305, 353, 0, 38, 38
7799, 1, 1636422609225, 1636422609890, 665, 310, 355, 0, 42, 42
7800, 1, 1636422609243, 1636422609890, 647, 293, 354, 0, 25, 25
7802, 1, 1636422609365, 1636422610026, 661, 268, 393, 0, 1, 1
7803, 1, 1636422609371, 1636422610038, 667, 277, 390, 2, 0, 2
7801, 1, 1636422609291, 1636422610118, 827, 474, 353, 1, 1, 2
7804, 1, 1636422609578, 1636422610234, 656, 264, 392, 1, 0, 1
7807, 1, 1636422609663, 1636422610290, 627, 267, 360, 0, 1, 1
7806, 1, 1636422609658, 1636422610290, 632, 275, 357, 2, 1, 3
7805, 1, 1636422609622, 1636422610290, 668, 267, 401, 0, 2, 2
7809, 1, 1636422609918, 1636422610538, 620, 267, 353, 0, 0, 0
7811, 1, 1636422610026, 1636422610646, 620, 267, 353, 0, 0, 0
7812, 1, 1636422610032, 1636422610650, 618, 266, 352, 0, 0, 0
7814, 1, 1636422610175, 1636422610794, 619, 266, 353, 0, 0, 0
7813, 1, 1636422610120, 1636422610798, 678, 270, 408, 0, 0, 0
7815, 1, 1636422610182, 1636422610798, 616, 263, 353, 0, 0, 0
7816, 1, 1636422610327, 1636422610950, 623, 266, 357, 1, 0, 1
7817, 1, 1636422610376, 1636422610994, 618, 266, 352, 0, 0, 0
7818, 1, 1636422610461, 1636422611090, 629, 272, 357, 0, 0, 0
7819, 1, 1636422610464, 1636422611090, 626, 275, 351, 3, 0, 3
7820, 1, 1636422610722, 1636422611354, 632, 270, 362, 0, 0, 0
7821, 1, 1636422610819, 1636422611442, 623, 270, 353, 0, 0, 0
7823, 1, 1636422610929, 1636422611550, 621, 266, 355, 0, 0, 0
7712, 2, 1636422601434, 1636422611567, 10133, 0, 10133, 0, 0, 0
7824, 1, 1636422610962, 1636422611586, 624, 269, 355, 0, 0, 0
7825, 1, 1636422610981, 1636422611606, 625, 267, 358, 0, 1, 1
7827, 1, 1636422611183, 1636422611838, 655, 297, 358, 0, 27, 27
7828, 1, 1636422611250, 1636422611870, 620, 265, 355, 1, 0, 1
7830, 1, 1636422611511, 1636422612154, 643, 271, 372, 1, 1, 2
7714, 2, 1636422602058, 1636422612191, 10133, 0, 10133, 0, 0, 0
7831, 1, 1636422611633, 1636422612254, 621, 266, 355, 1, 0, 1
7833, 1, 1636422611725, 1636422612346, 621, 266, 355, 0, 0, 0
7832, 1, 1636422611702, 1636422612366, 664, 269, 395, 1, 0, 1
7834, 1, 1636422611769, 1636422612550, 781, 425, 356, 0, 22, 22
7836, 1, 1636422611977, 1636422612650, 673, 315, 358, 1, 35, 36
7837, 1, 1636422612047, 1636422612670, 623, 269, 354, 0, 0, 0
7838, 1, 1636422612311, 1636422612934, 623, 270, 353, 1, 0, 1
7839, 1, 1636422612322, 1636422612986, 664, 262, 402, 0, 0, 0
7840, 1, 1636422612419, 1636422613042, 623, 270, 353, 0, 0, 0
7841, 1, 1636422612453, 1636422613078, 625, 270, 355, 0, 0, 0
7842, 1, 1636422612534, 1636422613162, 628, 270, 358, 0, 0, 0
7843, 1, 1636422612569, 1636422613238, 669, 270, 399, 0, 0, 0
7844, 1, 1636422612782, 1636422613414, 632, 277, 355, 0, 1, 1
7845, 1, 1636422612835, 1636422613458, 623, 270, 353, 0, 2, 2
7846, 1, 1636422613073, 1636422613702, 629, 274, 355, 0, 0, 0
7847, 1, 1636422613118, 1636422613746, 628, 270, 358, 0, 0, 0
7848, 1, 1636422613202, 1636422613826, 624, 270, 354, 0, 0, 0
7850, 1, 1636422613345, 1636422613970, 625, 270, 355, 0, 1, 1
7851, 1, 1636422613365, 1636422613994, 629, 272, 357, 1, 0, 1
7852, 1, 1636422613578, 1636422614210, 632, 274, 358, 0, 0, 0
7853, 1, 1636422613640, 1636422614262, 622, 270, 352, 1, 0, 1
7855, 1, 1636422613917, 1636422614542, 625, 270, 355, 1, 0, 1
7856, 1, 1636422614007, 1636422614630, 623, 270, 353, 0, 0, 0
7858, 1, 1636422614155, 1636422614778, 623, 270, 353, 0, 0, 0
7857, 1, 1636422614149, 1636422614778, 629, 270, 359, 0, 0, 0
7746, 2, 1636422604855, 1636422614992, 10137, 1, 10136, 0, 1, 1
7859, 1, 1636422614373, 1636422614998, 625, 270, 355, 1, 0, 1
7860, 1, 1636422614426, 1636422615054, 628, 270, 358, 0, 0, 0
7749, 2, 1636422604981, 1636422615115, 10134, 0, 10134, 0, 0, 0
7752, 2, 1636422605136, 1636422615284, 10148, 1, 10147, 0, 1, 1
7861, 1, 1636422614709, 1636422615378, 669, 314, 355, 0, 47, 47
7755, 2, 1636422605337, 1636422615471, 10134, 0, 10134, 0, 0, 0
7862, 1, 1636422614809, 1636422615474, 665, 306, 359, 1, 39, 40
7864, 1, 1636422614993, 1636422615578, 585, 270, 315, 0, 0, 0
7863, 1, 1636422614992, 1636422615654, 662, 273, 389, 0, 1, 1
7866, 1, 1636422615179, 1636422615822, 643, 278, 365, 2, 8, 10
7865, 1, 1636422615122, 1636422615826, 704, 275, 429, 0, 6, 6
7868, 1, 1636422615285, 1636422615954, 669, 272, 397, 0, 0, 0
7760, 2, 1636422605898, 1636422616031, 10133, 0, 10133, 0, 0, 0
7870, 1, 1636422615510, 1636422616134, 624, 270, 354, 1, 0, 1
7872, 1, 1636422615621, 1636422616246, 625, 270, 355, 0, 1, 1
7871, 1, 1636422615602, 1636422616298, 696, 297, 399, 0, 30, 30
7874, 1, 1636422615759, 1636422616386, 627, 277, 350, 1, 11, 12
7873, 1, 1636422615757, 1636422616386, 629, 275, 354, 1, 10, 11
7875, 1, 1636422615876, 1636422616502, 626, 266, 360, 0, 0, 0
7808, 1, 1636422609717, 1636422616522, 6805, 6446, 359, 0, 1, 1
7877, 1, 1636422616032, 1636422616606, 574, 264, 310, 1, 1, 2
7876, 1, 1636422616032, 1636422616650, 618, 266, 352, 1, 0, 1
7878, 1, 1636422616162, 1636422616822, 660, 265, 395, 1, 0, 1
7879, 1, 1636422616303, 1636422616926, 623, 266, 357, 0, 0, 0
7880, 1, 1636422616356, 1636422616986, 630, 271, 359, 0, 0, 0
7881, 1, 1636422616421, 1636422617042, 621, 271, 350, 1, 1, 2
7883, 1, 1636422616561, 1636422617186, 625, 271, 354, 0, 0, 0
7882, 1, 1636422616524, 1636422617190, 666, 266, 400, 0, 1, 1
7884, 1, 1636422616571, 1636422617190, 619, 265, 354, 0, 0, 0
7886, 1, 1636422616790, 1636422617414, 624, 267, 357, 0, 0, 0
7887, 1, 1636422616816, 1636422617442, 626, 274, 352, 0, 1, 1
7888, 1, 1636422616925, 1636422617562, 637, 274, 363, 1, 0, 1
7889, 1, 1636422617108, 1636422617742, 634, 278, 356, 0, 0, 0
7892, 1, 1636422617334, 1636422617954, 620, 266, 354, 0, 0, 0
7783, 2, 1636422607855, 1636422617987, 10132, 1, 10131, 0, 0, 0
7894, 1, 1636422617375, 1636422617990, 615, 266, 349, 1, 0, 1
7893, 1, 1636422617370, 1636422617994, 624, 271, 353, 1, 0, 1
7896, 1, 1636422617604, 1636422618246, 642, 295, 347, 0, 25, 25
7895, 1, 1636422617589, 1636422618250, 661, 309, 352, 1, 42, 43
7897, 1, 1636422617736, 1636422618358, 622, 271, 351, 0, 0, 0
7898, 1, 1636422617905, 1636422618566, 661, 269, 392, 1, 0, 1
7900, 1, 1636422618138, 1636422618770, 632, 270, 362, 0, 0, 0
7902, 1, 1636422618177, 1636422618802, 625, 270, 355, 0, 0, 0
7901, 1, 1636422618172, 1636422618802, 630, 269, 361, 0, 0, 0
7904, 1, 1636422618408, 1636422619042, 634, 274, 360, 0, 0, 0
7905, 1, 1636422618524, 1636422619146, 622, 269, 353, 0, 0, 0
7906, 1, 1636422618714, 1636422619342, 628, 274, 354, 1, 0, 1
7907, 1, 1636422618926, 1636422619550, 624, 270, 354, 0, 0, 0
7910, 1, 1636422619211, 1636422619834, 623, 269, 354, 1, 0, 1
7911, 1, 1636422619330, 1636422619962, 632, 269, 363, 0, 0, 0
7810, 2, 1636422609975, 1636422620107, 10132, 1, 10131, 0, 1, 1
7912, 1, 1636422619522, 1636422620150, 628, 270, 358, 0, 0, 0
7913, 1, 1636422619732, 1636422620378, 646, 287, 359, 0, 18, 18
7914, 1, 1636422620001, 1636422620646, 645, 267, 378, 0, 0, 0
7915, 1, 1636422620134, 1636422620762, 628, 274, 354, 1, 1, 2
7917, 1, 1636422620309, 1636422620938, 629, 270, 359, 1, 2, 3
7822, 2, 1636422610823, 1636422620955, 10132, 0, 10132, 0, 0, 0
7918, 1, 1636422620534, 1636422621166, 632, 272, 360, 1, 0, 1
7826, 2, 1636422611123, 1636422621255, 10132, 0, 10132, 0, 0, 0
7829, 2, 1636422611257, 1636422621391, 10134, 1, 10133, 0, 0, 0
7919, 1, 1636422620809, 1636422621422, 613, 258, 355, 0, 0, 0
7920, 1, 1636422620956, 1636422621658, 702, 350, 352, 0, 77, 77
7922, 1, 1636422621106, 1636422621742, 636, 282, 354, 0, 14, 14
7921, 1, 1636422621086, 1636422621786, 700, 265, 435, 0, 1, 1
7835, 2, 1636422611776, 1636422621907, 10131, 0, 10131, 0, 0, 0
7923, 1, 1636422621334, 1636422621970, 636, 269, 367, 0, 0, 0
7925, 1, 1636422621523, 1636422622190, 667, 270, 397, 1, 0, 1
7926, 1, 1636422621615, 1636422622258, 643, 290, 353, 0, 26, 26
7927, 1, 1636422621734, 1636422622354, 620, 267, 353, 1, 0, 1
7928, 1, 1636422621839, 1636422622486, 647, 270, 377, 0, 0, 0
7929, 1, 1636422621914, 1636422622546, 632, 273, 359, 0, 0, 0
7930, 1, 1636422622038, 1636422622710, 672, 270, 402, 2, 0, 2
7931, 1, 1636422622147, 1636422622770, 623, 266, 357, 0, 0, 0
7932, 1, 1636422622276, 1636422622898, 622, 265, 357, 0, 0, 0
7933, 1, 1636422622403, 1636422623026, 623, 269, 354, 1, 0, 1
7935, 1, 1636422622636, 1636422623266, 630, 270, 360, 0, 0, 0
7934, 1, 1636422622544, 1636422623298, 754, 394, 360, 0, 0, 0
7936, 1, 1636422622705, 1636422623334, 629, 271, 358, 2, 0, 2
7849, 2, 1636422613249, 1636422623383, 10134, 1, 10133, 1, 0, 1
7937, 1, 1636422622793, 1636422623422, 629, 270, 359, 0, 0, 0
7938, 1, 1636422622958, 1636422623578, 620, 266, 354, 1, 0, 1
7939, 1, 1636422623062, 1636422623682, 620, 266, 354, 1, 0, 1
7940, 1, 1636422623205, 1636422623834, 629, 274, 355, 0, 2, 2
7941, 1, 1636422623383, 1636422623962, 579, 269, 310, 0, 0, 0
7854, 2, 1636422613870, 1636422624007, 10137, 0, 10137, 0, 0, 0
7942, 1, 1636422623432, 1636422624054, 622, 271, 351, 1, 0, 1
7944, 1, 1636422623515, 1636422624138, 623, 270, 353, 0, 1, 1
7945, 1, 1636422623583, 1636422624206, 623, 270, 353, 0, 0, 0
7946, 1, 1636422623753, 1636422624370, 617, 266, 351, 0, 0, 0
7947, 1, 1636422623859, 1636422624482, 623, 266, 357, 0, 0, 0
7948, 1, 1636422624008, 1636422624634, 626, 270, 356, 0, 0, 0
7950, 1, 1636422624152, 1636422624774, 622, 270, 352, 1, 0, 1
7951, 1, 1636422624244, 1636422624870, 626, 269, 357, 0, 1, 1
7952, 1, 1636422624314, 1636422624946, 632, 270, 362, 0, 1, 1
7953, 1, 1636422624379, 1636422625010, 631, 277, 354, 0, 0, 0
7954, 1, 1636422624559, 1636422625174, 615, 263, 352, 1, 0, 1
7955, 1, 1636422624671, 1636422625294, 623, 267, 356, 0, 1, 1
7867, 2, 1636422615222, 1636422625375, 10153, 2, 10151, 1, 1, 2
7956, 1, 1636422624781, 1636422625410, 629, 268, 361, 0, 0, 0
7957, 1, 1636422624938, 1636422625562, 624, 268, 356, 0, 1, 1
7869, 2, 1636422615414, 1636422625587, 10173, 0, 10173, 0, 0, 0
7958, 1, 1636422625033, 1636422625662, 629, 270, 359, 0, 0, 0
7959, 1, 1636422625117, 1636422625738, 621, 266, 355, 0, 0, 0
7960, 1, 1636422625182, 1636422625862, 680, 316, 364, 0, 48, 48
7961, 1, 1636422625376, 1636422626038, 662, 306, 356, 0, 39, 39
7962, 1, 1636422625460, 1636422626130, 670, 271, 399, 1, 1, 2
7964, 1, 1636422625588, 1636422626210, 622, 269, 353, 0, 0, 0
7966, 1, 1636422625726, 1636422626354, 628, 266, 362, 0, 0, 0
7965, 1, 1636422625718, 1636422626394, 676, 279, 397, 0, 0, 0
7967, 1, 1636422625845, 1636422626470, 625, 270, 355, 2, 0, 2
7969, 1, 1636422625972, 1636422626606, 634, 277, 357, 1, 0, 1
7970, 1, 1636422626147, 1636422626770, 623, 270, 353, 0, 0, 0
7885, 2, 1636422616681, 1636422626815, 10134, 0, 10134, 0, 0, 0
7971, 1, 1636422626265, 1636422626890, 625, 270, 355, 1, 0, 1
7972, 1, 1636422626379, 1636422627002, 623, 270, 353, 0, 0, 0
7973, 1, 1636422626470, 1636422627098, 628, 270, 358, 0, 0, 0
7974, 1, 1636422626513, 1636422627170, 657, 302, 355, 0, 38, 38
7975, 1, 1636422626646, 1636422627266, 620, 266, 354, 0, 0, 0
7890, 2, 1636422617158, 1636422627295, 10137, 0, 10137, 0, 0, 0
7891, 2, 1636422617216, 1636422627347, 10131, 0, 10131, 0, 0, 0
7976, 1, 1636422626816, 1636422627434, 618, 266, 352, 1, 0, 1
7977, 1, 1636422626934, 1636422627562, 628, 272, 356, 0, 3, 3
7978, 1, 1636422626946, 1636422627650, 704, 306, 398, 0, 34, 34
7979, 1, 1636422627066, 1636422627702, 636, 283, 353, 1, 18, 19
7980, 1, 1636422627166, 1636422627830, 664, 268, 396, 0, 0, 0
7982, 1, 1636422627348, 1636422627974, 626, 274, 352, 0, 0, 0
7984, 1, 1636422627441, 1636422628062, 621, 265, 356, 0, 0, 0
7983, 1, 1636422627434, 1636422628110, 676, 270, 406, 0, 0, 0
7985, 1, 1636422627474, 1636422628138, 664, 270, 394, 1, 1, 2
7986, 1, 1636422627584, 1636422628214, 630, 270, 360, 0, 0, 0
7899, 2, 1636422618118, 1636422628291, 10173, 1, 10172, 0, 0, 0
7988, 1, 1636422627740, 1636422628357, 617, 266, 351, 0, 0, 0
7987, 1, 1636422627704, 1636422628402, 698, 346, 352, 0, 0, 0
7989, 1, 1636422627866, 1636422628490, 624, 270, 354, 2, 0, 2
7903, 2, 1636422618376, 1636422628507, 10131, 0, 10131, 0, 0, 0
7991, 1, 1636422628115, 1636422628774, 659, 305, 354, 1, 37, 38
7992, 1, 1636422628198, 1636422628858, 660, 301, 359, 2, 39, 41
7993, 1, 1636422628233, 1636422628882, 649, 276, 373, 0, 1, 1
7994, 1, 1636422628245, 1636422628882, 637, 275, 362, 1, 2, 3
7995, 1, 1636422628384, 1636422629050, 666, 267, 399, 0, 0, 0
7996, 1, 1636422628422, 1636422629090, 668, 271, 397, 1, 0, 1
7908, 2, 1636422618967, 1636422629099, 10132, 1, 10131, 0, 0, 0
7997, 1, 1636422628508, 1636422629126, 618, 266, 352, 1, 0, 1
7909, 2, 1636422618979, 1636422629151, 10172, 0, 10172, 0, 0, 0
7998, 1, 1636422628525, 1636422629162, 637, 277, 360, 0, 1, 1
8000, 1, 1636422628675, 1636422629302, 627, 273, 354, 0, 0, 0
7999, 1, 1636422628638, 1636422629302, 664, 266, 398, 0, 0, 0
8002, 1, 1636422628989, 1636422629686, 697, 319, 378, 52, 0, 52
8004, 1, 1636422629047, 1636422629694, 647, 325, 322, 52, 1, 53
8003, 1, 1636422629026, 1636422629702, 676, 330, 346, 53, 1, 54
8005, 1, 1636422629175, 1636422629806, 631, 278, 353, 1, 0, 1
8006, 1, 1636422629186, 1636422629818, 632, 270, 362, 0, 0, 0
8007, 1, 1636422629238, 1636422629898, 660, 258, 402, 0, 0, 0
8008, 1, 1636422629246, 1636422629914, 668, 267, 401, 1, 0, 1
8009, 1, 1636422629311, 1636422629942, 631, 271, 360, 1, 1, 2
8011, 1, 1636422629396, 1636422630014, 618, 266, 352, 0, 0, 0
8012, 1, 1636422629490, 1636422630118, 628, 270, 358, 0, 0, 0
8013, 1, 1636422629792, 1636422630410, 618, 265, 353, 1, 0, 1
7916, 2, 1636422620238, 1636422630415, 10177, 1, 10176, 0, 0, 0
8014, 1, 1636422629823, 1636422630450, 627, 271, 356, 0, 0, 0
8015, 1, 1636422629834, 1636422630458, 624, 266, 358, 0, 0, 0
8017, 1, 1636422629988, 1636422630614, 626, 268, 358, 0, 0, 0
8018, 1, 1636422629993, 1636422630622, 629, 270, 359, 0, 0, 0
8019, 1, 1636422630126, 1636422630766, 640, 286, 354, 0, 21, 21
8020, 1, 1636422630193, 1636422630858, 665, 266, 399, 0, 0, 0
8021, 1, 1636422630288, 1636422630950, 662, 268, 394, 1, 0, 1
8022, 1, 1636422630546, 1636422631210, 664, 264, 400, 0, 0, 0
8023, 1, 1636422630602, 1636422631234, 632, 275, 357, 0, 1, 1
8024, 1, 1636422630635, 1636422631266, 631, 275, 356, 1, 0, 1
8025, 1, 1636422630648, 1636422631274, 626, 269, 357, 0, 0, 0
8026, 1, 1636422630785, 1636422631414, 629, 274, 355, 0, 0, 0
8028, 1, 1636422630912, 1636422631542, 630, 273, 357, 0, 0, 0
7924, 2, 1636422621392, 1636422631567, 10175, 1, 10174, 0, 1, 1
8029, 1, 1636422630982, 1636422631606, 624, 266, 358, 0, 0, 0
8030, 1, 1636422631095, 1636422631718, 623, 265, 358, 0, 0, 0
8031, 1, 1636422631300, 1636422631922, 622, 270, 352, 0, 6, 6
8032, 1, 1636422631396, 1636422632006, 610, 259, 351, 1, 0, 1
8033, 1, 1636422631430, 1636422632050, 620, 266, 354, 0, 0, 0
8034, 1, 1636422631438, 1636422632102, 664, 265, 399, 0, 0, 0
8035, 1, 1636422631600, 1636422632226, 626, 268, 358, 1, 0, 1
8037, 1, 1636422631720, 1636422632338, 618, 265, 353, 1, 0, 1
8036, 1, 1636422631706, 1636422632374, 668, 270, 398, 0, 0, 0
8038, 1, 1636422631793, 1636422632418, 625, 262, 363, 0, 0, 0
8039, 1, 1636422631885, 1636422632506, 621, 266, 355, 0, 0, 0
8041, 1, 1636422632207, 1636422632830, 623, 270, 353, 0, 0, 0
8043, 1, 1636422632244, 1636422632862, 618, 266, 352, 0, 1, 1
8042, 1, 1636422632233, 1636422632870, 637, 275, 362, 0, 1, 1
8044, 1, 1636422632391, 1636422633014, 623, 267, 356, 0, 0, 0
8045, 1, 1636422632454, 1636422633106, 652, 295, 357, 0, 1, 1
8046, 1, 1636422632511, 1636422633142, 631, 274, 357, 1, 0, 1
8047, 1, 1636422632582, 1636422633206, 624, 270, 354, 0, 0, 0
8048, 1, 1636422632670, 1636422633302, 632, 274, 358, 0, 0, 0
8049, 1, 1636422633000, 1636422633626, 626, 275, 351, 0, 1, 1
8050, 1, 1636422633019, 1636422633658, 639, 274, 365, 0, 1, 1
8051, 1, 1636422633053, 1636422633690, 637, 271, 366, 0, 0, 0
7943, 2, 1636422623514, 1636422633691, 10177, 1, 10176, 1, 0, 1
8052, 1, 1636422633175, 1636422633806, 631, 273, 358, 0, 0, 0
8054, 1, 1636422633319, 1636422633958, 639, 285, 354, 1, 14, 15
8055, 1, 1636422633397, 1636422634046, 649, 296, 353, 0, 31, 31
8056, 1, 1636422633456, 1636422634082, 626, 270, 356, 0, 0, 0
7949, 2, 1636422624139, 1636422634315, 10176, 0, 10176, 0, 0, 0
8057, 1, 1636422633815, 1636422634434, 619, 267, 352, 1, 0, 1
8058, 1, 1636422633815, 1636422634442, 627, 275, 352, 1, 1, 2
8059, 1, 1636422633822, 1636422634486, 664, 265, 399, 0, 0, 0
8060, 1, 1636422633853, 1636422634486, 633, 278, 355, 0, 0, 0
8061, 1, 1636422633960, 1636422634582, 622, 269, 353, 1, 6, 7
8062, 1, 1636422634131, 1636422634762, 631, 277, 354, 0, 10, 10
8063, 1, 1636422634196, 1636422634850, 654, 270, 384, 2, 0, 2
8064, 1, 1636422634243, 1636422634893, 650, 271, 379, 0, 1, 1
8065, 1, 1636422634450, 1636422635122, 672, 266, 406, 0, 0, 0
8066, 1, 1636422634576, 1636422635202, 626, 270, 356, 1, 0, 1
8068, 1, 1636422634624, 1636422635246, 622, 266, 356, 0, 1, 1
8067, 1, 1636422634617, 1636422635246, 629, 270, 359, 1, 1, 2
8069, 1, 1636422634667, 1636422635298, 631, 274, 357, 0, 0, 0
8070, 1, 1636422634747, 1636422635370, 623, 267, 356, 0, 0, 0
8071, 1, 1636422634920, 1636422635542, 622, 270, 352, 1, 0, 1
8072, 1, 1636422634992, 1636422635618, 626, 270, 356, 0, 0, 0
8073, 1, 1636422635040, 1636422635670, 630, 277, 353, 0, 0, 0
7963, 2, 1636422625507, 1636422635683, 10176, 0, 10176, 0, 0, 0
8074, 1, 1636422635197, 1636422635834, 637, 270, 367, 0, 0, 0
8076, 1, 1636422635409, 1636422636042, 633, 273, 360, 2, 6, 8
8077, 1, 1636422635410, 1636422636042, 632, 277, 355, 2, 6, 8
7968, 2, 1636422625933, 1636422636067, 10134, 0, 10134, 0, 0, 0
8078, 1, 1636422635469, 1636422636134, 665, 310, 355, 0, 39, 39
8079, 1, 1636422635546, 1636422636174, 628, 266, 362, 0, 0, 0
8080, 1, 1636422635723, 1636422636350, 627, 274, 353, 0, 0, 0
8081, 1, 1636422635796, 1636422636426, 630, 274, 356, 0, 1, 1
8083, 1, 1636422635829, 1636422636458, 629, 270, 359, 0, 0, 0
8082, 1, 1636422635814, 1636422636514, 700, 302, 398, 0, 35, 35
8085, 1, 1636422636201, 1636422636830, 629, 271, 358, 1, 0, 1
8087, 1, 1636422636223, 1636422636838, 615, 262, 353, 0, 1, 1
8086, 1, 1636422636202, 1636422636874, 672, 270, 402, 2, 0, 2
8088, 1, 1636422636267, 1636422636894, 627, 267, 360, 1, 0, 1
8089, 1, 1636422636334, 1636422636958, 624, 271, 353, 0, 0, 0
8090, 1, 1636422636530, 1636422637158, 628, 269, 359, 0, 0, 0
8091, 1, 1636422636568, 1636422637190, 622, 270, 352, 0, 0, 0
8092, 1, 1636422636598, 1636422637222, 624, 270, 354, 1, 0, 1
8093, 1, 1636422636626, 1636422637246, 620, 265, 355, 0, 0, 0
7981, 2, 1636422627296, 1636422637435, 10139, 0, 10139, 0, 0, 0
8094, 1, 1636422637000, 1636422637626, 626, 271, 355, 0, 0, 0
8095, 1, 1636422637024, 1636422637654, 630, 270, 360, 0, 0, 0
8096, 1, 1636422637080, 1636422637702, 622, 268, 354, 1, 2, 3
8097, 1, 1636422637131, 1636422637794, 663, 306, 357, 1, 39, 40
8098, 1, 1636422637328, 1636422637970, 642, 269, 373, 0, 0, 0
8101, 1, 1636422637437, 1636422638022, 585, 274, 311, 0, 0, 0
8100, 1, 1636422637436, 1636422638062, 626, 274, 352, 0, 0, 0
7990, 2, 1636422627955, 1636422638087, 10132, 0, 10132, 0, 0, 0
8102, 1, 1636422637562, 1636422638226, 664, 270, 394, 1, 0, 1
8104, 1, 1636422637822, 1636422638442, 620, 265, 355, 0, 0, 0
8103, 1, 1636422637786, 1636422638442, 656, 299, 357, 0, 34, 34
8105, 1, 1636422637869, 1636422638534, 665, 310, 355, 1, 37, 38
8106, 1, 1636422637929, 1636422638554, 625, 269, 356, 1, 0, 1
8107, 1, 1636422638114, 1636422638734, 620, 268, 352, 0, 0, 0
8108, 1, 1636422638209, 1636422638830, 621, 267, 354, 0, 0, 0
8109, 1, 1636422638215, 1636422638850, 635, 277, 358, 0, 0, 0
8111, 1, 1636422638331, 1636422638954, 623, 270, 353, 0, 0, 0
8001, 2, 1636422628905, 1636422639039, 10134, 0, 10134, 0, 0, 0
8113, 1, 1636422638613, 1636422639242, 629, 270, 359, 1, 1, 2
8114, 1, 1636422638664, 1636422639306, 642, 287, 355, 0, 18, 18
8115, 1, 1636422638716, 1636422639342, 626, 269, 357, 1, 0, 1
8010, 2, 1636422629312, 1636422639451, 10139, 1, 10138, 0, 1, 1
8116, 1, 1636422638916, 1636422639578, 662, 268, 394, 2, 1, 3
8118, 1, 1636422639041, 1636422639626, 585, 274, 311, 0, 0, 0
8119, 1, 1636422639115, 1636422639742, 627, 270, 357, 0, 1, 1
8121, 1, 1636422639452, 1636422640074, 622, 265, 357, 1, 0, 1
8122, 1, 1636422639461, 1636422640078, 617, 266, 351, 0, 0, 0
8016, 2, 1636422629978, 1636422640111, 10133, 0, 10133, 0, 0, 0
8125, 1, 1636422639706, 1636422640374, 668, 269, 399, 0, 0, 0
8126, 1, 1636422639784, 1636422640406, 622, 266, 356, 0, 0, 0
8127, 1, 1636422639923, 1636422640562, 639, 282, 357, 0, 14, 14
8128, 1, 1636422640218, 1636422640838, 620, 266, 354, 0, 0, 0
8130, 1, 1636422640257, 1636422640878, 621, 267, 354, 0, 1, 1
8129, 1, 1636422640242, 1636422640906, 664, 270, 394, 0, 0, 0
8027, 2, 1636422630794, 1636422640927, 10133, 1, 10132, 0, 0, 0
8131, 1, 1636422640517, 1636422641142, 625, 270, 355, 0, 0, 0
8132, 1, 1636422640581, 1636422641210, 629, 271, 358, 0, 1, 1
8133, 1, 1636422640730, 1636422641374, 644, 290, 354, 0, 22, 22
8134, 1, 1636422641004, 1636422641626, 622, 269, 353, 0, 0, 0
8135, 1, 1636422641023, 1636422641654, 631, 274, 357, 1, 0, 1
8136, 1, 1636422641058, 1636422641686, 628, 274, 354, 0, 0, 0
8137, 1, 1636422641058, 1636422641722, 664, 267, 397, 0, 1, 1
8138, 1, 1636422641311, 1636422641930, 619, 265, 354, 0, 0, 0
8139, 1, 1636422641366, 1636422641986, 620, 266, 354, 0, 0, 0
8140, 1, 1636422641516, 1636422642134, 618, 271, 347, 0, 1, 1
8040, 2, 1636422632105, 1636422642239, 10134, 0, 10134, 0, 0, 0
8141, 1, 1636422641788, 1636422642402, 614, 261, 353, 0, 0, 0
8143, 1, 1636422641823, 1636422642446, 623, 267, 356, 1, 1, 2
8142, 1, 1636422641821, 1636422642446, 625, 265, 360, 1, 0, 1
8144, 1, 1636422641845, 1636422642510, 665, 305, 360, 0, 35, 35
8145, 1, 1636422642118, 1636422642770, 652, 263, 389, 0, 0, 0
8146, 1, 1636422642167, 1636422642818, 651, 271, 380, 0, 1, 1
8147, 1, 1636422642326, 1636422642962, 636, 278, 358, 0, 0, 0
8148, 1, 1636422642370, 1636422643038, 668, 270, 398, 0, 1, 1
8149, 1, 1636422642599, 1636422643222, 623, 266, 357, 0, 0, 0
8150, 1, 1636422642607, 1636422643234, 627, 270, 357, 0, 0, 0
8151, 1, 1636422642628, 1636422643254, 626, 268, 358, 1, 0, 1
8053, 2, 1636422633259, 1636422643391, 10132, 0, 10132, 0, 0, 0
8152, 1, 1636422642638, 1636422643502, 864, 511, 353, 0, 0, 0
8153, 1, 1636422642931, 1636422643550, 619, 266, 353, 0, 0, 0
8154, 1, 1636422642955, 1636422643582, 627, 274, 353, 0, 0, 0
8156, 1, 1636422643133, 1636422643762, 629, 270, 359, 0, 0, 0
8155, 1, 1636422643116, 1636422643838, 722, 371, 351, 0, 18, 18
8157, 1, 1636422643408, 1636422644030, 622, 267, 355, 1, 1, 2
8158, 1, 1636422643415, 1636422644034, 619, 266, 353, 0, 0, 0
8159, 1, 1636422643435, 1636422644106, 671, 318, 353, 0, 0, 0
8161, 1, 1636422643522, 1636422644186, 664, 270, 394, 1, 0, 1
8162, 1, 1636422643718, 1636422644342, 624, 270, 354, 0, 0, 0
8163, 1, 1636422643751, 1636422644366, 615, 262, 353, 0, 0, 0
8164, 1, 1636422643921, 1636422644546, 625, 270, 355, 1, 0, 1
8165, 1, 1636422643925, 1636422644634, 709, 354, 355, 1, 0, 1
8166, 1, 1636422644200, 1636422644822, 622, 259, 363, 0, 1, 1
8167, 1, 1636422644223, 1636422644846, 623, 266, 357, 0, 0, 0
8168, 1, 1636422644226, 1636422644862, 636, 275, 361, 0, 0, 0
8169, 1, 1636422644288, 1636422644918, 630, 270, 360, 0, 0, 0
8170, 1, 1636422644502, 1636422645134, 632, 274, 358, 0, 0, 0
8171, 1, 1636422644537, 1636422645162, 625, 270, 355, 1, 0, 1
8172, 1, 1636422644725, 1636422645346, 621, 267, 354, 0, 1, 1
8173, 1, 1636422644730, 1636422645362, 632, 275, 357, 2, 0, 2
8075, 2, 1636422635380, 1636422645515, 10135, 0, 10135, 0, 0, 0
8174, 1, 1636422645001, 1636422645634, 633, 278, 355, 0, 0, 0
8175, 1, 1636422645014, 1636422645646, 632, 274, 358, 1, 0, 1
8176, 1, 1636422645015, 1636422645646, 631, 270, 361, 1, 0, 1
8177, 1, 1636422645080, 1636422645702, 622, 267, 355, 0, 0, 0
8178, 1, 1636422645311, 1636422645962, 651, 290, 361, 0, 22, 22
8179, 1, 1636422645323, 1636422645970, 647, 290, 357, 0, 18, 18
8180, 1, 1636422645516, 1636422646134, 618, 268, 350, 0, 1, 1
8084, 2, 1636422635999, 1636422646159, 10160, 0, 10160, 0, 0, 0
8181, 1, 1636422645545, 1636422646170, 625, 269, 356, 0, 0, 0
8182, 1, 1636422645647, 1636422646314, 667, 271, 396, 1, 1, 2
8183, 1, 1636422645791, 1636422646422, 631, 281, 350, 0, 14, 14
8184, 1, 1636422645822, 1636422646454, 632, 278, 354, 0, 0, 0
8185, 1, 1636422645826, 1636422646454, 628, 270, 358, 1, 0, 1
8186, 1, 1636422645888, 1636422646514, 626, 274, 352, 0, 10, 10
8187, 1, 1636422646106, 1636422646738, 632, 269, 363, 1, 0, 1
8190, 1, 1636422646323, 1636422646950, 627, 275, 352, 1, 0, 1
8191, 1, 1636422646337, 1636422646970, 633, 269, 364, 0, 0, 0
8189, 1, 1636422646294, 1636422646970, 676, 270, 406, 1, 0, 1
8192, 1, 1636422646408, 1636422647034, 626, 273, 353, 0, 0, 0
8193, 1, 1636422646598, 1636422647226, 628, 271, 357, 0, 2, 2
8194, 1, 1636422646612, 1636422647238, 626, 273, 353, 0, 0, 0
8195, 1, 1636422646619, 1636422647246, 627, 274, 353, 0, 0, 0
8196, 1, 1636422646698, 1636422647322, 624, 270, 354, 1, 0, 1
8099, 2, 1636422637373, 1636422647527, 10154, 1, 10153, 1, 0, 1
8197, 1, 1636422646920, 1636422647546, 626, 269, 357, 1, 0, 1
8198, 1, 1636422647058, 1636422647690, 632, 274, 358, 0, 1, 1
8199, 1, 1636422647131, 1636422647790, 659, 308, 351, 1, 42, 43
8200, 1, 1636422647147, 1636422647790, 643, 287, 356, 0, 26, 26
8201, 1, 1636422647192, 1636422647810, 618, 263, 355, 0, 0, 0
8203, 1, 1636422647423, 1636422648058, 635, 265, 370, 0, 2, 2
8204, 1, 1636422647435, 1636422648062, 627, 266, 361, 0, 0, 0
8202, 1, 1636422647402, 1636422648062, 660, 264, 396, 0, 1, 1
8205, 1, 1636422647528, 1636422648138, 610, 259, 351, 1, 1, 2
8206, 1, 1636422647658, 1636422648322, 664, 262, 402, 1, 0, 1
8207, 1, 1636422647720, 1636422648338, 618, 266, 352, 1, 0, 1
8110, 2, 1636422638218, 1636422648391, 10173, 0, 10173, 0, 0, 0
8208, 1, 1636422647850, 1636422648474, 624, 270, 354, 0, 0, 0
8209, 1, 1636422647919, 1636422648542, 623, 266, 357, 0, 0, 0
8210, 1, 1636422647947, 1636422648578, 631, 270, 361, 0, 0, 0
8211, 1, 1636422648002, 1636422648658, 656, 300, 356, 0, 31, 31
8112, 2, 1636422638591, 1636422648723, 10132, 0, 10132, 0, 0, 0
8213, 1, 1636422648209, 1636422648842, 633, 274, 359, 3, 5, 8
8212, 1, 1636422648194, 1636422648842, 648, 293, 355, 1, 23, 24
8214, 1, 1636422648239, 1636422648866, 627, 271, 356, 0, 2, 2
8215, 1, 1636422648304, 1636422648930, 626, 270, 356, 0, 0, 0
8216, 1, 1636422648424, 1636422649082, 658, 302, 356, 1, 31, 32
8218, 1, 1636422648531, 1636422649170, 639, 286, 353, 0, 19, 19
8117, 2, 1636422639040, 1636422649171, 10131, 0, 10131, 0, 0, 0
8217, 1, 1636422648522, 1636422649190, 668, 273, 395, 0, 0, 0
8219, 1, 1636422648658, 1636422649302, 644, 265, 379, 0, 0, 0
8120, 2, 1636422639170, 1636422649344, 10174, 0, 10174, 0, 0, 0
8220, 1, 1636422648724, 1636422649346, 622, 267, 355, 1, 1, 2
8221, 1, 1636422648754, 1636422649382, 628, 270, 358, 1, 0, 1
8222, 1, 1636422648814, 1636422649437, 623, 267, 356, 1, 0, 1
8223, 1, 1636422648854, 1636422649522, 668, 270, 398, 0, 9, 9
8224, 1, 1636422649004, 1636422649618, 614, 262, 352, 0, 0, 0
8225, 1, 1636422649011, 1636422649638, 627, 270, 357, 0, 0, 0
8123, 2, 1636422639520, 1636422649655, 10135, 0, 10135, 0, 0, 0
8226, 1, 1636422649023, 1636422649698, 675, 276, 399, 2, 0, 2
8124, 2, 1636422639586, 1636422649763, 10177, 0, 10177, 0, 0, 0
8227, 1, 1636422649097, 1636422649798, 701, 314, 387, 1, 43, 44
8228, 1, 1636422649217, 1636422649926, 709, 308, 401, 0, 38, 38
8229, 1, 1636422649280, 1636422649934, 654, 279, 375, 1, 1, 2
8230, 1, 1636422649298, 1636422649966, 668, 270, 398, 1, 0, 1
8231, 1, 1636422649459, 1636422650122, 663, 306, 357, 1, 41, 42
8232, 1, 1636422649474, 1636422650142, 668, 269, 399, 0, 0, 0
8234, 1, 1636422649557, 1636422650210, 653, 288, 365, 0, 19, 19
8233, 1, 1636422649525, 1636422650210, 685, 289, 396, 1, 15, 16
8235, 1, 1636422649607, 1636422650230, 623, 263, 360, 3, 0, 3
8236, 1, 1636422649657, 1636422650242, 585, 275, 310, 0, 0, 0
8238, 1, 1636422649807, 1636422650430, 623, 270, 353, 1, 0, 1
8239, 1, 1636422649831, 1636422650454, 623, 266, 357, 0, 0, 0
8237, 1, 1636422649786, 1636422650454, 668, 267, 401, 2, 0, 2
8241, 1, 1636422649902, 1636422650526, 624, 262, 362, 0, 0, 0
8240, 1, 1636422649894, 1636422650562, 668, 270, 398, 0, 0, 0
8242, 1, 1636422650019, 1636422650642, 623, 266, 357, 0, 0, 0
8243, 1, 1636422650067, 1636422650690, 623, 268, 355, 1, 0, 1
8245, 1, 1636422650230, 1636422650854, 624, 270, 354, 0, 0, 0
8246, 1, 1636422650247, 1636422650870, 623, 270, 353, 1, 0, 1
8247, 1, 1636422650315, 1636422650938, 623, 270, 353, 0, 0, 0
8248, 1, 1636422650347, 1636422650978, 631, 270, 361, 0, 0, 0
8249, 1, 1636422650401, 1636422651026, 625, 269, 356, 0, 0, 0
8250, 1, 1636422650406, 1636422651118, 712, 358, 354, 0, 0, 0
8251, 1, 1636422650550, 1636422651178, 628, 270, 358, 0, 0, 0
8252, 1, 1636422650604, 1636422651238, 634, 274, 360, 2, 0, 2
8253, 1, 1636422650639, 1636422651262, 623, 270, 353, 0, 0, 0
8255, 1, 1636422650705, 1636422651334, 629, 266, 363, 0, 0, 0
8254, 1, 1636422650645, 1636422651390, 745, 382, 363, 0, 0, 0
8256, 1, 1636422650828, 1636422651458, 630, 270, 360, 0, 0, 0
8257, 1, 1636422650850, 1636422651470, 620, 267, 353, 1, 0, 1
8259, 1, 1636422651047, 1636422651674, 627, 274, 353, 0, 0, 0
8260, 1, 1636422651119, 1636422651730, 611, 258, 353, 0, 1, 1
8261, 1, 1636422651160, 1636422651778, 618, 264, 354, 0, 0, 0
8262, 1, 1636422651201, 1636422651834, 633, 275, 358, 1, 1, 2
8263, 1, 1636422651209, 1636422651850, 641, 283, 358, 1, 1, 2
8264, 1, 1636422651334, 1636422651962, 628, 274, 354, 2, 0, 2
8265, 1, 1636422651402, 1636422652034, 632, 269, 363, 1, 0, 1
8266, 1, 1636422651436, 1636422652070, 634, 278, 356, 0, 1, 1
8268, 1, 1636422651491, 1636422652122, 631, 273, 358, 2, 0, 2
8269, 1, 1636422651623, 1636422652250, 627, 269, 358, 1, 0, 1
8270, 1, 1636422651659, 1636422652278, 619, 266, 353, 0, 0, 0
8271, 1, 1636422651840, 1636422652466, 626, 274, 352, 1, 0, 1
8272, 1, 1636422651907, 1636422652526, 619, 266, 353, 0, 0, 0
8273, 1, 1636422651959, 1636422652590, 631, 274, 357, 0, 0, 0
8274, 1, 1636422652008, 1636422652638, 630, 274, 356, 0, 0, 0
8275, 1, 1636422652017, 1636422652646, 629, 274, 355, 0, 0, 0
8276, 1, 1636422652141, 1636422652766, 625, 270, 355, 0, 0, 0
8277, 1, 1636422652217, 1636422652842, 625, 270, 355, 0, 0, 0
8278, 1, 1636422652234, 1636422652858, 624, 270, 354, 1, 0, 1
8279, 1, 1636422652303, 1636422652926, 623, 270, 353, 0, 0, 0
8280, 1, 1636422652424, 1636422653049, 625, 271, 354, 1, 0, 1
8281, 1, 1636422652469, 1636422653094, 625, 266, 359, 0, 0, 0
8282, 1, 1636422652655, 1636422653282, 627, 269, 358, 0, 0, 0
8283, 1, 1636422652723, 1636422653346, 623, 270, 353, 0, 1, 1
8284, 1, 1636422652758, 1636422653382, 624, 271, 353, 0, 1, 1
8285, 1, 1636422652811, 1636422653426, 615, 262, 353, 0, 1, 1
8286, 1, 1636422652820, 1636422653438, 618, 263, 355, 0, 0, 0
8287, 1, 1636422652952, 1636422653574, 622, 272, 350, 1, 1, 2
8288, 1, 1636422653010, 1636422653638, 628, 270, 358, 0, 0, 0
8289, 1, 1636422653035, 1636422653666, 631, 271, 360, 0, 2, 2
8160, 2, 1636422643503, 1636422653679, 10176, 0, 10176, 0, 0, 0
8290, 1, 1636422653110, 1636422653734, 624, 266, 358, 0, 0, 0
8291, 1, 1636422653217, 1636422653842, 625, 266, 359, 0, 1, 1
8292, 1, 1636422653261, 1636422653886, 625, 265, 360, 0, 0, 0
8293, 1, 1636422653458, 1636422654126, 668, 313, 355, 0, 47, 47
8294, 1, 1636422653531, 1636422654154, 623, 266, 357, 1, 0, 1
8295, 1, 1636422653550, 1636422654210, 660, 263, 397, 0, 1, 1
8297, 1, 1636422653621, 1636422654262, 641, 271, 370, 3, 0, 3
8296, 1, 1636422653610, 1636422654266, 656, 271, 385, 3, 0, 3
8298, 1, 1636422653745, 1636422654370, 625, 265, 360, 0, 0, 0
8301, 1, 1636422653822, 1636422654434, 612, 259, 353, 0, 0, 0
8300, 1, 1636422653820, 1636422654438, 618, 266, 352, 0, 0, 0
8302, 1, 1636422653908, 1636422654530, 622, 266, 356, 0, 0, 0
8303, 1, 1636422654033, 1636422654662, 629, 270, 359, 0, 0, 0
8304, 1, 1636422654061, 1636422654690, 629, 269, 360, 1, 0, 1
8305, 1, 1636422654249, 1636422654926, 677, 322, 355, 0, 0, 0
8306, 1, 1636422654319, 1636422654954, 635, 274, 361, 0, 0, 0
8307, 1, 1636422654357, 1636422654986, 629, 272, 357, 0, 0, 0
8309, 1, 1636422654423, 1636422655050, 627, 266, 361, 1, 1, 2
8308, 1, 1636422654422, 1636422655054, 632, 270, 362, 0, 1, 1
8310, 1, 1636422654545, 1636422655170, 625, 270, 355, 0, 0, 0
8312, 1, 1636422654625, 1636422655254, 629, 270, 359, 0, 0, 0
8313, 1, 1636422654699, 1636422655322, 623, 270, 353, 1, 0, 1
8311, 1, 1636422654608, 1636422655450, 842, 485, 357, 1, 0, 1
8314, 1, 1636422654845, 1636422655470, 625, 270, 355, 1, 0, 1
8315, 1, 1636422654855, 1636422655482, 627, 262, 365, 0, 0, 0
8316, 1, 1636422655057, 1636422655694, 637, 274, 363, 0, 0, 0
8317, 1, 1636422655106, 1636422655734, 628, 274, 354, 0, 0, 0
8318, 1, 1636422655152, 1636422655770, 618, 267, 351, 0, 1, 1
8319, 1, 1636422655229, 1636422655854, 625, 267, 358, 0, 1, 1
8320, 1, 1636422655231, 1636422655858, 627, 270, 357, 1, 0, 1
8321, 1, 1636422655338, 1636422655962, 624, 270, 354, 0, 0, 0
8322, 1, 1636422655420, 1636422656050, 630, 274, 356, 0, 0, 0
8324, 1, 1636422655500, 1636422656118, 618, 266, 352, 1, 0, 1
8325, 1, 1636422655631, 1636422656258, 627, 270, 357, 2, 0, 2
8188, 2, 1636422646161, 1636422656291, 10130, 1, 10129, 0, 1, 1
8327, 1, 1636422655864, 1636422656490, 626, 270, 356, 1, 0, 1
8326, 1, 1636422655670, 1636422656558, 888, 533, 355, 0, 31, 31
8328, 1, 1636422655922, 1636422656558, 636, 279, 357, 0, 6, 6
8330, 1, 1636422656029, 1636422656654, 625, 270, 355, 1, 0, 1
8331, 1, 1636422656032, 1636422656662, 630, 275, 355, 1, 0, 1
8329, 1, 1636422655956, 1636422656762, 806, 453, 353, 0, 0, 0
8332, 1, 1636422656154, 1636422656834, 680, 322, 358, 1, 0, 1
8333, 1, 1636422656232, 1636422656866, 634, 263, 371, 0, 0, 0
8334, 1, 1636422656292, 1636422656910, 618, 266, 352, 0, 0, 0
8336, 1, 1636422656435, 1636422657062, 627, 270, 357, 1, 0, 1
8335, 1, 1636422656422, 1636422657078, 656, 262, 394, 0, 0, 0
8337, 1, 1636422656559, 1636422657222, 663, 269, 394, 0, 1, 1
8338, 1, 1636422656662, 1636422657294, 632, 270, 362, 0, 0, 0
8339, 1, 1636422656713, 1636422657342, 629, 274, 355, 0, 0, 0
8340, 1, 1636422656764, 1636422657434, 670, 271, 399, 0, 1, 1
8341, 1, 1636422656819, 1636422657442, 623, 270, 353, 0, 0, 0
8342, 1, 1636422656821, 1636422657442, 621, 266, 355, 0, 0, 0
8343, 1, 1636422656964, 1636422657582, 618, 266, 352, 0, 0, 0
8344, 1, 1636422657034, 1636422657650, 616, 262, 354, 0, 0, 0
8345, 1, 1636422657092, 1636422657706, 614, 263, 351, 0, 2, 2
8346, 1, 1636422657179, 1636422657798, 619, 266, 353, 1, 1, 2
8348, 1, 1636422657352, 1636422657982, 630, 273, 357, 0, 1, 1
8347, 1, 1636422657242, 1636422657982, 740, 387, 353, 1, 1, 2
8349, 1, 1636422657460, 1636422658082, 622, 270, 352, 0, 0, 0
8350, 1, 1636422657525, 1636422658150, 625, 270, 355, 2, 0, 2
8353, 1, 1636422657623, 1636422658246, 623, 269, 354, 0, 1, 1
8352, 1, 1636422657620, 1636422658250, 630, 270, 360, 0, 1, 1
8354, 1, 1636422657753, 1636422658378, 625, 270, 355, 0, 0, 0
8355, 1, 1636422657825, 1636422658450, 625, 270, 355, 0, 0, 0
8356, 1, 1636422657879, 1636422658502, 623, 270, 353, 0, 0, 0
8357, 1, 1636422657976, 1636422658606, 630, 270, 360, 0, 0, 0
8358, 1, 1636422658039, 1636422658666, 627, 271, 356, 0, 1, 1
8359, 1, 1636422658138, 1636422658762, 624, 270, 354, 0, 0, 0
8360, 1, 1636422658260, 1636422658886, 626, 271, 355, 0, 0, 0
8361, 1, 1636422658323, 1636422658946, 623, 270, 353, 0, 0, 0
8362, 1, 1636422658415, 1636422659046, 631, 274, 357, 1, 1, 2
8363, 1, 1636422658430, 1636422659054, 624, 269, 355, 0, 1, 1
8364, 1, 1636422658555, 1636422659178, 623, 270, 353, 1, 0, 1
8365, 1, 1636422658610, 1636422659242, 632, 274, 358, 1, 0, 1
8366, 1, 1636422658686, 1636422659310, 624, 266, 358, 0, 0, 0
8367, 1, 1636422658786, 1636422659410, 624, 263, 361, 1, 0, 1
8368, 1, 1636422658831, 1636422659446, 615, 263, 352, 1, 1, 2
8369, 1, 1636422658937, 1636422659562, 625, 271, 354, 1, 0, 1
8370, 1, 1636422659053, 1636422659678, 625, 270, 355, 0, 0, 0
8371, 1, 1636422659123, 1636422659746, 623, 269, 354, 0, 0, 0
8372, 1, 1636422659224, 1636422659846, 622, 266, 356, 0, 0, 0
8373, 1, 1636422659228, 1636422659854, 626, 270, 356, 0, 0, 0
8375, 1, 1636422659418, 1636422660042, 624, 270, 354, 0, 0, 0
8376, 1, 1636422659493, 1636422660110, 617, 262, 355, 0, 0, 0
8377, 1, 1636422659596, 1636422660214, 618, 266, 352, 0, 0, 0
8244, 2, 1636422650085, 1636422660219, 10134, 0, 10134, 0, 0, 0
8378, 1, 1636422659644, 1636422660262, 618, 266, 352, 0, 0, 0
8379, 1, 1636422659738, 1636422660362, 624, 265, 359, 0, 0, 0
8382, 1, 1636422660020, 1636422660666, 646, 292, 354, 1, 26, 27
8381, 1, 1636422660020, 1636422660674, 654, 298, 356, 1, 26, 27
8383, 1, 1636422660220, 1636422660850, 630, 274, 356, 1, 0, 1
8384, 1, 1636422660284, 1636422660906, 622, 267, 355, 0, 1, 1
8385, 1, 1636422660350, 1636422661014, 664, 269, 395, 0, 0, 0
8386, 1, 1636422660389, 1636422661014, 625, 271, 354, 2, 1, 3
8387, 1, 1636422660431, 1636422661058, 627, 270, 357, 0, 0, 0
8258, 2, 1636422651036, 1636422661167, 10131, 0, 10131, 0, 0, 0
8388, 1, 1636422660543, 1636422661170, 627, 273, 354, 0, 0, 0
8390, 1, 1636422660831, 1636422661458, 627, 272, 355, 0, 0, 0
8389, 1, 1636422660828, 1636422661462, 634, 273, 361, 0, 0, 0
8267, 2, 1636422651449, 1636422661587, 10138, 0, 10138, 0, 0, 0
8391, 1, 1636422661016, 1636422661642, 626, 275, 351, 1, 0, 1
8392, 1, 1636422661069, 1636422661710, 641, 277, 364, 0, 1, 1
8393, 1, 1636422661119, 1636422661746, 627, 269, 358, 0, 1, 1
8394, 1, 1636422661189, 1636422661850, 661, 308, 353, 1, 42, 43
8396, 1, 1636422661298, 1636422661962, 664, 270, 394, 0, 0, 0
8397, 1, 1636422661345, 1636422661970, 625, 271, 354, 1, 0, 1
8398, 1, 1636422661623, 1636422662250, 627, 274, 353, 2, 0, 2
8399, 1, 1636422661638, 1636422662262, 624, 269, 355, 0, 0, 0
8400, 1, 1636422661718, 1636422662390, 672, 274, 398, 1, 0, 1
8401, 1, 1636422661869, 1636422662494, 625, 266, 359, 0, 0, 0
8402, 1, 1636422661902, 1636422662530, 628, 270, 358, 0, 0, 0
8403, 1, 1636422661986, 1636422662610, 624, 266, 358, 0, 0, 0
8404, 1, 1636422662065, 1636422662690, 625, 271, 354, 1, 0, 1
8405, 1, 1636422662131, 1636422662750, 619, 266, 353, 0, 0, 0
8406, 1, 1636422662425, 1636422663050, 625, 269, 356, 1, 0, 1
8408, 1, 1636422662481, 1636422663110, 629, 270, 359, 0, 0, 0
8409, 1, 1636422662656, 1636422663278, 622, 270, 352, 0, 0, 0
8410, 1, 1636422662710, 1636422663342, 632, 275, 357, 1, 1, 2
8411, 1, 1636422662801, 1636422663422, 621, 262, 359, 0, 0, 0
8412, 1, 1636422662850, 1636422663466, 616, 263, 353, 0, 0, 0
8413, 1, 1636422662936, 1636422663562, 626, 271, 355, 0, 1, 1
8414, 1, 1636422663209, 1636422663842, 633, 277, 356, 0, 0, 0
8415, 1, 1636422663265, 1636422663890, 625, 266, 359, 0, 0, 0
8299, 2, 1636422653806, 1636422663979, 10173, 0, 10173, 0, 0, 0
8416, 1, 1636422663466, 1636422664094, 628, 270, 358, 0, 0, 0
8417, 1, 1636422663525, 1636422664150, 625, 271, 354, 0, 1, 1
8418, 1, 1636422663604, 1636422664246, 642, 288, 354, 0, 18, 18
8419, 1, 1636422663660, 1636422664282, 622, 271, 351, 0, 0, 0
8420, 1, 1636422663724, 1636422664350, 626, 275, 351, 2, 0, 2
8421, 1, 1636422664017, 1636422664642, 625, 271, 354, 2, 0, 2
8422, 1, 1636422664073, 1636422664702, 629, 271, 358, 2, 1, 3
8423, 1, 1636422664107, 1636422664774, 667, 271, 396, 0, 1, 1
8424, 1, 1636422664266, 1636422664890, 624, 270, 354, 0, 0, 0
8425, 1, 1636422664317, 1636422664946, 629, 271, 358, 0, 0, 0
8426, 1, 1636422664390, 1636422665014, 624, 271, 353, 0, 0, 0
8427, 1, 1636422664470, 1636422665094, 624, 270, 354, 1, 0, 1
8429, 1, 1636422664804, 1636422665434, 630, 271, 359, 1, 1, 2
8430, 1, 1636422664862, 1636422665486, 624, 270, 354, 0, 0, 0
8431, 1, 1636422664883, 1636422665506, 623, 270, 353, 0, 0, 0
8323, 2, 1636422655451, 1636422665623, 10172, 1, 10171, 1, 0, 1
8432, 1, 1636422665067, 1636422665686, 619, 263, 356, 0, 0, 0
8433, 1, 1636422665118, 1636422665758, 640, 282, 358, 1, 0, 1
8434, 1, 1636422665192, 1636422665822, 630, 270, 360, 0, 0, 0
8435, 1, 1636422665261, 1636422665890, 629, 273, 356, 0, 6, 6
8436, 1, 1636422665624, 1636422666250, 626, 266, 360, 0, 0, 0
8438, 1, 1636422665675, 1636422666298, 623, 270, 353, 0, 0, 0
8439, 1, 1636422665762, 1636422666426, 664, 269, 395, 1, 0, 1
8440, 1, 1636422665918, 1636422666546, 628, 271, 357, 0, 1, 1
8442, 1, 1636422666071, 1636422666706, 635, 270, 365, 0, 0, 0
8443, 1, 1636422666404, 1636422667026, 622, 271, 351, 0, 0, 0
8444, 1, 1636422666476, 1636422667102, 626, 270, 356, 1, 0, 1
8445, 1, 1636422666517, 1636422667142, 625, 269, 356, 1, 0, 1
8446, 1, 1636422666733, 1636422667358, 625, 270, 355, 1, 0, 1
8447, 1, 1636422666862, 1636422667490, 628, 270, 358, 1, 0, 1
8351, 2, 1636422657569, 1636422667704, 10135, 1, 10134, 1, 0, 1
8448, 1, 1636422667205, 1636422667830, 625, 270, 355, 0, 0, 0
8449, 1, 1636422667268, 1636422667890, 622, 270, 352, 2, 0, 2
8450, 1, 1636422667322, 1636422667970, 648, 291, 357, 1, 22, 23
8451, 1, 1636422667536, 1636422668162, 626, 274, 352, 0, 0, 0
8452, 1, 1636422667704, 1636422668326, 622, 270, 352, 1, 0, 1
8453, 1, 1636422667834, 1636422668506, 672, 270, 402, 0, 1, 1
8454, 1, 1636422668084, 1636422668710, 626, 270, 356, 0, 0, 0
8455, 1, 1636422668130, 1636422668754, 624, 271, 353, 0, 0, 0
8456, 1, 1636422668322, 1636422668978, 656, 297, 359, 0, 0, 0
8457, 1, 1636422668482, 1636422669106, 624, 270, 354, 1, 0, 1
8458, 1, 1636422668591, 1636422669222, 631, 273, 358, 0, 0, 0
8459, 1, 1636422668887, 1636422669510, 623, 266, 357, 1, 0, 1
8460, 1, 1636422668947, 1636422669578, 631, 273, 358, 1, 0, 1
8374, 2, 1636422659363, 1636422669759, 10396, 217, 10179, 0, 1, 1
8461, 1, 1636422669135, 1636422669762, 627, 275, 352, 1, 0, 1
8462, 1, 1636422669268, 1636422669886, 618, 266, 352, 0, 1, 1
8380, 2, 1636422659858, 1636422669991, 10133, 0, 10133, 0, 0, 0
8463, 1, 1636422669403, 1636422670114, 711, 358, 353, 1, 90, 91
8465, 1, 1636422669760, 1636422670346, 586, 275, 311, 2, 5, 7
8464, 1, 1636422669760, 1636422670378, 618, 266, 352, 0, 1, 1
8466, 1, 1636422669846, 1636422670530, 684, 272, 412, 0, 1, 1
8468, 1, 1636422670075, 1636422670698, 623, 271, 352, 0, 2, 2
8469, 1, 1636422670208, 1636422670834, 626, 270, 356, 0, 1, 1
8470, 1, 1636422670480, 1636422671102, 622, 271, 351, 1, 1, 2
8471, 1, 1636422670526, 1636422671154, 628, 270, 358, 0, 0, 0
8472, 1, 1636422670610, 1636422671234, 624, 271, 353, 0, 1, 1
8395, 2, 1636422661236, 1636422671367, 10131, 0, 10131, 0, 0, 0
8474, 1, 1636422671024, 1636422671646, 622, 268, 354, 0, 0, 0
8476, 1, 1636422671311, 1636422671938, 627, 263, 364, 0, 1, 1
8477, 1, 1636422671412, 1636422672034, 622, 270, 352, 0, 0, 0
8478, 1, 1636422671818, 1636422672450, 632, 270, 362, 0, 0, 0
8407, 2, 1636422662428, 1636422672564, 10136, 1, 10135, 1, 1, 2
8479, 1, 1636422672198, 1636422672834, 636, 275, 361, 0, 2, 2
8480, 1, 1636422672612, 1636422673246, 634, 268, 366, 0, 0, 0
8481, 1, 1636422673011, 1636422673634, 623, 270, 353, 0, 1, 1
8482, 1, 1636422673405, 1636422674034, 629, 269, 360, 1, 0, 1
8483, 1, 1636422673800, 1636422674422, 622, 269, 353, 2, 0, 2
8428, 2, 1636422664534, 1636422674667, 10133, 1, 10132, 0, 0, 0
8485, 1, 1636422674802, 1636422675474, 672, 269, 403, 0, 0, 0
8437, 2, 1636422665667, 1636422675800, 10133, 0, 10133, 0, 0, 0
8441, 2, 1636422665999, 1636422676131, 10132, 0, 10132, 0, 0, 0
8486, 1, 1636422675558, 1636422676190, 632, 269, 363, 1, 0, 1
8487, 1, 1636422675930, 1636422676594, 664, 269, 395, 0, 0, 0
8488, 1, 1636422676370, 1636422676994, 624, 269, 355, 1, 0, 1
8489, 1, 1636422676698, 1636422677326, 628, 271, 357, 0, 1, 1
8490, 1, 1636422677181, 1636422677806, 625, 268, 357, 1, 0, 1
8491, 1, 1636422677482, 1636422678110, 628, 269, 359, 0, 0, 0
8492, 1, 1636422677997, 1636422678626, 629, 271, 358, 1, 1, 2
8493, 1, 1636422678290, 1636422678918, 628, 272, 356, 0, 1, 1
8494, 1, 1636422678785, 1636422679414, 629, 268, 361, 0, 0, 0
8495, 1, 1636422679100, 1636422679722, 622, 271, 351, 1, 0, 1
8467, 2, 1636422669943, 1636422680079, 10136, 0, 10136, 0, 0, 0
8500, 1, 1636422679892, 1636422680526, 634, 282, 352, 0, 14, 14
8499, 1, 1636422679843, 1636422680526, 683, 285, 398, 1, 15, 16
8501, 1, 1636422680210, 1636422680882, 672, 270, 402, 1, 0, 1
8473, 2, 1636422670881, 1636422681016, 10135, 0, 10135, 0, 0, 0
8502, 1, 1636422680606, 1636422681234, 628, 270, 358, 1, 0, 1
8503, 1, 1636422680702, 1636422681322, 620, 268, 352, 0, 1, 1
8475, 1, 1636422671288, 1636422681506, 10218, 9831, 387, 0, 1, 1
8504, 1, 1636422680970, 1636422681594, 624, 268, 356, 0, 0, 0
8505, 1, 1636422681146, 1636422681809, 663, 270, 393, 1, 0, 1
8506, 1, 1636422681408, 1636422682026, 618, 267, 351, 0, 1, 1
8507, 1, 1636422681494, 1636422682118, 624, 269, 355, 0, 0, 0
8508, 1, 1636422681507, 1636422682174, 667, 266, 401, 0, 0, 0
8509, 1, 1636422681773, 1636422682398, 625, 270, 355, 0, 1, 1
8510, 1, 1636422681905, 1636422682530, 625, 268, 357, 0, 0, 0
8511, 1, 1636422682196, 1636422682826, 630, 274, 356, 0, 0, 0
8512, 1, 1636422682310, 1636422682938, 628, 266, 362, 0, 0, 0
8513, 1, 1636422682313, 1636422682946, 633, 270, 363, 0, 0, 0
8514, 1, 1636422682560, 1636422683182, 622, 271, 351, 1, 0, 1
8515, 1, 1636422682708, 1636422683330, 622, 270, 352, 0, 0, 0
8516, 1, 1636422683008, 1636422683626, 618, 266, 352, 0, 0, 0
8517, 1, 1636422683113, 1636422683738, 625, 270, 355, 0, 1, 1
8518, 1, 1636422683113, 1636422683742, 629, 271, 358, 1, 2, 3
8519, 1, 1636422683368, 1636422683990, 622, 266, 356, 0, 0, 0
8520, 1, 1636422683494, 1636422684118, 624, 270, 354, 1, 1, 2
8522, 1, 1636422683900, 1636422684522, 622, 270, 352, 0, 0, 0
8523, 1, 1636422683905, 1636422684530, 625, 270, 355, 0, 0, 0
8484, 2, 1636422674608, 1636422684756, 10148, 0, 10148, 1, 0, 1
8525, 1, 1636422684303, 1636422684930, 627, 270, 357, 0, 0, 0
8526, 1, 1636422684701, 1636422685338, 637, 271, 366, 1, 0, 1
8527, 1, 1636422684757, 1636422685342, 585, 274, 311, 0, 0, 0
8528, 1, 1636422684886, 1636422685566, 680, 269, 411, 0, 0, 0
8531, 1, 1636422685509, 1636422686134, 625, 270, 355, 1, 0, 1
8532, 1, 1636422685638, 1636422686266, 628, 270, 358, 1, 0, 1
8533, 1, 1636422686306, 1636422686934, 628, 270, 358, 0, 0, 0
8534, 1, 1636422686444, 1636422687070, 626, 269, 357, 0, 1, 1
8535, 1, 1636422687097, 1636422687722, 625, 270, 355, 0, 1, 1
8536, 1, 1636422687256, 1636422687878, 622, 270, 352, 0, 1, 1
8537, 1, 1636422687899, 1636422688526, 627, 270, 357, 1, 0, 1
8538, 1, 1636422688072, 1636422688702, 630, 270, 360, 1, 1, 2
8539, 1, 1636422688692, 1636422689314, 622, 271, 351, 0, 0, 0
8540, 1, 1636422688860, 1636422689486, 626, 268, 358, 0, 0, 0
8497, 2, 1636422679843, 1636422690019, 10176, 2, 10174, 3, 0, 3
8498, 2, 1636422679843, 1636422690063, 10220, 2, 10218, 0, 1, 1
8496, 2, 1636422679842, 1636422690108, 10266, 1, 10265, 0, 2, 2
8541, 1, 1636422689497, 1636422690122, 625, 269, 356, 1, 0, 1
8542, 1, 1636422690194, 1636422690862, 668, 270, 398, 0, 0, 0
8545, 1, 1636422690292, 1636422690914, 622, 269, 353, 0, 0, 0
8543, 1, 1636422690198, 1636422691138, 940, 541, 399, 0, 0, 0
8544, 1, 1636422690198, 1636422691410, 1212, 815, 397, 1, 2, 3
8546, 1, 1636422690951, 1636422691570, 619, 267, 352, 0, 0, 0
8547, 1, 1636422691099, 1636422691726, 627, 267, 360, 1, 0, 1
8548, 1, 1636422691139, 1636422691806, 667, 270, 397, 0, 0, 0
8549, 1, 1636422691412, 1636422692078, 666, 268, 398, 0, 0, 0
8550, 1, 1636422691736, 1636422692358, 622, 270, 352, 0, 0, 0
8551, 1, 1636422691906, 1636422692526, 620, 265, 355, 1, 0, 1
8552, 1, 1636422691949, 1636422692570, 621, 268, 353, 1, 0, 1
8553, 1, 1636422692222, 1636422692850, 628, 270, 358, 0, 0, 0
8554, 1, 1636422692541, 1636422693170, 629, 273, 356, 1, 0, 1
8555, 1, 1636422692693, 1636422693318, 625, 270, 355, 0, 1, 1
8556, 1, 1636422692756, 1636422693378, 622, 269, 353, 0, 0, 0
8557, 1, 1636422693029, 1636422693662, 633, 270, 363, 1, 0, 1
8521, 2, 1636422683791, 1636422693927, 10136, 0, 10136, 0, 0, 0
8558, 1, 1636422693352, 1636422693970, 618, 267, 351, 1, 0, 1
8559, 1, 1636422693477, 1636422694102, 625, 270, 355, 0, 0, 0
8560, 1, 1636422693543, 1636422694194, 651, 295, 356, 1, 26, 27
8524, 2, 1636422684155, 1636422694287, 10132, 0, 10132, 0, 0, 0
8561, 1, 1636422693828, 1636422694470, 642, 272, 370, 0, 0, 0
8562, 1, 1636422694058, 1636422694730, 672, 278, 394, 0, 14, 14
8563, 1, 1636422694155, 1636422694778, 623, 270, 353, 0, 1, 1
8564, 1, 1636422694292, 1636422694914, 622, 270, 352, 1, 0, 1
8565, 1, 1636422694331, 1636422694950, 619, 266, 353, 2, 1, 3
8566, 1, 1636422694418, 1636422695090, 672, 273, 399, 1, 0, 1
8529, 2, 1636422685092, 1636422695227, 10135, 0, 10135, 0, 0, 0
8567, 1, 1636422694625, 1636422695250, 625, 269, 356, 0, 0, 0
8568, 1, 1636422694815, 1636422695442, 627, 270, 357, 0, 0, 0
8569, 1, 1636422694948, 1636422695578, 630, 278, 352, 0, 14, 14
8530, 1, 1636422685502, 1636422695726, 10224, 9863, 361, 0, 1, 1
8570, 1, 1636422695146, 1636422695810, 664, 270, 394, 1, 1, 2
8571, 1, 1636422695178, 1636422695810, 632, 270, 362, 1, 1, 2
8572, 1, 1636422695358, 1636422696022, 664, 269, 395, 0, 0, 0
8573, 1, 1636422695441, 1636422696074, 633, 278, 355, 0, 1, 1
8574, 1, 1636422695601, 1636422696226, 625, 270, 355, 0, 0, 0
8576, 1, 1636422695743, 1636422696362, 619, 271, 348, 0, 0, 0
8575, 1, 1636422695727, 1636422696394, 667, 270, 397, 0, 0, 0
8577, 1, 1636422695978, 1636422696602, 624, 270, 354, 1, 0, 1
8578, 1, 1636422696114, 1636422696746, 632, 278, 354, 0, 0, 0
8579, 1, 1636422696232, 1636422696858, 626, 270, 356, 0, 0, 0
8580, 1, 1636422696406, 1636422697026, 620, 267, 353, 0, 0, 0
8581, 1, 1636422696515, 1636422697138, 623, 270, 353, 1, 0, 1
8582, 1, 1636422696527, 1636422697146, 619, 267, 352, 1, 0, 1
8583, 1, 1636422696784, 1636422697406, 622, 266, 356, 0, 1, 1
8584, 1, 1636422696914, 1636422697538, 624, 269, 355, 0, 0, 0
8585, 1, 1636422697042, 1636422697666, 624, 270, 354, 0, 0, 0
8586, 1, 1636422697217, 1636422697842, 625, 270, 355, 0, 0, 0
8587, 1, 1636422697301, 1636422697922, 621, 271, 350, 0, 0, 0
8588, 1, 1636422697595, 1636422698218, 623, 270, 353, 1, 0, 1
8589, 1, 1636422697720, 1636422698342, 622, 270, 352, 2, 0, 2
8590, 1, 1636422698033, 1636422698662, 629, 267, 362, 0, 0, 0
8591, 1, 1636422698105, 1636422698726, 621, 266, 355, 0, 0, 0
8592, 1, 1636422698410, 1636422699038, 628, 269, 359, 0, 1, 1
8593, 1, 1636422698532, 1636422699162, 630, 271, 359, 1, 0, 1
8594, 1, 1636422698821, 1636422699446, 625, 270, 355, 0, 0, 0
8595, 1, 1636422698916, 1636422699538, 622, 270, 352, 1, 1, 2
8596, 1, 1636422699204, 1636422699826, 622, 269, 353, 1, 0, 1
8597, 1, 1636422699332, 1636422699966, 634, 269, 365, 1, 0, 1
8598, 1, 1636422699732, 1636422700350, 618, 261, 357, 0, 0, 0
8599, 1, 1636422700121, 1636422700754, 633, 268, 365, 1, 0, 1
8600, 1, 1636422700531, 1636422701158, 627, 271, 356, 1, 0, 1
8617, 2, 1636423361303, 1636423392029, 30726, 0, 30726, 0, 0, 0
8618, 2, 1636423364375, 1636423395094, 30719, 0, 30719, 0, 0, 0
8619, 2, 1636423388950, 1636423410454, 21504, 0, 21504, 1, 0, 1
8620, 2, 1636423392022, 1636423435030, 43008, 4, 43004, 0, 4, 4
