Xid, State, StartTime, EndTime, TransactionTime, ExecuteTime, CommunicationTime, ReadTime, WriteTime, DBTime
1, 1, 1636423658197, 1636423659046, 849, 465, 384, 0, 14, 14
2, 1, 1636423659135, 1636423659810, 675, 279, 396, 0, 1, 1
3, 1, 1636423659856, 1636423660538, 682, 277, 405, 0, 1, 1
4, 1, 1636423660584, 1636423661262, 678, 277, 401, 0, 1, 1
5, 1, 1636423661307, 1636423661995, 688, 281, 407, 0, 1, 1
6, 1, 1636423662040, 1636423662722, 682, 278, 404, 0, 0, 0
7, 1, 1636423662767, 1636423663442, 675, 277, 398, 0, 0, 0
8, 1, 1636423663488, 1636423664162, 674, 275, 399, 0, 0, 0
9, 1, 1636423664207, 1636423664902, 695, 278, 417, 0, 1, 1
10, 1, 1636423664947, 1636423665622, 675, 278, 397, 0, 1, 1
11, 1, 1636423665668, 1636423666343, 675, 275, 400, 0, 0, 0
12, 1, 1636423666387, 1636423667058, 671, 273, 398, 0, 1, 1
13, 1, 1636423667103, 1636423667778, 675, 275, 400, 0, 1, 1
14, 1, 1636423667823, 1636423668494, 671, 275, 396, 0, 0, 0
15, 1, 1636423668540, 1636423669214, 674, 277, 397, 0, 1, 1
16, 1, 1636423669260, 1636423669934, 674, 274, 400, 0, 0, 0
17, 1, 1636423669979, 1636423670650, 671, 273, 398, 0, 0, 0
18, 1, 1636423670653, 1636423671283, 630, 270, 360, 0, 0, 0
19, 1, 1636423671285, 1636423671914, 629, 271, 358, 0, 1, 1
20, 1, 1636423671917, 1636423672550, 633, 275, 358, 0, 0, 0
21, 1, 1636423672553, 1636423673186, 633, 270, 363, 0, 0, 0
23, 1, 1636423673189, 1636423673819, 630, 269, 361, 0, 0, 0
22, 1, 1636423673115, 1636423673934, 819, 401, 418, 0, 2, 2
24, 1, 1636423673821, 1636423674442, 621, 266, 355, 0, 0, 0
25, 1, 1636423674001, 1636423674670, 669, 270, 399, 0, 0, 0
26, 1, 1636423674444, 1636423675074, 630, 276, 354, 0, 0, 0
27, 1, 1636423674673, 1636423675346, 673, 275, 398, 0, 0, 0
28, 1, 1636423675076, 1636423675706, 630, 276, 354, 0, 0, 0
29, 1, 1636423675348, 1636423676022, 674, 274, 400, 0, 0, 0
30, 1, 1636423675709, 1636423676338, 629, 270, 359, 0, 0, 0
31, 1, 1636423676024, 1636423676702, 678, 273, 405, 0, 0, 0
32, 1, 1636423676341, 1636423676974, 633, 274, 359, 0, 0, 0
33, 1, 1636423676705, 1636423677382, 677, 275, 402, 0, 0, 0
34, 1, 1636423676977, 1636423677610, 633, 275, 358, 0, 0, 0
35, 1, 1636423677384, 1636423678058, 674, 274, 400, 0, 0, 0
36, 1, 1636423677612, 1636423678246, 634, 277, 357, 0, 1, 1
37, 1, 1636423678060, 1636423678734, 674, 275, 399, 0, 0, 0
38, 1, 1636423678248, 1636423678874, 626, 274, 352, 0, 0, 0
39, 1, 1636423678737, 1636423679418, 681, 275, 406, 0, 0, 0
40, 1, 1636423678877, 1636423679502, 625, 266, 359, 0, 0, 0
41, 1, 1636423679420, 1636423680098, 678, 279, 399, 0, 0, 0
42, 1, 1636423679504, 1636423680130, 626, 272, 354, 0, 0, 0
44, 1, 1636423680133, 1636423680762, 629, 268, 361, 0, 0, 0
43, 1, 1636423680100, 1636423680774, 674, 274, 400, 0, 0, 0
45, 1, 1636423680764, 1636423681390, 626, 274, 352, 0, 0, 0
46, 1, 1636423680777, 1636423681450, 673, 276, 397, 0, 0, 0
47, 1, 1636423681392, 1636423682022, 630, 274, 356, 0, 0, 0
48, 1, 1636423681453, 1636423682130, 677, 275, 402, 0, 0, 0
49, 1, 1636423682025, 1636423682658, 633, 272, 361, 0, 0, 0
50, 1, 1636423682132, 1636423682814, 682, 276, 406, 0, 0, 0
51, 1, 1636423682660, 1636423683286, 626, 269, 357, 0, 0, 0
52, 1, 1636423682817, 1636423683494, 677, 273, 404, 0, 0, 0
53, 1, 1636423683288, 1636423683910, 622, 272, 350, 0, 0, 0
54, 1, 1636423683497, 1636423684174, 677, 277, 400, 0, 0, 0
55, 1, 1636423683913, 1636423684546, 633, 277, 356, 0, 0, 0
56, 1, 1636423684176, 1636423684802, 626, 270, 356, 0, 0, 0
57, 1, 1636423684549, 1636423685182, 633, 277, 356, 0, 0, 0
58, 1, 1636423684804, 1636423685434, 630, 274, 356, 0, 0, 0
59, 1, 1636423685184, 1636423685810, 626, 274, 352, 0, 0, 0
60, 1, 1636423685436, 1636423686066, 630, 275, 355, 0, 0, 0
61, 1, 1636423685812, 1636423686446, 634, 275, 359, 0, 0, 0
62, 1, 1636423686069, 1636423686698, 629, 275, 354, 0, 0, 0
63, 1, 1636423686448, 1636423687078, 630, 273, 357, 0, 0, 0
64, 1, 1636423686701, 1636423687330, 629, 275, 354, 0, 0, 0
65, 1, 1636423687080, 1636423687714, 634, 278, 356, 0, 0, 0
66, 1, 1636423687333, 1636423687966, 633, 273, 360, 0, 0, 0
67, 1, 1636423687717, 1636423688350, 633, 274, 359, 0, 0, 0
68, 1, 1636423687969, 1636423688598, 629, 274, 355, 0, 1, 1
69, 1, 1636423688352, 1636423688974, 622, 270, 352, 0, 0, 0
70, 1, 1636423688600, 1636423689230, 630, 273, 357, 0, 0, 0
71, 1, 1636423688977, 1636423689606, 629, 276, 353, 0, 1, 1
72, 1, 1636423689232, 1636423689858, 626, 271, 355, 0, 0, 0
73, 1, 1636423689607, 1636423690230, 623, 267, 356, 0, 0, 0
74, 1, 1636423689860, 1636423690490, 630, 273, 357, 0, 0, 0
75, 1, 1636423690232, 1636423690858, 626, 274, 352, 0, 0, 0
76, 1, 1636423690494, 1636423691118, 624, 269, 355, 0, 0, 0
77, 1, 1636423690598, 1636423691370, 772, 394, 378, 0, 0, 0
78, 1, 1636423690860, 1636423691478, 618, 267, 351, 0, 1, 1
79, 1, 1636423691120, 1636423691750, 630, 273, 357, 0, 0, 0
81, 1, 1636423691481, 1636423692114, 633, 276, 357, 0, 0, 0
80, 1, 1636423691436, 1636423692114, 678, 279, 399, 0, 0, 0
82, 1, 1636423691752, 1636423692382, 630, 273, 357, 0, 0, 0
83, 1, 1636423692116, 1636423692742, 626, 270, 356, 0, 0, 0
84, 1, 1636423692117, 1636423692794, 677, 278, 399, 0, 1, 1
85, 1, 1636423692384, 1636423693010, 626, 270, 356, 0, 0, 0
86, 1, 1636423692744, 1636423693366, 622, 266, 356, 0, 0, 0
87, 1, 1636423692797, 1636423693474, 677, 276, 401, 0, 0, 0
88, 1, 1636423693012, 1636423693650, 638, 279, 359, 0, 0, 0
89, 1, 1636423693367, 1636423693990, 623, 272, 351, 0, 0, 0
90, 1, 1636423693477, 1636423694150, 673, 275, 398, 0, 0, 0
91, 1, 1636423693652, 1636423694274, 622, 269, 353, 0, 0, 0
92, 1, 1636423693992, 1636423694614, 622, 268, 354, 0, 0, 0
93, 1, 1636423694152, 1636423694830, 678, 280, 398, 0, 0, 0
94, 1, 1636423694275, 1636423694902, 627, 270, 357, 0, 0, 0
95, 1, 1636423694616, 1636423695250, 634, 276, 358, 0, 0, 0
96, 1, 1636423694831, 1636423695510, 679, 275, 404, 0, 1, 1
97, 1, 1636423694904, 1636423695538, 634, 275, 359, 0, 1, 1
98, 1, 1636423695252, 1636423695866, 614, 267, 347, 0, 1, 1
100, 1, 1636423695541, 1636423696170, 629, 275, 354, 0, 1, 1
99, 1, 1636423695512, 1636423696190, 678, 276, 402, 0, 0, 0
101, 1, 1636423695868, 1636423696498, 630, 271, 359, 0, 1, 1
102, 1, 1636423696172, 1636423696798, 626, 271, 355, 0, 1, 1
103, 1, 1636423696193, 1636423696874, 681, 272, 409, 0, 1, 1
104, 1, 1636423696500, 1636423697122, 622, 277, 345, 0, 1, 1
105, 1, 1636423696801, 1636423697434, 633, 273, 360, 0, 0, 0
106, 1, 1636423696877, 1636423697554, 677, 276, 401, 0, 1, 1
107, 1, 1636423697123, 1636423697738, 615, 267, 348, 0, 1, 1
108, 1, 1636423697436, 1636423698062, 626, 272, 354, 0, 0, 0
109, 1, 1636423697556, 1636423698230, 674, 275, 399, 0, 0, 0
110, 1, 1636423697740, 1636423698366, 626, 276, 350, 0, 1, 1
111, 1, 1636423698064, 1636423698690, 626, 270, 356, 0, 0, 0
112, 1, 1636423698232, 1636423698906, 674, 276, 398, 0, 0, 0
113, 1, 1636423698368, 1636423698990, 622, 270, 352, 0, 0, 0
114, 1, 1636423698693, 1636423699318, 625, 270, 355, 0, 0, 0
115, 1, 1636423698908, 1636423699582, 674, 274, 400, 0, 0, 0
116, 1, 1636423698993, 1636423699622, 629, 268, 361, 0, 0, 0
117, 1, 1636423699320, 1636423699946, 626, 271, 355, 0, 1, 1
119, 1, 1636423699624, 1636423700254, 630, 274, 356, 0, 1, 1
118, 1, 1636423699584, 1636423700262, 678, 276, 402, 0, 0, 0
120, 1, 1636423699948, 1636423700578, 630, 274, 356, 0, 1, 1
121, 1, 1636423700257, 1636423700886, 629, 271, 358, 0, 0, 0
122, 1, 1636423700264, 1636423700938, 674, 278, 396, 0, 1, 1
123, 1, 1636423700579, 1636423701206, 627, 270, 357, 0, 0, 0
124, 1, 1636423700888, 1636423701506, 618, 266, 352, 0, 0, 0
125, 1, 1636423700940, 1636423701614, 674, 275, 399, 0, 0, 0
126, 1, 1636423701208, 1636423701834, 626, 272, 354, 0, 1, 1
127, 1, 1636423701509, 1636423702130, 621, 264, 357, 0, 1, 1
128, 1, 1636423701616, 1636423702246, 630, 276, 354, 0, 2, 2
129, 1, 1636423701836, 1636423702466, 630, 271, 359, 0, 0, 0
130, 1, 1636423702132, 1636423702754, 622, 267, 355, 0, 0, 0
131, 1, 1636423702249, 1636423702882, 633, 275, 358, 0, 0, 0
132, 1, 1636423702468, 1636423703098, 630, 274, 356, 0, 1, 1
133, 1, 1636423702756, 1636423703382, 626, 272, 354, 0, 0, 0
134, 1, 1636423702884, 1636423703514, 630, 274, 356, 0, 0, 0
135, 1, 1636423703101, 1636423703726, 625, 271, 354, 0, 0, 0
136, 1, 1636423703384, 1636423704010, 626, 276, 350, 0, 1, 1
137, 1, 1636423703515, 1636423704142, 627, 271, 356, 0, 0, 0
138, 1, 1636423703729, 1636423704358, 629, 275, 354, 0, 0, 0
139, 1, 1636423704012, 1636423704642, 630, 275, 355, 0, 0, 0
140, 1, 1636423704144, 1636423704774, 630, 274, 356, 0, 0, 0
141, 1, 1636423704360, 1636423704994, 634, 278, 356, 0, 1, 1
142, 1, 1636423704644, 1636423705266, 622, 268, 354, 0, 0, 0
143, 1, 1636423704776, 1636423705402, 626, 271, 355, 0, 0, 0
144, 1, 1636423704995, 1636423705626, 631, 275, 356, 0, 0, 0
145, 1, 1636423705268, 1636423705898, 630, 274, 356, 0, 0, 0
146, 1, 1636423705404, 1636423706034, 630, 275, 355, 0, 1, 1
147, 1, 1636423705628, 1636423706258, 630, 274, 356, 0, 0, 0
148, 1, 1636423705900, 1636423706530, 630, 270, 360, 0, 0, 0
149, 1, 1636423706036, 1636423706662, 626, 270, 356, 0, 1, 1
150, 1, 1636423706260, 1636423706894, 634, 278, 356, 0, 1, 1
151, 1, 1636423706532, 1636423707154, 622, 271, 351, 0, 0, 0
152, 1, 1636423706663, 1636423707294, 631, 275, 356, 0, 0, 0
153, 1, 1636423706897, 1636423707526, 629, 275, 354, 0, 0, 0
154, 1, 1636423707156, 1636423707786, 630, 276, 354, 0, 0, 0
155, 1, 1636423707295, 1636423707922, 627, 270, 357, 0, 1, 1
156, 1, 1636423707528, 1636423708154, 626, 271, 355, 0, 0, 0
157, 1, 1636423707788, 1636423708418, 630, 274, 356, 0, 0, 0
158, 1, 1636423707924, 1636423708554, 630, 275, 355, 0, 1, 1
159, 1, 1636423708156, 1636423708782, 626, 270, 356, 0, 0, 0
160, 1, 1636423708420, 1636423709050, 630, 274, 356, 0, 0, 0
161, 1, 1636423708556, 1636423709190, 634, 273, 361, 0, 0, 0
162, 1, 1636423708785, 1636423709414, 629, 274, 355, 0, 0, 0
163, 1, 1636423709052, 1636423709674, 622, 267, 355, 0, 0, 0
164, 1, 1636423709193, 1636423709822, 629, 274, 355, 0, 0, 0
165, 1, 1636423709417, 1636423710038, 621, 271, 350, 0, 0, 0
166, 1, 1636423709676, 1636423710294, 618, 276, 342, 0, 0, 0
167, 1, 1636423709825, 1636423710454, 629, 275, 354, 0, 1, 1
168, 1, 1636423710040, 1636423710666, 626, 270, 356, 0, 0, 0
169, 1, 1636423710296, 1636423710926, 630, 274, 356, 0, 0, 0
170, 1, 1636423710456, 1636423711082, 626, 270, 356, 0, 0, 0
171, 1, 1636423710668, 1636423711298, 630, 273, 357, 0, 1, 1
172, 1, 1636423710928, 1636423711558, 630, 271, 359, 0, 0, 0
173, 1, 1636423711085, 1636423711714, 629, 274, 355, 0, 1, 1
174, 1, 1636423711301, 1636423711930, 629, 275, 354, 0, 1, 1
175, 1, 1636423711560, 1636423712194, 634, 279, 355, 0, 0, 0
176, 1, 1636423711717, 1636423712346, 629, 275, 354, 0, 1, 1
177, 1, 1636423711933, 1636423712558, 625, 275, 350, 0, 0, 0
178, 1, 1636423712196, 1636423712822, 626, 267, 359, 0, 0, 0
179, 1, 1636423712348, 1636423712978, 630, 275, 355, 0, 0, 0
180, 1, 1636423712560, 1636423713190, 630, 273, 357, 0, 0, 0
181, 1, 1636423712824, 1636423713450, 626, 272, 354, 0, 0, 0
182, 1, 1636423712980, 1636423713610, 630, 273, 357, 0, 0, 0
183, 1, 1636423713193, 1636423713822, 629, 275, 354, 0, 0, 0
184, 1, 1636423713452, 1636423714070, 618, 270, 348, 0, 1, 1
185, 1, 1636423713613, 1636423714242, 629, 274, 355, 0, 0, 0
186, 1, 1636423713824, 1636423714454, 630, 274, 356, 0, 0, 0
187, 1, 1636423714072, 1636423714694, 622, 266, 356, 0, 0, 0
188, 1, 1636423714244, 1636423714870, 626, 271, 355, 0, 1, 1
189, 1, 1636423714456, 1636423715086, 630, 275, 355, 0, 1, 1
190, 1, 1636423714695, 1636423715318, 623, 272, 351, 0, 0, 0
191, 1, 1636423714872, 1636423715502, 630, 274, 356, 0, 0, 0
192, 1, 1636423715089, 1636423715718, 629, 273, 356, 0, 0, 0
193, 1, 1636423715320, 1636423715942, 622, 273, 349, 0, 0, 0
194, 1, 1636423715503, 1636423716126, 623, 270, 353, 0, 0, 0
195, 1, 1636423715720, 1636423716342, 622, 267, 355, 0, 0, 0
196, 1, 1636423715943, 1636423716566, 623, 266, 357, 0, 0, 0
197, 1, 1636423716127, 1636423716758, 631, 274, 357, 0, 1, 1
198, 1, 1636423716345, 1636423716970, 625, 271, 354, 0, 0, 0
199, 1, 1636423716569, 1636423717194, 625, 274, 351, 0, 0, 0
200, 1, 1636423716760, 1636423717386, 626, 271, 355, 0, 0, 0
201, 1, 1636423716972, 1636423717594, 622, 266, 356, 0, 0, 0
202, 1, 1636423717195, 1636423717818, 623, 267, 356, 0, 0, 0
203, 1, 1636423717389, 1636423718022, 633, 272, 361, 0, 0, 0
204, 1, 1636423717597, 1636423718222, 625, 269, 356, 0, 0, 0
205, 1, 1636423717821, 1636423718454, 633, 271, 362, 0, 0, 0
206, 1, 1636423718024, 1636423718658, 634, 274, 360, 0, 0, 0
207, 1, 1636423718224, 1636423718846, 622, 266, 356, 0, 0, 0
208, 1, 1636423718456, 1636423719078, 622, 266, 356, 0, 0, 0
209, 1, 1636423718660, 1636423719290, 630, 275, 355, 0, 0, 0
210, 1, 1636423718849, 1636423719470, 621, 271, 350, 0, 0, 0
211, 1, 1636423719081, 1636423719706, 625, 272, 353, 0, 1, 1
212, 1, 1636423719292, 1636423719918, 626, 272, 354, 0, 1, 1
213, 1, 1636423719473, 1636423720102, 629, 270, 359, 0, 0, 0
214, 1, 1636423719708, 1636423720322, 614, 267, 347, 0, 0, 0
215, 1, 1636423719920, 1636423720550, 630, 274, 356, 0, 0, 0
216, 1, 1636423720104, 1636423720730, 626, 271, 355, 0, 0, 0
217, 1, 1636423720324, 1636423720946, 622, 266, 356, 0, 0, 0
218, 1, 1636423720552, 1636423721186, 634, 272, 362, 0, 0, 0
219, 1, 1636423720732, 1636423721358, 626, 271, 355, 0, 0, 0
220, 1, 1636423720949, 1636423721578, 629, 270, 359, 0, 0, 0
221, 1, 1636423721188, 1636423721814, 626, 270, 356, 0, 0, 0
222, 1, 1636423721361, 1636423721986, 625, 271, 354, 0, 0, 0
223, 1, 1636423721579, 1636423722210, 631, 275, 356, 0, 0, 0
224, 1, 1636423721816, 1636423722446, 630, 274, 356, 0, 1, 1
225, 1, 1636423721988, 1636423722618, 630, 273, 357, 0, 0, 0
226, 1, 1636423722213, 1636423722838, 625, 272, 353, 0, 0, 0
227, 1, 1636423722448, 1636423723078, 630, 275, 355, 0, 1, 1
228, 1, 1636423722620, 1636423723250, 630, 274, 356, 0, 0, 0
229, 1, 1636423722840, 1636423723466, 626, 271, 355, 0, 1, 1
230, 1, 1636423723080, 1636423723714, 634, 274, 360, 0, 0, 0
231, 1, 1636423723253, 1636423723882, 629, 274, 355, 0, 0, 0
232, 1, 1636423723468, 1636423724090, 622, 278, 344, 0, 0, 0
233, 1, 1636423723716, 1636423724346, 630, 273, 357, 0, 0, 0
234, 1, 1636423723884, 1636423724514, 630, 270, 360, 0, 0, 0
235, 1, 1636423724092, 1636423724722, 630, 278, 352, 0, 0, 0
236, 1, 1636423724348, 1636423724978, 630, 273, 357, 0, 0, 0
237, 1, 1636423724516, 1636423725142, 626, 271, 355, 0, 0, 0
238, 1, 1636423724725, 1636423725350, 625, 266, 359, 0, 0, 0
239, 1, 1636423724981, 1636423725610, 629, 275, 354, 0, 0, 0
240, 1, 1636423725144, 1636423725770, 626, 270, 356, 0, 0, 0
241, 1, 1636423725352, 1636423725978, 626, 271, 355, 0, 0, 0
242, 1, 1636423725612, 1636423726242, 630, 274, 356, 0, 0, 0
243, 1, 1636423725772, 1636423726406, 634, 277, 357, 0, 0, 0
244, 1, 1636423725980, 1636423726614, 634, 274, 360, 0, 0, 0
245, 1, 1636423726244, 1636423726874, 630, 274, 356, 0, 0, 0
246, 1, 1636423726409, 1636423727038, 629, 275, 354, 0, 1, 1
247, 1, 1636423726616, 1636423727246, 630, 274, 356, 0, 0, 0
248, 1, 1636423726876, 1636423727506, 630, 275, 355, 0, 1, 1
249, 1, 1636423727040, 1636423727670, 630, 274, 356, 0, 1, 1
250, 1, 1636423727248, 1636423727874, 626, 273, 353, 0, 1, 1
251, 1, 1636423727509, 1636423728138, 629, 275, 354, 0, 0, 0
252, 1, 1636423727672, 1636423728298, 626, 271, 355, 0, 0, 0
253, 1, 1636423727876, 1636423728502, 626, 271, 355, 0, 0, 0
254, 1, 1636423728140, 1636423728766, 626, 270, 356, 0, 1, 1
255, 1, 1636423728300, 1636423728926, 626, 271, 355, 0, 0, 0
256, 1, 1636423728505, 1636423729130, 625, 267, 358, 0, 0, 0
257, 1, 1636423728767, 1636423729398, 631, 276, 355, 0, 1, 1
258, 1, 1636423728928, 1636423729554, 626, 270, 356, 0, 0, 0
259, 1, 1636423729131, 1636423729754, 623, 266, 357, 0, 0, 0
260, 1, 1636423729401, 1636423730034, 633, 275, 358, 0, 0, 0
261, 1, 1636423729556, 1636423730182, 626, 269, 357, 0, 0, 0
262, 1, 1636423729756, 1636423730378, 622, 267, 355, 0, 0, 0
263, 1, 1636423730037, 1636423730666, 629, 275, 354, 0, 0, 0
264, 1, 1636423730184, 1636423730806, 622, 271, 351, 0, 1, 1
265, 1, 1636423730380, 1636423731002, 622, 267, 355, 0, 0, 0
266, 1, 1636423730668, 1636423731302, 634, 279, 355, 0, 0, 0
267, 1, 1636423730808, 1636423731434, 626, 270, 356, 0, 1, 1
268, 1, 1636423731005, 1636423731626, 621, 262, 359, 0, 1, 1
269, 1, 1636423731305, 1636423731934, 629, 274, 355, 0, 0, 0
270, 1, 1636423731436, 1636423732058, 622, 266, 356, 0, 1, 1
271, 1, 1636423731628, 1636423732254, 626, 271, 355, 0, 0, 0
272, 1, 1636423731936, 1636423732566, 630, 275, 355, 0, 1, 1
273, 1, 1636423732060, 1636423732694, 634, 283, 351, 0, 0, 0
274, 1, 1636423732255, 1636423732878, 623, 267, 356, 0, 0, 0
275, 1, 1636423732568, 1636423733190, 622, 269, 353, 0, 0, 0
276, 1, 1636423732695, 1636423733322, 627, 270, 357, 0, 1, 1
277, 1, 1636423732880, 1636423733498, 618, 267, 351, 0, 1, 1
278, 1, 1636423733192, 1636423733818, 626, 269, 357, 0, 1, 1
279, 1, 1636423733325, 1636423733954, 629, 274, 355, 0, 1, 1
280, 1, 1636423733501, 1636423734134, 633, 272, 361, 0, 0, 0
281, 1, 1636423733820, 1636423734450, 630, 275, 355, 0, 1, 1
282, 1, 1636423733956, 1636423734582, 626, 271, 355, 0, 1, 1
283, 1, 1636423734135, 1636423734758, 623, 271, 352, 0, 0, 0
284, 1, 1636423734452, 1636423735086, 634, 275, 359, 0, 1, 1
285, 1, 1636423734584, 1636423735214, 630, 273, 357, 0, 0, 0
286, 1, 1636423734760, 1636423735382, 622, 271, 351, 0, 0, 0
287, 1, 1636423735088, 1636423735710, 622, 267, 355, 0, 1, 1
288, 1, 1636423735216, 1636423735850, 634, 273, 361, 0, 0, 0
289, 1, 1636423735384, 1636423736006, 622, 267, 355, 0, 0, 0
290, 1, 1636423735712, 1636423736334, 622, 268, 354, 0, 1, 1
291, 1, 1636423735852, 1636423736478, 626, 271, 355, 0, 0, 0
292, 1, 1636423736008, 1636423736630, 622, 267, 355, 0, 0, 0
293, 1, 1636423736336, 1636423736966, 630, 273, 357, 0, 0, 0
294, 1, 1636423736480, 1636423737114, 634, 275, 359, 0, 1, 1
295, 1, 1636423736633, 1636423737258, 625, 267, 358, 0, 0, 0
296, 1, 1636423736968, 1636423737598, 630, 275, 355, 0, 1, 1
297, 1, 1636423737116, 1636423737742, 626, 271, 355, 0, 0, 0
298, 1, 1636423737260, 1636423737886, 626, 276, 350, 0, 0, 0
299, 1, 1636423737600, 1636423738230, 630, 275, 355, 0, 1, 1
300, 1, 1636423737745, 1636423738374, 629, 274, 355, 0, 1, 1
301, 1, 1636423737889, 1636423738518, 629, 270, 359, 0, 0, 0
302, 1, 1636423738233, 1636423738862, 629, 274, 355, 0, 0, 0
303, 1, 1636423738376, 1636423739002, 626, 271, 355, 0, 1, 1
304, 1, 1636423738520, 1636423739150, 630, 275, 355, 0, 0, 0
305, 1, 1636423738864, 1636423739490, 626, 272, 354, 0, 0, 0
306, 1, 1636423739004, 1636423739634, 630, 275, 355, 0, 0, 0
307, 1, 1636423739152, 1636423739766, 614, 267, 347, 0, 1, 1
308, 1, 1636423739492, 1636423740118, 626, 275, 351, 0, 0, 0
309, 1, 1636423739635, 1636423740258, 623, 267, 356, 0, 1, 1
310, 1, 1636423739768, 1636423740378, 610, 268, 342, 0, 0, 0
311, 1, 1636423740120, 1636423740750, 630, 268, 362, 0, 1, 1
312, 1, 1636423740260, 1636423740878, 618, 262, 356, 0, 0, 0
313, 1, 1636423740379, 1636423741002, 623, 267, 356, 0, 0, 0
314, 1, 1636423740752, 1636423741386, 634, 275, 359, 0, 1, 1
315, 1, 1636423740880, 1636423741510, 630, 275, 355, 0, 0, 0
316, 1, 1636423741003, 1636423741626, 623, 267, 356, 0, 0, 0
317, 1, 1636423741387, 1636423742022, 635, 274, 361, 0, 0, 0
318, 1, 1636423741512, 1636423742154, 642, 279, 363, 0, 1, 1
319, 1, 1636423741628, 1636423742242, 614, 262, 352, 0, 1, 1
320, 1, 1636423742024, 1636423742658, 634, 279, 355, 0, 1, 1
321, 1, 1636423742156, 1636423742786, 630, 274, 356, 0, 0, 0
322, 1, 1636423742244, 1636423742866, 622, 268, 354, 0, 1, 1
323, 1, 1636423742660, 1636423743286, 626, 270, 356, 0, 1, 1
324, 1, 1636423742789, 1636423743410, 621, 262, 359, 0, 0, 0
325, 1, 1636423742868, 1636423743490, 622, 264, 358, 0, 1, 1
326, 1, 1636423743288, 1636423743906, 618, 268, 350, 0, 0, 0
327, 1, 1636423743412, 1636423744034, 622, 272, 350, 0, 1, 1
328, 1, 1636423743492, 1636423744098, 606, 259, 347, 0, 0, 0
329, 1, 1636423743907, 1636423744534, 627, 270, 357, 0, 0, 0
330, 1, 1636423744035, 1636423744662, 627, 270, 357, 0, 0, 0
331, 1, 1636423744099, 1636423744722, 623, 267, 356, 0, 0, 0
332, 1, 1636423744535, 1636423745154, 619, 264, 355, 0, 1, 1
333, 1, 1636423744663, 1636423745290, 627, 262, 365, 0, 0, 0
334, 1, 1636423744723, 1636423745326, 603, 255, 348, 0, 0, 0
335, 1, 1636423745156, 1636423745782, 626, 270, 356, 0, 0, 0
336, 1, 1636423745292, 1636423745914, 622, 267, 355, 0, 1, 1
337, 1, 1636423745328, 1636423745938, 610, 264, 346, 0, 0, 0
338, 1, 1636423745784, 1636423746422, 638, 279, 359, 0, 1, 1
339, 1, 1636423745916, 1636423746546, 630, 271, 359, 0, 0, 0
340, 1, 1636423745940, 1636423746558, 618, 267, 351, 0, 0, 0
341, 1, 1636423746424, 1636423747062, 638, 275, 363, 0, 1, 1
342, 1, 1636423746548, 1636423747174, 626, 271, 355, 0, 0, 0
343, 1, 1636423746560, 1636423747194, 634, 275, 359, 0, 0, 0
344, 1, 1636423747064, 1636423747694, 630, 274, 356, 0, 1, 1
345, 1, 1636423747176, 1636423747798, 622, 271, 351, 0, 0, 0
346, 1, 1636423747195, 1636423747810, 615, 262, 353, 0, 0, 0
347, 1, 1636423747695, 1636423748330, 635, 273, 362, 0, 0, 0
348, 1, 1636423747799, 1636423748426, 627, 266, 361, 0, 0, 0
349, 1, 1636423747812, 1636423748434, 622, 272, 350, 0, 1, 1
350, 1, 1636423748332, 1636423748954, 622, 267, 355, 0, 0, 0
352, 1, 1636423748436, 1636423749058, 622, 271, 351, 0, 0, 0
351, 1, 1636423748428, 1636423749062, 634, 278, 356, 0, 0, 0
353, 1, 1636423748956, 1636423749586, 630, 274, 356, 0, 0, 0
354, 1, 1636423749060, 1636423749674, 614, 268, 346, 0, 1, 1
355, 1, 1636423749064, 1636423749690, 626, 270, 356, 0, 0, 0
356, 1, 1636423749588, 1636423750218, 630, 270, 360, 0, 0, 0
357, 1, 1636423749675, 1636423750290, 615, 266, 349, 0, 0, 0
358, 1, 1636423749692, 1636423750318, 626, 270, 356, 0, 0, 0
359, 1, 1636423750220, 1636423750854, 634, 273, 361, 0, 0, 0
360, 1, 1636423750292, 1636423750914, 622, 272, 350, 0, 0, 0
361, 1, 1636423750320, 1636423750946, 626, 272, 354, 0, 0, 0
362, 1, 1636423750856, 1636423751494, 638, 279, 359, 0, 1, 1
363, 1, 1636423750916, 1636423751538, 622, 268, 354, 0, 0, 0
364, 1, 1636423750948, 1636423751574, 626, 271, 355, 0, 1, 1
365, 1, 1636423751496, 1636423752130, 634, 274, 360, 0, 0, 0
366, 1, 1636423751540, 1636423752158, 618, 267, 351, 0, 0, 0
367, 1, 1636423751576, 1636423752202, 626, 270, 356, 0, 0, 0
368, 1, 1636423752132, 1636423752762, 630, 274, 356, 0, 0, 0
369, 1, 1636423752160, 1636423752782, 622, 270, 352, 0, 0, 0
370, 1, 1636423752204, 1636423752834, 630, 274, 356, 0, 0, 0
371, 1, 1636423752764, 1636423753386, 622, 266, 356, 0, 0, 0
372, 1, 1636423752784, 1636423753402, 618, 268, 350, 0, 1, 1
373, 1, 1636423752837, 1636423753466, 629, 274, 355, 0, 0, 0
374, 1, 1636423753388, 1636423754018, 630, 271, 359, 0, 0, 0
375, 1, 1636423753404, 1636423754026, 622, 267, 355, 0, 1, 1
376, 1, 1636423753468, 1636423754094, 626, 272, 354, 0, 0, 0
378, 1, 1636423754028, 1636423754650, 622, 265, 357, 0, 0, 0
377, 1, 1636423754020, 1636423754658, 638, 275, 363, 0, 0, 0
379, 1, 1636423754096, 1636423754718, 622, 267, 355, 0, 0, 0
380, 1, 1636423754653, 1636423755278, 625, 268, 357, 0, 0, 0
381, 1, 1636423754660, 1636423755290, 630, 274, 356, 0, 0, 0
382, 1, 1636423754720, 1636423755346, 626, 269, 357, 0, 0, 0
383, 1, 1636423755280, 1636423755890, 610, 261, 349, 0, 0, 0
384, 1, 1636423755292, 1636423755926, 634, 278, 356, 0, 0, 0
385, 1, 1636423755348, 1636423755974, 626, 270, 356, 0, 1, 1
386, 1, 1636423755891, 1636423756502, 611, 264, 347, 0, 1, 1
387, 1, 1636423755928, 1636423756550, 622, 267, 355, 0, 0, 0
388, 1, 1636423755976, 1636423756606, 630, 271, 359, 0, 0, 0
389, 1, 1636423756504, 1636423757122, 618, 264, 354, 0, 0, 0
390, 1, 1636423756552, 1636423757178, 626, 270, 356, 0, 0, 0
391, 1, 1636423756608, 1636423757234, 626, 270, 356, 0, 0, 0
392, 1, 1636423757124, 1636423757742, 618, 267, 351, 0, 0, 0
393, 1, 1636423757180, 1636423757810, 630, 274, 356, 0, 0, 0
394, 1, 1636423757235, 1636423757858, 623, 270, 353, 0, 0, 0
395, 1, 1636423757744, 1636423758354, 610, 262, 348, 0, 0, 0
396, 1, 1636423757812, 1636423758438, 626, 269, 357, 0, 0, 0
397, 1, 1636423757859, 1636423758490, 631, 274, 357, 0, 0, 0
398, 1, 1636423758356, 1636423758970, 614, 263, 351, 0, 0, 0
399, 1, 1636423758440, 1636423759070, 630, 274, 356, 0, 0, 0
400, 1, 1636423758493, 1636423759110, 617, 263, 354, 0, 0, 0
401, 1, 1636423758972, 1636423759586, 614, 258, 356, 0, 0, 0
402, 1, 1636423759072, 1636423759698, 626, 273, 353, 0, 0, 0
403, 1, 1636423759112, 1636423759738, 626, 270, 356, 0, 0, 0
404, 1, 1636423759588, 1636423760210, 622, 271, 351, 0, 0, 0
405, 1, 1636423759700, 1636423760326, 626, 271, 355, 0, 0, 0
406, 1, 1636423759740, 1636423760370, 630, 275, 355, 0, 0, 0
407, 1, 1636423760212, 1636423760842, 630, 271, 359, 0, 0, 0
408, 1, 1636423760328, 1636423760954, 626, 270, 356, 0, 0, 0
409, 1, 1636423760373, 1636423761006, 633, 273, 360, 0, 0, 0
410, 1, 1636423760844, 1636423761470, 626, 274, 352, 0, 0, 0
411, 1, 1636423760956, 1636423761586, 630, 274, 356, 0, 0, 0
412, 1, 1636423761008, 1636423761634, 626, 270, 356, 0, 0, 0
413, 1, 1636423761472, 1636423762098, 626, 263, 363, 0, 0, 0
414, 1, 1636423761588, 1636423762214, 626, 271, 355, 0, 0, 0
415, 1, 1636423761636, 1636423762262, 626, 269, 357, 0, 0, 0
416, 1, 1636423762100, 1636423762734, 634, 278, 356, 0, 1, 1
417, 1, 1636423762216, 1636423762842, 626, 271, 355, 0, 0, 0
418, 1, 1636423762263, 1636423762894, 631, 269, 362, 0, 0, 0
419, 1, 1636423762736, 1636423763366, 630, 269, 361, 0, 0, 0
420, 1, 1636423762844, 1636423763474, 630, 275, 355, 0, 1, 1
421, 1, 1636423762896, 1636423763526, 630, 274, 356, 0, 0, 0
422, 1, 1636423763369, 1636423763990, 621, 262, 359, 0, 0, 0
423, 1, 1636423763476, 1636423764102, 626, 271, 355, 0, 0, 0
424, 1, 1636423763528, 1636423764158, 630, 275, 355, 0, 1, 1
425, 1, 1636423763992, 1636423764614, 622, 274, 348, 0, 0, 0
426, 1, 1636423764104, 1636423764734, 630, 273, 357, 0, 0, 0
427, 1, 1636423764160, 1636423764790, 630, 274, 356, 0, 0, 0
428, 1, 1636423764616, 1636423765226, 610, 264, 346, 0, 1, 1
429, 1, 1636423764736, 1636423765370, 634, 274, 360, 0, 0, 0
430, 1, 1636423764792, 1636423765422, 630, 274, 356, 0, 0, 0
431, 1, 1636423765228, 1636423765850, 622, 266, 356, 0, 0, 0
432, 1, 1636423765372, 1636423765998, 626, 271, 355, 0, 1, 1
433, 1, 1636423765424, 1636423766054, 630, 273, 357, 0, 0, 0
434, 1, 1636423765852, 1636423766470, 618, 268, 350, 0, 0, 0
435, 1, 1636423766000, 1636423766630, 630, 274, 356, 0, 0, 0
436, 1, 1636423766056, 1636423766682, 626, 270, 356, 0, 0, 0
437, 1, 1636423766472, 1636423767102, 630, 274, 356, 0, 0, 0
438, 1, 1636423766633, 1636423767266, 633, 280, 353, 0, 0, 0
439, 1, 1636423766684, 1636423767314, 630, 275, 355, 0, 1, 1
440, 1, 1636423767104, 1636423767726, 622, 268, 354, 0, 0, 0
441, 1, 1636423767268, 1636423767894, 626, 271, 355, 0, 0, 0
442, 1, 1636423767316, 1636423767942, 626, 271, 355, 0, 1, 1
443, 1, 1636423767728, 1636423768342, 614, 263, 351, 0, 0, 0
444, 1, 1636423767897, 1636423768526, 629, 274, 355, 0, 0, 0
445, 1, 1636423767945, 1636423768574, 629, 275, 354, 0, 0, 0
446, 1, 1636423768344, 1636423768970, 626, 273, 353, 0, 1, 1
447, 1, 1636423768528, 1636423769158, 630, 275, 355, 0, 0, 0
448, 1, 1636423768576, 1636423769202, 626, 271, 355, 0, 0, 0
449, 1, 1636423768972, 1636423769594, 622, 266, 356, 0, 0, 0
450, 1, 1636423769160, 1636423769790, 630, 270, 360, 0, 0, 0
451, 1, 1636423769203, 1636423769834, 631, 274, 357, 0, 1, 1
452, 1, 1636423769596, 1636423770230, 634, 275, 359, 0, 0, 0
453, 1, 1636423769791, 1636423770422, 631, 274, 357, 0, 0, 0
454, 1, 1636423769836, 1636423770466, 630, 274, 356, 0, 0, 0
455, 1, 1636423770232, 1636423770862, 630, 275, 355, 0, 0, 0
456, 1, 1636423770424, 1636423771054, 630, 274, 356, 0, 0, 0
457, 1, 1636423770468, 1636423771090, 622, 266, 356, 0, 0, 0
458, 1, 1636423770865, 1636423771490, 625, 270, 355, 0, 0, 0
459, 1, 1636423771056, 1636423771674, 618, 263, 355, 0, 0, 0
460, 1, 1636423771092, 1636423771722, 630, 273, 357, 0, 0, 0
461, 1, 1636423771493, 1636423772126, 633, 274, 359, 0, 0, 0
462, 1, 1636423771676, 1636423772306, 630, 274, 356, 0, 0, 0
463, 1, 1636423771725, 1636423772358, 633, 278, 355, 0, 0, 0
464, 1, 1636423772128, 1636423772754, 626, 270, 356, 0, 0, 0
465, 1, 1636423772308, 1636423772938, 630, 274, 356, 0, 0, 0
466, 1, 1636423772361, 1636423772978, 617, 266, 351, 0, 1, 1
467, 1, 1636423772757, 1636423773394, 637, 277, 360, 0, 0, 0
468, 1, 1636423772940, 1636423773570, 630, 274, 356, 0, 0, 0
469, 1, 1636423772979, 1636423773606, 627, 270, 357, 0, 0, 0
470, 1, 1636423773396, 1636423774022, 626, 266, 360, 0, 0, 0
471, 1, 1636423773572, 1636423774206, 634, 276, 358, 0, 0, 0
472, 1, 1636423773608, 1636423774238, 630, 270, 360, 0, 0, 0
473, 1, 1636423774024, 1636423774654, 630, 270, 360, 0, 0, 0
474, 1, 1636423774208, 1636423774838, 630, 274, 356, 0, 0, 0
475, 1, 1636423774241, 1636423774870, 629, 274, 355, 0, 1, 1
476, 1, 1636423774656, 1636423775282, 626, 269, 357, 0, 0, 0
477, 1, 1636423774840, 1636423775470, 630, 274, 356, 0, 0, 0
478, 1, 1636423774872, 1636423775502, 630, 274, 356, 0, 0, 0
479, 1, 1636423775284, 1636423775894, 610, 262, 348, 0, 1, 1
480, 1, 1636423775473, 1636423776102, 629, 274, 355, 0, 0, 0
481, 1, 1636423775504, 1636423776130, 626, 269, 357, 0, 0, 0
482, 1, 1636423775896, 1636423776526, 630, 274, 356, 0, 0, 0
483, 1, 1636423776104, 1636423776734, 630, 274, 356, 0, 0, 0
484, 1, 1636423776132, 1636423776766, 634, 274, 360, 0, 0, 0
485, 1, 1636423776528, 1636423777150, 622, 269, 353, 0, 0, 0
486, 1, 1636423776736, 1636423777366, 630, 275, 355, 0, 0, 0
487, 1, 1636423776768, 1636423777398, 630, 275, 355, 0, 0, 0
488, 1, 1636423777152, 1636423777770, 618, 264, 354, 0, 0, 0
489, 1, 1636423777368, 1636423777998, 630, 275, 355, 0, 1, 1
490, 1, 1636423777400, 1636423778026, 626, 270, 356, 0, 1, 1
491, 1, 1636423777772, 1636423778398, 626, 272, 354, 0, 0, 0
492, 1, 1636423778000, 1636423778630, 630, 275, 355, 0, 1, 1
493, 1, 1636423778029, 1636423778654, 625, 271, 354, 0, 0, 0
494, 1, 1636423778400, 1636423779026, 626, 271, 355, 0, 0, 0
495, 1, 1636423778631, 1636423779250, 619, 262, 357, 0, 1, 1
496, 1, 1636423778656, 1636423779282, 626, 271, 355, 0, 0, 0
497, 1, 1636423779028, 1636423779646, 618, 266, 352, 0, 1, 1
498, 1, 1636423779252, 1636423779882, 630, 273, 357, 0, 0, 0
499, 1, 1636423779284, 1636423779910, 626, 270, 356, 0, 0, 0
500, 1, 1636423779649, 1636423780274, 625, 267, 358, 0, 1, 1
501, 1, 1636423779884, 1636423780514, 630, 274, 356, 0, 0, 0
502, 1, 1636423779912, 1636423780538, 626, 270, 356, 0, 0, 0
503, 1, 1636423780277, 1636423780902, 625, 267, 358, 0, 0, 0
504, 1, 1636423780516, 1636423781146, 630, 274, 356, 0, 0, 0
505, 1, 1636423780540, 1636423781170, 630, 274, 356, 0, 1, 1
506, 1, 1636423780903, 1636423781522, 619, 265, 354, 0, 0, 0
507, 1, 1636423781148, 1636423781778, 630, 274, 356, 0, 0, 0
508, 1, 1636423781172, 1636423781798, 626, 271, 355, 0, 0, 0
509, 1, 1636423781524, 1636423782150, 626, 271, 355, 0, 0, 0
510, 1, 1636423781780, 1636423782410, 630, 275, 355, 0, 0, 0
511, 1, 1636423781800, 1636423782430, 630, 275, 355, 0, 0, 0
512, 1, 1636423782152, 1636423782782, 630, 274, 356, 0, 1, 1
513, 1, 1636423782412, 1636423783046, 634, 275, 359, 0, 0, 0
514, 1, 1636423782432, 1636423783058, 626, 271, 355, 0, 0, 0
515, 1, 1636423782784, 1636423783414, 630, 275, 355, 0, 0, 0
516, 1, 1636423783048, 1636423783678, 630, 275, 355, 0, 0, 0
517, 1, 1636423783060, 1636423783698, 638, 273, 365, 0, 0, 0
518, 1, 1636423783416, 1636423784050, 634, 275, 359, 0, 1, 1
519, 1, 1636423783680, 1636423784310, 630, 275, 355, 0, 0, 0
520, 1, 1636423783700, 1636423784334, 634, 273, 361, 0, 0, 0
521, 1, 1636423784052, 1636423784674, 622, 272, 350, 0, 1, 1
522, 1, 1636423784312, 1636423784942, 630, 274, 356, 0, 0, 0
523, 1, 1636423784336, 1636423784966, 630, 275, 355, 0, 0, 0
524, 1, 1636423784676, 1636423785306, 630, 271, 359, 0, 1, 1
525, 1, 1636423784944, 1636423785574, 630, 273, 357, 0, 0, 0
526, 1, 1636423784968, 1636423785598, 630, 274, 356, 0, 0, 0
527, 1, 1636423785576, 1636423786206, 630, 274, 356, 0, 0, 0
528, 1, 1636423785600, 1636423786226, 626, 270, 356, 0, 0, 0
529, 1, 1636423786208, 1636423786842, 634, 274, 360, 0, 1, 1
530, 1, 1636423786229, 1636423786866, 637, 270, 367, 0, 0, 0
531, 1, 1636423786844, 1636423787470, 626, 271, 355, 0, 0, 0
532, 1, 1636423786868, 1636423787494, 626, 270, 356, 0, 0, 0
533, 1, 1636423787473, 1636423788098, 625, 270, 355, 0, 0, 0
534, 1, 1636423787496, 1636423788122, 626, 267, 359, 0, 0, 0
535, 1, 1636423788100, 1636423788730, 630, 274, 356, 0, 0, 0
536, 1, 1636423788125, 1636423788754, 629, 275, 354, 0, 0, 0
537, 1, 1636423788732, 1636423789362, 630, 275, 355, 0, 1, 1
538, 1, 1636423788756, 1636423789386, 630, 275, 355, 0, 0, 0
539, 1, 1636423789364, 1636423789990, 626, 271, 355, 0, 0, 0
540, 1, 1636423789388, 1636423790018, 630, 272, 358, 0, 0, 0
541, 1, 1636423789992, 1636423790626, 634, 279, 355, 0, 0, 0
542, 1, 1636423790020, 1636423790650, 630, 269, 361, 0, 0, 0
543, 1, 1636423790628, 1636423791258, 630, 275, 355, 0, 0, 0
544, 1, 1636423790653, 1636423791286, 633, 277, 356, 0, 0, 0
545, 1, 1636423791260, 1636423791886, 626, 271, 355, 0, 0, 0
546, 1, 1636423791289, 1636423791918, 629, 274, 355, 0, 0, 0
547, 1, 1636423791888, 1636423792518, 630, 274, 356, 0, 0, 0
548, 1, 1636423791921, 1636423792550, 629, 272, 357, 0, 0, 0
549, 1, 1636423792520, 1636423793150, 630, 275, 355, 0, 1, 1
550, 1, 1636423792552, 1636423793178, 626, 269, 357, 0, 0, 0
551, 1, 1636423793153, 1636423793770, 617, 270, 347, 0, 0, 0
552, 1, 1636423793180, 1636423793810, 630, 273, 357, 0, 0, 0
553, 1, 1636423793771, 1636423794402, 631, 273, 358, 0, 0, 0
554, 1, 1636423793812, 1636423794442, 630, 271, 359, 0, 1, 1
555, 1, 1636423794404, 1636423795034, 630, 275, 355, 0, 1, 1
556, 1, 1636423794445, 1636423795070, 625, 270, 355, 0, 0, 0
557, 1, 1636423795036, 1636423795666, 630, 274, 356, 0, 0, 0
558, 1, 1636423795071, 1636423795702, 631, 275, 356, 0, 1, 1
559, 1, 1636423795668, 1636423796294, 626, 270, 356, 0, 0, 0
560, 1, 1636423795704, 1636423796330, 626, 270, 356, 0, 0, 0
561, 1, 1636423796297, 1636423796930, 633, 274, 359, 0, 0, 0
562, 1, 1636423796333, 1636423796962, 629, 273, 356, 0, 0, 0
563, 1, 1636423796932, 1636423797566, 634, 275, 359, 0, 0, 0
564, 1, 1636423796964, 1636423797590, 626, 270, 356, 0, 1, 1
565, 1, 1636423797568, 1636423798198, 630, 275, 355, 0, 1, 1
566, 1, 1636423797593, 1636423798218, 625, 269, 356, 0, 0, 0
567, 1, 1636423798200, 1636423798830, 630, 273, 357, 0, 0, 0
568, 1, 1636423798220, 1636423798854, 634, 274, 360, 0, 0, 0
569, 1, 1636423798833, 1636423799466, 633, 277, 356, 0, 0, 0
570, 1, 1636423798857, 1636423799482, 625, 271, 354, 0, 1, 1
571, 1, 1636423799467, 1636423800094, 627, 275, 352, 0, 0, 0
572, 1, 1636423799484, 1636423800110, 626, 273, 353, 0, 0, 0
573, 1, 1636423800096, 1636423800726, 630, 274, 356, 0, 0, 0
574, 1, 1636423800729, 1636423801354, 625, 272, 353, 0, 0, 0
575, 1, 1636423801355, 1636423801986, 631, 275, 356, 0, 0, 0
576, 1, 1636423801988, 1636423802618, 630, 274, 356, 0, 0, 0
577, 1, 1636423802620, 1636423803250, 630, 274, 356, 0, 1, 1
578, 1, 1636423803252, 1636423803878, 626, 270, 356, 0, 0, 0
579, 1, 1636423803880, 1636423804510, 630, 274, 356, 0, 0, 0
580, 1, 1636423804512, 1636423805142, 630, 275, 355, 0, 1, 1
581, 1, 1636423805144, 1636423805778, 634, 274, 360, 0, 0, 0
582, 1, 1636423805780, 1636423806414, 634, 275, 359, 0, 1, 1
583, 1, 1636423806415, 1636423807046, 631, 273, 358, 0, 1, 1
584, 1, 1636423807048, 1636423807678, 630, 273, 357, 0, 0, 0
585, 1, 1636423807680, 1636423808310, 630, 274, 356, 0, 1, 1
586, 1, 1636423808313, 1636423808946, 633, 275, 358, 0, 0, 0
587, 1, 1636423808948, 1636423809574, 626, 271, 355, 0, 0, 0
588, 1, 1636423809577, 1636423810206, 629, 273, 356, 0, 0, 0
589, 1, 1636423810208, 1636423810838, 630, 274, 356, 0, 1, 1
590, 1, 1636423810840, 1636423811470, 630, 274, 356, 0, 1, 1
591, 1, 1636423811473, 1636423812102, 629, 275, 354, 0, 0, 0
592, 1, 1636423812104, 1636423812738, 634, 274, 360, 0, 1, 1
593, 1, 1636423812741, 1636423813370, 629, 274, 355, 0, 0, 0
594, 1, 1636423813373, 1636423813998, 625, 269, 356, 0, 0, 0
595, 1, 1636423814000, 1636423814634, 634, 275, 359, 0, 0, 0
596, 1, 1636423814636, 1636423815262, 626, 274, 352, 0, 1, 1
597, 1, 1636423815265, 1636423815894, 629, 274, 355, 0, 0, 0
598, 1, 1636423815896, 1636423816526, 630, 274, 356, 0, 0, 0
599, 1, 1636423816529, 1636423817158, 629, 273, 356, 0, 0, 0
600, 1, 1636423817159, 1636423817790, 631, 272, 359, 0, 0, 0
601, 1, 1636423994480, 1636423995358, 878, 348, 530, 6, 4, 10
602, 1, 1636423995046, 1636423995946, 900, 364, 536, 0, 1, 1
603, 1, 1636423995627, 1636423996530, 903, 371, 532, 1, 0, 1
604, 1, 1636423995807, 1636423996610, 803, 277, 526, 1, 1, 2
605, 1, 1636423996242, 1636423997114, 872, 332, 540, 0, 0, 0
606, 1, 1636423996367, 1636423997198, 831, 298, 533, 2, 1, 3
607, 1, 1636423996806, 1636423997694, 888, 357, 531, 1, 0, 1
608, 1, 1636423996945, 1636423997782, 837, 304, 533, 0, 1, 1
609, 1, 1636423997099, 1636423997906, 807, 273, 534, 2, 0, 2
610, 1, 1636423997374, 1636423998286, 912, 370, 542, 0, 1, 1
611, 1, 1636423997513, 1636423998366, 853, 314, 539, 3, 1, 4
612, 1, 1636423997695, 1636423998502, 807, 272, 535, 1, 0, 1
613, 1, 1636423997954, 1636423998870, 916, 376, 540, 1, 2, 3
614, 1, 1636423998084, 1636423998942, 858, 333, 525, 1, 0, 1
615, 1, 1636423998274, 1636423999090, 816, 279, 537, 2, 0, 2
616, 1, 1636423998466, 1636423999270, 804, 277, 527, 2, 0, 2
617, 1, 1636423998502, 1636423999330, 828, 423, 405, 2, 4, 6
618, 1, 1636423998632, 1636423999398, 766, 404, 362, 1, 2, 3
619, 1, 1636423998843, 1636423999542, 699, 343, 356, 1, 0, 1
620, 1, 1636423999063, 1636423999730, 667, 303, 364, 4, 0, 4
621, 1, 1636423999126, 1636423999810, 684, 270, 414, 1, 0, 1
622, 1, 1636423999208, 1636423999850, 642, 283, 359, 2, 1, 3
623, 1, 1636423999414, 1636424000046, 632, 270, 362, 0, 0, 0
624, 1, 1636423999654, 1636424000286, 632, 270, 362, 1, 0, 1
625, 1, 1636423999786, 1636424000422, 636, 274, 362, 0, 1, 1
627, 1, 1636423999819, 1636424000446, 627, 271, 356, 1, 1, 2
626, 1, 1636423999786, 1636424000466, 680, 278, 402, 1, 0, 1
628, 1, 1636423999932, 1636424000554, 622, 270, 352, 1, 0, 1
629, 1, 1636424000198, 1636424000838, 640, 273, 367, 1, 0, 1
630, 1, 1636424000409, 1636424001046, 637, 272, 365, 0, 1, 1
631, 1, 1636424000446, 1636424001074, 628, 269, 359, 1, 0, 1
632, 1, 1636424000492, 1636424001118, 626, 272, 354, 2, 1, 3
633, 1, 1636424000807, 1636424001438, 631, 277, 354, 1, 0, 1
634, 1, 1636424001049, 1636424001682, 633, 270, 363, 2, 0, 2
635, 1, 1636424001066, 1636424001698, 632, 273, 359, 1, 0, 1
636, 1, 1636424001092, 1636424001722, 630, 270, 360, 0, 0, 0
638, 1, 1636424001307, 1636424001938, 631, 270, 361, 2, 0, 2
637, 1, 1636424001151, 1636424002134, 983, 627, 356, 0, 1, 1
639, 1, 1636424001482, 1636424002150, 668, 271, 397, 0, 1, 1
641, 1, 1636424001716, 1636424002350, 634, 275, 359, 0, 0, 0
643, 1, 1636424001867, 1636424002502, 635, 275, 360, 1, 0, 1
644, 1, 1636424002034, 1636424002714, 680, 273, 407, 0, 1, 1
647, 1, 1636424002372, 1636424003010, 638, 277, 361, 0, 1, 1
648, 1, 1636424002467, 1636424003098, 631, 271, 360, 1, 1, 2
649, 1, 1636424002513, 1636424003166, 653, 295, 358, 2, 0, 2
651, 1, 1636424002704, 1636424003330, 626, 270, 356, 1, 1, 2
652, 1, 1636424002754, 1636424003618, 864, 467, 397, 0, 1, 1
653, 1, 1636424003109, 1636424003738, 629, 271, 358, 1, 2, 3
655, 1, 1636424003314, 1636424003942, 628, 269, 359, 0, 1, 1
656, 1, 1636424003414, 1636424004098, 684, 272, 412, 0, 0, 0
657, 1, 1636424003765, 1636424004402, 637, 273, 364, 0, 0, 0
659, 1, 1636424003904, 1636424004538, 634, 274, 360, 0, 0, 0
660, 1, 1636424004009, 1636424004634, 625, 272, 353, 3, 1, 4
662, 1, 1636424004033, 1636424004670, 637, 273, 364, 0, 0, 0
661, 1, 1636424004010, 1636424004690, 680, 275, 405, 1, 1, 2
664, 1, 1636424004566, 1636424005246, 680, 274, 406, 0, 0, 0
665, 1, 1636424004642, 1636424005270, 628, 270, 358, 0, 1, 1
666, 1, 1636424004696, 1636424005322, 626, 271, 355, 0, 1, 1
668, 1, 1636424005166, 1636424005858, 692, 281, 411, 1, 0, 1
669, 1, 1636424005289, 1636424005926, 637, 265, 372, 0, 1, 1
670, 1, 1636424005305, 1636424005942, 637, 277, 360, 0, 0, 0
671, 1, 1636424005338, 1636424005966, 628, 271, 357, 0, 0, 0
672, 1, 1636424005426, 1636424006050, 624, 271, 353, 0, 2, 2
673, 1, 1636424005774, 1636424006450, 676, 270, 406, 0, 1, 1
674, 1, 1636424005845, 1636424006478, 633, 271, 362, 3, 0, 3
676, 1, 1636424006024, 1636424006658, 634, 274, 360, 0, 0, 0
675, 1, 1636424006016, 1636424006658, 642, 276, 366, 0, 3, 3
677, 1, 1636424006322, 1636424006990, 668, 270, 398, 1, 1, 2
678, 1, 1636424006449, 1636424007086, 637, 271, 366, 0, 1, 1
679, 1, 1636424006595, 1636424007222, 627, 271, 356, 1, 0, 1
680, 1, 1636424006692, 1636424007318, 626, 269, 357, 0, 0, 0
681, 1, 1636424006713, 1636424007346, 633, 270, 363, 1, 1, 2
683, 1, 1636424006898, 1636424007574, 676, 270, 406, 0, 0, 0
684, 1, 1636424007053, 1636424007682, 629, 266, 363, 1, 0, 1
685, 1, 1636424007151, 1636424007782, 631, 270, 361, 0, 0, 0
687, 1, 1636424007417, 1636424008046, 629, 270, 359, 0, 1, 1
688, 1, 1636424007547, 1636424008178, 631, 273, 358, 2, 0, 2
689, 1, 1636424007755, 1636424008386, 631, 269, 362, 0, 0, 0
690, 1, 1636424007964, 1636424008590, 626, 265, 361, 0, 0, 0
691, 1, 1636424007971, 1636424008610, 639, 271, 368, 0, 3, 3
693, 1, 1636424008177, 1636424008818, 641, 274, 367, 0, 0, 0
694, 1, 1636424008382, 1636424009010, 628, 271, 357, 1, 1, 2
695, 1, 1636424008526, 1636424009162, 636, 271, 365, 1, 0, 1
697, 1, 1636424008875, 1636424009502, 627, 267, 360, 1, 0, 1
698, 1, 1636424009130, 1636424009762, 632, 272, 360, 0, 2, 2
699, 1, 1636424009264, 1636424009898, 634, 274, 360, 2, 1, 3
701, 1, 1636424009460, 1636424010102, 642, 276, 366, 1, 2, 3
702, 1, 1636424009757, 1636424010394, 637, 274, 363, 0, 0, 0
704, 1, 1636424010250, 1636424010886, 636, 274, 362, 1, 2, 3
706, 1, 1636424010547, 1636424011182, 635, 274, 361, 1, 2, 3
707, 1, 1636424010854, 1636424011494, 640, 275, 365, 1, 0, 1
640, 2, 1636424001593, 1636424011741, 10148, 0, 10148, 0, 1, 1
642, 2, 1636424001776, 1636424011913, 10137, 0, 10137, 1, 0, 1
645, 2, 1636424002201, 1636424012342, 10141, 1, 10140, 1, 0, 1
646, 2, 1636424002318, 1636424012453, 10135, 0, 10135, 0, 0, 0
710, 1, 1636424011946, 1636424012606, 660, 308, 352, 0, 41, 41
650, 2, 1636424002648, 1636424012781, 10133, 1, 10132, 0, 2, 2
713, 1, 1636424012343, 1636424013050, 707, 284, 423, 2, 20, 22
712, 1, 1636424012342, 1636424013050, 708, 284, 424, 0, 21, 21
654, 2, 1636424003262, 1636424013397, 10135, 0, 10135, 0, 1, 1
715, 1, 1636424012638, 1636424013502, 864, 449, 415, 0, 0, 0
714, 1, 1636424012550, 1636424013502, 952, 552, 400, 0, 0, 0
717, 1, 1636424013220, 1636424013842, 622, 270, 352, 0, 0, 0
658, 2, 1636424003809, 1636424013945, 10136, 1, 10135, 0, 1, 1
716, 1, 1636424012970, 1636424013962, 992, 585, 407, 0, 0, 0
718, 1, 1636424013569, 1636424014214, 645, 286, 359, 1, 16, 17
719, 1, 1636424013573, 1636424014214, 641, 283, 358, 1, 12, 13
720, 1, 1636424013582, 1636424014414, 832, 426, 406, 0, 1, 1
663, 2, 1636424004451, 1636424014589, 10138, 0, 10138, 1, 0, 1
721, 1, 1636424013838, 1636424014674, 836, 453, 383, 1, 0, 1
722, 1, 1636424013946, 1636424014678, 732, 365, 367, 1, 0, 1
723, 1, 1636424014142, 1636424014862, 720, 325, 395, 0, 0, 0
724, 1, 1636424014256, 1636424015122, 866, 510, 356, 0, 1, 1
725, 1, 1636424014618, 1636424015258, 640, 279, 361, 1, 2, 3
667, 2, 1636424005161, 1636424015301, 10140, 1, 10139, 1, 0, 1
726, 1, 1636424014766, 1636424015442, 676, 279, 397, 3, 0, 3
728, 1, 1636424014856, 1636424015486, 630, 268, 362, 0, 0, 0
729, 1, 1636424014864, 1636424015498, 634, 274, 360, 0, 0, 0
727, 1, 1636424014829, 1636424015574, 745, 386, 359, 2, 0, 2
730, 1, 1636424015139, 1636424015942, 803, 438, 365, 0, 0, 0
731, 1, 1636424015215, 1636424015958, 743, 380, 363, 0, 2, 2
732, 1, 1636424015375, 1636424016030, 655, 295, 360, 0, 2, 2
733, 1, 1636424015490, 1636424016158, 668, 271, 397, 2, 1, 3
734, 1, 1636424015583, 1636424016402, 819, 454, 365, 0, 1, 1
735, 1, 1636424015927, 1636424016558, 631, 270, 361, 0, 1, 1
736, 1, 1636424016051, 1636424016674, 623, 270, 353, 0, 0, 0
737, 1, 1636424016136, 1636424016762, 626, 271, 355, 1, 0, 1
739, 1, 1636424016170, 1636424016802, 632, 271, 361, 1, 1, 2
738, 1, 1636424016142, 1636424016854, 712, 347, 365, 0, 3, 3
682, 2, 1636424006766, 1636424016902, 10136, 1, 10135, 1, 0, 1
740, 1, 1636424016442, 1636424017266, 824, 458, 366, 1, 9, 10
741, 1, 1636424016519, 1636424017266, 747, 339, 408, 1, 1, 2
742, 1, 1636424016668, 1636424017354, 686, 274, 412, 1, 1, 2
743, 1, 1636424016766, 1636424017442, 676, 316, 360, 0, 0, 0
686, 2, 1636424007365, 1636424017501, 10136, 1, 10135, 1, 0, 1
744, 1, 1636424016902, 1636424017718, 816, 458, 358, 1, 0, 1
745, 1, 1636424017082, 1636424017774, 692, 286, 406, 0, 14, 14
746, 1, 1636424017226, 1636424017858, 632, 278, 354, 0, 12, 12
747, 1, 1636424017353, 1636424017982, 629, 269, 360, 0, 0, 0
749, 1, 1636424017443, 1636424018090, 647, 272, 375, 0, 0, 0
748, 1, 1636424017427, 1636424018094, 667, 271, 396, 1, 0, 1
750, 1, 1636424017454, 1636424018166, 712, 352, 360, 0, 2, 2
692, 2, 1636424008107, 1636424018241, 10134, 0, 10134, 0, 0, 0
751, 1, 1636424017690, 1636424018374, 684, 278, 406, 1, 0, 1
752, 1, 1636424017736, 1636424018546, 810, 446, 364, 1, 0, 1
753, 1, 1636424017835, 1636424018550, 715, 358, 357, 0, 0, 0
754, 1, 1636424017957, 1636424018610, 653, 295, 358, 1, 0, 1
755, 1, 1636424018067, 1636424018690, 623, 270, 353, 0, 4, 4
696, 2, 1636424008758, 1636424018893, 10135, 0, 10135, 0, 0, 0
756, 1, 1636424018189, 1636424019002, 813, 442, 371, 1, 1, 2
757, 1, 1636424018353, 1636424019006, 653, 289, 364, 0, 0, 0
758, 1, 1636424018418, 1636424019086, 668, 273, 395, 0, 1, 1
759, 1, 1636424018577, 1636424019254, 677, 271, 406, 1, 1, 2
760, 1, 1636424018666, 1636424019294, 628, 269, 359, 0, 1, 1
763, 1, 1636424018804, 1636424019430, 626, 267, 359, 0, 1, 1
762, 1, 1636424018740, 1636424019462, 722, 358, 364, 1, 0, 1
761, 1, 1636424018728, 1636424019462, 734, 378, 356, 0, 1, 1
700, 2, 1636424009366, 1636424019501, 10135, 1, 10134, 1, 1, 2
766, 1, 1636424019078, 1636424019766, 688, 295, 393, 0, 24, 24
767, 1, 1636424019213, 1636424019882, 669, 314, 355, 0, 0, 0
765, 1, 1636424019018, 1636424019950, 932, 569, 363, 0, 41, 41
768, 1, 1636424019228, 1636424019954, 726, 370, 356, 1, 41, 42
769, 1, 1636424019381, 1636424020034, 653, 266, 387, 0, 0, 0
703, 2, 1636424009921, 1636424020058, 10137, 1, 10136, 0, 1, 1
771, 1, 1636424019646, 1636424020270, 624, 266, 358, 1, 1, 2
772, 1, 1636424019682, 1636424020350, 668, 270, 398, 1, 0, 1
774, 1, 1636424019918, 1636424020554, 636, 271, 365, 0, 1, 1
705, 2, 1636424010472, 1636424020605, 10133, 1, 10132, 0, 1, 1
775, 1, 1636424019990, 1636424020646, 656, 270, 386, 0, 1, 1
777, 1, 1636424020063, 1636424020690, 627, 273, 354, 1, 0, 1
778, 1, 1636424020158, 1636424020778, 620, 271, 349, 3, 0, 3
779, 1, 1636424020246, 1636424020974, 728, 318, 410, 1, 41, 42
781, 1, 1636424020374, 1636424021150, 776, 407, 369, 1, 0, 1
783, 1, 1636424020608, 1636424021234, 626, 274, 352, 1, 1, 2
708, 2, 1636424011152, 1636424021285, 10133, 0, 10133, 0, 0, 0
784, 1, 1636424020669, 1636424021294, 625, 265, 360, 1, 1, 2
785, 1, 1636424020778, 1636424021454, 676, 270, 406, 1, 1, 2
787, 1, 1636424020960, 1636424021586, 626, 270, 356, 1, 0, 1
709, 2, 1636424011645, 1636424021789, 10144, 1, 10143, 1, 0, 1
788, 1, 1636424021225, 1636424021866, 641, 269, 372, 0, 0, 0
790, 1, 1636424021416, 1636424022050, 634, 286, 348, 2, 16, 18
791, 1, 1636424021470, 1636424022138, 668, 271, 397, 0, 8, 8
793, 1, 1636424021504, 1636424022146, 642, 285, 357, 0, 19, 19
711, 1, 1636424012249, 1636424022282, 10033, 9716, 317, 49, 0, 49
794, 1, 1636424021789, 1636424022502, 713, 399, 314, 0, 1, 1
797, 1, 1636424021973, 1636424022594, 621, 262, 359, 1, 0, 1
796, 1, 1636424021966, 1636424022634, 668, 270, 398, 1, 0, 1
799, 1, 1636424022284, 1636424022914, 630, 271, 359, 1, 1, 2
800, 1, 1636424022298, 1636424023086, 788, 391, 397, 1, 2, 3
801, 1, 1636424022555, 1636424023186, 631, 270, 361, 2, 2, 4
803, 1, 1636424022804, 1636424023426, 622, 268, 354, 2, 0, 2
804, 1, 1636424022842, 1636424023474, 632, 277, 355, 0, 0, 0
805, 1, 1636424023125, 1636424023882, 757, 398, 359, 1, 1, 2
807, 1, 1636424023363, 1636424023998, 635, 274, 361, 0, 1, 1
810, 1, 1636424023853, 1636424024478, 625, 270, 355, 1, 1, 2
811, 1, 1636424024150, 1636424024778, 628, 270, 358, 0, 0, 0
812, 1, 1636424024164, 1636424024782, 618, 265, 353, 0, 0, 0
813, 1, 1636424024483, 1636424025238, 755, 389, 366, 0, 0, 0
814, 1, 1636424024685, 1636424025322, 637, 274, 363, 1, 1, 2
815, 1, 1636424025131, 1636424025754, 623, 270, 353, 0, 1, 1
816, 1, 1636424025418, 1636424026054, 636, 274, 362, 0, 1, 1
817, 1, 1636424025491, 1636424026122, 631, 270, 361, 1, 0, 1
818, 1, 1636424025815, 1636424026514, 699, 339, 360, 1, 1, 2
819, 1, 1636424025993, 1636424026626, 633, 272, 361, 2, 1, 3
820, 1, 1636424026518, 1636424027146, 628, 270, 358, 2, 0, 2
821, 1, 1636424026727, 1636424027358, 631, 273, 358, 0, 1, 1
822, 1, 1636424026888, 1636424027522, 634, 276, 358, 0, 2, 2
823, 1, 1636424027117, 1636424027814, 697, 329, 368, 1, 0, 1
824, 1, 1636424027339, 1636424027974, 635, 278, 357, 1, 1, 2
825, 1, 1636424027900, 1636424028526, 626, 276, 350, 2, 2, 4
826, 1, 1636424028072, 1636424028698, 626, 271, 355, 0, 2, 2
827, 1, 1636424028239, 1636424028870, 631, 271, 360, 1, 0, 1
764, 2, 1636424018967, 1636424029102, 10135, 0, 10135, 0, 1, 1
828, 1, 1636424028452, 1636424029146, 694, 339, 355, 1, 1, 2
829, 1, 1636424028689, 1636424029378, 689, 320, 369, 0, 48, 48
770, 2, 1636424019502, 1636424029638, 10136, 0, 10136, 0, 0, 0
830, 1, 1636424029182, 1636424029814, 632, 271, 361, 3, 1, 4
773, 2, 1636424019691, 1636424029826, 10135, 1, 10134, 1, 0, 1
831, 1, 1636424029424, 1636424030094, 670, 315, 355, 0, 45, 45
776, 2, 1636424020058, 1636424030197, 10139, 1, 10138, 1, 0, 1
832, 1, 1636424029638, 1636424030278, 640, 282, 358, 0, 13, 13
780, 2, 1636424020356, 1636424030489, 10133, 0, 10133, 0, 0, 0
833, 1, 1636424029827, 1636424030554, 727, 367, 360, 1, 3, 4
782, 2, 1636424020559, 1636424030698, 10139, 1, 10138, 1, 1, 2
836, 1, 1636424030046, 1636424030758, 712, 290, 422, 3, 19, 22
837, 1, 1636424030052, 1636424030758, 706, 349, 357, 1, 19, 20
835, 1, 1636424030042, 1636424030758, 716, 290, 426, 1, 27, 28
786, 2, 1636424020957, 1636424031088, 10131, 1, 10130, 0, 2, 2
839, 1, 1636424030494, 1636424031146, 652, 297, 355, 0, 29, 29
838, 1, 1636424030326, 1636424031222, 896, 451, 445, 1, 0, 1
834, 1, 1636424030042, 1636424031222, 1180, 741, 439, 1, 0, 1
789, 2, 1636424021286, 1636424031421, 10135, 0, 10135, 0, 0, 0
841, 1, 1636424030818, 1636424031450, 632, 274, 358, 0, 3, 3
843, 1, 1636424030919, 1636424031550, 631, 271, 360, 1, 2, 3
792, 2, 1636424021488, 1636424031621, 10133, 1, 10132, 0, 0, 0
840, 1, 1636424030618, 1636424031686, 1068, 671, 397, 1, 18, 19
842, 1, 1636424030834, 1636424031690, 856, 453, 403, 2, 17, 19
844, 1, 1636424031196, 1636424031914, 718, 354, 364, 0, 0, 0
849, 1, 1636424031423, 1636424032010, 587, 269, 318, 1, 0, 1
848, 1, 1636424031423, 1636424032014, 591, 269, 322, 1, 0, 1
795, 2, 1636424021960, 1636424032093, 10133, 0, 10133, 0, 0, 0
845, 1, 1636424031218, 1636424032142, 924, 518, 406, 0, 0, 0
798, 2, 1636424022066, 1636424032205, 10139, 0, 10139, 0, 0, 0
850, 1, 1636424031550, 1636424032218, 668, 270, 398, 0, 1, 1
851, 1, 1636424031621, 1636424032470, 849, 494, 355, 1, 11, 12
853, 1, 1636424031876, 1636424032590, 714, 362, 352, 0, 0, 0
855, 1, 1636424032123, 1636424032750, 627, 269, 358, 2, 2, 4
857, 1, 1636424032226, 1636424032862, 636, 271, 365, 3, 0, 3
802, 2, 1636424022744, 1636424032877, 10133, 1, 10132, 1, 0, 1
858, 1, 1636424032226, 1636424032894, 668, 269, 399, 0, 1, 1
856, 1, 1636424032136, 1636424032934, 798, 402, 396, 1, 0, 1
859, 1, 1636424032334, 1636424033042, 708, 311, 397, 0, 1, 1
861, 1, 1636424032499, 1636424033238, 739, 382, 357, 1, 38, 39
862, 1, 1636424032662, 1636424033338, 676, 308, 368, 0, 17, 17
863, 1, 1636424032712, 1636424033342, 630, 270, 360, 0, 0, 0
806, 2, 1636424023241, 1636424033377, 10136, 1, 10135, 0, 0, 0
852, 1, 1636424031754, 1636424033498, 1744, 1342, 402, 0, 1, 1
864, 1, 1636424032895, 1636424033530, 635, 275, 360, 1, 1, 2
808, 2, 1636424023574, 1636424033712, 10138, 0, 10138, 0, 0, 0
809, 2, 1636424023625, 1636424033761, 10136, 1, 10135, 0, 1, 1
865, 1, 1636424032961, 1636424033826, 865, 511, 354, 0, 33, 33
867, 1, 1636424033248, 1636424033922, 674, 274, 400, 1, 0, 1
866, 1, 1636424033010, 1636424034026, 1016, 570, 446, 1, 32, 33
868, 1, 1636424033430, 1636424034074, 644, 278, 366, 1, 11, 12
871, 1, 1636424033517, 1636424034222, 705, 296, 409, 0, 18, 18
873, 1, 1636424033566, 1636424034222, 656, 289, 367, 1, 17, 18
872, 1, 1636424033537, 1636424034226, 689, 275, 414, 1, 1, 2
869, 1, 1636424033487, 1636424034282, 795, 438, 357, 1, 2, 3
870, 1, 1636424033514, 1636424034474, 960, 562, 398, 1, 0, 1
875, 1, 1636424033833, 1636424034522, 689, 330, 359, 0, 1, 1
876, 1, 1636424033850, 1636424034526, 676, 271, 405, 0, 2, 2
878, 1, 1636424033954, 1636424034678, 724, 359, 365, 0, 1, 1
879, 1, 1636424034081, 1636424034710, 629, 270, 359, 1, 0, 1
880, 1, 1636424034228, 1636424034854, 626, 271, 355, 0, 1, 1
877, 1, 1636424033862, 1636424034926, 1064, 667, 397, 1, 0, 1
882, 1, 1636424034313, 1636424035154, 841, 482, 359, 1, 1, 2
883, 1, 1636424034564, 1636424035190, 626, 269, 357, 2, 0, 2
884, 1, 1636424034742, 1636424035374, 632, 270, 362, 0, 1, 1
888, 1, 1636424034903, 1636424035526, 623, 270, 353, 1, 1, 2
889, 1, 1636424034907, 1636424035542, 635, 274, 361, 0, 1, 1
886, 1, 1636424034847, 1636424035606, 759, 403, 356, 1, 0, 1
887, 1, 1636424034859, 1636424035650, 791, 434, 357, 1, 0, 1
892, 1, 1636424035172, 1636424035802, 630, 271, 359, 2, 0, 2
890, 1, 1636424035104, 1636424035830, 726, 365, 361, 1, 0, 1
894, 1, 1636424035346, 1636424035974, 628, 270, 358, 1, 1, 2
893, 1, 1636424035231, 1636424036098, 867, 514, 353, 0, 0, 0
896, 1, 1636424035617, 1636424036258, 641, 270, 371, 2, 0, 2
895, 1, 1636424035600, 1636424036430, 830, 472, 358, 0, 0, 0
897, 1, 1636424035833, 1636424036466, 633, 271, 362, 0, 1, 1
898, 1, 1636424036047, 1636424036674, 627, 270, 357, 0, 0, 0
900, 1, 1636424036232, 1636424036854, 622, 266, 356, 0, 0, 0
899, 1, 1636424036132, 1636424036882, 750, 395, 355, 2, 0, 2
901, 1, 1636424036291, 1636424036922, 631, 269, 362, 1, 0, 1
902, 1, 1636424036308, 1636424036934, 626, 270, 356, 0, 0, 0
903, 1, 1636424036380, 1636424037126, 746, 393, 353, 0, 0, 0
904, 1, 1636424036530, 1636424037158, 628, 269, 359, 1, 0, 1
906, 1, 1636424036667, 1636424037294, 627, 266, 361, 2, 0, 2
905, 1, 1636424036597, 1636424037318, 721, 349, 372, 0, 0, 0
907, 1, 1636424036924, 1636424037550, 626, 269, 357, 1, 0, 1
908, 1, 1636424036932, 1636424037754, 822, 463, 359, 2, 0, 2
909, 1, 1636424037133, 1636424037762, 629, 270, 359, 0, 1, 1
910, 1, 1636424037390, 1636424038022, 632, 276, 356, 0, 1, 1
911, 1, 1636424037414, 1636424038210, 796, 439, 357, 1, 1, 2
913, 1, 1636424037596, 1636424038218, 622, 269, 353, 2, 0, 2
914, 1, 1636424037664, 1636424038294, 630, 274, 356, 0, 1, 1
915, 1, 1636424037748, 1636424038470, 722, 366, 356, 1, 0, 1
917, 1, 1636424037919, 1636424038546, 627, 269, 358, 0, 0, 0
918, 1, 1636424038016, 1636424038646, 630, 270, 360, 0, 0, 0
919, 1, 1636424038245, 1636424038878, 633, 267, 366, 0, 1, 1
920, 1, 1636424038271, 1636424039106, 835, 478, 357, 0, 0, 0
921, 1, 1636424038519, 1636424039146, 627, 270, 357, 1, 0, 1
924, 1, 1636424038904, 1636424039522, 618, 266, 352, 1, 0, 1
923, 1, 1636424038766, 1636424039558, 792, 435, 357, 0, 1, 1
925, 1, 1636424038937, 1636424039598, 661, 303, 358, 1, 1, 2
927, 1, 1636424039183, 1636424039822, 639, 272, 367, 0, 0, 0
928, 1, 1636424039331, 1636424039962, 631, 271, 360, 1, 0, 1
930, 1, 1636424039629, 1636424040262, 633, 270, 363, 0, 0, 0
929, 1, 1636424039579, 1636424040410, 831, 475, 356, 0, 1, 1
931, 1, 1636424039846, 1636424040474, 628, 269, 359, 1, 0, 1
932, 1, 1636424040063, 1636424040866, 803, 445, 358, 1, 1, 2
934, 1, 1636424040248, 1636424040874, 626, 274, 352, 0, 0, 0
933, 1, 1636424040239, 1636424040874, 635, 269, 366, 0, 0, 0
935, 1, 1636424040462, 1636424041090, 628, 270, 358, 0, 0, 0
936, 1, 1636424040631, 1636424041258, 627, 271, 356, 1, 1, 2
847, 2, 1636424031326, 1636424041469, 10143, 1, 10142, 3, 0, 3
846, 2, 1636424031310, 1636424041513, 10203, 0, 10203, 0, 0, 0
938, 1, 1636424040956, 1636424041582, 626, 274, 352, 0, 1, 1
937, 1, 1636424040909, 1636424041774, 865, 470, 395, 0, 25, 25
939, 1, 1636424041229, 1636424041878, 649, 289, 360, 1, 16, 17
854, 2, 1636424031891, 1636424042029, 10138, 1, 10137, 1, 1, 2
941, 1, 1636424041535, 1636424042162, 627, 276, 351, 0, 2, 2
942, 1, 1636424041566, 1636424042194, 628, 273, 355, 1, 0, 1
940, 1, 1636424041355, 1636424042218, 863, 482, 381, 0, 1, 1
944, 1, 1636424041602, 1636424042298, 696, 300, 396, 2, 26, 28
945, 1, 1636424041811, 1636424042482, 671, 317, 354, 0, 46, 46
946, 1, 1636424041966, 1636424042614, 648, 267, 381, 1, 0, 1
860, 2, 1636424032498, 1636424042634, 10136, 1, 10135, 2, 0, 2
943, 1, 1636424041602, 1636424042750, 1148, 751, 397, 0, 0, 0
948, 1, 1636424042257, 1636424042902, 645, 285, 360, 0, 16, 16
949, 1, 1636424042261, 1636424043086, 825, 470, 355, 1, 21, 22
950, 1, 1636424042531, 1636424043162, 631, 265, 366, 1, 0, 1
947, 1, 1636424042158, 1636424043206, 1048, 642, 406, 1, 2, 3
953, 1, 1636424042867, 1636424043490, 623, 265, 358, 0, 0, 0
954, 1, 1636424042882, 1636424043514, 632, 268, 364, 0, 0, 0
955, 1, 1636424042900, 1636424043526, 626, 266, 360, 0, 0, 0
951, 1, 1636424042709, 1636424043534, 825, 471, 354, 0, 1, 1
952, 1, 1636424042766, 1636424043666, 900, 498, 402, 1, 0, 1
957, 1, 1636424043090, 1636424043718, 628, 270, 358, 0, 1, 1
874, 2, 1636424033615, 1636424043757, 10142, 1, 10141, 2, 0, 2
958, 1, 1636424043315, 1636424043946, 631, 273, 358, 0, 0, 0
956, 1, 1636424042950, 1636424044022, 1072, 714, 358, 0, 45, 45
960, 1, 1636424043628, 1636424044294, 666, 271, 395, 0, 0, 0
961, 1, 1636424043631, 1636424044394, 763, 371, 392, 1, 0, 1
881, 2, 1636424034299, 1636424044433, 10134, 1, 10133, 0, 1, 1
962, 1, 1636424043835, 1636424044462, 627, 271, 356, 2, 0, 2
959, 1, 1636424043471, 1636424044470, 999, 647, 352, 1, 1, 2
963, 1, 1636424043886, 1636424044562, 676, 275, 401, 1, 0, 1
966, 1, 1636424044203, 1636424044830, 627, 268, 359, 1, 0, 1
968, 1, 1636424044258, 1636424044882, 624, 270, 354, 2, 0, 2
967, 1, 1636424044214, 1636424044886, 672, 314, 358, 1, 44, 45
964, 1, 1636424044079, 1636424044886, 807, 449, 358, 1, 36, 37
965, 1, 1636424044092, 1636424044922, 830, 475, 355, 0, 1, 1
885, 2, 1636424034790, 1636424044925, 10135, 0, 10135, 0, 1, 1
970, 1, 1636424044434, 1636424045066, 632, 271, 361, 1, 0, 1
891, 2, 1636424035133, 1636424045269, 10136, 1, 10135, 0, 0, 0
972, 1, 1636424044620, 1636424045282, 662, 311, 351, 0, 46, 46
971, 1, 1636424044566, 1636424045286, 720, 272, 448, 1, 1, 2
969, 1, 1636424044290, 1636424045386, 1096, 731, 365, 3, 46, 49
975, 1, 1636424044978, 1636424045630, 652, 294, 358, 0, 24, 24
974, 1, 1636424044948, 1636424045722, 774, 422, 352, 1, 0, 1
976, 1, 1636424045058, 1636424045738, 680, 283, 397, 1, 0, 1
977, 1, 1636424045176, 1636424045793, 617, 264, 353, 0, 0, 0
973, 1, 1636424044829, 1636424045830, 1001, 643, 358, 1, 1, 2
978, 1, 1636424045191, 1636424045842, 651, 262, 389, 1, 1, 2
979, 1, 1636424045413, 1636424046158, 745, 391, 354, 1, 1, 2
982, 1, 1636424045550, 1636424046170, 620, 263, 357, 0, 1, 1
980, 1, 1636424045442, 1636424046182, 740, 338, 402, 1, 0, 1
983, 1, 1636424045574, 1636424046210, 636, 266, 370, 1, 0, 1
984, 1, 1636424045592, 1636424046214, 622, 266, 356, 1, 0, 1
981, 1, 1636424045448, 1636424046278, 830, 474, 356, 0, 0, 0
986, 1, 1636424045796, 1636424046426, 630, 273, 357, 1, 0, 1
987, 1, 1636424045873, 1636424046510, 637, 278, 359, 0, 1, 1
988, 1, 1636424045892, 1636424046518, 626, 274, 352, 0, 0, 0
985, 1, 1636424045608, 1636424046630, 1022, 662, 360, 0, 0, 0
991, 1, 1636424046304, 1636424046926, 622, 261, 361, 0, 0, 0
990, 1, 1636424046242, 1636424046962, 720, 366, 354, 1, 0, 1
992, 1, 1636424046390, 1636424047010, 620, 266, 354, 0, 0, 0
989, 1, 1636424046153, 1636424047082, 929, 574, 355, 1, 0, 1
993, 1, 1636424046532, 1636424047154, 622, 269, 353, 0, 0, 0
994, 1, 1636424046564, 1636424047186, 622, 266, 356, 0, 0, 0
995, 1, 1636424046734, 1636424047405, 671, 318, 353, 1, 0, 1
997, 1, 1636424046767, 1636424047446, 679, 334, 345, 2, 0, 2
998, 1, 1636424046834, 1636424047458, 624, 271, 353, 1, 1, 2
999, 1, 1636424046888, 1636424047490, 602, 254, 348, 0, 0, 0
996, 1, 1636424046740, 1636424047518, 778, 431, 347, 1, 1, 2
1000, 1, 1636424046897, 1636424047518, 621, 260, 361, 0, 0, 0
912, 2, 1636424037538, 1636424047673, 10135, 1, 10134, 0, 1, 1
1002, 1, 1636424047186, 1636424047810, 624, 262, 362, 0, 1, 1
1003, 1, 1636424047260, 1636424047874, 614, 259, 355, 0, 0, 0
1004, 1, 1636424047276, 1636424047890, 614, 254, 360, 0, 0, 0
1001, 1, 1636424046916, 1636424047938, 1022, 672, 350, 0, 44, 44
916, 2, 1636424037875, 1636424048009, 10134, 0, 10134, 1, 0, 1
1006, 1, 1636424047580, 1636424048214, 634, 270, 364, 1, 0, 1
1007, 1, 1636424047674, 1636424048370, 696, 383, 313, 1, 29, 30
1005, 1, 1636424047452, 1636424048398, 946, 585, 361, 0, 0, 0
1008, 1, 1636424047788, 1636424048462, 674, 272, 402, 3, 1, 4
1010, 1, 1636424047836, 1636424048482, 646, 278, 368, 0, 0, 0
1009, 1, 1636424047806, 1636424048486, 680, 278, 402, 0, 1, 1
1011, 1, 1636424047878, 1636424048542, 664, 271, 393, 2, 1, 3
1018, 1, 1636424048173, 1636424048794, 621, 266, 355, 0, 0, 0
1017, 1, 1636424048163, 1636424048794, 631, 271, 360, 1, 1, 2
1013, 1, 1636424048082, 1636424048818, 736, 366, 370, 1, 0, 1
922, 2, 1636424038687, 1636424048821, 10134, 0, 10134, 0, 0, 0
1012, 1, 1636424048069, 1636424048846, 777, 422, 355, 0, 0, 0
1015, 1, 1636424048134, 1636424048926, 792, 425, 367, 1, 0, 1
1016, 1, 1636424048138, 1636424048934, 796, 393, 403, 1, 0, 1
1020, 1, 1636424048491, 1636424049126, 635, 274, 361, 1, 1, 2
1022, 1, 1636424048645, 1636424049270, 625, 270, 355, 0, 4, 4
926, 1, 1636424039026, 1636424049318, 10292, 9933, 359, 1, 0, 1
1025, 1, 1636424048970, 1636424049598, 628, 269, 359, 1, 0, 1
1024, 1, 1636424048950, 1636424049618, 668, 270, 398, 0, 0, 0
1026, 1, 1636424049006, 1636424049726, 720, 359, 361, 0, 1, 1
1028, 1, 1636424049119, 1636424049750, 631, 271, 360, 0, 1, 1
1029, 1, 1636424049151, 1636424049778, 627, 271, 356, 1, 2, 3
1036, 1, 1636424049505, 1636424050133, 628, 267, 361, 1, 1, 2
1034, 1, 1636424049455, 1636424050174, 719, 367, 352, 2, 0, 2
1037, 1, 1636424049552, 1636424050174, 622, 265, 357, 0, 0, 0
1033, 1, 1636424049449, 1636424050222, 773, 417, 356, 0, 0, 0
1038, 1, 1636424049796, 1636424050422, 626, 270, 356, 0, 1, 1
1040, 1, 1636424050288, 1636424050914, 626, 266, 360, 1, 1, 2
1042, 1, 1636424050339, 1636424050966, 627, 270, 357, 0, 0, 0
1044, 1, 1636424050528, 1636424051158, 630, 274, 356, 0, 0, 0
1047, 1, 1636424050887, 1636424051510, 623, 270, 353, 1, 1, 2
1048, 1, 1636424050922, 1636424051550, 628, 271, 357, 1, 2, 3
1046, 1, 1636424050795, 1636424051614, 819, 461, 358, 0, 0, 0
1049, 1, 1636424051180, 1636424051810, 630, 273, 357, 0, 0, 0
1051, 1, 1636424051665, 1636424052298, 633, 271, 362, 1, 1, 2
1052, 1, 1636424051850, 1636424052482, 632, 270, 362, 1, 0, 1
1054, 1, 1636424052176, 1636424052802, 626, 270, 356, 1, 0, 1
1053, 1, 1636424052120, 1636424052934, 814, 460, 354, 1, 1, 2
1056, 1, 1636424052551, 1636424053190, 639, 270, 369, 1, 1, 2
1057, 1, 1636424052990, 1636424053618, 628, 269, 359, 0, 1, 1
1058, 1, 1636424053118, 1636424053754, 636, 273, 363, 1, 0, 1
1060, 1, 1636424053502, 1636424054134, 632, 270, 362, 0, 1, 1
1059, 1, 1636424053409, 1636424054210, 801, 439, 362, 0, 0, 0
1062, 1, 1636424054270, 1636424054902, 632, 270, 362, 1, 2, 3
1063, 1, 1636424054474, 1636424055106, 632, 270, 362, 0, 1, 1
1065, 1, 1636424054801, 1636424055434, 633, 269, 364, 1, 0, 1
1064, 1, 1636424054763, 1636424055562, 799, 442, 357, 0, 0, 0
1066, 1, 1636424055626, 1636424056258, 632, 270, 362, 1, 1, 2
1067, 1, 1636424055865, 1636424056494, 629, 266, 363, 1, 0, 1
1068, 1, 1636424056080, 1636424056710, 630, 265, 365, 0, 0, 0
1069, 1, 1636424056099, 1636424056950, 851, 489, 362, 0, 0, 0
1070, 1, 1636424057017, 1636424057646, 629, 266, 363, 0, 1, 1
1071, 1, 1636424057155, 1636424057786, 631, 273, 358, 0, 0, 0
1073, 1, 1636424057467, 1636424058098, 631, 269, 362, 0, 1, 1
1072, 1, 1636424057401, 1636424058242, 841, 480, 361, 1, 2, 3
1014, 2, 1636424048120, 1636424058253, 10133, 1, 10132, 1, 0, 1
1019, 2, 1636424048245, 1636424058385, 10140, 0, 10140, 0, 0, 0
1021, 2, 1636424048590, 1636424058729, 10139, 1, 10138, 1, 0, 1
1023, 2, 1636424048760, 1636424058913, 10153, 1, 10152, 0, 1, 1
1074, 1, 1636424058307, 1636424058998, 691, 297, 394, 2, 28, 30
1075, 1, 1636424058438, 1636424059086, 648, 289, 359, 0, 24, 24
1027, 2, 1636424049085, 1636424059225, 10140, 0, 10140, 0, 0, 0
1076, 1, 1636424058570, 1636424059270, 700, 275, 425, 1, 5, 6
1030, 2, 1636424049161, 1636424059297, 10136, 1, 10135, 0, 0, 0
1079, 1, 1636424058849, 1636424059510, 661, 270, 391, 0, 0, 0
1031, 2, 1636424049337, 1636424059513, 10176, 0, 10176, 0, 1, 1
1032, 2, 1636424049395, 1636424059561, 10166, 1, 10165, 1, 0, 1
1080, 1, 1636424058862, 1636424059582, 720, 271, 449, 2, 0, 2
1078, 1, 1636424058732, 1636424059594, 862, 454, 408, 1, 0, 1
1035, 2, 1636424049464, 1636424059608, 10144, 0, 10144, 0, 0, 0
1077, 1, 1636424058571, 1636424059870, 1299, 829, 470, 0, 108, 108
1039, 2, 1636424049943, 1636424060077, 10134, 1, 10133, 2, 0, 2
1043, 1, 1636424050405, 1636424060102, 9697, 9339, 358, 0, 0, 0
1082, 1, 1636424059386, 1636424060150, 764, 313, 451, 0, 48, 48
1083, 1, 1636424059640, 1636424060258, 618, 265, 353, 2, 1, 3
1081, 1, 1636424059050, 1636424060342, 1292, 897, 395, 1, 28, 29
1085, 1, 1636424059710, 1636424060362, 652, 258, 394, 0, 0, 0
1087, 1, 1636424059737, 1636424060366, 629, 273, 356, 0, 0, 0
1041, 2, 1636424050291, 1636424060425, 10134, 0, 10134, 0, 0, 0
1088, 1, 1636424059758, 1636424060438, 680, 278, 402, 0, 19, 19
1090, 1, 1636424059901, 1636424060538, 637, 276, 361, 2, 1, 3
1089, 1, 1636424059890, 1636424060566, 676, 267, 409, 0, 0, 0
1086, 1, 1636424059730, 1636424060606, 876, 474, 402, 2, 0, 2
1093, 1, 1636424060155, 1636424060786, 631, 271, 360, 0, 3, 3
1094, 1, 1636424060173, 1636424060798, 625, 267, 358, 0, 1, 1
1091, 1, 1636424060077, 1636424060814, 737, 378, 359, 1, 0, 1
1095, 1, 1636424060206, 1636424060870, 664, 266, 398, 0, 0, 0
1045, 2, 1636424050740, 1636424060873, 10133, 1, 10132, 0, 0, 0
1096, 1, 1636424060354, 1636424061022, 668, 270, 398, 1, 1, 2
1097, 1, 1636424060554, 1636424061322, 768, 370, 398, 1, 4, 5
1098, 1, 1636424060690, 1636424061329, 639, 282, 357, 1, 8, 9
1099, 1, 1636424060930, 1636424061558, 628, 266, 362, 1, 1, 2
1100, 1, 1636424060949, 1636424061582, 633, 268, 365, 2, 0, 2
1103, 1, 1636424061045, 1636424061666, 621, 272, 349, 2, 1, 3
1104, 1, 1636424061055, 1636424061670, 615, 262, 353, 0, 0, 0
1050, 2, 1636424051637, 1636424061773, 10136, 1, 10135, 0, 1, 1
1102, 1, 1636424061043, 1636424061774, 731, 374, 357, 0, 0, 0
1101, 1, 1636424061010, 1636424061778, 768, 366, 402, 1, 0, 1
1105, 1, 1636424061200, 1636424061826, 626, 267, 359, 0, 0, 0
1108, 1, 1636424061444, 1636424062074, 630, 271, 359, 1, 0, 1
1109, 1, 1636424061480, 1636424062134, 654, 295, 359, 0, 24, 24
1107, 1, 1636424061329, 1636424062138, 809, 447, 362, 0, 17, 17
1106, 1, 1636424061223, 1636424062218, 995, 646, 349, 0, 0, 0
1111, 1, 1636424061687, 1636424062310, 623, 269, 354, 1, 1, 2
1055, 2, 1636424052221, 1636424062357, 10136, 0, 10136, 0, 0, 0
1112, 1, 1636424061821, 1636424062526, 705, 351, 354, 1, 0, 1
1113, 1, 1636424061902, 1636424062714, 812, 418, 394, 0, 46, 46
1061, 1, 1636424053858, 1636424062850, 8992, 8634, 358, 0, 0, 0
1115, 1, 1636424062237, 1636424062890, 653, 269, 384, 1, 0, 1
1117, 1, 1636424062277, 1636424062938, 661, 266, 395, 1, 0, 1
1116, 1, 1636424062260, 1636424062982, 722, 356, 366, 1, 1, 2
1122, 1, 1636424062521, 1636424063150, 629, 267, 362, 1, 1, 2
1123, 1, 1636424062525, 1636424063158, 633, 274, 359, 1, 0, 1
1121, 1, 1636424062486, 1636424063166, 680, 279, 401, 0, 0, 0
1125, 1, 1636424062752, 1636424063390, 638, 283, 355, 2, 0, 2
1127, 1, 1636424062868, 1636424063618, 750, 350, 400, 1, 0, 1
1128, 1, 1636424063008, 1636424063650, 642, 279, 363, 1, 0, 1
1130, 1, 1636424063183, 1636424063814, 631, 270, 361, 0, 1, 1
1129, 1, 1636424063093, 1636424063846, 753, 396, 357, 1, 2, 3
1132, 1, 1636424063568, 1636424064294, 726, 375, 351, 0, 2, 2
1134, 1, 1636424063718, 1636424064342, 624, 269, 355, 0, 1, 1
1135, 1, 1636424063871, 1636424064498, 627, 272, 355, 2, 1, 3
1136, 1, 1636424063871, 1636424064502, 631, 275, 356, 1, 1, 2
1138, 1, 1636424064174, 1636424064802, 628, 272, 356, 2, 1, 3
1139, 1, 1636424064407, 1636424065042, 635, 274, 361, 0, 0, 0
1141, 1, 1636424064491, 1636424065122, 631, 270, 361, 0, 1, 1
1143, 1, 1636424065026, 1636424065662, 636, 273, 363, 1, 1, 2
1144, 1, 1636424065186, 1636424065810, 624, 271, 353, 2, 1, 3
1145, 1, 1636424065223, 1636424065846, 623, 266, 357, 0, 0, 0
1146, 1, 1636424065482, 1636424066114, 632, 274, 358, 1, 0, 1
1147, 1, 1636424065735, 1636424066362, 627, 271, 356, 2, 0, 2
1150, 1, 1636424066486, 1636424067118, 632, 269, 363, 0, 1, 1
1151, 1, 1636424066620, 1636424067250, 630, 272, 358, 2, 1, 3
1153, 1, 1636424067034, 1636424067662, 628, 270, 358, 0, 0, 0
1154, 1, 1636424067839, 1636424068470, 631, 273, 358, 0, 1, 1
1155, 1, 1636424067924, 1636424068550, 626, 270, 356, 1, 1, 2
1156, 1, 1636424068369, 1636424068998, 629, 269, 360, 0, 0, 0
1158, 1, 1636424069232, 1636424069862, 630, 274, 356, 1, 0, 1
1157, 1, 1636424069229, 1636424069862, 633, 273, 360, 1, 0, 1
1084, 2, 1636424059698, 1636424069877, 10179, 0, 10179, 0, 0, 0
1092, 2, 1636424060118, 1636424070298, 10180, 0, 10180, 0, 0, 0
1159, 1, 1636424069759, 1636424070422, 663, 274, 389, 1, 0, 1
1162, 1, 1636424070542, 1636424071174, 632, 272, 360, 1, 1, 2
1163, 1, 1636424070553, 1636424071186, 633, 271, 362, 1, 1, 2
1110, 2, 1636424061520, 1636424071657, 10137, 0, 10137, 0, 0, 0
1164, 1, 1636424071091, 1636424071718, 627, 271, 356, 1, 1, 2
1114, 2, 1636424062078, 1636424072217, 10139, 0, 10139, 0, 0, 0
1166, 1, 1636424071848, 1636424072482, 634, 278, 356, 1, 12, 13
1167, 1, 1636424071859, 1636424072486, 627, 270, 357, 0, 4, 4
1119, 2, 1636424062358, 1636424072489, 10131, 1, 10130, 1, 0, 1
1118, 2, 1636424062357, 1636424072537, 10180, 1, 10179, 1, 0, 1
1120, 1, 1636424062399, 1636424072710, 10311, 9953, 358, 1, 1, 2
1124, 2, 1636424062629, 1636424072761, 10132, 1, 10131, 1, 0, 1
1126, 2, 1636424062861, 1636424072997, 10136, 0, 10136, 0, 0, 0
1169, 1, 1636424072395, 1636424073070, 675, 310, 365, 48, 1, 49
1171, 1, 1636424072626, 1636424073302, 676, 315, 361, 48, 0, 48
1170, 1, 1636424072626, 1636424073302, 676, 317, 359, 49, 0, 49
1131, 2, 1636424063533, 1636424073669, 10136, 1, 10135, 1, 0, 1
1173, 1, 1636424072890, 1636424073754, 864, 441, 423, 0, 0, 0
1174, 1, 1636424073130, 1636424073790, 660, 263, 397, 1, 1, 2
1133, 2, 1636424063659, 1636424073793, 10134, 0, 10134, 0, 0, 0
1175, 1, 1636424073237, 1636424073862, 625, 270, 355, 0, 0, 0
1176, 1, 1636424073243, 1636424073866, 623, 271, 352, 1, 0, 1
1137, 2, 1636424064105, 1636424074241, 10136, 0, 10136, 0, 1, 1
1177, 1, 1636424073794, 1636424074410, 616, 267, 349, 0, 1, 1
1179, 1, 1636424073880, 1636424074518, 638, 272, 366, 0, 7, 7
1178, 1, 1636424073802, 1636424074518, 716, 301, 415, 0, 36, 36
1180, 1, 1636424073883, 1636424074518, 635, 270, 365, 0, 3, 3
1140, 2, 1636424064443, 1636424074582, 10139, 1, 10138, 0, 0, 0
1181, 1, 1636424073926, 1636424074602, 676, 277, 399, 0, 12, 12
1182, 1, 1636424074155, 1636424074970, 815, 457, 358, 0, 0, 0
1184, 1, 1636424074396, 1636424075034, 638, 283, 355, 0, 17, 17
1183, 1, 1636424074374, 1636424075066, 692, 291, 401, 0, 1, 1
1142, 2, 1636424064944, 1636424075077, 10133, 1, 10132, 0, 1, 1
1185, 1, 1636424074533, 1636424075162, 629, 272, 357, 1, 0, 1
1186, 1, 1636424074613, 1636424075238, 625, 270, 355, 1, 0, 1
1187, 1, 1636424074710, 1636424075534, 824, 419, 405, 1, 9, 10
1188, 1, 1636424075078, 1636424075726, 648, 273, 375, 0, 0, 0
1189, 1, 1636424075158, 1636424075786, 628, 271, 357, 0, 1, 1
1190, 1, 1636424075186, 1636424075810, 624, 270, 354, 0, 0, 0
1193, 1, 1636424075251, 1636424075882, 631, 270, 361, 1, 0, 1
1148, 2, 1636424065843, 1636424075977, 10134, 1, 10133, 1, 0, 1
1191, 1, 1636424075218, 1636424075989, 771, 374, 397, 2, 0, 2
1195, 1, 1636424075640, 1636424076258, 618, 265, 353, 0, 0, 0
1194, 1, 1636424075527, 1636424076330, 803, 449, 354, 0, 3, 3
1196, 1, 1636424075726, 1636424076342, 616, 263, 353, 0, 1, 1
1197, 1, 1636424075814, 1636424076434, 620, 263, 357, 2, 1, 3
1149, 2, 1636424066379, 1636424076513, 10134, 0, 10134, 1, 0, 1
1198, 1, 1636424075911, 1636424076554, 643, 266, 377, 0, 0, 0
1199, 1, 1636424075977, 1636424076710, 733, 373, 360, 0, 0, 0
1200, 1, 1636424076110, 1636424076778, 668, 272, 396, 0, 4, 4
1152, 2, 1636424066849, 1636424076985, 10136, 0, 10136, 0, 0, 0
1201, 1, 1636424076426, 1636424077054, 628, 267, 361, 1, 0, 1
1202, 1, 1636424076455, 1636424077098, 643, 273, 370, 3, 0, 3
1203, 1, 1636424076514, 1636424077138, 624, 266, 358, 0, 1, 1
1204, 1, 1636424076515, 1636424077170, 655, 336, 319, 0, 0, 0
1205, 1, 1636424076611, 1636424077246, 635, 280, 355, 1, 3, 4
1206, 1, 1636424076642, 1636424077338, 696, 302, 394, 1, 35, 36
1192, 1, 1636424075220, 1636424077474, 2254, 1894, 360, 0, 2, 2
1208, 1, 1636424076923, 1636424077590, 667, 293, 374, 1, 0, 1
1207, 1, 1636424076901, 1636424077690, 789, 437, 352, 0, 1, 1
1211, 1, 1636424077122, 1636424077738, 616, 262, 354, 0, 0, 0
1209, 1, 1636424077113, 1636424077742, 629, 270, 359, 1, 0, 1
1210, 1, 1636424077118, 1636424077790, 672, 270, 402, 1, 0, 1
1212, 1, 1636424077248, 1636424077874, 626, 271, 355, 0, 0, 0
1214, 1, 1636424077377, 1636424078006, 629, 270, 359, 2, 0, 2
1213, 1, 1636424077251, 1636424078042, 791, 430, 361, 0, 1, 1
1215, 1, 1636424077476, 1636424078154, 678, 279, 399, 2, 1, 3
1217, 1, 1636424077786, 1636424078413, 627, 271, 356, 2, 1, 3
1218, 1, 1636424077791, 1636424078426, 635, 274, 361, 0, 1, 1
1216, 1, 1636424077767, 1636424078498, 731, 374, 357, 1, 0, 1
1219, 1, 1636424077884, 1636424078506, 622, 271, 351, 0, 1, 1
1220, 1, 1636424077931, 1636424078554, 623, 265, 358, 1, 0, 1
1221, 1, 1636424078001, 1636424078630, 629, 268, 361, 0, 0, 0
1223, 1, 1636424078288, 1636424078966, 678, 321, 357, 0, 0, 0
1224, 1, 1636424078379, 1636424079014, 635, 273, 362, 1, 0, 1
1226, 1, 1636424078399, 1636424079018, 619, 266, 353, 0, 0, 0
1225, 1, 1636424078392, 1636424079022, 630, 270, 360, 0, 0, 0
1222, 1, 1636424078252, 1636424079090, 838, 482, 356, 0, 1, 1
1228, 1, 1636424078623, 1636424079250, 627, 271, 356, 0, 1, 1
1229, 1, 1636424078680, 1636424079306, 626, 268, 358, 0, 0, 0
1227, 1, 1636424078603, 1636424079418, 815, 458, 357, 1, 0, 1
1230, 1, 1636424078831, 1636424079454, 623, 270, 353, 1, 1, 2
1231, 1, 1636424079121, 1636424079738, 617, 266, 351, 1, 0, 1
1233, 1, 1636424079162, 1636424079790, 628, 270, 358, 2, 0, 2
1234, 1, 1636424079163, 1636424079798, 635, 269, 366, 0, 0, 0
1235, 1, 1636424079234, 1636424079854, 620, 266, 354, 2, 0, 2
1232, 1, 1636424079144, 1636424079874, 730, 377, 353, 1, 0, 1
1236, 1, 1636424079278, 1636424079898, 620, 265, 355, 1, 0, 1
1238, 1, 1636424079596, 1636424080254, 658, 303, 355, 0, 2, 2
1240, 1, 1636424079684, 1636424080294, 610, 259, 351, 1, 0, 1
1239, 1, 1636424079644, 1636424080310, 666, 305, 361, 0, 0, 0
1237, 1, 1636424079550, 1636424080346, 796, 438, 358, 1, 0, 1
1241, 1, 1636424079781, 1636424080410, 629, 270, 359, 1, 0, 1
1243, 1, 1636424079945, 1636424080578, 633, 270, 363, 0, 0, 0
1161, 2, 1636424070434, 1636424080613, 10179, 1, 10178, 2, 0, 2
1160, 2, 1636424070434, 1636424080661, 10227, 0, 10227, 1, 0, 1
1244, 1, 1636424080065, 1636424080690, 625, 270, 355, 1, 0, 1
1242, 1, 1636424079923, 1636424080702, 779, 415, 364, 0, 0, 0
1245, 1, 1636424080128, 1636424080762, 634, 274, 360, 1, 0, 1
1246, 1, 1636424080430, 1636424081114, 684, 282, 402, 2, 8, 10
1247, 1, 1636424080432, 1636424081118, 686, 282, 404, 3, 8, 11
1248, 1, 1636424080473, 1636424081150, 677, 322, 355, 0, 0, 0
1249, 1, 1636424080485, 1636424081194, 709, 314, 395, 50, 1, 51
1251, 1, 1636424080663, 1636424081282, 619, 269, 350, 2, 0, 2
1254, 1, 1636424080838, 1636424081558, 720, 366, 354, 1, 0, 1
1257, 1, 1636424081075, 1636424081694, 619, 268, 351, 0, 1, 1
1256, 1, 1636424081008, 1636424081726, 718, 361, 357, 1, 0, 1
1258, 1, 1636424081110, 1636424081726, 616, 262, 354, 1, 0, 1
1260, 1, 1636424081252, 1636424081878, 626, 270, 356, 0, 0, 0
1165, 2, 1636424071786, 1636424081965, 10179, 0, 10179, 0, 0, 0
1261, 1, 1636424081355, 1636424081986, 631, 269, 362, 1, 0, 1
1262, 1, 1636424081424, 1636424082050, 626, 265, 361, 0, 0, 0
1264, 1, 1636424081768, 1636424082414, 646, 290, 356, 0, 23, 23
1265, 1, 1636424081796, 1636424082430, 634, 274, 360, 0, 0, 0
1168, 2, 1636424072350, 1636424082538, 10188, 0, 10188, 47, 0, 47
1267, 1, 1636424081900, 1636424082558, 658, 270, 388, 1, 0, 1
1269, 1, 1636424082203, 1636424082826, 623, 271, 352, 1, 1, 2
1270, 1, 1636424082296, 1636424083010, 714, 358, 356, 1, 0, 1
1271, 1, 1636424082394, 1636424083030, 636, 274, 362, 0, 0, 0
1172, 1, 1636424072712, 1636424083034, 10322, 9925, 397, 1, 0, 1
1272, 1, 1636424082476, 1636424083122, 646, 267, 379, 0, 2, 2
1274, 1, 1636424082639, 1636424083266, 627, 270, 357, 0, 0, 0
1276, 1, 1636424082771, 1636424083394, 623, 267, 356, 0, 0, 0
1278, 1, 1636424083135, 1636424083758, 623, 270, 353, 0, 0, 0
1279, 1, 1636424083156, 1636424083782, 626, 268, 358, 0, 0, 0
1281, 1, 1636424083559, 1636424084186, 627, 272, 355, 0, 2, 2
1283, 1, 1636424083743, 1636424084366, 623, 271, 352, 1, 1, 2
1284, 1, 1636424083830, 1636424084462, 632, 271, 361, 0, 0, 0
1285, 1, 1636424084027, 1636424084658, 631, 270, 361, 0, 1, 1
1286, 1, 1636424084116, 1636424084738, 622, 270, 352, 1, 1, 2
1287, 1, 1636424084519, 1636424085142, 623, 269, 354, 0, 0, 0
1288, 1, 1636424084523, 1636424085150, 627, 267, 360, 0, 2, 2
1289, 1, 1636424084837, 1636424085466, 629, 270, 359, 0, 0, 0
1290, 1, 1636424085032, 1636424085658, 626, 271, 355, 1, 1, 2
1291, 1, 1636424085171, 1636424085802, 631, 270, 361, 1, 0, 1
1292, 1, 1636424085318, 1636424085950, 632, 274, 358, 0, 0, 0
1293, 1, 1636424085490, 1636424086122, 632, 269, 363, 0, 0, 0
1294, 1, 1636424085814, 1636424086438, 624, 270, 354, 0, 1, 1
1295, 1, 1636424085901, 1636424086522, 621, 266, 355, 1, 1, 2
1296, 1, 1636424086206, 1636424086894, 688, 327, 361, 0, 1, 1
1298, 1, 1636424086542, 1636424087170, 628, 271, 357, 0, 1, 1
1299, 1, 1636424086594, 1636424087218, 624, 265, 359, 0, 0, 0
1300, 1, 1636424086772, 1636424087394, 622, 265, 357, 0, 0, 0
1301, 1, 1636424087097, 1636424087726, 629, 271, 358, 1, 1, 2
1302, 1, 1636424087253, 1636424087886, 633, 271, 362, 1, 0, 1
1303, 1, 1636424087586, 1636424088214, 628, 269, 359, 1, 0, 1
1304, 1, 1636424087882, 1636424088518, 636, 270, 366, 0, 0, 0
1306, 1, 1636424088143, 1636424088774, 631, 268, 363, 0, 0, 0
1308, 1, 1636424088622, 1636424089242, 620, 269, 351, 0, 1, 1
1309, 1, 1636424088883, 1636424089506, 623, 265, 358, 0, 0, 0
1310, 1, 1636424089257, 1636424089882, 625, 270, 355, 2, 0, 2
1311, 1, 1636424089494, 1636424090126, 632, 271, 361, 2, 0, 2
1312, 1, 1636424089980, 1636424090610, 630, 270, 360, 1, 0, 1
1250, 2, 1636424080613, 1636424090757, 10144, 2, 10142, 0, 1, 1
1313, 1, 1636424090191, 1636424090818, 627, 271, 356, 0, 2, 2
1253, 2, 1636424080751, 1636424090929, 10178, 0, 10178, 0, 0, 0
1252, 2, 1636424080750, 1636424090973, 10223, 1, 10222, 2, 0, 2
1255, 2, 1636424080902, 1636424091042, 10140, 0, 10140, 0, 0, 0
1314, 1, 1636424090620, 1636424091326, 706, 354, 352, 2, 36, 38
1259, 2, 1636424081239, 1636424091369, 10130, 0, 10130, 0, 0, 0
1315, 1, 1636424090843, 1636424091518, 675, 313, 362, 44, 0, 44
1263, 2, 1636424081759, 1636424091893, 10134, 0, 10134, 0, 0, 0
1266, 2, 1636424081804, 1636424091941, 10137, 1, 10136, 1, 0, 1
1318, 1, 1636424091370, 1636424092002, 632, 269, 363, 0, 0, 0
1319, 1, 1636424091538, 1636424092206, 668, 314, 354, 0, 44, 44
1268, 2, 1636424082094, 1636424092277, 10183, 0, 10183, 0, 0, 0
1320, 1, 1636424091654, 1636424092398, 744, 336, 408, 1, 67, 68
1273, 2, 1636424082636, 1636424092769, 10133, 0, 10133, 0, 0, 0
1275, 2, 1636424082710, 1636424092885, 10175, 0, 10175, 0, 0, 0
1277, 2, 1636424083036, 1636424093213, 10177, 1, 10176, 0, 1, 1
1280, 2, 1636424083207, 1636424093341, 10134, 1, 10133, 0, 0, 0
1329, 1, 1636424092887, 1636424093514, 627, 270, 357, 0, 1, 1
1331, 1, 1636424092944, 1636424093614, 670, 310, 360, 2, 39, 41
1326, 1, 1636424092115, 1636424093710, 1595, 1234, 361, 1, 0, 1
1282, 2, 1636424083578, 1636424093713, 10135, 0, 10135, 1, 0, 1
1335, 1, 1636424093715, 1636424094386, 671, 271, 400, 1, 1, 2
1337, 1, 1636424094221, 1636424094850, 629, 266, 363, 0, 1, 1
1339, 1, 1636424095039, 1636424095666, 627, 270, 357, 1, 0, 1
1340, 1, 1636424095523, 1636424096154, 631, 270, 361, 0, 0, 0
1297, 2, 1636424086314, 1636424096450, 10136, 0, 10136, 0, 0, 0
1341, 1, 1636424096342, 1636424096990, 648, 269, 379, 1, 1, 2
1343, 1, 1636424096896, 1636424097526, 630, 271, 359, 1, 0, 1
1305, 2, 1636424087922, 1636424098057, 10135, 0, 10135, 0, 0, 0
1344, 1, 1636424097610, 1636424098246, 636, 270, 366, 1, 0, 1
1307, 2, 1636424088424, 1636424098557, 10133, 0, 10133, 0, 0, 0
1345, 1, 1636424098168, 1636424098822, 654, 302, 352, 1, 32, 33
1346, 1, 1636424098186, 1636424098862, 676, 275, 401, 1, 0, 1
1347, 1, 1636424098690, 1636424099370, 680, 274, 406, 1, 1, 2
1348, 1, 1636424098881, 1636424099514, 633, 271, 362, 1, 0, 1
1349, 1, 1636424099480, 1636424100102, 622, 272, 350, 1, 0, 1
1350, 1, 1636424099560, 1636424100186, 626, 271, 355, 1, 0, 1
1351, 1, 1636424099985, 1636424100614, 629, 270, 359, 0, 1, 1
1352, 1, 1636424100212, 1636424100842, 630, 269, 361, 1, 0, 1
1316, 2, 1636424091062, 1636424101241, 10179, 1, 10178, 2, 0, 2
1317, 2, 1636424091062, 1636424101285, 10223, 0, 10223, 0, 0, 0
1353, 1, 1636424100798, 1636424101422, 624, 271, 353, 0, 0, 0
1354, 1, 1636424100921, 1636424101558, 637, 271, 366, 1, 3, 4
1321, 2, 1636424091654, 1636424101835, 10181, 2, 10179, 2, 1, 3
1322, 2, 1636424091655, 1636424101881, 10226, 0, 10226, 1, 0, 1
1355, 1, 1636424101302, 1636424101926, 624, 266, 358, 0, 1, 1
1357, 1, 1636424101375, 1636424102050, 675, 271, 404, 0, 0, 0
1323, 2, 1636424092009, 1636424102142, 10133, 0, 10133, 0, 0, 0
1324, 2, 1636424092030, 1636424102209, 10179, 1, 10178, 0, 1, 1
1358, 1, 1636424101542, 1636424102238, 696, 294, 402, 1, 26, 27
1325, 2, 1636424092074, 1636424102253, 10179, 1, 10178, 1, 0, 1
1356, 1, 1636424101374, 1636424102518, 1144, 743, 401, 2, 20, 22
1327, 2, 1636424092410, 1636424102589, 10179, 1, 10178, 1, 0, 1
1328, 1, 1636424092693, 1636424102714, 10021, 9622, 399, 1, 4, 5
1361, 1, 1636424102142, 1636424102790, 648, 266, 382, 0, 0, 0
1362, 1, 1636424102254, 1636424102878, 624, 274, 350, 1, 1, 2
1360, 1, 1636424101971, 1636424102974, 1003, 561, 442, 1, 0, 1
1330, 2, 1636424092902, 1636424103077, 10175, 0, 10175, 0, 0, 0
1332, 2, 1636424093014, 1636424103189, 10175, 0, 10175, 0, 0, 0
1367, 1, 1636424102628, 1636424103242, 614, 262, 352, 0, 0, 0
1366, 1, 1636424102606, 1636424103246, 640, 278, 362, 0, 0, 0
1370, 1, 1636424102722, 1636424103454, 732, 331, 401, 1, 28, 29
1333, 2, 1636424093342, 1636424103521, 10179, 1, 10178, 0, 2, 2
1371, 1, 1636424102879, 1636424103546, 667, 315, 352, 1, 44, 45
1334, 2, 1636424093470, 1636424103645, 10175, 0, 10175, 0, 0, 0
1368, 1, 1636424102653, 1636424103690, 1037, 682, 355, 3, 0, 3
1373, 1, 1636424103282, 1636424103910, 628, 273, 355, 0, 0, 0
1372, 1, 1636424103210, 1636424103922, 712, 306, 406, 0, 9, 9
1338, 1, 1636424094263, 1636424104014, 9751, 9398, 353, 1, 0, 1
1336, 2, 1636424093847, 1636424104025, 10178, 0, 10178, 0, 0, 0
1375, 1, 1636424103455, 1636424104106, 651, 274, 377, 0, 0, 0
1376, 1, 1636424103645, 1636424104294, 649, 292, 357, 1, 29, 30
1342, 1, 1636424096582, 1636424104514, 7932, 7535, 397, 1, 1, 2
1382, 1, 1636424104027, 1636424104618, 591, 274, 317, 3, 0, 3
1379, 1, 1636424103963, 1636424104622, 659, 276, 383, 3, 1, 4
1380, 1, 1636424103977, 1636424104626, 649, 273, 376, 3, 0, 3
1383, 1, 1636424104027, 1636424104698, 671, 267, 404, 1, 0, 1
1384, 1, 1636424104165, 1636424104794, 629, 270, 359, 1, 0, 1
1381, 1, 1636424104027, 1636424105078, 1051, 688, 363, 0, 1, 1
1387, 1, 1636424104551, 1636424105190, 639, 273, 366, 0, 0, 0
1388, 1, 1636424104600, 1636424105226, 626, 270, 356, 0, 0, 0
1389, 1, 1636424104842, 1636424105466, 624, 266, 358, 2, 0, 2
1390, 1, 1636424104996, 1636424105626, 630, 268, 362, 0, 0, 0
1391, 1, 1636424105240, 1636424105866, 626, 270, 356, 0, 0, 0
1393, 1, 1636424105348, 1636424105974, 626, 270, 356, 0, 0, 0
1394, 1, 1636424105363, 1636424105986, 623, 270, 353, 0, 0, 0
1395, 1, 1636424105365, 1636424105998, 633, 275, 358, 2, 0, 2
1396, 1, 1636424105439, 1636424106066, 627, 266, 361, 0, 0, 0
1392, 1, 1636424105312, 1636424106322, 1010, 650, 360, 1, 1, 2
1397, 1, 1636424105875, 1636424106502, 627, 270, 357, 1, 0, 1
1398, 1, 1636424105905, 1636424106546, 641, 278, 363, 0, 1, 1
1399, 1, 1636424106177, 1636424106806, 629, 270, 359, 0, 0, 0
1400, 1, 1636424106327, 1636424106954, 627, 270, 357, 0, 0, 0
1401, 1, 1636424106541, 1636424107170, 629, 270, 359, 0, 0, 0
1403, 1, 1636424106692, 1636424107314, 622, 270, 352, 0, 0, 0
1404, 1, 1636424106698, 1636424107326, 628, 274, 354, 0, 0, 0
1405, 1, 1636424106712, 1636424107334, 622, 270, 352, 0, 0, 0
1406, 1, 1636424106727, 1636424107354, 627, 270, 357, 0, 0, 0
1402, 1, 1636424106634, 1636424107626, 992, 634, 358, 0, 1, 1
1407, 1, 1636424107179, 1636424107818, 639, 273, 366, 1, 1, 2
1408, 1, 1636424107276, 1636424107902, 626, 274, 352, 0, 1, 1
1409, 1, 1636424107453, 1636424108082, 629, 270, 359, 1, 0, 1
1410, 1, 1636424107691, 1636424108318, 627, 273, 354, 0, 0, 0
1411, 1, 1636424107876, 1636424108506, 630, 268, 362, 0, 2, 2
1412, 1, 1636424107975, 1636424108602, 627, 266, 361, 0, 0, 0
1413, 1, 1636424107981, 1636424108610, 629, 271, 358, 2, 0, 2
1415, 1, 1636424107993, 1636424108622, 629, 263, 366, 0, 0, 0
1416, 1, 1636424108035, 1636424108654, 619, 266, 353, 0, 0, 0
1414, 1, 1636424107981, 1636424108958, 977, 612, 365, 0, 0, 0
1417, 1, 1636424108551, 1636424109174, 623, 269, 354, 0, 0, 0
1418, 1, 1636424108636, 1636424109266, 630, 271, 359, 0, 1, 1
1419, 1, 1636424108721, 1636424109354, 633, 270, 363, 1, 0, 1
1420, 1, 1636424108960, 1636424109586, 626, 271, 355, 1, 0, 1
1421, 1, 1636424109242, 1636424109870, 628, 271, 357, 0, 0, 0
1423, 1, 1636424109281, 1636424109902, 621, 265, 356, 0, 0, 0
1422, 1, 1636424109265, 1636424109906, 641, 273, 368, 0, 0, 0
1424, 1, 1636424109329, 1636424109946, 617, 267, 350, 3, 0, 3
1426, 1, 1636424109419, 1636424110046, 627, 266, 361, 0, 0, 0
1425, 1, 1636424109336, 1636424110354, 1018, 661, 357, 0, 0, 0
1427, 1, 1636424109912, 1636424110538, 626, 266, 360, 1, 1, 2
1428, 1, 1636424109971, 1636424110590, 619, 270, 349, 1, 0, 1
1429, 1, 1636424110071, 1636424110702, 631, 270, 361, 1, 0, 1
1430, 1, 1636424110260, 1636424110890, 630, 269, 361, 0, 1, 1
1431, 1, 1636424110550, 1636424111174, 624, 270, 354, 1, 0, 1
1432, 1, 1636424110565, 1636424111185, 620, 270, 350, 0, 0, 0
1433, 1, 1636424110605, 1636424111226, 621, 269, 352, 0, 0, 0
1435, 1, 1636424110670, 1636424111298, 628, 267, 361, 0, 0, 0
1436, 1, 1636424110795, 1636424111426, 631, 269, 362, 0, 0, 0
1434, 1, 1636424110646, 1636424111634, 988, 626, 362, 1, 0, 1
1437, 1, 1636424111247, 1636424111874, 627, 268, 359, 0, 0, 0
1438, 1, 1636424111283, 1636424111902, 619, 262, 357, 0, 0, 0
1439, 1, 1636424111426, 1636424112050, 624, 269, 355, 0, 0, 0
1440, 1, 1636424111550, 1636424112174, 624, 269, 355, 0, 0, 0
1359, 2, 1636424101970, 1636424112189, 10219, 1, 10218, 2, 0, 2
1441, 1, 1636424111832, 1636424112454, 622, 270, 352, 0, 0, 0
1442, 1, 1636424111855, 1636424112482, 627, 271, 356, 0, 1, 1
1363, 2, 1636424102386, 1636424112561, 10175, 0, 10175, 0, 0, 0
1444, 1, 1636424111961, 1636424112582, 621, 262, 359, 1, 0, 1
1445, 1, 1636424111975, 1636424112634, 659, 306, 353, 0, 36, 36
1364, 2, 1636424102490, 1636424112681, 10191, 1, 10190, 0, 1, 1
1365, 2, 1636424102490, 1636424112725, 10235, 1, 10234, 0, 1, 1
1446, 1, 1636424112063, 1636424112742, 679, 266, 413, 2, 0, 2
1443, 1, 1636424111961, 1636424112986, 1025, 628, 397, 1, 7, 8
1447, 1, 1636424112562, 1636424113170, 608, 294, 314, 0, 28, 28
1369, 1, 1636424102715, 1636424113214, 10499, 10103, 396, 1, 1, 2
1448, 1, 1636424112615, 1636424113270, 655, 325, 330, 45, 0, 45
1449, 1, 1636424112725, 1636424113354, 629, 267, 362, 0, 0, 0
1452, 1, 1636424112828, 1636424113446, 618, 266, 352, 1, 0, 1
1450, 1, 1636424112810, 1636424113482, 672, 273, 399, 0, 0, 0
1374, 2, 1636424103318, 1636424113493, 10175, 0, 10175, 1, 0, 1
1453, 1, 1636424113135, 1636424113762, 627, 270, 357, 0, 0, 0
1377, 2, 1636424103654, 1636424113833, 10179, 0, 10179, 0, 0, 0
1455, 1, 1636424113240, 1636424113866, 626, 271, 355, 1, 0, 1
1456, 1, 1636424113265, 1636424113894, 629, 270, 359, 0, 0, 0
1454, 1, 1636424113216, 1636424113946, 730, 333, 397, 0, 7, 7
1378, 2, 1636424103774, 1636424113949, 10175, 0, 10175, 0, 0, 0
1457, 1, 1636424113291, 1636424113954, 663, 302, 361, 1, 27, 28
1459, 1, 1636424113368, 1636424114030, 662, 266, 396, 0, 0, 0
1458, 1, 1636424113314, 1636424114322, 1008, 649, 359, 1, 0, 1
1385, 2, 1636424104166, 1636424114345, 10179, 1, 10178, 1, 0, 1
1451, 1, 1636424112814, 1636424114410, 1596, 1190, 406, 1, 4, 5
1460, 1, 1636424113835, 1636424114490, 655, 265, 390, 0, 0, 0
1463, 1, 1636424114038, 1636424114706, 668, 271, 397, 0, 1, 1
1466, 1, 1636424114042, 1636424114710, 668, 303, 365, 1, 34, 35
1462, 1, 1636424114034, 1636424114710, 676, 275, 401, 2, 8, 10
1468, 1, 1636424114135, 1636424114798, 663, 301, 362, 3, 33, 36
1469, 1, 1636424114143, 1636424114798, 655, 294, 361, 2, 29, 31
1386, 1, 1636424104532, 1636424114838, 10306, 9906, 400, 0, 0, 0
1461, 1, 1636424113954, 1636424114866, 912, 555, 357, 0, 0, 0
1471, 1, 1636424114456, 1636424115094, 638, 275, 363, 0, 1, 1
1470, 1, 1636424114425, 1636424115102, 677, 274, 403, 1, 0, 1
1472, 1, 1636424114474, 1636424115154, 680, 281, 399, 2, 0, 2
1465, 1, 1636424114039, 1636424115162, 1123, 720, 403, 0, 0, 0
1474, 1, 1636424114611, 1636424115230, 619, 263, 356, 2, 1, 3
1475, 1, 1636424114634, 1636424115246, 612, 259, 353, 0, 1, 1
1473, 1, 1636424114589, 1636424115246, 657, 299, 358, 0, 0, 0
1476, 1, 1636424114639, 1636424115262, 623, 266, 357, 0, 0, 0
1478, 1, 1636424114674, 1636424115294, 620, 262, 358, 0, 0, 0
1477, 1, 1636424114654, 1636424115674, 1020, 665, 355, 0, 0, 0
1480, 1, 1636424115175, 1636424115802, 627, 273, 354, 2, 0, 2
1481, 1, 1636424115320, 1636424115938, 618, 267, 351, 0, 0, 0
1482, 1, 1636424115342, 1636424115970, 628, 270, 358, 0, 1, 1
1484, 1, 1636424115358, 1636424115986, 628, 269, 359, 0, 0, 0
1485, 1, 1636424115420, 1636424116034, 614, 262, 352, 0, 0, 0
1486, 1, 1636424115450, 1636424116078, 628, 270, 358, 1, 0, 1
1487, 1, 1636424115473, 1636424116098, 625, 275, 350, 1, 0, 1
1488, 1, 1636424115714, 1636424116334, 620, 266, 354, 0, 0, 0
1489, 1, 1636424115727, 1636424116346, 619, 262, 357, 0, 0, 0
1483, 1, 1636424115354, 1636424116422, 1068, 714, 354, 1, 0, 1
1490, 1, 1636424115796, 1636424116446, 650, 291, 359, 1, 0, 1
1491, 1, 1636424115897, 1636424116526, 629, 271, 358, 0, 1, 1
1492, 1, 1636424115919, 1636424116554, 635, 271, 364, 0, 0, 0
1494, 1, 1636424115976, 1636424116602, 626, 270, 356, 2, 0, 2
1495, 1, 1636424115988, 1636424116618, 630, 266, 364, 0, 0, 0
1496, 1, 1636424116009, 1636424116634, 625, 266, 359, 0, 0, 0
1493, 1, 1636424115973, 1636424116974, 1001, 647, 354, 1, 1, 2
1497, 1, 1636424116530, 1636424117162, 632, 265, 367, 0, 1, 1
1498, 1, 1636424116624, 1636424117250, 626, 263, 363, 0, 0, 0
1499, 1, 1636424116664, 1636424117294, 630, 282, 348, 0, 1, 1
1501, 1, 1636424116687, 1636424117314, 627, 273, 354, 0, 1, 1
1502, 1, 1636424116720, 1636424117338, 618, 270, 348, 0, 0, 0
1503, 1, 1636424116762, 1636424117382, 620, 271, 349, 2, 0, 2
1504, 1, 1636424116843, 1636424117474, 631, 279, 352, 1, 1, 2
1505, 1, 1636424116993, 1636424117606, 613, 259, 354, 0, 0, 0
1506, 1, 1636424117044, 1636424117666, 622, 266, 356, 0, 0, 0
1500, 1, 1636424116681, 1636424117742, 1061, 706, 355, 1, 0, 1
1507, 1, 1636424117150, 1636424117786, 636, 283, 353, 1, 1, 2
1510, 1, 1636424117265, 1636424117882, 617, 267, 350, 0, 0, 0
1511, 1, 1636424117285, 1636424117910, 625, 266, 359, 0, 0, 0
1512, 1, 1636424117307, 1636424117926, 619, 267, 352, 2, 0, 2
1509, 1, 1636424117260, 1636424117934, 674, 310, 364, 1, 0, 1
1508, 1, 1636424117242, 1636424118234, 992, 634, 358, 0, 0, 0
1513, 1, 1636424117326, 1636424118342, 1016, 658, 358, 0, 1, 1
1515, 1, 1636424117964, 1636424118582, 618, 263, 355, 0, 1, 1
1517, 1, 1636424117994, 1636424118630, 636, 279, 357, 3, 1, 4
1516, 1, 1636424117994, 1636424118630, 636, 280, 356, 1, 2, 3
1519, 1, 1636424118078, 1636424118718, 640, 278, 362, 3, 0, 3
1520, 1, 1636424118099, 1636424118722, 623, 267, 356, 2, 1, 3
1514, 1, 1636424117809, 1636424118794, 985, 629, 356, 0, 0, 0
1521, 1, 1636424118178, 1636424118806, 628, 274, 354, 0, 0, 0
1522, 1, 1636424118331, 1636424118954, 623, 270, 353, 1, 0, 1
1523, 1, 1636424118391, 1636424119022, 631, 270, 361, 1, 0, 1
1518, 1, 1636424118013, 1636424119030, 1017, 655, 362, 0, 0, 0
1524, 1, 1636424118491, 1636424119170, 679, 326, 353, 1, 0, 1
1525, 1, 1636424118583, 1636424119206, 623, 266, 357, 0, 0, 0
1526, 1, 1636424118593, 1636424119214, 621, 266, 355, 1, 0, 1
1527, 1, 1636424118604, 1636424119226, 622, 267, 355, 2, 0, 2
1528, 1, 1636424118615, 1636424119254, 639, 278, 361, 0, 0, 0
1530, 1, 1636424118690, 1636424119326, 636, 274, 362, 0, 0, 0
1529, 1, 1636424118661, 1636424119682, 1021, 662, 359, 0, 1, 1
1531, 1, 1636424119147, 1636424119778, 631, 274, 357, 0, 0, 0
1532, 1, 1636424119330, 1636424119950, 620, 265, 355, 0, 0, 0
1533, 1, 1636424119354, 1636424119978, 624, 271, 353, 2, 0, 2
1534, 1, 1636424119364, 1636424119990, 626, 277, 349, 3, 1, 4
1536, 1, 1636424119367, 1636424119994, 627, 278, 349, 0, 0, 0
1537, 1, 1636424119470, 1636424120094, 624, 262, 362, 1, 0, 1
1538, 1, 1636424119475, 1636424120094, 619, 261, 358, 1, 0, 1
1539, 1, 1636424119663, 1636424120290, 627, 271, 356, 1, 1, 2
1540, 1, 1636424119683, 1636424120314, 631, 275, 356, 2, 1, 3
1535, 1, 1636424119364, 1636424120406, 1042, 687, 355, 2, 2, 4
1542, 1, 1636424119882, 1636424120514, 632, 270, 362, 1, 0, 1
1541, 1, 1636424119842, 1636424120546, 704, 346, 358, 1, 0, 1
1543, 1, 1636424119926, 1636424120566, 640, 279, 361, 3, 0, 3
1544, 1, 1636424119930, 1636424120566, 636, 269, 367, 0, 0, 0
1545, 1, 1636424119940, 1636424120570, 630, 270, 360, 0, 0, 0
1547, 1, 1636424120062, 1636424120694, 632, 266, 366, 0, 0, 0
1546, 1, 1636424119987, 1636424121018, 1031, 675, 356, 1, 1, 2
1548, 1, 1636424120483, 1636424121106, 623, 267, 356, 0, 1, 1
1549, 1, 1636424120660, 1636424121282, 622, 270, 352, 1, 0, 1
1550, 1, 1636424120702, 1636424121330, 628, 269, 359, 2, 0, 2
1551, 1, 1636424120706, 1636424121330, 624, 266, 358, 0, 0, 0
1553, 1, 1636424120712, 1636424121334, 622, 271, 351, 1, 0, 1
1554, 1, 1636424120804, 1636424121430, 626, 267, 359, 0, 0, 0
1555, 1, 1636424120809, 1636424121438, 629, 266, 363, 1, 0, 1
1556, 1, 1636424120962, 1636424121590, 628, 269, 359, 1, 0, 1
1557, 1, 1636424121016, 1636424121638, 622, 273, 349, 2, 0, 2
1552, 1, 1636424120707, 1636424121782, 1075, 715, 360, 2, 0, 2
1558, 1, 1636424121194, 1636424121822, 628, 270, 358, 0, 0, 0
1560, 1, 1636424121246, 1636424121866, 620, 267, 353, 0, 0, 0
1561, 1, 1636424121249, 1636424121890, 641, 274, 367, 2, 0, 2
1559, 1, 1636424121226, 1636424121890, 664, 300, 364, 0, 0, 0
1562, 1, 1636424121291, 1636424121914, 623, 266, 357, 0, 0, 0
1564, 1, 1636424121384, 1636424122010, 626, 266, 360, 0, 0, 0
1563, 1, 1636424121306, 1636424122278, 972, 613, 359, 1, 0, 1
1565, 1, 1636424121779, 1636424122402, 623, 271, 352, 2, 0, 2
1566, 1, 1636424121985, 1636424122618, 633, 269, 364, 0, 0, 0
1567, 1, 1636424121991, 1636424122630, 639, 279, 360, 2, 0, 2
1568, 1, 1636424121993, 1636424122634, 641, 278, 363, 2, 0, 2
1570, 1, 1636424122066, 1636424122686, 620, 262, 358, 1, 0, 1
1571, 1, 1636424122149, 1636424122782, 633, 273, 360, 1, 0, 1
1572, 1, 1636424122151, 1636424122782, 631, 275, 356, 2, 0, 2
1573, 1, 1636424122236, 1636424122862, 626, 265, 361, 0, 0, 0
1574, 1, 1636424122377, 1636424122998, 621, 271, 350, 0, 0, 0
1569, 1, 1636424122022, 1636424123082, 1060, 706, 354, 1, 0, 1
1575, 1, 1636424122579, 1636424123194, 615, 264, 351, 1, 1, 2
1577, 1, 1636424122621, 1636424123246, 625, 271, 354, 1, 0, 1
1578, 1, 1636424122622, 1636424123246, 624, 275, 349, 1, 1, 2
1576, 1, 1636424122619, 1636424123250, 631, 274, 357, 1, 0, 1
1581, 1, 1636424122665, 1636424123290, 625, 266, 359, 2, 0, 2
1580, 1, 1636424122664, 1636424123290, 626, 270, 356, 1, 0, 1
1579, 1, 1636424122656, 1636424123642, 986, 630, 356, 0, 0, 0
1582, 1, 1636424123088, 1636424123714, 626, 271, 355, 1, 2, 3
1583, 1, 1636424123256, 1636424123882, 626, 270, 356, 0, 0, 0
1584, 1, 1636424123271, 1636424123914, 643, 275, 368, 1, 0, 1
1586, 1, 1636424123353, 1636424123986, 633, 271, 362, 1, 0, 1
1587, 1, 1636424123363, 1636424123994, 631, 270, 361, 1, 0, 1
1590, 1, 1636424123525, 1636424124146, 621, 269, 352, 0, 0, 0
1589, 1, 1636424123520, 1636424124150, 630, 271, 359, 1, 1, 2
1464, 2, 1636424114038, 1636424124217, 10179, 0, 10179, 0, 0, 0
1467, 2, 1636424114078, 1636424124262, 10184, 0, 10184, 0, 0, 0
1591, 1, 1636424123649, 1636424124274, 625, 274, 351, 1, 0, 1
1585, 1, 1636424123335, 1636424124358, 1023, 668, 355, 0, 0, 0
1588, 1, 1636424123497, 1636424124534, 1037, 671, 366, 1, 84, 85
1596, 1, 1636424123982, 1636424124626, 644, 281, 363, 1, 13, 14
1593, 1, 1636424123952, 1636424124626, 674, 314, 360, 1, 45, 46
1592, 1, 1636424123910, 1636424124626, 716, 355, 361, 2, 81, 83
1598, 1, 1636424124049, 1636424124710, 661, 305, 356, 1, 38, 39
1594, 1, 1636424123967, 1636424124986, 1019, 660, 359, 1, 2, 3
1479, 2, 1636424114839, 1636424125017, 10178, 0, 10178, 0, 0, 0
1595, 1, 1636424123976, 1636424125066, 1090, 742, 348, 1, 1, 2
1597, 1, 1636424124003, 1636424125070, 1067, 717, 350, 0, 2, 2
1600, 1, 1636424124544, 1636424125158, 614, 267, 347, 0, 1, 1
1601, 1, 1636424124582, 1636424125214, 632, 270, 362, 0, 0, 0
1603, 1, 1636424124685, 1636424125330, 645, 278, 367, 1, 0, 1
1605, 1, 1636424124848, 1636424125458, 610, 263, 347, 0, 1, 1
1606, 1, 1636424124855, 1636424125462, 607, 258, 349, 0, 0, 0
1607, 1, 1636424124870, 1636424125486, 616, 258, 358, 1, 0, 1
1608, 1, 1636424125041, 1636424125666, 625, 265, 360, 0, 1, 1
1602, 1, 1636424124653, 1636424125670, 1017, 654, 363, 2, 0, 2
1609, 1, 1636424125146, 1636424125822, 676, 270, 406, 0, 0, 0
1613, 1, 1636424125282, 1636424125906, 624, 270, 354, 0, 0, 0
1614, 1, 1636424125309, 1636424125942, 633, 270, 363, 0, 1, 1
1615, 1, 1636424125313, 1636424125942, 629, 266, 363, 0, 0, 0
1617, 1, 1636424125374, 1636424125998, 624, 266, 358, 1, 0, 1
1618, 1, 1636424125402, 1636424126030, 628, 266, 362, 0, 0, 0
1610, 1, 1636424125218, 1636424126126, 908, 546, 362, 0, 1, 1
1611, 1, 1636424125246, 1636424126266, 1020, 622, 398, 1, 1, 2
1616, 1, 1636424125334, 1636424126354, 1020, 671, 349, 0, 2, 2
1619, 1, 1636424125860, 1636424126498, 638, 277, 361, 0, 0, 0
1620, 1, 1636424125867, 1636424126502, 635, 269, 366, 0, 0, 0
1622, 1, 1636424126046, 1636424126674, 628, 263, 365, 1, 0, 1
1612, 1, 1636424125246, 1636424126730, 1484, 1081, 403, 1, 0, 1
1623, 1, 1636424126125, 1636424126750, 625, 270, 355, 0, 0, 0
1624, 1, 1636424126164, 1636424126786, 622, 271, 351, 1, 1, 2
1625, 1, 1636424126251, 1636424126870, 619, 267, 352, 1, 1, 2
1621, 1, 1636424125986, 1636424126946, 960, 603, 357, 1, 0, 1
1626, 1, 1636424126382, 1636424127002, 620, 271, 349, 0, 0, 0
1629, 1, 1636424126565, 1636424127198, 633, 271, 362, 0, 0, 0
1630, 1, 1636424126590, 1636424127210, 620, 267, 353, 1, 0, 1
1631, 1, 1636424126623, 1636424127238, 615, 262, 353, 0, 0, 0
1633, 1, 1636424126648, 1636424127262, 614, 265, 349, 0, 1, 1
1634, 1, 1636424126692, 1636424127318, 626, 271, 355, 3, 0, 3
1636, 1, 1636424126750, 1636424127430, 680, 279, 401, 2, 0, 2
1632, 1, 1636424126645, 1636424127646, 1001, 646, 355, 1, 1, 2
1637, 1, 1636424127219, 1636424127838, 619, 266, 353, 2, 0, 2
1638, 1, 1636424127259, 1636424127882, 623, 265, 358, 0, 0, 0
1640, 1, 1636424127395, 1636424128022, 627, 269, 358, 0, 0, 0
1641, 1, 1636424127465, 1636424128098, 633, 273, 360, 1, 0, 1
1642, 1, 1636424127496, 1636424128138, 642, 278, 364, 1, 0, 1
1643, 1, 1636424127591, 1636424128214, 623, 269, 354, 0, 0, 0
1644, 1, 1636424127671, 1636424128298, 627, 270, 357, 1, 0, 1
1639, 1, 1636424127333, 1636424128322, 989, 638, 351, 0, 0, 0
1645, 1, 1636424127846, 1636424128466, 620, 266, 354, 0, 0, 0
1646, 1, 1636424127878, 1636424128502, 624, 262, 362, 1, 0, 1
1647, 1, 1636424127969, 1636424128590, 621, 266, 355, 2, 0, 2
1649, 1, 1636424127975, 1636424128598, 623, 274, 349, 0, 0, 0
1650, 1, 1636424128018, 1636424128646, 628, 271, 357, 1, 0, 1
1651, 1, 1636424128073, 1636424128710, 637, 274, 363, 1, 0, 1
1648, 1, 1636424127972, 1636424128914, 942, 590, 352, 0, 1, 1
1652, 1, 1636424128559, 1636424129178, 619, 267, 352, 0, 1, 1
1653, 1, 1636424128641, 1636424129266, 625, 270, 355, 0, 1, 1
1655, 1, 1636424128691, 1636424129306, 615, 268, 347, 3, 0, 3
1656, 1, 1636424128793, 1636424129414, 621, 266, 355, 1, 0, 1
1657, 1, 1636424128835, 1636424129462, 627, 268, 359, 0, 1, 1
1658, 1, 1636424128860, 1636424129478, 618, 270, 348, 1, 1, 2
1659, 1, 1636424129035, 1636424129662, 627, 270, 357, 1, 0, 1
1654, 1, 1636424128689, 1636424129714, 1025, 670, 355, 1, 0, 1
1660, 1, 1636424129153, 1636424129778, 625, 270, 355, 0, 0, 0
1661, 1, 1636424129184, 1636424129798, 614, 258, 356, 0, 0, 0
1664, 1, 1636424129315, 1636424129946, 631, 270, 361, 0, 0, 0
1663, 1, 1636424129303, 1636424129946, 643, 278, 365, 1, 0, 1
1665, 1, 1636424129345, 1636424129970, 625, 267, 358, 1, 0, 1
1666, 1, 1636424129360, 1636424129978, 618, 263, 355, 1, 0, 1
1662, 1, 1636424129302, 1636424130234, 932, 567, 365, 1, 1, 2
1667, 1, 1636424129851, 1636424130486, 635, 274, 361, 1, 0, 1
1668, 1, 1636424129924, 1636424130558, 634, 277, 357, 1, 0, 1
1670, 1, 1636424130084, 1636424130722, 638, 277, 361, 0, 0, 0
1671, 1, 1636424130142, 1636424130766, 624, 270, 354, 0, 0, 0
1672, 1, 1636424130183, 1636424130814, 631, 274, 357, 2, 0, 2
1673, 1, 1636424130190, 1636424130826, 636, 269, 367, 0, 0, 0
1674, 1, 1636424130304, 1636424130930, 626, 275, 351, 3, 0, 3
1669, 1, 1636424130001, 1636424131014, 1013, 654, 359, 1, 0, 1
1676, 1, 1636424130585, 1636424131218, 633, 274, 359, 1, 0, 1
1678, 1, 1636424130626, 1636424131250, 624, 266, 358, 1, 0, 1
1679, 1, 1636424130693, 1636424131318, 625, 264, 361, 0, 1, 1
1680, 1, 1636424130709, 1636424131338, 629, 274, 355, 0, 0, 0
1681, 1, 1636424130735, 1636424131358, 623, 274, 349, 0, 0, 0
1682, 1, 1636424131141, 1636424131782, 641, 274, 367, 0, 0, 0
1683, 1, 1636424131253, 1636424131878, 625, 269, 356, 0, 0, 0
1686, 1, 1636424131417, 1636424132042, 625, 270, 355, 0, 0, 0
1689, 1, 1636424131604, 1636424132230, 626, 270, 356, 0, 2, 2
1684, 1, 1636424131305, 1636424132330, 1025, 671, 354, 0, 1, 1
1691, 1, 1636424131944, 1636424132570, 626, 269, 357, 0, 0, 0
1693, 1, 1636424132074, 1636424132702, 628, 270, 358, 0, 1, 1
1694, 1, 1636424132094, 1636424132722, 628, 268, 360, 0, 0, 0
1698, 1, 1636424132762, 1636424133390, 628, 269, 359, 0, 1, 1
1699, 1, 1636424132895, 1636424133526, 631, 271, 360, 1, 1, 2
1700, 1, 1636424133344, 1636424133970, 626, 270, 356, 0, 1, 1
1701, 1, 1636424133419, 1636424134042, 623, 266, 357, 0, 1, 1
1702, 1, 1636424133429, 1636424134054, 625, 271, 354, 0, 0, 0
1599, 2, 1636424124435, 1636424134570, 10135, 1, 10134, 0, 0, 0
1703, 1, 1636424134147, 1636424134774, 627, 270, 357, 1, 0, 1
1704, 1, 1636424134168, 1636424134838, 670, 310, 360, 0, 40, 40
1604, 2, 1636424124708, 1636424134845, 10137, 0, 10137, 0, 1, 1
1705, 1, 1636424134625, 1636424135294, 669, 314, 355, 0, 46, 46
1706, 1, 1636424134706, 1636424135334, 628, 271, 357, 1, 1, 2
1707, 1, 1636424134846, 1636424135430, 584, 271, 313, 0, 0, 0
1708, 1, 1636424134978, 1636424135646, 668, 265, 403, 0, 0, 0
1709, 1, 1636424135078, 1636424135754, 676, 270, 406, 1, 0, 1
1710, 1, 1636424135420, 1636424136050, 630, 273, 357, 2, 0, 2
1711, 1, 1636424135456, 1636424136082, 626, 272, 354, 0, 3, 3
1627, 2, 1636424126393, 1636424136529, 10136, 0, 10136, 0, 1, 1
1712, 1, 1636424135898, 1636424136534, 636, 278, 358, 0, 1, 1
1713, 1, 1636424135974, 1636424136602, 628, 270, 358, 1, 0, 1
1628, 2, 1636424126530, 1636424136665, 10135, 0, 10135, 0, 0, 0
1714, 1, 1636424136076, 1636424136698, 622, 266, 356, 1, 0, 1
1635, 2, 1636424126703, 1636424136833, 10130, 0, 10130, 0, 0, 0
1716, 1, 1636424136391, 1636424137034, 643, 282, 361, 0, 8, 8
1715, 1, 1636424136328, 1636424137038, 710, 346, 364, 2, 72, 74
1717, 1, 1636424136777, 1636424137414, 637, 270, 367, 1, 1, 2
1718, 1, 1636424136784, 1636424137418, 634, 267, 367, 2, 1, 3
1722, 1, 1636424137223, 1636424137854, 631, 270, 361, 1, 0, 1
1721, 1, 1636424136970, 1636424137870, 900, 497, 403, 0, 0, 0
1723, 1, 1636424137336, 1636424137958, 622, 269, 353, 1, 0, 1
1725, 1, 1636424137685, 1636424138314, 629, 270, 359, 0, 1, 1
1724, 1, 1636424137440, 1636424138334, 894, 534, 360, 1, 0, 1
1726, 1, 1636424137705, 1636424138342, 637, 275, 362, 2, 0, 2
1727, 1, 1636424138048, 1636424138670, 622, 269, 353, 0, 1, 1
1728, 1, 1636424138144, 1636424138766, 622, 262, 360, 1, 1, 2
1729, 1, 1636424138228, 1636424138850, 622, 269, 353, 1, 0, 1
1730, 1, 1636424138511, 1636424139134, 623, 270, 353, 2, 1, 3
1731, 1, 1636424138692, 1636424139318, 626, 269, 357, 1, 0, 1
1732, 1, 1636424138785, 1636424139414, 629, 263, 366, 0, 1, 1
1733, 1, 1636424139015, 1636424139646, 631, 268, 363, 1, 0, 1
1734, 1, 1636424139060, 1636424139686, 626, 275, 351, 1, 0, 1
1735, 1, 1636424139334, 1636424139966, 632, 269, 363, 0, 0, 0
1736, 1, 1636424139515, 1636424140146, 631, 274, 357, 0, 0, 0
1738, 1, 1636424139841, 1636424140474, 633, 270, 363, 0, 0, 0
1675, 2, 1636424130443, 1636424140581, 10138, 0, 10138, 0, 1, 1
1739, 1, 1636424139970, 1636424140594, 624, 268, 356, 0, 0, 0
1677, 2, 1636424130603, 1636424140741, 10138, 0, 10138, 0, 0, 0
1740, 1, 1636424140172, 1636424140802, 630, 270, 360, 0, 0, 0
1741, 1, 1636424140329, 1636424140958, 629, 271, 358, 2, 0, 2
1742, 1, 1636424140380, 1636424141030, 650, 294, 356, 1, 27, 28
1743, 1, 1636424140610, 1636424141274, 664, 266, 398, 1, 0, 1
1745, 1, 1636424140812, 1636424141446, 634, 269, 365, 0, 0, 0
1685, 2, 1636424131411, 1636424141545, 10134, 0, 10134, 0, 0, 0
1687, 2, 1636424131480, 1636424141613, 10133, 0, 10133, 1, 0, 1
1688, 2, 1636424131496, 1636424141661, 10165, 1, 10164, 0, 1, 1
1747, 1, 1636424141120, 1636424141746, 626, 269, 357, 1, 0, 1
1748, 1, 1636424141339, 1636424142026, 687, 331, 356, 1, 56, 57
1690, 2, 1636424131917, 1636424142057, 10140, 0, 10140, 0, 0, 0
1692, 2, 1636424131991, 1636424142125, 10134, 0, 10134, 0, 0, 0
1749, 1, 1636424141469, 1636424142202, 733, 319, 414, 48, 1, 49
1750, 1, 1636424141662, 1636424142318, 656, 305, 351, 1, 39, 40
1751, 1, 1636424141703, 1636424142338, 635, 275, 360, 1, 0, 1
1754, 1, 1636424141871, 1636424142574, 703, 310, 393, 2, 37, 39
1752, 1, 1636424141870, 1636424142582, 712, 312, 400, 1, 41, 42
1753, 1, 1636424141871, 1636424142582, 711, 309, 402, 1, 33, 34
1695, 1, 1636424132426, 1636424142614, 10188, 9832, 356, 1, 1, 2
1755, 1, 1636424141986, 1636424142658, 672, 266, 406, 1, 0, 1
1756, 1, 1636424142126, 1636424142754, 628, 270, 358, 0, 0, 0
1696, 2, 1636424132621, 1636424142757, 10136, 0, 10136, 0, 0, 0
1697, 2, 1636424132652, 1636424142805, 10153, 1, 10152, 1, 0, 1
1758, 1, 1636424142262, 1636424143070, 808, 415, 393, 2, 49, 51
1759, 1, 1636424142410, 1636424143070, 660, 305, 355, 0, 24, 24
1737, 1, 1636424139620, 1636424143290, 3670, 3326, 344, 0, 0, 0
1761, 1, 1636424142709, 1636424143338, 629, 317, 312, 49, 0, 49
1760, 1, 1636424142615, 1636424143342, 727, 319, 408, 48, 1, 49
1762, 1, 1636424142806, 1636424143430, 624, 271, 353, 1, 1, 2
1764, 1, 1636424142903, 1636424143522, 619, 266, 353, 1, 0, 1
1763, 1, 1636424142894, 1636424143558, 664, 265, 399, 0, 0, 0
1766, 1, 1636424143019, 1636424143642, 623, 265, 358, 0, 1, 1
1767, 1, 1636424143111, 1636424143738, 627, 274, 353, 2, 0, 2
1768, 1, 1636424143113, 1636424143742, 629, 269, 360, 1, 0, 1
1769, 1, 1636424143142, 1636424143762, 620, 267, 353, 0, 0, 0
1771, 1, 1636424143314, 1636424143938, 624, 269, 355, 0, 0, 0
1770, 1, 1636424143292, 1636424143970, 678, 278, 400, 0, 0, 0
1765, 1, 1636424142918, 1636424144006, 1088, 694, 394, 0, 1, 1
1772, 1, 1636424143402, 1636424144030, 628, 271, 357, 0, 0, 0
1773, 1, 1636424143516, 1636424144214, 698, 343, 355, 0, 0, 0
1774, 1, 1636424143692, 1636424144314, 622, 275, 347, 2, 1, 3
1775, 1, 1636424143921, 1636424144546, 625, 270, 355, 0, 1, 1
1776, 1, 1636424144006, 1636424144634, 628, 270, 358, 1, 0, 1
1777, 1, 1636424144046, 1636424144666, 620, 271, 349, 1, 0, 1
1778, 1, 1636424144160, 1636424144782, 622, 270, 352, 0, 0, 0
1779, 1, 1636424144169, 1636424144790, 621, 271, 350, 2, 0, 2
1781, 1, 1636424144309, 1636424144946, 637, 276, 361, 0, 2, 2
1782, 1, 1636424144450, 1636424145074, 624, 266, 358, 0, 0, 0
1784, 1, 1636424144503, 1636424145126, 623, 270, 353, 0, 0, 0
1783, 1, 1636424144501, 1636424145134, 633, 270, 363, 0, 0, 0
1780, 1, 1636424144194, 1636424145234, 1040, 682, 358, 0, 0, 0
1786, 1, 1636424144647, 1636424145270, 623, 270, 353, 1, 0, 1
1787, 1, 1636424144704, 1636424145326, 622, 270, 352, 0, 0, 0
1788, 1, 1636424144839, 1636424145530, 691, 333, 358, 0, 0, 0
1785, 1, 1636424144588, 1636424145574, 986, 638, 348, 1, 0, 1
1789, 1, 1636424145060, 1636424145682, 622, 269, 353, 1, 0, 1
1792, 1, 1636424145323, 1636424145946, 623, 270, 353, 0, 0, 0
1791, 1, 1636424145314, 1636424145954, 640, 274, 366, 0, 1, 1
1790, 1, 1636424145308, 1636424146022, 714, 362, 352, 0, 0, 0
1793, 1, 1636424145462, 1636424146090, 628, 270, 358, 1, 0, 1
1794, 1, 1636424145476, 1636424146102, 626, 271, 355, 0, 1, 1
1796, 1, 1636424145587, 1636424146210, 623, 272, 351, 1, 2, 3
1797, 1, 1636424145771, 1636424146406, 635, 274, 361, 0, 0, 0
1798, 1, 1636424145848, 1636424146466, 618, 265, 353, 0, 0, 0
1799, 1, 1636424145859, 1636424146482, 623, 270, 353, 1, 0, 1
1800, 1, 1636424145889, 1636424146518, 629, 266, 363, 1, 0, 1
1795, 1, 1636424145511, 1636424146538, 1027, 670, 357, 1, 0, 1
1801, 1, 1636424145944, 1636424146566, 622, 267, 355, 1, 1, 2
1802, 1, 1636424146048, 1636424146674, 626, 274, 352, 0, 0, 0
1803, 1, 1636424146138, 1636424146862, 724, 363, 361, 0, 1, 1
1719, 2, 1636424136879, 1636424147057, 10178, 0, 10178, 1, 0, 1
1720, 2, 1636424136880, 1636424147101, 10221, 1, 10220, 1, 0, 1
1806, 1, 1636424146717, 1636424147366, 649, 293, 356, 0, 27, 27
1804, 1, 1636424146678, 1636424147366, 688, 290, 398, 1, 20, 21
1805, 1, 1636424146688, 1636424147366, 678, 277, 401, 1, 3, 4
1810, 1, 1636424146891, 1636424147550, 659, 305, 354, 2, 35, 37
1811, 1, 1636424147057, 1636424147686, 629, 276, 353, 2, 0, 2
1813, 1, 1636424147134, 1636424147758, 624, 270, 354, 2, 0, 2
1807, 1, 1636424146797, 1636424147810, 1013, 659, 354, 1, 1, 2
1816, 1, 1636424147197, 1636424147818, 621, 270, 351, 0, 0, 0
1817, 1, 1636424147252, 1636424147862, 610, 258, 352, 0, 0, 0
1818, 1, 1636424147318, 1636424147942, 624, 271, 353, 0, 1, 1
1819, 1, 1636424147440, 1636424148142, 702, 341, 361, 0, 0, 0
1821, 1, 1636424148010, 1636424148638, 628, 271, 357, 1, 1, 2
1822, 1, 1636424148073, 1636424148706, 633, 270, 363, 0, 0, 0
1823, 1, 1636424148112, 1636424148742, 630, 270, 360, 0, 0, 0
1825, 1, 1636424148349, 1636424148974, 625, 270, 355, 0, 0, 0
1824, 1, 1636424148172, 1636424149162, 990, 635, 355, 1, 1, 2
1827, 1, 1636424148581, 1636424149206, 625, 271, 354, 0, 1, 1
1828, 1, 1636424148592, 1636424149214, 622, 271, 351, 1, 1, 2
1830, 1, 1636424148725, 1636424149434, 709, 345, 364, 1, 0, 1
1829, 1, 1636424148655, 1636424149610, 955, 602, 353, 0, 0, 0
1831, 1, 1636424149284, 1636424149914, 630, 273, 357, 0, 0, 0
1832, 1, 1636424149398, 1636424150030, 632, 273, 359, 1, 0, 1
1833, 1, 1636424149434, 1636424150062, 628, 269, 359, 1, 0, 1
1834, 1, 1636424149501, 1636424150138, 637, 270, 367, 2, 0, 2
1835, 1, 1636424149679, 1636424150306, 627, 261, 366, 1, 0, 1
1836, 1, 1636424149948, 1636424150570, 622, 271, 351, 1, 1, 2
1837, 1, 1636424149956, 1636424150578, 622, 268, 354, 0, 0, 0
1838, 1, 1636424150023, 1636424150654, 631, 274, 357, 2, 1, 3
1839, 1, 1636424150055, 1636424150758, 703, 340, 363, 0, 0, 0
1744, 2, 1636424140742, 1636424150925, 10183, 0, 10183, 0, 0, 0
1746, 2, 1636424140870, 1636424151049, 10179, 0, 10179, 1, 0, 1
1840, 1, 1636424150648, 1636424151314, 666, 314, 352, 1, 47, 48
1841, 1, 1636424150674, 1636424151318, 644, 285, 359, 0, 11, 11
1842, 1, 1636424150744, 1636424151406, 662, 306, 356, 1, 39, 40
1843, 1, 1636424150832, 1636424151502, 670, 305, 365, 0, 40, 40
1757, 1, 1636424142218, 1636424151534, 9316, 8918, 398, 0, 0, 0
1844, 1, 1636424151050, 1636424151674, 624, 266, 358, 0, 0, 0
1848, 1, 1636424151224, 1636424151854, 630, 270, 360, 3, 0, 3
1847, 1, 1636424151223, 1636424151854, 631, 271, 360, 3, 0, 3
1849, 1, 1636424151398, 1636424152034, 636, 280, 356, 1, 1, 2
1850, 1, 1636424151429, 1636424152122, 693, 335, 358, 1, 1, 2
1852, 1, 1636424151917, 1636424152542, 625, 269, 356, 1, 1, 2
1853, 1, 1636424152011, 1636424152630, 619, 270, 349, 1, 1, 2
1854, 1, 1636424152100, 1636424152722, 622, 266, 356, 0, 1, 1
1855, 1, 1636424152144, 1636424152766, 622, 268, 354, 2, 0, 2
1856, 1, 1636424152317, 1636424152942, 625, 267, 358, 2, 0, 2
1858, 1, 1636424152528, 1636424153154, 626, 269, 357, 1, 1, 2
1857, 1, 1636424152525, 1636424153158, 633, 271, 362, 3, 0, 3
1859, 1, 1636424152679, 1636424153306, 627, 269, 358, 0, 0, 0
1860, 1, 1636424152700, 1636424153394, 694, 338, 356, 1, 0, 1
1861, 1, 1636424153219, 1636424153846, 627, 269, 358, 0, 0, 0
1862, 1, 1636424153339, 1636424153966, 627, 270, 357, 0, 1, 1
1863, 1, 1636424153451, 1636424154078, 627, 273, 354, 1, 0, 1
1864, 1, 1636424153496, 1636424154122, 626, 269, 357, 0, 0, 0
1865, 1, 1636424153591, 1636424154214, 623, 266, 357, 0, 0, 0
1866, 1, 1636424153796, 1636424154422, 626, 264, 362, 0, 0, 0
1867, 1, 1636424153819, 1636424154446, 627, 266, 361, 0, 1, 1
1868, 1, 1636424153995, 1636424154666, 671, 312, 359, 1, 0, 1
1869, 1, 1636424154051, 1636424154682, 631, 269, 362, 0, 0, 0
1870, 1, 1636424154543, 1636424155174, 631, 272, 359, 1, 1, 2
1871, 1, 1636424154613, 1636424155242, 629, 266, 363, 0, 2, 2
1872, 1, 1636424154774, 1636424155406, 632, 270, 362, 0, 1, 1
1873, 1, 1636424154799, 1636424155426, 627, 270, 357, 1, 2, 3
1874, 1, 1636424154879, 1636424155510, 631, 270, 361, 0, 0, 0
1875, 1, 1636424155123, 1636424155758, 635, 270, 365, 0, 0, 0
1876, 1, 1636424155206, 1636424155834, 628, 272, 356, 1, 1, 2
1877, 1, 1636424155289, 1636424155970, 681, 318, 363, 1, 0, 1
1878, 1, 1636424155402, 1636424156030, 628, 271, 357, 1, 0, 1
1879, 1, 1636424155901, 1636424156542, 641, 271, 370, 2, 1, 3
1880, 1, 1636424155928, 1636424156558, 630, 275, 355, 1, 1, 2
1881, 1, 1636424156049, 1636424156674, 625, 270, 355, 0, 0, 0
1882, 1, 1636424156097, 1636424156722, 625, 265, 360, 1, 0, 1
1883, 1, 1636424156186, 1636424156810, 624, 269, 355, 0, 0, 0
1808, 2, 1636424146848, 1636424156982, 10134, 1, 10133, 1, 0, 1
1809, 2, 1636424146856, 1636424157029, 10173, 0, 10173, 0, 0, 0
1885, 1, 1636424156546, 1636424157178, 632, 270, 362, 1, 0, 1
1812, 2, 1636424147122, 1636424157257, 10135, 0, 10135, 0, 0, 0
1886, 1, 1636424156623, 1636424157298, 675, 317, 358, 1, 32, 33
1815, 2, 1636424147191, 1636424157369, 10178, 0, 10178, 1, 0, 1
1887, 1, 1636424156750, 1636424157390, 640, 277, 363, 1, 8, 9
1814, 2, 1636424147190, 1636424157417, 10227, 1, 10226, 1, 0, 1
1826, 1, 1636424148475, 1636424157522, 9047, 8694, 353, 2, 1, 3
1888, 1, 1636424157257, 1636424157870, 613, 298, 315, 0, 25, 25
1889, 1, 1636424157268, 1636424157962, 694, 322, 372, 50, 2, 52
1890, 1, 1636424157370, 1636424158002, 632, 272, 360, 2, 1, 3
1892, 1, 1636424157491, 1636424158114, 623, 264, 359, 1, 0, 1
1820, 2, 1636424148002, 1636424158137, 10135, 1, 10134, 1, 0, 1
1897, 1, 1636424157538, 1636424158174, 636, 266, 370, 1, 0, 1
1898, 1, 1636424157539, 1636424158206, 667, 270, 397, 1, 0, 1
1891, 1, 1636424157418, 1636424158418, 1000, 600, 400, 2, 0, 2
1899, 1, 1636424157885, 1636424158530, 645, 279, 366, 0, 1, 1
1900, 1, 1636424157993, 1636424158630, 637, 279, 358, 0, 1, 1
1901, 1, 1636424158031, 1636424158674, 643, 269, 374, 1, 0, 1
1902, 1, 1636424158270, 1636424158950, 680, 271, 409, 2, 1, 3
1903, 1, 1636424158554, 1636424159182, 628, 271, 357, 1, 1, 2
1904, 1, 1636424158616, 1636424159242, 626, 273, 353, 0, 0, 0
1905, 1, 1636424158660, 1636424159286, 626, 266, 360, 1, 0, 1
1907, 1, 1636424158860, 1636424159494, 634, 274, 360, 1, 0, 1
1908, 1, 1636424158931, 1636424159558, 627, 273, 354, 2, 0, 2
1909, 1, 1636424158932, 1636424159562, 630, 273, 357, 1, 0, 1
1906, 1, 1636424158678, 1636424159686, 1008, 654, 354, 0, 0, 0
1910, 1, 1636424159169, 1636424159786, 617, 259, 358, 0, 0, 0
1911, 1, 1636424159385, 1636424160018, 633, 270, 363, 0, 0, 0
1912, 1, 1636424159389, 1636424160022, 633, 270, 363, 0, 0, 0
1913, 1, 1636424159588, 1636424160222, 634, 270, 364, 2, 0, 2
1914, 1, 1636424159924, 1636424160554, 630, 267, 363, 2, 0, 2
1915, 1, 1636424159928, 1636424160554, 626, 267, 359, 0, 0, 0
1917, 1, 1636424160011, 1636424160634, 623, 269, 354, 0, 0, 0
1918, 1, 1636424160198, 1636424160834, 636, 270, 366, 0, 0, 0
1919, 1, 1636424160254, 1636424160874, 620, 270, 350, 1, 0, 1
1920, 1, 1636424160284, 1636424160910, 626, 269, 357, 0, 0, 0
1916, 1, 1636424159994, 1636424160990, 996, 651, 345, 0, 0, 0
1921, 1, 1636424160564, 1636424161190, 626, 262, 364, 0, 0, 0
1845, 2, 1636424151054, 1636424161233, 10179, 1, 10178, 1, 0, 1
1922, 1, 1636424160710, 1636424161334, 624, 270, 354, 0, 0, 0
1923, 1, 1636424160723, 1636424161354, 631, 271, 360, 2, 0, 2
1846, 2, 1636424151178, 1636424161361, 10183, 0, 10183, 0, 0, 0
1924, 1, 1636424160897, 1636424161530, 633, 269, 364, 1, 0, 1
1851, 2, 1636424151554, 1636424161733, 10179, 0, 10179, 0, 0, 0
1925, 1, 1636424161234, 1636424161814, 580, 271, 309, 0, 1, 1
1926, 1, 1636424161285, 1636424161950, 665, 271, 394, 1, 0, 1
1929, 1, 1636424161387, 1636424162014, 627, 270, 357, 3, 0, 3
1930, 1, 1636424161489, 1636424162122, 633, 274, 359, 1, 0, 1
1884, 1, 1636424156435, 1636424162226, 5791, 5430, 361, 0, 1, 1
1933, 1, 1636424161648, 1636424162274, 626, 268, 358, 1, 0, 1
1927, 1, 1636424161362, 1636424162398, 1036, 679, 357, 1, 1, 2
1935, 1, 1636424161881, 1636424162506, 625, 270, 355, 0, 0, 0
1936, 1, 1636424162009, 1636424162642, 633, 273, 360, 1, 0, 1
1937, 1, 1636424162116, 1636424162742, 626, 270, 356, 1, 0, 1
1939, 1, 1636424162252, 1636424162874, 622, 267, 355, 2, 0, 2
1938, 1, 1636424162228, 1636424162898, 670, 274, 396, 0, 0, 0
1940, 1, 1636424162478, 1636424163110, 632, 270, 362, 0, 0, 0
1941, 1, 1636424162601, 1636424163230, 629, 271, 358, 2, 0, 2
1942, 1, 1636424162655, 1636424163286, 631, 271, 360, 0, 2, 2
1944, 1, 1636424162774, 1636424163554, 780, 423, 357, 2, 1, 3
1945, 1, 1636424162922, 1636424163554, 632, 269, 363, 1, 0, 1
1943, 1, 1636424162662, 1636424163686, 1024, 665, 359, 1, 0, 1
1946, 1, 1636424163216, 1636424163830, 614, 263, 351, 0, 0, 0
1947, 1, 1636424163294, 1636424164010, 716, 359, 357, 0, 1, 1
1948, 1, 1636424163501, 1636424164134, 633, 278, 355, 0, 1, 1
1949, 1, 1636424163582, 1636424164214, 632, 270, 362, 0, 2, 2
1950, 1, 1636424163590, 1636424164214, 624, 269, 355, 0, 0, 0
1951, 1, 1636424163762, 1636424164466, 704, 347, 357, 1, 1, 2
1952, 1, 1636424163937, 1636424164570, 633, 271, 362, 1, 0, 1
1955, 1, 1636424164091, 1636424164726, 635, 271, 364, 0, 0, 0
1953, 1, 1636424163960, 1636424164914, 954, 597, 357, 1, 1, 2
1956, 1, 1636424164290, 1636424164918, 628, 270, 358, 2, 0, 2
1954, 1, 1636424164017, 1636424165026, 1009, 642, 367, 0, 0, 0
1957, 1, 1636424164548, 1636424165174, 626, 270, 356, 0, 0, 0
1958, 1, 1636424164604, 1636424165230, 626, 270, 356, 0, 0, 0
1959, 1, 1636424164810, 1636424165438, 628, 270, 358, 2, 0, 2
1961, 1, 1636424164941, 1636424165578, 637, 270, 367, 1, 0, 1
1962, 1, 1636424165054, 1636424165682, 628, 271, 357, 1, 1, 2
1963, 1, 1636424165262, 1636424165890, 628, 270, 358, 1, 0, 1
1964, 1, 1636424165273, 1636424165894, 621, 269, 352, 0, 0, 0
1966, 1, 1636424165403, 1636424166030, 627, 271, 356, 1, 1, 2
1967, 1, 1636424165657, 1636424166290, 633, 275, 358, 2, 0, 2
1965, 1, 1636424165325, 1636424166346, 1021, 658, 363, 2, 0, 2
1968, 1, 1636424165871, 1636424166494, 623, 269, 354, 2, 0, 2
1969, 1, 1636424165940, 1636424166562, 622, 271, 351, 1, 0, 1
1970, 1, 1636424166174, 1636424166798, 624, 270, 354, 0, 0, 0
1971, 1, 1636424166267, 1636424166890, 623, 270, 353, 1, 0, 1
1972, 1, 1636424166321, 1636424166954, 633, 277, 356, 0, 0, 0
1973, 1, 1636424166576, 1636424167202, 626, 271, 355, 0, 1, 1
1974, 1, 1636424166654, 1636424167278, 624, 270, 354, 0, 0, 0
1976, 1, 1636424166770, 1636424167394, 624, 266, 358, 0, 0, 0
1977, 1, 1636424166998, 1636424167626, 628, 270, 358, 0, 0, 0
1895, 2, 1636424157507, 1636424167685, 10178, 2, 10176, 3, 0, 3
1893, 2, 1636424157507, 1636424167733, 10226, 2, 10224, 3, 1, 4
1975, 1, 1636424166658, 1636424167742, 1084, 721, 363, 0, 0, 0
1896, 2, 1636424157510, 1636424167777, 10267, 1, 10266, 2, 0, 2
1894, 2, 1636424157507, 1636424167821, 10314, 1, 10313, 1, 0, 1
1978, 1, 1636424167239, 1636424167862, 623, 270, 353, 1, 0, 1
1979, 1, 1636424167299, 1636424168086, 787, 298, 489, 0, 24, 24
1980, 1, 1636424167540, 1636424168278, 738, 381, 357, 1, 108, 109
1932, 1, 1636424161633, 1636424168306, 6673, 6307, 366, 1, 0, 1
1981, 1, 1636424167686, 1636424168354, 668, 266, 402, 0, 0, 0
1982, 1, 1636424167822, 1636424168398, 576, 271, 305, 2, 0, 2
1983, 1, 1636424167842, 1636424168466, 624, 271, 353, 0, 0, 0
1984, 1, 1636424167906, 1636424168566, 660, 266, 394, 0, 0, 0
1985, 1, 1636424167910, 1636424168590, 680, 270, 410, 1, 0, 1
1988, 1, 1636424167995, 1636424168614, 619, 267, 352, 0, 0, 0
1990, 1, 1636424168069, 1636424168694, 625, 266, 359, 0, 0, 0
1992, 1, 1636424168307, 1636424168966, 659, 262, 397, 0, 1, 1
1987, 1, 1636424167914, 1636424169022, 1108, 702, 406, 2, 0, 2
1986, 1, 1636424167914, 1636424169042, 1128, 722, 406, 2, 0, 2
1989, 1, 1636424168045, 1636424169066, 1021, 658, 363, 0, 0, 0
1993, 1, 1636424168538, 1636424169170, 632, 274, 358, 0, 0, 0
1994, 1, 1636424168596, 1636424169230, 634, 274, 360, 1, 0, 1
1995, 1, 1636424168913, 1636424169546, 633, 270, 363, 0, 0, 0
1997, 1, 1636424169008, 1636424169630, 622, 271, 351, 1, 1, 2
1996, 1, 1636424169002, 1636424169634, 632, 270, 362, 2, 0, 2
1998, 1, 1636424169203, 1636424169838, 635, 273, 362, 1, 0, 1
1999, 1, 1636424169209, 1636424169838, 629, 270, 359, 1, 0, 1
2000, 1, 1636424169217, 1636424169850, 633, 275, 358, 1, 0, 1
2003, 1, 1636424169278, 1636424169898, 620, 267, 353, 1, 0, 1
2005, 1, 1636424169462, 1636424170094, 632, 266, 366, 0, 0, 0
2006, 1, 1636424169597, 1636424170214, 617, 262, 355, 0, 0, 0
2002, 1, 1636424169247, 1636424170286, 1039, 683, 356, 0, 1, 1
2001, 1, 1636424169224, 1636424170290, 1066, 719, 347, 0, 1, 1
2004, 1, 1636424169356, 1636424170350, 994, 630, 364, 0, 0, 0
2007, 1, 1636424169890, 1636424170506, 616, 270, 346, 0, 0, 0
2008, 1, 1636424169931, 1636424170562, 631, 271, 360, 0, 1, 1
2010, 1, 1636424170334, 1636424170966, 632, 269, 363, 0, 0, 0
2011, 1, 1636424170366, 1636424171006, 640, 283, 357, 1, 0, 1
2012, 1, 1636424170508, 1636424171134, 626, 270, 356, 0, 0, 0
2013, 1, 1636424170517, 1636424171142, 625, 270, 355, 0, 0, 0
2014, 1, 1636424170542, 1636424171166, 624, 266, 358, 0, 1, 1
2016, 1, 1636424170557, 1636424171186, 629, 271, 358, 1, 0, 1
2019, 1, 1636424170802, 1636424171426, 624, 271, 353, 1, 0, 1
2020, 1, 1636424170864, 1636424171490, 626, 269, 357, 1, 0, 1
1928, 2, 1636424161363, 1636424171553, 10190, 0, 10190, 0, 0, 0
2015, 1, 1636424170556, 1636424171590, 1034, 674, 360, 2, 0, 2
2018, 1, 1636424170674, 1636424171618, 944, 587, 357, 1, 0, 1
2017, 1, 1636424170593, 1636424171634, 1041, 686, 355, 0, 0, 0
1931, 2, 1636424161490, 1636424171669, 10179, 1, 10178, 2, 0, 2
2021, 1, 1636424171203, 1636424171822, 619, 264, 355, 1, 1, 2
2022, 1, 1636424171273, 1636424171942, 669, 306, 363, 0, 35, 35
1934, 2, 1636424161866, 1636424172045, 10179, 0, 10179, 0, 0, 0
2023, 1, 1636424171671, 1636424172262, 591, 279, 312, 0, 1, 1
2024, 1, 1636424171678, 1636424172346, 668, 270, 398, 0, 0, 0
2025, 1, 1636424171744, 1636424172402, 658, 306, 352, 0, 16, 16
2027, 1, 1636424171818, 1636424172434, 616, 267, 349, 0, 0, 0
2028, 1, 1636424171892, 1636424172514, 622, 269, 353, 0, 0, 0
2031, 1, 1636424171901, 1636424172518, 617, 261, 356, 0, 0, 0
2034, 1, 1636424172091, 1636424172714, 623, 266, 357, 0, 0, 0
2026, 1, 1636424171803, 1636424172802, 999, 599, 400, 2, 0, 2
2033, 1, 1636424171976, 1636424172882, 906, 526, 380, 0, 0, 0
2032, 1, 1636424171948, 1636424172974, 1026, 658, 368, 1, 0, 1
2038, 1, 1636424172551, 1636424173186, 635, 274, 361, 0, 0, 0
2037, 1, 1636424172506, 1636424173250, 744, 392, 352, 2, 0, 2
2039, 1, 1636424172940, 1636424173574, 634, 283, 351, 2, 0, 2
2040, 1, 1636424173000, 1636424173618, 618, 266, 352, 1, 0, 1
2041, 1, 1636424173019, 1636424173646, 627, 271, 356, 1, 0, 1
2036, 1, 1636424172174, 1636424173702, 1528, 1126, 402, 0, 1, 1
2044, 1, 1636424173169, 1636424173790, 621, 266, 355, 1, 1, 2
2046, 1, 1636424173277, 1636424173910, 633, 270, 363, 0, 0, 0
2048, 1, 1636424173384, 1636424174010, 626, 270, 356, 0, 0, 0
2042, 1, 1636424173098, 1636424174066, 968, 615, 353, 0, 0, 0
2045, 1, 1636424173255, 1636424174246, 991, 626, 365, 0, 0, 0
2049, 1, 1636424173703, 1636424174382, 679, 275, 404, 2, 1, 3
2050, 1, 1636424173808, 1636424174438, 630, 266, 364, 0, 0, 0
2051, 1, 1636424173833, 1636424174470, 637, 274, 363, 1, 1, 2
2053, 1, 1636424174312, 1636424174934, 622, 269, 353, 0, 1, 1
2054, 1, 1636424174355, 1636424174990, 635, 269, 366, 0, 0, 0
1960, 2, 1636424164855, 1636424174993, 10138, 1, 10137, 1, 0, 1
2056, 1, 1636424174501, 1636424175130, 629, 271, 358, 0, 1, 1
2058, 1, 1636424174588, 1636424175262, 674, 270, 404, 1, 0, 1
2055, 1, 1636424174441, 1636424175446, 1005, 647, 358, 1, 3, 4
2059, 1, 1636424174783, 1636424175458, 675, 306, 369, 2, 36, 38
2057, 1, 1636424174567, 1636424175578, 1011, 657, 354, 0, 0, 0
2060, 1, 1636424175055, 1636424175682, 627, 274, 353, 0, 0, 0
2061, 1, 1636424175122, 1636424175790, 668, 270, 398, 1, 0, 1
2063, 1, 1636424175198, 1636424175822, 624, 267, 357, 0, 1, 1
2062, 1, 1636424175172, 1636424175906, 734, 381, 353, 0, 0, 0
2064, 1, 1636424175711, 1636424176362, 651, 294, 357, 0, 1, 1
2065, 1, 1636424175746, 1636424176374, 628, 266, 362, 0, 0, 0
2067, 1, 1636424175864, 1636424176490, 626, 269, 357, 1, 0, 1
2068, 1, 1636424175900, 1636424176526, 626, 270, 356, 0, 0, 0
2070, 1, 1636424176064, 1636424176690, 626, 274, 352, 0, 0, 0
2066, 1, 1636424175776, 1636424176818, 1042, 691, 351, 0, 0, 0
2069, 1, 1636424175916, 1636424176942, 1026, 670, 356, 0, 0, 0
2071, 1, 1636424176395, 1636424177026, 631, 267, 364, 0, 0, 0
2072, 1, 1636424176451, 1636424177078, 627, 265, 362, 0, 0, 0
2073, 1, 1636424176489, 1636424177130, 641, 287, 354, 0, 0, 0
2074, 1, 1636424176503, 1636424177134, 631, 267, 364, 0, 1, 1
2075, 1, 1636424177003, 1636424177630, 627, 266, 361, 0, 0, 0
2076, 1, 1636424177024, 1636424177654, 630, 270, 360, 0, 0, 0
2078, 1, 1636424177221, 1636424177854, 633, 274, 359, 0, 0, 0
2080, 1, 1636424177300, 1636424177930, 630, 270, 360, 1, 1, 2
2081, 1, 1636424177371, 1636424177998, 627, 271, 356, 1, 1, 2
2077, 1, 1636424177086, 1636424178110, 1024, 665, 359, 0, 0, 0
2079, 1, 1636424177262, 1636424178306, 1044, 691, 353, 2, 0, 2
2082, 1, 1636424177733, 1636424178366, 633, 270, 363, 0, 0, 0
2083, 1, 1636424177760, 1636424178390, 630, 273, 357, 0, 0, 0
1991, 2, 1636424168296, 1636424178430, 10134, 0, 10134, 0, 0, 0
2084, 1, 1636424177796, 1636424178446, 650, 294, 356, 0, 0, 0
2085, 1, 1636424177854, 1636424178474, 620, 266, 354, 0, 0, 0
2086, 1, 1636424178290, 1636424178922, 632, 274, 358, 0, 0, 0
2087, 1, 1636424178309, 1636424178966, 657, 269, 388, 1, 0, 1
2089, 1, 1636424178541, 1636424179186, 645, 275, 370, 1, 0, 1
2092, 1, 1636424178598, 1636424179222, 624, 271, 353, 4, 0, 4
2090, 1, 1636424178558, 1636424179230, 672, 269, 403, 1, 0, 1
2093, 1, 1636424178750, 1636424179370, 620, 268, 352, 1, 0, 1
2088, 1, 1636424178431, 1636424179374, 943, 587, 356, 1, 1, 2
2091, 1, 1636424178568, 1636424179630, 1062, 703, 359, 0, 1, 1
2095, 1, 1636424179103, 1636424179722, 619, 257, 362, 0, 0, 0
2094, 1, 1636424179097, 1636424179722, 625, 261, 364, 1, 0, 1
2096, 1, 1636424179185, 1636424179826, 641, 282, 359, 0, 0, 0
2097, 1, 1636424179200, 1636424179834, 634, 274, 360, 0, 0, 0
2098, 1, 1636424179640, 1636424180254, 614, 266, 348, 1, 0, 1
2099, 1, 1636424179663, 1636424180282, 619, 266, 353, 0, 0, 0
2009, 2, 1636424170236, 1636424180373, 10137, 1, 10136, 0, 0, 0
2101, 1, 1636424179839, 1636424180462, 623, 268, 355, 0, 0, 0
2102, 1, 1636424179879, 1636424180506, 627, 268, 359, 0, 0, 0
2103, 1, 1636424179904, 1636424180530, 626, 270, 356, 2, 0, 2
2100, 1, 1636424179743, 1636424180722, 979, 631, 348, 0, 24, 24
2105, 1, 1636424180139, 1636424180766, 627, 271, 356, 1, 1, 2
2035, 1, 1636424172167, 1636424180878, 8711, 8345, 366, 0, 0, 0
2104, 1, 1636424179909, 1636424180962, 1053, 694, 359, 1, 0, 1
2106, 1, 1636424180390, 1636424181018, 628, 269, 359, 0, 0, 0
2107, 1, 1636424180446, 1636424181074, 628, 270, 358, 1, 0, 1
2108, 1, 1636424180502, 1636424181178, 676, 270, 406, 0, 0, 0
2109, 1, 1636424180545, 1636424181218, 673, 313, 360, 0, 0, 0
2110, 1, 1636424180880, 1636424181546, 666, 271, 395, 0, 1, 1
2111, 1, 1636424180997, 1636424181622, 625, 271, 354, 0, 0, 0
2112, 1, 1636424181052, 1636424181678, 626, 274, 352, 1, 0, 1
2114, 1, 1636424181147, 1636424181770, 623, 269, 354, 0, 0, 0
2115, 1, 1636424181213, 1636424181834, 621, 262, 359, 1, 0, 1
2117, 1, 1636424181284, 1636424181906, 622, 266, 356, 1, 0, 1
2029, 2, 1636424171896, 1636424182033, 10137, 1, 10136, 0, 0, 0
2113, 1, 1636424181098, 1636424182074, 976, 618, 358, 1, 0, 1
2030, 2, 1636424171900, 1636424182081, 10181, 1, 10180, 1, 0, 1
2118, 1, 1636424181538, 1636424182158, 620, 267, 353, 1, 0, 1
2116, 1, 1636424181253, 1636424182346, 1093, 690, 403, 1, 12, 13
2120, 1, 1636424181775, 1636424182434, 659, 310, 349, 0, 39, 39
2119, 1, 1636424181726, 1636424182434, 708, 311, 397, 0, 40, 40
2121, 1, 1636424181781, 1636424182438, 657, 306, 351, 1, 29, 30
2122, 1, 1636424181919, 1636424182618, 699, 315, 384, 48, 2, 50
2123, 1, 1636424182156, 1636424182782, 626, 270, 356, 1, 1, 2
2124, 1, 1636424182170, 1636424182838, 668, 272, 396, 0, 0, 0
2126, 1, 1636424182276, 1636424183074, 798, 442, 356, 0, 0, 0
2129, 1, 1636424182479, 1636424183106, 627, 275, 352, 0, 0, 0
2130, 1, 1636424182498, 1636424183142, 644, 273, 371, 1, 0, 1
2043, 2, 1636424173121, 1636424183261, 10140, 0, 10140, 0, 0, 0
2125, 1, 1636424182170, 1636424183286, 1116, 719, 397, 0, 1, 1
2132, 1, 1636424182674, 1636424183290, 616, 262, 354, 0, 0, 0
2047, 2, 1636424173297, 1636424183433, 10136, 1, 10135, 0, 1, 1
2133, 1, 1636424182840, 1636424183458, 618, 266, 352, 0, 0, 0
2131, 1, 1636424182578, 1636424183554, 976, 622, 354, 0, 0, 0
2134, 1, 1636424183007, 1636424183630, 623, 265, 358, 0, 1, 1
2135, 1, 1636424183080, 1636424183706, 626, 270, 356, 0, 7, 7
2136, 1, 1636424183095, 1636424183730, 635, 277, 358, 1, 0, 1
2137, 1, 1636424183262, 1636424183918, 656, 338, 318, 0, 1, 1
2052, 1, 1636424174242, 1636424183934, 9692, 9328, 364, 0, 0, 0
2138, 1, 1636424183449, 1636424184078, 629, 274, 355, 1, 0, 1
2139, 1, 1636424183466, 1636424184098, 632, 273, 359, 1, 0, 1
2141, 1, 1636424183654, 1636424184282, 628, 271, 357, 0, 1, 1
2142, 1, 1636424183787, 1636424184414, 627, 269, 358, 1, 0, 1
2146, 1, 1636424183891, 1636424184510, 619, 266, 353, 0, 0, 0
2140, 1, 1636424183477, 1636424184554, 1077, 717, 360, 0, 0, 0
2149, 1, 1636424184112, 1636424184738, 626, 265, 361, 0, 0, 0
2145, 1, 1636424183886, 1636424184870, 984, 617, 367, 0, 0, 0
2150, 1, 1636424184383, 1636424185014, 631, 270, 361, 0, 0, 0
2151, 1, 1636424184400, 1636424185022, 622, 271, 351, 2, 0, 2
2152, 1, 1636424184447, 1636424185066, 619, 265, 354, 1, 0, 1
2153, 1, 1636424184541, 1636424185194, 653, 298, 355, 0, 0, 0
2154, 1, 1636424184807, 1636424185438, 631, 270, 361, 1, 0, 1
2156, 1, 1636424184833, 1636424185470, 637, 274, 363, 1, 0, 1
2157, 1, 1636424184989, 1636424185602, 613, 263, 350, 0, 0, 0
2158, 1, 1636424185134, 1636424185770, 636, 274, 362, 1, 0, 1
2159, 1, 1636424185182, 1636424185810, 628, 267, 361, 2, 0, 2
2155, 1, 1636424184833, 1636424185894, 1061, 698, 363, 1, 0, 1
2160, 1, 1636424185221, 1636424186226, 1005, 646, 359, 1, 0, 1
2162, 1, 1636424185770, 1636424186394, 624, 270, 354, 0, 0, 0
2163, 1, 1636424185787, 1636424186414, 627, 271, 356, 0, 0, 0
2164, 1, 1636424185790, 1636424186426, 636, 278, 358, 0, 0, 0
2166, 1, 1636424186129, 1636424186754, 625, 269, 356, 0, 0, 0
2167, 1, 1636424186167, 1636424186794, 627, 270, 357, 1, 0, 1
2169, 1, 1636424186255, 1636424186886, 631, 273, 358, 1, 0, 1
2170, 1, 1636424186486, 1636424187118, 632, 269, 363, 1, 0, 1
2171, 1, 1636424186496, 1636424187122, 626, 270, 356, 0, 0, 0
2168, 1, 1636424186178, 1636424187254, 1076, 713, 363, 0, 0, 0
2172, 1, 1636424186562, 1636424187578, 1016, 658, 358, 1, 0, 1
2173, 1, 1636424187041, 1636424187670, 629, 270, 359, 0, 0, 0
2174, 1, 1636424187055, 1636424187690, 635, 274, 361, 1, 0, 1
2175, 1, 1636424187103, 1636424187734, 631, 269, 362, 0, 0, 0
2176, 1, 1636424187471, 1636424188102, 631, 271, 360, 2, 0, 2
2179, 1, 1636424187563, 1636424188189, 626, 266, 360, 1, 0, 1
2180, 1, 1636424187771, 1636424188406, 635, 270, 365, 1, 1, 2
2181, 1, 1636424187870, 1636424188498, 628, 266, 362, 1, 0, 1
2182, 1, 1636424187910, 1636424188950, 1040, 678, 362, 0, 0, 0
2183, 1, 1636424188345, 1636424188978, 633, 274, 359, 0, 0, 0
2185, 1, 1636424188404, 1636424189026, 622, 266, 356, 0, 0, 0
2184, 1, 1636424188394, 1636424189034, 640, 271, 369, 0, 0, 0
2186, 1, 1636424188834, 1636424189458, 624, 269, 355, 1, 0, 1
2187, 1, 1636424188910, 1636424189546, 636, 273, 363, 0, 0, 0
2188, 1, 1636424189071, 1636424189702, 631, 270, 361, 0, 0, 0
2189, 1, 1636424189180, 1636424189806, 626, 270, 356, 1, 0, 1
2190, 1, 1636424189222, 1636424190258, 1036, 678, 358, 1, 0, 1
2191, 1, 1636424189630, 1636424190258, 628, 270, 358, 0, 1, 1
2192, 1, 1636424189680, 1636424190302, 622, 266, 356, 1, 0, 1
2193, 1, 1636424189768, 1636424190390, 622, 269, 353, 1, 0, 1
2194, 1, 1636424190117, 1636424190750, 633, 270, 363, 0, 1, 1
2195, 1, 1636424190272, 1636424190894, 622, 266, 356, 0, 0, 0
2196, 1, 1636424190338, 1636424190970, 632, 271, 361, 0, 0, 0
2197, 1, 1636424190552, 1636424191178, 626, 270, 356, 2, 0, 2
2199, 1, 1636424190957, 1636424191586, 629, 267, 362, 1, 0, 1
2200, 1, 1636424190972, 1636424191598, 626, 269, 357, 0, 0, 0
2198, 1, 1636424190555, 1636424191622, 1067, 714, 353, 0, 0, 0
2201, 1, 1636424191041, 1636424191670, 629, 270, 359, 0, 0, 0
2202, 1, 1636424191516, 1636424192142, 626, 270, 356, 0, 0, 0
2203, 1, 1636424191645, 1636424192278, 633, 274, 359, 0, 0, 0
2204, 1, 1636424191730, 1636424192354, 624, 267, 357, 0, 0, 0
2127, 2, 1636424182401, 1636424192541, 10140, 1, 10139, 1, 0, 1
2128, 2, 1636424182451, 1636424192590, 10139, 1, 10138, 1, 0, 1
2207, 1, 1636424192223, 1636424192858, 635, 279, 356, 0, 9, 9
2208, 1, 1636424192262, 1636424192954, 692, 279, 413, 1, 12, 13
2209, 1, 1636424192434, 1636424193086, 652, 275, 377, 0, 0, 0
2148, 1, 1636424184073, 1636424193086, 9013, 8654, 359, 1, 0, 1
2210, 1, 1636424192916, 1636424193538, 622, 272, 350, 1, 2, 3
2211, 1, 1636424192927, 1636424193558, 631, 271, 360, 0, 1, 1
2212, 1, 1636424193029, 1636424193662, 633, 270, 363, 0, 0, 0
2213, 1, 1636424193106, 1636424193778, 672, 274, 398, 0, 0, 0
2215, 1, 1636424193166, 1636424193838, 672, 276, 396, 0, 0, 0
2144, 2, 1636424183794, 1636424193969, 10175, 1, 10174, 1, 0, 1
2143, 2, 1636424183794, 1636424194018, 10224, 0, 10224, 0, 0, 0
2147, 2, 1636424183936, 1636424194117, 10181, 0, 10181, 0, 0, 0
2217, 1, 1636424193628, 1636424194286, 658, 302, 356, 0, 32, 32
2214, 1, 1636424193166, 1636424194286, 1120, 666, 454, 0, 4, 4
2218, 1, 1636424193799, 1636424194490, 691, 323, 368, 1, 53, 54
2219, 1, 1636424194240, 1636424194866, 626, 266, 360, 1, 0, 1
2220, 1, 1636424194299, 1636424194926, 627, 270, 357, 0, 0, 0
2224, 1, 1636424194394, 1636424195030, 636, 274, 362, 0, 0, 0
2222, 1, 1636424194374, 1636424195054, 680, 268, 412, 1, 0, 1
2225, 1, 1636424194414, 1636424195057, 643, 275, 368, 0, 1, 1
2161, 2, 1636424185386, 1636424195521, 10135, 1, 10134, 0, 0, 0
2228, 1, 1636424194923, 1636424195542, 619, 265, 354, 0, 0, 0
2229, 1, 1636424195116, 1636424195782, 666, 269, 397, 0, 0, 0
2165, 2, 1636424185853, 1636424195985, 10132, 0, 10132, 0, 0, 0
2230, 1, 1636424195581, 1636424196246, 665, 266, 399, 0, 1, 1
2233, 1, 1636424195681, 1636424196342, 661, 302, 359, 0, 36, 36
2235, 1, 1636424195791, 1636424196426, 635, 287, 348, 1, 21, 22
2234, 1, 1636424195773, 1636424196434, 661, 299, 362, 1, 32, 33
2237, 1, 1636424196474, 1636424197106, 632, 269, 363, 0, 0, 0
2238, 1, 1636424196876, 1636424197506, 630, 278, 352, 0, 0, 0
2177, 2, 1636424187507, 1636424197641, 10134, 0, 10134, 0, 0, 0
2239, 1, 1636424197028, 1636424197654, 626, 269, 357, 0, 0, 0
2240, 1, 1636424197049, 1636424197678, 629, 269, 360, 0, 0, 0
2178, 2, 1636424187518, 1636424197685, 10167, 0, 10167, 1, 0, 1
2242, 1, 1636424197744, 1636424198374, 630, 270, 360, 0, 0, 0
2244, 1, 1636424197775, 1636424198446, 671, 270, 401, 0, 0, 0
2245, 1, 1636424198241, 1636424198870, 629, 270, 359, 1, 1, 2
2243, 1, 1636424197774, 1636424198890, 1116, 719, 397, 1, 0, 1
2246, 1, 1636424198317, 1636424198938, 621, 265, 356, 0, 0, 0
2247, 1, 1636424198333, 1636424198966, 633, 273, 360, 0, 0, 0
2248, 1, 1636424199015, 1636424199642, 627, 271, 356, 2, 0, 2
2249, 1, 1636424199045, 1636424199674, 629, 270, 359, 0, 0, 0
2250, 1, 1636424199059, 1636424200098, 1039, 683, 356, 0, 1, 1
2251, 1, 1636424199588, 1636424200214, 626, 268, 358, 1, 0, 1
2252, 1, 1636424199671, 1636424200298, 627, 268, 359, 0, 0, 0
2253, 1, 1636424200334, 1636424200962, 628, 270, 358, 0, 0, 0
2254, 1, 1636424200399, 1636424201030, 631, 269, 362, 2, 0, 2
2255, 1, 1636424200406, 1636424201486, 1080, 722, 358, 1, 0, 1
2256, 1, 1636424200882, 1636424201514, 632, 272, 360, 0, 0, 0
2257, 1, 1636424200967, 1636424201598, 631, 272, 359, 0, 0, 0
2205, 2, 1636424191902, 1636424202038, 10136, 0, 10136, 0, 0, 0
2206, 2, 1636424191906, 1636424202085, 10179, 1, 10178, 0, 0, 0
2258, 1, 1636424201607, 1636424202238, 631, 271, 360, 0, 0, 0
2259, 1, 1636424201745, 1636424202442, 697, 295, 402, 0, 24, 24
2261, 1, 1636424202231, 1636424202862, 631, 275, 356, 0, 0, 0
2260, 1, 1636424201788, 1636424202894, 1106, 744, 362, 1, 1, 2
2262, 1, 1636424202273, 1636424202902, 629, 267, 362, 1, 1, 2
2265, 1, 1636424202910, 1636424203534, 624, 270, 354, 1, 0, 1
2266, 1, 1636424203115, 1636424203738, 623, 269, 354, 1, 0, 1
2216, 2, 1636424193615, 1636424203749, 10134, 0, 10134, 0, 0, 0
2267, 1, 1636424203122, 1636424204190, 1068, 719, 349, 0, 7, 7
2268, 1, 1636424203609, 1636424204238, 629, 271, 358, 1, 1, 2
2231, 1, 1636424195650, 1636424204242, 8592, 8231, 361, 0, 1, 1
2269, 1, 1636424203652, 1636424204282, 630, 266, 364, 0, 0, 0
2223, 2, 1636424194375, 1636424204553, 10178, 2, 10176, 2, 1, 3
2227, 2, 1636424194460, 1636424204602, 10142, 2, 10140, 3, 0, 3
2226, 2, 1636424194447, 1636424204649, 10202, 0, 10202, 0, 0, 0
2270, 1, 1636424203882, 1636424204694, 812, 412, 400, 0, 1, 1
2221, 2, 1636424194374, 1636424204701, 10327, 1, 10326, 1, 1, 2
2271, 1, 1636424204231, 1636424204966, 735, 382, 353, 0, 112, 112
2275, 1, 1636424204790, 1636424205466, 676, 271, 405, 1, 0, 1
2277, 1, 1636424205018, 1636424205658, 640, 277, 363, 0, 0, 0
2278, 1, 1636424205138, 1636424205806, 668, 266, 402, 0, 0, 0
2279, 1, 1636424205142, 1636424205814, 672, 270, 402, 1, 0, 1
2232, 2, 1636424195658, 1636424205837, 10179, 0, 10179, 0, 0, 0
2282, 1, 1636424205542, 1636424206202, 660, 299, 361, 1, 28, 29
2236, 2, 1636424196110, 1636424206285, 10175, 0, 10175, 0, 0, 0
2280, 1, 1636424205142, 1636424206298, 1156, 746, 410, 2, 32, 34
2283, 1, 1636424205966, 1636424206746, 780, 391, 389, 0, 0, 0
2284, 1, 1636424206135, 1636424206750, 615, 270, 345, 1, 0, 1
2241, 1, 1636424197092, 1636424206778, 9686, 9334, 352, 0, 1, 1
2285, 1, 1636424206391, 1636424207014, 623, 270, 353, 0, 0, 0
2288, 1, 1636424206444, 1636424207058, 614, 267, 347, 1, 0, 1
2287, 1, 1636424206419, 1636424207058, 639, 273, 366, 2, 0, 2
2286, 1, 1636424206418, 1636424207198, 780, 381, 399, 0, 0, 0
2291, 1, 1636424206876, 1636424207506, 630, 269, 361, 0, 0, 0
2289, 1, 1636424206465, 1636424207510, 1045, 683, 362, 2, 1, 3
2290, 1, 1636424206780, 1636424207658, 878, 474, 404, 2, 0, 2
2292, 1, 1636424207276, 1636424207958, 682, 330, 352, 0, 0, 0
2293, 1, 1636424207462, 1636424208094, 632, 269, 363, 0, 0, 0
2294, 1, 1636424207680, 1636424208310, 630, 270, 360, 1, 1, 2
2295, 1, 1636424207688, 1636424208318, 630, 274, 356, 1, 0, 1
2297, 1, 1636424207761, 1636424208386, 625, 270, 355, 1, 0, 1
2296, 1, 1636424207724, 1636424208422, 698, 339, 359, 1, 0, 1
2300, 1, 1636424208206, 1636424208834, 628, 269, 359, 0, 0, 0
2298, 1, 1636424207786, 1636424208842, 1056, 694, 362, 0, 0, 0
2299, 1, 1636424208139, 1636424208870, 731, 373, 358, 0, 0, 0
2301, 1, 1636424208563, 1636424209290, 727, 374, 353, 1, 0, 1
2302, 1, 1636424208825, 1636424209454, 629, 270, 359, 1, 0, 1
2303, 1, 1636424208997, 1636424209622, 625, 270, 355, 0, 0, 0
2305, 1, 1636424209069, 1636424209702, 633, 275, 358, 0, 1, 1
2304, 1, 1636424209036, 1636424209734, 698, 346, 352, 1, 0, 1
2306, 1, 1636424209455, 1636424210186, 731, 378, 353, 0, 0, 0
2307, 1, 1636424209559, 1636424210186, 627, 271, 356, 1, 0, 1
2308, 1, 1636424210170, 1636424210802, 632, 270, 362, 0, 0, 0
2309, 1, 1636424210273, 1636424210906, 633, 270, 363, 1, 0, 1
2310, 1, 1636424210373, 1636424211006, 633, 274, 359, 1, 0, 1
2311, 1, 1636424210836, 1636424211466, 630, 270, 360, 1, 0, 1
2312, 1, 1636424211461, 1636424212090, 629, 265, 364, 0, 0, 0
2313, 1, 1636424211539, 1636424212174, 635, 271, 364, 0, 1, 1
2263, 2, 1636424202446, 1636424212625, 10179, 0, 10179, 0, 1, 1
2264, 2, 1636424202447, 1636424212669, 10222, 1, 10221, 1, 0, 1
2314, 1, 1636424212110, 1636424212734, 624, 268, 356, 0, 1, 1
2272, 1, 1636424204260, 1636424213158, 8898, 8499, 399, 0, 1, 1
2315, 1, 1636424212758, 1636424213430, 672, 274, 398, 2, 0, 2
2318, 1, 1636424212819, 1636424213442, 623, 266, 357, 0, 0, 0
2317, 1, 1636424212802, 1636424213442, 640, 272, 368, 1, 0, 1
2320, 1, 1636424213399, 1636424214034, 635, 272, 363, 0, 0, 0
2321, 1, 1636424214002, 1636424214634, 632, 276, 356, 0, 0, 0
2274, 2, 1636424204438, 1636424214697, 10259, 0, 10259, 52, 0, 52
2273, 2, 1636424204436, 1636424214741, 10305, 0, 10305, 51, 0, 51
2322, 1, 1636424214167, 1636424214794, 627, 269, 358, 1, 0, 1
2276, 2, 1636424204872, 1636424215010, 10138, 1, 10137, 1, 0, 1
2281, 2, 1636424205146, 1636424215285, 10139, 0, 10139, 0, 0, 0
2323, 1, 1636424214742, 1636424215370, 628, 271, 357, 0, 4, 4
2324, 1, 1636424214830, 1636424215498, 668, 269, 399, 0, 1, 1
2326, 1, 1636424215146, 1636424215830, 684, 271, 413, 1, 0, 1
2327, 1, 1636424215323, 1636424215950, 627, 271, 356, 2, 1, 3
2325, 1, 1636424214870, 1636424215950, 1080, 671, 409, 1, 0, 1
2329, 1, 1636424215474, 1636424216110, 636, 267, 369, 0, 0, 0
2328, 1, 1636424215414, 1636424216286, 872, 465, 407, 0, 0, 0
2330, 1, 1636424216053, 1636424216682, 629, 271, 358, 1, 1, 2
2331, 1, 1636424216155, 1636424216782, 627, 270, 357, 0, 0, 0
2333, 1, 1636424216462, 1636424217090, 628, 271, 357, 1, 0, 1
2332, 1, 1636424216177, 1636424217238, 1061, 702, 359, 0, 0, 0
2334, 1, 1636424216638, 1636424217266, 628, 268, 360, 0, 0, 0
2335, 1, 1636424216737, 1636424217546, 809, 444, 365, 0, 0, 0
2337, 1, 1636424217429, 1636424218054, 625, 267, 358, 1, 0, 1
2338, 1, 1636424217490, 1636424218122, 632, 273, 359, 0, 0, 0
2340, 1, 1636424217772, 1636424218402, 630, 275, 355, 0, 1, 1
2339, 1, 1636424217520, 1636424218586, 1066, 705, 361, 0, 0, 0
2341, 1, 1636424218031, 1636424218654, 623, 265, 358, 0, 0, 0
2342, 1, 1636424218042, 1636424218850, 808, 449, 359, 1, 0, 1
2344, 1, 1636424218815, 1636424219442, 627, 269, 358, 1, 1, 2
2346, 1, 1636424219134, 1636424219762, 628, 270, 358, 0, 0, 0
2345, 1, 1636424218841, 1636424219898, 1057, 694, 363, 0, 0, 0
2347, 1, 1636424219305, 1636424219934, 629, 269, 360, 0, 0, 0
2348, 1, 1636424219375, 1636424220218, 843, 486, 357, 2, 1, 3
2349, 1, 1636424220123, 1636424220750, 627, 269, 358, 0, 0, 0
2351, 1, 1636424220464, 1636424221094, 630, 269, 361, 1, 0, 1
2350, 1, 1636424220173, 1636424221206, 1033, 673, 360, 0, 0, 0
2352, 1, 1636424220598, 1636424221230, 632, 269, 363, 0, 0, 0
2353, 1, 1636424220673, 1636424221550, 877, 514, 363, 2, 0, 2
2354, 1, 1636424221470, 1636424222098, 628, 271, 357, 1, 2, 3
2356, 1, 1636424221801, 1636424222430, 629, 272, 357, 1, 1, 2
2355, 1, 1636424221533, 1636424222554, 1021, 662, 359, 0, 0, 0
2357, 1, 1636424221936, 1636424222562, 626, 270, 356, 1, 0, 1
2358, 1, 1636424222029, 1636424222886, 857, 493, 364, 0, 0, 0
2316, 2, 1636424212758, 1636424222937, 10179, 1, 10178, 1, 0, 1
2319, 2, 1636424213160, 1636424223337, 10177, 0, 10177, 0, 0, 0
2359, 1, 1636424222815, 1636424223474, 659, 270, 389, 1, 2, 3
2361, 1, 1636424223072, 1636424223702, 630, 270, 360, 1, 0, 1
2336, 1, 1636424216858, 1636424223830, 6972, 6609, 363, 2, 0, 2
2362, 1, 1636424223245, 1636424223874, 629, 265, 364, 0, 0, 0
2360, 1, 1636424222885, 1636424223926, 1041, 673, 368, 0, 1, 1
2363, 1, 1636424223338, 1636424224158, 820, 462, 358, 0, 0, 0
2365, 1, 1636424223522, 1636424224198, 676, 271, 405, 1, 0, 1
2367, 1, 1636424224164, 1636424224786, 622, 270, 352, 0, 1, 1
2369, 1, 1636424224466, 1636424225094, 628, 270, 358, 0, 1, 1
2370, 1, 1636424224587, 1636424225218, 631, 271, 360, 0, 0, 0
2368, 1, 1636424224244, 1636424225242, 998, 641, 357, 0, 0, 0
2372, 1, 1636424224812, 1636424225438, 626, 269, 357, 0, 0, 0
2371, 1, 1636424224666, 1636424225554, 888, 530, 358, 0, 1, 1
2373, 1, 1636424225474, 1636424226102, 628, 270, 358, 0, 1, 1
2375, 1, 1636424225857, 1636424226486, 629, 271, 358, 2, 1, 3
2374, 1, 1636424225563, 1636424226550, 987, 633, 354, 0, 0, 0
2376, 1, 1636424225949, 1636424226574, 625, 270, 355, 1, 1, 2
2378, 1, 1636424226206, 1636424226838, 632, 276, 356, 1, 1, 2
2377, 1, 1636424226011, 1636424226938, 927, 570, 357, 0, 0, 0
2379, 1, 1636424226845, 1636424227474, 629, 271, 358, 1, 1, 2
2381, 1, 1636424227184, 1636424227814, 630, 269, 361, 0, 0, 0
2382, 1, 1636424227233, 1636424227858, 625, 271, 354, 1, 0, 1
2380, 1, 1636424226903, 1636424227934, 1031, 670, 361, 1, 1, 2
2384, 1, 1636424227571, 1636424228206, 635, 274, 361, 0, 0, 0
2383, 1, 1636424227337, 1636424228266, 929, 571, 358, 0, 1, 1
2385, 1, 1636424228196, 1636424228822, 626, 271, 355, 0, 1, 1
2343, 2, 1636424218696, 1636424228829, 10133, 1, 10132, 0, 1, 1
2387, 1, 1636424228486, 1636424229114, 628, 270, 358, 1, 0, 1
2388, 1, 1636424228628, 1636424229286, 658, 294, 364, 1, 24, 25
2386, 1, 1636424228254, 1636424229286, 1032, 670, 362, 2, 3, 5
2389, 1, 1636424228668, 1636424229562, 894, 538, 356, 0, 0, 0
2391, 1, 1636424228965, 1636424229590, 625, 266, 359, 0, 0, 0
2390, 1, 1636424228958, 1636424229630, 672, 269, 403, 1, 0, 1
2394, 1, 1636424229761, 1636424230390, 629, 269, 360, 1, 0, 1
2396, 1, 1636424229981, 1636424230610, 629, 269, 360, 0, 0, 0
2395, 1, 1636424229962, 1636424230838, 876, 525, 351, 0, 0, 0
2397, 1, 1636424230264, 1636424230882, 618, 266, 352, 0, 1, 1
2398, 1, 1636424230350, 1636424230986, 636, 266, 370, 0, 1, 1
2399, 1, 1636424231053, 1636424231682, 629, 269, 360, 1, 1, 2
2401, 1, 1636424231310, 1636424231942, 632, 275, 357, 0, 1, 1
2400, 1, 1636424231280, 1636424232134, 854, 496, 358, 0, 0, 0
2402, 1, 1636424231659, 1636424232290, 631, 271, 360, 0, 0, 0
2403, 1, 1636424231667, 1636424232294, 627, 270, 357, 0, 0, 0
2404, 1, 1636424232342, 1636424232970, 628, 271, 357, 0, 1, 1
2406, 1, 1636424232710, 1636424233346, 636, 274, 362, 1, 0, 1
2405, 1, 1636424232582, 1636424233430, 848, 493, 355, 0, 1, 1
2407, 1, 1636424232961, 1636424233594, 633, 270, 363, 0, 0, 0
2408, 1, 1636424233023, 1636424233650, 627, 269, 358, 1, 0, 1
2364, 2, 1636424223522, 1636424233701, 10179, 1, 10178, 2, 0, 2
2366, 2, 1636424223832, 1636424234009, 10177, 1, 10176, 2, 0, 2
2409, 1, 1636424234010, 1636424234634, 624, 271, 353, 0, 2, 2
2412, 1, 1636424234310, 1636424234938, 628, 271, 357, 0, 0, 0
2410, 1, 1636424234286, 1636424234962, 676, 270, 406, 1, 0, 1
2413, 1, 1636424234389, 1636424235014, 625, 270, 355, 0, 0, 0
2411, 1, 1636424234287, 1636424235422, 1135, 725, 410, 1, 1, 2
2414, 1, 1636424235368, 1636424235994, 626, 269, 357, 0, 0, 0
2417, 1, 1636424235687, 1636424236322, 635, 269, 366, 1, 0, 1
2418, 1, 1636424235776, 1636424236398, 622, 271, 351, 1, 0, 1
2419, 1, 1636424236714, 1636424237342, 628, 269, 359, 1, 1, 2
2421, 1, 1636424237073, 1636424237702, 629, 269, 360, 0, 0, 0
2422, 1, 1636424238008, 1636424238638, 630, 270, 360, 1, 1, 2
2423, 1, 1636424238346, 1636424238978, 632, 270, 362, 0, 1, 1
2392, 2, 1636424229545, 1636424239681, 10136, 1, 10135, 0, 0, 0
2393, 2, 1636424229596, 1636424239725, 10129, 0, 10129, 1, 0, 1
2424, 1, 1636424239396, 1636424240038, 642, 286, 356, 1, 20, 21
2425, 1, 1636424239611, 1636424240262, 651, 266, 385, 0, 0, 0
2426, 1, 1636424239810, 1636424240482, 672, 270, 402, 0, 0, 0
2427, 1, 1636424239862, 1636424240938, 1076, 668, 408, 1, 2, 3
2428, 1, 1636424240753, 1636424241382, 629, 270, 359, 0, 1, 1
2429, 1, 1636424240902, 1636424241534, 632, 270, 362, 0, 1, 1
2433, 1, 1636424242247, 1636424242878, 631, 270, 361, 1, 0, 1
2434, 1, 1636424243517, 1636424244150, 633, 269, 364, 2, 0, 2
2435, 1, 1636424244845, 1636424245474, 629, 271, 358, 1, 1, 2
2415, 2, 1636424235517, 1636424245653, 10136, 0, 10136, 1, 0, 1
2416, 2, 1636424235573, 1636424245708, 10135, 0, 10135, 0, 0, 0
2436, 1, 1636424245798, 1636424246474, 676, 271, 405, 3, 0, 3
2438, 1, 1636424246209, 1636424246838, 629, 270, 359, 1, 0, 1
2437, 1, 1636424245838, 1636424246926, 1088, 684, 404, 0, 0, 0
2420, 2, 1636424237016, 1636424247149, 10133, 1, 10132, 1, 1, 2
2439, 1, 1636424247071, 1636424247734, 663, 268, 395, 0, 0, 0
2441, 1, 1636424247282, 1636424247954, 672, 270, 402, 0, 0, 0
2442, 1, 1636424247486, 1636424248114, 628, 270, 358, 2, 0, 2
2440, 1, 1636424247150, 1636424248186, 1036, 678, 358, 1, 0, 1
2443, 1, 1636424248431, 1636424249062, 631, 269, 362, 1, 0, 1
2445, 1, 1636424248573, 1636424249202, 629, 270, 359, 0, 0, 0
2446, 1, 1636424248788, 1636424249418, 630, 268, 362, 1, 0, 1
2444, 1, 1636424248464, 1636424249514, 1050, 695, 355, 1, 1, 2
2447, 1, 1636424249706, 1636424250334, 628, 274, 354, 1, 0, 1
2449, 1, 1636424249882, 1636424250514, 632, 271, 361, 0, 2, 2
2450, 1, 1636424250111, 1636424250742, 631, 270, 361, 0, 0, 0
2448, 1, 1636424249780, 1636424250790, 1010, 654, 356, 1, 0, 1
2430, 2, 1636424241045, 1636424251181, 10136, 0, 10136, 0, 0, 0
2431, 2, 1636424241137, 1636424251270, 10133, 10000, 133, 0, 0, 0
2451, 1, 1636424250998, 1636424251634, 636, 279, 357, 1, 9, 10
2453, 1, 1636424251270, 1636424251894, 624, 268, 356, 0, 1, 1
2454, 1, 1636424251315, 1636424251982, 667, 266, 401, 0, 0, 0
2452, 1, 1636424251087, 1636424252090, 1003, 639, 364, 0, 1, 1
2456, 1, 1636424251497, 1636424252130, 633, 270, 363, 1, 0, 1
2432, 2, 1636424242017, 1636424252153, 10136, 1, 10135, 0, 1, 1
2455, 1, 1636424251358, 1636424252442, 1084, 685, 399, 1, 0, 1
2457, 1, 1636424252282, 1636424252954, 672, 272, 400, 2, 1, 3
2458, 1, 1636424252336, 1636424252970, 634, 270, 364, 1, 0, 1
2460, 1, 1636424252524, 1636424253146, 622, 269, 353, 0, 0, 0
2461, 1, 1636424252599, 1636424253222, 623, 266, 357, 1, 0, 1
2459, 1, 1636424252433, 1636424253430, 997, 635, 362, 0, 0, 0
2463, 1, 1636424252877, 1636424253502, 625, 267, 358, 0, 0, 0
2462, 1, 1636424252643, 1636424253678, 1035, 678, 357, 0, 0, 0
2464, 1, 1636424253574, 1636424254214, 640, 274, 366, 2, 0, 2
2465, 1, 1636424253631, 1636424254254, 623, 272, 351, 1, 1, 2
2467, 1, 1636424253926, 1636424254554, 628, 269, 359, 1, 0, 1
2466, 1, 1636424253752, 1636424254706, 954, 599, 355, 0, 1, 1
2470, 1, 1636424254268, 1636424254894, 626, 271, 355, 2, 0, 2
2471, 1, 1636424254884, 1636424255510, 626, 270, 356, 0, 2, 2
2472, 1, 1636424254973, 1636424255602, 629, 269, 360, 0, 1, 1
2474, 1, 1636424255197, 1636424255826, 629, 271, 358, 0, 0, 0
2473, 1, 1636424255108, 1636424256062, 954, 598, 356, 1, 0, 1
2475, 1, 1636424255576, 1636424256202, 626, 266, 360, 1, 0, 1
2476, 1, 1636424256245, 1636424256878, 633, 271, 362, 0, 0, 0
2477, 1, 1636424256336, 1636424256962, 626, 271, 355, 1, 1, 2
2479, 1, 1636424256590, 1636424257222, 632, 270, 362, 0, 0, 0
2478, 1, 1636424256466, 1636424257418, 952, 594, 358, 0, 0, 0
2480, 1, 1636424256938, 1636424257566, 628, 271, 357, 1, 1, 2
2481, 1, 1636424257546, 1636424258182, 636, 274, 362, 1, 1, 2
2482, 1, 1636424257619, 1636424258246, 627, 269, 358, 0, 0, 0
2484, 1, 1636424257986, 1636424258614, 628, 271, 357, 0, 1, 1
2483, 1, 1636424257778, 1636424258698, 920, 567, 353, 1, 1, 2
2485, 1, 1636424258269, 1636424258902, 633, 271, 362, 1, 0, 1
2486, 1, 1636424258905, 1636424259534, 629, 270, 359, 0, 1, 1
2487, 1, 1636424259015, 1636424259638, 623, 266, 357, 0, 0, 0
2489, 1, 1636424259313, 1636424259942, 629, 270, 359, 0, 0, 0
2488, 1, 1636424259146, 1636424260090, 944, 586, 358, 0, 1, 1
2490, 1, 1636424259627, 1636424260258, 631, 270, 361, 2, 0, 2
2491, 1, 1636424260176, 1636424260798, 622, 271, 351, 0, 1, 1
2492, 1, 1636424260415, 1636424261042, 627, 270, 357, 1, 0, 1
2494, 1, 1636424260614, 1636424261242, 628, 269, 359, 0, 0, 0
2493, 1, 1636424260487, 1636424261494, 1007, 654, 353, 1, 1, 2
2495, 1, 1636424260898, 1636424261530, 632, 273, 359, 1, 0, 1
2496, 1, 1636424261570, 1636424262202, 632, 270, 362, 1, 0, 1
2497, 1, 1636424261745, 1636424262378, 633, 269, 364, 0, 0, 0
2499, 1, 1636424261891, 1636424262518, 627, 270, 357, 1, 0, 1
2498, 1, 1636424261808, 1636424262834, 1026, 666, 360, 0, 0, 0
2500, 1, 1636424262287, 1636424262914, 627, 270, 357, 1, 0, 1
2501, 1, 1636424262965, 1636424263598, 633, 269, 364, 1, 1, 2
2502, 1, 1636424263144, 1636424263778, 634, 270, 364, 2, 1, 3
2469, 2, 1636424253995, 1636424264129, 10134, 1, 10133, 1, 1, 2
2468, 2, 1636424253990, 1636424264173, 10183, 1, 10182, 0, 1, 1
2503, 1, 1636424263169, 1636424264226, 1057, 702, 355, 1, 0, 1
2504, 1, 1636424263677, 1636424264310, 633, 271, 362, 1, 0, 1
2507, 1, 1636424264278, 1636424264906, 628, 270, 358, 0, 0, 0
2506, 1, 1636424264263, 1636424264930, 667, 271, 396, 0, 1, 1
2508, 1, 1636424264414, 1636424265054, 640, 272, 368, 0, 0, 0
2505, 1, 1636424264262, 1636424265386, 1124, 717, 407, 0, 1, 1
2509, 1, 1636424264484, 1636424265514, 1030, 662, 368, 0, 0, 0
2510, 1, 1636424264990, 1636424265622, 632, 270, 362, 2, 0, 2
2511, 1, 1636424265562, 1636424266194, 632, 269, 363, 0, 1, 1
2514, 1, 1636424265792, 1636424266422, 630, 270, 360, 1, 0, 1
2515, 1, 1636424265841, 1636424266878, 1037, 678, 359, 0, 1, 1
2517, 1, 1636424266837, 1636424267466, 629, 270, 359, 1, 0, 1
2518, 1, 1636424267138, 1636424267770, 632, 269, 363, 0, 1, 1
2519, 1, 1636424267200, 1636424268222, 1022, 660, 362, 1, 0, 1
2520, 1, 1636424268201, 1636424268830, 629, 265, 364, 0, 1, 1
2521, 1, 1636424268457, 1636424269086, 629, 269, 360, 0, 0, 0
2522, 1, 1636424268521, 1636424269542, 1021, 661, 360, 0, 0, 0
2523, 1, 1636424269567, 1636424270202, 635, 271, 364, 1, 2, 3
2524, 1, 1636424269845, 1636424270474, 629, 270, 359, 0, 0, 0
2525, 1, 1636424269881, 1636424270930, 1049, 690, 359, 1, 0, 1
2526, 1, 1636424270909, 1636424271538, 629, 269, 360, 2, 0, 2
2527, 1, 1636424271215, 1636424271842, 627, 269, 358, 1, 0, 1
2528, 1, 1636424271223, 1636424272294, 1071, 713, 358, 1, 0, 1
2529, 1, 1636424272206, 1636424272838, 632, 271, 361, 0, 1, 1
2532, 1, 1636424273506, 1636424274134, 628, 269, 359, 0, 1, 1
2533, 1, 1636424274770, 1636424275402, 632, 271, 361, 0, 1, 1
2512, 2, 1636424265579, 1636424275713, 10134, 0, 10134, 0, 0, 0
2513, 2, 1636424265610, 1636424275757, 10147, 0, 10147, 0, 0, 0
2516, 1, 1636424266283, 1636424276250, 9967, 9610, 357, 1, 1, 2
2534, 1, 1636424276047, 1636424276674, 627, 269, 358, 1, 1, 2
2535, 1, 1636424276252, 1636424276926, 674, 271, 403, 1, 0, 1
2537, 1, 1636424276286, 1636424276958, 672, 271, 401, 3, 0, 3
2536, 1, 1636424276282, 1636424277378, 1096, 689, 407, 0, 0, 0
2538, 1, 1636424277441, 1636424278070, 629, 269, 360, 0, 0, 0
2539, 1, 1636424277573, 1636424278202, 629, 269, 360, 2, 0, 2
2540, 1, 1636424278710, 1636424279338, 628, 269, 359, 0, 1, 1
2541, 1, 1636424278904, 1636424279534, 630, 271, 359, 0, 2, 2
2542, 1, 1636424279984, 1636424280614, 630, 269, 361, 0, 1, 1
2543, 1, 1636424280256, 1636424280886, 630, 271, 359, 0, 2, 2
2544, 1, 1636424281349, 1636424281978, 629, 270, 359, 0, 0, 0
2545, 1, 1636424281534, 1636424282166, 632, 268, 364, 0, 0, 0
2530, 2, 1636424272479, 1636424282613, 10134, 0, 10134, 0, 0, 0
2531, 2, 1636424272531, 1636424282665, 10134, 0, 10134, 0, 0, 0
2546, 1, 1636424282666, 1636424283250, 584, 270, 314, 0, 0, 0
2547, 1, 1636424282754, 1636424283422, 668, 271, 397, 0, 1, 1
2549, 1, 1636424282805, 1636424283430, 625, 269, 356, 0, 0, 0
2548, 1, 1636424282794, 1636424283878, 1084, 680, 404, 0, 0, 0
2550, 1, 1636424283927, 1636424284554, 627, 270, 357, 0, 0, 0
2551, 1, 1636424284083, 1636424284714, 631, 270, 361, 0, 0, 0
2553, 1, 1636424284093, 1636424284722, 629, 270, 359, 0, 0, 0
2552, 1, 1636424284090, 1636424285170, 1080, 718, 362, 1, 0, 1
2554, 1, 1636424285250, 1636424285878, 628, 268, 360, 0, 0, 0
2555, 1, 1636424285393, 1636424286022, 629, 270, 359, 0, 0, 0
2556, 1, 1636424285401, 1636424286034, 633, 271, 362, 0, 0, 0
2557, 1, 1636424285414, 1636424286482, 1068, 705, 363, 1, 0, 1
2558, 1, 1636424286636, 1636424287262, 626, 269, 357, 1, 0, 1
2559, 1, 1636424286747, 1636424287378, 631, 270, 361, 2, 0, 2
2561, 1, 1636424286755, 1636424287382, 627, 270, 357, 0, 0, 0
2560, 1, 1636424286753, 1636424287834, 1081, 719, 362, 0, 2, 2
2562, 1, 1636424287975, 1636424288606, 631, 269, 362, 0, 0, 0
2563, 1, 1636424288073, 1636424288706, 633, 270, 363, 0, 0, 0
2565, 1, 1636424288128, 1636424288750, 622, 263, 359, 0, 0, 0
2564, 1, 1636424288077, 1636424289170, 1093, 727, 366, 2, 0, 2
2566, 1, 1636424289314, 1636424289946, 632, 269, 363, 0, 0, 0
2568, 1, 1636424289413, 1636424290042, 629, 269, 360, 0, 0, 0
2569, 1, 1636424289433, 1636424290498, 1065, 704, 361, 1, 0, 1
2570, 1, 1636424290624, 1636424291250, 626, 269, 357, 0, 1, 1
2571, 1, 1636424290684, 1636424291306, 622, 270, 352, 1, 0, 1
2572, 1, 1636424290747, 1636424291758, 1011, 654, 357, 0, 1, 1
2573, 1, 1636424291985, 1636424292614, 629, 270, 359, 2, 0, 2
2574, 1, 1636424292037, 1636424292670, 633, 270, 363, 1, 0, 1
2575, 1, 1636424292082, 1636424293122, 1040, 681, 359, 1, 0, 1
2576, 1, 1636424293316, 1636424293946, 630, 271, 359, 2, 0, 2
2577, 1, 1636424293428, 1636424294058, 630, 269, 361, 0, 0, 0
2578, 1, 1636424293434, 1636424294518, 1084, 720, 364, 1, 0, 1
2579, 1, 1636424294652, 1636424295278, 626, 270, 356, 1, 0, 1
2580, 1, 1636424294743, 1636424295354, 611, 260, 351, 0, 0, 0
2581, 1, 1636424294755, 1636424295810, 1055, 697, 358, 0, 1, 1
2582, 1, 1636424295922, 1636424296554, 632, 269, 363, 1, 0, 1
2583, 1, 1636424297312, 1636424297938, 626, 270, 356, 1, 0, 1
2584, 1, 1636424298702, 1636424299338, 636, 270, 366, 1, 0, 1
2567, 2, 1636424289396, 1636424299529, 10133, 0, 10133, 0, 0, 0
2585, 1, 1636424299670, 1636424300334, 664, 270, 394, 0, 0, 0
2586, 1, 1636424300014, 1636424300642, 628, 267, 361, 0, 0, 0
2587, 1, 1636424300970, 1636424301602, 632, 270, 362, 0, 1, 1
2588, 1, 1636424302334, 1636424302962, 628, 269, 359, 0, 0, 0
2589, 1, 1636424303627, 1636424304258, 631, 276, 355, 0, 1, 1
2590, 1, 1636424305015, 1636424305646, 631, 274, 357, 0, 1, 1
2591, 1, 1636424306393, 1636424307026, 633, 269, 364, 0, 0, 0
2592, 2, 1636424307721, 1636424317857, 10136, 0, 10136, 0, 0, 0
2593, 1, 1636424317994, 1636424318662, 668, 271, 397, 1, 2, 3
2594, 1, 1636424319285, 1636424319914, 629, 269, 360, 0, 1, 1
2595, 1, 1636424320594, 1636424321226, 632, 271, 361, 1, 0, 1
2596, 1, 1636424321948, 1636424322578, 630, 271, 359, 1, 0, 1
2597, 1, 1636424323279, 1636424323910, 631, 273, 358, 0, 1, 1
2598, 1, 1636424324638, 1636424325266, 628, 271, 357, 0, 1, 1
2599, 1, 1636424325908, 1636424326542, 634, 269, 365, 1, 0, 1
2600, 1, 1636424327298, 1636424327926, 628, 270, 358, 0, 1, 1
2601, 1, 1636424485122, 1636424485750, 628, 270, 358, 0, 0, 0
2602, 1, 1636424485615, 1636424486246, 631, 269, 362, 0, 0, 0
2603, 1, 1636424486186, 1636424486814, 628, 269, 359, 0, 0, 0
2604, 1, 1636424486861, 1636424487490, 629, 268, 361, 0, 0, 0
2605, 1, 1636424486986, 1636424487614, 628, 269, 359, 0, 0, 0
2606, 1, 1636424487480, 1636424488110, 630, 269, 361, 1, 0, 1
2607, 1, 1636424487482, 1636424488110, 628, 271, 357, 1, 0, 1
2608, 1, 1636424488116, 1636424488742, 626, 270, 356, 1, 1, 2
2609, 1, 1636424488184, 1636424488810, 626, 271, 355, 1, 1, 2
2610, 1, 1636424488722, 1636424489350, 628, 270, 358, 1, 0, 1
2611, 1, 1636424488726, 1636424489358, 632, 273, 359, 0, 0, 0
2612, 1, 1636424488935, 1636424489562, 627, 268, 359, 0, 0, 0
2613, 1, 1636424489347, 1636424489978, 631, 270, 361, 1, 0, 1
2614, 1, 1636424489431, 1636424490054, 623, 265, 358, 0, 0, 0
2615, 1, 1636424489470, 1636424490110, 640, 278, 362, 2, 0, 2
2616, 1, 1636424490005, 1636424490634, 629, 270, 359, 0, 0, 0
2617, 1, 1636424490113, 1636424490742, 629, 269, 360, 1, 0, 1
2618, 1, 1636424490131, 1636424490758, 627, 270, 357, 2, 0, 2
2619, 1, 1636424490555, 1636424491186, 631, 270, 361, 1, 0, 1
2620, 1, 1636424490677, 1636424491309, 632, 270, 362, 0, 0, 0
2621, 1, 1636424490719, 1636424491350, 631, 269, 362, 0, 0, 0
2622, 1, 1636424490976, 1636424491606, 630, 270, 360, 0, 0, 0
2623, 1, 1636424491298, 1636424491934, 636, 274, 362, 1, 0, 1
2624, 1, 1636424491376, 1636424492006, 630, 270, 360, 0, 0, 0
2625, 1, 1636424491472, 1636424492098, 626, 271, 355, 1, 0, 1
2626, 1, 1636424491969, 1636424492602, 633, 270, 363, 1, 0, 1
2627, 1, 1636424492003, 1636424492634, 631, 274, 357, 1, 0, 1
2628, 1, 1636424492064, 1636424492686, 622, 275, 347, 1, 0, 1
2629, 1, 1636424492172, 1636424492798, 626, 265, 361, 0, 0, 0
2630, 1, 1636424492419, 1636424493090, 671, 313, 358, 1, 0, 1
2631, 1, 1636424492670, 1636424493294, 624, 270, 354, 0, 0, 0
2632, 1, 1636424492691, 1636424493326, 635, 270, 365, 0, 0, 0
2633, 1, 1636424492783, 1636424493410, 627, 274, 353, 1, 0, 1
2634, 1, 1636424493059, 1636424493694, 635, 270, 365, 0, 1, 1
2635, 1, 1636424493151, 1636424493862, 711, 358, 353, 1, 1, 2
2636, 1, 1636424493312, 1636424493942, 630, 270, 360, 2, 0, 2
2637, 1, 1636424493328, 1636424493954, 626, 270, 356, 1, 0, 1
2638, 1, 1636424493599, 1636424494222, 623, 269, 354, 1, 0, 1
2639, 1, 1636424493834, 1636424494458, 624, 271, 353, 1, 1, 2
2640, 1, 1636424493938, 1636424494570, 632, 270, 362, 0, 0, 0
2641, 1, 1636424493954, 1636424494586, 632, 270, 362, 0, 0, 0
2642, 1, 1636424494105, 1636424494734, 629, 270, 359, 0, 1, 1
2643, 1, 1636424494299, 1636424494922, 623, 269, 354, 1, 0, 1
2644, 1, 1636424494338, 1636424495038, 700, 344, 356, 1, 0, 1
2645, 1, 1636424494711, 1636424495350, 639, 271, 368, 2, 1, 3
2646, 1, 1636424494711, 1636424495350, 639, 272, 367, 1, 0, 1
2647, 1, 1636424494775, 1636424495402, 627, 271, 356, 1, 1, 2
2648, 1, 1636424494780, 1636424495410, 630, 279, 351, 0, 0, 0
2650, 1, 1636424494983, 1636424495798, 815, 458, 357, 2, 0, 2
2649, 1, 1636424494930, 1636424495858, 928, 566, 362, 1, 0, 1
2651, 1, 1636424495035, 1636424495862, 827, 470, 357, 0, 0, 0
2652, 1, 1636424495370, 1636424495998, 628, 271, 357, 1, 0, 1
2654, 1, 1636424495505, 1636424496310, 805, 446, 359, 0, 0, 0
2655, 1, 1636424495766, 1636424496390, 624, 271, 353, 1, 0, 1
2656, 1, 1636424495782, 1636424496410, 628, 266, 362, 0, 1, 1
2657, 1, 1636424495803, 1636424496434, 631, 270, 361, 0, 0, 0
2658, 1, 1636424495967, 1636424496590, 623, 267, 356, 2, 0, 2
2653, 1, 1636424495397, 1636424496766, 1369, 1010, 359, 0, 0, 0
2661, 1, 1636424496367, 1636424496990, 623, 270, 353, 1, 0, 1
2662, 1, 1636424496443, 1636424497070, 627, 271, 356, 0, 0, 0
2663, 1, 1636424496618, 1636424497242, 624, 270, 354, 0, 0, 0
2665, 1, 1636424496731, 1636424497362, 631, 266, 365, 0, 0, 0
2667, 1, 1636424496884, 1636424497510, 626, 270, 356, 0, 0, 0
2669, 1, 1636424496983, 1636424497690, 707, 354, 353, 1, 0, 1
2668, 1, 1636424496942, 1636424497814, 872, 510, 362, 0, 0, 0
2670, 1, 1636424497022, 1636424497970, 948, 586, 362, 0, 0, 0
2673, 1, 1636424497498, 1636424498126, 628, 271, 357, 2, 0, 2
2675, 1, 1636424497755, 1636424498370, 615, 262, 353, 1, 0, 1
2676, 1, 1636424497764, 1636424498386, 622, 267, 355, 0, 0, 0
2677, 1, 1636424497824, 1636424498446, 622, 270, 352, 0, 0, 0
2679, 1, 1636424498364, 1636424498990, 626, 270, 356, 0, 0, 0
2680, 1, 1636424498566, 1636424499190, 624, 266, 358, 1, 1, 2
2682, 1, 1636424498746, 1636424499366, 620, 265, 355, 1, 0, 1
2683, 1, 1636424498882, 1636424499502, 620, 262, 358, 0, 0, 0
2685, 1, 1636424498956, 1636424499650, 694, 334, 360, 1, 0, 1
2686, 1, 1636424499027, 1636424499662, 635, 275, 360, 0, 0, 0
2684, 1, 1636424498956, 1636424499818, 862, 507, 355, 2, 0, 2
2688, 1, 1636424499712, 1636424500338, 626, 269, 357, 0, 0, 0
2689, 1, 1636424499815, 1636424500442, 627, 270, 357, 0, 0, 0
2691, 1, 1636424500312, 1636424500942, 630, 275, 355, 2, 0, 2
2692, 1, 1636424500607, 1636424501222, 615, 267, 348, 0, 0, 0
2693, 1, 1636424500830, 1636424501450, 620, 263, 357, 0, 0, 0
2696, 1, 1636424501068, 1636424501694, 626, 271, 355, 1, 0, 1
2697, 1, 1636424501110, 1636424501738, 628, 270, 358, 1, 0, 1
2698, 1, 1636424501753, 1636424502382, 629, 269, 360, 0, 0, 0
2700, 1, 1636424502326, 1636424502954, 628, 269, 359, 0, 0, 0
2702, 1, 1636424502872, 1636424503490, 618, 262, 356, 0, 0, 0
2703, 1, 1636424503173, 1636424503794, 621, 264, 357, 0, 0, 0
2708, 1, 1636424505162, 1636424505786, 624, 265, 359, 0, 0, 0
2659, 2, 1636424496189, 1636424506325, 10136, 0, 10136, 0, 0, 0
2660, 2, 1636424496206, 1636424506373, 10167, 1, 10166, 0, 0, 0
2664, 2, 1636424496682, 1636424506817, 10135, 0, 10135, 0, 0, 0
2666, 2, 1636424496733, 1636424506873, 10140, 1, 10139, 2, 0, 2
2709, 1, 1636424506874, 1636424507526, 652, 258, 394, 0, 0, 0
2671, 2, 1636424497396, 1636424507529, 10133, 0, 10133, 0, 0, 0
2710, 1, 1636424506874, 1636424507538, 664, 271, 393, 0, 1, 1
2672, 2, 1636424497495, 1636424507633, 10138, 1, 10137, 1, 0, 1
2713, 1, 1636424507034, 1636424507645, 611, 262, 349, 0, 0, 0
2674, 2, 1636424497553, 1636424507688, 10135, 0, 10135, 0, 0, 0
2712, 1, 1636424507002, 1636424507990, 988, 586, 402, 0, 3, 3
2711, 1, 1636424506962, 1636424507990, 1028, 622, 406, 0, 15, 15
2678, 2, 1636424498094, 1636424508233, 10139, 1, 10138, 0, 1, 1
2714, 1, 1636424507689, 1636424508446, 757, 358, 399, 1, 0, 1
2681, 2, 1636424498570, 1636424508705, 10135, 1, 10134, 1, 0, 1
2716, 1, 1636424508058, 1636424508774, 716, 265, 451, 0, 0, 0
2717, 1, 1636424508370, 1636424509058, 688, 294, 394, 1, 27, 28
2718, 1, 1636424508754, 1636424509382, 628, 270, 358, 1, 0, 1
2719, 1, 1636424508825, 1636424509450, 625, 265, 360, 1, 0, 1
2720, 1, 1636424508834, 1636424509506, 672, 273, 399, 0, 0, 0
2687, 2, 1636424499406, 1636424509545, 10139, 1, 10138, 0, 0, 0
2723, 1, 1636424508939, 1636424509570, 631, 270, 361, 0, 0, 0
2721, 1, 1636424508913, 1636424509830, 917, 558, 359, 1, 0, 1
2722, 1, 1636424508923, 1636424509910, 987, 627, 360, 0, 8, 8
2690, 2, 1636424499951, 1636424510085, 10134, 0, 10134, 0, 0, 0
2724, 1, 1636424509546, 1636424510286, 740, 382, 358, 1, 0, 1
2725, 1, 1636424509674, 1636424510350, 676, 262, 414, 1, 0, 1
2726, 1, 1636424509983, 1636424510634, 651, 274, 377, 1, 0, 1
2727, 1, 1636424510214, 1636424510890, 676, 270, 406, 0, 0, 0
2728, 1, 1636424510301, 1636424510930, 629, 270, 359, 0, 0, 0
2694, 2, 1636424500872, 1636424511005, 10133, 0, 10133, 0, 0, 0
2695, 2, 1636424501009, 1636424511145, 10136, 0, 10136, 0, 0, 0
2730, 1, 1636424510713, 1636424511414, 701, 342, 359, 0, 28, 28
2729, 1, 1636424510697, 1636424511418, 721, 310, 411, 1, 40, 41
2731, 1, 1636424510804, 1636424511506, 702, 303, 399, 2, 28, 30
2734, 1, 1636424511067, 1636424511730, 663, 271, 392, 3, 0, 3
2735, 1, 1636424511146, 1636424511814, 668, 266, 402, 0, 0, 0
2732, 1, 1636424510811, 1636424511870, 1059, 702, 357, 1, 0, 1
2733, 1, 1636424510901, 1636424511950, 1049, 678, 371, 0, 1, 1
2699, 2, 1636424501943, 1636424512077, 10134, 1, 10133, 0, 1, 1
2738, 1, 1636424511540, 1636424512162, 622, 270, 352, 0, 1, 1
2736, 1, 1636424511274, 1636424512262, 988, 594, 394, 0, 0, 0
2737, 1, 1636424511420, 1636424512346, 926, 569, 357, 0, 23, 23
2739, 1, 1636424511854, 1636424512522, 668, 315, 353, 2, 47, 49
2740, 1, 1636424512164, 1636424512790, 626, 270, 356, 0, 1, 1
2701, 2, 1636424502669, 1636424512809, 10140, 1, 10139, 1, 0, 1
2741, 1, 1636424512198, 1636424512866, 668, 270, 398, 1, 0, 1
2742, 1, 1636424512255, 1636424512886, 631, 272, 359, 0, 0, 0
2744, 1, 1636424512663, 1636424513286, 623, 270, 353, 1, 0, 1
2704, 2, 1636424503194, 1636424513329, 10135, 0, 10135, 0, 0, 0
2743, 1, 1636424512644, 1636424513334, 690, 334, 356, 1, 0, 1
2746, 1, 1636424512810, 1636424513386, 576, 270, 306, 1, 0, 1
2748, 1, 1636424512942, 1636424513610, 668, 270, 398, 0, 0, 0
2749, 1, 1636424513046, 1636424513686, 640, 286, 354, 0, 16, 16
2750, 1, 1636424513084, 1636424513702, 618, 266, 352, 1, 0, 1
2745, 1, 1636424512731, 1636424513774, 1043, 658, 385, 2, 44, 46
2747, 1, 1636424512857, 1636424513838, 981, 622, 359, 0, 0, 0
2705, 2, 1636424503880, 1636424514017, 10137, 1, 10136, 0, 0, 0
2753, 1, 1636424513466, 1636424514130, 664, 266, 398, 0, 0, 0
2751, 1, 1636424513196, 1636424514150, 954, 595, 359, 0, 0, 0
2752, 1, 1636424513364, 1636424514222, 858, 502, 356, 0, 0, 0
2754, 1, 1636424513483, 1636424514286, 803, 450, 353, 0, 0, 0
2706, 2, 1636424504454, 1636424514588, 10134, 0, 10134, 0, 0, 0
2755, 1, 1636424513853, 1636424514602, 749, 394, 355, 1, 0, 1
2757, 1, 1636424514127, 1636424514746, 619, 265, 354, 0, 0, 0
2759, 1, 1636424514215, 1636424514854, 639, 285, 354, 0, 15, 15
2758, 1, 1636424514150, 1636424514858, 708, 302, 406, 0, 35, 35
2756, 1, 1636424514085, 1636424515046, 961, 603, 358, 1, 0, 1
2707, 2, 1636424504935, 1636424515069, 10134, 0, 10134, 0, 0, 0
2761, 1, 1636424514650, 1636424515270, 620, 263, 357, 0, 0, 0
2760, 1, 1636424514615, 1636424515334, 719, 361, 358, 1, 35, 36
2764, 1, 1636424514718, 1636424515422, 704, 306, 398, 0, 40, 40
2715, 1, 1636424507818, 1636424515554, 7736, 7338, 398, 0, 0, 0
2767, 1, 1636424515069, 1636424515646, 577, 262, 315, 0, 0, 0
2765, 1, 1636424514806, 1636424515722, 916, 562, 354, 0, 0, 0
2768, 1, 1636424515142, 1636424515766, 624, 270, 354, 1, 0, 1
2770, 1, 1636424515194, 1636424515882, 688, 278, 410, 0, 0, 0
2773, 1, 1636424515432, 1636424516070, 638, 270, 368, 0, 0, 0
2769, 1, 1636424515190, 1636424516106, 916, 551, 365, 1, 1, 2
2774, 1, 1636424515556, 1636424516226, 670, 269, 401, 0, 0, 0
2775, 1, 1636424515935, 1636424516562, 627, 270, 357, 1, 0, 1
2777, 1, 1636424516063, 1636424516690, 627, 271, 356, 0, 1, 1
2778, 1, 1636424516069, 1636424516694, 625, 271, 354, 0, 0, 0
2779, 1, 1636424516164, 1636424516778, 614, 262, 352, 0, 0, 0
2780, 1, 1636424516522, 1636424517230, 708, 349, 359, 0, 0, 0
2784, 1, 1636424516992, 1636424517618, 626, 270, 356, 0, 0, 0
2786, 1, 1636424517102, 1636424517734, 632, 270, 362, 1, 0, 1
2788, 1, 1636424517385, 1636424518014, 629, 270, 359, 0, 0, 0
2785, 1, 1636424517090, 1636424518062, 972, 614, 358, 0, 0, 0
2789, 1, 1636424517458, 1636424518086, 628, 269, 359, 0, 0, 0
2790, 1, 1636424517953, 1636424518586, 633, 274, 359, 2, 0, 2
2791, 1, 1636424518005, 1636424518630, 625, 265, 360, 0, 0, 0
2792, 1, 1636424518073, 1636424518702, 629, 270, 359, 0, 1, 1
2795, 1, 1636424518877, 1636424519502, 625, 266, 359, 0, 1, 1
2796, 1, 1636424518982, 1636424519610, 628, 269, 359, 1, 0, 1
2797, 1, 1636424519006, 1636424519958, 952, 594, 358, 0, 0, 0
2799, 1, 1636424519463, 1636424520086, 623, 269, 354, 0, 1, 1
2800, 1, 1636424519889, 1636424520518, 629, 271, 358, 1, 1, 2
2802, 1, 1636424520151, 1636424520782, 631, 270, 361, 3, 0, 3
2805, 1, 1636424521079, 1636424521702, 623, 269, 354, 0, 0, 0
2806, 1, 1636424521600, 1636424522226, 626, 270, 356, 1, 0, 1
2808, 1, 1636424522224, 1636424522854, 630, 269, 361, 0, 0, 0
2809, 1, 1636424523123, 1636424523754, 631, 271, 360, 1, 1, 2
2810, 1, 1636424523604, 1636424524226, 622, 270, 352, 0, 0, 0
2762, 2, 1636424514661, 1636424524801, 10140, 1, 10139, 1, 1, 2
2811, 1, 1636424524190, 1636424524818, 628, 271, 357, 2, 2, 4
2763, 2, 1636424514673, 1636424524845, 10172, 1, 10171, 0, 0, 0
2766, 2, 1636424514864, 1636424524997, 10133, 0, 10133, 0, 0, 0
2771, 2, 1636424515325, 1636424525461, 10136, 0, 10136, 0, 0, 0
2772, 2, 1636424515351, 1636424525509, 10158, 0, 10158, 0, 0, 0
2812, 1, 1636424525085, 1636424525778, 693, 287, 406, 2, 16, 18
2813, 1, 1636424525134, 1636424525866, 732, 286, 446, 1, 12, 13
2814, 1, 1636424525134, 1636424525874, 740, 287, 453, 3, 12, 15
2776, 2, 1636424516026, 1636424526161, 10135, 1, 10134, 2, 0, 2
2817, 1, 1636424525603, 1636424526230, 627, 269, 358, 0, 0, 0
2818, 1, 1636424525614, 1636424526330, 716, 314, 402, 1, 0, 1
2781, 2, 1636424516540, 1636424526673, 10133, 0, 10133, 0, 0, 0
2819, 1, 1636424526081, 1636424526746, 665, 265, 400, 0, 0, 0
2782, 2, 1636424516623, 1636424526757, 10134, 0, 10134, 0, 0, 0
2783, 2, 1636424516755, 1636424526889, 10134, 0, 10134, 0, 0, 0
2820, 1, 1636424526290, 1636424526962, 672, 270, 402, 2, 0, 2
2787, 2, 1636424517146, 1636424527285, 10139, 0, 10139, 0, 0, 0
2821, 1, 1636424526890, 1636424527562, 672, 267, 405, 1, 0, 1
2823, 1, 1636424526979, 1636424527642, 663, 311, 352, 0, 41, 41
2824, 1, 1636424527017, 1636424527646, 629, 275, 354, 0, 9, 9
2826, 1, 1636424527123, 1636424527754, 631, 271, 360, 1, 0, 1
2827, 1, 1636424527414, 1636424528082, 668, 269, 399, 0, 0, 0
2828, 1, 1636424527556, 1636424528186, 630, 271, 359, 1, 1, 2
2829, 1, 1636424527594, 1636424528222, 628, 270, 358, 1, 0, 1
2793, 2, 1636424518149, 1636424528285, 10136, 0, 10136, 0, 0, 0
2794, 2, 1636424518478, 1636424528617, 10139, 1, 10138, 0, 0, 0
2831, 1, 1636424528194, 1636424528826, 632, 272, 360, 1, 1, 2
2830, 1, 1636424528168, 1636424528830, 662, 271, 391, 1, 1, 2
2834, 1, 1636424528822, 1636424529450, 628, 270, 358, 1, 0, 1
2835, 1, 1636424528900, 1636424529526, 626, 270, 356, 1, 0, 1
2836, 1, 1636424528958, 1636424529586, 628, 270, 358, 0, 0, 0
2798, 2, 1636424519459, 1636424529593, 10134, 0, 10134, 0, 0, 0
2837, 1, 1636424529228, 1636424529862, 634, 278, 356, 0, 12, 12
2838, 1, 1636424529362, 1636424529986, 624, 265, 359, 0, 0, 0
2801, 2, 1636424519906, 1636424530041, 10135, 1, 10134, 1, 0, 1
2839, 1, 1636424529487, 1636424530122, 635, 266, 369, 1, 0, 1
2840, 1, 1636424529529, 1636424530166, 637, 265, 372, 0, 1, 1
2841, 1, 1636424529722, 1636424530394, 672, 274, 398, 0, 7, 7
2842, 1, 1636424530125, 1636424530754, 629, 272, 357, 1, 2, 3
2844, 1, 1636424530236, 1636424530858, 622, 266, 356, 0, 0, 0
2803, 2, 1636424520767, 1636424530897, 10130, 0, 10130, 0, 0, 0
2804, 2, 1636424520902, 1636424531037, 10135, 0, 10135, 0, 0, 0
2845, 1, 1636424530705, 1636424531394, 689, 283, 406, 1, 16, 17
2846, 1, 1636424530898, 1636424531534, 636, 270, 366, 2, 1, 3
2847, 1, 1636424530898, 1636424531534, 636, 271, 365, 2, 1, 3
2807, 1, 1636424521842, 1636424531538, 9696, 9328, 368, 0, 1, 1
2850, 1, 1636424531244, 1636424531866, 622, 266, 356, 0, 0, 0
2851, 1, 1636424531309, 1636424531942, 633, 266, 367, 0, 0, 0
2852, 1, 1636424531352, 1636424531986, 634, 274, 360, 0, 0, 0
2854, 1, 1636424531554, 1636424532186, 632, 269, 363, 0, 1, 1
2855, 1, 1636424531788, 1636424532414, 626, 272, 354, 1, 1, 2
2856, 1, 1636424531990, 1636424532626, 636, 269, 367, 1, 0, 1
2857, 1, 1636424532334, 1636424532970, 636, 273, 363, 1, 0, 1
2858, 1, 1636424532652, 1636424533282, 630, 274, 356, 2, 0, 2
2860, 1, 1636424532974, 1636424533610, 636, 264, 372, 0, 0, 0
2861, 1, 1636424533221, 1636424533850, 629, 271, 358, 2, 0, 2
2862, 1, 1636424533241, 1636424533870, 629, 271, 358, 1, 0, 1
2864, 1, 1636424533600, 1636424534226, 626, 269, 357, 0, 0, 0
2865, 1, 1636424533695, 1636424534326, 631, 270, 361, 1, 0, 1
2867, 1, 1636424534269, 1636424534902, 633, 269, 364, 0, 0, 0
2815, 2, 1636424525142, 1636424535325, 10183, 0, 10183, 0, 0, 0
2869, 1, 1636424534997, 1636424535626, 629, 269, 360, 0, 1, 1
2816, 2, 1636424525598, 1636424535773, 10175, 0, 10175, 1, 0, 1
2870, 1, 1636424535155, 1636424535782, 627, 270, 357, 0, 0, 0
2872, 1, 1636424535616, 1636424536246, 630, 269, 361, 0, 0, 0
2874, 1, 1636424535958, 1636424536630, 672, 270, 402, 0, 1, 1
2876, 1, 1636424536240, 1636424536866, 626, 269, 357, 0, 0, 0
2822, 2, 1636424526890, 1636424537029, 10139, 0, 10139, 0, 0, 0
2875, 1, 1636424535959, 1636424537082, 1123, 717, 406, 1, 0, 1
2825, 2, 1636424527018, 1636424537197, 10179, 0, 10179, 0, 0, 0
2877, 1, 1636424536978, 1636424537650, 672, 307, 365, 0, 41, 41
2878, 1, 1636424537198, 1636424537870, 672, 271, 401, 2, 1, 3
2881, 1, 1636424537551, 1636424538178, 627, 269, 358, 1, 0, 1
2880, 1, 1636424537331, 1636424538326, 995, 595, 400, 0, 1, 1
2882, 1, 1636424537871, 1636424538498, 627, 269, 358, 1, 0, 1
2832, 2, 1636424528414, 1636424538589, 10175, 0, 10175, 0, 0, 0
2884, 1, 1636424538189, 1636424538858, 669, 309, 360, 1, 40, 41
2833, 2, 1636424528746, 1636424538921, 10175, 0, 10175, 0, 0, 0
2883, 1, 1636424537877, 1636424538954, 1077, 717, 360, 0, 0, 0
2885, 1, 1636424538718, 1636424539386, 668, 270, 398, 0, 1, 1
2886, 1, 1636424538953, 1636424539582, 629, 270, 359, 1, 1, 2
2888, 1, 1636424539062, 1636424539694, 632, 270, 362, 1, 0, 1
2887, 1, 1636424539050, 1636424539838, 788, 384, 404, 0, 0, 0
2890, 1, 1636424539521, 1636424540154, 633, 269, 364, 1, 0, 1
2889, 1, 1636424539270, 1636424540154, 884, 522, 362, 1, 0, 1
2843, 2, 1636424530171, 1636424540349, 10178, 0, 10178, 1, 0, 1
2891, 1, 1636424539788, 1636424540422, 634, 269, 365, 1, 0, 1
2893, 1, 1636424540168, 1636424540802, 634, 279, 355, 1, 10, 11
2892, 1, 1636424539828, 1636424540870, 1042, 686, 356, 0, 1, 1
2848, 2, 1636424531037, 1636424541217, 10180, 0, 10180, 1, 0, 1
2895, 1, 1636424540606, 1636424541234, 628, 270, 358, 0, 0, 0
2894, 1, 1636424540478, 1636424541330, 852, 445, 407, 1, 0, 1
2849, 2, 1636424531170, 1636424541349, 10179, 1, 10178, 1, 0, 1
2896, 1, 1636424540983, 1636424541706, 723, 366, 357, 0, 25, 25
2853, 2, 1636424531539, 1636424541713, 10174, 0, 10174, 0, 0, 0
2898, 1, 1636424541001, 1636424541718, 717, 346, 371, 0, 76, 76
2897, 1, 1636424540989, 1636424541798, 809, 456, 353, 0, 16, 16
2902, 1, 1636424541500, 1636424542166, 666, 312, 354, 1, 42, 43
2903, 1, 1636424541838, 1636424542474, 636, 272, 364, 0, 0, 0
2906, 1, 1636424542197, 1636424542822, 625, 271, 354, 0, 2, 2
2905, 1, 1636424541916, 1636424542922, 1006, 646, 360, 1, 0, 1
2907, 1, 1636424542405, 1636424543030, 625, 269, 356, 0, 0, 0
2859, 2, 1636424532914, 1636424543049, 10135, 1, 10134, 1, 1, 2
2863, 2, 1636424533433, 1636424543569, 10136, 1, 10135, 0, 0, 0
2910, 1, 1636424543063, 1636424543686, 623, 268, 355, 0, 0, 0
2911, 1, 1636424543080, 1636424543706, 626, 270, 356, 1, 0, 1
2913, 1, 1636424543417, 1636424544050, 633, 270, 363, 0, 0, 0
2866, 2, 1636424534071, 1636424544205, 10134, 0, 10134, 0, 0, 0
2915, 1, 1636424543769, 1636424544398, 629, 270, 359, 1, 0, 1
2917, 1, 1636424544149, 1636424544790, 641, 270, 371, 0, 1, 1
2916, 1, 1636424543831, 1636424544854, 1023, 662, 361, 1, 0, 1
2868, 2, 1636424534732, 1636424544865, 10133, 1, 10132, 1, 0, 1
2871, 2, 1636424535326, 1636424545461, 10135, 0, 10135, 1, 0, 1
2921, 1, 1636424545041, 1636424545670, 629, 270, 359, 1, 0, 1
2922, 1, 1636424545048, 1636424545678, 630, 269, 361, 1, 0, 1
2879, 1, 1636424537226, 1636424545958, 8732, 8370, 362, 0, 0, 0
2873, 2, 1636424535827, 1636424545961, 10134, 1, 10133, 0, 0, 0
2923, 1, 1636424545462, 1636424546086, 624, 270, 354, 2, 0, 2
2925, 1, 1636424545876, 1636424546514, 638, 276, 362, 0, 0, 0
2927, 1, 1636424545962, 1636424546646, 684, 273, 411, 0, 1, 1
2929, 1, 1636424546102, 1636424546734, 632, 270, 362, 0, 2, 2
2928, 1, 1636424546090, 1636424546758, 668, 265, 403, 0, 0, 0
2926, 1, 1636424545906, 1636424546966, 1060, 691, 369, 0, 0, 0
2930, 1, 1636424546939, 1636424547570, 631, 270, 361, 0, 0, 0
2931, 1, 1636424547142, 1636424547778, 636, 271, 365, 2, 0, 2
2932, 1, 1636424547390, 1636424548018, 628, 270, 358, 1, 0, 1
2933, 1, 1636424547788, 1636424548414, 626, 269, 357, 0, 1, 1
2934, 1, 1636424547863, 1636424548486, 623, 269, 354, 1, 0, 1
2936, 1, 1636424547957, 1636424548590, 633, 270, 363, 0, 0, 0
2937, 1, 1636424548068, 1636424548698, 630, 269, 361, 1, 0, 1
2935, 1, 1636424547876, 1636424548870, 994, 633, 361, 1, 1, 2
2938, 1, 1636424548872, 1636424549498, 626, 269, 357, 1, 0, 1
2939, 1, 1636424549053, 1636424549678, 625, 266, 359, 0, 0, 0
2940, 1, 1636424549336, 1636424549966, 630, 271, 359, 2, 0, 2
2941, 1, 1636424549741, 1636424550370, 629, 270, 359, 1, 0, 1
2943, 1, 1636424549906, 1636424550534, 628, 269, 359, 1, 0, 1
2944, 1, 1636424549953, 1636424550586, 633, 270, 363, 1, 0, 1
2945, 1, 1636424549960, 1636424550590, 630, 265, 365, 0, 0, 0
2942, 1, 1636424549832, 1636424550826, 994, 634, 360, 0, 0, 0
2899, 2, 1636424541218, 1636424551393, 10175, 0, 10175, 0, 0, 0
2900, 2, 1636424541350, 1636424551530, 10180, 0, 10180, 0, 0, 0
2901, 2, 1636424541478, 1636424551653, 10175, 0, 10175, 0, 0, 0
2947, 1, 1636424551006, 1636424551666, 660, 297, 363, 1, 32, 33
2948, 1, 1636424551301, 1636424551926, 625, 266, 359, 0, 0, 0
2904, 2, 1636424541850, 1636424552025, 10175, 0, 10175, 1, 0, 1
2950, 1, 1636424551858, 1636424552478, 620, 263, 357, 2, 0, 2
2949, 1, 1636424551848, 1636424552478, 630, 271, 359, 0, 5, 5
2953, 1, 1636424551887, 1636424552562, 675, 272, 403, 4, 0, 4
2951, 1, 1636424551886, 1636424552566, 680, 270, 410, 1, 0, 1
2955, 1, 1636424552028, 1636424552654, 626, 265, 361, 0, 0, 0
2908, 2, 1636424542524, 1636424552657, 10133, 0, 10133, 0, 0, 0
2956, 1, 1636424552086, 1636424552718, 632, 270, 362, 0, 0, 0
2954, 1, 1636424551912, 1636424552930, 1018, 632, 386, 0, 0, 0
2909, 2, 1636424542881, 1636424553021, 10140, 0, 10140, 0, 0, 0
2912, 2, 1636424543182, 1636424553361, 10179, 1, 10178, 1, 1, 2
2958, 1, 1636424552786, 1636424553478, 692, 290, 402, 1, 21, 22
2959, 1, 1636424553126, 1636424553754, 628, 267, 361, 2, 0, 2
2961, 1, 1636424553166, 1636424553810, 644, 271, 373, 0, 0, 0
2914, 2, 1636424543698, 1636424553873, 10175, 0, 10175, 0, 1, 1
2960, 1, 1636424553150, 1636424553930, 780, 381, 399, 1, 0, 1
2963, 1, 1636424553894, 1636424554514, 620, 265, 355, 2, 0, 2
2919, 2, 1636424544384, 1636424554517, 10133, 0, 10133, 1, 0, 1
2964, 1, 1636424553896, 1636424554522, 626, 270, 356, 3, 0, 3
2918, 2, 1636424544339, 1636424554560, 10221, 1, 10220, 1, 0, 1
2967, 1, 1636424553974, 1636424554602, 628, 270, 358, 1, 1, 2
2970, 1, 1636424554048, 1636424554666, 618, 266, 352, 0, 1, 1
2968, 1, 1636424553988, 1636424555058, 1070, 710, 360, 0, 0, 0
2920, 2, 1636424544994, 1636424555177, 10183, 0, 10183, 0, 0, 0
2972, 1, 1636424554651, 1636424555326, 675, 271, 404, 1, 1, 2
2973, 1, 1636424554842, 1636424555470, 628, 270, 358, 1, 1, 2
2924, 2, 1636424545594, 1636424555769, 10175, 0, 10175, 0, 0, 0
2974, 1, 1636424555177, 1636424555807, 630, 270, 360, 1, 0, 1
2976, 1, 1636424555248, 1636424555874, 626, 269, 357, 0, 1, 1
2975, 1, 1636424555188, 1636424555918, 730, 373, 357, 0, 0, 0
2978, 1, 1636424555884, 1636424556510, 626, 271, 355, 1, 1, 2
2980, 1, 1636424555915, 1636424556546, 631, 273, 358, 1, 1, 2
2981, 1, 1636424555942, 1636424556570, 628, 269, 359, 1, 0, 1
2983, 1, 1636424555976, 1636424556969, 993, 625, 368, 0, 0, 0
2982, 1, 1636424555954, 1636424557002, 1048, 690, 358, 1, 0, 1
2984, 1, 1636424556658, 1636424557281, 623, 273, 350, 2, 0, 2
2985, 1, 1636424556833, 1636424557449, 616, 262, 354, 0, 0, 0
2986, 1, 1636424557117, 1636424557734, 617, 261, 356, 0, 0, 0
2988, 1, 1636424557131, 1636424557746, 615, 264, 351, 1, 1, 2
2987, 1, 1636424557123, 1636424557894, 771, 418, 353, 0, 0, 0
2989, 1, 1636424557785, 1636424558410, 625, 262, 363, 0, 0, 0
2990, 1, 1636424557861, 1636424558490, 629, 270, 359, 0, 0, 0
2992, 1, 1636424557940, 1636424558566, 626, 270, 356, 0, 0, 0
2993, 1, 1636424557941, 1636424558570, 629, 270, 359, 2, 0, 2
2991, 1, 1636424557928, 1636424558946, 1018, 661, 357, 1, 0, 1
2995, 1, 1636424558739, 1636424559366, 627, 270, 357, 0, 0, 0
2994, 1, 1636424558648, 1636424559402, 754, 394, 360, 1, 1, 2
2996, 1, 1636424558979, 1636424559614, 635, 269, 366, 0, 0, 0
2998, 1, 1636424559088, 1636424559822, 734, 373, 361, 0, 0, 0
2997, 1, 1636424559061, 1636424559854, 793, 433, 360, 1, 0, 1
2999, 1, 1636424559750, 1636424560378, 628, 270, 358, 0, 0, 0
3000, 1, 1636424559881, 1636424560510, 629, 271, 358, 1, 0, 1
3001, 1, 1636424559885, 1636424560526, 641, 278, 363, 0, 0, 0
3003, 1, 1636424559932, 1636424560554, 622, 266, 356, 1, 0, 1
3002, 1, 1636424559921, 1636424560826, 905, 545, 360, 0, 0, 0
2946, 2, 1636424550913, 1636424561045, 10132, 0, 10132, 1, 0, 1
3004, 1, 1636424560624, 1636424561258, 634, 273, 361, 1, 0, 1
3005, 1, 1636424560836, 1636424561498, 662, 307, 355, 2, 32, 34
2966, 1, 1636424553962, 1636424561530, 7568, 7210, 358, 1, 0, 1
3006, 1, 1636424561046, 1636424561670, 624, 266, 358, 0, 0, 0
3007, 1, 1636424561112, 1636424561742, 630, 268, 362, 0, 0, 0
3009, 1, 1636424561182, 1636424561854, 672, 274, 398, 2, 0, 2
3008, 1, 1636424561152, 1636424561958, 806, 450, 356, 0, 1, 1
2952, 2, 1636424551886, 1636424562073, 10187, 1, 10186, 2, 0, 2
3010, 1, 1636424561532, 1636424562202, 670, 270, 400, 1, 0, 1
2957, 2, 1636424552154, 1636424562329, 10175, 0, 10175, 0, 0, 0
3011, 1, 1636424561694, 1636424562338, 644, 285, 359, 2, 15, 17
3012, 1, 1636424561833, 1636424562462, 629, 267, 362, 1, 0, 1
3015, 1, 1636424561929, 1636424562594, 665, 305, 360, 0, 35, 35
3014, 1, 1636424561926, 1636424562594, 668, 265, 403, 1, 0, 1
3013, 1, 1636424561916, 1636424562798, 882, 526, 356, 0, 1, 1
3016, 1, 1636424562649, 1636424563274, 625, 269, 356, 1, 0, 1
3019, 1, 1636424562904, 1636424563534, 630, 270, 360, 1, 0, 1
3020, 1, 1636424562980, 1636424563610, 630, 270, 360, 2, 0, 2
3021, 1, 1636424562988, 1636424563618, 630, 274, 356, 0, 0, 0
2962, 2, 1636424553490, 1636424563669, 10179, 0, 10179, 1, 0, 1
3023, 1, 1636424563247, 1636424564026, 779, 427, 352, 2, 40, 42
2965, 2, 1636424553912, 1636424564045, 10133, 0, 10133, 0, 0, 0
2969, 2, 1636424554007, 1636424564189, 10182, 0, 10182, 0, 0, 0
3025, 1, 1636424563738, 1636424564402, 664, 311, 353, 1, 42, 43
3027, 1, 1636424563857, 1636424564490, 633, 282, 351, 0, 16, 16
3029, 1, 1636424563992, 1636424564638, 646, 280, 366, 0, 13, 13
3030, 1, 1636424564047, 1636424564682, 635, 276, 359, 1, 1, 2
2971, 2, 1636424554650, 1636424564825, 10175, 0, 10175, 0, 0, 0
3028, 1, 1636424563930, 1636424564854, 924, 537, 387, 1, 1, 2
3033, 1, 1636424564657, 1636424565286, 629, 274, 355, 0, 1, 1
2977, 2, 1636424555310, 1636424565489, 10179, 0, 10179, 0, 1, 1
3034, 1, 1636424564927, 1636424565562, 635, 273, 362, 0, 0, 0
3036, 1, 1636424564981, 1636424565614, 633, 273, 360, 1, 0, 1
3037, 1, 1636424565108, 1636424565758, 650, 295, 355, 0, 24, 24
2979, 1, 1636424555902, 1636424565982, 10080, 9683, 397, 2, 0, 2
3038, 1, 1636424565261, 1636424566074, 813, 458, 355, 0, 2, 2
3040, 1, 1636424565801, 1636424566430, 629, 271, 358, 0, 1, 1
3041, 1, 1636424565896, 1636424566518, 622, 269, 353, 1, 1, 2
3042, 1, 1636424565902, 1636424566530, 628, 271, 357, 0, 0, 0
3044, 1, 1636424565993, 1636424566626, 633, 270, 363, 0, 0, 0
3043, 1, 1636424565940, 1636424566886, 946, 586, 360, 0, 0, 0
3046, 1, 1636424566734, 1636424567362, 628, 269, 359, 0, 1, 1
3047, 1, 1636424566917, 1636424567546, 629, 269, 360, 1, 1, 2
3049, 1, 1636424567152, 1636424567778, 626, 270, 356, 2, 1, 3
3050, 1, 1636424567167, 1636424568006, 839, 477, 362, 0, 1, 1
3051, 1, 1636424567756, 1636424568378, 622, 270, 352, 2, 1, 3
3053, 1, 1636424567898, 1636424568526, 628, 268, 360, 1, 0, 1
3054, 1, 1636424567919, 1636424568538, 619, 262, 357, 1, 0, 1
3055, 1, 1636424567963, 1636424568582, 619, 267, 352, 1, 0, 1
3052, 1, 1636424567889, 1636424568830, 941, 581, 360, 0, 0, 0
3056, 1, 1636424568661, 1636424569290, 629, 269, 360, 0, 1, 1
3057, 1, 1636424568886, 1636424569518, 632, 272, 360, 0, 2, 2
3058, 1, 1636424569106, 1636424569734, 628, 269, 359, 1, 0, 1
3059, 1, 1636424569141, 1636424569974, 833, 474, 359, 1, 0, 1
3060, 1, 1636424569756, 1636424570386, 630, 271, 359, 2, 0, 2
3061, 1, 1636424569851, 1636424570470, 619, 267, 352, 1, 1, 2
3063, 1, 1636424569902, 1636424570534, 632, 271, 361, 1, 2, 3
3064, 1, 1636424569912, 1636424570538, 626, 267, 359, 1, 1, 2
3062, 1, 1636424569864, 1636424570842, 978, 620, 358, 1, 0, 1
3065, 1, 1636424570631, 1636424571258, 627, 269, 358, 1, 0, 1
3066, 1, 1636424570864, 1636424571494, 630, 270, 360, 1, 0, 1
3068, 1, 1636424571106, 1636424571734, 628, 267, 361, 3, 0, 3
3067, 1, 1636424571038, 1636424571954, 916, 552, 364, 0, 0, 0
3069, 1, 1636424571804, 1636424572442, 638, 273, 365, 2, 0, 2
3070, 1, 1636424571821, 1636424572454, 633, 274, 359, 0, 0, 0
3072, 1, 1636424571902, 1636424572530, 628, 270, 358, 0, 0, 0
3073, 1, 1636424571933, 1636424572562, 629, 270, 359, 2, 0, 2
3018, 2, 1636424562654, 1636424572828, 10174, 1, 10173, 1, 1, 2
3017, 2, 1636424562654, 1636424572873, 10219, 0, 10219, 0, 1, 1
3071, 1, 1636424571878, 1636424572886, 1008, 656, 352, 0, 1, 1
3074, 1, 1636424572580, 1636424573234, 654, 297, 357, 0, 27, 27
3022, 2, 1636424563203, 1636424573337, 10134, 1, 10133, 2, 0, 2
3075, 1, 1636424572829, 1636424573458, 629, 270, 359, 1, 0, 1
3076, 1, 1636424572958, 1636424573626, 668, 273, 395, 0, 0, 0
3024, 2, 1636424563617, 1636424573761, 10144, 0, 10144, 0, 0, 0
3079, 1, 1636424573110, 1636424573778, 668, 266, 402, 0, 0, 0
3078, 1, 1636424573017, 1636424573914, 897, 533, 364, 0, 0, 0
3026, 2, 1636424563798, 1636424573977, 10179, 1, 10178, 0, 1, 1
3077, 1, 1636424572962, 1636424574118, 1156, 756, 400, 0, 35, 35
3080, 1, 1636424573470, 1636424574134, 664, 269, 395, 0, 0, 0
3031, 2, 1636424564189, 1636424574365, 10176, 0, 10176, 0, 0, 0
3081, 1, 1636424573799, 1636424574426, 627, 269, 358, 1, 3, 4
3082, 1, 1636424573834, 1636424574454, 620, 266, 354, 0, 1, 1
3032, 2, 1636424564314, 1636424574493, 10179, 0, 10179, 0, 0, 0
3083, 1, 1636424573886, 1636424574510, 624, 267, 357, 2, 0, 2
3084, 1, 1636424573890, 1636424574558, 668, 267, 401, 2, 1, 3
3086, 1, 1636424574001, 1636424574630, 629, 273, 356, 0, 3, 3
3087, 1, 1636424574106, 1636424574854, 748, 346, 402, 1, 75, 76
3085, 1, 1636424573978, 1636424574946, 968, 611, 357, 2, 40, 42
3088, 1, 1636424574493, 1636424575118, 625, 270, 355, 2, 0, 2
3035, 2, 1636424564954, 1636424575137, 10183, 0, 10183, 0, 0, 0
3092, 1, 1636424574863, 1636424575498, 635, 274, 361, 1, 4, 5
3091, 1, 1636424574857, 1636424575502, 645, 282, 363, 1, 12, 13
3039, 2, 1636424565618, 1636424575797, 10179, 0, 10179, 0, 0, 0
3095, 1, 1636424575237, 1636424575862, 625, 268, 357, 1, 1, 2
3093, 1, 1636424574893, 1636424575954, 1061, 701, 360, 2, 0, 2
3094, 1, 1636424575138, 1636424575958, 820, 457, 363, 1, 0, 1
3097, 1, 1636424575363, 1636424575986, 623, 266, 357, 1, 0, 1
3045, 1, 1636424565993, 1636424576294, 10301, 9902, 399, 0, 0, 0
3098, 1, 1636424575798, 1636424576426, 628, 270, 358, 1, 0, 1
3099, 1, 1636424575798, 1636424576426, 628, 270, 358, 1, 0, 1
3101, 1, 1636424575872, 1636424576494, 622, 269, 353, 0, 0, 0
3103, 1, 1636424575917, 1636424576538, 621, 266, 355, 0, 0, 0
3105, 1, 1636424575966, 1636424576590, 624, 266, 358, 2, 0, 2
3100, 1, 1636424575813, 1636424576882, 1069, 710, 359, 0, 0, 0
3048, 2, 1636424566944, 1636424577077, 10133, 0, 10133, 0, 1, 1
3107, 1, 1636424576518, 1636424577146, 628, 270, 358, 2, 0, 2
3102, 1, 1636424575882, 1636424577342, 1460, 1101, 359, 0, 8, 8
3108, 1, 1636424576800, 1636424577438, 638, 282, 356, 2, 16, 18
3112, 1, 1636424577206, 1636424577834, 628, 265, 363, 0, 0, 0
3113, 1, 1636424577210, 1636424577882, 672, 271, 401, 1, 0, 1
3111, 1, 1636424577021, 1636424577886, 865, 500, 365, 2, 0, 2
3114, 1, 1636424577319, 1636424577938, 619, 270, 349, 1, 1, 2
3115, 1, 1636424577759, 1636424578394, 635, 269, 366, 2, 0, 2
3117, 1, 1636424577818, 1636424578438, 620, 271, 349, 0, 0, 0
3116, 1, 1636424577813, 1636424578450, 637, 275, 362, 1, 1, 2
3118, 1, 1636424577825, 1636424578462, 637, 270, 367, 2, 0, 2
3120, 1, 1636424577853, 1636424578486, 633, 266, 367, 0, 0, 0
3119, 1, 1636424577845, 1636424578902, 1057, 700, 357, 1, 0, 1
3122, 1, 1636424578470, 1636424579098, 628, 270, 358, 1, 0, 1
3123, 1, 1636424578747, 1636424579562, 815, 453, 362, 0, 0, 0
3125, 1, 1636424579073, 1636424579706, 633, 270, 363, 0, 0, 0
3126, 1, 1636424579095, 1636424579722, 627, 269, 358, 0, 0, 0
3124, 1, 1636424578939, 1636424580010, 1071, 719, 352, 2, 1, 3
3127, 1, 1636424579416, 1636424580042, 626, 269, 357, 0, 0, 0
3128, 1, 1636424579746, 1636424580378, 632, 267, 365, 2, 0, 2
3130, 1, 1636424579791, 1636424580406, 615, 260, 355, 1, 0, 1
3131, 1, 1636424579796, 1636424580410, 614, 263, 351, 0, 0, 0
3129, 1, 1636424579770, 1636424580454, 684, 327, 357, 1, 0, 1
3133, 1, 1636424579893, 1636424580518, 625, 266, 359, 0, 0, 0
3132, 1, 1636424579839, 1636424580826, 987, 626, 361, 0, 1, 1
3134, 1, 1636424580377, 1636424581006, 629, 268, 361, 0, 0, 0
3135, 1, 1636424580653, 1636424581290, 637, 273, 364, 0, 0, 0
3137, 1, 1636424580982, 1636424581606, 624, 271, 353, 0, 1, 1
3138, 1, 1636424581054, 1636424581682, 628, 269, 359, 0, 0, 0
3136, 1, 1636424580862, 1636424581746, 884, 525, 359, 0, 1, 1
3139, 1, 1636424581298, 1636424581930, 632, 269, 363, 0, 0, 0
3140, 1, 1636424581698, 1636424582326, 628, 270, 358, 0, 1, 1
3141, 1, 1636424581716, 1636424582346, 630, 271, 359, 0, 0, 0
3142, 1, 1636424581826, 1636424582454, 628, 270, 358, 0, 0, 0
3145, 1, 1636424581883, 1636424582502, 619, 263, 356, 3, 0, 3
3144, 1, 1636424581882, 1636424582506, 624, 262, 362, 2, 0, 2
3143, 1, 1636424581882, 1636424582958, 1076, 717, 359, 1, 0, 1
3146, 1, 1636424582343, 1636424582974, 631, 274, 357, 1, 0, 1
3147, 1, 1636424582538, 1636424583166, 628, 270, 358, 1, 1, 2
3148, 1, 1636424582813, 1636424583622, 809, 450, 359, 0, 0, 0
3149, 1, 1636424583022, 1636424583654, 632, 270, 362, 0, 1, 1
3150, 1, 1636424583151, 1636424583778, 627, 269, 358, 0, 0, 0
3151, 1, 1636424583199, 1636424583830, 631, 270, 361, 0, 0, 0
3152, 1, 1636424583573, 1636424584202, 629, 270, 359, 0, 0, 0
3153, 1, 1636424583709, 1636424584334, 625, 265, 360, 1, 0, 1
3154, 1, 1636424583755, 1636424584378, 623, 272, 351, 0, 1, 1
3157, 1, 1636424584001, 1636424584626, 625, 269, 356, 0, 0, 0
3089, 2, 1636424574494, 1636424584669, 10175, 0, 10175, 1, 0, 1
3090, 2, 1636424574622, 1636424584797, 10175, 0, 10175, 0, 0, 0
3158, 1, 1636424584229, 1636424584854, 625, 266, 359, 0, 1, 1
3159, 1, 1636424584626, 1636424585250, 624, 271, 353, 1, 1, 2
3096, 2, 1636424575266, 1636424585445, 10179, 0, 10179, 0, 0, 0
3164, 1, 1636424585034, 1636424585710, 676, 270, 406, 1, 0, 1
3160, 1, 1636424584905, 1636424585710, 805, 449, 356, 0, 8, 8
3165, 1, 1636424585159, 1636424585802, 643, 290, 353, 1, 20, 21
3166, 1, 1636424585457, 1636424586082, 625, 266, 359, 0, 0, 0
3104, 2, 1636424575926, 1636424586109, 10183, 0, 10183, 0, 0, 0
3168, 1, 1636424585624, 1636424586238, 614, 262, 352, 0, 0, 0
3169, 1, 1636424585661, 1636424586290, 629, 270, 359, 0, 0, 0
3170, 1, 1636424585880, 1636424586506, 626, 270, 356, 1, 0, 1
3106, 1, 1636424576295, 1636424586606, 10311, 9911, 400, 0, 1, 1
3172, 1, 1636424586315, 1636424586942, 627, 266, 361, 0, 0, 0
3109, 2, 1636424576947, 1636424587125, 10178, 1, 10177, 1, 0, 1
3173, 1, 1636424586494, 1636424587129, 635, 273, 362, 2, 0, 2
3110, 2, 1636424576991, 1636424587168, 10177, 1, 10176, 1, 0, 1
3176, 1, 1636424586984, 1636424587610, 626, 273, 353, 0, 0, 0
3175, 1, 1636424586873, 1636424587626, 753, 395, 358, 1, 35, 36
3121, 1, 1636424578038, 1636424587654, 9616, 9266, 350, 0, 0, 0
3177, 1, 1636424587182, 1636424587810, 628, 270, 358, 1, 0, 1
3178, 1, 1636424587255, 1636424587918, 663, 270, 393, 1, 0, 1
3180, 1, 1636424587477, 1636424588102, 625, 270, 355, 1, 0, 1
3181, 1, 1636424587487, 1636424588114, 627, 270, 357, 1, 0, 1
3183, 1, 1636424587716, 1636424588350, 634, 274, 360, 0, 0, 0
3184, 1, 1636424587833, 1636424588466, 633, 273, 360, 0, 0, 0
3185, 1, 1636424588184, 1636424588814, 630, 273, 357, 0, 0, 0
3186, 1, 1636424588478, 1636424589110, 632, 273, 359, 2, 0, 2
3188, 1, 1636424588903, 1636424589526, 623, 271, 352, 1, 0, 1
3187, 1, 1636424588765, 1636424589562, 797, 441, 356, 0, 1, 1
3189, 1, 1636424589174, 1636424589790, 616, 266, 350, 0, 1, 1
3190, 1, 1636424589250, 1636424589866, 616, 259, 357, 0, 0, 0
3191, 1, 1636424589346, 1636424589970, 624, 264, 360, 1, 1, 2
3192, 1, 1636424589524, 1636424590162, 638, 278, 360, 1, 0, 1
3193, 1, 1636424589837, 1636424590458, 621, 266, 355, 0, 0, 0
3194, 1, 1636424589888, 1636424590514, 626, 270, 356, 0, 0, 0
3195, 1, 1636424590118, 1636424590746, 628, 272, 356, 2, 1, 3
3196, 1, 1636424590609, 1636424591234, 625, 270, 355, 1, 0, 1
3198, 1, 1636424590992, 1636424591614, 622, 270, 352, 1, 0, 1
3197, 1, 1636424590809, 1636424591686, 877, 518, 359, 1, 0, 1
3199, 1, 1636424591081, 1636424591702, 621, 270, 351, 1, 0, 1
3200, 1, 1636424591218, 1636424591834, 616, 263, 353, 1, 0, 1
3201, 1, 1636424591254, 1636424591878, 624, 270, 354, 0, 0, 0
3202, 1, 1636424591393, 1636424592030, 637, 278, 359, 1, 0, 1
3203, 1, 1636424591856, 1636424592482, 626, 271, 355, 2, 0, 2
3204, 1, 1636424591893, 1636424592522, 629, 270, 359, 0, 0, 0
3205, 1, 1636424592155, 1636424592778, 623, 269, 354, 1, 0, 1
3206, 1, 1636424592508, 1636424593130, 622, 271, 351, 2, 0, 2
3207, 1, 1636424592709, 1636424593590, 881, 518, 363, 0, 0, 0
3208, 1, 1636424593061, 1636424593690, 629, 266, 363, 0, 0, 0
3209, 1, 1636424593177, 1636424593802, 625, 271, 354, 0, 0, 0
3211, 1, 1636424593303, 1636424593930, 627, 270, 357, 0, 0, 0
3212, 1, 1636424593339, 1636424593966, 627, 271, 356, 1, 1, 2
3155, 2, 1636424583870, 1636424594006, 10136, 1, 10135, 2, 0, 2
3156, 2, 1636424583872, 1636424594057, 10185, 1, 10184, 0, 0, 0
3213, 1, 1636424593775, 1636424594418, 643, 286, 357, 3, 16, 19
3163, 1, 1636424584964, 1636424594546, 9582, 9226, 356, 0, 0, 0
3214, 1, 1636424594006, 1636424594634, 628, 266, 362, 2, 0, 2
3215, 1, 1636424594057, 1636424594678, 621, 265, 356, 0, 0, 0
3218, 1, 1636424594451, 1636424595086, 635, 274, 361, 0, 0, 0
3162, 2, 1636424584946, 1636424595125, 10179, 1, 10178, 1, 1, 2
3161, 2, 1636424584946, 1636424595169, 10223, 1, 10222, 1, 0, 1
3220, 1, 1636424594616, 1636424595614, 998, 602, 396, 2, 40, 42
3167, 2, 1636424585574, 1636424595749, 10175, 1, 10174, 0, 1, 1
3221, 1, 1636424595169, 1636424595802, 633, 270, 363, 0, 0, 0
3222, 1, 1636424595186, 1636424595810, 624, 270, 354, 0, 0, 0
3223, 1, 1636424595201, 1636424595826, 625, 270, 355, 1, 0, 1
3225, 1, 1636424595266, 1636424595926, 660, 262, 398, 0, 0, 0
3227, 1, 1636424595684, 1636424596330, 646, 269, 377, 2, 0, 2
3224, 1, 1636424595266, 1636424596374, 1108, 715, 393, 1, 0, 1
3171, 2, 1636424586238, 1636424596417, 10179, 1, 10178, 0, 0, 0
3229, 1, 1636424595922, 1636424596550, 628, 270, 358, 1, 0, 1
3230, 1, 1636424595996, 1636424596786, 790, 426, 364, 1, 0, 1
3228, 1, 1636424595874, 1636424596870, 996, 594, 402, 1, 44, 45
3174, 1, 1636424586608, 1636424596906, 10298, 9902, 396, 0, 1, 1
3232, 1, 1636424596554, 1636424597326, 772, 369, 403, 0, 0, 0
3179, 2, 1636424587258, 1636424597437, 10179, 0, 10179, 0, 0, 0
3236, 1, 1636424597158, 1636424597790, 632, 271, 361, 0, 1, 1
3235, 1, 1636424597144, 1636424597798, 654, 298, 356, 1, 28, 29
3234, 1, 1636424596908, 1636424597798, 890, 490, 400, 1, 16, 17
3237, 1, 1636424597203, 1636424597814, 611, 263, 348, 1, 0, 1
3182, 2, 1636424587656, 1636424597833, 10177, 0, 10177, 0, 0, 0
3238, 1, 1636424597266, 1636424597886, 620, 267, 353, 0, 0, 0
3239, 1, 1636424597285, 1636424598334, 1049, 691, 358, 0, 0, 0
3240, 1, 1636424597834, 1636424598414, 580, 266, 314, 0, 1, 1
3242, 1, 1636424597858, 1636424598486, 628, 266, 362, 0, 0, 0
3243, 1, 1636424597962, 1636424598634, 672, 269, 403, 0, 0, 0
3241, 1, 1636424597846, 1636424598782, 936, 578, 358, 0, 0, 0
3244, 1, 1636424598010, 1636424599090, 1080, 678, 402, 0, 0, 0
3246, 1, 1636424598571, 1636424599242, 671, 309, 362, 0, 0, 0
3247, 1, 1636424598930, 1636424599690, 760, 406, 354, 0, 0, 0
3248, 1, 1636424599138, 1636424599758, 620, 266, 354, 0, 0, 0
3249, 1, 1636424599183, 1636424599814, 631, 277, 354, 1, 0, 1
3250, 1, 1636424599188, 1636424599814, 626, 270, 356, 0, 0, 0
3251, 1, 1636424599231, 1636424600270, 1039, 682, 357, 1, 0, 1
3254, 1, 1636424599867, 1636424600494, 627, 266, 361, 0, 0, 0
3255, 1, 1636424599890, 1636424600518, 628, 266, 362, 0, 1, 1
3257, 1, 1636424599982, 1636424600610, 628, 270, 358, 2, 0, 2
3253, 1, 1636424599745, 1636424600730, 985, 623, 362, 0, 0, 0
3256, 1, 1636424599946, 1636424600958, 1012, 646, 366, 1, 0, 1
3258, 1, 1636424600571, 1636424601198, 627, 270, 357, 1, 0, 1
3259, 1, 1636424600927, 1636424601658, 731, 374, 357, 0, 0, 0
3260, 1, 1636424601109, 1636424601718, 609, 255, 354, 0, 0, 0
3261, 1, 1636424601153, 1636424601782, 629, 273, 356, 0, 0, 0
3263, 1, 1636424601191, 1636424601814, 623, 267, 356, 1, 0, 1
3262, 1, 1636424601153, 1636424602242, 1089, 730, 359, 1, 0, 1
3265, 1, 1636424601808, 1636424602434, 626, 270, 356, 1, 0, 1
3266, 1, 1636424601937, 1636424602566, 629, 271, 358, 1, 0, 1
3264, 1, 1636424601678, 1636424602690, 1012, 658, 354, 2, 0, 2
3268, 1, 1636424602085, 1636424602714, 629, 270, 359, 1, 0, 1
3267, 1, 1636424601948, 1636424603022, 1074, 718, 356, 1, 0, 1
3269, 1, 1636424602536, 1636424603162, 626, 266, 360, 0, 0, 0
3210, 2, 1636424593201, 1636424603341, 10140, 0, 10140, 1, 0, 1
3270, 1, 1636424602831, 1636424603614, 783, 428, 355, 0, 1, 1
3271, 1, 1636424603030, 1636424603698, 668, 315, 353, 1, 45, 46
3273, 1, 1636424603219, 1636424603890, 671, 269, 402, 0, 0, 0
3274, 1, 1636424603342, 1636424603974, 632, 270, 362, 1, 0, 1
3275, 1, 1636424603470, 1636424604142, 672, 270, 402, 0, 1, 1
3217, 2, 1636424594147, 1636424604321, 10174, 1, 10173, 0, 0, 0
3276, 1, 1636424603681, 1636424604338, 657, 307, 350, 1, 1, 2
3216, 2, 1636424594146, 1636424604365, 10219, 0, 10219, 0, 1, 1
3277, 1, 1636424603896, 1636424604526, 630, 268, 362, 0, 0, 0
3279, 1, 1636424603920, 1636424604630, 710, 357, 353, 0, 88, 88
3280, 1, 1636424603985, 1636424604630, 645, 288, 357, 0, 23, 23
3219, 2, 1636424594562, 1636424604741, 10179, 1, 10178, 2, 0, 2
3272, 1, 1636424603218, 1636424604822, 1604, 1207, 397, 1, 28, 29
3278, 1, 1636424603906, 1636424605010, 1104, 741, 363, 0, 31, 31
3282, 1, 1636424604458, 1636424605126, 668, 269, 399, 0, 0, 0
3283, 1, 1636424604608, 1636424605270, 662, 310, 352, 1, 0, 1
3226, 2, 1636424595404, 1636424605537, 10133, 0, 10133, 0, 0, 0
3286, 1, 1636424604947, 1636424605574, 627, 272, 355, 0, 1, 1
3287, 1, 1636424605100, 1636424605726, 626, 270, 356, 1, 1, 2
3285, 1, 1636424604894, 1636424605730, 836, 474, 362, 2, 1, 3
3289, 1, 1636424605229, 1636424605902, 673, 315, 358, 1, 40, 41
3290, 1, 1636424605474, 1636424606126, 652, 269, 383, 1, 0, 1
3288, 1, 1636424605201, 1636424606178, 977, 623, 354, 0, 1, 1
3293, 1, 1636424605827, 1636424606462, 635, 273, 362, 0, 0, 0
3291, 1, 1636424605571, 1636424606618, 1047, 696, 351, 1, 2, 3
3295, 1, 1636424606014, 1636424606638, 624, 262, 362, 0, 0, 0
3231, 2, 1636424596533, 1636424606669, 10136, 1, 10135, 0, 0, 0
3296, 1, 1636424606047, 1636424606670, 623, 262, 361, 0, 0, 0
3233, 2, 1636424596683, 1636424606817, 10134, 1, 10133, 1, 0, 1
3294, 1, 1636424605865, 1636424606934, 1069, 711, 358, 0, 28, 28
3297, 1, 1636424606321, 1636424606954, 633, 272, 361, 0, 0, 0
3298, 1, 1636424606519, 1636424607178, 659, 303, 356, 1, 32, 33
3300, 1, 1636424606886, 1636424607622, 736, 382, 354, 1, 1, 2
3302, 1, 1636424607046, 1636424607674, 628, 271, 357, 0, 1, 1
3303, 1, 1636424607049, 1636424607682, 633, 270, 363, 0, 0, 0
3305, 1, 1636424607313, 1636424607934, 621, 261, 360, 0, 0, 0
3306, 1, 1636424607504, 1636424608138, 634, 274, 360, 0, 0, 0
3307, 1, 1636424607570, 1636424608194, 624, 269, 355, 1, 0, 1
3245, 2, 1636424598102, 1636424608237, 10135, 1, 10134, 1, 0, 1
3308, 1, 1636424607865, 1636424608506, 641, 277, 364, 2, 8, 10
3310, 1, 1636424607926, 1636424608594, 668, 311, 357, 1, 36, 37
3304, 1, 1636424607166, 1636424608598, 1432, 1073, 359, 2, 7, 9
3311, 1, 1636424608124, 1636424608778, 654, 269, 385, 0, 0, 0
3312, 1, 1636424608303, 1636424608930, 627, 265, 362, 0, 0, 0
3309, 1, 1636424607919, 1636424608958, 1039, 683, 356, 0, 1, 1
3314, 1, 1636424608437, 1636424609062, 625, 271, 354, 1, 0, 1
3252, 2, 1636424599270, 1636424609405, 10135, 0, 10135, 0, 0, 0
3315, 1, 1636424608880, 1636424609510, 630, 278, 352, 0, 0, 0
3316, 1, 1636424608999, 1636424609618, 619, 266, 353, 0, 0, 0
3317, 1, 1636424609087, 1636424609718, 631, 270, 361, 1, 0, 1
3319, 1, 1636424609349, 1636424609994, 645, 271, 374, 1, 0, 1
3322, 1, 1636424609563, 1636424610186, 623, 265, 358, 0, 0, 0
3323, 1, 1636424609817, 1636424610454, 637, 273, 364, 0, 0, 0
3324, 1, 1636424609881, 1636424610510, 629, 270, 359, 0, 0, 0
3326, 1, 1636424610035, 1636424610662, 627, 269, 358, 0, 0, 0
3325, 1, 1636424609929, 1636424610974, 1045, 677, 368, 0, 0, 0
3327, 1, 1636424610399, 1636424611026, 627, 269, 358, 0, 0, 0
3330, 1, 1636424610973, 1636424611602, 629, 266, 363, 1, 0, 1
3331, 1, 1636424611121, 1636424611754, 633, 274, 359, 0, 1, 1
3332, 1, 1636424611324, 1636424611950, 626, 266, 360, 2, 0, 2
3333, 1, 1636424611450, 1636424612078, 628, 271, 357, 0, 0, 0
3334, 1, 1636424611873, 1636424612502, 629, 270, 359, 1, 0, 1
3336, 1, 1636424611888, 1636424612510, 622, 270, 352, 1, 0, 1
3337, 1, 1636424611922, 1636424612546, 624, 266, 358, 1, 1, 2
3338, 1, 1636424612282, 1636424612906, 624, 264, 360, 0, 0, 0
3335, 1, 1636424611876, 1636424612950, 1074, 719, 355, 1, 0, 1
3339, 1, 1636424612849, 1636424613478, 629, 269, 360, 0, 0, 0
3340, 1, 1636424613113, 1636424613746, 633, 269, 364, 0, 0, 0
3341, 1, 1636424613426, 1636424614058, 632, 270, 362, 3, 0, 3
3342, 1, 1636424613477, 1636424614102, 625, 269, 356, 0, 0, 0
3343, 1, 1636424613760, 1636424614386, 626, 271, 355, 1, 0, 1
3345, 1, 1636424613923, 1636424614554, 631, 275, 356, 2, 2, 4
3281, 2, 1636424604454, 1636424614633, 10179, 1, 10178, 2, 0, 2
3344, 1, 1636424613871, 1636424614838, 967, 610, 357, 1, 0, 1
3347, 1, 1636424614219, 1636424614854, 635, 270, 365, 0, 0, 0
3346, 1, 1636424613950, 1636424615010, 1060, 702, 358, 0, 0, 0
3284, 2, 1636424604870, 1636424615053, 10183, 1, 10182, 0, 0, 0
3348, 1, 1636424614715, 1636424615338, 623, 270, 353, 0, 1, 1
3349, 1, 1636424615061, 1636424615690, 629, 271, 358, 1, 0, 1
3292, 2, 1636424605666, 1636424615845, 10179, 0, 10179, 0, 0, 0
3352, 1, 1636424615513, 1636424616142, 629, 270, 359, 1, 1, 2
3353, 1, 1636424615555, 1636424616202, 647, 269, 378, 1, 0, 1
3354, 1, 1636424615846, 1636424616438, 592, 274, 318, 0, 1, 1
3357, 1, 1636424615988, 1636424616622, 634, 274, 360, 2, 0, 2
3358, 1, 1636424616009, 1636424616638, 629, 271, 358, 2, 0, 2
3359, 1, 1636424616179, 1636424616802, 623, 270, 353, 1, 0, 1
3355, 1, 1636424615879, 1636424616894, 1015, 659, 356, 1, 1, 2
3299, 2, 1636424606818, 1636424616993, 10175, 1, 10174, 1, 0, 1
3301, 2, 1636424606947, 1636424617121, 10174, 1, 10173, 1, 0, 1
3360, 1, 1636424616801, 1636424617490, 689, 327, 362, 0, 52, 52
3361, 1, 1636424617122, 1636424617754, 632, 273, 359, 0, 0, 0
3364, 1, 1636424617514, 1636424618142, 628, 269, 359, 0, 0, 0
3365, 1, 1636424617578, 1636424618202, 624, 265, 359, 1, 1, 2
3366, 1, 1636424617869, 1636424618502, 633, 270, 363, 0, 0, 0
3367, 1, 1636424617881, 1636424618510, 629, 270, 359, 0, 0, 0
3313, 2, 1636424608366, 1636424618545, 10179, 0, 10179, 0, 1, 1
3369, 1, 1636424618073, 1636424618702, 629, 273, 356, 1, 0, 1
3370, 1, 1636424618269, 1636424618906, 637, 274, 363, 0, 8, 8
3368, 1, 1636424617944, 1636424618990, 1046, 690, 356, 1, 36, 37
3320, 1, 1636424609534, 1636424619034, 9500, 9102, 398, 1, 0, 1
3318, 2, 1636424609195, 1636424619333, 10138, 0, 10138, 0, 0, 0
3372, 1, 1636424618798, 1636424619430, 632, 270, 362, 2, 0, 2
3321, 2, 1636424609543, 1636424619677, 10134, 0, 10134, 0, 0, 0
3374, 1, 1636424619196, 1636424619822, 626, 269, 357, 0, 1, 1
3375, 1, 1636424619535, 1636424620162, 627, 270, 357, 3, 0, 3
3376, 1, 1636424619550, 1636424620206, 656, 267, 389, 0, 1, 1
3377, 1, 1636424619797, 1636424620430, 633, 271, 362, 1, 2, 3
3378, 1, 1636424619810, 1636424620482, 672, 274, 398, 0, 0, 0
3381, 1, 1636424619929, 1636424620558, 629, 270, 359, 0, 1, 1
3382, 1, 1636424619953, 1636424620610, 657, 301, 356, 0, 0, 0
3328, 2, 1636424610553, 1636424620689, 10136, 0, 10136, 0, 1, 1
3380, 1, 1636424619880, 1636424620886, 1006, 646, 360, 1, 0, 1
3379, 1, 1636424619810, 1636424620954, 1144, 742, 402, 0, 32, 32
3329, 1, 1636424610919, 1636424621174, 10255, 9906, 349, 0, 0, 0
3384, 1, 1636424620733, 1636424621358, 625, 266, 359, 1, 0, 1
3383, 1, 1636424620355, 1636424621398, 1043, 686, 357, 1, 0, 1
3386, 1, 1636424621077, 1636424621706, 629, 269, 360, 1, 0, 1
3388, 1, 1636424621461, 1636424622090, 629, 271, 358, 1, 0, 1
3389, 1, 1636424621630, 1636424622262, 632, 271, 361, 1, 2, 3
3390, 1, 1636424621700, 1636424622326, 626, 271, 355, 1, 0, 1
3392, 1, 1636424621800, 1636424622430, 630, 270, 360, 0, 0, 0
3394, 1, 1636424621973, 1636424622606, 633, 269, 364, 0, 0, 0
3395, 1, 1636424621976, 1636424622718, 742, 383, 359, 3, 0, 3
3391, 1, 1636424621716, 1636424622778, 1062, 702, 360, 1, 0, 1
3393, 1, 1636424621933, 1636424622878, 945, 582, 363, 0, 0, 0
3396, 1, 1636424622412, 1636424623034, 622, 271, 351, 0, 0, 0
3397, 1, 1636424622770, 1636424623406, 636, 270, 366, 0, 0, 0
3398, 1, 1636424623081, 1636424623710, 629, 270, 359, 0, 0, 0
3399, 1, 1636424623406, 1636424624034, 628, 266, 362, 0, 1, 1
3400, 1, 1636424623573, 1636424624190, 617, 266, 351, 1, 1, 2
3401, 1, 1636424623659, 1636424624282, 623, 266, 357, 1, 0, 1
3403, 1, 1636424623935, 1636424624562, 627, 271, 356, 1, 0, 1
3402, 1, 1636424623708, 1636424624646, 938, 586, 352, 1, 0, 1
3405, 1, 1636424624068, 1636424624682, 614, 261, 353, 0, 0, 0
3406, 1, 1636424624089, 1636424624722, 633, 281, 352, 0, 1, 1
3404, 1, 1636424623942, 1636424625018, 1076, 720, 356, 1, 1, 2
3408, 1, 1636424624638, 1636424625270, 632, 269, 363, 1, 1, 2
3351, 2, 1636424615214, 1636424625393, 10179, 1, 10178, 2, 0, 2
3350, 2, 1636424615214, 1636424625437, 10223, 0, 10223, 0, 0, 0
3409, 1, 1636424625216, 1636424625882, 666, 273, 393, 1, 3, 4
3410, 1, 1636424625296, 1636424625966, 670, 304, 366, 44, 1, 45
3411, 1, 1636424625486, 1636424626122, 636, 270, 366, 0, 0, 0
3356, 2, 1636424615974, 1636424626153, 10179, 1, 10178, 0, 1, 1
3412, 1, 1636424625526, 1636424626202, 676, 274, 402, 1, 1, 2
3415, 1, 1636424625710, 1636424626334, 624, 269, 355, 0, 0, 0
3416, 1, 1636424625911, 1636424626542, 631, 270, 361, 1, 0, 1
3414, 1, 1636424625661, 1636424626602, 941, 586, 355, 0, 32, 32
3413, 1, 1636424625526, 1636424626646, 1120, 722, 398, 0, 0, 0
3418, 1, 1636424626046, 1636424626690, 644, 265, 379, 1, 0, 1
3419, 1, 1636424626184, 1636424626822, 638, 275, 363, 1, 0, 1
3417, 1, 1636424625917, 1636424626994, 1077, 717, 360, 0, 1, 1
3420, 1, 1636424626282, 1636424627094, 812, 410, 402, 0, 0, 0
3421, 1, 1636424626584, 1636424627214, 630, 270, 360, 1, 1, 2
3362, 2, 1636424617123, 1636424627297, 10174, 1, 10173, 0, 0, 0
3363, 2, 1636424617251, 1636424627425, 10174, 0, 10174, 1, 0, 1
3422, 1, 1636424627205, 1636424627874, 669, 309, 360, 1, 44, 45
3425, 1, 1636424627426, 1636424628050, 624, 266, 358, 1, 0, 1
3423, 1, 1636424627426, 1636424628094, 668, 271, 397, 2, 0, 2
3426, 1, 1636424627552, 1636424628178, 626, 271, 355, 2, 0, 2
3430, 1, 1636424627709, 1636424628334, 625, 267, 358, 0, 0, 0
3431, 1, 1636424627833, 1636424628466, 633, 269, 364, 1, 0, 1
3427, 1, 1636424627555, 1636424628546, 991, 595, 396, 1, 0, 1
3428, 1, 1636424627600, 1636424628626, 1026, 674, 352, 0, 1, 1
3433, 1, 1636424628077, 1636424628710, 633, 269, 364, 0, 0, 0
3434, 1, 1636424628092, 1636424628786, 694, 338, 356, 1, 0, 1
3371, 2, 1636424618674, 1636424628853, 10179, 1, 10178, 0, 1, 1
3432, 1, 1636424627875, 1636424628926, 1051, 687, 364, 1, 0, 1
3435, 1, 1636424628288, 1636424629126, 838, 477, 361, 0, 43, 43
3373, 1, 1636424619036, 1636424629346, 10310, 9910, 400, 0, 0, 0
3437, 1, 1636424628982, 1636424629654, 672, 270, 402, 1, 1, 2
3438, 1, 1636424629180, 1636424629810, 630, 271, 359, 1, 1, 2
3440, 1, 1636424629359, 1636424629986, 627, 270, 357, 1, 0, 1
3439, 1, 1636424629347, 1636424630106, 759, 359, 400, 0, 0, 0
3441, 1, 1636424629488, 1636424630122, 634, 274, 360, 1, 0, 1
3443, 1, 1636424629667, 1636424630294, 627, 271, 356, 0, 0, 0
3445, 1, 1636424629745, 1636424630378, 633, 273, 360, 1, 0, 1
3446, 1, 1636424629867, 1636424630502, 635, 278, 357, 1, 0, 1
3442, 1, 1636424629598, 1636424630574, 976, 618, 358, 0, 0, 0
3444, 1, 1636424629692, 1636424630746, 1054, 695, 359, 1, 1, 2
3447, 1, 1636424629880, 1636424630958, 1078, 723, 355, 1, 1, 2
3385, 2, 1636424620818, 1636424630997, 10179, 1, 10178, 1, 1, 2
3450, 1, 1636424630352, 1636424631202, 850, 491, 359, 0, 1, 1
3387, 2, 1636424621176, 1636424631353, 10177, 0, 10177, 0, 0, 0
3451, 1, 1636424631047, 1636424631718, 671, 314, 357, 1, 39, 40
3452, 1, 1636424631214, 1636424631842, 628, 265, 363, 0, 0, 0
3453, 1, 1636424631257, 1636424631894, 637, 259, 378, 1, 0, 1
3455, 1, 1636424631486, 1636424632158, 672, 270, 402, 2, 0, 2
3454, 1, 1636424631396, 1636424632178, 782, 422, 360, 0, 0, 0
3457, 1, 1636424631601, 1636424632226, 625, 269, 356, 0, 0, 0
3462, 1, 1636424631880, 1636424632510, 630, 271, 359, 1, 0, 1
3456, 1, 1636424631490, 1636424632614, 1124, 722, 402, 1, 0, 1
3458, 1, 1636424631643, 1636424632682, 1039, 683, 356, 1, 0, 1
3463, 1, 1636424631964, 1636424632966, 1002, 642, 360, 1, 0, 1
3465, 1, 1636424633127, 1636424633754, 627, 269, 358, 1, 0, 1
3466, 1, 1636424633291, 1636424633910, 619, 267, 352, 0, 0, 0
3468, 1, 1636424633375, 1636424633998, 623, 270, 353, 2, 0, 2
3467, 1, 1636424633375, 1636424633998, 623, 270, 353, 2, 1, 3
3469, 1, 1636424633433, 1636424634206, 773, 415, 358, 0, 1, 1
3473, 1, 1636424633761, 1636424634390, 629, 271, 358, 1, 2, 3
3470, 1, 1636424633437, 1636424634434, 997, 642, 355, 0, 0, 0
3407, 2, 1636424624360, 1636424634493, 10133, 0, 10133, 0, 0, 0
3474, 1, 1636424633894, 1636424634850, 956, 603, 353, 0, 12, 12
3475, 1, 1636424634618, 1636424635286, 668, 269, 399, 0, 0, 0
3477, 1, 1636424635256, 1636424635886, 630, 270, 360, 0, 1, 1
3478, 1, 1636424635274, 1636424635906, 632, 274, 358, 1, 0, 1
3482, 1, 1636424635706, 1636424636338, 632, 272, 360, 1, 0, 1
3483, 1, 1636424635885, 1636424636790, 905, 551, 354, 0, 1, 1
3484, 1, 1636424636585, 1636424637218, 633, 270, 363, 1, 0, 1
3424, 2, 1636424627426, 1636424637560, 10134, 1, 10133, 2, 0, 2
3429, 2, 1636424627640, 1636424637773, 10133, 0, 10133, 0, 0, 0
3485, 1, 1636424637175, 1636424637826, 651, 296, 355, 0, 28, 28
3486, 1, 1636424637324, 1636424637950, 626, 271, 355, 1, 0, 1
3487, 1, 1636424637603, 1636424638234, 631, 274, 357, 1, 0, 1
3488, 1, 1636424637691, 1636424638366, 675, 270, 405, 1, 0, 1
3489, 1, 1636424637833, 1636424638690, 857, 493, 364, 0, 0, 0
3436, 2, 1636424628602, 1636424638737, 10135, 1, 10134, 0, 0, 0
3490, 1, 1636424637902, 1636424638818, 916, 514, 402, 1, 0, 1
3491, 1, 1636424638738, 1636424639362, 624, 267, 357, 1, 1, 2
3492, 1, 1636424638866, 1636424639530, 664, 267, 397, 0, 0, 0
3493, 1, 1636424639125, 1636424639754, 629, 269, 360, 0, 0, 0
3494, 1, 1636424639435, 1636424640058, 623, 265, 358, 0, 0, 0
3495, 1, 1636424639525, 1636424640142, 617, 267, 350, 0, 1, 1
3496, 1, 1636424639561, 1636424640194, 633, 270, 363, 1, 0, 1
3448, 2, 1636424630143, 1636424640277, 10134, 0, 10134, 0, 0, 0
3449, 2, 1636424630181, 1636424640325, 10144, 0, 10144, 0, 0, 0
3497, 1, 1636424639787, 1636424640674, 887, 538, 349, 0, 91, 91
3498, 1, 1636424639841, 1636424640678, 837, 477, 360, 0, 35, 35
3461, 1, 1636424631849, 1636424640818, 8969, 8610, 359, 0, 0, 0
3499, 1, 1636424640474, 1636424641142, 668, 267, 401, 2, 0, 2
3500, 1, 1636424640475, 1636424641142, 667, 266, 401, 1, 1, 2
3501, 1, 1636424640625, 1636424641250, 625, 266, 359, 0, 0, 0
3502, 1, 1636424640763, 1636424641390, 627, 266, 361, 0, 0, 0
3503, 1, 1636424640819, 1636424641598, 779, 377, 402, 1, 0, 1
3504, 1, 1636424641106, 1636424641738, 632, 270, 362, 1, 0, 1
3459, 2, 1636424631714, 1636424641853, 10139, 0, 10139, 0, 1, 1
3460, 2, 1636424631788, 1636424641929, 10141, 1, 10140, 0, 1, 1
3505, 1, 1636424641405, 1636424642034, 629, 271, 358, 0, 0, 0
3506, 1, 1636424641507, 1636424642130, 623, 266, 357, 0, 0, 0
3507, 1, 1636424641517, 1636424642146, 629, 267, 362, 1, 0, 1
3464, 2, 1636424632368, 1636424642501, 10133, 1, 10132, 0, 0, 0
3509, 1, 1636424641854, 1636424642578, 724, 337, 387, 1, 0, 1
3508, 1, 1636424641749, 1636424642598, 849, 474, 375, 2, 0, 2
3510, 1, 1636424642266, 1636424642946, 680, 283, 397, 1, 16, 17
3512, 1, 1636424642359, 1636424642986, 627, 270, 357, 0, 1, 1
3513, 1, 1636424642396, 1636424643046, 650, 270, 380, 1, 0, 1
3514, 1, 1636424642512, 1636424643134, 622, 270, 352, 0, 0, 0
3517, 1, 1636424642761, 1636424643438, 677, 316, 361, 1, 1, 2
3516, 1, 1636424642717, 1636424643494, 777, 419, 358, 1, 1, 2
3518, 1, 1636424643065, 1636424643698, 633, 269, 364, 1, 0, 1
3471, 2, 1636424633716, 1636424643857, 10141, 1, 10140, 1, 0, 1
3472, 2, 1636424633722, 1636424643905, 10183, 0, 10183, 1, 0, 1
3519, 1, 1636424643382, 1636424644010, 628, 267, 361, 0, 1, 1
3521, 1, 1636424643521, 1636424644166, 645, 269, 376, 0, 0, 0
3520, 1, 1636424643473, 1636424644170, 697, 298, 399, 0, 36, 36
3523, 1, 1636424643858, 1636424644458, 600, 285, 315, 0, 0, 0
3522, 1, 1636424643649, 1636424644622, 973, 614, 359, 0, 0, 0
3526, 1, 1636424644188, 1636424644822, 634, 265, 369, 0, 1, 1
3527, 1, 1636424644275, 1636424644902, 627, 270, 357, 2, 0, 2
3528, 1, 1636424644282, 1636424644906, 624, 265, 359, 0, 0, 0
3529, 1, 1636424644540, 1636424645354, 814, 457, 357, 0, 0, 0
3530, 1, 1636424644718, 1636424645358, 640, 282, 358, 1, 0, 1
3476, 2, 1636424635248, 1636424645385, 10137, 1, 10136, 0, 0, 0
3531, 1, 1636424644825, 1636424645442, 617, 271, 346, 1, 0, 1
3479, 2, 1636424635324, 1636424645460, 10136, 0, 10136, 0, 0, 0
3532, 1, 1636424645046, 1636424645670, 624, 270, 354, 2, 0, 2
3481, 1, 1636424635499, 1636424645918, 10419, 10059, 360, 0, 35, 35
3533, 1, 1636424645247, 1636424645918, 671, 310, 361, 1, 43, 44
3480, 1, 1636424635436, 1636424645950, 10514, 10159, 355, 0, 1, 1
3536, 1, 1636424645592, 1636424646222, 630, 270, 360, 1, 0, 1
3535, 1, 1636424645578, 1636424646246, 668, 271, 397, 2, 0, 2
3537, 1, 1636424645618, 1636424646254, 636, 274, 362, 1, 0, 1
3539, 1, 1636424645795, 1636424646418, 623, 270, 353, 1, 0, 1
3538, 1, 1636424645712, 1636424646674, 962, 606, 356, 1, 0, 1
3541, 1, 1636424645952, 1636424646702, 750, 350, 400, 0, 0, 0
3542, 1, 1636424646149, 1636424646774, 625, 269, 356, 1, 0, 1
3543, 1, 1636424646199, 1636424646818, 619, 266, 353, 0, 0, 0
3544, 1, 1636424646224, 1636424646854, 630, 271, 359, 0, 1, 1
3545, 1, 1636424646636, 1636424647254, 618, 270, 348, 0, 0, 0
3546, 1, 1636424646637, 1636424647302, 665, 305, 360, 0, 0, 0
3548, 1, 1636424647144, 1636424647774, 630, 274, 356, 1, 0, 1
3549, 1, 1636424647320, 1636424647946, 626, 270, 356, 0, 0, 0
3551, 1, 1636424647604, 1636424648238, 634, 275, 359, 1, 0, 1
3552, 1, 1636424647610, 1636424648254, 644, 279, 365, 0, 1, 1
3554, 1, 1636424647882, 1636424648514, 632, 270, 362, 1, 0, 1
3555, 1, 1636424648061, 1636424648690, 629, 270, 359, 1, 0, 1
3556, 1, 1636424648124, 1636424648746, 622, 266, 356, 1, 0, 1
3557, 1, 1636424648141, 1636424648762, 621, 265, 356, 0, 0, 0
3558, 1, 1636424648239, 1636424648862, 623, 270, 353, 1, 0, 1
3559, 1, 1636424648633, 1636424649262, 629, 269, 360, 0, 1, 1
3560, 1, 1636424648663, 1636424649290, 627, 269, 358, 0, 1, 1
3562, 1, 1636424649187, 1636424649814, 627, 269, 358, 0, 0, 0
3563, 1, 1636424649639, 1636424650266, 627, 270, 357, 1, 0, 1
3564, 1, 1636424649683, 1636424650306, 623, 266, 357, 1, 0, 1
3565, 1, 1636424649748, 1636424650370, 622, 270, 352, 0, 0, 0
3566, 1, 1636424650039, 1636424650658, 619, 270, 349, 0, 0, 0
3567, 1, 1636424650140, 1636424650758, 618, 262, 356, 0, 0, 0
3568, 1, 1636424650192, 1636424650810, 618, 265, 353, 0, 0, 0
3569, 1, 1636424650307, 1636424650934, 627, 264, 363, 0, 0, 0
3570, 1, 1636424650620, 1636424651246, 626, 270, 356, 2, 0, 2
3571, 1, 1636424650707, 1636424651330, 623, 270, 353, 1, 0, 1
3572, 1, 1636424651060, 1636424651686, 626, 271, 355, 0, 1, 1
3574, 1, 1636424651563, 1636424652190, 627, 270, 357, 0, 1, 1
3573, 1, 1636424651563, 1636424652194, 631, 270, 361, 2, 1, 3
3575, 1, 1636424651621, 1636424652258, 637, 272, 365, 0, 0, 0
3511, 2, 1636424642270, 1636424652449, 10179, 0, 10179, 0, 0, 0
3576, 1, 1636424652045, 1636424652718, 673, 314, 359, 0, 44, 44
3577, 1, 1636424652105, 1636424652734, 629, 268, 361, 0, 0, 0
3578, 1, 1636424652109, 1636424652742, 633, 274, 359, 0, 0, 0
3515, 2, 1636424642630, 1636424652809, 10179, 0, 10179, 1, 0, 1
3579, 1, 1636424652340, 1636424652982, 642, 264, 378, 0, 0, 0
3580, 1, 1636424652689, 1636424653346, 657, 270, 387, 2, 5, 7
3581, 1, 1636424652716, 1636424653346, 630, 265, 365, 2, 0, 2
3584, 1, 1636424653097, 1636424653730, 633, 266, 367, 0, 0, 0
3525, 2, 1636424643990, 1636424654165, 10175, 1, 10174, 0, 1, 1
3585, 1, 1636424653578, 1636424654206, 628, 271, 357, 0, 1, 1
3524, 2, 1636424643990, 1636424654217, 10227, 0, 10227, 1, 0, 1
3586, 1, 1636424653612, 1636424654238, 626, 265, 361, 0, 1, 1
3587, 1, 1636424653752, 1636424654374, 622, 269, 353, 1, 1, 2
3588, 1, 1636424654064, 1636424654754, 690, 319, 371, 53, 1, 54
3589, 1, 1636424654089, 1636424654762, 673, 324, 349, 52, 0, 52
3590, 1, 1636424654108, 1636424654766, 658, 324, 334, 54, 0, 54
3594, 1, 1636424654686, 1636424655310, 624, 265, 359, 0, 0, 0
3595, 1, 1636424654745, 1636424655374, 629, 270, 359, 0, 0, 0
3596, 1, 1636424654965, 1636424655594, 629, 272, 357, 0, 1, 1
3534, 2, 1636424645550, 1636424655729, 10179, 0, 10179, 1, 0, 1
3540, 2, 1636424645920, 1636424656097, 10177, 0, 10177, 0, 0, 0
3597, 1, 1636424655601, 1636424656258, 657, 267, 390, 1, 1, 2
3598, 1, 1636424655650, 1636424656310, 660, 262, 398, 0, 2, 2
3599, 1, 1636424655731, 1636424656358, 627, 263, 364, 1, 1, 2
3601, 1, 1636424655964, 1636424656638, 674, 313, 361, 47, 0, 47
3602, 1, 1636424655995, 1636424656638, 643, 267, 376, 0, 0, 0
3603, 1, 1636424656098, 1636424656722, 624, 270, 354, 2, 0, 2
3547, 2, 1636424646766, 1636424656901, 10135, 0, 10135, 0, 0, 0
3605, 1, 1636424656678, 1636424657350, 672, 268, 404, 1, 0, 1
3606, 1, 1636424656840, 1636424657486, 646, 271, 375, 1, 0, 1
3607, 1, 1636424656911, 1636424657534, 623, 267, 356, 0, 0, 0
3550, 2, 1636424647533, 1636424657669, 10136, 0, 10136, 0, 0, 0
3553, 2, 1636424647683, 1636424657817, 10134, 0, 10134, 0, 0, 0
3609, 1, 1636424657528, 1636424658174, 646, 290, 356, 1, 21, 22
3610, 1, 1636424657548, 1636424658206, 658, 266, 392, 0, 0, 0
3561, 1, 1636424649086, 1636424658314, 9228, 8867, 361, 1, 1, 2
3611, 1, 1636424657732, 1636424658354, 622, 264, 358, 0, 0, 0
3613, 1, 1636424657870, 1636424658498, 628, 270, 358, 0, 0, 0
3614, 1, 1636424657925, 1636424658554, 629, 270, 359, 0, 1, 1
3616, 1, 1636424658015, 1636424658670, 655, 294, 361, 0, 0, 0
3618, 1, 1636424658666, 1636424659294, 628, 270, 358, 0, 0, 0
3619, 1, 1636424658749, 1636424659382, 633, 270, 363, 1, 0, 1
3621, 1, 1636424659488, 1636424660114, 626, 269, 357, 0, 0, 0
3623, 1, 1636424659774, 1636424660406, 632, 270, 362, 0, 0, 0
3624, 1, 1636424659908, 1636424660530, 622, 270, 352, 1, 0, 1
3625, 1, 1636424659909, 1636424660542, 633, 274, 359, 1, 0, 1
3626, 1, 1636424659955, 1636424660578, 623, 267, 356, 1, 0, 1
3627, 1, 1636424660706, 1636424661338, 632, 270, 362, 0, 0, 0
3628, 1, 1636424660842, 1636424661466, 624, 266, 358, 0, 1, 1
3629, 1, 1636424661595, 1636424662214, 619, 266, 353, 0, 0, 0
3630, 1, 1636424661900, 1636424662522, 622, 266, 356, 1, 0, 1
3631, 1, 1636424661947, 1636424662566, 619, 265, 354, 0, 0, 0
3632, 1, 1636424661969, 1636424662594, 625, 265, 360, 0, 0, 0
3633, 1, 1636424662062, 1636424662690, 628, 270, 358, 0, 0, 0
3582, 2, 1636424653038, 1636424663217, 10179, 1, 10178, 1, 0, 1
3583, 2, 1636424653038, 1636424663261, 10223, 1, 10222, 0, 0, 0
3634, 1, 1636424662766, 1636424663390, 624, 271, 353, 1, 0, 1
3635, 1, 1636424662969, 1636424663614, 645, 290, 355, 0, 15, 15
3637, 1, 1636424663351, 1636424664022, 671, 270, 401, 1, 0, 1
3638, 1, 1636424663671, 1636424664298, 627, 270, 357, 0, 0, 0
3593, 2, 1636424654339, 1636424664473, 10134, 0, 10134, 0, 0, 0
3636, 1, 1636424663350, 1636424664478, 1128, 726, 402, 1, 0, 1
3592, 2, 1636424654306, 1636424664516, 10210, 1, 10209, 1, 0, 1
3591, 2, 1636424654302, 1636424664561, 10259, 1, 10258, 1, 0, 1
3641, 1, 1636424664056, 1636424664678, 622, 271, 351, 0, 0, 0
3642, 1, 1636424664138, 1636424664830, 692, 335, 357, 1, 64, 65
3644, 1, 1636424664646, 1636424665314, 668, 270, 398, 1, 0, 1
3646, 1, 1636424664650, 1636424665330, 680, 270, 410, 0, 0, 0
3647, 1, 1636424665065, 1636424665694, 629, 270, 359, 0, 1, 1
3645, 1, 1636424664647, 1636424665774, 1127, 729, 398, 2, 0, 2
3648, 1, 1636424665311, 1636424665938, 627, 270, 357, 1, 0, 1
3600, 2, 1636424655862, 1636424666041, 10179, 0, 10179, 0, 0, 0
3650, 1, 1636424665636, 1636424666310, 674, 270, 404, 0, 0, 0
3649, 1, 1636424665413, 1636424666394, 981, 622, 359, 1, 12, 13
3604, 2, 1636424656230, 1636424666405, 10175, 1, 10174, 0, 1, 1
3652, 1, 1636424666135, 1636424666766, 631, 275, 356, 1, 3, 4
3608, 2, 1636424657026, 1636424667201, 10175, 0, 10175, 0, 0, 0
3654, 1, 1636424666534, 1636424667218, 684, 287, 397, 1, 1, 2
3655, 1, 1636424666639, 1636424667262, 623, 269, 354, 0, 0, 0
3657, 1, 1636424666711, 1636424667714, 1003, 647, 356, 1, 0, 1
3658, 1, 1636424667202, 1636424667786, 584, 269, 315, 0, 0, 0
3612, 2, 1636424657818, 1636424667997, 10179, 0, 10179, 0, 0, 0
3660, 1, 1636424667408, 1636424668042, 634, 273, 361, 0, 0, 0
3615, 2, 1636424657946, 1636424668129, 10183, 0, 10183, 0, 0, 0
3662, 1, 1636424667561, 1636424668194, 633, 269, 364, 0, 0, 0
3661, 1, 1636424667472, 1636424668494, 1022, 666, 356, 0, 0, 0
3617, 1, 1636424658316, 1636424668622, 10306, 9905, 401, 0, 1, 1
3663, 1, 1636424668053, 1636424668714, 661, 270, 391, 0, 1, 1
3620, 2, 1636424658934, 1636424669069, 10135, 0, 10135, 0, 0, 0
3666, 1, 1636424668602, 1636424669230, 628, 272, 356, 2, 1, 3
3668, 1, 1636424668728, 1636424669362, 634, 269, 365, 0, 0, 0
3670, 1, 1636424669113, 1636424669746, 633, 265, 368, 1, 0, 1
3622, 2, 1636424659650, 1636424669789, 10139, 0, 10139, 0, 0, 0
3669, 1, 1636424668736, 1636424669814, 1078, 719, 359, 1, 0, 1
3671, 1, 1636424669198, 1636424669866, 668, 270, 398, 0, 0, 0
3672, 1, 1636424669459, 1636424670086, 627, 270, 357, 0, 0, 0
3673, 1, 1636424669533, 1636424670162, 629, 271, 358, 0, 1, 1
3675, 1, 1636424669918, 1636424670590, 672, 270, 402, 1, 0, 1
3676, 1, 1636424669977, 1636424670610, 633, 274, 359, 0, 0, 0
3674, 1, 1636424669538, 1636424670618, 1080, 719, 361, 0, 1, 1
3677, 1, 1636424670698, 1636424671326, 628, 273, 355, 0, 0, 0
3678, 1, 1636424670739, 1636424671366, 627, 271, 356, 0, 0, 0
3680, 1, 1636424671063, 1636424671690, 627, 271, 356, 0, 0, 0
3679, 1, 1636424670855, 1636424671818, 963, 605, 358, 0, 0, 0
3681, 1, 1636424671244, 1636424671862, 618, 265, 353, 1, 0, 1
3682, 1, 1636424671440, 1636424672070, 630, 270, 360, 0, 0, 0
3684, 1, 1636424671478, 1636424672142, 664, 308, 356, 0, 1, 1
3686, 1, 1636424671899, 1636424672526, 627, 271, 356, 0, 0, 0
3688, 1, 1636424672712, 1636424673338, 626, 269, 357, 0, 0, 0
3690, 1, 1636424673018, 1636424673646, 628, 271, 357, 1, 0, 1
3691, 1, 1636424673341, 1636424673970, 629, 270, 359, 0, 0, 0
3639, 2, 1636424663837, 1636424673973, 10136, 1, 10135, 1, 0, 1
3692, 1, 1636424673373, 1636424674002, 629, 271, 358, 0, 1, 1
3640, 2, 1636424663901, 1636424674037, 10136, 1, 10135, 0, 0, 0
3643, 2, 1636424664634, 1636424674769, 10135, 1, 10134, 1, 0, 1
3695, 1, 1636424674126, 1636424674794, 668, 269, 399, 1, 1, 2
3696, 1, 1636424674170, 1636424674846, 676, 270, 406, 0, 1, 1
3698, 1, 1636424674898, 1636424675574, 676, 275, 401, 0, 0, 0
3699, 1, 1636424675115, 1636424675742, 627, 271, 356, 0, 1, 1
3700, 1, 1636424675300, 1636424675926, 626, 270, 356, 2, 0, 2
3701, 1, 1636424675426, 1636424676058, 632, 275, 357, 1, 1, 2
3651, 2, 1636424665924, 1636424676089, 10165, 1, 10164, 1, 1, 2
3653, 2, 1636424666170, 1636424676349, 10179, 1, 10178, 1, 0, 1
3656, 2, 1636424666651, 1636424676785, 10134, 0, 10134, 0, 0, 0
3702, 1, 1636424676140, 1636424676798, 658, 307, 351, 1, 36, 37
3703, 1, 1636424676218, 1636424676886, 668, 268, 400, 1, 0, 1
3704, 1, 1636424676248, 1636424676890, 642, 270, 372, 3, 0, 3
3659, 2, 1636424667326, 1636424677501, 10175, 0, 10175, 0, 0, 0
3705, 1, 1636424676937, 1636424677566, 629, 271, 358, 1, 0, 1
3706, 1, 1636424676997, 1636424677622, 625, 271, 354, 0, 1, 1
3709, 1, 1636424677347, 1636424677974, 627, 270, 357, 0, 0, 0
3708, 1, 1636424677311, 1636424677982, 671, 270, 401, 2, 0, 2
3707, 1, 1636424677310, 1636424677982, 672, 268, 404, 0, 0, 0
3664, 2, 1636424668130, 1636424678305, 10175, 0, 10175, 1, 0, 1
3711, 1, 1636424677634, 1636424678434, 800, 403, 397, 2, 0, 2
3665, 2, 1636424668258, 1636424678436, 10178, 1, 10177, 0, 0, 0
3710, 1, 1636424677396, 1636424678437, 1041, 662, 379, 1, 0, 1
3712, 1, 1636424678164, 1636424678794, 630, 268, 362, 0, 0, 0
3713, 1, 1636424678233, 1636424678878, 645, 264, 381, 2, 0, 2
3714, 1, 1636424678253, 1636424678882, 629, 262, 367, 0, 1, 1
3667, 1, 1636424668624, 1636424678922, 10298, 9898, 400, 1, 0, 1
3715, 1, 1636424678442, 1636424679110, 668, 266, 402, 0, 0, 0
3719, 1, 1636424678974, 1636424679602, 628, 269, 359, 1, 0, 1
3720, 1, 1636424679143, 1636424679766, 623, 270, 353, 1, 1, 2
3722, 1, 1636424679232, 1636424679858, 626, 268, 358, 0, 0, 0
3721, 1, 1636424679228, 1636424679858, 630, 270, 360, 0, 0, 0
3724, 1, 1636424679572, 1636424680214, 642, 285, 357, 0, 0, 0
3723, 1, 1636424679360, 1636424680298, 938, 587, 351, 0, 1, 1
3725, 1, 1636424680240, 1636424680870, 630, 269, 361, 0, 0, 0
3726, 1, 1636424680253, 1636424680898, 645, 279, 366, 1, 0, 1
3727, 1, 1636424680276, 1636424680898, 622, 271, 351, 1, 0, 1
3728, 1, 1636424680296, 1636424680922, 626, 265, 361, 0, 0, 0
3729, 1, 1636424680973, 1636424681586, 613, 264, 349, 1, 1, 2
3683, 2, 1636424671457, 1636424681593, 10136, 1, 10135, 0, 1, 1
3730, 1, 1636424681116, 1636424681734, 618, 266, 352, 1, 1, 2
3731, 1, 1636424681232, 1636424681854, 622, 275, 347, 1, 8, 9
3732, 1, 1636424681277, 1636424681898, 621, 263, 358, 0, 0, 0
3685, 2, 1636424671782, 1636424681921, 10139, 0, 10139, 0, 0, 0
3734, 1, 1636424681595, 1636424682302, 707, 345, 362, 1, 0, 1
3733, 1, 1636424681398, 1636424682362, 964, 616, 348, 2, 24, 26
3735, 1, 1636424682110, 1636424682742, 632, 271, 361, 1, 1, 2
3687, 2, 1636424672663, 1636424682793, 10130, 1, 10129, 0, 0, 0
3736, 1, 1636424682234, 1636424682898, 664, 268, 396, 1, 0, 1
3737, 1, 1636424682234, 1636424682898, 664, 265, 399, 0, 0, 0
3689, 2, 1636424672770, 1636424682901, 10131, 1, 10130, 2, 0, 2
3738, 1, 1636424682295, 1636424682922, 627, 270, 357, 2, 0, 2
3739, 1, 1636424682323, 1636424682946, 623, 267, 356, 2, 1, 3
3740, 1, 1636424682365, 1636424682982, 617, 266, 351, 1, 0, 1
3693, 2, 1636424673399, 1636424683532, 10133, 1, 10132, 1, 0, 1
3741, 1, 1636424682930, 1636424683594, 664, 266, 398, 1, 1, 2
3742, 1, 1636424682991, 1636424683618, 627, 270, 357, 0, 0, 0
3743, 1, 1636424683016, 1636424683638, 622, 271, 351, 1, 0, 1
3694, 2, 1636424673780, 1636424683913, 10133, 1, 10132, 1, 0, 1
3745, 1, 1636424683300, 1636424683926, 626, 269, 357, 0, 1, 1
3746, 1, 1636424683330, 1636424683978, 648, 294, 354, 0, 27, 27
3744, 1, 1636424683034, 1636424684042, 1008, 613, 395, 0, 1, 1
3748, 1, 1636424683658, 1636424684358, 700, 302, 398, 1, 40, 41
3749, 1, 1636424683711, 1636424684378, 667, 306, 361, 0, 0, 0
3697, 1, 1636424674635, 1636424684398, 9763, 9414, 349, 48, 0, 48
3747, 1, 1636424683429, 1636424684422, 993, 627, 366, 0, 1, 1
3752, 1, 1636424684119, 1636424684750, 631, 273, 358, 0, 0, 0
3753, 1, 1636424684135, 1636424684770, 635, 270, 365, 0, 0, 0
3750, 1, 1636424684042, 1636424684806, 764, 366, 398, 0, 0, 0
3754, 1, 1636424684338, 1636424684966, 628, 270, 358, 1, 0, 1
3755, 1, 1636424684358, 1636424684986, 628, 270, 358, 1, 0, 1
3756, 1, 1636424684400, 1636424685066, 666, 270, 396, 0, 0, 0
3757, 1, 1636424684481, 1636424685110, 629, 271, 358, 0, 1, 1
3760, 1, 1636424685051, 1636424685678, 627, 270, 357, 1, 0, 1
3761, 1, 1636424685103, 1636424685730, 627, 269, 358, 2, 0, 2
3762, 1, 1636424685196, 1636424685830, 634, 275, 359, 0, 1, 1
3763, 1, 1636424685332, 1636424685966, 634, 270, 364, 0, 1, 1
3765, 1, 1636424685589, 1636424686222, 633, 269, 364, 0, 0, 0
3764, 1, 1636424685360, 1636424686278, 918, 566, 352, 0, 0, 0
3766, 1, 1636424685748, 1636424686422, 674, 314, 360, 0, 1, 1
3768, 1, 1636424686019, 1636424686654, 635, 270, 365, 0, 0, 0
3767, 1, 1636424685949, 1636424686678, 729, 371, 358, 0, 0, 0
3769, 1, 1636424686190, 1636424686818, 628, 269, 359, 0, 0, 0
3772, 1, 1636424686373, 1636424687006, 633, 269, 364, 1, 0, 1
3773, 1, 1636424686514, 1636424687142, 628, 270, 358, 0, 0, 0
3775, 1, 1636424687077, 1636424687698, 621, 264, 357, 0, 0, 0
3776, 1, 1636424687218, 1636424687842, 624, 266, 358, 0, 0, 0
3779, 1, 1636424687644, 1636424688270, 626, 269, 357, 0, 0, 0
3778, 1, 1636424687441, 1636424688290, 849, 493, 356, 2, 0, 2
3781, 1, 1636424687984, 1636424688730, 746, 387, 359, 0, 0, 0
3716, 2, 1636424678566, 1636424688745, 10179, 0, 10179, 0, 0, 0
3782, 1, 1636424688152, 1636424688774, 622, 271, 351, 0, 0, 0
3783, 1, 1636424688196, 1636424688818, 622, 266, 356, 0, 0, 0
3718, 2, 1636424678934, 1636424689069, 10135, 0, 10135, 0, 0, 0
3717, 2, 1636424678925, 1636424689113, 10188, 1, 10187, 0, 0, 0
3786, 1, 1636424688998, 1636424689658, 660, 269, 391, 1, 1, 2
3789, 1, 1636424689203, 1636424689874, 671, 269, 402, 0, 0, 0
3790, 1, 1636424689352, 1636424689982, 630, 273, 357, 0, 1, 1
3792, 1, 1636424689649, 1636424690278, 629, 270, 359, 1, 0, 1
3791, 1, 1636424689453, 1636424690438, 985, 626, 359, 1, 0, 1
3793, 1, 1636424690101, 1636424690730, 629, 270, 359, 2, 0, 2
3795, 1, 1636424690226, 1636424690854, 628, 270, 358, 0, 0, 0
3796, 1, 1636424691086, 1636424691718, 632, 269, 363, 1, 0, 1
3797, 1, 1636424691153, 1636424691782, 629, 271, 358, 0, 0, 0
3798, 1, 1636424691333, 1636424691962, 629, 269, 360, 0, 1, 1
3799, 1, 1636424691453, 1636424692418, 965, 606, 359, 0, 0, 0
3802, 1, 1636424692186, 1636424692818, 632, 268, 364, 0, 0, 0
3803, 1, 1636424693049, 1636424693678, 629, 271, 358, 1, 1, 2
3804, 1, 1636424693131, 1636424693754, 623, 270, 353, 1, 1, 2
3805, 1, 1636424693365, 1636424693994, 629, 271, 358, 0, 1, 1
3751, 2, 1636424684090, 1636424694229, 10139, 0, 10139, 0, 0, 0
3806, 1, 1636424693527, 1636424694446, 919, 562, 357, 0, 0, 0
3807, 1, 1636424694081, 1636424694714, 633, 270, 363, 1, 0, 1
3758, 2, 1636424684843, 1636424694977, 10134, 1, 10133, 0, 1, 1
3808, 1, 1636424694358, 1636424695030, 672, 269, 403, 0, 0, 0
3759, 2, 1636424684938, 1636424695073, 10135, 1, 10134, 0, 1, 1
3809, 1, 1636424694978, 1636424695614, 636, 269, 367, 1, 0, 1
3810, 1, 1636424695110, 1636424695782, 672, 270, 402, 2, 0, 2
3812, 1, 1636424695256, 1636424695878, 622, 266, 356, 2, 0, 2
3813, 1, 1636424695287, 1636424695910, 623, 270, 353, 2, 0, 2
3811, 1, 1636424695202, 1636424696238, 1036, 634, 402, 1, 0, 1
3814, 1, 1636424695489, 1636424696362, 873, 509, 364, 1, 0, 1
3770, 2, 1636424686359, 1636424696493, 10134, 0, 10134, 0, 0, 0
3771, 2, 1636424686367, 1636424696541, 10174, 0, 10174, 0, 0, 0
3815, 1, 1636424696018, 1636424696646, 628, 271, 357, 0, 0, 0
3816, 1, 1636424696391, 1636424697078, 687, 315, 372, 49, 1, 50
3774, 2, 1636424687051, 1636424697185, 10134, 0, 10134, 0, 0, 0
3817, 1, 1636424696630, 1636424697298, 668, 271, 397, 1, 0, 1
3818, 1, 1636424696630, 1636424697314, 684, 274, 410, 0, 0, 0
3777, 2, 1636424687321, 1636424697457, 10136, 1, 10135, 1, 1, 2
3819, 1, 1636424696900, 1636424697546, 646, 289, 357, 0, 20, 20
3780, 2, 1636424687649, 1636424697785, 10136, 0, 10136, 0, 0, 0
3820, 1, 1636424697118, 1636424697818, 700, 318, 382, 1, 49, 50
3822, 1, 1636424697248, 1636424697910, 662, 304, 358, 1, 37, 38
3824, 1, 1636424697359, 1636424698002, 643, 271, 372, 2, 1, 3
3826, 1, 1636424697586, 1636424698254, 668, 269, 399, 0, 0, 0
3821, 1, 1636424697237, 1636424698270, 1033, 673, 360, 0, 0, 0
3784, 2, 1636424688253, 1636424698389, 10136, 1, 10135, 0, 0, 0
3785, 2, 1636424688462, 1636424698597, 10135, 0, 10135, 1, 0, 1
3828, 1, 1636424697994, 1636424698654, 660, 304, 356, 1, 40, 41
3827, 1, 1636424697914, 1636424698750, 836, 437, 399, 0, 41, 41
3829, 1, 1636424698420, 1636424699042, 622, 270, 352, 0, 3, 3
3831, 1, 1636424698635, 1636424699254, 619, 266, 353, 1, 0, 1
3832, 1, 1636424698708, 1636424699338, 630, 270, 360, 1, 0, 1
3788, 2, 1636424689203, 1636424699381, 10178, 1, 10177, 1, 0, 1
3833, 1, 1636424698726, 1636424699390, 664, 263, 401, 0, 0, 0
3787, 2, 1636424689202, 1636424699429, 10227, 1, 10226, 1, 0, 1
3834, 1, 1636424698963, 1636424699586, 623, 267, 356, 0, 0, 0
3835, 1, 1636424699169, 1636424699882, 713, 307, 406, 1, 28, 29
3836, 1, 1636424699241, 1636424699886, 645, 283, 362, 1, 12, 13
3838, 1, 1636424699382, 1636424700018, 636, 270, 366, 0, 1, 1
3839, 1, 1636424699592, 1636424700330, 738, 387, 351, 0, 0, 0
3837, 1, 1636424699326, 1636424700330, 1004, 681, 323, 0, 49, 49
3794, 2, 1636424690216, 1636424700349, 10133, 0, 10133, 0, 0, 0
3841, 1, 1636424699929, 1636424700550, 621, 266, 355, 1, 0, 1
3842, 1, 1636424699962, 1636424700630, 668, 270, 398, 1, 0, 1
3840, 1, 1636424699881, 1636424700806, 925, 554, 371, 0, 15, 15
3843, 1, 1636424699962, 1636424701074, 1112, 714, 398, 0, 1, 1
3846, 1, 1636424700630, 1636424701254, 624, 265, 359, 0, 0, 0
3847, 1, 1636424700741, 1636424701374, 633, 267, 366, 1, 0, 1
3848, 1, 1636424700760, 1636424701390, 630, 270, 360, 0, 0, 0
3845, 1, 1636424700482, 1636424701522, 1040, 639, 401, 0, 1, 1
3800, 2, 1636424691727, 1636424701861, 10134, 1, 10133, 1, 0, 1
3851, 1, 1636424701231, 1636424701862, 631, 275, 356, 2, 0, 2
3853, 1, 1636424701358, 1636424701982, 624, 269, 355, 0, 1, 1
3854, 1, 1636424701664, 1636424702306, 642, 285, 357, 0, 23, 23
3801, 1, 1636424692179, 1636424702350, 10171, 9818, 353, 1, 0, 1
3856, 1, 1636424701937, 1636424702566, 629, 270, 359, 0, 0, 0
3857, 1, 1636424701980, 1636424702602, 622, 269, 353, 0, 0, 0
3858, 1, 1636424701986, 1636424702646, 660, 266, 394, 0, 0, 0
3855, 1, 1636424701896, 1636424702754, 858, 501, 357, 0, 0, 0
3859, 1, 1636424701990, 1636424703062, 1072, 714, 358, 0, 0, 0
3860, 1, 1636424702352, 1636424703094, 742, 346, 396, 0, 0, 0
3863, 1, 1636424702700, 1636424703330, 630, 269, 361, 0, 0, 0
3864, 1, 1636424702887, 1636424703506, 619, 263, 356, 0, 0, 0
3861, 1, 1636424702488, 1636424703510, 1022, 666, 356, 0, 0, 0
3865, 1, 1636424703163, 1636424703790, 627, 269, 358, 0, 1, 1
3866, 1, 1636424703433, 1636424704062, 629, 270, 359, 0, 0, 0
3869, 1, 1636424703904, 1636424704534, 630, 273, 357, 0, 0, 0
3872, 1, 1636424704029, 1636424704662, 633, 269, 364, 1, 0, 1
3873, 1, 1636424704462, 1636424705122, 660, 298, 362, 1, 0, 1
3875, 1, 1636424704569, 1636424705198, 629, 268, 361, 0, 0, 0
3877, 1, 1636424705084, 1636424705710, 626, 270, 356, 1, 0, 1
3879, 1, 1636424705938, 1636424706570, 632, 275, 357, 2, 0, 2
3882, 1, 1636424706695, 1636424707322, 627, 269, 358, 1, 0, 1
3823, 2, 1636424697314, 1636424707501, 10187, 0, 10187, 0, 0, 0
3825, 2, 1636424697459, 1636424707593, 10134, 0, 10134, 0, 0, 0
3883, 1, 1636424707007, 1636424707634, 627, 269, 358, 1, 0, 1
3886, 1, 1636424708010, 1636424708626, 616, 264, 352, 0, 0, 0
3884, 1, 1636424708002, 1636424708670, 668, 274, 394, 1, 0, 1
3885, 1, 1636424708003, 1636424708678, 675, 274, 401, 2, 1, 3
3830, 2, 1636424698518, 1636424708697, 10179, 1, 10178, 0, 1, 1
3887, 1, 1636424708592, 1636424709238, 646, 269, 377, 1, 0, 1
3888, 1, 1636424708826, 1636424709498, 672, 269, 403, 0, 0, 0
3889, 1, 1636424708949, 1636424709578, 629, 271, 358, 0, 0, 0
3844, 2, 1636424700350, 1636424710485, 10135, 0, 10135, 0, 0, 0
3890, 1, 1636424709951, 1636424710570, 619, 271, 348, 0, 1, 1
3891, 1, 1636424709981, 1636424710610, 629, 269, 360, 0, 0, 0
3892, 1, 1636424710128, 1636424710750, 622, 268, 354, 0, 3, 3
3849, 2, 1636424701031, 1636424711165, 10134, 1, 10133, 0, 0, 0
3893, 1, 1636424710612, 1636424711238, 626, 269, 357, 1, 0, 1
3850, 2, 1636424701118, 1636424711253, 10135, 0, 10135, 0, 0, 0
3894, 1, 1636424710614, 1636424711282, 668, 266, 402, 0, 0, 0
3852, 2, 1636424701237, 1636424711373, 10136, 1, 10135, 0, 0, 0
3895, 1, 1636424710807, 1636424711426, 619, 269, 350, 1, 3, 4
3896, 1, 1636424710850, 1636424711518, 668, 267, 401, 0, 0, 0
3897, 1, 1636424711374, 1636424712042, 668, 270, 398, 2, 1, 3
3898, 1, 1636424711382, 1636424712046, 664, 271, 393, 1, 0, 1
3900, 1, 1636424711841, 1636424712466, 625, 270, 355, 1, 0, 1
3899, 1, 1636424711503, 1636424712498, 995, 599, 396, 2, 1, 3
3901, 1, 1636424711959, 1636424712586, 627, 268, 359, 0, 1, 1
3902, 1, 1636424712142, 1636424712770, 628, 272, 356, 2, 2, 4
3862, 2, 1636424702700, 1636424712833, 10133, 0, 10133, 0, 0, 0
3903, 1, 1636424712617, 1636424713278, 661, 313, 348, 1, 41, 42
3904, 1, 1636424712716, 1636424713366, 650, 267, 383, 1, 0, 1
3905, 1, 1636424712744, 1636424713370, 626, 271, 355, 0, 0, 0
3906, 1, 1636424712924, 1636424713546, 622, 266, 356, 0, 0, 0
3907, 1, 1636424712962, 1636424713622, 660, 266, 394, 0, 0, 0
3867, 2, 1636424703562, 1636424713697, 10135, 0, 10135, 0, 0, 0
3908, 1, 1636424713360, 1636424713982, 622, 270, 352, 0, 0, 0
3909, 1, 1636424713367, 1636424713994, 627, 269, 358, 0, 0, 0
3868, 2, 1636424703888, 1636424714021, 10133, 0, 10133, 0, 0, 0
3871, 2, 1636424703993, 1636424714129, 10136, 1, 10135, 2, 0, 2
3870, 2, 1636424703993, 1636424714173, 10180, 1, 10179, 1, 1, 2
3911, 1, 1636424713826, 1636424714526, 700, 307, 393, 0, 36, 36
3910, 1, 1636424713541, 1636424714526, 985, 579, 406, 1, 43, 44
3913, 1, 1636424713950, 1636424714622, 672, 288, 384, 3, 19, 22
3912, 1, 1636424713887, 1636424714622, 735, 286, 449, 0, 19, 19
3874, 2, 1636424704555, 1636424714689, 10134, 0, 10134, 0, 0, 0
3876, 2, 1636424704780, 1636424714913, 10133, 0, 10133, 0, 1, 1
3914, 1, 1636424714173, 1636424714974, 801, 401, 400, 0, 0, 0
3917, 1, 1636424714507, 1636424715178, 671, 319, 352, 0, 49, 49
3918, 1, 1636424714587, 1636424715278, 691, 271, 420, 1, 0, 1
3919, 1, 1636424714704, 1636424715362, 658, 305, 353, 0, 37, 37
3878, 1, 1636424705327, 1636424715406, 10079, 9722, 357, 0, 0, 0
3921, 1, 1636424714914, 1636424715550, 636, 271, 365, 0, 0, 0
3922, 1, 1636424714947, 1636424715574, 627, 271, 356, 0, 0, 0
3923, 1, 1636424715042, 1636424715714, 672, 265, 407, 0, 0, 0
3924, 1, 1636424715350, 1636424715978, 628, 270, 358, 1, 0, 1
3925, 1, 1636424715359, 1636424715990, 631, 270, 361, 0, 0, 0
3926, 1, 1636424715408, 1636424716174, 766, 366, 400, 0, 0, 0
3880, 2, 1636424706156, 1636424716289, 10133, 0, 10133, 0, 0, 0
3928, 1, 1636424715801, 1636424716426, 625, 269, 356, 0, 0, 0
3927, 1, 1636424715525, 1636424716434, 909, 547, 362, 1, 1, 2
3929, 1, 1636424715893, 1636424716554, 661, 310, 351, 0, 44, 44
3930, 1, 1636424715925, 1636424716558, 633, 273, 360, 0, 5, 5
3881, 1, 1636424706512, 1636424716790, 10278, 9918, 360, 0, 0, 0
3931, 1, 1636424716195, 1636424716874, 679, 318, 361, 1, 0, 1
3933, 1, 1636424716516, 1636424717138, 622, 269, 353, 1, 0, 1
3934, 1, 1636424716593, 1636424717222, 629, 275, 354, 1, 1, 2
3935, 1, 1636424716678, 1636424717302, 624, 269, 355, 0, 0, 0
3937, 1, 1636424716833, 1636424717458, 625, 267, 358, 1, 0, 1
3938, 1, 1636424716880, 1636424717506, 626, 267, 359, 0, 0, 0
3939, 1, 1636424717045, 1636424717670, 625, 269, 356, 0, 0, 0
3940, 1, 1636424717265, 1636424717894, 629, 268, 361, 0, 0, 0
3941, 1, 1636424717412, 1636424718034, 622, 271, 351, 2, 1, 3
3942, 1, 1636424717518, 1636424718146, 628, 270, 358, 1, 1, 2
3944, 1, 1636424717687, 1636424718314, 627, 271, 356, 1, 1, 2
3945, 1, 1636424717814, 1636424718434, 620, 264, 356, 0, 0, 0
3946, 1, 1636424717839, 1636424718470, 631, 270, 361, 0, 0, 0
3943, 1, 1636424717607, 1636424718490, 883, 522, 361, 2, 0, 2
3947, 1, 1636424718112, 1636424718770, 658, 302, 356, 1, 0, 1
3948, 1, 1636424718483, 1636424719106, 623, 270, 353, 0, 0, 0
3949, 1, 1636424718590, 1636424719218, 628, 271, 357, 0, 1, 1
3950, 1, 1636424718651, 1636424719274, 623, 270, 353, 2, 0, 2
3951, 1, 1636424718871, 1636424719490, 619, 266, 353, 0, 0, 0
3952, 1, 1636424718894, 1636424719518, 624, 266, 358, 0, 0, 0
3953, 1, 1636424718931, 1636424719558, 627, 271, 356, 1, 0, 1
3954, 1, 1636424719338, 1636424719966, 628, 271, 357, 1, 0, 1
3955, 1, 1636424719404, 1636424720030, 626, 269, 357, 0, 0, 0
3956, 1, 1636424719547, 1636424720178, 631, 271, 360, 2, 0, 2
3959, 1, 1636424719750, 1636424720378, 628, 268, 360, 0, 0, 0
3958, 1, 1636424719749, 1636424720382, 633, 269, 364, 0, 0, 0
3960, 1, 1636424719957, 1636424720586, 629, 271, 358, 0, 0, 0
3957, 1, 1636424719657, 1636424720630, 973, 613, 360, 1, 0, 1
3961, 1, 1636424720224, 1636424720846, 622, 269, 353, 0, 0, 0
3962, 1, 1636424720418, 1636424721046, 628, 269, 359, 0, 0, 0
3963, 1, 1636424720566, 1636424721194, 628, 270, 358, 0, 1, 1
3964, 1, 1636424720584, 1636424721218, 634, 271, 363, 1, 2, 3
3965, 1, 1636424720853, 1636424721482, 629, 274, 355, 1, 0, 1
3966, 1, 1636424720992, 1636424721617, 625, 269, 356, 0, 0, 0
3967, 1, 1636424721029, 1636424721658, 629, 269, 360, 0, 0, 0
3968, 1, 1636424721284, 1636424721910, 626, 269, 357, 1, 0, 1
3969, 1, 1636424721466, 1636424722094, 628, 271, 357, 1, 0, 1
3970, 1, 1636424721529, 1636424722146, 617, 262, 355, 0, 0, 0
3974, 1, 1636424721856, 1636424722470, 614, 262, 352, 0, 0, 0
3973, 1, 1636424721849, 1636424722482, 633, 267, 366, 1, 0, 1
3971, 1, 1636424721638, 1636424722598, 960, 601, 359, 1, 0, 1
3975, 1, 1636424722359, 1636424722990, 631, 274, 357, 0, 0, 0
3976, 1, 1636424722445, 1636424723070, 625, 269, 356, 0, 0, 0
3978, 1, 1636424722615, 1636424723242, 627, 270, 357, 0, 0, 0
3979, 1, 1636424722859, 1636424723486, 627, 275, 352, 1, 0, 1
3980, 1, 1636424723010, 1636424723634, 624, 271, 353, 1, 1, 2
3981, 1, 1636424723128, 1636424723746, 618, 267, 351, 1, 0, 1
3982, 1, 1636424723218, 1636424723850, 632, 270, 362, 0, 0, 0
3983, 1, 1636424723601, 1636424724238, 637, 275, 362, 1, 0, 1
3984, 1, 1636424723620, 1636424724246, 626, 269, 357, 0, 0, 0
3916, 2, 1636424714262, 1636424724441, 10179, 1, 10178, 0, 0, 0
3986, 1, 1636424723830, 1636424724462, 632, 268, 364, 0, 0, 0
3915, 2, 1636424714262, 1636424724485, 10223, 1, 10222, 2, 0, 2
3987, 1, 1636424723867, 1636424724490, 623, 270, 353, 1, 0, 1
3985, 1, 1636424723712, 1636424724746, 1034, 636, 398, 1, 3, 4
3920, 2, 1636424714822, 1636424725005, 10183, 1, 10182, 1, 1, 2
3988, 1, 1636424724339, 1636424725022, 683, 312, 371, 44, 1, 45
3989, 1, 1636424724486, 1636424725110, 624, 271, 353, 1, 1, 2
3990, 1, 1636424724519, 1636424725150, 631, 269, 362, 1, 0, 1
3991, 1, 1636424724575, 1636424725270, 695, 297, 398, 1, 27, 28
3993, 1, 1636424725005, 1636424725586, 581, 269, 312, 1, 0, 1
3994, 1, 1636424725011, 1636424725630, 619, 265, 354, 0, 0, 0
3995, 1, 1636424725060, 1636424725678, 618, 262, 356, 1, 0, 1
3992, 1, 1636424724575, 1636424725722, 1147, 745, 402, 1, 0, 1
3998, 1, 1636424725525, 1636424726150, 625, 267, 358, 0, 0, 0
3996, 1, 1636424725134, 1636424726174, 1040, 643, 397, 0, 0, 0
3999, 1, 1636424725581, 1636424726202, 621, 267, 354, 1, 0, 1
4001, 1, 1636424725939, 1636424726558, 619, 262, 357, 1, 0, 1
3932, 2, 1636424716422, 1636424726597, 10175, 1, 10174, 0, 1, 1
4000, 1, 1636424725674, 1636424726602, 928, 573, 355, 1, 0, 1
4002, 1, 1636424725977, 1636424726602, 625, 270, 355, 2, 0, 2
3936, 2, 1636424716791, 1636424726969, 10178, 1, 10177, 1, 0, 1
4005, 1, 1636424726413, 1636424727046, 633, 279, 354, 1, 8, 9
4004, 1, 1636424726384, 1636424727054, 670, 310, 360, 1, 40, 41
4003, 1, 1636424726360, 1636424727054, 694, 334, 360, 3, 40, 43
4006, 1, 1636424726598, 1636424727182, 584, 274, 310, 0, 1, 1
4008, 1, 1636424726734, 1636424727418, 684, 291, 393, 1, 19, 20
4010, 1, 1636424726969, 1636424727598, 629, 267, 362, 1, 1, 2
4007, 1, 1636424726611, 1636424727638, 1027, 672, 355, 2, 1, 3
4013, 1, 1636424727151, 1636424727778, 627, 266, 361, 0, 0, 0
4011, 1, 1636424727102, 1636424727870, 768, 366, 402, 0, 0, 0
4012, 1, 1636424727128, 1636424728082, 954, 607, 347, 1, 1, 2
4014, 1, 1636424727487, 1636424728110, 623, 270, 353, 1, 0, 1
4015, 1, 1636424727584, 1636424728230, 646, 290, 356, 0, 1, 1
4017, 1, 1636424727870, 1636424728494, 624, 270, 354, 0, 0, 0
4016, 1, 1636424727631, 1636424728558, 927, 569, 358, 0, 0, 0
4018, 1, 1636424727936, 1636424728558, 622, 267, 355, 1, 1, 2
4019, 1, 1636424728296, 1636424728946, 650, 285, 365, 0, 0, 0
4020, 1, 1636424728327, 1636424728958, 631, 269, 362, 1, 0, 1
4021, 1, 1636424728447, 1636424729070, 623, 268, 355, 0, 1, 1
4022, 1, 1636424728472, 1636424729094, 622, 267, 355, 1, 0, 1
4024, 1, 1636424728764, 1636424729390, 626, 270, 356, 0, 1, 1
4025, 1, 1636424728852, 1636424729478, 626, 269, 357, 0, 0, 0
4023, 1, 1636424728562, 1636424729546, 984, 626, 358, 0, 1, 1
4027, 1, 1636424729055, 1636424729678, 623, 269, 354, 0, 0, 0
4028, 1, 1636424729158, 1636424729838, 680, 322, 358, 0, 0, 0
4026, 1, 1636424729045, 1636424730002, 957, 595, 362, 1, 1, 2
4029, 1, 1636424729399, 1636424730030, 631, 271, 360, 1, 0, 1
4030, 1, 1636424729464, 1636424730130, 666, 310, 356, 2, 0, 2
4032, 1, 1636424729832, 1636424730458, 626, 269, 357, 1, 0, 1
4031, 1, 1636424729621, 1636424730482, 861, 500, 361, 0, 0, 0
4033, 1, 1636424729992, 1636424730618, 626, 270, 356, 1, 0, 1
4035, 1, 1636424730279, 1636424730910, 631, 275, 356, 0, 0, 0
4034, 1, 1636424730190, 1636424730910, 720, 362, 358, 0, 0, 0
4036, 1, 1636424730522, 1636424731158, 636, 275, 361, 1, 0, 1
4037, 1, 1636424730584, 1636424731214, 630, 270, 360, 1, 0, 1
4039, 1, 1636424730683, 1636424731314, 631, 274, 357, 0, 0, 0
4041, 1, 1636424731019, 1636424731646, 627, 269, 358, 0, 0, 0
4040, 1, 1636424730764, 1636424731666, 902, 542, 360, 0, 0, 0
4042, 1, 1636424731043, 1636424731770, 727, 366, 361, 0, 0, 0
3972, 2, 1636424721805, 1636424731945, 10140, 0, 10140, 0, 0, 0
4044, 1, 1636424731351, 1636424731982, 631, 268, 363, 0, 0, 0
4045, 1, 1636424731418, 1636424732094, 676, 322, 354, 0, 1, 1
4046, 1, 1636424731565, 1636424732426, 861, 509, 352, 0, 0, 0
3977, 2, 1636424722477, 1636424732613, 10136, 1, 10135, 1, 0, 1
4048, 1, 1636424732052, 1636424732682, 630, 275, 355, 1, 0, 1
4049, 1, 1636424732078, 1636424732738, 660, 266, 394, 0, 0, 0
4051, 1, 1636424732211, 1636424732830, 619, 264, 355, 1, 0, 1
3997, 1, 1636424725274, 1636424733114, 7840, 7474, 366, 0, 1, 1
4052, 1, 1636424732712, 1636424733338, 626, 271, 355, 1, 0, 1
4053, 1, 1636424732731, 1636424733354, 623, 270, 353, 0, 0, 0
4054, 1, 1636424732742, 1636424733402, 660, 262, 398, 0, 0, 0
4058, 1, 1636424733116, 1636424733854, 738, 343, 395, 2, 0, 2
4059, 1, 1636424733284, 1636424733910, 626, 270, 356, 1, 1, 2
4061, 1, 1636424733506, 1636424734362, 856, 501, 355, 2, 1, 3
4062, 1, 1636424733937, 1636424734562, 625, 266, 359, 0, 1, 1
4063, 1, 1636424734044, 1636424734670, 626, 271, 355, 0, 1, 1
4064, 1, 1636424734164, 1636424734794, 630, 269, 361, 1, 0, 1
4066, 1, 1636424734605, 1636424735234, 629, 270, 359, 1, 1, 2
4065, 1, 1636424734601, 1636424735238, 637, 270, 367, 1, 0, 1
4067, 1, 1636424734726, 1636424735354, 628, 270, 358, 0, 0, 0
4068, 1, 1636424735049, 1636424735690, 641, 286, 355, 0, 0, 0
4069, 1, 1636424735205, 1636424735834, 629, 265, 364, 0, 0, 0
4070, 1, 1636424735428, 1636424736286, 858, 501, 357, 0, 0, 0
4072, 1, 1636424736084, 1636424736710, 626, 271, 355, 0, 1, 1
4073, 1, 1636424736160, 1636424736786, 626, 269, 357, 0, 0, 0
4009, 2, 1636424726892, 1636424737061, 10169, 0, 10169, 1, 0, 1
4074, 1, 1636424736532, 1636424737154, 622, 270, 352, 0, 0, 0
4075, 1, 1636424736646, 1636424737274, 628, 270, 358, 1, 0, 1
4079, 1, 1636424737200, 1636424737822, 622, 269, 353, 0, 0, 0
4078, 1, 1636424737190, 1636424737862, 672, 269, 403, 0, 0, 0
4080, 1, 1636424737342, 1636424738278, 936, 578, 358, 1, 0, 1
4081, 1, 1636424738008, 1636424738634, 626, 271, 355, 1, 0, 1
4082, 1, 1636424738103, 1636424738730, 627, 266, 361, 0, 0, 0
4083, 1, 1636424738559, 1636424739186, 627, 271, 356, 0, 0, 0
4084, 1, 1636424738570, 1636424739202, 632, 274, 358, 0, 0, 0
4085, 1, 1636424739143, 1636424739770, 627, 270, 357, 0, 0, 0
4086, 1, 1636424739205, 1636424739834, 629, 271, 358, 0, 0, 0
4087, 1, 1636424739332, 1636424740226, 894, 537, 357, 0, 0, 0
4088, 1, 1636424740000, 1636424740630, 630, 270, 360, 0, 0, 0
4089, 1, 1636424740118, 1636424740746, 628, 270, 358, 0, 0, 0
4038, 2, 1636424730651, 1636424740789, 10138, 0, 10138, 0, 0, 0
4090, 1, 1636424740543, 1636424741170, 627, 269, 358, 1, 0, 1
4043, 2, 1636424731054, 1636424741185, 10131, 1, 10130, 0, 1, 1
4091, 1, 1636424740595, 1636424741246, 651, 293, 358, 0, 20, 20
4092, 1, 1636424741040, 1636424741666, 626, 268, 358, 0, 0, 0
4093, 1, 1636424741242, 1636424741870, 628, 265, 363, 0, 0, 0
4047, 2, 1636424731744, 1636424741881, 10137, 1, 10136, 0, 1, 1
4094, 1, 1636424741289, 1636424742146, 857, 502, 355, 0, 33, 33
4050, 2, 1636424732185, 1636424742325, 10140, 0, 10140, 0, 0, 0
4096, 1, 1636424741759, 1636424742470, 711, 271, 440, 1, 0, 1
4097, 1, 1636424742010, 1636424742686, 676, 273, 403, 0, 3, 3
4098, 1, 1636424742073, 1636424742714, 641, 273, 368, 1, 0, 1
4099, 1, 1636424742139, 1636424742774, 635, 283, 352, 1, 11, 12
4055, 2, 1636424732755, 1636424742889, 10134, 0, 10134, 0, 0, 0
4095, 1, 1636424741758, 1636424742918, 1160, 731, 429, 1, 0, 1
4056, 2, 1636424732931, 1636424743065, 10134, 0, 10134, 0, 0, 0
4101, 1, 1636424742495, 1636424743162, 667, 307, 360, 2, 36, 38
4100, 1, 1636424742454, 1636424743162, 708, 305, 403, 2, 11, 13
4057, 2, 1636424733087, 1636424743221, 10134, 1, 10133, 0, 1, 1
4102, 1, 1636424742678, 1636424743342, 664, 307, 357, 1, 35, 36
4103, 1, 1636424743014, 1636424743682, 668, 267, 401, 0, 1, 1
4060, 1, 1636424733362, 1636424743722, 10360, 9998, 362, 0, 0, 0
4104, 1, 1636424743107, 1636424743750, 643, 262, 381, 1, 0, 1
4105, 1, 1636424743123, 1636424743754, 631, 263, 368, 1, 1, 2
4106, 1, 1636424743223, 1636424743886, 663, 262, 401, 0, 1, 1
4108, 1, 1636424743350, 1636424744134, 784, 387, 397, 1, 1, 2
4107, 1, 1636424743326, 1636424744198, 872, 516, 356, 0, 0, 0
4109, 1, 1636424743602, 1636424744230, 628, 269, 359, 0, 0, 0
4111, 1, 1636424743724, 1636424744398, 674, 270, 404, 1, 0, 1
4112, 1, 1636424743937, 1636424744570, 633, 274, 359, 1, 0, 1
4113, 1, 1636424743993, 1636424744626, 633, 274, 359, 0, 0, 0
4114, 1, 1636424744006, 1636424744630, 624, 267, 357, 0, 0, 0
4110, 1, 1636424743711, 1636424744678, 967, 610, 357, 1, 0, 1
4115, 1, 1636424744345, 1636424745030, 685, 323, 362, 1, 0, 1
4116, 1, 1636424744570, 1636424745194, 624, 271, 353, 0, 0, 0
4117, 1, 1636424744621, 1636424745242, 621, 266, 355, 0, 0, 0
4118, 1, 1636424744967, 1636424745602, 635, 271, 364, 0, 0, 0
4119, 1, 1636424745027, 1636424745658, 631, 271, 360, 0, 1, 1
4120, 1, 1636424745035, 1636424745666, 631, 274, 357, 0, 0, 0
4121, 1, 1636424745210, 1636424745838, 628, 267, 361, 0, 0, 0
4122, 1, 1636424745291, 1636424746058, 767, 413, 354, 0, 0, 0
4123, 1, 1636424745301, 1636424746106, 805, 438, 367, 0, 0, 0
4071, 2, 1636424735999, 1636424746133, 10134, 1, 10133, 0, 1, 1
4124, 1, 1636424745607, 1636424746234, 627, 270, 357, 0, 0, 0
4125, 1, 1636424745649, 1636424746278, 629, 274, 355, 0, 0, 0
4127, 1, 1636424745942, 1636424746586, 644, 286, 358, 1, 16, 17
4128, 1, 1636424745992, 1636424746614, 622, 270, 352, 0, 1, 1
4126, 1, 1636424745717, 1636424746730, 1013, 654, 359, 0, 0, 0
4076, 2, 1636424736685, 1636424746821, 10136, 1, 10135, 0, 0, 0
4130, 1, 1636424746262, 1636424746934, 672, 271, 401, 0, 2, 2
4129, 1, 1636424746049, 1636424747086, 1037, 685, 352, 0, 24, 24
4131, 1, 1636424746383, 1636424747090, 707, 350, 357, 0, 44, 44
4132, 1, 1636424746553, 1636424747174, 621, 270, 351, 1, 0, 1
4077, 2, 1636424737079, 1636424747213, 10134, 1, 10133, 0, 0, 0
4133, 1, 1636424746715, 1636424747350, 635, 267, 368, 0, 0, 0
4135, 1, 1636424747015, 1636424747666, 651, 293, 358, 0, 20, 20
4137, 1, 1636424747040, 1636424747666, 626, 270, 356, 1, 0, 1
4136, 1, 1636424747027, 1636424747666, 639, 274, 365, 2, 7, 9
4134, 1, 1636424746950, 1636424747674, 724, 314, 410, 1, 44, 45
4138, 1, 1636424747245, 1636424747878, 633, 271, 362, 0, 0, 0
4141, 1, 1636424747350, 1636424748114, 764, 370, 394, 0, 0, 0
4139, 1, 1636424747268, 1636424748122, 854, 486, 368, 1, 0, 1
4140, 1, 1636424747334, 1636424748122, 788, 426, 362, 0, 0, 0
4142, 1, 1636424747717, 1636424748350, 633, 273, 360, 0, 0, 0
4143, 1, 1636424747769, 1636424748398, 629, 274, 355, 0, 0, 0
4145, 1, 1636424747874, 1636424748502, 628, 275, 353, 2, 0, 2
4146, 1, 1636424747983, 1636424748618, 635, 273, 362, 0, 0, 0
4148, 1, 1636424748108, 1636424748730, 622, 272, 350, 1, 2, 3
4147, 1, 1636424748103, 1636424748738, 635, 270, 365, 2, 0, 2
4144, 1, 1636424747773, 1636424748854, 1081, 722, 359, 0, 0, 0
4149, 1, 1636424748376, 1636424748998, 622, 267, 355, 0, 0, 0
4150, 1, 1636424748508, 1636424749142, 634, 275, 359, 0, 0, 0
4151, 1, 1636424748743, 1636424749362, 619, 267, 352, 0, 1, 1
4152, 1, 1636424748827, 1636424749446, 619, 271, 348, 0, 1, 1
4153, 1, 1636424748907, 1636424749530, 623, 270, 353, 0, 1, 1
4154, 1, 1636424748969, 1636424749594, 625, 270, 355, 0, 0, 0
4155, 1, 1636424749115, 1636424749742, 627, 271, 356, 0, 2, 2
4158, 1, 1636424749278, 1636424749906, 628, 270, 358, 0, 0, 0
4157, 1, 1636424749247, 1636424749982, 735, 378, 357, 0, 1, 1
4159, 1, 1636424749430, 1636424750194, 764, 407, 357, 0, 0, 0
4160, 1, 1636424749585, 1636424750218, 633, 270, 363, 0, 0, 0
4161, 1, 1636424749656, 1636424750278, 622, 266, 356, 1, 0, 1
4163, 1, 1636424749772, 1636424750406, 634, 275, 359, 0, 1, 1
4164, 1, 1636424749920, 1636424750534, 614, 266, 348, 0, 0, 0
4166, 1, 1636424750083, 1636424750706, 623, 270, 353, 0, 0, 0
4162, 1, 1636424749755, 1636424750722, 967, 615, 352, 0, 0, 0
4167, 1, 1636424750274, 1636424750886, 612, 254, 358, 0, 0, 0
4168, 1, 1636424750441, 1636424751066, 625, 267, 358, 0, 0, 0
4169, 1, 1636424750795, 1636424751422, 627, 270, 357, 1, 0, 1
4170, 1, 1636424750803, 1636424751438, 635, 270, 365, 0, 0, 0
4171, 1, 1636424750868, 1636424751490, 622, 270, 352, 0, 0, 0
4172, 1, 1636424750889, 1636424751526, 637, 269, 368, 0, 1, 1
4173, 1, 1636424751001, 1636424751634, 633, 266, 367, 0, 0, 0
4175, 1, 1636424751254, 1636424751886, 632, 274, 358, 0, 1, 1
4174, 1, 1636424751195, 1636424751974, 779, 419, 360, 1, 0, 1
4176, 1, 1636424751356, 1636424752070, 714, 362, 352, 1, 0, 1
4177, 1, 1636424751479, 1636424752106, 627, 270, 357, 0, 0, 0
4178, 1, 1636424751717, 1636424752342, 625, 263, 362, 0, 1, 1
4180, 1, 1636424751890, 1636424752522, 632, 270, 362, 0, 1, 1
4181, 1, 1636424751964, 1636424752586, 622, 267, 355, 0, 0, 0
4182, 1, 1636424752009, 1636424752634, 625, 267, 358, 0, 1, 1
4179, 1, 1636424751813, 1636424752786, 973, 618, 355, 0, 0, 0
4183, 1, 1636424752279, 1636424752974, 695, 342, 353, 0, 0, 0
4184, 1, 1636424752423, 1636424753050, 627, 271, 356, 1, 0, 1
4185, 1, 1636424752703, 1636424753330, 627, 269, 358, 0, 0, 0
4186, 1, 1636424752793, 1636424753418, 625, 266, 359, 0, 0, 0
4187, 1, 1636424752896, 1636424753518, 622, 270, 352, 0, 0, 0
4188, 1, 1636424752948, 1636424753561, 613, 262, 351, 0, 0, 0
4189, 1, 1636424753022, 1636424753642, 620, 270, 350, 0, 0, 0
4190, 1, 1636424753155, 1636424753778, 623, 267, 356, 2, 0, 2
4191, 1, 1636424753289, 1636424753970, 681, 322, 359, 0, 0, 0
4192, 1, 1636424753472, 1636424754094, 622, 266, 356, 0, 0, 0
4193, 1, 1636424753559, 1636424754174, 615, 261, 354, 1, 0, 1
4194, 1, 1636424753757, 1636424754390, 633, 270, 363, 2, 0, 2
4195, 1, 1636424753852, 1636424754474, 622, 269, 353, 0, 0, 0
4197, 1, 1636424753971, 1636424754602, 631, 270, 361, 0, 0, 0
4198, 1, 1636424754118, 1636424754746, 628, 269, 359, 0, 0, 0
4199, 1, 1636424754277, 1636424754906, 629, 270, 359, 0, 0, 0
4196, 1, 1636424753879, 1636424754926, 1047, 694, 353, 0, 0, 0
4200, 1, 1636424754462, 1636424755090, 628, 270, 358, 1, 0, 1
4201, 1, 1636424754710, 1636424755342, 632, 269, 363, 0, 0, 0
4202, 1, 1636424754829, 1636424755454, 625, 270, 355, 0, 0, 0
4203, 1, 1636424754911, 1636424755542, 631, 267, 364, 1, 1, 2
4204, 1, 1636424755004, 1636424755626, 622, 274, 348, 0, 0, 0
4205, 1, 1636424755158, 1636424755786, 628, 274, 354, 1, 0, 1
4206, 1, 1636424755163, 1636424755790, 627, 274, 353, 0, 0, 0
4207, 1, 1636424755355, 1636424756078, 723, 370, 353, 1, 0, 1
4208, 1, 1636424755522, 1636424756146, 624, 271, 353, 0, 0, 0
4209, 1, 1636424755608, 1636424756234, 626, 274, 352, 0, 0, 0
4210, 1, 1636424755785, 1636424756414, 629, 271, 358, 0, 0, 0
4211, 1, 1636424755807, 1636424756430, 623, 267, 356, 0, 1, 1
4213, 1, 1636424755938, 1636424756562, 624, 265, 359, 0, 0, 0
4212, 1, 1636424755842, 1636424756862, 1020, 666, 354, 0, 0, 0
4215, 1, 1636424756326, 1636424756958, 632, 270, 362, 0, 0, 0
4216, 1, 1636424756571, 1636424757190, 619, 266, 353, 0, 0, 0
4217, 1, 1636424756677, 1636424757310, 633, 274, 359, 0, 1, 1
4220, 1, 1636424756961, 1636424757586, 625, 270, 355, 0, 0, 0
4219, 1, 1636424756957, 1636424757586, 629, 270, 359, 1, 0, 1
4221, 1, 1636424757091, 1636424757718, 627, 271, 356, 0, 1, 1
4222, 1, 1636424757115, 1636424757758, 643, 290, 353, 1, 0, 1
4224, 1, 1636424757538, 1636424758162, 624, 270, 354, 2, 0, 2
4225, 1, 1636424757540, 1636424758162, 622, 269, 353, 0, 0, 0
4226, 1, 1636424757816, 1636424758442, 626, 271, 355, 0, 1, 1
4227, 1, 1636424757918, 1636424758542, 624, 271, 353, 0, 1, 1
4228, 1, 1636424757926, 1636424758898, 972, 614, 358, 0, 0, 0
4229, 1, 1636424758430, 1636424759058, 628, 269, 359, 0, 0, 0
4156, 2, 1636424749124, 1636424759261, 10137, 1, 10136, 0, 1, 1
4232, 1, 1636424759088, 1636424759718, 630, 270, 360, 1, 3, 4
4233, 1, 1636424759095, 1636424759718, 623, 266, 357, 0, 0, 0
4231, 1, 1636424759073, 1636424759718, 645, 281, 364, 1, 15, 16
4234, 1, 1636424759390, 1636424760062, 672, 271, 401, 0, 2, 2
4165, 2, 1636424749982, 1636424760117, 10135, 0, 10135, 0, 0, 0
4235, 1, 1636424759542, 1636424760170, 628, 270, 358, 0, 0, 0
4236, 1, 1636424759650, 1636424760274, 624, 269, 355, 0, 0, 0
4237, 1, 1636424759720, 1636424760386, 666, 309, 357, 1, 43, 44
4238, 1, 1636424759876, 1636424760506, 630, 270, 360, 0, 0, 0
4239, 1, 1636424759882, 1636424760838, 956, 598, 358, 0, 0, 0
4240, 1, 1636424760246, 1636424760918, 672, 270, 402, 0, 0, 0
4241, 1, 1636424760389, 1636424761018, 629, 270, 359, 1, 0, 1
4242, 1, 1636424760987, 1636424761614, 627, 271, 356, 1, 0, 1
4243, 1, 1636424760999, 1636424761630, 631, 270, 361, 0, 0, 0
4244, 1, 1636424761213, 1636424761842, 629, 270, 359, 1, 0, 1
4245, 1, 1636424761352, 1636424761978, 626, 270, 356, 1, 0, 1
4246, 1, 1636424761446, 1636424762074, 628, 275, 353, 0, 1, 1
4247, 1, 1636424761609, 1636424762234, 625, 270, 355, 0, 2, 2
4248, 1, 1636424761675, 1636424762302, 627, 269, 358, 1, 0, 1
4250, 1, 1636424761953, 1636424762582, 629, 268, 361, 1, 0, 1
4249, 1, 1636424761811, 1636424762754, 943, 586, 357, 0, 0, 0
4251, 1, 1636424762206, 1636424762838, 632, 270, 362, 0, 0, 0
4252, 1, 1636424762465, 1636424763098, 633, 270, 363, 0, 0, 0
4253, 1, 1636424762864, 1636424763494, 630, 275, 355, 1, 2, 3
4254, 1, 1636424763043, 1636424763666, 623, 270, 353, 0, 1, 1
4255, 1, 1636424763168, 1636424763806, 638, 274, 364, 1, 1, 2
4256, 1, 1636424763330, 1636424763970, 640, 278, 362, 0, 0, 0
4257, 1, 1636424763408, 1636424764038, 630, 270, 360, 0, 1, 1
4258, 1, 1636424763587, 1636424764214, 627, 269, 358, 0, 0, 0
4259, 1, 1636424763664, 1636424764294, 630, 274, 356, 1, 0, 1
4260, 1, 1636424763732, 1636424764666, 934, 577, 357, 1, 0, 1
4261, 1, 1636424764048, 1636424764682, 634, 274, 360, 1, 0, 1
4262, 1, 1636424764158, 1636424764790, 632, 271, 361, 0, 1, 1
4263, 1, 1636424764560, 1636424765190, 630, 269, 361, 0, 0, 0
4264, 1, 1636424764759, 1636424765394, 635, 269, 366, 0, 0, 0
4265, 1, 1636424765102, 1636424765730, 628, 270, 358, 0, 0, 0
4266, 1, 1636424765195, 1636424765818, 623, 272, 351, 1, 1, 2
4267, 1, 1636424765303, 1636424765950, 647, 277, 370, 1, 0, 1
4214, 2, 1636424755986, 1636424766121, 10135, 0, 10135, 0, 1, 1
4269, 1, 1636424765556, 1636424766182, 626, 271, 355, 0, 0, 0
4268, 1, 1636424765343, 1636424766186, 843, 482, 361, 0, 0, 0
4271, 1, 1636424765760, 1636424766642, 882, 526, 356, 0, 1, 1
4270, 1, 1636424765693, 1636424766642, 949, 586, 363, 1, 1, 2
4272, 1, 1636424766040, 1636424766702, 662, 266, 396, 0, 0, 0
4274, 1, 1636424766250, 1636424766926, 676, 270, 406, 0, 0, 0
4218, 2, 1636424756873, 1636424767009, 10136, 0, 10136, 0, 0, 0
4273, 1, 1636424766234, 1636424767094, 860, 502, 358, 0, 0, 0
4275, 1, 1636424766552, 1636424767178, 626, 271, 355, 1, 0, 1
4276, 1, 1636424766711, 1636424767366, 655, 297, 358, 1, 27, 28
4223, 2, 1636424757333, 1636424767469, 10136, 1, 10135, 0, 0, 0
4277, 1, 1636424767073, 1636424767742, 669, 307, 362, 1, 32, 33
4279, 1, 1636424767207, 1636424767830, 623, 264, 359, 0, 2, 2
4278, 1, 1636424767138, 1636424767834, 696, 294, 402, 0, 27, 27
4280, 1, 1636424767265, 1636424767926, 661, 298, 363, 1, 28, 29
4281, 1, 1636424767292, 1636424767930, 638, 274, 364, 2, 3, 5
4282, 1, 1636424767552, 1636424768178, 626, 271, 355, 2, 0, 2
4283, 1, 1636424767598, 1636424768290, 692, 289, 403, 0, 0, 0
4285, 1, 1636424767690, 1636424768314, 624, 270, 354, 1, 0, 1
4230, 2, 1636424758439, 1636424768573, 10134, 0, 10134, 0, 1, 1
4284, 1, 1636424767609, 1636424768634, 1025, 663, 362, 0, 1, 1
4286, 1, 1636424768083, 1636424768710, 627, 271, 356, 0, 0, 0
4287, 1, 1636424768144, 1636424768778, 634, 270, 364, 0, 0, 0
4288, 1, 1636424768288, 1636424768938, 650, 285, 365, 0, 16, 16
4289, 1, 1636424768583, 1636424769210, 627, 270, 357, 0, 0, 0
4290, 1, 1636424768592, 1636424769226, 634, 270, 364, 0, 0, 0
4291, 1, 1636424768702, 1636424769374, 672, 270, 402, 1, 0, 1
4292, 1, 1636424769103, 1636424769726, 623, 270, 353, 1, 0, 1
4293, 1, 1636424769116, 1636424769738, 622, 270, 352, 0, 0, 0
4294, 1, 1636424769226, 1636424769854, 628, 273, 355, 0, 0, 0
4295, 1, 1636424769242, 1636424769866, 624, 270, 354, 0, 0, 0
4296, 1, 1636424769366, 1636424769990, 624, 270, 354, 0, 0, 0
4297, 1, 1636424769472, 1636424770098, 626, 267, 359, 0, 0, 0
4298, 1, 1636424769563, 1636424770186, 623, 261, 362, 0, 0, 0
4300, 1, 1636424769730, 1636424770358, 628, 269, 359, 0, 0, 0
4299, 1, 1636424769566, 1636424770550, 984, 626, 358, 0, 1, 1
4301, 1, 1636424770007, 1636424770634, 627, 269, 358, 0, 0, 0
4302, 1, 1636424770153, 1636424770770, 617, 266, 351, 0, 0, 0
4303, 1, 1636424770401, 1636424771026, 625, 270, 355, 0, 2, 2
4304, 1, 1636424770503, 1636424771134, 631, 271, 360, 1, 0, 1
4305, 1, 1636424770586, 1636424771210, 624, 271, 353, 0, 2, 2
4306, 1, 1636424770717, 1636424771350, 633, 271, 362, 1, 0, 1
4307, 1, 1636424771040, 1636424771662, 622, 270, 352, 0, 1, 1
4308, 1, 1636424771145, 1636424771774, 629, 268, 361, 1, 0, 1
4309, 1, 1636424771146, 1636424771774, 628, 271, 357, 3, 0, 3
4310, 1, 1636424771223, 1636424771846, 623, 262, 361, 0, 0, 0
4311, 1, 1636424771262, 1636424771886, 624, 269, 355, 0, 1, 1
4312, 1, 1636424771395, 1636424772026, 631, 274, 357, 0, 0, 0
4314, 1, 1636424771654, 1636424772286, 632, 271, 361, 1, 1, 2
4315, 1, 1636424771683, 1636424772314, 631, 273, 358, 0, 0, 0
4313, 1, 1636424771503, 1636424772478, 975, 618, 357, 0, 0, 0
4316, 1, 1636424772117, 1636424772742, 625, 267, 358, 1, 1, 2
4317, 1, 1636424772145, 1636424772774, 629, 271, 358, 1, 0, 1
4319, 1, 1636424772499, 1636424773126, 627, 269, 358, 0, 0, 0
4318, 1, 1636424772401, 1636424773198, 797, 439, 358, 0, 0, 0
4321, 1, 1636424772754, 1636424773382, 628, 270, 358, 0, 1, 1
4320, 1, 1636424772697, 1636424773638, 941, 586, 355, 0, 0, 0
4322, 1, 1636424773030, 1636424773646, 616, 263, 353, 0, 1, 1
4323, 1, 1636424773070, 1636424773682, 612, 259, 353, 0, 0, 0
4326, 1, 1636424773337, 1636424773962, 625, 262, 363, 1, 0, 1
4327, 1, 1636424773368, 1636424773994, 626, 268, 358, 0, 0, 0
4328, 1, 1636424773475, 1636424774450, 975, 618, 357, 0, 0, 0
4331, 1, 1636424774236, 1636424774866, 630, 269, 361, 0, 0, 0
4332, 1, 1636424774276, 1636424774898, 622, 266, 356, 0, 0, 0
4333, 1, 1636424774441, 1636424775070, 629, 270, 359, 0, 0, 0
4334, 1, 1636424774455, 1636424775086, 631, 271, 360, 1, 1, 2
4335, 1, 1636424774744, 1636424775374, 630, 272, 358, 0, 1, 1
4337, 1, 1636424774948, 1636424775574, 626, 271, 355, 1, 1, 2
4338, 1, 1636424775068, 1636424775694, 626, 270, 356, 0, 0, 0
4339, 1, 1636424775266, 1636424775898, 632, 270, 362, 1, 0, 1
4341, 1, 1636424775412, 1636424776038, 626, 267, 359, 1, 0, 1
4340, 1, 1636424775377, 1636424776350, 973, 617, 356, 0, 0, 0
4343, 1, 1636424776342, 1636424776970, 628, 271, 357, 1, 1, 2
4344, 1, 1636424776351, 1636424776978, 627, 271, 356, 0, 1, 1
4345, 1, 1636424776582, 1636424777210, 628, 270, 358, 1, 0, 1
4347, 1, 1636424776946, 1636424777578, 632, 270, 362, 0, 0, 0
4348, 1, 1636424776965, 1636424777594, 629, 269, 360, 2, 0, 2
4349, 1, 1636424777339, 1636424777970, 631, 269, 362, 1, 0, 1
4350, 1, 1636424777372, 1636424777998, 626, 270, 356, 1, 0, 1
4351, 1, 1636424777450, 1636424778426, 976, 615, 361, 0, 0, 0
4352, 1, 1636424778312, 1636424778946, 634, 269, 365, 0, 0, 0
4353, 1, 1636424778409, 1636424779042, 633, 271, 362, 0, 0, 0
4355, 1, 1636424779007, 1636424779638, 631, 275, 356, 0, 1, 1
4356, 1, 1636424779032, 1636424779662, 630, 270, 360, 1, 0, 1
4357, 1, 1636424779224, 1636424779854, 630, 275, 355, 0, 0, 0
4358, 1, 1636424779296, 1636424779922, 626, 271, 355, 1, 0, 1
4359, 1, 1636424779403, 1636424780306, 903, 542, 361, 0, 1, 1
4360, 1, 1636424780206, 1636424780830, 624, 262, 362, 1, 1, 2
4361, 1, 1636424780294, 1636424780914, 620, 266, 354, 0, 2, 2
4362, 1, 1636424780898, 1636424781530, 632, 270, 362, 1, 0, 1
4363, 1, 1636424780917, 1636424781550, 633, 270, 363, 0, 0, 0
4364, 1, 1636424781208, 1636424781834, 626, 269, 357, 1, 1, 2
4365, 1, 1636424781223, 1636424781850, 627, 265, 362, 0, 0, 0
4366, 1, 1636424781301, 1636424782294, 993, 638, 355, 0, 0, 0
4367, 1, 1636424782118, 1636424782742, 624, 266, 358, 0, 0, 0
4368, 1, 1636424782248, 1636424782874, 626, 271, 355, 0, 0, 0
4324, 2, 1636424773150, 1636424783285, 10135, 1, 10134, 1, 0, 1
4325, 2, 1636424773222, 1636424783361, 10139, 1, 10138, 0, 0, 0
4369, 1, 1636424782866, 1636424783494, 628, 270, 358, 0, 0, 0
4370, 1, 1636424782916, 1636424783550, 634, 282, 352, 0, 16, 16
4329, 2, 1636424773550, 1636424783685, 10135, 0, 10135, 0, 0, 0
4371, 1, 1636424783185, 1636424783818, 633, 266, 367, 2, 0, 2
4330, 2, 1636424773704, 1636424783837, 10133, 0, 10133, 0, 0, 0
4372, 1, 1636424783215, 1636424783898, 683, 267, 416, 0, 1, 1
4373, 1, 1636424783287, 1636424784342, 1055, 671, 384, 0, 0, 0
4375, 1, 1636424783774, 1636424784446, 672, 270, 402, 0, 0, 0
4374, 1, 1636424783770, 1636424784450, 680, 275, 405, 0, 0, 0
4378, 1, 1636424784094, 1636424784718, 624, 270, 354, 0, 0, 0
4379, 1, 1636424784239, 1636424784866, 627, 270, 357, 0, 0, 0
4336, 2, 1636424774753, 1636424784889, 10136, 0, 10136, 0, 0, 0
4376, 1, 1636424783838, 1636424784898, 1060, 665, 395, 0, 0, 0
4377, 1, 1636424783967, 1636424784906, 939, 530, 409, 1, 0, 1
4380, 1, 1636424784890, 1636424785478, 588, 273, 315, 0, 0, 0
4381, 1, 1636424784984, 1636424785606, 622, 270, 352, 0, 0, 0
4382, 1, 1636424785018, 1636424785678, 660, 267, 393, 1, 0, 1
4383, 1, 1636424785103, 1636424785722, 619, 266, 353, 1, 0, 1
4384, 1, 1636424785172, 1636424785802, 630, 270, 360, 0, 0, 0
4385, 1, 1636424785223, 1636424786174, 951, 591, 360, 0, 1, 1
4342, 2, 1636424776103, 1636424786237, 10134, 1, 10133, 1, 1, 2
4386, 1, 1636424785619, 1636424786250, 631, 270, 361, 0, 1, 1
4387, 1, 1636424785692, 1636424786314, 622, 262, 360, 0, 0, 0
4390, 1, 1636424785973, 1636424786598, 625, 270, 355, 0, 0, 0
4389, 1, 1636424785874, 1636424786698, 824, 470, 354, 0, 0, 0
4346, 1, 1636424776611, 1636424786730, 10119, 9766, 353, 0, 0, 0
4388, 1, 1636424785703, 1636424786766, 1063, 708, 355, 0, 2, 2
4391, 1, 1636424786237, 1636424786853, 616, 262, 354, 1, 0, 1
4392, 1, 1636424786366, 1636424787034, 668, 264, 404, 0, 0, 0
4394, 1, 1636424786786, 1636424787410, 624, 266, 358, 1, 1, 2
4393, 1, 1636424786731, 1636424787494, 763, 362, 401, 0, 0, 0
4395, 1, 1636424786890, 1636424787514, 624, 270, 354, 0, 0, 0
4396, 1, 1636424786917, 1636424787554, 637, 269, 368, 0, 0, 0
4397, 1, 1636424787192, 1636424787818, 626, 270, 356, 0, 0, 0
4399, 1, 1636424787544, 1636424788178, 634, 270, 364, 0, 1, 1
4398, 1, 1636424787260, 1636424788274, 1014, 662, 352, 0, 1, 1
4400, 1, 1636424787734, 1636424788354, 620, 270, 350, 1, 0, 1
4354, 2, 1636424778461, 1636424788593, 10132, 0, 10132, 0, 0, 0
4401, 1, 1636424787778, 1636424788630, 852, 495, 357, 2, 0, 2
4402, 1, 1636424787811, 1636424788802, 991, 634, 357, 0, 0, 0
4403, 1, 1636424788226, 1636424788866, 640, 277, 363, 1, 15, 16
4404, 1, 1636424788298, 1636424789254, 956, 598, 358, 2, 0, 2
4406, 1, 1636424788722, 1636424789398, 676, 273, 403, 1, 0, 1
4407, 1, 1636424788825, 1636424789454, 629, 271, 358, 1, 1, 2
4408, 1, 1636424788842, 1636424789474, 632, 271, 361, 0, 1, 1
4411, 1, 1636424789303, 1636424789934, 631, 275, 356, 2, 0, 2
4410, 1, 1636424789302, 1636424790382, 1080, 723, 357, 2, 0, 2
4414, 1, 1636424789802, 1636424790430, 628, 269, 359, 1, 0, 1
4415, 1, 1636424789857, 1636424790886, 1029, 669, 360, 0, 0, 0
4416, 1, 1636424790318, 1636424790950, 632, 269, 363, 0, 0, 0
4419, 1, 1636424790800, 1636424791430, 630, 271, 359, 2, 0, 2
4420, 1, 1636424790885, 1636424791514, 629, 271, 358, 1, 0, 1
4423, 1, 1636424791859, 1636424792490, 631, 269, 362, 1, 0, 1
4424, 1, 1636424791933, 1636424792946, 1013, 654, 359, 0, 1, 1
4426, 1, 1636424792752, 1636424793378, 626, 271, 355, 1, 0, 1
4428, 1, 1636424793811, 1636424794442, 631, 268, 363, 0, 0, 0
4429, 1, 1636424793866, 1636424794902, 1036, 673, 363, 1, 0, 1
4430, 1, 1636424794777, 1636424795406, 629, 269, 360, 0, 0, 0
4431, 1, 1636424795888, 1636424796514, 626, 269, 357, 1, 1, 2
4432, 1, 1636424795942, 1636424796970, 1028, 666, 362, 0, 0, 0
4433, 1, 1636424796646, 1636424797278, 632, 268, 364, 0, 0, 0
4434, 1, 1636424797851, 1636424798478, 627, 273, 354, 0, 0, 0
4405, 2, 1636424788648, 1636424798781, 10133, 0, 10133, 0, 0, 0
4435, 1, 1636424797867, 1636424798938, 1071, 709, 362, 1, 0, 1
4409, 2, 1636424789008, 1636424799141, 10133, 0, 10133, 0, 0, 0
4436, 1, 1636424798654, 1636424799322, 668, 270, 398, 0, 0, 0
4412, 2, 1636424789475, 1636424799609, 10134, 0, 10134, 0, 0, 0
4413, 2, 1636424789706, 1636424799841, 10135, 0, 10135, 1, 0, 1
4437, 1, 1636424799346, 1636424800010, 664, 266, 398, 1, 0, 1
4438, 1, 1636424799347, 1636424800054, 707, 311, 396, 1, 39, 40
4417, 2, 1636424790338, 1636424800473, 10135, 0, 10135, 0, 0, 0
4439, 1, 1636424799742, 1636424800506, 764, 350, 414, 0, 0, 0
4440, 1, 1636424799916, 1636424800538, 622, 266, 356, 0, 0, 0
4418, 1, 1636424790773, 1636424800958, 10185, 9830, 355, 0, 0, 0
4441, 1, 1636424799970, 1636424800958, 988, 587, 401, 0, 0, 0
4442, 1, 1636424799976, 1636424800994, 1018, 658, 360, 0, 0, 0
4443, 1, 1636424800599, 1636424801226, 627, 270, 357, 1, 0, 1
4444, 1, 1636424800602, 1636424801266, 664, 265, 399, 0, 1, 1
4421, 2, 1636424791230, 1636424801365, 10135, 0, 10135, 0, 0, 0
4422, 2, 1636424791244, 1636424801413, 10169, 1, 10168, 0, 1, 1
4445, 1, 1636424800959, 1636424801634, 675, 274, 401, 0, 3, 3
4447, 1, 1636424801317, 1636424801954, 637, 313, 324, 49, 1, 50
4446, 1, 1636424801249, 1636424801958, 709, 313, 396, 47, 1, 48
4449, 1, 1636424801506, 1636424802170, 664, 270, 394, 1, 0, 1
4425, 2, 1636424792259, 1636424802392, 10133, 1, 10132, 0, 0, 0
4450, 1, 1636424801686, 1636424802406, 720, 359, 361, 1, 0, 1
4451, 1, 1636424801812, 1636424802430, 618, 265, 353, 1, 0, 1
4448, 1, 1636424801502, 1636424802658, 1156, 756, 400, 1, 35, 36
4452, 1, 1636424801876, 1636424802858, 982, 627, 355, 1, 0, 1
4453, 1, 1636424801901, 1636424802878, 977, 623, 354, 0, 2, 2
4427, 2, 1636424792754, 1636424802889, 10135, 0, 10135, 0, 0, 0
4454, 1, 1636424802518, 1636424803182, 664, 270, 394, 0, 0, 0
4455, 1, 1636424802572, 1636424803194, 622, 270, 352, 1, 0, 1
4456, 1, 1636424802675, 1636424803338, 663, 306, 357, 0, 40, 40
4457, 1, 1636424802889, 1636424803518, 629, 270, 359, 0, 0, 0
4458, 1, 1636424803018, 1636424803686, 668, 271, 397, 0, 0, 0
4459, 1, 1636424803262, 1636424803890, 628, 270, 358, 0, 1, 1
4460, 1, 1636424803427, 1636424804054, 627, 270, 357, 1, 0, 1
4461, 1, 1636424803519, 1636424804150, 631, 270, 361, 0, 0, 0
4463, 1, 1636424803690, 1636424804346, 656, 298, 358, 2, 0, 2
4464, 1, 1636424803868, 1636424804502, 634, 271, 363, 1, 1, 2
4462, 1, 1636424803536, 1636424804606, 1070, 714, 356, 0, 0, 0
4466, 1, 1636424803963, 1636424804806, 843, 485, 358, 0, 0, 0
4465, 1, 1636424803902, 1636424804962, 1060, 698, 362, 0, 0, 0
4467, 1, 1636424804549, 1636424805178, 629, 270, 359, 1, 0, 1
4468, 1, 1636424804680, 1636424805306, 626, 269, 357, 0, 1, 1
4469, 1, 1636424804795, 1636424805422, 627, 269, 358, 1, 0, 1
4470, 1, 1636424804985, 1636424805606, 621, 266, 355, 0, 0, 0
4471, 1, 1636424805032, 1636424805654, 622, 267, 355, 1, 0, 1
4472, 1, 1636424805357, 1636424805986, 629, 270, 359, 1, 0, 1
4473, 1, 1636424805370, 1636424805998, 628, 271, 357, 1, 1, 2
4474, 1, 1636424805557, 1636424806190, 633, 276, 357, 1, 0, 1
4476, 1, 1636424805801, 1636424806454, 653, 294, 359, 0, 0, 0
4477, 1, 1636424805956, 1636424806582, 626, 270, 356, 0, 0, 0
4475, 1, 1636424805589, 1636424806642, 1053, 694, 359, 0, 0, 0
4479, 1, 1636424805985, 1636424806902, 917, 557, 360, 0, 0, 0
4478, 1, 1636424805975, 1636424807034, 1059, 707, 352, 0, 1, 1
4480, 1, 1636424806585, 1636424807214, 629, 270, 359, 1, 0, 1
4481, 1, 1636424806610, 1636424807238, 628, 271, 357, 0, 1, 1
4482, 1, 1636424806755, 1636424807382, 627, 270, 357, 2, 1, 3
4483, 1, 1636424807093, 1636424807722, 629, 271, 358, 0, 0, 0
4484, 1, 1636424807152, 1636424807778, 626, 265, 361, 0, 0, 0
4486, 1, 1636424807300, 1636424807922, 622, 269, 353, 0, 0, 0
4487, 1, 1636424807423, 1636424808050, 627, 265, 362, 0, 0, 0
4485, 1, 1636424807286, 1636424808230, 944, 586, 358, 1, 0, 1
4489, 1, 1636424807677, 1636424808378, 701, 342, 359, 0, 0, 0
4488, 1, 1636424807498, 1636424808502, 1004, 642, 362, 1, 0, 1
4491, 1, 1636424807905, 1636424808530, 625, 268, 357, 0, 0, 0
4490, 1, 1636424807900, 1636424808830, 930, 569, 361, 0, 0, 0
4492, 1, 1636424807917, 1636424808982, 1065, 704, 361, 0, 0, 0
4493, 1, 1636424808538, 1636424809166, 628, 270, 358, 0, 0, 0
4494, 1, 1636424808585, 1636424809210, 625, 267, 358, 1, 0, 1
4495, 1, 1636424808679, 1636424809302, 623, 265, 358, 0, 0, 0
4496, 1, 1636424809023, 1636424809646, 623, 269, 354, 0, 0, 0
4497, 1, 1636424809152, 1636424809778, 626, 271, 355, 0, 1, 1
4498, 1, 1636424809228, 1636424809854, 626, 270, 356, 0, 0, 0
4499, 1, 1636424809387, 1636424810018, 631, 274, 357, 0, 0, 0
4500, 1, 1636424809466, 1636424810090, 624, 267, 357, 0, 0, 0
4502, 1, 1636424809607, 1636424810298, 691, 335, 356, 0, 0, 0
4503, 1, 1636424809829, 1636424810450, 621, 266, 355, 0, 0, 0
4501, 1, 1636424809586, 1636424810538, 952, 598, 354, 0, 0, 0
4505, 1, 1636424809857, 1636424810754, 897, 538, 359, 0, 0, 0
4504, 1, 1636424809847, 1636424810890, 1043, 690, 353, 0, 0, 0
4507, 1, 1636424810592, 1636424811214, 622, 270, 352, 0, 2, 2
4506, 1, 1636424810591, 1636424811218, 627, 270, 357, 1, 1, 2
4508, 1, 1636424810628, 1636424811250, 622, 270, 352, 0, 0, 0
4509, 1, 1636424810951, 1636424811578, 627, 270, 357, 0, 0, 0
4510, 1, 1636424811195, 1636424811818, 623, 270, 353, 0, 0, 0
4511, 1, 1636424811277, 1636424811910, 633, 275, 358, 1, 1, 2
4512, 1, 1636424811282, 1636424811910, 628, 271, 357, 1, 1, 2
4513, 1, 1636424811502, 1636424812130, 628, 270, 358, 2, 1, 3
4515, 1, 1636424811613, 1636424812358, 745, 387, 358, 0, 0, 0
4516, 1, 1636424811742, 1636424812370, 628, 270, 358, 0, 0, 0
4514, 1, 1636424811600, 1636424812582, 982, 626, 356, 0, 0, 0
4518, 1, 1636424811903, 1636424812810, 907, 550, 357, 0, 0, 0
4517, 1, 1636424811837, 1636424812826, 989, 625, 364, 0, 0, 0
4519, 1, 1636424812538, 1636424813162, 624, 264, 360, 0, 0, 0
4520, 1, 1636424812663, 1636424813290, 627, 268, 359, 0, 0, 0
4521, 1, 1636424813005, 1636424813638, 633, 271, 362, 0, 2, 2
4522, 1, 1636424813160, 1636424813786, 626, 270, 356, 0, 0, 0
4524, 1, 1636424813230, 1636424813854, 624, 272, 352, 2, 1, 3
4523, 1, 1636424813229, 1636424813858, 629, 271, 358, 2, 1, 3
4525, 1, 1636424813501, 1636424814310, 809, 450, 359, 2, 0, 2
4528, 1, 1636424813895, 1636424814766, 871, 514, 357, 1, 1, 2
4529, 1, 1636424814472, 1636424815102, 630, 269, 361, 2, 0, 2
4531, 1, 1636424814896, 1636424815530, 634, 275, 359, 0, 1, 1
4532, 1, 1636424815111, 1636424815742, 631, 270, 361, 1, 0, 1
4533, 1, 1636424815219, 1636424815842, 623, 270, 353, 0, 0, 0
4535, 1, 1636424815418, 1636424816206, 788, 422, 366, 1, 0, 1
4536, 1, 1636424815882, 1636424816658, 776, 420, 356, 1, 1, 2
4537, 1, 1636424816529, 1636424817162, 633, 271, 362, 0, 0, 0
4538, 1, 1636424816779, 1636424817414, 635, 270, 365, 1, 0, 1
4539, 1, 1636424817167, 1636424817794, 627, 269, 358, 0, 0, 0
4540, 1, 1636424817289, 1636424817918, 629, 271, 358, 0, 1, 1
4541, 1, 1636424817531, 1636424818246, 715, 359, 356, 1, 0, 1
4542, 1, 1636424817915, 1636424818706, 791, 430, 361, 0, 0, 0
4543, 1, 1636424818573, 1636424819202, 629, 270, 359, 1, 0, 1
4544, 1, 1636424818835, 1636424819462, 627, 270, 357, 1, 0, 1
4545, 1, 1636424819237, 1636424819862, 625, 270, 355, 0, 0, 0
4546, 1, 1636424819330, 1636424819958, 628, 269, 359, 1, 0, 1
4547, 1, 1636424819626, 1636424820306, 680, 326, 354, 0, 1, 1
4548, 1, 1636424819968, 1636424820762, 794, 436, 358, 0, 0, 0
4549, 1, 1636424820657, 1636424821290, 633, 268, 365, 0, 0, 0
4550, 1, 1636424820905, 1636424821530, 625, 270, 355, 0, 1, 1
4551, 1, 1636424821209, 1636424821842, 633, 270, 363, 0, 0, 0
4552, 1, 1636424821278, 1636424821906, 628, 270, 358, 1, 0, 1
4553, 1, 1636424821745, 1636424822374, 629, 270, 359, 0, 0, 0
4554, 1, 1636424822084, 1636424822826, 742, 382, 360, 1, 0, 1
4555, 1, 1636424822550, 1636424823182, 632, 269, 363, 1, 0, 1
4556, 1, 1636424822946, 1636424823574, 628, 269, 359, 0, 0, 0
4526, 2, 1636424813502, 1636424823637, 10135, 1, 10134, 1, 0, 1
4527, 2, 1636424813511, 1636424823680, 10169, 0, 10169, 0, 0, 0
4557, 1, 1636424823156, 1636424823782, 626, 270, 356, 0, 0, 0
4558, 1, 1636424823638, 1636424824266, 628, 271, 357, 0, 1, 1
4559, 1, 1636424823770, 1636424824438, 668, 268, 400, 0, 0, 0
4561, 1, 1636424823962, 1636424824726, 764, 405, 359, 0, 0, 0
4530, 2, 1636424814663, 1636424824797, 10134, 1, 10133, 0, 0, 0
4560, 1, 1636424823774, 1636424824894, 1120, 722, 398, 0, 0, 0
4534, 2, 1636424815230, 1636424825365, 10135, 1, 10134, 1, 1, 2
4562, 1, 1636424824824, 1636424825450, 626, 271, 355, 1, 0, 1
4563, 1, 1636424824926, 1636424825634, 708, 307, 401, 0, 39, 39
4564, 1, 1636424825494, 1636424826170, 676, 270, 406, 0, 1, 1
4565, 1, 1636424825729, 1636424826362, 633, 270, 363, 0, 0, 0
4566, 1, 1636424825785, 1636424826814, 1029, 670, 359, 0, 0, 0
4567, 1, 1636424826921, 1636424827558, 637, 270, 367, 0, 0, 0
4568, 1, 1636424827572, 1636424828202, 630, 270, 360, 1, 0, 1
4569, 1, 1636424827682, 1636424828306, 624, 267, 357, 0, 0, 0
4570, 1, 1636424827785, 1636424828762, 977, 619, 358, 0, 1, 1
4571, 1, 1636424828873, 1636424829502, 629, 271, 358, 1, 0, 1
4572, 1, 1636424829524, 1636424830150, 626, 268, 358, 0, 0, 0
4573, 1, 1636424829706, 1636424830330, 624, 266, 358, 1, 0, 1
4574, 1, 1636424829861, 1636424830778, 917, 560, 357, 0, 1, 1
4575, 1, 1636424830950, 1636424831582, 632, 269, 363, 0, 0, 0
4576, 1, 1636424831549, 1636424832178, 629, 267, 362, 0, 1, 1
4577, 1, 1636424831669, 1636424832298, 629, 269, 360, 0, 0, 0
4578, 1, 1636424831826, 1636424832754, 928, 570, 358, 0, 1, 1
4579, 1, 1636424832818, 1636424833446, 628, 271, 357, 1, 0, 1
4580, 1, 1636424833418, 1636424834046, 628, 271, 357, 0, 1, 1
4581, 1, 1636424833677, 1636424834302, 625, 267, 358, 2, 0, 2
4582, 1, 1636424833894, 1636424834758, 864, 501, 363, 0, 0, 0
4583, 1, 1636424834943, 1636424835570, 627, 269, 358, 1, 0, 1
4584, 1, 1636424835543, 1636424836166, 623, 270, 353, 0, 0, 0
4585, 1, 1636424835573, 1636424836198, 625, 271, 354, 0, 0, 0
4586, 1, 1636424835877, 1636424836654, 777, 419, 358, 0, 2, 2
4587, 1, 1636424836840, 1636424837466, 626, 269, 357, 0, 0, 0
4588, 1, 1636424837439, 1636424838066, 627, 271, 356, 0, 1, 1
4589, 1, 1636424837648, 1636424838278, 630, 271, 359, 1, 1, 2
4590, 1, 1636424837981, 1636424838734, 753, 382, 371, 0, 0, 0
4591, 1, 1636424838914, 1636424839546, 632, 270, 362, 0, 0, 0
4592, 1, 1636424839514, 1636424840142, 628, 269, 359, 1, 0, 1
4593, 1, 1636424839756, 1636424840382, 626, 270, 356, 3, 0, 3
4594, 1, 1636424840004, 1636424840838, 834, 479, 355, 1, 1, 2
4595, 1, 1636424841022, 1636424841658, 636, 269, 367, 0, 0, 0
4596, 1, 1636424841589, 1636424842218, 629, 271, 358, 2, 0, 2
4597, 1, 1636424841716, 1636424842346, 630, 271, 359, 1, 1, 2
4598, 1, 1636424841933, 1636424842798, 865, 506, 359, 0, 0, 0
4599, 1, 1636424843014, 1636424843642, 628, 269, 359, 1, 0, 1
4600, 1, 1636424843582, 1636424844210, 628, 271, 357, 1, 0, 1
4601, 2, 1636425033946, 1636425044081, 10135, 1, 10134, 0, 0, 0
4602, 2, 1636425034659, 1636425044793, 10134, 0, 10134, 0, 0, 0
4617, 1, 1636425044210, 1636425044886, 676, 271, 405, 0, 1, 1
4603, 2, 1636425035262, 1636425045397, 10135, 0, 10135, 0, 0, 0
4619, 1, 1636425044922, 1636425045594, 672, 268, 404, 0, 0, 0
4604, 2, 1636425035810, 1636425045945, 10135, 0, 10135, 0, 0, 0
4621, 1, 1636425045526, 1636425046210, 684, 286, 398, 0, 16, 16
4605, 2, 1636425036367, 1636425046501, 10134, 0, 10134, 0, 0, 0
4623, 1, 1636425046074, 1636425046770, 696, 294, 402, 0, 24, 24
4606, 2, 1636425036919, 1636425047053, 10134, 0, 10134, 0, 0, 0
4624, 1, 1636425046634, 1636425047322, 688, 289, 399, 0, 23, 23
4607, 2, 1636425037497, 1636425047633, 10136, 0, 10136, 0, 0, 0
4625, 1, 1636425047182, 1636425047906, 724, 270, 454, 0, 0, 0
4608, 2, 1636425038089, 1636425048225, 10136, 1, 10135, 0, 1, 1
4626, 1, 1636425047766, 1636425048442, 676, 271, 405, 0, 2, 2
4627, 1, 1636425047970, 1636425048598, 628, 269, 359, 0, 1, 1
4609, 2, 1636425038667, 1636425048801, 10134, 0, 10134, 0, 0, 0
4628, 1, 1636425048354, 1636425049018, 664, 265, 399, 0, 0, 0
4610, 2, 1636425039229, 1636425049365, 10136, 0, 10136, 1, 0, 1
4629, 1, 1636425048802, 1636425049426, 624, 266, 358, 0, 0, 0
4630, 1, 1636425048930, 1636425049626, 696, 306, 390, 1, 36, 37
4631, 1, 1636425049288, 1636425049950, 662, 271, 391, 1, 0, 1
4632, 1, 1636425049494, 1636425050166, 672, 269, 403, 0, 0, 0
4633, 1, 1636425049723, 1636425050402, 679, 317, 362, 1, 0, 1
4611, 2, 1636425040805, 1636425050941, 10136, 1, 10135, 0, 1, 1
4634, 1, 1636425050420, 1636425051046, 626, 270, 356, 1, 0, 1
4612, 2, 1636425041282, 1636425051416, 10134, 1, 10133, 0, 1, 1
4635, 1, 1636425051070, 1636425051770, 700, 302, 398, 0, 35, 35
4636, 1, 1636425051126, 1636425051770, 644, 287, 357, 0, 19, 19
4637, 1, 1636425051546, 1636425052210, 664, 266, 398, 0, 0, 0
4613, 2, 1636425042124, 1636425052257, 10133, 0, 10133, 0, 0, 0
4638, 1, 1636425051638, 1636425052262, 624, 262, 362, 0, 0, 0
4614, 2, 1636425042363, 1636425052497, 10134, 0, 10134, 0, 0, 0
4639, 1, 1636425052116, 1636425052770, 654, 292, 362, 1, 23, 24
4641, 1, 1636425052390, 1636425053082, 692, 270, 422, 0, 0, 0
4615, 2, 1636425043151, 1636425053285, 10134, 0, 10134, 0, 0, 0
4643, 1, 1636425052719, 1636425053346, 627, 271, 356, 1, 1, 2
4642, 1, 1636425052626, 1636425053558, 932, 529, 403, 0, 19, 19
4616, 2, 1636425043515, 1636425053649, 10134, 0, 10134, 0, 0, 0
4646, 1, 1636425053367, 1636425054006, 639, 282, 357, 1, 15, 16
4647, 1, 1636425053414, 1636425054094, 680, 281, 399, 0, 19, 19
4648, 1, 1636425053778, 1636425054550, 772, 371, 401, 0, 1, 1
4618, 2, 1636425044532, 1636425054665, 10133, 1, 10132, 0, 0, 0
4620, 2, 1636425045129, 1636425055265, 10136, 0, 10136, 0, 0, 0
4651, 1, 1636425054719, 1636425055346, 627, 270, 357, 0, 0, 0
4652, 1, 1636425054794, 1636425055466, 672, 269, 403, 0, 1, 1
4654, 1, 1636425055356, 1636425055986, 630, 271, 359, 1, 0, 1
4622, 2, 1636425045837, 1636425055993, 10156, 0, 10156, 0, 0, 0
4655, 1, 1636425055390, 1636425056062, 672, 269, 403, 0, 0, 0
4657, 1, 1636425056118, 1636425056794, 676, 270, 406, 0, 0, 0
4658, 1, 1636425056174, 1636425056802, 628, 270, 358, 0, 0, 0
4660, 1, 1636425056531, 1636425057254, 723, 366, 357, 0, 0, 0
4662, 1, 1636425057176, 1636425057806, 630, 270, 360, 2, 0, 2
4663, 1, 1636425057517, 1636425058262, 745, 385, 360, 0, 0, 0
4665, 1, 1636425058665, 1636425059298, 633, 270, 363, 0, 0, 0
4667, 1, 1636425059264, 1636425059898, 634, 271, 363, 1, 0, 1
4669, 1, 1636425059879, 1636425060506, 627, 270, 357, 0, 0, 0
4640, 2, 1636425052158, 1636425062301, 10143, 1, 10142, 1, 0, 1
4644, 2, 1636425052993, 1636425063129, 10136, 0, 10136, 0, 0, 0
4645, 2, 1636425053331, 1636425063465, 10134, 1, 10133, 1, 0, 1
4649, 2, 1636425054009, 1636425064145, 10136, 0, 10136, 0, 0, 0
4650, 2, 1636425054609, 1636425064757, 10148, 0, 10148, 0, 0, 0
4653, 2, 1636425055317, 1636425065453, 10136, 1, 10135, 1, 0, 1
4656, 2, 1636425055828, 1636425065961, 10133, 1, 10132, 0, 1, 1
4659, 2, 1636425056177, 1636425066313, 10136, 1, 10135, 1, 0, 1
4661, 2, 1636425056907, 1636425067041, 10134, 1, 10133, 0, 1, 1
4664, 2, 1636425057558, 1636425067692, 10134, 1, 10133, 0, 0, 0
4666, 2, 1636425058907, 1636425069041, 10134, 0, 10134, 0, 0, 0
4668, 2, 1636425059641, 1636425069777, 10136, 0, 10136, 0, 1, 1
4670, 2, 1636425060362, 1636425070497, 10135, 0, 10135, 0, 0, 0
4671, 2, 1636425060553, 1636425070689, 10136, 0, 10136, 0, 0, 0
4672, 2, 1636425061375, 1636425071509, 10134, 0, 10134, 0, 0, 0
4673, 2, 1636425061678, 1636425071813, 10135, 0, 10135, 0, 0, 0
4674, 2, 1636425062430, 1636425072605, 10175, 0, 10175, 0, 0, 0
4675, 2, 1636425062865, 1636425073001, 10136, 1, 10135, 0, 1, 1
4693, 1, 1636425072734, 1636425073406, 672, 269, 403, 0, 0, 0
4676, 2, 1636425063258, 1636425073437, 10179, 0, 10179, 0, 0, 0
4677, 2, 1636425063465, 1636425073601, 10136, 0, 10136, 0, 0, 0
4678, 2, 1636425063594, 1636425073773, 10179, 0, 10179, 0, 1, 1
4679, 2, 1636425064067, 1636425074237, 10170, 1, 10169, 0, 0, 0
4695, 1, 1636425073602, 1636425074310, 708, 265, 443, 0, 0, 0
4680, 2, 1636425064274, 1636425074453, 10179, 0, 10179, 0, 0, 0
4697, 1, 1636425073902, 1636425074814, 912, 463, 449, 0, 0, 0
4681, 2, 1636425064890, 1636425075065, 10175, 1, 10174, 0, 0, 0
4699, 1, 1636425074578, 1636425075278, 700, 290, 410, 1, 0, 1
4682, 2, 1636425065582, 1636425075761, 10179, 0, 10179, 0, 1, 1
4700, 1, 1636425075190, 1636425075854, 664, 270, 394, 1, 0, 1
4683, 2, 1636425066090, 1636425076269, 10179, 0, 10179, 0, 0, 0
4701, 1, 1636425075890, 1636425076558, 668, 267, 401, 0, 0, 0
4684, 2, 1636425066442, 1636425076617, 10175, 0, 10175, 1, 0, 1
4702, 1, 1636425076398, 1636425077066, 668, 270, 398, 0, 0, 0
4703, 1, 1636425076724, 1636425077330, 606, 259, 347, 1, 0, 1
4685, 2, 1636425067170, 1636425077349, 10179, 0, 10179, 0, 0, 0
4704, 1, 1636425076746, 1636425077514, 768, 371, 397, 1, 0, 1
4686, 2, 1636425067822, 1636425077997, 10175, 0, 10175, 1, 0, 1
4706, 1, 1636425077525, 1636425078150, 625, 267, 358, 0, 0, 0
4705, 1, 1636425077478, 1636425078149, 671, 270, 401, 0, 0, 0
4708, 1, 1636425078135, 1636425078766, 631, 269, 362, 0, 0, 0
4707, 1, 1636425078122, 1636425078794, 672, 269, 403, 0, 0, 0
4709, 1, 1636425078567, 1636425079214, 647, 294, 353, 0, 0, 0
4687, 2, 1636425069170, 1636425079349, 10179, 1, 10178, 0, 0, 0
4710, 1, 1636425079236, 1636425079890, 654, 271, 383, 0, 1, 1
4688, 2, 1636425069906, 1636425080085, 10179, 0, 10179, 0, 0, 0
4711, 1, 1636425079478, 1636425080150, 672, 270, 402, 2, 0, 2
4712, 1, 1636425080085, 1636425080670, 585, 269, 316, 0, 0, 0
4689, 2, 1636425070630, 1636425080805, 10175, 0, 10175, 0, 0, 0
4713, 1, 1636425080214, 1636425080886, 672, 271, 401, 0, 0, 0
4690, 2, 1636425070822, 1636425080997, 10175, 1, 10174, 0, 0, 0
4714, 1, 1636425080551, 1636425081178, 627, 271, 356, 0, 1, 1
4717, 1, 1636425080934, 1636425081610, 676, 270, 406, 0, 0, 0
4691, 2, 1636425071642, 1636425081861, 10219, 1, 10218, 0, 1, 1
4718, 1, 1636425081122, 1636425082070, 948, 547, 401, 0, 0, 0
4692, 2, 1636425071942, 1636425082121, 10179, 0, 10179, 0, 0, 0
4721, 1, 1636425081990, 1636425082662, 672, 270, 402, 0, 0, 0
4723, 1, 1636425082250, 1636425083118, 868, 466, 402, 1, 0, 1
4694, 2, 1636425073130, 1636425083309, 10179, 1, 10178, 0, 1, 1
4696, 2, 1636425073726, 1636425083901, 10175, 0, 10175, 0, 0, 0
4727, 1, 1636425083438, 1636425084110, 672, 274, 398, 0, 0, 0
4698, 2, 1636425074366, 1636425084545, 10179, 0, 10179, 0, 0, 0
4730, 1, 1636425084030, 1636425084706, 676, 269, 407, 0, 0, 0
4733, 1, 1636425084674, 1636425085346, 672, 269, 403, 2, 0, 2
4715, 2, 1636425080690, 1636425090853, 10163, 0, 10163, 0, 0, 0
4716, 2, 1636425080922, 1636425091089, 10167, 0, 10167, 0, 0, 0
4719, 2, 1636425081491, 1636425091625, 10134, 0, 10134, 0, 0, 0
4720, 2, 1636425081633, 1636425091769, 10136, 0, 10136, 0, 0, 0
4742, 1, 1636425091274, 1636425091978, 704, 309, 395, 1, 43, 44
4741, 1, 1636425091270, 1636425091982, 712, 312, 400, 1, 43, 44
4722, 2, 1636425082133, 1636425092273, 10140, 0, 10140, 0, 0, 0
4724, 2, 1636425082277, 1636425092413, 10136, 0, 10136, 0, 0, 0
4743, 1, 1636425091769, 1636425092442, 673, 274, 399, 0, 0, 0
4744, 1, 1636425091894, 1636425092558, 664, 266, 398, 1, 0, 1
4725, 2, 1636425082551, 1636425092685, 10134, 1, 10133, 1, 1, 2
4745, 1, 1636425092414, 1636425093090, 676, 270, 406, 1, 0, 1
4746, 1, 1636425092542, 1636425093218, 676, 266, 410, 0, 0, 0
4726, 2, 1636425083219, 1636425093357, 10138, 1, 10137, 1, 1, 2
4747, 1, 1636425092814, 1636425093538, 724, 323, 401, 0, 1, 1
4728, 2, 1636425083630, 1636425093765, 10135, 0, 10135, 0, 0, 0
4729, 2, 1636425084010, 1636425094145, 10135, 0, 10135, 0, 0, 0
4748, 1, 1636425093486, 1636425094154, 668, 271, 397, 1, 2, 3
4749, 1, 1636425093890, 1636425094594, 704, 300, 404, 0, 35, 35
4731, 2, 1636425084546, 1636425094681, 10135, 0, 10135, 0, 0, 0
4732, 2, 1636425084629, 1636425094765, 10136, 1, 10135, 0, 0, 0
4750, 1, 1636425094274, 1636425094950, 676, 272, 404, 1, 3, 4
4734, 2, 1636425085088, 1636425095221, 10133, 0, 10133, 0, 0, 0
4735, 2, 1636425085202, 1636425095337, 10135, 1, 10134, 0, 0, 0
4751, 1, 1636425094854, 1636425095522, 668, 271, 397, 0, 0, 0
4752, 1, 1636425094890, 1636425095602, 712, 313, 399, 0, 42, 42
4754, 1, 1636425095109, 1636425095794, 685, 298, 387, 1, 31, 32
4753, 1, 1636425095103, 1636425095974, 871, 487, 384, 1, 0, 1
4755, 1, 1636425095350, 1636425096054, 704, 305, 399, 0, 0, 0
4757, 1, 1636425095472, 1636425096246, 774, 419, 355, 1, 0, 1
4736, 2, 1636425086144, 1636425096277, 10133, 1, 10132, 0, 0, 0
4758, 1, 1636425095549, 1636425096422, 873, 517, 356, 0, 1, 1
4756, 1, 1636425095462, 1636425096542, 1080, 686, 394, 1, 40, 41
4737, 2, 1636425086414, 1636425096549, 10135, 1, 10134, 0, 1, 1
4759, 1, 1636425096119, 1636425096742, 623, 270, 353, 0, 0, 0
4760, 1, 1636425096226, 1636425096902, 676, 310, 366, 0, 36, 36
4761, 1, 1636425096406, 1636425097086, 680, 266, 414, 0, 0, 0
4762, 1, 1636425096453, 1636425097190, 737, 374, 363, 0, 0, 0
4763, 1, 1636425096678, 1636425097542, 864, 466, 398, 1, 0, 1
4738, 2, 1636425087591, 1636425097725, 10134, 1, 10133, 1, 0, 1
4764, 1, 1636425097197, 1636425097826, 629, 269, 360, 0, 0, 0
4739, 2, 1636425088186, 1636425098321, 10135, 0, 10135, 0, 0, 0
4765, 1, 1636425097726, 1636425098346, 620, 269, 351, 1, 0, 1
4766, 1, 1636425097854, 1636425098526, 672, 271, 401, 1, 1, 2
4767, 1, 1636425097986, 1636425098610, 624, 267, 357, 1, 0, 1
4740, 1, 1636425088828, 1636425098810, 9982, 9630, 352, 0, 0, 0
4768, 1, 1636425098446, 1636425099114, 668, 270, 398, 0, 0, 0
4769, 1, 1636425098565, 1636425099190, 625, 269, 356, 0, 0, 0
4771, 1, 1636425098882, 1636425099506, 624, 265, 359, 0, 0, 0
4770, 1, 1636425098813, 1636425099561, 748, 354, 394, 0, 0, 0
4773, 1, 1636425098980, 1636425099598, 618, 267, 351, 0, 1, 1
4772, 1, 1636425098889, 1636425099646, 757, 397, 360, 0, 0, 0
4776, 1, 1636425099261, 1636425099958, 697, 334, 363, 0, 0, 0
4777, 1, 1636425099335, 1636425100098, 763, 406, 357, 1, 0, 1
4778, 1, 1636425099912, 1636425100550, 638, 277, 361, 1, 0, 1
4779, 1, 1636425100023, 1636425100650, 627, 269, 358, 1, 0, 1
4780, 1, 1636425100242, 1636425101106, 864, 505, 359, 0, 0, 0
4783, 1, 1636425101108, 1636425101726, 618, 271, 347, 1, 0, 1
4784, 1, 1636425101505, 1636425102122, 617, 262, 355, 1, 0, 1
4786, 1, 1636425101889, 1636425102522, 633, 274, 359, 0, 0, 0
4788, 1, 1636425102468, 1636425103090, 622, 263, 359, 0, 0, 0
4789, 1, 1636425102556, 1636425103182, 626, 266, 360, 0, 0, 0
4791, 1, 1636425102681, 1636425103542, 861, 502, 359, 0, 0, 0
4792, 1, 1636425103120, 1636425103750, 630, 273, 357, 0, 0, 0
4794, 1, 1636425103212, 1636425103842, 630, 270, 360, 0, 0, 0
4793, 1, 1636425103159, 1636425104002, 843, 481, 362, 0, 0, 0
4795, 1, 1636425103697, 1636425104318, 621, 269, 352, 0, 0, 0
4796, 1, 1636425103823, 1636425104450, 627, 271, 356, 0, 0, 0
4797, 1, 1636425104104, 1636425104770, 666, 307, 359, 0, 0, 0
4798, 1, 1636425105078, 1636425105706, 628, 268, 360, 0, 0, 0
4799, 1, 1636425105242, 1636425105870, 628, 269, 359, 1, 1, 2
4800, 1, 1636425105726, 1636425106354, 628, 270, 358, 0, 2, 2
4801, 1, 1636425106142, 1636425106810, 668, 307, 361, 0, 0, 0
4803, 1, 1636425106544, 1636425107266, 722, 358, 364, 0, 1, 1
4804, 1, 1636425106976, 1636425107722, 746, 391, 355, 1, 0, 1
4806, 1, 1636425107220, 1636425107850, 630, 269, 361, 0, 1, 1
4807, 1, 1636425107497, 1636425108174, 677, 317, 360, 2, 0, 2
4774, 2, 1636425099145, 1636425109281, 10136, 0, 10136, 0, 0, 0
4775, 2, 1636425099181, 1636425109329, 10148, 0, 10148, 0, 0, 0
4810, 1, 1636425108916, 1636425109598, 682, 275, 407, 3, 4, 7
4812, 1, 1636425109686, 1636425110350, 664, 266, 398, 0, 0, 0
4781, 2, 1636425100247, 1636425110381, 10134, 0, 10134, 0, 0, 0
4782, 2, 1636425100369, 1636425110505, 10136, 0, 10136, 0, 0, 0
4814, 1, 1636425109687, 1636425110870, 1183, 782, 401, 1, 63, 64
4818, 1, 1636425110634, 1636425111322, 688, 291, 397, 1, 1, 2
4785, 2, 1636425101535, 1636425111669, 10134, 0, 10134, 0, 0, 0
4817, 1, 1636425110510, 1636425111774, 1264, 861, 403, 1, 0, 1
4820, 1, 1636425111238, 1636425111866, 628, 269, 359, 0, 0, 0
4787, 2, 1636425102102, 1636425112237, 10135, 0, 10135, 0, 0, 0
4822, 1, 1636425111798, 1636425112506, 708, 304, 404, 0, 35, 35
4790, 2, 1636425102644, 1636425112777, 10133, 0, 10133, 0, 0, 0
4823, 1, 1636425112362, 1636425113050, 688, 283, 405, 1, 12, 13
4825, 1, 1636425112906, 1636425113578, 672, 268, 404, 0, 0, 0
4826, 1, 1636425113478, 1636425114114, 636, 273, 363, 1, 1, 2
4827, 1, 1636425113494, 1636425114566, 1072, 710, 362, 0, 2, 2
4828, 1, 1636425114405, 1636425115038, 633, 271, 362, 0, 1, 1
4829, 1, 1636425114426, 1636425115494, 1068, 706, 362, 3, 0, 3
4831, 1, 1636425115455, 1636425116082, 627, 270, 357, 0, 0, 0
4802, 2, 1636425106516, 1636425116649, 10133, 1, 10132, 0, 1, 1
4832, 1, 1636425116250, 1636425116918, 668, 310, 358, 0, 40, 40
4805, 2, 1636425107030, 1636425117165, 10135, 0, 10135, 1, 0, 1
4833, 1, 1636425116677, 1636425117370, 693, 332, 361, 0, 0, 0
4834, 1, 1636425116778, 1636425117442, 664, 269, 395, 2, 0, 2
4808, 2, 1636425107656, 1636425117793, 10137, 1, 10136, 1, 0, 1
4809, 2, 1636425107810, 1636425117945, 10135, 0, 10135, 0, 0, 0
4835, 1, 1636425117294, 1636425117966, 672, 270, 402, 0, 1, 1
4836, 1, 1636425117408, 1636425118066, 658, 298, 360, 1, 27, 28
4837, 1, 1636425117469, 1636425118510, 1041, 683, 358, 1, 0, 1
4838, 1, 1636425117945, 1636425118618, 673, 269, 404, 0, 0, 0
4840, 1, 1636425118335, 1636425118962, 627, 271, 356, 0, 1, 1
4839, 1, 1636425118074, 1636425119074, 1000, 598, 402, 1, 0, 1
4811, 2, 1636425109037, 1636425119173, 10136, 0, 10136, 0, 0, 0
4841, 1, 1636425118358, 1636425119438, 1080, 723, 357, 0, 24, 24
4813, 2, 1636425109686, 1636425119821, 10135, 1, 10134, 0, 1, 1
4842, 1, 1636425119306, 1636425119970, 664, 265, 399, 1, 0, 1
4815, 2, 1636425109848, 1636425119981, 10133, 0, 10133, 0, 0, 0
4843, 1, 1636425119424, 1636425120086, 662, 309, 353, 1, 39, 40
4816, 2, 1636425110382, 1636425120553, 10171, 0, 10171, 0, 0, 0
4844, 1, 1636425119982, 1636425120618, 636, 274, 362, 0, 0, 0
4845, 1, 1636425119982, 1636425120654, 672, 270, 402, 0, 0, 0
4819, 2, 1636425110677, 1636425120813, 10136, 0, 10136, 0, 0, 0
4846, 1, 1636425120110, 1636425121110, 1000, 594, 406, 0, 0, 0
4847, 1, 1636425120654, 1636425121286, 632, 271, 361, 0, 0, 0
4821, 2, 1636425111306, 1636425121441, 10135, 1, 10134, 1, 1, 2
4848, 1, 1636425120678, 1636425121566, 888, 478, 410, 0, 0, 0
4850, 1, 1636425120969, 1636425121602, 633, 269, 364, 0, 0, 0
4851, 1, 1636425121223, 1636425121890, 667, 312, 355, 0, 39, 39
4849, 1, 1636425120942, 1636425122018, 1076, 678, 398, 0, 1, 1
4853, 1, 1636425121509, 1636425122134, 625, 270, 355, 0, 0, 0
4852, 1, 1636425121290, 1636425122346, 1056, 695, 361, 0, 0, 0
4854, 1, 1636425121574, 1636425122474, 900, 502, 398, 1, 0, 1
4855, 1, 1636425122087, 1636425122726, 639, 276, 363, 0, 0, 0
4856, 1, 1636425122160, 1636425122802, 642, 283, 359, 0, 1, 1
4824, 2, 1636425112778, 1636425122913, 10135, 0, 10135, 1, 0, 1
4857, 1, 1636425122254, 1636425123178, 924, 572, 352, 0, 5, 5
4858, 1, 1636425122352, 1636425123270, 918, 566, 352, 0, 24, 24
4830, 1, 1636425115267, 1636425123402, 8135, 7779, 356, 1, 0, 1
4859, 1, 1636425123042, 1636425123718, 676, 268, 408, 0, 0, 0
4860, 1, 1636425123142, 1636425123770, 628, 270, 358, 0, 0, 0
4862, 1, 1636425123522, 1636425124150, 628, 270, 358, 2, 0, 2
4861, 1, 1636425123403, 1636425124174, 771, 369, 402, 0, 0, 0
4863, 1, 1636425123776, 1636425124402, 626, 267, 359, 0, 1, 1
4864, 1, 1636425124116, 1636425124742, 626, 267, 359, 1, 0, 1
4865, 1, 1636425124290, 1636425125194, 904, 547, 357, 0, 1, 1
4866, 1, 1636425124568, 1636425125198, 630, 270, 360, 0, 0, 0
4869, 1, 1636425125219, 1636425125846, 627, 270, 357, 0, 0, 0
4870, 1, 1636425125402, 1636425126022, 620, 266, 354, 1, 0, 1
4872, 1, 1636425125634, 1636425126306, 672, 310, 362, 1, 0, 1
4871, 1, 1636425125463, 1636425126458, 995, 642, 353, 0, 0, 0
4874, 1, 1636425126156, 1636425126782, 626, 266, 360, 0, 0, 0
4875, 1, 1636425126264, 1636425126906, 642, 286, 356, 0, 0, 0
4877, 1, 1636425126517, 1636425127230, 713, 354, 359, 0, 0, 0
4876, 1, 1636425126468, 1636425127354, 886, 526, 360, 0, 0, 0
4879, 1, 1636425127304, 1636425127930, 626, 269, 357, 0, 0, 0
4881, 1, 1636425127646, 1636425128274, 628, 270, 358, 0, 0, 0
4882, 1, 1636425127938, 1636425128566, 628, 270, 358, 0, 0, 0
4883, 1, 1636425128240, 1636425128866, 626, 271, 355, 0, 2, 2
4885, 1, 1636425128658, 1636425129286, 628, 270, 358, 0, 1, 1
4884, 1, 1636425128335, 1636425129318, 983, 625, 358, 1, 0, 1
4886, 1, 1636425129282, 1636425129914, 632, 271, 361, 1, 1, 2
4889, 1, 1636425129883, 1636425130510, 627, 268, 359, 0, 0, 0
4890, 1, 1636425130220, 1636425130970, 750, 389, 361, 0, 0, 0
4892, 1, 1636425130558, 1636425131430, 872, 510, 362, 0, 1, 1
4895, 1, 1636425131710, 1636425132338, 628, 271, 357, 0, 2, 2
4897, 1, 1636425132303, 1636425132934, 631, 269, 362, 0, 1, 1
4898, 1, 1636425132425, 1636425133386, 961, 603, 358, 1, 1, 2
4900, 1, 1636425133270, 1636425133898, 628, 269, 359, 1, 0, 1
4901, 1, 1636425133823, 1636425134450, 627, 270, 357, 0, 0, 0
4902, 1, 1636425134184, 1636425134903, 719, 362, 357, 0, 0, 0
4867, 2, 1636425124861, 1636425134997, 10136, 0, 10136, 1, 0, 1
4868, 2, 1636425124904, 1636425135045, 10141, 0, 10141, 0, 0, 0
4903, 1, 1636425134522, 1636425135406, 884, 522, 362, 0, 52, 52
4873, 2, 1636425125686, 1636425135821, 10135, 0, 10135, 0, 0, 0
4904, 1, 1636425135286, 1636425135954, 668, 268, 400, 0, 0, 0
4906, 1, 1636425135697, 1636425136350, 653, 262, 391, 1, 0, 1
4905, 1, 1636425135287, 1636425136398, 1111, 714, 397, 1, 0, 1
4907, 1, 1636425135950, 1636425136850, 900, 501, 399, 1, 0, 1
4908, 1, 1636425136291, 1636425136914, 623, 271, 352, 1, 1, 2
4878, 2, 1636425127104, 1636425137237, 10133, 1, 10132, 0, 1, 1
4909, 1, 1636425136362, 1636425137362, 1000, 643, 357, 0, 0, 0
4910, 1, 1636425136939, 1636425137598, 659, 301, 358, 0, 32, 32
4880, 2, 1636425127607, 1636425137741, 10134, 0, 10134, 0, 0, 0
4911, 1, 1636425137366, 1636425138042, 676, 270, 406, 1, 0, 1
4912, 1, 1636425137492, 1636425138118, 626, 264, 362, 0, 0, 0
4913, 1, 1636425137874, 1636425138542, 668, 270, 398, 0, 0, 0
4914, 1, 1636425138018, 1636425138646, 628, 269, 359, 0, 0, 0
4915, 1, 1636425138232, 1636425139102, 870, 514, 356, 1, 0, 1
4916, 1, 1636425138940, 1636425139570, 630, 270, 360, 0, 0, 0
4887, 2, 1636425129600, 1636425139733, 10133, 1, 10132, 1, 0, 1
4888, 2, 1636425129646, 1636425139780, 10134, 0, 10134, 0, 0, 0
4917, 1, 1636425139137, 1636425140050, 913, 553, 360, 1, 31, 32
4918, 1, 1636425139405, 1636425140050, 645, 284, 361, 0, 20, 20
4919, 1, 1636425139866, 1636425140534, 668, 266, 402, 0, 0, 0
4920, 1, 1636425139903, 1636425140534, 631, 274, 357, 0, 0, 0
4891, 2, 1636425130403, 1636425140537, 10134, 1, 10133, 0, 0, 0
4922, 1, 1636425139960, 1636425140578, 618, 266, 352, 1, 0, 1
4893, 2, 1636425130772, 1636425140905, 10133, 1, 10132, 0, 1, 1
4921, 1, 1636425139910, 1636425140982, 1072, 678, 394, 0, 4, 4
4923, 1, 1636425140170, 1636425141026, 856, 504, 352, 0, 1, 1
4924, 1, 1636425140666, 1636425141434, 768, 366, 402, 1, 1, 2
4894, 2, 1636425131503, 1636425141637, 10134, 1, 10133, 1, 1, 2
4926, 1, 1636425141049, 1636425141678, 629, 270, 359, 2, 0, 2
4927, 1, 1636425141068, 1636425141698, 630, 268, 362, 0, 0, 0
4925, 1, 1636425141034, 1636425141898, 864, 474, 390, 1, 16, 17
4928, 1, 1636425141638, 1636425142262, 624, 266, 358, 0, 0, 0
4896, 2, 1636425132136, 1636425142269, 10133, 0, 10133, 0, 0, 0
4929, 1, 1636425141766, 1636425142426, 660, 266, 394, 1, 0, 1
4930, 1, 1636425141936, 1636425142562, 626, 270, 356, 0, 0, 0
4899, 1, 1636425132857, 1636425142762, 9905, 9547, 358, 1, 0, 1
4931, 1, 1636425142138, 1636425142806, 668, 266, 402, 1, 0, 1
4933, 1, 1636425142398, 1636425143066, 668, 270, 398, 0, 0, 0
4932, 1, 1636425142270, 1636425143258, 988, 626, 362, 1, 0, 1
4934, 1, 1636425142764, 1636425143518, 754, 352, 402, 0, 0, 0
4935, 1, 1636425143109, 1636425143738, 629, 270, 359, 0, 1, 1
4937, 1, 1636425143519, 1636425144138, 619, 266, 353, 0, 0, 0
4936, 1, 1636425143249, 1636425144186, 937, 578, 359, 0, 0, 0
4939, 1, 1636425143666, 1636425144290, 624, 265, 359, 0, 0, 0
4938, 1, 1636425143605, 1636425144582, 977, 626, 351, 1, 0, 1
4940, 1, 1636425144071, 1636425144698, 627, 270, 357, 0, 1, 1
4941, 1, 1636425144273, 1636425144902, 629, 269, 360, 0, 0, 0
4943, 1, 1636425144508, 1636425145134, 626, 270, 356, 1, 0, 1
4942, 1, 1636425144422, 1636425145358, 936, 579, 357, 0, 1, 1
4944, 1, 1636425144964, 1636425145586, 622, 266, 356, 0, 0, 0
4945, 1, 1636425144989, 1636425145618, 629, 268, 361, 0, 0, 0
4946, 1, 1636425145236, 1636425145866, 630, 271, 359, 0, 1, 1
4947, 1, 1636425145327, 1636425146082, 755, 389, 366, 0, 0, 0
4948, 1, 1636425145697, 1636425146326, 629, 270, 359, 1, 1, 2
4949, 1, 1636425145993, 1636425146630, 637, 273, 364, 1, 1, 2
4952, 1, 1636425146128, 1636425146754, 626, 271, 355, 0, 0, 0
4951, 1, 1636425146049, 1636425146778, 729, 370, 359, 1, 0, 1
4950, 1, 1636425146045, 1636425147078, 1033, 674, 359, 1, 0, 1
4953, 1, 1636425146608, 1636425147234, 626, 271, 355, 1, 0, 1
4954, 1, 1636425146870, 1636425147498, 628, 271, 357, 1, 0, 1
4955, 1, 1636425146975, 1636425147954, 979, 618, 361, 0, 1, 1
4956, 1, 1636425147502, 1636425148126, 624, 267, 357, 0, 1, 1
4957, 1, 1636425147624, 1636425148254, 630, 270, 360, 0, 1, 1
4958, 1, 1636425147738, 1636425148410, 672, 310, 362, 0, 0, 0
4959, 1, 1636425147769, 1636425148710, 941, 583, 358, 0, 1, 1
4960, 1, 1636425148213, 1636425148846, 633, 270, 363, 2, 0, 2
4962, 1, 1636425148613, 1636425149242, 629, 271, 358, 0, 1, 1
4961, 1, 1636425148349, 1636425149302, 953, 586, 367, 1, 0, 1
4963, 1, 1636425148816, 1636425149454, 638, 274, 364, 0, 1, 1
4964, 1, 1636425148998, 1636425149626, 628, 266, 362, 1, 0, 1
4965, 1, 1636425149068, 1636425149694, 626, 271, 355, 0, 0, 0
4966, 1, 1636425149322, 1636425149950, 628, 271, 357, 3, 0, 3
4967, 1, 1636425149808, 1636425150434, 626, 269, 357, 2, 0, 2
4969, 1, 1636425149865, 1636425150494, 629, 271, 358, 2, 1, 3
4970, 1, 1636425150099, 1636425150734, 635, 273, 362, 0, 0, 0
4968, 1, 1636425149821, 1636425150886, 1065, 700, 365, 0, 0, 0
4971, 1, 1636425150363, 1636425150990, 627, 270, 357, 0, 0, 0
4972, 1, 1636425150713, 1636425151442, 729, 370, 359, 2, 0, 2
4973, 1, 1636425150999, 1636425151630, 631, 269, 362, 0, 0, 0
4975, 1, 1636425151386, 1636425152010, 624, 263, 361, 1, 0, 1
4974, 1, 1636425151035, 1636425152074, 1039, 686, 353, 0, 0, 0
4976, 1, 1636425151485, 1636425152102, 617, 262, 355, 1, 0, 1
4977, 1, 1636425151508, 1636425152458, 950, 599, 351, 1, 0, 1
4978, 1, 1636425151926, 1636425152550, 624, 265, 359, 0, 0, 0
4979, 1, 1636425152041, 1636425152662, 621, 266, 355, 2, 0, 2
4981, 1, 1636425152375, 1636425152998, 623, 266, 357, 1, 0, 1
4980, 1, 1636425152225, 1636425153118, 893, 531, 362, 1, 0, 1
4982, 1, 1636425152735, 1636425153450, 715, 358, 357, 0, 0, 0
4983, 1, 1636425152902, 1636425153526, 624, 267, 357, 1, 0, 1
4984, 1, 1636425153164, 1636425153790, 626, 269, 357, 1, 0, 1
4985, 1, 1636425153542, 1636425154166, 624, 269, 355, 1, 0, 1
4986, 1, 1636425153627, 1636425154250, 623, 268, 355, 0, 0, 0
4987, 1, 1636425154008, 1636425154634, 626, 265, 361, 1, 0, 1
4989, 1, 1636425154028, 1636425154698, 670, 318, 352, 1, 0, 1
4990, 1, 1636425154373, 1636425154994, 621, 266, 355, 0, 0, 0
4988, 1, 1636425154027, 1636425155090, 1063, 702, 361, 1, 1, 2
4991, 1, 1636425154440, 1636425155150, 710, 357, 353, 0, 1, 1
4992, 1, 1636425154863, 1636425155490, 627, 269, 358, 0, 0, 0
4993, 1, 1636425154929, 1636425155946, 1017, 657, 360, 1, 0, 1
4994, 1, 1636425155551, 1636425156178, 627, 273, 354, 0, 0, 0
4995, 1, 1636425155629, 1636425156398, 769, 414, 355, 1, 0, 1
4997, 1, 1636425155771, 1636425156398, 627, 269, 358, 0, 0, 0
4996, 1, 1636425155713, 1636425156630, 917, 558, 359, 0, 0, 0
4998, 1, 1636425156248, 1636425156874, 626, 270, 356, 0, 0, 0
5000, 1, 1636425156540, 1636425157166, 626, 270, 356, 0, 1, 1
4999, 1, 1636425156261, 1636425157330, 1069, 711, 358, 0, 0, 0
5002, 1, 1636425156866, 1636425157494, 628, 270, 358, 1, 0, 1
5001, 1, 1636425156772, 1636425157622, 850, 494, 356, 0, 0, 0
5003, 1, 1636425157022, 1636425157662, 640, 270, 370, 0, 0, 0
5004, 1, 1636425157661, 1636425158294, 633, 269, 364, 0, 0, 0
5005, 1, 1636425157793, 1636425158422, 629, 271, 358, 0, 1, 1
5006, 1, 1636425158128, 1636425158750, 622, 267, 355, 1, 1, 2
5008, 1, 1636425158218, 1636425158874, 656, 299, 357, 0, 1, 1
5010, 1, 1636425158492, 1636425159122, 630, 273, 357, 0, 0, 0
5007, 1, 1636425158160, 1636425159206, 1046, 686, 360, 1, 0, 1
5009, 1, 1636425158478, 1636425159334, 856, 499, 357, 0, 0, 0
5011, 1, 1636425158791, 1636425159418, 627, 268, 359, 0, 0, 0
5012, 1, 1636425158824, 1636425159874, 1050, 689, 361, 1, 0, 1
5013, 1, 1636425159252, 1636425159874, 622, 270, 352, 0, 0, 0
5014, 1, 1636425159527, 1636425160322, 795, 441, 354, 0, 0, 0
5015, 1, 1636425159604, 1636425160322, 718, 367, 351, 1, 0, 1
5016, 1, 1636425159892, 1636425160526, 634, 271, 363, 1, 1, 2
5017, 1, 1636425160242, 1636425160870, 628, 270, 358, 0, 0, 0
5018, 1, 1636425160368, 1636425160998, 630, 270, 360, 0, 0, 0
5020, 1, 1636425160595, 1636425161310, 715, 366, 349, 0, 1, 1
5021, 1, 1636425160779, 1636425161398, 619, 266, 353, 1, 0, 1
5019, 1, 1636425160395, 1636425161446, 1051, 689, 362, 1, 0, 1
5022, 1, 1636425160827, 1636425161458, 631, 274, 357, 0, 0, 0
5023, 1, 1636425161656, 1636425162282, 626, 271, 355, 0, 0, 0
5024, 1, 1636425161662, 1636425162290, 628, 270, 358, 0, 0, 0
5025, 1, 1636425161991, 1636425162734, 743, 385, 358, 0, 0, 0
5027, 1, 1636425162173, 1636425162802, 629, 270, 359, 0, 0, 0
5029, 1, 1636425162503, 1636425163130, 627, 271, 356, 1, 1, 2
5026, 1, 1636425162117, 1636425163190, 1073, 714, 359, 0, 1, 1
5028, 1, 1636425162300, 1636425163254, 954, 598, 356, 0, 1, 1
5030, 1, 1636425162980, 1636425163606, 626, 269, 357, 1, 0, 1
5032, 1, 1636425163214, 1636425163842, 628, 270, 358, 0, 0, 0
5031, 1, 1636425163116, 1636425164062, 946, 588, 358, 0, 0, 0
5033, 1, 1636425163300, 1636425164302, 1002, 642, 360, 0, 1, 1
5034, 1, 1636425163707, 1636425164514, 807, 454, 353, 0, 1, 1
5035, 1, 1636425163893, 1636425164526, 633, 271, 362, 1, 0, 1
5037, 1, 1636425164203, 1636425164830, 627, 270, 357, 1, 0, 1
5036, 1, 1636425164143, 1636425164982, 839, 478, 361, 1, 0, 1
5038, 1, 1636425164290, 1636425165286, 996, 638, 358, 0, 0, 0
5040, 1, 1636425164741, 1636425165370, 629, 270, 359, 2, 1, 3
5039, 1, 1636425164367, 1636425165430, 1063, 705, 358, 0, 0, 0
5041, 1, 1636425165151, 1636425165778, 627, 264, 363, 0, 0, 0
5042, 1, 1636425165616, 1636425166238, 622, 270, 352, 0, 0, 0
5043, 1, 1636425165623, 1636425166250, 627, 270, 357, 0, 0, 0
5046, 1, 1636425166069, 1636425166698, 629, 270, 359, 0, 1, 1
5047, 1, 1636425166293, 1636425167162, 869, 503, 366, 1, 1, 2
5048, 1, 1636425166794, 1636425167422, 628, 270, 358, 0, 1, 1
5049, 1, 1636425167055, 1636425167682, 627, 269, 358, 1, 1, 2
5051, 1, 1636425167502, 1636425168134, 632, 271, 361, 0, 0, 0
5050, 1, 1636425167394, 1636425168142, 748, 386, 362, 0, 0, 0
5052, 1, 1636425167539, 1636425168586, 1047, 690, 357, 0, 0, 0
5054, 1, 1636425167862, 1636425168594, 732, 374, 358, 1, 0, 1
5057, 1, 1636425168471, 1636425169102, 631, 272, 359, 1, 1, 2
5058, 1, 1636425168528, 1636425169558, 1030, 673, 357, 1, 3, 4
5059, 1, 1636425169002, 1636425169630, 628, 270, 358, 0, 1, 1
5060, 1, 1636425169226, 1636425169854, 628, 266, 362, 2, 0, 2
5061, 1, 1636425169805, 1636425170438, 633, 269, 364, 0, 1, 1
5062, 1, 1636425169942, 1636425170566, 624, 265, 359, 1, 0, 1
5063, 1, 1636425170392, 1636425171026, 634, 275, 359, 0, 1, 1
5065, 1, 1636425170807, 1636425171422, 615, 261, 354, 0, 0, 0
5064, 1, 1636425170521, 1636425171466, 945, 591, 354, 0, 2, 2
5066, 1, 1636425171141, 1636425171770, 629, 271, 358, 2, 0, 2
5067, 1, 1636425171250, 1636425171882, 632, 269, 363, 0, 0, 0
5068, 1, 1636425171674, 1636425172338, 664, 302, 362, 1, 0, 1
5069, 1, 1636425171771, 1636425172394, 623, 269, 354, 0, 0, 0
5070, 1, 1636425171788, 1636425172854, 1066, 710, 356, 0, 1, 1
5071, 1, 1636425172757, 1636425173382, 625, 269, 356, 0, 0, 0
5073, 1, 1636425172977, 1636425173606, 629, 271, 358, 1, 0, 1
5072, 1, 1636425172822, 1636425173834, 1012, 655, 357, 0, 1, 1
5074, 1, 1636425173248, 1636425173874, 626, 268, 358, 0, 0, 0
5075, 1, 1636425174016, 1636425174638, 622, 271, 351, 0, 0, 0
5076, 1, 1636425174053, 1636425174674, 621, 269, 352, 1, 0, 1
5077, 1, 1636425174623, 1636425175250, 627, 269, 358, 1, 1, 2
5078, 1, 1636425174679, 1636425175302, 623, 270, 353, 0, 0, 0
5080, 1, 1636425175076, 1636425175698, 622, 268, 354, 0, 0, 0
5079, 1, 1636425174799, 1636425175746, 947, 592, 355, 0, 0, 0
5081, 1, 1636425175178, 1636425175790, 612, 258, 354, 0, 0, 0
5044, 2, 1636425165844, 1636425175977, 10133, 0, 10133, 0, 0, 0
5045, 2, 1636425165932, 1636425176068, 10136, 0, 10136, 0, 0, 0
5082, 1, 1636425175346, 1636425176154, 808, 450, 358, 0, 0, 0
5089, 1, 1636425176658, 1636425177290, 632, 269, 363, 0, 0, 0
5090, 1, 1636425177030, 1636425177658, 628, 270, 358, 0, 2, 2
5053, 2, 1636425167808, 1636425177941, 10133, 1, 10132, 0, 0, 0
5055, 2, 1636425167869, 1636425178005, 10136, 1, 10135, 0, 0, 0
5092, 1, 1636425177834, 1636425178482, 648, 271, 377, 0, 0, 0
5056, 1, 1636425168144, 1636425178498, 10354, 9998, 356, 0, 0, 0
5101, 1, 1636425179273, 1636425179906, 633, 270, 363, 1, 1, 2
5103, 1, 1636425181208, 1636425181834, 626, 272, 354, 1, 2, 3
5104, 1, 1636425182045, 1636425182674, 629, 270, 359, 1, 0, 1
5083, 2, 1636425175503, 1636425185637, 10134, 0, 10134, 0, 0, 0
5084, 2, 1636425175523, 1636425185685, 10162, 0, 10162, 0, 0, 0
5106, 1, 1636425185485, 1636425186134, 649, 294, 355, 1, 24, 25
5086, 2, 1636425176343, 1636425186520, 10177, 1, 10176, 1, 0, 1
5107, 1, 1636425185878, 1636425186546, 668, 267, 401, 0, 0, 0
5085, 2, 1636425176342, 1636425186565, 10223, 0, 10223, 0, 0, 0
5087, 2, 1636425176508, 1636425186641, 10133, 0, 10133, 1, 0, 1
5088, 2, 1636425176599, 1636425186733, 10134, 0, 10134, 0, 1, 1
5109, 1, 1636425186115, 1636425186838, 723, 361, 362, 0, 93, 93
5108, 1, 1636425185882, 1636425187018, 1136, 738, 398, 0, 25, 25
5110, 1, 1636425186654, 1636425187330, 676, 270, 406, 1, 0, 1
5112, 1, 1636425186770, 1636425187466, 696, 301, 395, 1, 0, 1
5111, 1, 1636425186659, 1636425187790, 1131, 723, 408, 0, 1, 1
5091, 2, 1636425177768, 1636425187901, 10133, 0, 10133, 0, 0, 0
5113, 1, 1636425186862, 1636425187918, 1056, 655, 401, 0, 1, 1
5093, 2, 1636425178094, 1636425188265, 10171, 0, 10171, 1, 0, 1
5094, 2, 1636425178138, 1636425188317, 10179, 0, 10179, 0, 0, 0
5095, 2, 1636425178430, 1636425188565, 10135, 0, 10135, 0, 0, 0
5096, 2, 1636425178445, 1636425188608, 10163, 0, 10163, 0, 0, 0
5097, 2, 1636425178511, 1636425188689, 10178, 0, 10178, 0, 1, 1
5114, 1, 1636425188030, 1636425188718, 688, 282, 406, 1, 15, 16
5099, 2, 1636425178900, 1636425189033, 10133, 1, 10132, 1, 0, 1
5098, 1, 1636425178625, 1636425189062, 10437, 10074, 363, 0, 4, 4
5115, 1, 1636425188402, 1636425189150, 748, 271, 477, 2, 0, 2
5100, 2, 1636425179123, 1636425189257, 10134, 0, 10134, 1, 0, 1
5117, 1, 1636425188694, 1636425189390, 696, 303, 393, 0, 32, 32
5122, 1, 1636425189168, 1636425189802, 634, 268, 366, 0, 0, 0
5120, 1, 1636425189064, 1636425189834, 770, 369, 401, 0, 0, 0
5124, 1, 1636425189630, 1636425190258, 628, 267, 361, 0, 1, 1
5126, 1, 1636425190035, 1636425190662, 627, 267, 360, 1, 0, 1
5125, 1, 1636425189663, 1636425190702, 1039, 688, 351, 0, 0, 0
5102, 2, 1636425180596, 1636425190728, 10132, 0, 10132, 0, 0, 0
5127, 1, 1636425190548, 1636425191174, 626, 272, 354, 0, 7, 7
5105, 1, 1636425183418, 1636425191218, 7800, 7443, 357, 0, 2, 2
5128, 1, 1636425190650, 1636425191314, 664, 270, 394, 0, 0, 0
5129, 1, 1636425190729, 1636425191618, 889, 530, 359, 0, 0, 0
5131, 1, 1636425190883, 1636425191762, 879, 522, 357, 1, 0, 1
5133, 1, 1636425191807, 1636425192434, 627, 270, 357, 1, 1, 2
5134, 1, 1636425192430, 1636425193050, 620, 262, 358, 1, 0, 1
5135, 1, 1636425192474, 1636425193094, 620, 261, 359, 0, 0, 0
5137, 1, 1636425192890, 1636425193518, 628, 271, 357, 0, 1, 1
5136, 1, 1636425192803, 1636425193546, 743, 386, 357, 2, 0, 2
5140, 1, 1636425193708, 1636425194342, 634, 269, 365, 0, 1, 1
5142, 1, 1636425194611, 1636425195242, 631, 270, 361, 0, 1, 1
5144, 1, 1636425194706, 1636425195698, 992, 630, 362, 0, 0, 0
5147, 1, 1636425196340, 1636425196966, 626, 270, 356, 1, 1, 2
5149, 1, 1636425197192, 1636425197818, 626, 265, 361, 1, 0, 1
5150, 1, 1636425197830, 1636425198458, 628, 271, 357, 1, 1, 2
5116, 2, 1636425188446, 1636425198657, 10211, 1, 10210, 1, 0, 1
5118, 2, 1636425188719, 1636425198893, 10174, 1, 10173, 0, 0, 0
5119, 2, 1636425188818, 1636425198997, 10179, 0, 10179, 0, 0, 0
5151, 1, 1636425198405, 1636425199034, 629, 264, 365, 0, 0, 0
5121, 2, 1636425189162, 1636425199349, 10187, 1, 10186, 1, 0, 1
5152, 1, 1636425198704, 1636425199486, 782, 421, 361, 1, 0, 1
5123, 2, 1636425189386, 1636425199561, 10175, 1, 10174, 1, 0, 1
5158, 1, 1636425200285, 1636425200914, 629, 268, 361, 0, 0, 0
5130, 2, 1636425190858, 1636425201041, 10183, 1, 10182, 0, 0, 0
5132, 2, 1636425191220, 1636425201397, 10177, 1, 10176, 0, 0, 0
5160, 1, 1636425201397, 1636425202030, 633, 270, 363, 1, 0, 1
5162, 1, 1636425202006, 1636425202638, 632, 270, 362, 0, 1, 1
5163, 1, 1636425202323, 1636425202950, 627, 270, 357, 0, 0, 0
5164, 1, 1636425202667, 1636425203406, 739, 375, 364, 1, 2, 3
5138, 2, 1636425193432, 1636425203565, 10133, 0, 10133, 0, 0, 0
5139, 2, 1636425193492, 1636425203629, 10137, 0, 10137, 0, 0, 0
5141, 2, 1636425194410, 1636425204545, 10135, 0, 10135, 0, 1, 1
5143, 2, 1636425194658, 1636425204793, 10135, 0, 10135, 0, 0, 0
5167, 1, 1636425204204, 1636425204830, 626, 268, 358, 0, 0, 0
5170, 1, 1636425205091, 1636425205722, 631, 269, 362, 0, 0, 0
5145, 2, 1636425195669, 1636425205809, 10140, 1, 10139, 1, 0, 1
5146, 2, 1636425196336, 1636425206469, 10133, 0, 10133, 0, 0, 0
5171, 1, 1636425205878, 1636425206506, 628, 269, 359, 0, 0, 0
5173, 1, 1636425206046, 1636425206674, 628, 271, 357, 1, 0, 1
5148, 1, 1636425196701, 1636425206962, 10261, 9901, 360, 0, 0, 0
5175, 1, 1636425206660, 1636425207290, 630, 270, 360, 0, 1, 1
5177, 1, 1636425207927, 1636425208554, 627, 268, 359, 0, 0, 0
5154, 2, 1636425199242, 1636425209441, 10199, 1, 10198, 1, 1, 2
5153, 2, 1636425199238, 1636425209484, 10246, 1, 10245, 0, 1, 1
5155, 2, 1636425199243, 1636425209529, 10286, 0, 10286, 1, 0, 1
5156, 2, 1636425199478, 1636425209653, 10175, 0, 10175, 0, 0, 0
5178, 1, 1636425209042, 1636425209794, 752, 309, 443, 0, 40, 40
5157, 2, 1636425199690, 1636425209865, 10175, 1, 10174, 0, 0, 0
5180, 1, 1636425209654, 1636425210334, 680, 279, 401, 2, 0, 2
5182, 1, 1636425209710, 1636425210338, 628, 270, 358, 0, 0, 0
5185, 1, 1636425210072, 1636425210702, 630, 270, 360, 0, 0, 0
5186, 1, 1636425210660, 1636425211286, 626, 270, 356, 0, 1, 1
5159, 2, 1636425201170, 1636425211349, 10179, 0, 10179, 0, 0, 0
5161, 2, 1636425201526, 1636425211705, 10179, 0, 10179, 0, 0, 0
5189, 1, 1636425211952, 1636425212582, 630, 269, 361, 0, 0, 0
5190, 1, 1636425212972, 1636425213598, 626, 268, 358, 0, 0, 0
5165, 2, 1636425203714, 1636425213889, 10175, 1, 10174, 1, 1, 2
5166, 2, 1636425203758, 1636425213932, 10174, 0, 10174, 0, 0, 0
5191, 1, 1636425213413, 1636425214046, 633, 276, 357, 1, 0, 1
5192, 1, 1636425213746, 1636425214390, 644, 283, 361, 1, 11, 12
5193, 1, 1636425213933, 1636425214518, 585, 270, 315, 0, 0, 0
5168, 2, 1636425204674, 1636425214885, 10211, 0, 10211, 0, 1, 1
5196, 1, 1636425214477, 1636425215098, 621, 263, 358, 2, 0, 2
5169, 2, 1636425204922, 1636425215101, 10179, 1, 10178, 0, 0, 0
5172, 2, 1636425205934, 1636425216117, 10183, 0, 10183, 0, 0, 0
5199, 1, 1636425215627, 1636425216254, 627, 271, 356, 0, 3, 3
5174, 2, 1636425206594, 1636425216769, 10175, 0, 10175, 0, 0, 0
5176, 1, 1636425206964, 1636425217258, 10294, 9897, 397, 1, 0, 1
5202, 1, 1636425216947, 1636425217578, 631, 271, 360, 2, 1, 3
5203, 1, 1636425217247, 1636425218026, 779, 426, 353, 0, 0, 0
5205, 1, 1636425217420, 1636425218050, 630, 269, 361, 0, 0, 0
5206, 1, 1636425218113, 1636425218742, 629, 269, 360, 1, 0, 1
5207, 1, 1636425218272, 1636425218894, 622, 263, 359, 0, 0, 0
5179, 2, 1636425209654, 1636425219833, 10179, 1, 10178, 1, 0, 1
5181, 2, 1636425209654, 1636425219881, 10227, 1, 10226, 1, 0, 1
5183, 2, 1636425209782, 1636425219957, 10175, 0, 10175, 0, 0, 0
5208, 1, 1636425219422, 1636425220050, 628, 268, 360, 1, 0, 1
5184, 2, 1636425209994, 1636425220173, 10179, 0, 10179, 0, 0, 0
5213, 1, 1636425220722, 1636425221350, 628, 270, 358, 0, 1, 1
5187, 2, 1636425211478, 1636425221657, 10179, 0, 10179, 0, 0, 0
5214, 1, 1636425221121, 1636425221802, 681, 326, 355, 1, 1, 2
5188, 2, 1636425211835, 1636425222013, 10178, 1, 10177, 1, 0, 1
5215, 1, 1636425221487, 1636425222118, 631, 271, 360, 1, 0, 1
5217, 1, 1636425221894, 1636425222554, 660, 269, 391, 0, 0, 0
5219, 1, 1636425222415, 1636425223042, 627, 271, 356, 0, 1, 1
5221, 1, 1636425223489, 1636425224118, 629, 271, 358, 0, 3, 3
5194, 2, 1636425214018, 1636425224193, 10175, 0, 10175, 0, 0, 0
5195, 2, 1636425214062, 1636425224241, 10179, 1, 10178, 2, 0, 2
5224, 1, 1636425224402, 1636425225034, 632, 266, 366, 2, 1, 3
5197, 2, 1636425215014, 1636425225193, 10179, 1, 10178, 0, 0, 0
5198, 2, 1636425215230, 1636425225409, 10179, 0, 10179, 0, 0, 0
5225, 1, 1636425224990, 1636425225674, 684, 330, 354, 0, 61, 61
5227, 1, 1636425225410, 1636425226034, 624, 267, 357, 1, 0, 1
5200, 2, 1636425216246, 1636425226424, 10178, 0, 10178, 0, 0, 0
5229, 1, 1636425225833, 1636425226466, 633, 270, 363, 1, 0, 1
5230, 1, 1636425226345, 1636425227010, 665, 270, 395, 1, 0, 1
5201, 2, 1636425216898, 1636425227073, 10175, 0, 10175, 0, 1, 1
5204, 1, 1636425217260, 1636425227570, 10310, 9905, 405, 0, 1, 1
5233, 1, 1636425227389, 1636425228015, 626, 270, 356, 0, 1, 1
5235, 1, 1636425228633, 1636425229262, 629, 271, 358, 0, 1, 1
5236, 1, 1636425229035, 1636425229722, 687, 330, 357, 1, 0, 1
5237, 1, 1636425229360, 1636425229986, 626, 268, 358, 0, 0, 0
5210, 2, 1636425220427, 1636425230601, 10174, 1, 10173, 2, 0, 2
5209, 2, 1636425220426, 1636425230652, 10226, 0, 10226, 0, 0, 0
5238, 1, 1636425230031, 1636425230658, 627, 271, 356, 0, 0, 0
5212, 2, 1636425220427, 1636425230697, 10270, 1, 10269, 1, 1, 2
5239, 1, 1636425230105, 1636425230734, 629, 269, 360, 1, 1, 2
5211, 2, 1636425220427, 1636425230741, 10314, 0, 10314, 1, 0, 1
5243, 1, 1636425230831, 1636425231502, 671, 267, 404, 0, 0, 0
5244, 1, 1636425231052, 1636425231678, 626, 269, 357, 1, 1, 2
5216, 2, 1636425221786, 1636425231965, 10179, 0, 10179, 0, 0, 0
5218, 2, 1636425222142, 1636425232321, 10179, 0, 10179, 0, 0, 0
5220, 2, 1636425222843, 1636425232977, 10134, 1, 10133, 2, 0, 2
5247, 1, 1636425232510, 1636425233142, 632, 269, 363, 0, 1, 1
5248, 1, 1636425232760, 1636425233598, 838, 482, 356, 1, 0, 1
5249, 1, 1636425233106, 1636425233774, 668, 270, 398, 2, 0, 2
5222, 2, 1636425224326, 1636425234501, 10175, 0, 10175, 1, 0, 1
5223, 2, 1636425224366, 1636425234544, 10178, 0, 10178, 0, 0, 0
5252, 1, 1636425234239, 1636425234906, 667, 307, 360, 0, 40, 40
5253, 1, 1636425234545, 1636425235178, 633, 270, 363, 0, 1, 1
5226, 2, 1636425225322, 1636425235501, 10179, 1, 10178, 2, 0, 2
5228, 2, 1636425225538, 1636425235717, 10179, 0, 10179, 0, 0, 0
5231, 2, 1636425226554, 1636425236733, 10179, 0, 10179, 0, 1, 1
5259, 1, 1636425236506, 1636425237138, 632, 269, 363, 0, 0, 0
5232, 2, 1636425227198, 1636425237373, 10175, 0, 10175, 0, 0, 0
5260, 1, 1636425236557, 1636425237586, 1029, 674, 355, 0, 0, 0
5262, 1, 1636425236976, 1636425237634, 658, 307, 351, 3, 40, 43
5234, 1, 1636425227572, 1636425237854, 10282, 9886, 396, 1, 0, 1
5265, 1, 1636425238077, 1636425238710, 633, 270, 363, 0, 1, 1
5266, 1, 1636425238666, 1636425239294, 628, 270, 358, 1, 1, 2
5267, 1, 1636425240278, 1636425240910, 632, 268, 364, 0, 0, 0
5241, 2, 1636425230831, 1636425241009, 10178, 1, 10177, 2, 0, 2
5242, 2, 1636425230831, 1636425241053, 10222, 1, 10221, 1, 0, 1
5240, 2, 1636425230830, 1636425241101, 10271, 1, 10270, 1, 0, 1
5268, 1, 1636425240451, 1636425241466, 1015, 562, 453, 0, 4, 4
5270, 1, 1636425241594, 1636425242266, 672, 269, 403, 0, 1, 1
5245, 2, 1636425232094, 1636425242269, 10175, 0, 10175, 1, 0, 1
5273, 1, 1636425241886, 1636425242538, 652, 293, 359, 1, 25, 26
5246, 2, 1636425232450, 1636425242629, 10179, 0, 10179, 0, 0, 0
5271, 1, 1636425241594, 1636425242714, 1120, 723, 397, 2, 0, 2
5275, 1, 1636425242736, 1636425243354, 618, 261, 357, 0, 1, 1
5250, 2, 1636425233472, 1636425243605, 10133, 0, 10133, 0, 0, 0
5251, 2, 1636425234235, 1636425244369, 10134, 0, 10134, 0, 0, 0
5277, 1, 1636425243734, 1636425244406, 672, 270, 402, 0, 0, 0
5254, 2, 1636425234630, 1636425244804, 10174, 1, 10173, 1, 0, 1
5255, 2, 1636425234674, 1636425244849, 10175, 1, 10174, 0, 2, 2
5278, 1, 1636425244489, 1636425245206, 717, 269, 448, 0, 0, 0
5279, 1, 1636425244498, 1636425245210, 712, 306, 406, 0, 40, 40
5256, 2, 1636425235164, 1636425245297, 10133, 1, 10132, 0, 0, 0
5280, 1, 1636425244512, 1636425245658, 1146, 789, 357, 0, 0, 0
5257, 2, 1636425235630, 1636425245809, 10179, 0, 10179, 0, 1, 1
5258, 2, 1636425235846, 1636425246025, 10179, 1, 10178, 0, 1, 1
5283, 1, 1636425245430, 1636425246098, 668, 271, 397, 1, 1, 2
5284, 1, 1636425245656, 1636425246294, 638, 282, 356, 0, 13, 13
5286, 1, 1636425245873, 1636425246506, 633, 270, 363, 1, 1, 2
5285, 1, 1636425245714, 1636425246758, 1044, 671, 373, 0, 1, 1
5261, 2, 1636425236862, 1636425247041, 10179, 1, 10178, 0, 0, 0
5289, 1, 1636425246561, 1636425247190, 629, 269, 360, 0, 0, 0
5263, 2, 1636425237502, 1636425247677, 10175, 0, 10175, 0, 0, 0
5264, 1, 1636425237857, 1636425248170, 10313, 9914, 399, 1, 0, 1
5291, 1, 1636425247594, 1636425248214, 620, 263, 357, 0, 0, 0
5294, 1, 1636425248338, 1636425248966, 628, 268, 360, 0, 0, 0
5295, 1, 1636425248764, 1636425249394, 630, 270, 360, 2, 0, 2
5296, 1, 1636425248768, 1636425249846, 1078, 722, 356, 0, 0, 0
5297, 1, 1636425249290, 1636425249918, 628, 269, 359, 0, 0, 0
5298, 1, 1636425249437, 1636425250062, 625, 271, 354, 1, 0, 1
5299, 1, 1636425249683, 1636425250522, 839, 474, 365, 0, 1, 1
5300, 1, 1636425250024, 1636425250642, 618, 265, 353, 0, 0, 0
5301, 1, 1636425250283, 1636425250974, 691, 334, 357, 1, 0, 1
5269, 2, 1636425241102, 1636425251193, 10091, 1, 10090, 1, 0, 1
5272, 2, 1636425241595, 1636425251773, 10178, 0, 10178, 1, 0, 1
5302, 1, 1636425251274, 1636425251902, 628, 270, 358, 0, 1, 1
5274, 2, 1636425242402, 1636425252581, 10179, 0, 10179, 0, 0, 0
5304, 1, 1636425252018, 1636425252646, 628, 269, 359, 0, 0, 0
5276, 2, 1636425242758, 1636425252937, 10179, 0, 10179, 1, 0, 1
5307, 1, 1636425252970, 1636425253602, 632, 270, 362, 0, 0, 0
5308, 1, 1636425253020, 1636425253646, 626, 268, 358, 0, 0, 0
5311, 1, 1636425253212, 1636425253838, 626, 266, 360, 1, 1, 2
5309, 1, 1636425253032, 1636425254098, 1066, 704, 362, 1, 0, 1
5312, 1, 1636425253658, 1636425254286, 628, 274, 354, 0, 1, 1
5313, 1, 1636425254024, 1636425254646, 622, 274, 348, 0, 1, 1
5314, 1, 1636425254405, 1636425255042, 637, 270, 367, 0, 1, 1
5281, 2, 1636425244934, 1636425255109, 10175, 1, 10174, 0, 0, 0
5282, 2, 1636425244978, 1636425255156, 10178, 1, 10177, 1, 0, 1
5316, 1, 1636425255274, 1636425255902, 628, 270, 358, 1, 1, 2
5287, 2, 1636425245938, 1636425256117, 10179, 0, 10179, 0, 0, 0
5288, 2, 1636425246154, 1636425256333, 10179, 0, 10179, 0, 0, 0
5318, 1, 1636425256019, 1636425256694, 675, 307, 368, 0, 40, 40
5290, 2, 1636425247170, 1636425257349, 10179, 1, 10178, 1, 0, 1
5323, 1, 1636425257201, 1636425257834, 633, 274, 359, 1, 0, 1
5292, 2, 1636425247802, 1636425257977, 10175, 0, 10175, 0, 0, 0
5324, 1, 1636425257350, 1636425257978, 628, 268, 360, 0, 0, 0
5326, 1, 1636425257794, 1636425258434, 640, 285, 355, 1, 1, 2
5293, 1, 1636425248172, 1636425258474, 10302, 9902, 400, 0, 1, 1
5327, 1, 1636425258066, 1636425258694, 628, 269, 359, 0, 0, 0
5330, 1, 1636425258586, 1636425259214, 628, 265, 363, 1, 0, 1
5331, 1, 1636425259186, 1636425259814, 628, 270, 358, 0, 0, 0
5332, 1, 1636425259803, 1636425260426, 623, 269, 354, 0, 0, 0
5303, 2, 1636425251322, 1636425261497, 10175, 1, 10174, 0, 0, 0
5333, 1, 1636425261077, 1636425261706, 629, 270, 359, 2, 0, 2
5334, 1, 1636425261498, 1636425262126, 628, 270, 358, 1, 1, 2
5335, 1, 1636425261626, 1636425262298, 672, 269, 403, 0, 1, 1
5336, 1, 1636425261912, 1636425262586, 674, 310, 364, 1, 0, 1
5337, 1, 1636425261992, 1636425262618, 626, 264, 362, 0, 0, 0
5306, 2, 1636425252803, 1636425262985, 10182, 0, 10182, 0, 0, 0
5305, 2, 1636425252802, 1636425263028, 10226, 0, 10226, 0, 0, 0
5338, 1, 1636425262478, 1636425263102, 624, 266, 358, 1, 1, 2
5310, 2, 1636425253066, 1636425263245, 10179, 0, 10179, 0, 1, 1
5341, 1, 1636425263154, 1636425263790, 636, 315, 321, 49, 0, 49
5339, 1, 1636425263118, 1636425263794, 676, 269, 407, 1, 2, 3
5343, 1, 1636425263769, 1636425264398, 629, 268, 361, 0, 0, 0
5315, 2, 1636425255242, 1636425265421, 10179, 0, 10179, 0, 0, 0
5317, 2, 1636425255282, 1636425265465, 10183, 0, 10183, 0, 0, 0
5344, 1, 1636425265075, 1636425265734, 659, 301, 358, 1, 31, 32
5345, 1, 1636425265325, 1636425265958, 633, 263, 370, 0, 1, 1
5349, 1, 1636425265707, 1636425266334, 627, 266, 361, 2, 0, 2
5350, 1, 1636425265778, 1636425266402, 624, 266, 358, 0, 0, 0
5348, 1, 1636425265644, 1636425266414, 770, 410, 360, 0, 0, 0
5319, 2, 1636425256246, 1636425266425, 10179, 1, 10178, 1, 0, 1
5320, 2, 1636425256462, 1636425266641, 10179, 0, 10179, 0, 0, 0
5321, 2, 1636425256692, 1636425266825, 10133, 1, 10132, 0, 0, 0
5351, 1, 1636425266308, 1636425267002, 694, 303, 391, 0, 36, 36
5322, 2, 1636425257027, 1636425267161, 10134, 0, 10134, 1, 0, 1
5354, 1, 1636425266954, 1636425267622, 668, 271, 397, 1, 0, 1
5325, 2, 1636425257478, 1636425267657, 10179, 0, 10179, 0, 0, 0
5355, 1, 1636425267097, 1636425267754, 657, 270, 387, 0, 0, 0
5356, 1, 1636425267239, 1636425268110, 871, 516, 355, 0, 32, 32
5328, 2, 1636425258110, 1636425268285, 10175, 1, 10174, 0, 1, 1
5358, 1, 1636425267713, 1636425268342, 629, 270, 359, 0, 0, 0
5357, 1, 1636425267290, 1636425268562, 1272, 874, 398, 0, 0, 0
5329, 1, 1636425258476, 1636425268778, 10302, 9901, 401, 0, 0, 0
5362, 1, 1636425268979, 1636425269606, 627, 269, 358, 0, 0, 0
5363, 1, 1636425269136, 1636425269766, 630, 269, 361, 1, 0, 1
5364, 1, 1636425269407, 1636425270222, 815, 459, 356, 1, 1, 2
5365, 1, 1636425269761, 1636425270390, 629, 271, 358, 0, 0, 0
5366, 1, 1636425270005, 1636425270638, 633, 269, 364, 0, 0, 0
5367, 1, 1636425270202, 1636425270830, 628, 270, 358, 0, 0, 0
5368, 1, 1636425271063, 1636425271690, 627, 269, 358, 0, 2, 2
5369, 1, 1636425271253, 1636425271890, 637, 278, 359, 0, 1, 1
5371, 1, 1636425271502, 1636425272130, 628, 269, 359, 2, 0, 2
5370, 1, 1636425271483, 1636425272142, 659, 303, 356, 2, 0, 2
5372, 1, 1636425271925, 1636425272554, 629, 269, 360, 0, 0, 0
5340, 2, 1636425263118, 1636425273337, 10219, 1, 10218, 1, 0, 1
5342, 2, 1636425263374, 1636425273553, 10179, 0, 10179, 0, 0, 0
5373, 1, 1636425273014, 1636425273638, 624, 269, 355, 0, 0, 0
5374, 1, 1636425273091, 1636425273714, 623, 269, 354, 0, 0, 0
5375, 1, 1636425273200, 1636425274090, 890, 535, 355, 0, 2, 2
5379, 1, 1636425274159, 1636425274786, 627, 271, 356, 0, 1, 1
5380, 1, 1636425274178, 1636425274806, 628, 269, 359, 1, 0, 1
5346, 2, 1636425265550, 1636425275725, 10175, 0, 10175, 0, 0, 0
5347, 2, 1636425265586, 1636425275768, 10182, 1, 10181, 0, 0, 0
5381, 1, 1636425275267, 1636425275886, 619, 263, 356, 0, 0, 0
5382, 1, 1636425275273, 1636425275898, 625, 266, 359, 2, 0, 2
5383, 1, 1636425275306, 1636425275934, 628, 271, 357, 2, 1, 3
5384, 1, 1636425275614, 1636425276350, 736, 312, 424, 1, 0, 1
5387, 1, 1636425275939, 1636425276566, 627, 270, 357, 1, 0, 1
5352, 2, 1636425266554, 1636425276733, 10179, 0, 10179, 0, 0, 0
5353, 2, 1636425266770, 1636425276949, 10179, 0, 10179, 0, 0, 0
5390, 1, 1636425277168, 1636425277802, 634, 270, 364, 0, 0, 0
5359, 2, 1636425267786, 1636425277965, 10179, 1, 10178, 0, 0, 0
5392, 1, 1636425277367, 1636425277994, 627, 270, 357, 1, 1, 2
5391, 1, 1636425277243, 1636425278254, 1011, 654, 357, 0, 0, 0
5360, 2, 1636425268414, 1636425278589, 10175, 0, 10175, 1, 0, 1
5393, 1, 1636425277966, 1636425278594, 628, 269, 359, 1, 0, 1
5395, 1, 1636425278442, 1636425279074, 632, 269, 363, 1, 0, 1
5361, 1, 1636425268780, 1636425279086, 10306, 9902, 404, 0, 0, 0
5397, 1, 1636425278980, 1636425279606, 626, 269, 357, 0, 1, 1
5399, 1, 1636425279167, 1636425279798, 631, 274, 357, 0, 0, 0
5400, 1, 1636425279284, 1636425279910, 626, 271, 355, 1, 1, 2
5401, 1, 1636425279505, 1636425280254, 749, 389, 360, 0, 0, 0
5402, 1, 1636425279956, 1636425280586, 630, 270, 360, 0, 0, 0
5403, 1, 1636425281054, 1636425281682, 628, 269, 359, 0, 0, 0
5405, 1, 1636425281384, 1636425282006, 622, 265, 357, 0, 0, 0
5404, 1, 1636425281078, 1636425282134, 1056, 698, 358, 1, 0, 1
5406, 1, 1636425281832, 1636425282458, 626, 269, 357, 1, 0, 1
5407, 1, 1636425282218, 1636425282842, 624, 265, 359, 0, 1, 1
5409, 1, 1636425283031, 1636425283658, 627, 270, 357, 2, 0, 2
5411, 1, 1636425283281, 1636425283910, 629, 270, 359, 0, 0, 0
5378, 2, 1636425273888, 1636425284021, 10133, 0, 10133, 0, 0, 0
5377, 2, 1636425273882, 1636425284064, 10182, 0, 10182, 0, 0, 0
5376, 2, 1636425273882, 1636425284108, 10226, 0, 10226, 1, 0, 1
5410, 1, 1636425283261, 1636425284114, 853, 491, 362, 0, 1, 1
5413, 1, 1636425284194, 1636425284862, 668, 268, 400, 0, 0, 0
5414, 1, 1636425284198, 1636425284870, 672, 271, 401, 2, 0, 2
5415, 1, 1636425284199, 1636425285326, 1127, 724, 403, 1, 0, 1
5417, 1, 1636425285096, 1636425285726, 630, 270, 360, 0, 1, 1
5385, 2, 1636425275854, 1636425286029, 10175, 0, 10175, 0, 0, 0
5386, 2, 1636425275890, 1636425286072, 10182, 0, 10182, 0, 0, 0
5418, 1, 1636425285325, 1636425286174, 849, 493, 356, 0, 0, 0
5419, 1, 1636425285832, 1636425286518, 686, 329, 357, 0, 67, 67
5420, 1, 1636425286077, 1636425286710, 633, 268, 365, 0, 0, 0
5421, 1, 1636425286158, 1636425286826, 668, 271, 397, 0, 0, 0
5388, 2, 1636425276862, 1636425287041, 10179, 0, 10179, 0, 0, 0
5389, 2, 1636425277078, 1636425287257, 10179, 0, 10179, 0, 0, 0
5422, 1, 1636425286194, 1636425287306, 1112, 718, 394, 0, 28, 28
5423, 1, 1636425287170, 1636425287842, 672, 271, 401, 0, 0, 0
5424, 1, 1636425287269, 1636425287902, 633, 269, 364, 0, 0, 0
5427, 1, 1636425287462, 1636425288090, 628, 270, 358, 0, 0, 0
5394, 2, 1636425278094, 1636425288273, 10179, 1, 10178, 1, 0, 1
5426, 1, 1636425287386, 1636425288294, 908, 505, 403, 1, 0, 1
5425, 1, 1636425287343, 1636425288346, 1003, 647, 356, 2, 0, 2
5428, 1, 1636425287883, 1636425288542, 659, 302, 357, 0, 33, 33
5429, 1, 1636425287887, 1636425288542, 655, 293, 362, 0, 24, 24
5396, 2, 1636425278714, 1636425288889, 10175, 1, 10174, 0, 0, 0
5430, 1, 1636425288199, 1636425288998, 799, 406, 393, 0, 0, 0
5431, 1, 1636425288406, 1636425289078, 672, 271, 401, 0, 0, 0
5398, 1, 1636425279088, 1636425289378, 10290, 9886, 404, 1, 0, 1
5433, 1, 1636425289024, 1636425289650, 626, 270, 356, 1, 0, 1
5432, 1, 1636425289018, 1636425289686, 668, 271, 397, 0, 0, 0
5434, 1, 1636425289309, 1636425290102, 793, 434, 359, 1, 0, 1
5435, 1, 1636425289380, 1636425290134, 754, 353, 401, 0, 0, 0
5436, 1, 1636425289558, 1636425290182, 624, 267, 357, 0, 0, 0
5437, 1, 1636425290045, 1636425290670, 625, 267, 358, 0, 0, 0
5439, 1, 1636425290190, 1636425290814, 624, 271, 353, 0, 0, 0
5438, 1, 1636425290084, 1636425291122, 1038, 679, 359, 0, 0, 0
5440, 1, 1636425290886, 1636425291570, 684, 326, 358, 0, 1, 1
5442, 1, 1636425291309, 1636425291942, 633, 273, 360, 0, 0, 0
5443, 1, 1636425291353, 1636425291974, 621, 267, 354, 1, 0, 1
5441, 1, 1636425291277, 1636425292022, 745, 386, 359, 0, 0, 0
5445, 1, 1636425291626, 1636425292250, 624, 266, 358, 1, 0, 1
5446, 1, 1636425291771, 1636425292398, 627, 269, 358, 1, 0, 1
5444, 1, 1636425291486, 1636425292402, 916, 553, 363, 0, 0, 0
5447, 1, 1636425292046, 1636425292670, 624, 267, 357, 0, 0, 0
5448, 1, 1636425292075, 1636425292702, 627, 270, 357, 0, 0, 0
5408, 2, 1636425282956, 1636425293089, 10133, 1, 10132, 2, 0, 2
5449, 1, 1636425292740, 1636425293366, 626, 269, 357, 0, 0, 0
5450, 1, 1636425292945, 1636425293570, 625, 265, 360, 0, 0, 0
5451, 1, 1636425293001, 1636425293822, 821, 462, 359, 1, 0, 1
5412, 2, 1636425283714, 1636425293849, 10135, 0, 10135, 0, 0, 0
5452, 1, 1636425293218, 1636425293890, 672, 269, 403, 1, 0, 1
5453, 1, 1636425293250, 1636425294018, 768, 417, 351, 0, 0, 0
5454, 1, 1636425293524, 1636425294154, 630, 268, 362, 1, 0, 1
5455, 1, 1636425293769, 1636425294390, 621, 269, 352, 0, 0, 0
5456, 1, 1636425293982, 1636425294654, 672, 271, 401, 0, 1, 1
5457, 1, 1636425294072, 1636425294846, 774, 419, 355, 1, 0, 1
5458, 1, 1636425294446, 1636425295074, 628, 270, 358, 0, 0, 0
5416, 2, 1636425285056, 1636425295189, 10133, 0, 10133, 0, 0, 0
5459, 1, 1636425294568, 1636425295302, 734, 379, 355, 0, 0, 0
5460, 1, 1636425295190, 1636425295818, 628, 270, 358, 0, 0, 0
5461, 1, 1636425295269, 1636425295894, 625, 269, 356, 0, 0, 0
5462, 1, 1636425295322, 1636425295990, 668, 269, 399, 0, 1, 1
5463, 1, 1636425295630, 1636425296258, 628, 269, 359, 1, 0, 1
5464, 1, 1636425295652, 1636425296282, 630, 272, 358, 0, 0, 0
5466, 1, 1636425295730, 1636425296350, 620, 267, 353, 1, 0, 1
5467, 1, 1636425295769, 1636425296390, 621, 266, 355, 0, 0, 0
5465, 1, 1636425295667, 1636425296714, 1047, 691, 356, 1, 1, 2
5468, 1, 1636425296484, 1636425297114, 630, 270, 360, 0, 0, 0
5469, 1, 1636425296668, 1636425297290, 622, 267, 355, 0, 0, 0
5471, 1, 1636425297038, 1636425297666, 628, 271, 357, 0, 1, 1
5470, 1, 1636425297016, 1636425297758, 742, 370, 372, 1, 0, 1
5473, 1, 1636425297415, 1636425298050, 635, 269, 366, 1, 0, 1
5474, 1, 1636425297468, 1636425298102, 634, 269, 365, 1, 0, 1
5472, 1, 1636425297139, 1636425298118, 979, 618, 361, 1, 0, 1
5475, 1, 1636425297795, 1636425298426, 631, 274, 357, 0, 0, 0
5476, 1, 1636425298179, 1636425298806, 627, 270, 357, 1, 0, 1
5477, 1, 1636425298200, 1636425298826, 626, 271, 355, 2, 0, 2
5478, 1, 1636425298326, 1636425298958, 632, 270, 362, 0, 0, 0
5479, 1, 1636425298851, 1636425299470, 619, 264, 355, 0, 1, 1
5480, 1, 1636425298898, 1636425299514, 616, 259, 357, 0, 0, 0
5481, 1, 1636425299295, 1636425299918, 623, 266, 357, 0, 0, 0
5482, 1, 1636425299325, 1636425299954, 629, 270, 359, 1, 1, 2
5483, 1, 1636425299397, 1636425300030, 633, 271, 362, 0, 0, 0
5484, 1, 1636425299518, 1636425300134, 616, 266, 350, 0, 0, 0
5486, 1, 1636425299795, 1636425300418, 623, 267, 356, 0, 0, 0
5485, 1, 1636425299589, 1636425300474, 885, 530, 355, 2, 0, 2
5487, 1, 1636425300014, 1636425300642, 628, 270, 358, 1, 0, 1
5488, 1, 1636425300429, 1636425301066, 637, 269, 368, 1, 0, 1
5489, 1, 1636425300694, 1636425301322, 628, 270, 358, 0, 0, 0
5490, 1, 1636425301196, 1636425301830, 634, 275, 359, 0, 1, 1
5492, 1, 1636425301267, 1636425301894, 627, 265, 362, 0, 0, 0
5493, 1, 1636425301469, 1636425302102, 633, 269, 364, 0, 0, 0
5494, 1, 1636425301599, 1636425302226, 627, 271, 356, 1, 0, 1
5491, 1, 1636425301264, 1636425302266, 1002, 651, 351, 0, 1, 1
5495, 1, 1636425301680, 1636425302302, 622, 265, 357, 1, 0, 1
5496, 1, 1636425302000, 1636425302626, 626, 269, 357, 0, 0, 0
5497, 1, 1636425302389, 1636425303022, 633, 268, 365, 0, 0, 0
5498, 1, 1636425302424, 1636425303050, 626, 269, 357, 0, 0, 0
5499, 1, 1636425302668, 1636425303298, 630, 270, 360, 0, 0, 0
5500, 1, 1636425302739, 1636425303358, 619, 270, 349, 1, 1, 2
5502, 1, 1636425303122, 1636425303750, 628, 270, 358, 0, 0, 0
5501, 1, 1636425303112, 1636425303754, 642, 277, 365, 0, 0, 0
5503, 1, 1636425303589, 1636425304218, 629, 269, 360, 0, 1, 1
5504, 1, 1636425303612, 1636425304238, 626, 270, 356, 0, 0, 0
5505, 1, 1636425303646, 1636425304274, 628, 270, 358, 2, 0, 2
5507, 1, 1636425304040, 1636425304666, 626, 269, 357, 1, 0, 1
5506, 1, 1636425303773, 1636425304670, 897, 538, 359, 1, 1, 2
5508, 1, 1636425304511, 1636425305138, 627, 270, 357, 1, 0, 1
5509, 1, 1636425304577, 1636425305202, 625, 267, 358, 0, 0, 0
5510, 1, 1636425305084, 1636425305710, 626, 271, 355, 1, 0, 1
5511, 1, 1636425305225, 1636425305850, 625, 267, 358, 0, 0, 0
5513, 1, 1636425305452, 1636425306074, 622, 262, 360, 0, 0, 0
5514, 1, 1636425305492, 1636425306126, 634, 270, 364, 1, 0, 1
5512, 1, 1636425305367, 1636425306306, 939, 582, 357, 0, 0, 0
5515, 1, 1636425305795, 1636425306530, 735, 379, 356, 0, 0, 0
5516, 1, 1636425305956, 1636425306590, 634, 268, 366, 0, 0, 0
5517, 1, 1636425306171, 1636425306798, 627, 270, 357, 0, 0, 0
5518, 1, 1636425306447, 1636425307074, 627, 270, 357, 2, 0, 2
5519, 1, 1636425306634, 1636425307266, 632, 275, 357, 0, 0, 0
5520, 1, 1636425306651, 1636425307282, 631, 275, 356, 0, 0, 0
5521, 1, 1636425306786, 1636425307730, 944, 587, 357, 0, 0, 0
5522, 1, 1636425307265, 1636425307894, 629, 270, 359, 0, 0, 0
5524, 1, 1636425307427, 1636425308054, 627, 270, 357, 0, 1, 1
5523, 1, 1636425307407, 1636425308186, 779, 422, 357, 2, 0, 2
5525, 1, 1636425307649, 1636425308278, 629, 269, 360, 1, 0, 1
5526, 1, 1636425307842, 1636425308734, 892, 533, 359, 0, 0, 0
5527, 1, 1636425308306, 1636425308938, 632, 271, 361, 0, 0, 0
5528, 1, 1636425308338, 1636425308966, 628, 269, 359, 0, 0, 0
5529, 1, 1636425308879, 1636425309506, 627, 267, 360, 0, 0, 0
5530, 1, 1636425308938, 1636425309570, 632, 270, 362, 1, 0, 1
5531, 1, 1636425309062, 1636425309686, 624, 267, 357, 1, 0, 1
5533, 1, 1636425309356, 1636425309982, 626, 270, 356, 0, 0, 0
5532, 1, 1636425309078, 1636425310138, 1060, 701, 359, 0, 0, 0
5534, 1, 1636425309595, 1636425310218, 623, 267, 356, 0, 1, 1
5535, 1, 1636425309923, 1636425310554, 631, 270, 361, 0, 0, 0
5536, 1, 1636425310112, 1636425310746, 634, 274, 360, 0, 0, 0
5537, 1, 1636425310127, 1636425310758, 631, 270, 361, 0, 0, 0
5538, 1, 1636425310224, 1636425310842, 618, 268, 350, 0, 0, 0
5539, 1, 1636425310417, 1636425311054, 637, 270, 367, 0, 0, 0
5540, 1, 1636425310718, 1636425311354, 636, 272, 364, 0, 1, 1
5541, 1, 1636425310854, 1636425311802, 948, 595, 353, 1, 0, 1
5542, 1, 1636425311179, 1636425311806, 627, 269, 358, 0, 0, 0
5543, 1, 1636425311196, 1636425311834, 638, 268, 370, 0, 0, 0
5544, 1, 1636425311603, 1636425312254, 651, 293, 358, 0, 0, 0
5545, 1, 1636425311776, 1636425312402, 626, 270, 356, 1, 0, 1
5546, 1, 1636425312047, 1636425312858, 811, 451, 360, 0, 0, 0
5547, 1, 1636425312373, 1636425313002, 629, 270, 359, 0, 0, 0
5548, 1, 1636425312649, 1636425313274, 625, 271, 354, 1, 1, 2
5549, 1, 1636425312922, 1636425313554, 632, 270, 362, 1, 1, 2
5551, 1, 1636425313023, 1636425313650, 627, 266, 361, 2, 0, 2
5552, 1, 1636425313054, 1636425313678, 624, 267, 357, 1, 0, 1
5550, 1, 1636425312935, 1636425314010, 1075, 718, 357, 1, 1, 2
5553, 1, 1636425313525, 1636425314158, 633, 270, 363, 0, 0, 0
5554, 1, 1636425313595, 1636425314222, 627, 270, 357, 0, 0, 0
5556, 1, 1636425314011, 1636425314634, 623, 266, 357, 0, 0, 0
5557, 1, 1636425314160, 1636425314786, 626, 270, 356, 0, 1, 1
5558, 1, 1636425314279, 1636425314906, 627, 265, 362, 0, 0, 0
5559, 1, 1636425314357, 1636425314990, 633, 269, 364, 0, 0, 0
5560, 1, 1636425314565, 1636425315190, 625, 271, 354, 0, 1, 1
5562, 1, 1636425314879, 1636425315502, 623, 261, 362, 0, 0, 0
5561, 1, 1636425314619, 1636425315634, 1015, 658, 357, 0, 0, 0
5564, 1, 1636425315418, 1636425316046, 628, 269, 359, 0, 0, 0
5563, 1, 1636425315319, 1636425316090, 771, 414, 357, 0, 0, 0
5565, 1, 1636425315540, 1636425316166, 626, 269, 357, 0, 0, 0
5566, 1, 1636425315749, 1636425316618, 869, 509, 360, 0, 0, 0
5567, 1, 1636425316273, 1636425316894, 621, 266, 355, 1, 1, 2
5568, 1, 1636425316618, 1636425317234, 616, 265, 351, 1, 0, 1
5569, 1, 1636425316908, 1636425317530, 622, 266, 356, 0, 0, 0
5570, 1, 1636425316953, 1636425317586, 633, 270, 363, 0, 0, 0
5571, 1, 1636425317016, 1636425317650, 634, 271, 363, 1, 1, 2
5573, 1, 1636425317207, 1636425317982, 775, 418, 357, 0, 0, 0
5572, 1, 1636425317035, 1636425318102, 1067, 711, 356, 0, 1, 1
5575, 1, 1636425317712, 1636425318338, 626, 270, 356, 0, 2, 2
5574, 1, 1636425317677, 1636425318438, 761, 402, 359, 0, 1, 1
5577, 1, 1636425318235, 1636425318858, 623, 270, 353, 2, 0, 2
5576, 1, 1636425318229, 1636425318890, 661, 302, 359, 1, 0, 1
5578, 1, 1636425318278, 1636425318902, 624, 268, 356, 0, 0, 0
5580, 1, 1636425318525, 1636425319346, 821, 458, 363, 0, 0, 0
5579, 1, 1636425318519, 1636425319354, 835, 478, 357, 0, 0, 0
5582, 1, 1636425319254, 1636425319886, 632, 271, 361, 2, 0, 2
5583, 1, 1636425319536, 1636425320162, 626, 270, 356, 0, 1, 1
5584, 1, 1636425319718, 1636425320346, 628, 272, 356, 1, 1, 2
5586, 1, 1636425319937, 1636425320566, 629, 269, 360, 2, 0, 2
5585, 1, 1636425319816, 1636425320798, 982, 626, 356, 0, 0, 0
5587, 1, 1636425320369, 1636425320998, 629, 271, 358, 2, 0, 2
5588, 1, 1636425320635, 1636425321262, 627, 270, 357, 0, 1, 1
5589, 1, 1636425321215, 1636425321842, 627, 266, 361, 0, 0, 0
5591, 1, 1636425321263, 1636425322298, 1035, 673, 362, 1, 0, 1
5594, 1, 1636425322006, 1636425322634, 628, 271, 357, 1, 1, 2
5595, 1, 1636425322200, 1636425322830, 630, 271, 359, 0, 0, 0
5598, 1, 1636425322569, 1636425323198, 629, 270, 359, 0, 0, 0
5599, 1, 1636425322775, 1636425323402, 627, 270, 357, 0, 0, 0
5555, 2, 1636425313921, 1636425324057, 10136, 1, 10135, 0, 0, 0
5601, 1, 1636425323827, 1636425324454, 627, 269, 358, 0, 1, 1
5604, 1, 1636425324004, 1636425324642, 638, 271, 367, 2, 0, 2
5605, 1, 1636425324186, 1636425324854, 668, 270, 398, 1, 0, 1
5606, 1, 1636425324433, 1636425325066, 633, 275, 358, 3, 0, 3
5602, 1, 1636425323981, 1636425325098, 1117, 723, 394, 2, 1, 3
5608, 1, 1636425324969, 1636425325598, 629, 268, 361, 0, 0, 0
5609, 1, 1636425325245, 1636425326054, 809, 447, 362, 2, 0, 2
5610, 1, 1636425325870, 1636425326498, 628, 270, 358, 0, 2, 2
5611, 1, 1636425326144, 1636425326770, 626, 270, 356, 1, 1, 2
5612, 1, 1636425326337, 1636425326966, 629, 271, 358, 0, 1, 1
5613, 1, 1636425327068, 1636425327694, 626, 269, 357, 1, 0, 1
5614, 1, 1636425327594, 1636425328226, 632, 269, 363, 0, 0, 0
5615, 1, 1636425328176, 1636425328810, 634, 270, 364, 0, 1, 1
5617, 1, 1636425328385, 1636425329018, 633, 269, 364, 1, 0, 1
5581, 2, 1636425318992, 1636425329125, 10133, 1, 10132, 0, 0, 0
5618, 1, 1636425328606, 1636425329234, 628, 269, 359, 1, 0, 1
5616, 1, 1636425328295, 1636425329266, 971, 613, 358, 0, 1, 1
5619, 1, 1636425329200, 1636425329826, 626, 271, 355, 1, 2, 3
5620, 1, 1636425329255, 1636425329926, 671, 270, 401, 0, 0, 0
5621, 1, 1636425329554, 1636425330286, 732, 371, 361, 0, 0, 0
5622, 1, 1636425330089, 1636425330722, 633, 269, 364, 1, 0, 1
5623, 1, 1636425330256, 1636425330882, 626, 270, 356, 2, 0, 2
5624, 1, 1636425330529, 1636425331174, 645, 286, 359, 0, 0, 0
5590, 2, 1636425321252, 1636425331385, 10133, 0, 10133, 1, 0, 1
5592, 2, 1636425321293, 1636425331429, 10136, 1, 10135, 1, 1, 2
5625, 1, 1636425330834, 1636425331466, 632, 268, 364, 0, 0, 0
5593, 2, 1636425321780, 1636425331913, 10133, 1, 10132, 1, 0, 1
5626, 1, 1636425331518, 1636425332190, 672, 270, 402, 0, 1, 1
5596, 2, 1636425322306, 1636425332441, 10135, 1, 10134, 0, 2, 2
5628, 1, 1636425331786, 1636425332450, 664, 267, 397, 1, 0, 1
5627, 1, 1636425331558, 1636425332642, 1084, 682, 402, 1, 0, 1
5597, 2, 1636425322551, 1636425332685, 10134, 0, 10134, 0, 0, 0
5629, 1, 1636425332042, 1636425333138, 1096, 699, 397, 0, 44, 44
5630, 1, 1636425332508, 1636425333142, 634, 275, 359, 2, 3, 5
5632, 1, 1636425332570, 1636425333222, 652, 270, 382, 1, 0, 1
5634, 1, 1636425332764, 1636425333390, 626, 271, 355, 0, 0, 0
5600, 2, 1636425323311, 1636425333445, 10134, 1, 10133, 0, 2, 2
5631, 1, 1636425332551, 1636425333586, 1035, 683, 352, 49, 0, 49
5636, 1, 1636425333114, 1636425333742, 628, 268, 360, 0, 0, 0
5637, 1, 1636425333445, 1636425334082, 637, 269, 368, 0, 0, 0
5603, 2, 1636425323995, 1636425334153, 10158, 1, 10157, 1, 0, 1
5639, 1, 1636425333635, 1636425334530, 895, 544, 351, 2, 0, 2
5640, 1, 1636425334153, 1636425334782, 629, 269, 360, 0, 0, 0
5607, 2, 1636425324747, 1636425334881, 10134, 0, 10134, 0, 0, 0
5642, 1, 1636425334533, 1636425335166, 633, 275, 358, 0, 0, 0
5643, 1, 1636425334787, 1636425335418, 631, 266, 365, 1, 0, 1
5645, 1, 1636425335026, 1636425335654, 628, 270, 358, 0, 0, 0
5646, 1, 1636425335243, 1636425335878, 635, 271, 364, 1, 0, 1
5647, 1, 1636425335320, 1636425336338, 1018, 654, 364, 0, 1, 1
5648, 1, 1636425335858, 1636425336494, 636, 270, 366, 0, 0, 0
5649, 1, 1636425335863, 1636425336786, 923, 562, 361, 1, 0, 1
5650, 1, 1636425336245, 1636425336862, 617, 265, 352, 0, 1, 1
5651, 1, 1636425336434, 1636425337066, 632, 270, 362, 2, 0, 2
5652, 1, 1636425336435, 1636425337066, 631, 270, 361, 0, 0, 0
5654, 1, 1636425336795, 1636425337422, 627, 273, 354, 1, 0, 1
5653, 1, 1636425336448, 1636425337522, 1074, 721, 353, 0, 0, 0
5655, 1, 1636425337096, 1636425337722, 626, 271, 355, 0, 0, 0
5656, 1, 1636425337439, 1636425338178, 739, 380, 359, 0, 0, 0
5657, 1, 1636425338276, 1636425338910, 634, 270, 364, 1, 0, 1
5658, 1, 1636425338801, 1636425339434, 633, 269, 364, 0, 0, 0
5659, 1, 1636425338914, 1636425339538, 624, 269, 355, 0, 0, 0
5660, 1, 1636425338992, 1636425339618, 626, 270, 356, 0, 0, 0
5661, 1, 1636425339057, 1636425339678, 621, 266, 355, 2, 0, 2
5662, 1, 1636425339207, 1636425340070, 863, 506, 357, 0, 0, 0
5663, 1, 1636425339795, 1636425340522, 727, 371, 356, 2, 1, 3
5664, 1, 1636425339976, 1636425340602, 626, 271, 355, 1, 0, 1
5665, 1, 1636425339985, 1636425340626, 641, 265, 376, 1, 0, 1
5666, 1, 1636425340268, 1636425340898, 630, 271, 359, 0, 1, 1
5667, 1, 1636425340494, 1636425341122, 628, 270, 358, 1, 1, 2
5669, 1, 1636425340796, 1636425341422, 626, 270, 356, 1, 0, 1
5670, 1, 1636425340849, 1636425341478, 629, 271, 358, 1, 1, 2
5668, 1, 1636425340595, 1636425341582, 987, 627, 360, 0, 0, 0
5671, 1, 1636425341145, 1636425341934, 789, 425, 364, 0, 1, 1
5672, 1, 1636425341960, 1636425342586, 626, 270, 356, 1, 1, 2
5633, 2, 1636425332574, 1636425342776, 10202, 2, 10200, 1, 0, 1
5635, 2, 1636425332814, 1636425342993, 10179, 0, 10179, 0, 0, 0
5674, 1, 1636425342678, 1636425343350, 672, 306, 366, 0, 40, 40
5675, 1, 1636425342993, 1636425343614, 621, 266, 355, 0, 0, 0
5676, 1, 1636425343110, 1636425343734, 624, 265, 359, 0, 0, 0
5638, 2, 1636425333574, 1636425343752, 10178, 0, 10178, 0, 0, 0
5677, 1, 1636425343230, 1636425343898, 668, 271, 397, 2, 0, 2
5679, 1, 1636425343513, 1636425344142, 629, 272, 357, 0, 1, 1
5680, 1, 1636425343689, 1636425344334, 645, 264, 381, 0, 0, 0
5678, 1, 1636425343231, 1636425344354, 1123, 726, 397, 1, 0, 1
5641, 2, 1636425334278, 1636425344453, 10175, 0, 10175, 0, 0, 0
5683, 1, 1636425343950, 1636425344578, 628, 270, 358, 1, 0, 1
5681, 1, 1636425343875, 1636425344586, 711, 359, 352, 1, 0, 1
5682, 1, 1636425343886, 1636425344814, 928, 526, 402, 1, 7, 8
5684, 1, 1636425344215, 1636425344838, 623, 270, 353, 1, 0, 1
5644, 1, 1636425335010, 1636425344950, 9940, 9534, 406, 1, 0, 1
5686, 1, 1636425344607, 1636425345234, 627, 270, 357, 0, 0, 0
5685, 1, 1636425344578, 1636425345262, 684, 291, 393, 0, 0, 0
5687, 1, 1636425344708, 1636425345334, 626, 270, 356, 0, 0, 0
5688, 1, 1636425344729, 1636425345682, 953, 593, 360, 0, 0, 0
5690, 1, 1636425345087, 1636425345714, 627, 270, 357, 0, 0, 0
5689, 1, 1636425344952, 1636425345718, 766, 360, 406, 0, 0, 0
5691, 1, 1636425345158, 1636425346174, 1016, 653, 363, 1, 0, 1
5692, 1, 1636425346139, 1636425346775, 636, 271, 365, 1, 1, 2
5693, 1, 1636425346813, 1636425347442, 629, 271, 358, 0, 0, 0
5694, 1, 1636425346843, 1636425347466, 623, 270, 353, 0, 0, 0
5695, 1, 1636425346905, 1636425347542, 637, 274, 363, 0, 0, 0
5696, 1, 1636425347060, 1636425347686, 626, 270, 356, 1, 0, 1
5698, 1, 1636425347426, 1636425348054, 628, 270, 358, 0, 0, 0
5697, 1, 1636425347178, 1636425348138, 960, 602, 358, 0, 0, 0
5700, 1, 1636425347812, 1636425348438, 626, 265, 361, 0, 1, 1
5699, 1, 1636425347576, 1636425348502, 926, 570, 356, 1, 0, 1
5702, 1, 1636425347915, 1636425348546, 631, 275, 356, 1, 0, 1
5701, 1, 1636425347821, 1636425348586, 765, 408, 357, 0, 0, 0
5703, 1, 1636425348332, 1636425348958, 626, 270, 356, 0, 0, 0
5704, 1, 1636425348369, 1636425349046, 677, 315, 362, 0, 0, 0
5705, 1, 1636425348675, 1636425349306, 631, 273, 358, 0, 0, 0
5706, 1, 1636425348870, 1636425349498, 628, 271, 357, 2, 1, 3
5707, 1, 1636425348926, 1636425349554, 628, 269, 359, 0, 0, 0
5709, 1, 1636425349204, 1636425349834, 630, 270, 360, 0, 0, 0
5708, 1, 1636425348938, 1636425350010, 1072, 710, 362, 2, 0, 2
5710, 1, 1636425349304, 1636425350286, 982, 628, 354, 0, 2, 2
5711, 1, 1636425350394, 1636425351026, 632, 269, 363, 1, 1, 2
5712, 1, 1636425350775, 1636425351398, 623, 266, 357, 0, 0, 0
5713, 1, 1636425350874, 1636425351510, 636, 270, 366, 0, 0, 0
5714, 1, 1636425350902, 1636425351518, 616, 259, 357, 0, 0, 0
5715, 1, 1636425351063, 1636425351846, 783, 426, 357, 0, 0, 0
5716, 1, 1636425351130, 1636425351966, 836, 472, 364, 0, 0, 0
5717, 1, 1636425351341, 1636425351970, 629, 267, 362, 2, 0, 2
5719, 1, 1636425351720, 1636425352342, 622, 266, 356, 0, 0, 0
5718, 1, 1636425351343, 1636425352418, 1075, 718, 357, 0, 0, 0
5673, 2, 1636425342559, 1636425352693, 10134, 1, 10133, 1, 1, 2
5720, 1, 1636425352082, 1636425352706, 624, 270, 354, 0, 0, 0
5721, 1, 1636425352171, 1636425352794, 623, 266, 357, 1, 0, 1
5722, 1, 1636425352253, 1636425352874, 621, 270, 351, 0, 0, 0
5724, 1, 1636425352601, 1636425353230, 629, 311, 318, 49, 0, 49
5726, 1, 1636425352624, 1636425353274, 650, 268, 382, 2, 0, 2
5725, 1, 1636425352619, 1636425353274, 655, 269, 386, 2, 0, 2
5723, 1, 1636425352585, 1636425353318, 733, 354, 379, 0, 0, 0
5728, 1, 1636425352826, 1636425353498, 672, 270, 402, 0, 0, 0
5727, 1, 1636425352693, 1636425353678, 985, 626, 359, 1, 0, 1
5729, 1, 1636425353388, 1636425354014, 626, 270, 356, 2, 0, 2
5730, 1, 1636425353526, 1636425354462, 936, 582, 354, 0, 1, 1
5731, 1, 1636425354685, 1636425355322, 637, 270, 367, 1, 0, 1
5732, 1, 1636425354788, 1636425355422, 634, 274, 360, 2, 0, 2
5733, 1, 1636425355072, 1636425355690, 618, 267, 351, 0, 1, 1
5734, 1, 1636425355131, 1636425355758, 627, 271, 356, 0, 0, 0
5736, 1, 1636425355284, 1636425355906, 622, 268, 354, 2, 1, 3
5738, 1, 1636425355305, 1636425355930, 625, 270, 355, 1, 0, 1
5735, 1, 1636425355140, 1636425356142, 1002, 646, 356, 1, 1, 2
5737, 1, 1636425355297, 1636425356354, 1057, 695, 362, 2, 0, 2
5739, 1, 1636425355993, 1636425356626, 633, 269, 364, 0, 0, 0
5740, 1, 1636425356018, 1636425356642, 624, 270, 354, 1, 0, 1
5741, 1, 1636425356255, 1636425356886, 631, 270, 361, 1, 1, 2
5742, 1, 1636425356381, 1636425357014, 633, 269, 364, 0, 0, 0
5743, 1, 1636425356499, 1636425357126, 627, 276, 351, 0, 1, 1
5744, 1, 1636425356551, 1636425357170, 619, 266, 353, 0, 1, 1
5747, 1, 1636425356775, 1636425357406, 631, 269, 362, 0, 0, 0
5745, 1, 1636425356599, 1636425357570, 971, 617, 354, 1, 0, 1
5746, 1, 1636425356644, 1636425357614, 970, 617, 353, 0, 0, 0
5748, 1, 1636425357020, 1636425357642, 622, 269, 353, 0, 0, 0
5749, 1, 1636425357154, 1636425357782, 628, 269, 359, 0, 0, 0
5750, 1, 1636425357373, 1636425358238, 865, 501, 364, 0, 0, 0
5751, 1, 1636425359001, 1636425359626, 625, 270, 355, 1, 0, 1
5752, 1, 1636425359017, 1636425359638, 621, 269, 352, 0, 0, 0
5753, 1, 1636425359166, 1636425359794, 628, 269, 359, 0, 0, 0
5755, 1, 1636425359214, 1636425359850, 636, 273, 363, 1, 0, 1
5756, 1, 1636425359397, 1636425360082, 685, 322, 363, 0, 0, 0
5758, 1, 1636425359617, 1636425360242, 625, 270, 355, 1, 0, 1
5754, 1, 1636425359207, 1636425360242, 1035, 682, 353, 1, 0, 1
5759, 1, 1636425359788, 1636425360418, 630, 271, 359, 1, 1, 2
5757, 1, 1636425359482, 1636425360530, 1048, 692, 356, 0, 1, 1
5760, 1, 1636425360176, 1636425360806, 630, 270, 360, 0, 1, 1
5761, 1, 1636425360398, 1636425361026, 628, 270, 358, 0, 0, 0
5763, 1, 1636425360573, 1636425361202, 629, 269, 360, 0, 0, 0
5764, 1, 1636425360587, 1636425361218, 631, 269, 362, 0, 0, 0
5765, 1, 1636425360644, 1636425361266, 622, 269, 353, 0, 0, 0
5766, 1, 1636425360790, 1636425361422, 632, 270, 362, 0, 0, 0
5762, 1, 1636425360497, 1636425361474, 977, 617, 360, 1, 0, 1
5767, 1, 1636425360915, 1636425361714, 799, 441, 358, 0, 0, 0
5768, 1, 1636425361230, 1636425361854, 624, 267, 357, 1, 0, 1
5769, 1, 1636425361373, 1636425362002, 629, 269, 360, 0, 0, 0
5770, 1, 1636425361481, 1636425362454, 973, 614, 359, 0, 2, 2
5771, 1, 1636425362954, 1636425363582, 628, 270, 358, 0, 1, 1
5772, 1, 1636425363278, 1636425363902, 624, 268, 356, 2, 1, 3
5773, 1, 1636425363373, 1636425364006, 633, 270, 363, 0, 0, 0
5776, 1, 1636425363546, 1636425364178, 632, 270, 362, 1, 0, 1
5777, 1, 1636425363554, 1636425364190, 636, 274, 362, 0, 0, 0
5778, 1, 1636425363706, 1636425364334, 628, 271, 357, 2, 0, 2
5774, 1, 1636425363420, 1636425364358, 938, 582, 356, 0, 0, 0
5775, 1, 1636425363450, 1636425364454, 1004, 654, 350, 0, 0, 0
5779, 1, 1636425363935, 1636425364814, 879, 519, 360, 0, 1, 1
5781, 1, 1636425364263, 1636425364886, 623, 266, 357, 1, 1, 2
5780, 1, 1636425364206, 1636425364910, 704, 342, 362, 0, 1, 1
5783, 1, 1636425364527, 1636425365158, 631, 268, 363, 0, 0, 0
5784, 1, 1636425364633, 1636425365262, 629, 270, 359, 1, 0, 1
5782, 1, 1636425364492, 1636425365342, 850, 493, 357, 1, 0, 1
5785, 1, 1636425364928, 1636425365554, 626, 270, 356, 0, 0, 0
5787, 1, 1636425365058, 1636425365690, 632, 271, 361, 1, 0, 1
5788, 1, 1636425365124, 1636425365758, 634, 274, 360, 0, 0, 0
5786, 1, 1636425364957, 1636425366010, 1053, 694, 359, 0, 0, 0
5789, 1, 1636425365433, 1636425366058, 625, 267, 358, 2, 1, 3
5790, 1, 1636425365731, 1636425366514, 783, 423, 360, 1, 0, 1
5791, 1, 1636425367149, 1636425367778, 629, 270, 359, 2, 0, 2
5792, 1, 1636425367263, 1636425367882, 619, 270, 349, 0, 1, 1
5795, 1, 1636425367429, 1636425368058, 629, 273, 356, 0, 0, 0
5796, 1, 1636425367486, 1636425368110, 624, 267, 357, 1, 0, 1
5793, 1, 1636425367289, 1636425368226, 937, 578, 359, 2, 0, 2
5798, 1, 1636425367663, 1636425368338, 675, 314, 361, 1, 0, 1
5799, 1, 1636425367884, 1636425368678, 794, 438, 356, 0, 0, 0
5794, 1, 1636425367295, 1636425368790, 1495, 1138, 357, 1, 0, 1
5801, 1, 1636425368398, 1636425369026, 628, 268, 360, 0, 0, 0
5804, 1, 1636425368760, 1636425369386, 626, 270, 356, 1, 0, 1
5805, 1, 1636425368766, 1636425369398, 632, 275, 357, 0, 0, 0
5802, 1, 1636425368515, 1636425369478, 963, 607, 356, 1, 1, 2
5808, 1, 1636425368988, 1636425369618, 630, 270, 360, 1, 0, 1
5806, 1, 1636425368775, 1636425369858, 1083, 722, 361, 0, 0, 0
5809, 1, 1636425369486, 1636425370114, 628, 270, 358, 2, 1, 3
5810, 1, 1636425369747, 1636425370566, 819, 459, 360, 0, 0, 0
5811, 1, 1636425371008, 1636425371634, 626, 270, 356, 0, 0, 0
5812, 1, 1636425371064, 1636425372078, 1014, 662, 352, 1, 0, 1
5814, 1, 1636425371456, 1636425372082, 626, 270, 356, 3, 0, 3
5815, 1, 1636425371498, 1636425372122, 624, 268, 356, 0, 0, 0
5818, 1, 1636425371878, 1636425372534, 656, 294, 362, 0, 0, 0
5819, 1, 1636425372099, 1636425372730, 631, 270, 361, 0, 0, 0
5821, 1, 1636425372504, 1636425373130, 626, 269, 357, 0, 0, 0
5822, 1, 1636425372525, 1636425373154, 629, 266, 363, 1, 1, 2
5820, 1, 1636425372344, 1636425373182, 838, 482, 356, 0, 1, 1
5823, 1, 1636425372702, 1636425373582, 880, 523, 357, 2, 0, 2
5824, 1, 1636425373225, 1636425373854, 629, 269, 360, 1, 0, 1
5825, 1, 1636425373250, 1636425373878, 628, 266, 362, 2, 0, 2
5826, 1, 1636425373545, 1636425374334, 789, 421, 368, 1, 0, 1
5827, 1, 1636425375016, 1636425375642, 626, 272, 354, 0, 1, 1
5829, 1, 1636425375273, 1636425375902, 629, 270, 359, 1, 0, 1
5828, 1, 1636425375210, 1636425376094, 884, 527, 357, 1, 0, 1
5830, 1, 1636425375829, 1636425376462, 633, 268, 365, 0, 0, 0
5831, 1, 1636425375899, 1636425376526, 627, 269, 358, 0, 1, 1
5832, 1, 1636425376207, 1636425376834, 627, 271, 356, 1, 0, 1
5833, 1, 1636425376213, 1636425376982, 769, 402, 367, 0, 0, 0
5835, 1, 1636425376586, 1636425377218, 632, 270, 362, 0, 0, 0
5834, 1, 1636425376510, 1636425377294, 784, 422, 362, 0, 1, 1
5836, 1, 1636425376720, 1636425377746, 1026, 670, 356, 1, 0, 1
5797, 2, 1636425367613, 1636425377749, 10136, 0, 10136, 0, 0, 0
5837, 1, 1636425377265, 1636425377902, 637, 273, 364, 0, 0, 0
5838, 1, 1636425377428, 1636425378058, 630, 269, 361, 1, 0, 1
5800, 2, 1636425368345, 1636425378481, 10136, 0, 10136, 0, 0, 0
5839, 1, 1636425377814, 1636425378518, 704, 340, 364, 1, 0, 1
5803, 2, 1636425368586, 1636425378721, 10135, 0, 10135, 0, 0, 0
5807, 2, 1636425368815, 1636425378949, 10134, 1, 10133, 0, 0, 0
5817, 1, 1636425371795, 1636425379222, 7427, 7065, 362, 0, 7, 7
5842, 1, 1636425378883, 1636425379550, 667, 271, 396, 1, 0, 1
5840, 1, 1636425378882, 1636425379558, 676, 271, 405, 2, 0, 2
5843, 1, 1636425379082, 1636425379746, 664, 266, 398, 0, 1, 1
5845, 1, 1636425379256, 1636425379886, 630, 270, 360, 0, 0, 0
5846, 1, 1636425379271, 1636425380010, 739, 382, 357, 1, 0, 1
5848, 1, 1636425379809, 1636425380438, 629, 265, 364, 0, 0, 0
5847, 1, 1636425379439, 1636425380466, 1027, 667, 360, 0, 1, 1
5849, 1, 1636425379929, 1636425380558, 629, 271, 358, 1, 0, 1
5850, 1, 1636425380412, 1636425381034, 622, 270, 352, 0, 0, 0
5851, 1, 1636425380463, 1636425381078, 615, 261, 354, 1, 0, 1
5813, 2, 1636425371111, 1636425381249, 10138, 0, 10138, 0, 0, 0
5854, 1, 1636425380843, 1636425381514, 671, 268, 403, 1, 0, 1
5853, 1, 1636425380799, 1636425381534, 735, 373, 362, 0, 1, 1
5816, 2, 1636425371504, 1636425381637, 10133, 0, 10133, 0, 1, 1
5852, 1, 1636425380751, 1636425381998, 1247, 887, 360, 2, 17, 19
5855, 1, 1636425381378, 1636425382082, 704, 307, 397, 0, 41, 41
5856, 1, 1636425381587, 1636425382214, 627, 265, 362, 0, 0, 0
5857, 1, 1636425381684, 1636425382310, 626, 273, 353, 0, 0, 0
5858, 1, 1636425381766, 1636425382530, 764, 367, 397, 0, 1, 1
5859, 1, 1636425381923, 1636425382762, 839, 478, 361, 1, 0, 1
5860, 1, 1636425382954, 1636425383586, 632, 270, 362, 0, 0, 0
5861, 1, 1636425383029, 1636425383658, 629, 268, 361, 0, 0, 0
5864, 1, 1636425383323, 1636425383954, 631, 272, 359, 0, 0, 0
5865, 1, 1636425383363, 1636425383990, 627, 269, 358, 0, 0, 0
5866, 1, 1636425383707, 1636425384334, 627, 271, 356, 1, 0, 1
5867, 1, 1636425383732, 1636425384362, 630, 274, 356, 0, 0, 0
5869, 1, 1636425384249, 1636425384878, 629, 270, 359, 3, 0, 3
5872, 1, 1636425384965, 1636425385590, 625, 266, 359, 0, 1, 1
5873, 1, 1636425385353, 1636425385978, 625, 266, 359, 1, 1, 2
5874, 1, 1636425385487, 1636425386118, 631, 274, 357, 0, 0, 0
5875, 1, 1636425385766, 1636425386390, 624, 268, 356, 1, 2, 3
5876, 1, 1636425385898, 1636425386574, 676, 315, 361, 1, 0, 1
5877, 1, 1636425386109, 1636425386842, 733, 374, 359, 1, 0, 1
5878, 1, 1636425386767, 1636425387398, 631, 270, 361, 0, 1, 1
5879, 1, 1636425387223, 1636425387850, 627, 269, 358, 0, 0, 0
5880, 1, 1636425387286, 1636425387914, 628, 269, 359, 0, 0, 0
5881, 1, 1636425387561, 1636425388190, 629, 271, 358, 1, 0, 1
5882, 1, 1636425387573, 1636425388202, 629, 269, 360, 0, 1, 1
5883, 1, 1636425387705, 1636425388326, 621, 261, 360, 1, 0, 1
5884, 1, 1636425388077, 1636425388706, 629, 268, 361, 0, 0, 0
5841, 2, 1636425378883, 1636425389065, 10182, 1, 10181, 0, 1, 1
5844, 2, 1636425379224, 1636425389401, 10177, 0, 10177, 0, 0, 0
5885, 1, 1636425389277, 1636425389934, 657, 268, 389, 1, 0, 1
5887, 1, 1636425389572, 1636425390198, 626, 271, 355, 0, 0, 0
5886, 1, 1636425389530, 1636425390202, 672, 271, 401, 1, 0, 1
5889, 1, 1636425389671, 1636425390298, 627, 270, 357, 0, 0, 0
5888, 1, 1636425389642, 1636425390654, 1012, 615, 397, 0, 2, 2
5890, 1, 1636425390078, 1636425390698, 620, 266, 354, 0, 0, 0
5891, 1, 1636425390206, 1636425390830, 624, 269, 355, 1, 0, 1
5892, 1, 1636425390347, 1636425391150, 803, 446, 357, 1, 0, 1
5893, 1, 1636425390582, 1636425391222, 640, 272, 368, 1, 0, 1
5894, 1, 1636425390888, 1636425391518, 630, 270, 360, 0, 0, 0
5895, 1, 1636425391468, 1636425392094, 626, 266, 360, 1, 1, 2
5896, 1, 1636425391558, 1636425392194, 636, 277, 359, 0, 0, 0
5897, 1, 1636425391570, 1636425392194, 624, 269, 355, 0, 0, 0
5898, 1, 1636425391712, 1636425392326, 614, 262, 352, 0, 0, 0
5899, 1, 1636425391759, 1636425392642, 883, 522, 361, 0, 0, 0
5862, 2, 1636425383187, 1636425393321, 10134, 0, 10134, 0, 0, 0
5863, 2, 1636425383257, 1636425393389, 10132, 1, 10131, 2, 0, 2
5900, 1, 1636425393128, 1636425393778, 650, 286, 364, 0, 16, 16
5901, 1, 1636425393553, 1636425394182, 629, 270, 359, 0, 0, 0
5902, 1, 1636425393566, 1636425394194, 628, 267, 361, 0, 0, 0
5903, 1, 1636425393602, 1636425394226, 624, 263, 361, 1, 1, 2
5868, 2, 1636425384147, 1636425394281, 10134, 0, 10134, 1, 0, 1
5904, 1, 1636425393678, 1636425394350, 672, 271, 401, 0, 1, 1
5906, 1, 1636425393750, 1636425394642, 892, 529, 363, 0, 7, 7
5907, 1, 1636425394016, 1636425394642, 626, 270, 356, 1, 3, 4
5909, 1, 1636425394101, 1636425394730, 629, 273, 356, 1, 3, 4
5905, 1, 1636425393682, 1636425394802, 1120, 714, 406, 0, 0, 0
5870, 2, 1636425384697, 1636425394833, 10136, 0, 10136, 0, 0, 0
5871, 2, 1636425384784, 1636425394917, 10133, 1, 10132, 0, 0, 0
5910, 1, 1636425394402, 1636425395030, 628, 266, 362, 0, 0, 0
5908, 1, 1636425394079, 1636425395102, 1023, 666, 357, 0, 7, 7
5911, 1, 1636425394426, 1636425395286, 860, 458, 402, 1, 31, 32
5915, 1, 1636425395220, 1636425395850, 630, 264, 366, 0, 0, 0
5916, 1, 1636425395527, 1636425396158, 631, 274, 357, 0, 1, 1
5917, 1, 1636425395705, 1636425396334, 629, 270, 359, 1, 0, 1
5918, 1, 1636425395765, 1636425396402, 637, 274, 363, 1, 0, 1
5919, 1, 1636425396004, 1636425396858, 854, 493, 361, 0, 0, 0
5920, 1, 1636425397132, 1636425397758, 626, 271, 355, 1, 1, 2
5921, 1, 1636425397320, 1636425397942, 622, 267, 355, 0, 1, 1
5922, 1, 1636425397655, 1636425398282, 627, 270, 357, 0, 0, 0
5923, 1, 1636425397811, 1636425398438, 627, 270, 357, 0, 0, 0
5926, 1, 1636425397858, 1636425398486, 628, 270, 358, 0, 0, 0
5925, 1, 1636425397853, 1636425398490, 637, 270, 367, 1, 0, 1
5928, 1, 1636425398111, 1636425398734, 623, 267, 356, 0, 0, 0
5924, 1, 1636425397848, 1636425398886, 1038, 681, 357, 0, 1, 1
5929, 1, 1636425398289, 1636425398918, 629, 270, 359, 0, 0, 0
5927, 1, 1636425397898, 1636425398930, 1032, 674, 358, 1, 0, 1
5930, 1, 1636425398325, 1636425399186, 861, 502, 359, 0, 0, 0
5931, 1, 1636425398654, 1636425399382, 728, 370, 358, 1, 0, 1
5932, 1, 1636425399438, 1636425400070, 632, 270, 362, 0, 1, 1
5933, 1, 1636425399458, 1636425400086, 628, 265, 363, 0, 0, 0
5934, 1, 1636425399516, 1636425400142, 626, 265, 361, 0, 0, 0
5935, 1, 1636425399939, 1636425400566, 627, 271, 356, 0, 0, 0
5936, 1, 1636425400024, 1636425401022, 998, 637, 361, 0, 0, 0
5937, 1, 1636425401367, 1636425401990, 623, 266, 357, 2, 0, 2
5938, 1, 1636425401420, 1636425402050, 630, 273, 357, 0, 1, 1
5939, 1, 1636425401559, 1636425402182, 623, 270, 353, 0, 0, 0
5941, 1, 1636425401707, 1636425402334, 627, 270, 357, 0, 0, 0
5942, 1, 1636425401765, 1636425402502, 737, 378, 359, 0, 0, 0
5944, 1, 1636425402090, 1636425402718, 628, 270, 358, 0, 0, 0
5943, 1, 1636425401799, 1636425402782, 983, 626, 357, 1, 0, 1
5945, 1, 1636425402308, 1636425402926, 618, 263, 355, 0, 0, 0
5940, 1, 1636425401650, 1636425402946, 1296, 938, 358, 0, 0, 0
5946, 1, 1636425402346, 1636425402970, 624, 267, 357, 1, 0, 1
5947, 1, 1636425402419, 1636425403394, 975, 618, 357, 1, 0, 1
5948, 1, 1636425402471, 1636425403418, 947, 584, 363, 0, 0, 0
5949, 1, 1636425403297, 1636425403926, 629, 270, 359, 2, 0, 2
5950, 1, 1636425403576, 1636425404202, 626, 269, 357, 0, 0, 0
5951, 1, 1636425403914, 1636425404658, 744, 382, 362, 0, 0, 0
5952, 1, 1636425404052, 1636425404678, 626, 270, 356, 1, 0, 1
5912, 2, 1636425394946, 1636425405081, 10135, 0, 10135, 0, 0, 0
5953, 1, 1636425404214, 1636425405138, 924, 562, 362, 0, 0, 0
5913, 2, 1636425395002, 1636425405177, 10175, 0, 10175, 0, 0, 0
5914, 2, 1636425395006, 1636425405221, 10215, 0, 10215, 0, 0, 0
5954, 1, 1636425405222, 1636425405890, 668, 271, 397, 1, 1, 2
5955, 1, 1636425405310, 1636425405986, 676, 279, 397, 0, 6, 6
5957, 1, 1636425405481, 1636425406110, 629, 269, 360, 0, 0, 0
5958, 1, 1636425405675, 1636425406298, 623, 267, 356, 1, 0, 1
5959, 1, 1636425405698, 1636425406326, 628, 267, 361, 1, 0, 1
5956, 1, 1636425405350, 1636425406438, 1088, 690, 398, 1, 0, 1
5960, 1, 1636425405811, 1636425406438, 627, 269, 358, 0, 0, 0
5961, 1, 1636425405889, 1636425406522, 633, 275, 358, 0, 0, 0
5964, 1, 1636425406208, 1636425406834, 626, 274, 352, 0, 0, 0
5963, 1, 1636425406012, 1636425406886, 874, 522, 352, 0, 0, 0
5962, 1, 1636425405950, 1636425406970, 1020, 665, 355, 0, 0, 0
5965, 1, 1636425406348, 1636425406974, 626, 269, 357, 1, 0, 1
5967, 1, 1636425406678, 1636425407302, 624, 262, 362, 0, 0, 0
5966, 1, 1636425406449, 1636425407346, 897, 534, 363, 0, 0, 0
5968, 1, 1636425406720, 1636425407758, 1038, 678, 360, 0, 1, 1
5969, 1, 1636425407328, 1636425407958, 630, 269, 361, 0, 0, 0
5970, 1, 1636425407721, 1636425408354, 633, 269, 364, 0, 1, 1
5971, 1, 1636425407868, 1636425408490, 622, 270, 352, 1, 1, 2
5972, 1, 1636425407986, 1636425408810, 824, 466, 358, 0, 0, 0
5973, 1, 1636425408289, 1636425408914, 625, 270, 355, 0, 0, 0
5974, 1, 1636425409101, 1636425409722, 621, 269, 352, 0, 0, 0
5975, 1, 1636425409373, 1636425409994, 621, 267, 354, 0, 0, 0
5976, 1, 1636425409475, 1636425410090, 615, 263, 352, 0, 0, 0
5978, 1, 1636425409737, 1636425410366, 629, 266, 363, 0, 0, 0
5977, 1, 1636425409508, 1636425410542, 1034, 677, 357, 0, 0, 0
5979, 1, 1636425409968, 1636425410590, 622, 270, 352, 0, 0, 0
5980, 1, 1636425410039, 1636425410674, 635, 274, 361, 0, 1, 1
5982, 1, 1636425410133, 1636425410758, 625, 270, 355, 1, 0, 1
5985, 1, 1636425410353, 1636425410982, 629, 270, 359, 0, 0, 0
5984, 1, 1636425410182, 1636425411126, 944, 581, 363, 0, 0, 0
5986, 1, 1636425410499, 1636425411130, 631, 270, 361, 1, 0, 1
5983, 1, 1636425410164, 1636425411206, 1042, 686, 356, 0, 0, 0
5987, 1, 1636425410682, 1636425411430, 748, 390, 358, 0, 0, 0
5988, 1, 1636425410689, 1636425411658, 969, 605, 364, 0, 0, 0
5989, 1, 1636425411131, 1636425411758, 627, 270, 357, 0, 0, 0
5990, 1, 1636425411637, 1636425412266, 629, 269, 360, 0, 0, 0
5991, 1, 1636425411749, 1636425412382, 633, 274, 359, 0, 0, 0
5992, 1, 1636425412204, 1636425412830, 626, 270, 356, 0, 0, 0
5993, 1, 1636425412594, 1636425413226, 632, 269, 363, 0, 0, 0
5994, 1, 1636425412781, 1636425413410, 629, 270, 359, 1, 0, 1
5995, 1, 1636425413277, 1636425413906, 629, 268, 361, 0, 0, 0
5996, 1, 1636425413585, 1636425414218, 633, 268, 365, 0, 0, 0
5998, 1, 1636425413735, 1636425414366, 631, 271, 360, 0, 1, 1
5999, 1, 1636425414008, 1636425414638, 630, 274, 356, 1, 0, 1
6000, 1, 1636425414028, 1636425414658, 630, 270, 360, 0, 1, 1
5997, 1, 1636425413701, 1636425414662, 961, 605, 356, 0, 0, 0
6001, 1, 1636425414061, 1636425414682, 621, 266, 355, 0, 0, 0
6004, 1, 1636425414258, 1636425414890, 632, 274, 358, 1, 0, 1
6005, 1, 1636425414365, 1636425414990, 625, 274, 351, 0, 0, 0
6003, 1, 1636425414113, 1636425415082, 969, 611, 358, 0, 0, 0
6006, 1, 1636425414463, 1636425415130, 667, 307, 360, 0, 1, 1
6007, 1, 1636425414567, 1636425415338, 771, 414, 357, 0, 1, 1
6002, 1, 1636425414081, 1636425415582, 1501, 1139, 362, 1, 0, 1
6008, 1, 1636425414992, 1636425415618, 626, 270, 356, 0, 2, 2
6009, 1, 1636425415522, 1636425416146, 624, 266, 358, 0, 0, 0
6010, 1, 1636425415829, 1636425416458, 629, 271, 358, 1, 0, 1
6011, 1, 1636425415922, 1636425416598, 676, 313, 363, 0, 0, 0
6012, 1, 1636425416492, 1636425417122, 630, 269, 361, 0, 1, 1
6013, 1, 1636425416782, 1636425417414, 632, 268, 364, 0, 0, 0
6014, 1, 1636425417110, 1636425417738, 628, 266, 362, 0, 1, 1
6015, 1, 1636425417400, 1636425418022, 622, 267, 355, 0, 1, 1
6016, 1, 1636425417493, 1636425418482, 989, 626, 363, 1, 0, 1
6017, 1, 1636425417928, 1636425418554, 626, 269, 357, 1, 0, 1
6018, 1, 1636425418091, 1636425418718, 627, 272, 355, 1, 2, 3
6020, 1, 1636425418114, 1636425418746, 632, 270, 362, 1, 0, 1
6023, 1, 1636425418361, 1636425418990, 629, 270, 359, 1, 0, 1
6024, 1, 1636425418484, 1636425419170, 686, 330, 356, 0, 0, 0
6022, 1, 1636425418315, 1636425419198, 883, 530, 353, 2, 0, 2
6025, 1, 1636425418584, 1636425419218, 634, 270, 364, 0, 0, 0
6027, 1, 1636425418987, 1636425419618, 631, 269, 362, 0, 0, 0
6026, 1, 1636425418688, 1636425419650, 962, 606, 356, 1, 0, 1
5981, 2, 1636425410114, 1636425420249, 10135, 1, 10134, 0, 0, 0
6028, 1, 1636425419651, 1636425420274, 623, 269, 354, 1, 0, 1
6029, 1, 1636425419860, 1636425420518, 658, 302, 356, 2, 32, 34
6030, 1, 1636425420135, 1636425420786, 651, 267, 384, 0, 0, 0
6031, 1, 1636425420378, 1636425421054, 676, 271, 405, 2, 0, 2
6032, 1, 1636425420660, 1636425421286, 626, 270, 356, 0, 1, 1
6033, 1, 1636425420678, 1636425421306, 628, 266, 362, 0, 0, 0
6034, 1, 1636425420975, 1636425421602, 627, 269, 358, 1, 0, 1
6035, 1, 1636425421578, 1636425422210, 632, 269, 363, 1, 0, 1
6038, 1, 1636425421958, 1636425422578, 620, 270, 350, 0, 0, 0
6037, 1, 1636425421955, 1636425422590, 635, 272, 363, 0, 0, 0
6036, 1, 1636425421650, 1636425422658, 1008, 652, 356, 1, 1, 2
6039, 1, 1636425422301, 1636425422922, 621, 270, 351, 1, 0, 1
6040, 1, 1636425422318, 1636425422938, 620, 266, 354, 0, 0, 0
6041, 1, 1636425422442, 1636425423070, 628, 269, 359, 1, 0, 1
6043, 1, 1636425422643, 1636425423274, 631, 272, 359, 1, 1, 2
6042, 1, 1636425422597, 1636425423386, 789, 429, 360, 0, 0, 0
6045, 1, 1636425423194, 1636425423814, 620, 267, 353, 1, 0, 1
6044, 1, 1636425422889, 1636425423834, 945, 586, 359, 0, 0, 0
6046, 1, 1636425423590, 1636425424214, 624, 266, 358, 0, 1, 1
6048, 1, 1636425424034, 1636425424666, 632, 269, 363, 0, 0, 0
6047, 1, 1636425423875, 1636425424666, 791, 435, 356, 0, 0, 0
6049, 1, 1636425424499, 1636425425118, 619, 266, 353, 0, 0, 0
6050, 1, 1636425424626, 1636425425254, 628, 269, 359, 0, 0, 0
6051, 1, 1636425424985, 1636425425614, 629, 270, 359, 0, 0, 0
6052, 1, 1636425425111, 1636425425742, 631, 269, 362, 0, 0, 0
6053, 1, 1636425425646, 1636425426282, 636, 270, 366, 1, 0, 1
6055, 1, 1636425426010, 1636425426646, 636, 270, 366, 2, 0, 2
6056, 1, 1636425426073, 1636425426702, 629, 270, 359, 0, 1, 1
6054, 1, 1636425425667, 1636425426734, 1067, 703, 364, 0, 0, 0
6057, 1, 1636425426145, 1636425426766, 621, 263, 358, 0, 0, 0
6059, 1, 1636425426577, 1636425427210, 633, 270, 363, 1, 0, 1
6058, 1, 1636425426573, 1636425427222, 649, 286, 363, 1, 1, 2
6060, 1, 1636425426610, 1636425427238, 628, 265, 363, 0, 0, 0
6062, 1, 1636425426771, 1636425427398, 627, 270, 357, 1, 0, 1
6061, 1, 1636425426636, 1636425427678, 1042, 683, 359, 2, 0, 2
6063, 1, 1636425427362, 1636425427990, 628, 269, 359, 0, 0, 0
6019, 2, 1636425418114, 1636425428249, 10135, 1, 10134, 1, 0, 1
6021, 2, 1636425418129, 1636425428293, 10164, 0, 10164, 0, 0, 0
6065, 1, 1636425427719, 1636425428338, 619, 270, 349, 0, 0, 0
6064, 1, 1636425427718, 1636425428346, 628, 271, 357, 2, 1, 3
6066, 1, 1636425427934, 1636425428798, 864, 501, 363, 0, 0, 0
6067, 1, 1636425428382, 1636425429050, 668, 266, 402, 2, 0, 2
6069, 1, 1636425428608, 1636425429230, 622, 266, 356, 1, 0, 1
6070, 1, 1636425428621, 1636425429254, 633, 270, 363, 0, 0, 0
6068, 1, 1636425428394, 1636425429502, 1108, 711, 397, 2, 1, 3
6071, 1, 1636425428922, 1636425429954, 1032, 673, 359, 0, 0, 0
6072, 1, 1636425429381, 1636425430010, 629, 268, 361, 0, 0, 0
6073, 1, 1636425429477, 1636425430110, 633, 270, 363, 0, 0, 0
6075, 1, 1636425429695, 1636425430318, 623, 268, 355, 0, 1, 1
6076, 1, 1636425429884, 1636425430506, 622, 267, 355, 1, 0, 1
6074, 1, 1636425429633, 1636425430562, 929, 569, 360, 0, 0, 0
6077, 1, 1636425430352, 1636425430978, 626, 270, 356, 1, 0, 1
6078, 1, 1636425430388, 1636425431014, 626, 269, 357, 0, 0, 0
6079, 1, 1636425430535, 1636425431158, 623, 262, 361, 0, 0, 0
6080, 1, 1636425430845, 1636425431478, 633, 274, 359, 0, 0, 0
6081, 1, 1636425430867, 1636425431490, 623, 266, 357, 0, 0, 0
6082, 1, 1636425430876, 1636425431938, 1062, 711, 351, 0, 0, 0
6083, 1, 1636425431637, 1636425432270, 633, 271, 362, 1, 0, 1
6084, 1, 1636425431897, 1636425432522, 625, 270, 355, 2, 0, 2
6085, 1, 1636425431923, 1636425432546, 623, 267, 356, 1, 0, 1
6087, 1, 1636425432291, 1636425432918, 627, 269, 358, 0, 1, 1
6086, 1, 1636425432049, 1636425432998, 949, 589, 360, 1, 0, 1
6089, 1, 1636425432542, 1636425433170, 628, 269, 359, 0, 0, 0
6088, 1, 1636425432335, 1636425433370, 1035, 678, 357, 1, 0, 1
6091, 1, 1636425432833, 1636425433454, 621, 270, 351, 2, 0, 2
6090, 1, 1636425432777, 1636425433814, 1037, 678, 359, 0, 0, 0
6092, 1, 1636425433473, 1636425434098, 625, 266, 359, 0, 0, 0
6093, 1, 1636425433570, 1636425434194, 624, 266, 358, 0, 0, 0
6094, 1, 1636425433665, 1636425434294, 629, 270, 359, 0, 0, 0
6096, 1, 1636425433873, 1636425434498, 625, 266, 359, 0, 0, 0
6095, 1, 1636425433671, 1636425434642, 971, 614, 357, 0, 0, 0
6097, 1, 1636425434092, 1636425434698, 606, 260, 346, 0, 1, 1
6098, 1, 1636425434169, 1636425434782, 613, 263, 350, 0, 1, 1
6099, 1, 1636425434607, 1636425435234, 627, 266, 361, 0, 1, 1
6101, 1, 1636425434713, 1636425435342, 629, 270, 359, 2, 0, 2
6102, 1, 1636425434913, 1636425435542, 629, 269, 360, 0, 1, 1
6100, 1, 1636425434695, 1636425435678, 983, 626, 357, 1, 0, 1
6103, 1, 1636425435445, 1636425436070, 625, 265, 360, 0, 0, 0
6104, 1, 1636425435620, 1636425436242, 622, 266, 356, 0, 0, 0
6105, 1, 1636425436018, 1636425436694, 676, 318, 358, 0, 0, 0
6106, 1, 1636425436183, 1636425436802, 619, 266, 353, 0, 0, 0
6107, 1, 1636425436320, 1636425436934, 614, 259, 355, 1, 0, 1
6109, 1, 1636425436617, 1636425437254, 637, 272, 365, 0, 0, 0
6108, 1, 1636425436487, 1636425437382, 895, 537, 358, 0, 0, 0
6111, 1, 1636425437109, 1636425437742, 633, 274, 359, 1, 0, 1
6110, 1, 1636425436928, 1636425437846, 918, 558, 360, 1, 0, 1
6112, 1, 1636425437660, 1636425438286, 626, 270, 356, 0, 0, 0
6113, 1, 1636425437696, 1636425438322, 626, 270, 356, 0, 0, 0
6114, 1, 1636425437769, 1636425438398, 629, 266, 363, 0, 0, 0
6115, 1, 1636425437812, 1636425438438, 626, 265, 361, 0, 1, 1
6117, 1, 1636425438160, 1636425438790, 630, 270, 360, 0, 0, 0
6118, 1, 1636425438200, 1636425438818, 618, 260, 358, 0, 0, 0
6116, 1, 1636425437958, 1636425438890, 932, 575, 357, 1, 0, 1
6119, 1, 1636425438281, 1636425438914, 633, 270, 363, 0, 0, 0
6120, 1, 1636425438445, 1636425439366, 921, 562, 359, 1, 0, 1
6121, 1, 1636425438890, 1636425439518, 628, 272, 356, 1, 1, 2
6122, 1, 1636425438999, 1636425439626, 627, 270, 357, 0, 0, 0
6123, 1, 1636425439567, 1636425440194, 627, 269, 358, 1, 0, 1
6124, 1, 1636425439715, 1636425440346, 631, 269, 362, 0, 0, 0
6125, 1, 1636425439927, 1636425440646, 719, 359, 360, 0, 0, 0
6126, 1, 1636425440054, 1636425440682, 628, 269, 359, 1, 0, 1
6128, 1, 1636425440266, 1636425440894, 628, 272, 356, 0, 1, 1
6127, 1, 1636425440189, 1636425441134, 945, 580, 365, 0, 0, 0
6130, 1, 1636425440816, 1636425441442, 626, 271, 355, 2, 2, 4
6129, 1, 1636425440731, 1636425441586, 855, 499, 356, 0, 2, 2
6131, 1, 1636425441377, 1636425442002, 625, 272, 353, 2, 3, 5
6132, 1, 1636425441531, 1636425442162, 631, 271, 360, 0, 1, 1
6133, 1, 1636425441656, 1636425442282, 626, 270, 356, 0, 0, 0
6134, 1, 1636425441712, 1636425442342, 630, 273, 357, 2, 0, 2
6137, 1, 1636425441973, 1636425442598, 625, 270, 355, 0, 0, 0
6136, 1, 1636425441933, 1636425442614, 681, 323, 358, 0, 0, 0
6135, 1, 1636425441818, 1636425442730, 912, 554, 358, 1, 0, 1
6138, 1, 1636425442201, 1636425442830, 629, 270, 359, 0, 0, 0
6140, 1, 1636425442451, 1636425443082, 631, 269, 362, 0, 0, 0
6139, 1, 1636425442224, 1636425443278, 1054, 702, 352, 1, 0, 1
6141, 1, 1636425442796, 1636425443418, 622, 266, 356, 0, 0, 0
6142, 1, 1636425443083, 1636425443706, 623, 272, 351, 1, 0, 1
6143, 1, 1636425443270, 1636425443894, 624, 266, 358, 1, 0, 1
6144, 1, 1636425443488, 1636425444118, 630, 270, 360, 0, 2, 2
6145, 1, 1636425443889, 1636425444518, 629, 270, 359, 0, 1, 1
6146, 1, 1636425443914, 1636425444546, 632, 269, 363, 1, 0, 1
6147, 1, 1636425444178, 1636425444998, 820, 462, 358, 1, 0, 1
6148, 1, 1636425444579, 1636425445206, 627, 269, 358, 0, 1, 1
6149, 1, 1636425444652, 1636425445454, 802, 441, 361, 0, 0, 0
6152, 1, 1636425445360, 1636425445990, 630, 271, 359, 0, 0, 0
6154, 1, 1636425445624, 1636425446250, 626, 270, 356, 0, 1, 1
6153, 1, 1636425445607, 1636425446442, 835, 479, 356, 1, 0, 1
6155, 1, 1636425445954, 1636425446578, 624, 266, 358, 0, 0, 0
6157, 1, 1636425446113, 1636425446742, 629, 270, 359, 1, 0, 1
6159, 1, 1636425446182, 1636425446814, 632, 270, 362, 1, 0, 1
6156, 1, 1636425446077, 1636425447030, 953, 590, 363, 1, 0, 1
6158, 1, 1636425446178, 1636425447194, 1016, 651, 365, 2, 0, 2
6160, 1, 1636425446783, 1636425447406, 623, 271, 352, 0, 0, 0
6161, 1, 1636425446794, 1636425447422, 628, 266, 362, 1, 0, 1
6162, 1, 1636425447040, 1636425447670, 630, 269, 361, 0, 0, 0
6163, 1, 1636425447394, 1636425448026, 632, 271, 361, 0, 1, 1
6164, 1, 1636425447505, 1636425448126, 621, 262, 359, 0, 2, 2
6165, 1, 1636425447596, 1636425448218, 622, 265, 357, 0, 0, 0
6166, 1, 1636425447792, 1636425448422, 630, 270, 360, 1, 1, 2
6167, 1, 1636425448048, 1636425448678, 630, 269, 361, 1, 0, 1
6168, 1, 1636425448517, 1636425449150, 633, 275, 358, 0, 0, 0
6169, 1, 1636425448600, 1636425449234, 634, 269, 365, 1, 1, 2
6170, 1, 1636425449042, 1636425449690, 648, 288, 360, 1, 1, 2
6171, 1, 1636425449421, 1636425450146, 725, 366, 359, 0, 1, 1
6172, 1, 1636425449542, 1636425450166, 624, 268, 356, 0, 1, 1
6174, 1, 1636425449789, 1636425450418, 629, 268, 361, 1, 0, 1
6173, 1, 1636425449789, 1636425450614, 825, 471, 354, 0, 1, 1
6175, 1, 1636425449938, 1636425450870, 932, 574, 358, 0, 0, 0
6176, 1, 1636425450022, 1636425451070, 1048, 686, 362, 0, 0, 0
6177, 1, 1636425450523, 1636425451150, 627, 274, 353, 0, 1, 1
6178, 1, 1636425450660, 1636425451290, 630, 270, 360, 0, 1, 1
6179, 1, 1636425450720, 1636425451342, 622, 266, 356, 0, 0, 0
6180, 1, 1636425450996, 1636425451618, 622, 269, 353, 0, 0, 0
6181, 1, 1636425451334, 1636425451962, 628, 271, 357, 0, 1, 1
6182, 1, 1636425451445, 1636425452074, 629, 267, 362, 0, 0, 0
6183, 1, 1636425451699, 1636425452326, 627, 267, 360, 0, 1, 1
6184, 1, 1636425451749, 1636425452378, 629, 269, 360, 0, 1, 1
6185, 1, 1636425452256, 1636425452886, 630, 270, 360, 0, 1, 1
6186, 1, 1636425452576, 1636425453206, 630, 265, 365, 0, 0, 0
6187, 1, 1636425452808, 1636425453430, 622, 265, 357, 1, 0, 1
6188, 1, 1636425453090, 1636425453874, 784, 432, 352, 0, 2, 2
6189, 1, 1636425453341, 1636425453970, 629, 269, 360, 1, 1, 2
6191, 1, 1636425453566, 1636425454194, 628, 270, 358, 0, 1, 1
6190, 1, 1636425453454, 1636425454326, 872, 514, 358, 0, 1, 1
6193, 1, 1636425453755, 1636425454422, 667, 306, 361, 1, 0, 1
6194, 1, 1636425453883, 1636425454646, 763, 406, 357, 0, 0, 0
6150, 2, 1636425444711, 1636425454845, 10134, 0, 10134, 0, 0, 0
6192, 1, 1636425453726, 1636425454874, 1148, 791, 357, 0, 0, 0
6195, 1, 1636425454422, 1636425455050, 628, 270, 358, 1, 0, 1
6151, 2, 1636425445050, 1636425455185, 10135, 0, 10135, 0, 0, 0
6196, 1, 1636425454777, 1636425455454, 677, 293, 384, 0, 24, 24
6197, 1, 1636425454974, 1636425455642, 668, 270, 398, 1, 1, 2
6198, 1, 1636425455029, 1636425455662, 633, 270, 363, 0, 0, 0
6199, 1, 1636425455201, 1636425455826, 625, 265, 360, 0, 0, 0
6200, 1, 1636425455314, 1636425455990, 676, 270, 406, 0, 1, 1
6201, 1, 1636425455643, 1636425456274, 631, 274, 357, 0, 1, 1
6202, 1, 1636425455729, 1636425456354, 625, 267, 358, 2, 1, 3
6203, 1, 1636425455763, 1636425456390, 627, 266, 361, 1, 0, 1
6204, 1, 1636425455867, 1636425456490, 623, 266, 357, 1, 0, 1
6205, 1, 1636425456430, 1636425457058, 628, 270, 358, 2, 1, 3
6206, 1, 1636425456680, 1636425457306, 626, 270, 356, 1, 1, 2
6207, 1, 1636425456976, 1636425457598, 622, 269, 353, 0, 1, 1
6209, 1, 1636425457248, 1636425457870, 622, 270, 352, 0, 1, 1
6208, 1, 1636425457187, 1636425458050, 863, 507, 356, 0, 0, 0
6212, 1, 1636425457542, 1636425458170, 628, 268, 360, 0, 0, 0
6210, 1, 1636425457461, 1636425458502, 1041, 682, 359, 2, 0, 2
6214, 1, 1636425457853, 1636425458626, 773, 413, 360, 0, 1, 1
6215, 1, 1636425458636, 1636425459262, 626, 271, 355, 1, 3, 4
6216, 1, 1636425458905, 1636425459534, 629, 269, 360, 0, 2, 2
6217, 1, 1636425459132, 1636425459758, 626, 271, 355, 0, 0, 0
6218, 1, 1636425459138, 1636425459770, 632, 268, 364, 0, 0, 0
6219, 1, 1636425459159, 1636425459786, 627, 269, 358, 0, 1, 1
6220, 1, 1636425459472, 1636425460098, 626, 268, 358, 0, 0, 0
6221, 1, 1636425459721, 1636425460346, 625, 265, 360, 0, 1, 1
6222, 1, 1636425459746, 1636425460374, 628, 267, 361, 1, 1, 2
6223, 1, 1636425459933, 1636425460570, 637, 274, 363, 0, 0, 0
6224, 1, 1636425460143, 1636425460774, 631, 270, 361, 1, 1, 2
6225, 1, 1636425460696, 1636425461326, 630, 269, 361, 1, 0, 1
6226, 1, 1636425461011, 1636425461642, 631, 268, 363, 1, 0, 1
6227, 1, 1636425461141, 1636425461774, 633, 271, 362, 0, 1, 1
6228, 1, 1636425461251, 1636425461878, 627, 270, 357, 1, 0, 1
6231, 1, 1636425461615, 1636425462246, 631, 269, 362, 1, 0, 1
6230, 1, 1636425461547, 1636425462334, 787, 426, 361, 2, 1, 3
6232, 1, 1636425461982, 1636425462702, 720, 358, 362, 1, 0, 1
6229, 1, 1636425461364, 1636425462786, 1422, 1065, 357, 0, 0, 0
6233, 1, 1636425462417, 1636425463050, 633, 269, 364, 1, 1, 2
6234, 1, 1636425462946, 1636425463574, 628, 268, 360, 1, 0, 1
6235, 1, 1636425463172, 1636425463802, 630, 269, 361, 0, 0, 0
6236, 1, 1636425463220, 1636425463842, 622, 265, 357, 0, 1, 1
6237, 1, 1636425463462, 1636425464090, 628, 272, 356, 0, 2, 2
6238, 1, 1636425463646, 1636425464274, 628, 270, 358, 0, 1, 1
6239, 1, 1636425463682, 1636425464306, 624, 270, 354, 1, 1, 2
6240, 1, 1636425463734, 1636425464354, 620, 260, 360, 0, 0, 0
6241, 1, 1636425463951, 1636425464578, 627, 270, 357, 1, 0, 1
6242, 1, 1636425464077, 1636425464706, 629, 271, 358, 0, 1, 1
6243, 1, 1636425464504, 1636425465134, 630, 271, 359, 2, 1, 3
6244, 1, 1636425464920, 1636425465586, 666, 310, 356, 2, 0, 2
6246, 1, 1636425464989, 1636425465622, 633, 269, 364, 0, 0, 0
6247, 1, 1636425465131, 1636425466042, 911, 549, 362, 0, 1, 1
6249, 1, 1636425465570, 1636425466194, 624, 265, 359, 0, 1, 1
6248, 1, 1636425465505, 1636425466502, 997, 634, 363, 0, 1, 1
6250, 1, 1636425465980, 1636425466650, 670, 309, 361, 0, 1, 1
6251, 1, 1636425466448, 1636425467082, 634, 273, 361, 1, 0, 1
6211, 2, 1636425457469, 1636425467605, 10136, 1, 10135, 0, 1, 1
6252, 1, 1636425467138, 1636425467762, 624, 270, 354, 0, 1, 1
6253, 1, 1636425467180, 1636425467806, 626, 271, 355, 0, 2, 2
6254, 1, 1636425467215, 1636425467878, 663, 301, 362, 0, 33, 33
6213, 1, 1636425457615, 1636425468098, 10483, 10125, 358, 0, 0, 0
6255, 1, 1636425467544, 1636425468194, 650, 266, 384, 1, 0, 1
6256, 1, 1636425467606, 1636425468238, 632, 266, 366, 0, 0, 0
6257, 1, 1636425467606, 1636425468238, 632, 265, 367, 1, 0, 1
6258, 1, 1636425467803, 1636425468430, 627, 271, 356, 0, 1, 1
6259, 1, 1636425467962, 1636425468630, 668, 270, 398, 1, 0, 1
6260, 1, 1636425468055, 1636425468674, 619, 266, 353, 0, 0, 0
6262, 1, 1636425468220, 1636425468846, 626, 271, 355, 0, 1, 1
6261, 1, 1636425468100, 1636425469082, 982, 583, 399, 0, 1, 1
6263, 1, 1636425468533, 1636425469302, 769, 407, 362, 1, 1, 2
6264, 1, 1636425468887, 1636425469518, 631, 269, 362, 2, 0, 2
6265, 1, 1636425469230, 1636425469862, 632, 273, 359, 0, 0, 0
6267, 1, 1636425469400, 1636425470034, 634, 270, 364, 1, 0, 1
6266, 1, 1636425469383, 1636425470318, 935, 574, 361, 0, 1, 1
6269, 1, 1636425469882, 1636425470514, 632, 271, 361, 1, 1, 2
6268, 1, 1636425469714, 1636425470770, 1056, 699, 357, 1, 1, 2
6270, 1, 1636425470250, 1636425470882, 632, 270, 362, 0, 1, 1
6271, 1, 1636425471042, 1636425471670, 628, 274, 354, 0, 1, 1
6272, 1, 1636425471162, 1636425471790, 628, 270, 358, 0, 0, 0
6273, 1, 1636425471406, 1636425472034, 628, 266, 362, 0, 0, 0
6274, 1, 1636425471556, 1636425472186, 630, 270, 360, 1, 0, 1
6275, 1, 1636425471571, 1636425472190, 619, 266, 353, 1, 0, 1
6276, 1, 1636425471938, 1636425472566, 628, 270, 358, 0, 0, 0
6277, 1, 1636425471959, 1636425472590, 631, 269, 362, 0, 1, 1
6278, 1, 1636425472005, 1636425472630, 625, 262, 363, 2, 0, 2
6280, 1, 1636425472431, 1636425473058, 627, 269, 358, 1, 1, 2
6279, 1, 1636425472283, 1636425473082, 799, 438, 361, 0, 0, 0
6281, 1, 1636425472720, 1636425473350, 630, 270, 360, 1, 0, 1
6282, 1, 1636425473003, 1636425473634, 631, 271, 360, 1, 1, 2
6284, 1, 1636425473422, 1636425474050, 628, 269, 359, 0, 1, 1
6283, 1, 1636425473150, 1636425474086, 936, 578, 358, 1, 0, 1
6286, 1, 1636425473904, 1636425474530, 626, 271, 355, 1, 1, 2
6285, 1, 1636425473528, 1636425474538, 1010, 649, 361, 1, 0, 1
6287, 1, 1636425474079, 1636425474706, 627, 269, 358, 0, 1, 1
6245, 2, 1636425464970, 1636425475105, 10135, 0, 10135, 0, 0, 0
6288, 1, 1636425475040, 1636425475694, 654, 271, 383, 1, 0, 1
6289, 1, 1636425475176, 1636425475802, 626, 270, 356, 1, 1, 2
6290, 1, 1636425475234, 1636425475902, 668, 270, 398, 0, 0, 0
6291, 1, 1636425475291, 1636425475914, 623, 270, 353, 1, 0, 1
6292, 1, 1636425475414, 1636425476038, 624, 266, 358, 0, 0, 0
6295, 1, 1636425475803, 1636425476422, 619, 263, 356, 0, 1, 1
6293, 1, 1636425475793, 1636425476422, 629, 272, 357, 3, 2, 5
6294, 1, 1636425475794, 1636425476426, 632, 268, 364, 0, 1, 1
6296, 1, 1636425476066, 1636425476694, 628, 269, 359, 0, 1, 1
6297, 1, 1636425476151, 1636425476870, 719, 366, 353, 0, 1, 1
6298, 1, 1636425476560, 1636425477186, 626, 271, 355, 2, 0, 2
6299, 1, 1636425476578, 1636425477206, 628, 269, 359, 1, 0, 1
6300, 1, 1636425477020, 1636425477654, 634, 270, 364, 2, 0, 2
6301, 1, 1636425477220, 1636425477846, 626, 270, 356, 1, 1, 2
6302, 1, 1636425477227, 1636425478106, 879, 524, 355, 0, 1, 1
6303, 1, 1636425477700, 1636425478330, 630, 273, 357, 0, 0, 0
6304, 1, 1636425477739, 1636425478558, 819, 460, 359, 1, 0, 1
6305, 1, 1636425478074, 1636425478710, 636, 273, 363, 1, 0, 1
6306, 1, 1636425479019, 1636425479646, 627, 271, 356, 0, 1, 1
6307, 1, 1636425479026, 1636425479654, 628, 270, 358, 0, 0, 0
6308, 1, 1636425479230, 1636425479854, 624, 268, 356, 0, 0, 0
6309, 1, 1636425479259, 1636425479882, 623, 265, 358, 0, 0, 0
6310, 1, 1636425479503, 1636425480126, 623, 265, 358, 0, 0, 0
6311, 1, 1636425479649, 1636425480274, 625, 268, 357, 0, 0, 0
6312, 1, 1636425479834, 1636425480458, 624, 268, 356, 0, 1, 1
6313, 1, 1636425479861, 1636425480490, 629, 269, 360, 1, 0, 1
6314, 1, 1636425480004, 1636425480622, 618, 263, 355, 0, 0, 0
6315, 1, 1636425480376, 1636425481002, 626, 270, 356, 0, 1, 1
6316, 1, 1636425480498, 1636425481130, 632, 268, 364, 0, 1, 1
6317, 1, 1636425480694, 1636425481326, 632, 273, 359, 2, 0, 2
6318, 1, 1636425481000, 1636425481630, 630, 269, 361, 0, 0, 0
6320, 1, 1636425481278, 1636425481906, 628, 270, 358, 1, 0, 1
6319, 1, 1636425481210, 1636425482086, 876, 513, 363, 0, 0, 0
6321, 1, 1636425481499, 1636425482538, 1039, 680, 359, 0, 0, 0
6322, 1, 1636425481975, 1636425482602, 627, 271, 356, 0, 3, 3
6323, 1, 1636425482281, 1636425482914, 633, 269, 364, 2, 0, 2
6324, 1, 1636425483155, 1636425483782, 627, 269, 358, 0, 1, 1
6325, 1, 1636425483231, 1636425483858, 627, 270, 357, 0, 0, 0
6326, 1, 1636425483358, 1636425483986, 628, 268, 360, 1, 0, 1
6327, 1, 1636425483472, 1636425484094, 622, 267, 355, 0, 1, 1
6328, 1, 1636425483478, 1636425484106, 628, 270, 358, 0, 0, 0
6329, 1, 1636425483784, 1636425484410, 626, 268, 358, 1, 0, 1
6330, 1, 1636425484081, 1636425484702, 621, 265, 356, 0, 1, 1
6331, 1, 1636425484127, 1636425484746, 619, 267, 352, 2, 0, 2
6332, 1, 1636425484139, 1636425484766, 627, 269, 358, 0, 0, 0
6333, 1, 1636425484505, 1636425485134, 629, 269, 360, 1, 0, 1
6334, 1, 1636425484595, 1636425485222, 627, 265, 362, 0, 0, 0
6335, 1, 1636425484783, 1636425485410, 627, 266, 361, 1, 0, 1
6336, 1, 1636425485284, 1636425485918, 634, 269, 365, 0, 0, 0
6338, 1, 1636425485497, 1636425486134, 637, 275, 362, 0, 1, 1
6339, 1, 1636425485499, 1636425486378, 879, 513, 366, 0, 1, 1
6340, 1, 1636425486194, 1636425486826, 632, 271, 361, 0, 1, 1
6337, 1, 1636425485423, 1636425486830, 1407, 1050, 357, 0, 0, 0
6341, 1, 1636425486456, 1636425487086, 630, 270, 360, 1, 1, 2
6342, 1, 1636425486855, 1636425487486, 631, 270, 361, 0, 0, 0
6343, 1, 1636425487189, 1636425487814, 625, 269, 356, 1, 0, 1
6344, 1, 1636425487374, 1636425487998, 624, 262, 362, 0, 0, 0
6345, 1, 1636425487487, 1636425488110, 623, 266, 357, 0, 0, 0
6346, 1, 1636425487562, 1636425488190, 628, 269, 359, 0, 0, 0
6347, 1, 1636425487761, 1636425488382, 621, 263, 358, 0, 1, 1
6348, 1, 1636425487893, 1636425488514, 621, 263, 358, 1, 0, 1
6349, 1, 1636425487976, 1636425488598, 622, 266, 356, 0, 0, 0
6350, 1, 1636425488306, 1636425488930, 624, 270, 354, 1, 0, 1
6351, 1, 1636425488344, 1636425488966, 622, 264, 358, 0, 0, 0
6352, 1, 1636425488491, 1636425489122, 631, 270, 361, 0, 0, 0
6353, 1, 1636425488986, 1636425489614, 628, 270, 358, 0, 1, 1
6354, 1, 1636425489224, 1636425489850, 626, 269, 357, 0, 0, 0
6355, 1, 1636425489384, 1636425490066, 682, 325, 357, 0, 1, 1
6357, 1, 1636425489791, 1636425490514, 723, 365, 358, 0, 0, 0
6358, 1, 1636425489920, 1636425490538, 618, 266, 352, 0, 0, 0
6356, 1, 1636425489634, 1636425490962, 1328, 968, 360, 0, 0, 0
6359, 1, 1636425490655, 1636425491282, 627, 270, 357, 1, 0, 1
6360, 1, 1636425490722, 1636425491354, 632, 269, 363, 1, 0, 1
6361, 1, 1636425491260, 1636425491886, 626, 268, 358, 0, 0, 0
6362, 1, 1636425491267, 1636425491898, 631, 270, 361, 0, 0, 0
6363, 1, 1636425491617, 1636425492350, 733, 374, 359, 0, 0, 0
6364, 1, 1636425491727, 1636425492358, 631, 273, 358, 0, 0, 0
6365, 1, 1636425492042, 1636425492670, 628, 268, 360, 0, 0, 0
6366, 1, 1636425492112, 1636425492738, 626, 270, 356, 1, 0, 1
6367, 1, 1636425492220, 1636425492846, 626, 271, 355, 1, 1, 2
6368, 1, 1636425492336, 1636425492966, 630, 268, 362, 0, 0, 0
6369, 1, 1636425492683, 1636425493310, 627, 268, 359, 0, 0, 0
6370, 1, 1636425492736, 1636425493362, 626, 270, 356, 1, 0, 1
6371, 1, 1636425493215, 1636425493842, 627, 271, 356, 0, 2, 2
6374, 1, 1636425493466, 1636425494094, 628, 268, 360, 0, 0, 0
6373, 1, 1636425493465, 1636425494294, 829, 470, 359, 0, 1, 1
6372, 1, 1636425493419, 1636425494746, 1327, 971, 356, 0, 1, 1
6375, 1, 1636425494199, 1636425494826, 627, 268, 359, 0, 0, 0
6376, 1, 1636425494530, 1636425495158, 628, 269, 359, 0, 0, 0
6377, 1, 1636425494685, 1636425495318, 633, 270, 363, 0, 0, 0
6378, 1, 1636425495206, 1636425495834, 628, 269, 359, 0, 1, 1
6379, 1, 1636425495298, 1636425495926, 628, 270, 358, 0, 1, 1
6380, 1, 1636425495706, 1636425496334, 628, 269, 359, 0, 1, 1
6381, 1, 1636425495709, 1636425496342, 633, 270, 363, 1, 0, 1
6382, 1, 1636425495989, 1636425496626, 637, 273, 364, 0, 1, 1
6384, 1, 1636425496142, 1636425496770, 628, 268, 360, 0, 0, 0
6383, 1, 1636425496140, 1636425496774, 634, 269, 365, 1, 0, 1
6385, 1, 1636425496455, 1636425497082, 627, 270, 357, 1, 1, 2
6386, 1, 1636425496630, 1636425497258, 628, 268, 360, 1, 0, 1
6387, 1, 1636425496970, 1636425497598, 628, 269, 359, 0, 0, 0
6388, 1, 1636425497162, 1636425497790, 628, 270, 358, 1, 0, 1
6391, 1, 1636425497702, 1636425498334, 632, 270, 362, 0, 1, 1
6392, 1, 1636425498435, 1636425499062, 627, 269, 358, 0, 1, 1
6393, 1, 1636425498488, 1636425499114, 626, 270, 356, 0, 0, 0
6394, 1, 1636425498799, 1636425499514, 715, 357, 358, 0, 0, 0
6395, 1, 1636425498909, 1636425499534, 625, 266, 359, 2, 1, 3
6396, 1, 1636425499133, 1636425499762, 629, 270, 359, 0, 0, 0
6397, 1, 1636425499678, 1636425500310, 632, 270, 362, 0, 0, 0
6398, 1, 1636425499750, 1636425500378, 628, 269, 359, 0, 0, 0
6399, 1, 1636425499969, 1636425500594, 625, 270, 355, 2, 2, 4
6400, 1, 1636425500171, 1636425500802, 631, 273, 358, 0, 0, 0
6401, 1, 1636425500195, 1636425500826, 631, 273, 358, 1, 0, 1
6402, 1, 1636425500332, 1636425500958, 626, 269, 357, 0, 0, 0
6403, 1, 1636425500444, 1636425501070, 626, 270, 356, 1, 0, 1
6404, 1, 1636425500922, 1636425501550, 628, 270, 358, 1, 0, 1
6405, 1, 1636425500959, 1636425501582, 623, 270, 353, 0, 0, 0
6406, 1, 1636425501670, 1636425502302, 632, 269, 363, 1, 0, 1
6407, 1, 1636425502348, 1636425502974, 626, 271, 355, 0, 0, 0
6408, 1, 1636425502424, 1636425503046, 622, 270, 352, 1, 0, 1
6409, 1, 1636425502589, 1636425503214, 625, 265, 360, 0, 2, 2
6410, 1, 1636425502678, 1636425503306, 628, 270, 358, 0, 2, 2
6411, 1, 1636425502962, 1636425503594, 632, 268, 364, 0, 0, 0
6412, 1, 1636425503520, 1636425504150, 630, 270, 360, 0, 1, 1
6414, 1, 1636425503878, 1636425504498, 620, 267, 353, 2, 2, 4
6415, 1, 1636425503964, 1636425504590, 626, 265, 361, 0, 1, 1
6416, 1, 1636425504103, 1636425504730, 627, 270, 357, 2, 0, 2
6417, 1, 1636425504232, 1636425504858, 626, 272, 354, 1, 1, 2
6419, 1, 1636425504693, 1636425505322, 629, 270, 359, 1, 1, 2
6422, 1, 1636425506343, 1636425506966, 623, 266, 357, 0, 0, 0
6423, 1, 1636425506528, 1636425507158, 630, 274, 356, 0, 1, 1
6426, 1, 1636425506716, 1636425507342, 626, 269, 357, 0, 0, 0
6425, 1, 1636425506644, 1636425507422, 778, 417, 361, 0, 1, 1
6389, 2, 1636425497310, 1636425507445, 10135, 0, 10135, 0, 1, 1
6390, 2, 1636425497347, 1636425507493, 10146, 0, 10146, 0, 1, 1
6427, 1, 1636425507494, 1636425508126, 632, 269, 363, 0, 0, 0
6428, 1, 1636425507582, 1636425508254, 672, 269, 403, 0, 1, 1
6430, 1, 1636425507952, 1636425508578, 626, 269, 357, 1, 0, 1
6431, 1, 1636425508057, 1636425508686, 629, 270, 359, 3, 0, 3
6432, 1, 1636425508067, 1636425508694, 627, 271, 356, 3, 0, 3
6429, 1, 1636425507622, 1636425508702, 1080, 678, 402, 0, 0, 0
6433, 1, 1636425508223, 1636425508850, 627, 270, 357, 0, 0, 0
6434, 1, 1636425508650, 1636425509286, 636, 268, 368, 0, 0, 0
6435, 1, 1636425510447, 1636425511078, 631, 273, 358, 0, 0, 0
6436, 1, 1636425510655, 1636425511282, 627, 271, 356, 0, 1, 1
6437, 1, 1636425510807, 1636425511538, 731, 371, 360, 0, 0, 0
6438, 1, 1636425511415, 1636425512042, 627, 268, 359, 1, 0, 1
6439, 1, 1636425511576, 1636425512490, 914, 561, 353, 0, 0, 0
6440, 1, 1636425512232, 1636425512858, 626, 270, 356, 1, 0, 1
6441, 1, 1636425512236, 1636425512858, 622, 271, 351, 0, 0, 0
6442, 1, 1636425512314, 1636425512938, 624, 269, 355, 0, 0, 0
6413, 2, 1636425503784, 1636425513917, 10133, 0, 10133, 0, 0, 0
6443, 1, 1636425514047, 1636425514718, 671, 270, 401, 0, 1, 1
6418, 2, 1636425504660, 1636425514793, 10133, 0, 10133, 0, 0, 0
6444, 1, 1636425514620, 1636425515250, 630, 270, 360, 0, 0, 0
6420, 2, 1636425505175, 1636425515309, 10134, 1, 10133, 0, 1, 1
6445, 1, 1636425514793, 1636425515422, 629, 268, 361, 0, 0, 0
6446, 1, 1636425514922, 1636425515598, 676, 275, 401, 0, 1, 1
6447, 1, 1636425514987, 1636425515702, 715, 359, 356, 0, 1, 1
6421, 2, 1636425505777, 1636425515913, 10136, 0, 10136, 0, 1, 1
6448, 1, 1636425515341, 1636425515970, 629, 268, 361, 1, 0, 1
6449, 1, 1636425515438, 1636425516110, 672, 270, 402, 0, 1, 1
6450, 1, 1636425515448, 1636425516422, 974, 619, 355, 0, 1, 1
6451, 1, 1636425516042, 1636425516718, 676, 269, 407, 2, 0, 2
6424, 2, 1636425506640, 1636425516773, 10133, 1, 10132, 0, 0, 0
6452, 1, 1636425516396, 1636425517038, 642, 284, 358, 2, 15, 17
6454, 1, 1636425516511, 1636425517138, 627, 270, 357, 2, 0, 2
6453, 1, 1636425516477, 1636425517142, 665, 297, 368, 1, 27, 28
6455, 1, 1636425516902, 1636425517570, 668, 270, 398, 1, 0, 1
6456, 1, 1636425517957, 1636425518591, 634, 270, 364, 0, 0, 0
6457, 1, 1636425518832, 1636425519458, 626, 269, 357, 1, 0, 1
6458, 1, 1636425518883, 1636425519506, 623, 265, 358, 0, 0, 0
6459, 1, 1636425518887, 1636425519522, 635, 270, 365, 0, 0, 0
6460, 1, 1636425519142, 1636425519970, 828, 469, 359, 0, 0, 0
6461, 1, 1636425519347, 1636425519974, 627, 270, 357, 0, 0, 0
6462, 1, 1636425519674, 1636425520426, 752, 392, 360, 0, 0, 0
6463, 1, 1636425520181, 1636425520810, 629, 268, 361, 0, 0, 0
6464, 1, 1636425520438, 1636425521066, 628, 267, 361, 0, 0, 0
6465, 1, 1636425520613, 1636425521238, 625, 269, 356, 1, 0, 1
6466, 1, 1636425520761, 1636425521394, 633, 270, 363, 0, 0, 0
6467, 1, 1636425521989, 1636425522622, 633, 271, 362, 2, 0, 2
6468, 1, 1636425522581, 1636425523210, 629, 271, 358, 2, 2, 4
6469, 1, 1636425522695, 1636425523322, 627, 271, 356, 1, 1, 2
6470, 1, 1636425522862, 1636425523498, 636, 274, 362, 0, 0, 0
6471, 1, 1636425523122, 1636425523774, 652, 295, 357, 0, 0, 0
6472, 1, 1636425523377, 1636425524010, 633, 269, 364, 0, 0, 0
6473, 1, 1636425523824, 1636425524462, 638, 281, 357, 0, 1, 1
6474, 1, 1636425524209, 1636425524838, 629, 269, 360, 0, 0, 0
6475, 1, 1636425524375, 1636425525006, 631, 269, 362, 1, 0, 1
6476, 1, 1636425524643, 1636425525274, 631, 269, 362, 0, 0, 0
6477, 1, 1636425525164, 1636425525794, 630, 271, 359, 0, 1, 1
6478, 1, 1636425525792, 1636425526422, 630, 271, 359, 0, 1, 1
6479, 1, 1636425526282, 1636425526914, 632, 269, 363, 0, 0, 0
6480, 1, 1636425526665, 1636425527294, 629, 271, 358, 0, 2, 2
6481, 1, 1636425526964, 1636425527590, 626, 269, 357, 0, 1, 1
6482, 1, 1636425527180, 1636425527806, 626, 270, 356, 1, 0, 1
6483, 1, 1636425527408, 1636425528042, 634, 277, 357, 0, 0, 0
6484, 1, 1636425527628, 1636425528262, 634, 274, 360, 2, 0, 2
6485, 1, 1636425527928, 1636425528554, 626, 264, 362, 1, 0, 1
6486, 1, 1636425528434, 1636425529066, 632, 271, 361, 3, 1, 4
6487, 1, 1636425528445, 1636425529078, 633, 270, 363, 0, 0, 0
6488, 1, 1636425529149, 1636425529782, 633, 271, 362, 1, 1, 2
6489, 1, 1636425529622, 1636425530250, 628, 270, 358, 0, 1, 1
6490, 1, 1636425530044, 1636425530671, 627, 269, 358, 0, 0, 0
6491, 1, 1636425530494, 1636425531126, 632, 269, 363, 0, 1, 1
6492, 1, 1636425530682, 1636425531310, 628, 270, 358, 0, 0, 0
6493, 1, 1636425531040, 1636425531670, 630, 271, 359, 0, 0, 0
6494, 1, 1636425531181, 1636425531810, 629, 270, 359, 0, 0, 0
6495, 1, 1636425531457, 1636425532122, 665, 305, 360, 1, 0, 1
6496, 1, 1636425532057, 1636425532686, 629, 269, 360, 0, 1, 1
6497, 1, 1636425532275, 1636425532906, 631, 270, 361, 2, 0, 2
6498, 1, 1636425532537, 1636425533170, 633, 268, 365, 1, 0, 1
6499, 1, 1636425533584, 1636425534214, 630, 269, 361, 0, 0, 0
6500, 1, 1636425533617, 1636425534250, 633, 271, 362, 0, 2, 2
6501, 1, 1636425534175, 1636425534802, 627, 270, 357, 0, 1, 1
6502, 1, 1636425534723, 1636425535346, 623, 267, 356, 0, 2, 2
6503, 1, 1636425534810, 1636425535442, 632, 270, 362, 1, 1, 2
6504, 1, 1636425535198, 1636425535902, 704, 343, 361, 0, 2, 2
6505, 1, 1636425535283, 1636425535914, 631, 272, 359, 0, 0, 0
6506, 1, 1636425535957, 1636425536586, 629, 270, 359, 1, 0, 1
6507, 1, 1636425536037, 1636425536670, 633, 268, 365, 0, 0, 0
6508, 1, 1636425536606, 1636425537238, 632, 271, 361, 0, 1, 1
6509, 1, 1636425537530, 1636425538158, 628, 270, 358, 0, 0, 0
6510, 1, 1636425537824, 1636425538450, 626, 270, 356, 1, 0, 1
6511, 1, 1636425538279, 1636425538910, 631, 270, 361, 0, 1, 1
6512, 1, 1636425538790, 1636425539418, 628, 270, 358, 0, 1, 1
6513, 1, 1636425538826, 1636425539458, 632, 269, 363, 0, 1, 1
6514, 1, 1636425539017, 1636425539870, 853, 494, 359, 0, 1, 1
6515, 1, 1636425539491, 1636425540118, 627, 269, 358, 0, 1, 1
6516, 1, 1636425540164, 1636425540790, 626, 269, 357, 1, 0, 1
6517, 1, 1636425540323, 1636425540954, 631, 271, 360, 1, 1, 2
6518, 1, 1636425540584, 1636425541210, 626, 270, 356, 2, 1, 3
6519, 1, 1636425541850, 1636425542478, 628, 269, 359, 0, 1, 1
6520, 1, 1636425541992, 1636425542614, 622, 265, 357, 0, 0, 0
6521, 1, 1636425542453, 1636425543082, 629, 267, 362, 0, 2, 2
6522, 1, 1636425542919, 1636425543546, 627, 270, 357, 1, 1, 2
6523, 1, 1636425543000, 1636425543622, 622, 266, 356, 0, 0, 0
6524, 1, 1636425543031, 1636425543998, 967, 608, 359, 1, 0, 1
6525, 1, 1636425543658, 1636425544290, 632, 268, 364, 0, 0, 0
6526, 1, 1636425544333, 1636425544950, 617, 263, 354, 0, 0, 0
6527, 1, 1636425544422, 1636425545046, 624, 262, 362, 0, 0, 0
6528, 1, 1636425544487, 1636425545110, 623, 266, 357, 0, 0, 0
6529, 1, 1636425545973, 1636425546602, 629, 265, 364, 0, 0, 0
6530, 1, 1636425546267, 1636425546894, 627, 270, 357, 0, 1, 1
6531, 1, 1636425546720, 1636425547342, 622, 269, 353, 0, 0, 0
6532, 1, 1636425547051, 1636425547678, 627, 269, 358, 0, 1, 1
6534, 1, 1636425547275, 1636425547902, 627, 270, 357, 0, 1, 1
6533, 1, 1636425547123, 1636425548142, 1019, 654, 365, 0, 0, 0
6535, 1, 1636425547926, 1636425548554, 628, 269, 359, 0, 0, 0
6536, 1, 1636425548120, 1636425548746, 626, 269, 357, 0, 0, 0
6537, 1, 1636425548485, 1636425549106, 621, 260, 361, 1, 0, 1
6538, 1, 1636425548529, 1636425549154, 625, 261, 364, 0, 0, 0
6539, 1, 1636425549936, 1636425550550, 614, 262, 352, 0, 0, 0
6540, 1, 1636425550326, 1636425550954, 628, 266, 362, 0, 0, 0
6541, 1, 1636425550388, 1636425551006, 618, 266, 352, 0, 0, 0
6542, 1, 1636425550749, 1636425551366, 617, 263, 354, 1, 1, 2
6543, 1, 1636425550944, 1636425551566, 622, 267, 355, 0, 0, 0
6544, 1, 1636425551060, 1636425551814, 754, 399, 355, 1, 0, 1
6545, 1, 1636425551733, 1636425552358, 625, 270, 355, 0, 0, 0
6546, 1, 1636425552198, 1636425552822, 624, 266, 358, 1, 0, 1
6547, 1, 1636425552350, 1636425552982, 632, 274, 358, 0, 0, 0
6548, 1, 1636425554117, 1636425554746, 629, 270, 359, 0, 0, 0
6549, 1, 1636425554571, 1636425555206, 635, 270, 365, 1, 0, 1
6550, 1, 1636425554832, 1636425555458, 626, 270, 356, 0, 0, 0
6551, 1, 1636425555213, 1636425555843, 630, 269, 361, 0, 0, 0
6552, 1, 1636425556002, 1636425556630, 628, 268, 360, 0, 0, 0
6553, 1, 1636425556467, 1636425557098, 631, 270, 361, 1, 1, 2
6554, 1, 1636425556468, 1636425557098, 630, 269, 361, 2, 0, 2
6555, 1, 1636425557837, 1636425558470, 633, 271, 362, 0, 0, 0
6556, 1, 1636425558344, 1636425558974, 630, 269, 361, 0, 0, 0
6557, 1, 1636425558860, 1636425559490, 630, 270, 360, 1, 0, 1
6558, 1, 1636425558986, 1636425559942, 956, 598, 358, 1, 0, 1
6559, 1, 1636425559721, 1636425560394, 673, 314, 359, 0, 1, 1
6560, 1, 1636425560241, 1636425560870, 629, 270, 359, 0, 0, 0
6561, 1, 1636425560278, 1636425560902, 624, 265, 359, 0, 0, 0
6562, 1, 1636425561853, 1636425562486, 633, 274, 359, 0, 0, 0
6563, 1, 1636425562361, 1636425562990, 629, 269, 360, 0, 0, 0
6564, 1, 1636425563163, 1636425563794, 631, 271, 360, 0, 0, 0
6565, 1, 1636425563934, 1636425564562, 628, 271, 357, 0, 1, 1
6566, 1, 1636425564059, 1636425564682, 623, 266, 357, 0, 1, 1
6567, 1, 1636425564258, 1636425565014, 756, 398, 358, 0, 0, 0
6568, 1, 1636425565833, 1636425566466, 633, 271, 362, 0, 0, 0
6569, 1, 1636425566342, 1636425566970, 628, 270, 358, 0, 0, 0
6570, 1, 1636425567143, 1636425567770, 627, 269, 358, 1, 0, 1
6571, 1, 1636425567873, 1636425568502, 629, 270, 359, 0, 0, 0
6572, 1, 1636425568089, 1636425568714, 625, 264, 361, 1, 0, 1
6573, 1, 1636425568094, 1636425568954, 860, 502, 358, 0, 1, 1
6574, 1, 1636425570117, 1636425570746, 629, 270, 359, 0, 1, 1
6575, 1, 1636425570625, 1636425571254, 629, 270, 359, 1, 1, 2
6576, 1, 1636425571272, 1636425571902, 630, 270, 360, 0, 1, 1
6577, 1, 1636425571925, 1636425572554, 629, 269, 360, 0, 1, 1
6578, 1, 1636425572157, 1636425572786, 629, 269, 360, 1, 0, 1
6579, 1, 1636425572312, 1636425573238, 926, 566, 360, 0, 1, 1
6580, 1, 1636425575753, 1636425576386, 633, 269, 364, 1, 0, 1
6581, 1, 1636425579436, 1636425580066, 630, 269, 361, 0, 1, 1
6582, 1, 1636425583643, 1636425584274, 631, 269, 362, 1, 0, 1
6583, 1, 1636425587817, 1636425588446, 629, 271, 358, 1, 0, 1
6584, 1, 1636425592083, 1636425592718, 635, 274, 361, 0, 1, 1
6585, 1, 1636425595891, 1636425596522, 631, 271, 360, 2, 0, 2
6586, 1, 1636425599919, 1636425600542, 623, 271, 352, 0, 1, 1
6587, 1, 1636425603637, 1636425604266, 629, 269, 360, 0, 0, 0
6588, 1, 1636425607654, 1636425608282, 628, 269, 359, 1, 0, 1
6589, 1, 1636425611593, 1636425612222, 629, 265, 364, 0, 0, 0
6590, 1, 1636425615878, 1636425616506, 628, 269, 359, 0, 1, 1
6591, 1, 1636425619977, 1636425620606, 629, 266, 363, 0, 0, 0
6592, 1, 1636425623690, 1636425624326, 636, 270, 366, 0, 0, 0
6593, 1, 1636425627392, 1636425628022, 630, 270, 360, 1, 0, 1
6594, 1, 1636425631153, 1636425631786, 633, 270, 363, 0, 0, 0
6595, 1, 1636425635056, 1636425635682, 626, 270, 356, 0, 0, 0
6596, 1, 1636425638905, 1636425639538, 633, 270, 363, 0, 0, 0
6597, 1, 1636425642919, 1636425643550, 631, 269, 362, 0, 0, 0
6598, 1, 1636425646878, 1636425647510, 632, 270, 362, 1, 0, 1
6599, 1, 1636425650952, 1636425651578, 626, 269, 357, 0, 1, 1
6600, 1, 1636425655021, 1636425655650, 629, 270, 359, 0, 0, 0
