Xid, State, StartTime, EndTime, TransactionTime, ExecuteTime, CommunicationTime, ReadTime, WriteTime, DBTime
39, 1, 1636428102000, 1636428102519, 519, 97, 422, 43, 6, 49
42, 1, 1636428102874, 1636428103283, 409, 5, 404, 1, 1, 2
45, 1, 1636428103555, 1636428103966, 411, 3, 408, 2, 1, 3
48, 1, 1636428104238, 1636428104650, 412, 4, 408, 0, 1, 1
51, 1, 1636428104918, 1636428105331, 413, 4, 409, 1, 1, 2
55, 1, 1636428105602, 1636428106010, 408, 3, 405, 2, 1, 3
58, 1, 1636428106274, 1636428106686, 412, 2, 410, 0, 0, 0
61, 1, 1636428106954, 1636428107362, 408, 4, 404, 2, 0, 2
64, 1, 1636428107630, 1636428108050, 420, 3, 417, 3, 0, 3
67, 1, 1636428108314, 1636428108722, 408, 3, 405, 1, 0, 1
71, 1, 1636428108990, 1636428109398, 408, 3, 405, 1, 0, 1
74, 1, 1636428109666, 1636428110075, 409, 2, 407, 1, 0, 1
77, 1, 1636428110342, 1636428110750, 408, 2, 406, 2, 0, 2
80, 1, 1636428111014, 1636428111422, 408, 3, 405, 3, 0, 3
83, 1, 1636428111694, 1636428112102, 408, 3, 405, 2, 0, 2
86, 1, 1636428112370, 1636428112775, 405, 5, 400, 0, 1, 1
89, 1, 1636428113042, 1636428113406, 364, 3, 361, 0, 0, 0
92, 1, 1636428113674, 1636428114038, 364, 3, 361, 2, 0, 2
95, 1, 1636428114306, 1636428114666, 360, 2, 358, 1, 0, 1
98, 1, 1636428114930, 1636428115294, 364, 1, 363, 0, 1, 1
101, 1, 1636428115558, 1636428115914, 356, 3, 353, 2, 0, 2
104, 1, 1636428116178, 1636428116542, 364, 3, 361, 0, 1, 1
107, 1, 1636428116806, 1636428117170, 364, 3, 361, 1, 0, 1
110, 1, 1636428117438, 1636428117802, 364, 2, 362, 0, 0, 0
113, 1, 1636428118070, 1636428118434, 364, 2, 362, 1, 0, 1
116, 1, 1636428118698, 1636428119062, 364, 1, 363, 0, 1, 1
119, 1, 1636428119334, 1636428119698, 364, 3, 361, 1, 0, 1
122, 1, 1636428119970, 1636428120330, 360, 1, 359, 0, 0, 0
125, 1, 1636428120598, 1636428120970, 372, 1, 371, 0, 1, 1
128, 1, 1636428121242, 1636428121602, 360, 1, 359, 0, 0, 0
131, 1, 1636428121870, 1636428122234, 364, 1, 363, 0, 0, 0
134, 1, 1636428122498, 1636428122862, 364, 2, 362, 0, 1, 1
137, 1, 1636428123130, 1636428123494, 364, 2, 362, 1, 0, 1
140, 1, 1636428123758, 1636428124122, 364, 1, 363, 0, 1, 1
143, 1, 1636428124390, 1636428124754, 364, 1, 363, 0, 1, 1
146, 1, 1636428125022, 1636428125390, 368, 0, 368, 0, 0, 0
149, 1, 1636428125657, 1636428126022, 365, 1, 364, 0, 0, 0
152, 1, 1636428126290, 1636428126658, 368, 2, 366, 0, 0, 0
155, 1, 1636428126922, 1636428127286, 364, 0, 364, 0, 0, 0
158, 1, 1636428127554, 1636428127914, 360, 0, 360, 0, 0, 0
161, 1, 1636428128182, 1636428128546, 364, 0, 364, 0, 0, 0
164, 1, 1636428128814, 1636428129174, 360, 1, 359, 0, 0, 0
167, 1, 1636428129442, 1636428129806, 364, 2, 362, 1, 0, 1
170, 1, 1636428130074, 1636428130441, 367, 1, 366, 0, 0, 0
173, 1, 1636428130709, 1636428131074, 365, 1, 364, 0, 1, 1
176, 1, 1636428131342, 1636428131706, 364, 3, 361, 0, 0, 0
179, 1, 1636428131974, 1636428132338, 364, 1, 363, 0, 1, 1
182, 1, 1636428132606, 1636428132970, 364, 1, 363, 0, 1, 1
185, 1, 1636428133242, 1636428133606, 364, 0, 364, 0, 0, 0
188, 1, 1636428133874, 1636428134234, 360, 0, 360, 0, 0, 0
191, 1, 1636428134502, 1636428134866, 364, 0, 364, 0, 0, 0
194, 1, 1636428135134, 1636428135494, 360, 1, 359, 0, 0, 0
197, 1, 1636428135758, 1636428136122, 364, 1, 363, 0, 1, 1
200, 1, 1636428136390, 1636428136745, 355, 2, 353, 0, 0, 0
203, 1, 1636428137014, 1636428137378, 364, 0, 364, 0, 0, 0
206, 1, 1636428137646, 1636428138006, 360, 2, 358, 0, 1, 1
209, 1, 1636428138278, 1636428138638, 360, 1, 359, 0, 0, 0
212, 1, 1636428138906, 1636428139270, 364, 1, 363, 0, 0, 0
215, 1, 1636428139538, 1636428139898, 360, 1, 359, 0, 0, 0
218, 1, 1636428140162, 1636428140526, 364, 0, 364, 0, 0, 0
221, 1, 1636428140789, 1636428141154, 365, 1, 364, 1, 0, 1
224, 1, 1636428141418, 1636428141782, 364, 0, 364, 0, 0, 0
227, 1, 1636428142046, 1636428142410, 364, 0, 364, 0, 0, 0
230, 1, 1636428142674, 1636428143034, 360, 1, 359, 0, 0, 0
233, 1, 1636428143298, 1636428143666, 368, 5, 363, 3, 1, 4
236, 1, 1636428143930, 1636428144294, 364, 0, 364, 0, 0, 0
239, 1, 1636428144562, 1636428144922, 360, 1, 359, 1, 0, 1
242, 1, 1636428145185, 1636428145554, 369, 3, 366, 2, 0, 2
245, 1, 1636428145821, 1636428146186, 365, 2, 363, 0, 0, 0
248, 1, 1636428146450, 1636428146810, 360, 1, 359, 1, 0, 1
251, 1, 1636428147074, 1636428147438, 364, 1, 363, 0, 0, 0
254, 1, 1636428147702, 1636428148054, 352, 2, 350, 1, 0, 1
257, 1, 1636428148325, 1636428148681, 356, 1, 355, 0, 0, 0
260, 1, 1636428148950, 1636428149314, 364, 0, 364, 0, 0, 0
263, 1, 1636428149582, 1636428149946, 364, 0, 364, 0, 0, 0
266, 1, 1636428150210, 1636428150574, 364, 0, 364, 0, 0, 0
269, 1, 1636428150842, 1636428151206, 364, 0, 364, 0, 0, 0
272, 1, 1636428151470, 1636428151829, 359, 0, 359, 0, 0, 0
275, 1, 1636428152098, 1636428152462, 364, 2, 362, 0, 0, 0
278, 1, 1636428152729, 1636428153094, 365, 2, 363, 0, 0, 0
281, 1, 1636428153366, 1636428153730, 364, 0, 364, 0, 0, 0
284, 1, 1636428153994, 1636428154354, 360, 0, 360, 0, 0, 0
287, 1, 1636428154622, 1636428154982, 360, 1, 359, 0, 0, 0
290, 1, 1636428155246, 1636428155606, 360, 1, 359, 0, 0, 0
293, 1, 1636428155874, 1636428156238, 364, 0, 364, 0, 0, 0
296, 1, 1636428156506, 1636428156870, 364, 2, 362, 0, 0, 0
299, 1, 1636428157138, 1636428157498, 360, 0, 360, 0, 0, 0
302, 1, 1636428157766, 1636428158130, 364, 1, 363, 0, 0, 0
305, 1, 1636428158394, 1636428158754, 360, 0, 360, 0, 0, 0
308, 1, 1636428159022, 1636428159382, 360, 0, 360, 0, 0, 0
311, 1, 1636428159646, 1636428160014, 368, 2, 366, 0, 0, 0
314, 1, 1636428160278, 1636428160638, 360, 0, 360, 0, 0, 0
317, 1, 1636428160902, 1636428161266, 364, 0, 364, 0, 0, 0
320, 1, 1636428161534, 1636428161898, 364, 0, 364, 0, 0, 0
323, 1, 1636428162166, 1636428162530, 364, 0, 364, 0, 0, 0
326, 1, 1636428162797, 1636428163162, 365, 2, 363, 0, 0, 0
329, 1, 1636428163429, 1636428163794, 365, 1, 364, 0, 0, 0
332, 1, 1636428164062, 1636428164426, 364, 0, 364, 0, 0, 0
335, 1, 1636428164694, 1636428165050, 356, 0, 356, 0, 0, 0
338, 1, 1636428165322, 1636428165686, 364, 1, 363, 0, 0, 0
341, 1, 1636428165950, 1636428166314, 364, 2, 362, 1, 0, 1
344, 1, 1636428166586, 1636428166946, 360, 0, 360, 0, 0, 0
347, 1, 1636428167213, 1636428167578, 365, 1, 364, 0, 0, 0
350, 1, 1636428167846, 1636428168214, 368, 2, 366, 0, 0, 0
353, 1, 1636428168481, 1636428168846, 365, 1, 364, 1, 0, 1
356, 1, 1636428169114, 1636428169478, 364, 1, 363, 0, 0, 0
359, 1, 1636428169742, 1636428170106, 364, 0, 364, 0, 0, 0
362, 1, 1636428170374, 1636428170738, 364, 0, 364, 0, 0, 0
365, 1, 1636428171001, 1636428171366, 365, 2, 363, 0, 0, 0
368, 1, 1636428171634, 1636428171998, 364, 1, 363, 1, 0, 1
371, 1, 1636428172266, 1636428172625, 359, 2, 357, 1, 0, 1
374, 1, 1636428172898, 1636428173266, 368, 1, 367, 0, 0, 0
377, 1, 1636428173530, 1636428173894, 364, 1, 363, 1, 0, 1
380, 1, 1636428174166, 1636428174530, 364, 0, 364, 0, 0, 0
383, 1, 1636428174794, 1636428175158, 364, 0, 364, 0, 0, 0
386, 1, 1636428175426, 1636428175790, 364, 1, 363, 0, 0, 0
389, 1, 1636428176058, 1636428176417, 359, 1, 358, 1, 0, 1
392, 1, 1636428176686, 1636428177046, 360, 0, 360, 0, 0, 0
395, 1, 1636428177310, 1636428177674, 364, 0, 364, 0, 0, 0
398, 1, 1636428177942, 1636428178298, 356, 0, 356, 0, 0, 0
401, 1, 1636428178562, 1636428178925, 363, 0, 363, 0, 0, 0
404, 1, 1636428179198, 1636428179554, 356, 1, 355, 0, 0, 0
407, 1, 1636428179821, 1636428180178, 357, 3, 354, 1, 0, 1
410, 1, 1636428180446, 1636428180802, 356, 1, 355, 0, 0, 0
413, 1, 1636428181066, 1636428181430, 364, 1, 363, 1, 0, 1
416, 1, 1636428181698, 1636428182062, 364, 1, 363, 0, 0, 0
419, 1, 1636428182330, 1636428182694, 364, 1, 363, 0, 0, 0
422, 1, 1636428182958, 1636428183322, 364, 0, 364, 0, 0, 0
425, 1, 1636428183586, 1636428183950, 364, 0, 364, 0, 0, 0
428, 1, 1636428184218, 1636428184582, 364, 2, 362, 1, 0, 1
431, 1, 1636428184845, 1636428185210, 365, 2, 363, 0, 0, 0
434, 1, 1636428185478, 1636428185842, 364, 0, 364, 0, 0, 0
437, 1, 1636428186106, 1636428186470, 364, 1, 363, 0, 0, 0
440, 1, 1636428186741, 1636428187114, 373, 1, 372, 0, 0, 0
443, 1, 1636428187382, 1636428187741, 359, 0, 359, 0, 0, 0
446, 1, 1636428188005, 1636428188370, 365, 1, 364, 0, 0, 0
449, 1, 1636428188641, 1636428189002, 361, 2, 359, 0, 0, 0
452, 1, 1636428189274, 1636428189634, 360, 0, 360, 0, 0, 0
455, 1, 1636428189897, 1636428190262, 365, 1, 364, 1, 0, 1
458, 1, 1636428190538, 1636428190898, 360, 1, 359, 1, 0, 1
461, 1, 1636428191166, 1636428191522, 356, 0, 356, 0, 0, 0
464, 1, 1636428191790, 1636428192154, 364, 0, 364, 0, 0, 0
467, 1, 1636428192422, 1636428192786, 364, 0, 364, 0, 0, 0
470, 1, 1636428193050, 1636428193414, 364, 0, 364, 0, 0, 0
473, 1, 1636428193686, 1636428194050, 364, 1, 363, 1, 0, 1
476, 1, 1636428194314, 1636428194678, 364, 1, 363, 0, 0, 0
479, 1, 1636428194946, 1636428195306, 360, 1, 359, 0, 0, 0
482, 1, 1636428195578, 1636428195950, 372, 0, 372, 0, 0, 0
485, 1, 1636428196214, 1636428196578, 364, 1, 363, 0, 0, 0
488, 1, 1636428196846, 1636428197206, 360, 2, 358, 1, 0, 1
491, 1, 1636428197474, 1636428197842, 368, 0, 368, 0, 0, 0
494, 1, 1636428198106, 1636428198470, 364, 0, 364, 0, 0, 0
497, 1, 1636428198738, 1636428199098, 360, 1, 359, 0, 0, 0
500, 1, 1636428199366, 1636428199730, 364, 2, 362, 1, 0, 1
503, 1, 1636428199994, 1636428200362, 368, 0, 368, 0, 0, 0
507, 1, 1636428200630, 1636428200994, 364, 0, 364, 0, 0, 0
510, 1, 1636428201265, 1636428201626, 361, 1, 360, 0, 0, 0
513, 1, 1636428201890, 1636428202254, 364, 0, 364, 0, 0, 0
516, 1, 1636428202518, 1636428202878, 360, 0, 360, 0, 0, 0
519, 1, 1636428203142, 1636428203505, 363, 0, 363, 0, 0, 0
522, 1, 1636428203774, 1636428204138, 364, 0, 364, 0, 0, 0
525, 1, 1636428204401, 1636428204766, 365, 2, 363, 0, 0, 0
528, 1, 1636428205034, 1636428205394, 360, 1, 359, 0, 0, 0
531, 1, 1636428205658, 1636428206018, 360, 0, 360, 0, 0, 0
534, 1, 1636428206282, 1636428206646, 364, 0, 364, 0, 0, 0
537, 1, 1636428206918, 1636428207282, 364, 0, 364, 0, 0, 0
540, 1, 1636428207546, 1636428207910, 364, 0, 364, 0, 0, 0
543, 1, 1636428208173, 1636428208538, 365, 1, 364, 0, 1, 1
546, 1, 1636428208802, 1636428209158, 356, 0, 356, 0, 0, 0
549, 1, 1636428209426, 1636428209790, 364, 0, 364, 0, 0, 0
552, 1, 1636428210058, 1636428210430, 372, 0, 372, 0, 0, 0
555, 1, 1636428210698, 1636428211062, 364, 0, 364, 0, 0, 0
558, 1, 1636428211334, 1636428211698, 364, 0, 364, 0, 0, 0
561, 1, 1636428211961, 1636428212326, 365, 0, 365, 0, 0, 0
563, 1, 1636428212594, 1636428212954, 360, 1, 359, 0, 0, 0
565, 1, 1636428213221, 1636428213586, 365, 1, 364, 0, 0, 0
567, 1, 1636428213854, 1636428214218, 364, 0, 364, 0, 0, 0
569, 1, 1636428214486, 1636428214850, 364, 0, 364, 0, 0, 0
571, 1, 1636428215117, 1636428215482, 365, 1, 364, 1, 0, 1
573, 1, 1636428215745, 1636428216106, 361, 1, 360, 0, 0, 0
575, 1, 1636428216374, 1636428216737, 363, 1, 362, 0, 0, 0
577, 1, 1636428217001, 1636428217362, 361, 1, 360, 0, 0, 0
579, 1, 1636428217630, 1636428217994, 364, 0, 364, 0, 0, 0
581, 1, 1636428218262, 1636428218622, 360, 0, 360, 0, 0, 0
583, 1, 1636428218890, 1636428219254, 364, 1, 363, 0, 0, 0
585, 1, 1636428219518, 1636428219881, 363, 1, 362, 0, 0, 0
587, 1, 1636428220150, 1636428220510, 360, 0, 360, 0, 0, 0
588, 1, 1636428220778, 1636428221142, 364, 1, 363, 0, 0, 0
589, 1, 1636428221406, 1636428221770, 364, 0, 364, 0, 0, 0
590, 1, 1636428222038, 1636428222402, 364, 1, 363, 0, 0, 0
591, 1, 1636428222670, 1636428223034, 364, 0, 364, 0, 0, 0
592, 1, 1636428223302, 1636428223666, 364, 2, 362, 1, 0, 1
593, 1, 1636428223933, 1636428224298, 365, 1, 364, 0, 0, 0
594, 1, 1636428224566, 1636428224930, 364, 0, 364, 0, 0, 0
595, 1, 1636428225194, 1636428225558, 364, 0, 364, 0, 0, 0
596, 1, 1636428225826, 1636428226189, 363, 0, 363, 0, 0, 0
597, 1, 1636428226461, 1636428226826, 365, 1, 364, 0, 0, 0
598, 1, 1636428227094, 1636428227458, 364, 1, 363, 0, 0, 0
599, 1, 1636428227726, 1636428228090, 364, 0, 364, 0, 0, 0
600, 1, 1636428228354, 1636428228718, 364, 0, 364, 0, 0, 0
601, 1, 1636428331578, 1636428331910, 332, 11, 321, 0, 0, 0
602, 1, 1636428332626, 1636428332938, 312, 0, 312, 0, 0, 0
603, 1, 1636428333182, 1636428333498, 316, 0, 316, 0, 0, 0
604, 1, 1636428333421, 1636428333730, 309, 1, 308, 0, 0, 0
605, 1, 1636428334198, 1636428334506, 308, 0, 308, 0, 0, 0
606, 1, 1636428334622, 1636428334934, 312, 0, 312, 0, 0, 0
607, 1, 1636428334906, 1636428335218, 312, 0, 312, 0, 0, 0
608, 1, 1636428335178, 1636428335490, 312, 0, 312, 0, 0, 0
609, 1, 1636428335322, 1636428335630, 308, 0, 308, 0, 0, 0
610, 1, 1636428335678, 1636428335994, 316, 1, 315, 0, 0, 0
611, 1, 1636428336102, 1636428336414, 312, 0, 312, 0, 0, 0
612, 1, 1636428336506, 1636428336814, 308, 1, 307, 0, 1, 1
613, 1, 1636428336786, 1636428337098, 312, 0, 312, 0, 0, 0
614, 1, 1636428336801, 1636428337114, 313, 1, 312, 0, 0, 0
615, 1, 1636428337058, 1636428337369, 311, 0, 311, 0, 0, 0
616, 1, 1636428337222, 1636428337530, 308, 2, 306, 0, 0, 0
617, 1, 1636428337341, 1636428337610, 269, 1, 268, 0, 0, 0
618, 1, 1636428337458, 1636428337725, 267, 0, 267, 0, 0, 0
619, 1, 1636428337865, 1636428338134, 269, 1, 268, 0, 1, 1
620, 1, 1636428337897, 1636428338170, 273, 1, 272, 0, 1, 1
621, 1, 1636428338429, 1636428338693, 264, 1, 263, 0, 0, 0
622, 1, 1636428338517, 1636428338786, 269, 1, 268, 1, 0, 1
623, 1, 1636428338562, 1636428338833, 271, 0, 271, 0, 0, 0
624, 1, 1636428338598, 1636428338862, 264, 0, 264, 0, 0, 0
625, 1, 1636428338990, 1636428339262, 272, 0, 272, 0, 0, 0
626, 1, 1636428339041, 1636428339306, 265, 1, 264, 0, 0, 0
627, 1, 1636428339374, 1636428339646, 272, 0, 272, 0, 0, 0
628, 1, 1636428339454, 1636428339726, 272, 0, 272, 0, 0, 0
629, 1, 1636428339661, 1636428339926, 265, 1, 264, 0, 0, 0
630, 1, 1636428339930, 1636428340198, 268, 0, 268, 0, 0, 0
631, 1, 1636428340009, 1636428340282, 273, 0, 273, 0, 0, 0
632, 1, 1636428340362, 1636428340629, 267, 0, 267, 0, 0, 0
633, 1, 1636428340441, 1636428340710, 269, 1, 268, 0, 0, 0
634, 1, 1636428340549, 1636428340814, 265, 0, 265, 0, 0, 0
635, 1, 1636428340694, 1636428340962, 268, 0, 268, 0, 0, 0
636, 1, 1636428340905, 1636428341173, 268, 1, 267, 0, 0, 0
637, 1, 1636428341021, 1636428341286, 265, 1, 264, 0, 0, 0
638, 1, 1636428341097, 1636428341369, 272, 1, 271, 0, 0, 0
639, 1, 1636428341341, 1636428341605, 264, 0, 264, 0, 0, 0
641, 1, 1636428341393, 1636428341666, 273, 1, 272, 0, 0, 0
640, 1, 1636428341413, 1636428341677, 264, 1, 263, 0, 1, 1
642, 1, 1636428341645, 1636428341914, 269, 1, 268, 0, 0, 0
643, 1, 1636428341882, 1636428342150, 268, 0, 268, 0, 0, 0
644, 1, 1636428341973, 1636428342237, 264, 1, 263, 0, 0, 0
645, 1, 1636428342050, 1636428342314, 264, 0, 264, 0, 0, 0
646, 1, 1636428342282, 1636428342545, 263, 0, 263, 0, 0, 0
647, 1, 1636428342417, 1636428342686, 269, 1, 268, 0, 0, 0
648, 1, 1636428342538, 1636428342806, 268, 0, 268, 0, 0, 0
649, 1, 1636428342745, 1636428343010, 265, 1, 264, 0, 0, 0
650, 1, 1636428342814, 1636428343081, 267, 0, 267, 0, 0, 0
652, 1, 1636428343010, 1636428343278, 268, 1, 267, 0, 0, 0
651, 1, 1636428343009, 1636428343278, 269, 2, 267, 0, 1, 1
653, 1, 1636428343114, 1636428343382, 268, 0, 268, 0, 0, 0
654, 1, 1636428343213, 1636428343477, 264, 1, 263, 0, 0, 0
655, 1, 1636428343345, 1636428343613, 268, 1, 267, 0, 0, 0
656, 1, 1636428343434, 1636428343702, 268, 0, 268, 0, 0, 0
657, 1, 1636428343657, 1636428343930, 273, 1, 272, 0, 0, 0
658, 1, 1636428343677, 1636428343953, 276, 1, 275, 0, 0, 0
659, 1, 1636428343793, 1636428344062, 269, 1, 268, 0, 1, 1
660, 1, 1636428343805, 1636428344069, 264, 0, 264, 0, 0, 0
661, 1, 1636428343933, 1636428344197, 264, 0, 264, 0, 0, 0
662, 1, 1636428344310, 1636428344581, 271, 0, 271, 0, 0, 0
663, 1, 1636428344474, 1636428344742, 268, 0, 268, 0, 0, 0
665, 1, 1636428344661, 1636428344925, 264, 1, 263, 0, 0, 0
666, 1, 1636428344685, 1636428344954, 269, 1, 268, 0, 1, 1
667, 1, 1636428344729, 1636428344998, 269, 1, 268, 0, 0, 0
664, 1, 1636428344749, 1636428345013, 264, 1, 263, 0, 0, 0
668, 1, 1636428344845, 1636428345114, 269, 1, 268, 1, 0, 1
669, 1, 1636428345053, 1636428345322, 269, 1, 268, 0, 1, 1
671, 1, 1636428345117, 1636428345385, 268, 1, 267, 0, 0, 0
672, 1, 1636428345222, 1636428345486, 264, 0, 264, 0, 0, 0
673, 1, 1636428345310, 1636428345586, 276, 0, 276, 0, 0, 0
670, 1, 1636428345373, 1636428345642, 269, 1, 268, 0, 0, 0
674, 1, 1636428345417, 1636428345682, 265, 1, 264, 0, 0, 0
675, 1, 1636428345518, 1636428345786, 268, 0, 268, 0, 0, 0
676, 1, 1636428345745, 1636428346006, 261, 0, 261, 0, 0, 0
678, 1, 1636428345789, 1636428346053, 264, 1, 263, 0, 1, 1
677, 1, 1636428345789, 1636428346062, 273, 1, 272, 0, 1, 1
679, 1, 1636428345830, 1636428346098, 268, 0, 268, 0, 0, 0
680, 1, 1636428346050, 1636428346318, 268, 0, 268, 0, 0, 0
682, 1, 1636428346333, 1636428346602, 269, 1, 268, 0, 0, 0
681, 1, 1636428346369, 1636428346638, 269, 1, 268, 1, 0, 1
683, 1, 1636428346421, 1636428346701, 280, 1, 279, 1, 0, 1
684, 1, 1636428346505, 1636428346770, 265, 1, 264, 0, 0, 0
685, 1, 1636428346526, 1636428346797, 271, 0, 271, 0, 0, 0
686, 1, 1636428346697, 1636428346961, 264, 1, 263, 0, 0, 0
687, 1, 1636428346761, 1636428347030, 269, 1, 268, 0, 0, 0
688, 1, 1636428346770, 1636428347038, 268, 0, 268, 0, 0, 0
689, 1, 1636428346973, 1636428347245, 272, 0, 272, 0, 0, 0
690, 1, 1636428347117, 1636428347378, 261, 1, 260, 0, 0, 0
691, 1, 1636428347141, 1636428347410, 269, 1, 268, 0, 0, 0
692, 1, 1636428347201, 1636428347465, 264, 0, 264, 0, 0, 0
693, 1, 1636428347429, 1636428347694, 265, 1, 264, 0, 0, 0
694, 1, 1636428347441, 1636428347706, 265, 1, 264, 0, 0, 0
695, 1, 1636428347465, 1636428347729, 264, 1, 263, 0, 0, 0
696, 1, 1636428347561, 1636428347834, 273, 1, 272, 0, 0, 0
697, 1, 1636428347725, 1636428347994, 269, 1, 268, 0, 0, 0
698, 1, 1636428347818, 1636428348086, 268, 0, 268, 0, 0, 0
699, 1, 1636428347950, 1636428348218, 268, 0, 268, 0, 0, 0
701, 1, 1636428348113, 1636428348382, 269, 1, 268, 0, 0, 0
700, 1, 1636428348113, 1636428348382, 269, 1, 268, 0, 0, 0
702, 1, 1636428348253, 1636428348522, 269, 1, 268, 1, 0, 1
703, 1, 1636428348301, 1636428348569, 268, 1, 267, 1, 0, 1
704, 1, 1636428348525, 1636428348790, 265, 0, 265, 0, 0, 0
705, 1, 1636428348541, 1636428348809, 268, 1, 267, 0, 0, 0
706, 1, 1636428348793, 1636428349061, 268, 1, 267, 1, 0, 1
707, 1, 1636428348793, 1636428349061, 268, 1, 267, 1, 0, 1
708, 1, 1636428348873, 1636428349137, 264, 1, 263, 1, 0, 1
709, 1, 1636428348893, 1636428349166, 273, 0, 273, 0, 0, 0
710, 1, 1636428349129, 1636428349394, 265, 1, 264, 0, 0, 0
711, 1, 1636428349177, 1636428349446, 269, 1, 268, 0, 0, 0
712, 1, 1636428349254, 1636428349521, 267, 0, 267, 0, 0, 0
713, 1, 1636428349453, 1636428349722, 269, 1, 268, 1, 0, 1
714, 1, 1636428349465, 1636428349730, 265, 1, 264, 0, 0, 0
715, 1, 1636428349525, 1636428349793, 268, 0, 268, 0, 0, 0
716, 1, 1636428349569, 1636428349834, 265, 1, 264, 0, 0, 0
717, 1, 1636428349757, 1636428350021, 264, 1, 263, 0, 1, 1
718, 1, 1636428349825, 1636428350089, 264, 1, 263, 1, 0, 1
719, 1, 1636428349938, 1636428350206, 268, 0, 268, 0, 0, 0
720, 1, 1636428350005, 1636428350274, 269, 1, 268, 0, 1, 1
721, 1, 1636428350170, 1636428350434, 264, 0, 264, 0, 0, 0
722, 1, 1636428350285, 1636428350554, 269, 1, 268, 1, 0, 1
723, 1, 1636428350333, 1636428350598, 265, 1, 264, 0, 0, 0
724, 1, 1636428350581, 1636428350845, 264, 1, 263, 0, 0, 0
725, 1, 1636428350618, 1636428350881, 263, 0, 263, 0, 0, 0
727, 1, 1636428350814, 1636428351082, 268, 0, 268, 0, 0, 0
726, 1, 1636428350817, 1636428351098, 281, 1, 280, 1, 0, 1
728, 1, 1636428350913, 1636428351177, 264, 1, 263, 0, 0, 0
729, 1, 1636428350921, 1636428351186, 265, 1, 264, 0, 0, 0
730, 1, 1636428351166, 1636428351433, 267, 0, 267, 0, 0, 0
731, 1, 1636428351233, 1636428351501, 268, 1, 267, 0, 1, 1
732, 1, 1636428351278, 1636428351541, 263, 0, 263, 0, 0, 0
733, 1, 1636428351478, 1636428351746, 268, 0, 268, 0, 0, 0
734, 1, 1636428351493, 1636428351758, 265, 1, 264, 0, 0, 0
735, 1, 1636428351537, 1636428351801, 264, 1, 263, 0, 1, 1
736, 1, 1636428351582, 1636428351850, 268, 0, 268, 0, 0, 0
737, 1, 1636428351809, 1636428352073, 264, 0, 264, 0, 0, 0
738, 1, 1636428351833, 1636428352097, 264, 1, 263, 0, 1, 1
739, 1, 1636428351849, 1636428352114, 265, 1, 264, 0, 1, 1
740, 1, 1636428352033, 1636428352306, 273, 0, 273, 0, 0, 0
741, 1, 1636428352273, 1636428352537, 264, 1, 263, 0, 0, 0
742, 1, 1636428352409, 1636428352677, 268, 1, 267, 0, 0, 0
743, 1, 1636428352425, 1636428352685, 260, 1, 259, 0, 0, 0
744, 1, 1636428352541, 1636428352810, 269, 1, 268, 0, 0, 0
745, 1, 1636428352673, 1636428352942, 269, 1, 268, 0, 0, 0
746, 1, 1636428352793, 1636428353066, 273, 1, 272, 0, 0, 0
747, 1, 1636428352861, 1636428353134, 273, 1, 272, 0, 0, 0
748, 1, 1636428352881, 1636428353150, 269, 1, 268, 0, 0, 0
749, 1, 1636428352949, 1636428353214, 265, 1, 264, 0, 0, 0
750, 1, 1636428353169, 1636428353433, 264, 1, 263, 0, 0, 0
751, 1, 1636428353193, 1636428353458, 265, 1, 264, 0, 0, 0
752, 1, 1636428353290, 1636428353557, 267, 0, 267, 0, 0, 0
753, 1, 1636428353429, 1636428353693, 264, 1, 263, 0, 1, 1
754, 1, 1636428353433, 1636428353697, 264, 1, 263, 0, 1, 1
755, 1, 1636428353509, 1636428353777, 268, 1, 267, 0, 0, 0
756, 1, 1636428353641, 1636428353906, 265, 1, 264, 0, 0, 0
757, 1, 1636428353850, 1636428354118, 268, 0, 268, 0, 0, 0
758, 1, 1636428353869, 1636428354134, 265, 1, 264, 1, 0, 1
759, 1, 1636428353926, 1636428354189, 263, 0, 263, 0, 0, 0
760, 1, 1636428354141, 1636428354410, 269, 1, 268, 0, 0, 0
761, 1, 1636428354233, 1636428354498, 265, 0, 265, 0, 0, 0
762, 1, 1636428354326, 1636428354590, 264, 0, 264, 0, 0, 0
763, 1, 1636428354425, 1636428354694, 269, 1, 268, 1, 0, 1
764, 1, 1636428354525, 1636428354793, 268, 1, 267, 1, 0, 1
765, 1, 1636428354733, 1636428355002, 269, 1, 268, 0, 0, 0
766, 1, 1636428354845, 1636428355118, 273, 1, 272, 1, 0, 1
767, 1, 1636428354882, 1636428355150, 268, 0, 268, 0, 0, 0
768, 1, 1636428354910, 1636428355177, 267, 0, 267, 0, 0, 0
769, 1, 1636428354941, 1636428355214, 273, 1, 272, 0, 0, 0
770, 1, 1636428355081, 1636428355346, 265, 1, 264, 0, 0, 0
771, 1, 1636428355238, 1636428355506, 268, 0, 268, 0, 0, 0
772, 1, 1636428355349, 1636428355622, 273, 0, 273, 0, 0, 0
773, 1, 1636428355393, 1636428355658, 265, 1, 264, 0, 0, 0
774, 1, 1636428355441, 1636428355705, 264, 1, 263, 0, 1, 1
775, 1, 1636428355461, 1636428355730, 269, 1, 268, 1, 0, 1
776, 1, 1636428355625, 1636428355890, 265, 1, 264, 0, 1, 1
777, 1, 1636428355922, 1636428356190, 268, 0, 268, 0, 0, 0
778, 1, 1636428355945, 1636428356214, 269, 1, 268, 0, 0, 0
779, 1, 1636428355973, 1636428356242, 269, 0, 269, 0, 0, 0
780, 1, 1636428356082, 1636428356349, 267, 0, 267, 0, 0, 0
781, 1, 1636428356118, 1636428356385, 267, 0, 267, 0, 0, 0
782, 1, 1636428356338, 1636428356602, 264, 0, 264, 0, 0, 0
783, 1, 1636428356349, 1636428356617, 268, 1, 267, 1, 0, 1
784, 1, 1636428356629, 1636428356902, 273, 1, 272, 0, 0, 0
785, 1, 1636428356686, 1636428356949, 263, 0, 263, 0, 0, 0
786, 1, 1636428356721, 1636428356989, 268, 1, 267, 0, 1, 1
787, 1, 1636428356921, 1636428357190, 269, 1, 268, 0, 0, 0
788, 1, 1636428356977, 1636428357245, 268, 1, 267, 0, 0, 0
789, 1, 1636428356997, 1636428357265, 268, 1, 267, 0, 0, 0
790, 1, 1636428356997, 1636428357265, 268, 1, 267, 0, 0, 0
791, 1, 1636428357289, 1636428357558, 269, 0, 269, 0, 0, 0
792, 1, 1636428357353, 1636428357618, 265, 1, 264, 0, 0, 0
793, 1, 1636428357382, 1636428357646, 264, 0, 264, 0, 0, 0
794, 1, 1636428357473, 1636428357741, 268, 1, 267, 0, 0, 0
795, 1, 1636428357473, 1636428357741, 268, 1, 267, 0, 0, 0
796, 1, 1636428357554, 1636428357821, 267, 0, 267, 0, 0, 0
797, 1, 1636428357942, 1636428358210, 268, 0, 268, 0, 0, 0
798, 1, 1636428357973, 1636428358241, 268, 1, 267, 0, 1, 1
799, 1, 1636428358010, 1636428358281, 271, 0, 271, 0, 0, 0
801, 1, 1636428358098, 1636428358365, 267, 0, 267, 0, 0, 0
800, 1, 1636428358225, 1636428358497, 272, 1, 271, 0, 0, 0
802, 1, 1636428358369, 1636428358633, 264, 1, 263, 0, 0, 0
803, 1, 1636428358405, 1636428358678, 273, 1, 272, 0, 1, 1
804, 1, 1636428358578, 1636428358846, 268, 0, 268, 0, 0, 0
805, 1, 1636428358586, 1636428358854, 268, 0, 268, 0, 0, 0
806, 1, 1636428358861, 1636428359129, 268, 0, 268, 0, 0, 0
807, 1, 1636428358993, 1636428359257, 264, 0, 264, 0, 0, 0
808, 1, 1636428359005, 1636428359274, 269, 0, 269, 0, 0, 0
809, 1, 1636428359030, 1636428359297, 267, 0, 267, 0, 0, 0
810, 1, 1636428359102, 1636428359370, 268, 0, 268, 0, 0, 0
811, 1, 1636428359246, 1636428359518, 272, 0, 272, 0, 0, 0
812, 1, 1636428359265, 1636428359541, 276, 1, 275, 0, 1, 1
813, 1, 1636428359389, 1636428359658, 269, 1, 268, 0, 0, 0
814, 1, 1636428359401, 1636428359674, 273, 1, 272, 0, 0, 0
815, 1, 1636428359574, 1636428359841, 267, 0, 267, 0, 0, 0
816, 1, 1636428359581, 1636428359849, 268, 1, 267, 0, 1, 1
817, 1, 1636428359817, 1636428360086, 269, 1, 268, 0, 0, 0
818, 1, 1636428359881, 1636428360145, 264, 1, 263, 0, 0, 0
819, 1, 1636428360069, 1636428360338, 269, 1, 268, 1, 0, 1
820, 1, 1636428360101, 1636428360373, 272, 1, 271, 0, 0, 0
821, 1, 1636428360173, 1636428360442, 269, 1, 268, 0, 0, 0
822, 1, 1636428360357, 1636428360622, 265, 1, 264, 0, 0, 0
823, 1, 1636428360465, 1636428360730, 265, 1, 264, 1, 0, 1
824, 1, 1636428360473, 1636428360741, 268, 1, 267, 0, 0, 0
825, 1, 1636428360501, 1636428360766, 265, 1, 264, 0, 0, 0
826, 1, 1636428360645, 1636428360910, 265, 1, 264, 0, 0, 0
827, 1, 1636428360917, 1636428361189, 272, 1, 271, 0, 0, 0
830, 1, 1636428361053, 1636428361318, 265, 1, 264, 0, 0, 0
828, 1, 1636428361049, 1636428361318, 269, 1, 268, 0, 0, 0
829, 1, 1636428361053, 1636428361321, 268, 1, 267, 1, 0, 1
831, 1, 1636428361329, 1636428361597, 268, 1, 267, 0, 0, 0
833, 1, 1636428361369, 1636428361633, 264, 1, 263, 1, 0, 1
834, 1, 1636428361429, 1636428361698, 269, 1, 268, 0, 0, 0
835, 1, 1636428361593, 1636428361857, 264, 1, 263, 1, 0, 1
832, 1, 1636428361610, 1636428361882, 272, 0, 272, 0, 0, 0
836, 1, 1636428361630, 1636428361894, 264, 0, 264, 0, 0, 0
838, 1, 1636428361765, 1636428362030, 265, 1, 264, 0, 0, 0
839, 1, 1636428361986, 1636428362253, 267, 0, 267, 0, 0, 0
841, 1, 1636428362285, 1636428362554, 269, 1, 268, 0, 0, 0
842, 1, 1636428362390, 1636428362658, 268, 0, 268, 0, 0, 0
844, 1, 1636428362518, 1636428362793, 275, 0, 275, 0, 0, 0
845, 1, 1636428362538, 1636428362805, 267, 0, 267, 0, 0, 0
846, 1, 1636428362629, 1636428362898, 269, 1, 268, 0, 0, 0
847, 1, 1636428362953, 1636428363222, 269, 1, 268, 1, 0, 1
849, 1, 1636428363025, 1636428363297, 272, 1, 271, 0, 0, 0
850, 1, 1636428363106, 1636428363377, 271, 0, 271, 0, 0, 0
851, 1, 1636428363193, 1636428363458, 265, 1, 264, 0, 0, 0
852, 1, 1636428363301, 1636428363566, 265, 1, 264, 0, 0, 0
853, 1, 1636428363321, 1636428363590, 269, 1, 268, 0, 0, 0
854, 1, 1636428363321, 1636428363594, 273, 1, 272, 0, 0, 0
857, 1, 1636428363686, 1636428363958, 272, 0, 272, 0, 0, 0
858, 1, 1636428364013, 1636428364278, 265, 1, 264, 0, 0, 0
859, 1, 1636428364278, 1636428364542, 264, 0, 264, 0, 0, 0
860, 1, 1636428364337, 1636428364601, 264, 1, 263, 0, 0, 0
861, 1, 1636428364473, 1636428364738, 265, 1, 264, 1, 0, 1
863, 1, 1636428364649, 1636428364914, 265, 1, 264, 1, 0, 1
865, 1, 1636428364961, 1636428365230, 269, 1, 268, 0, 0, 0
867, 1, 1636428365174, 1636428365437, 263, 0, 263, 0, 0, 0
869, 1, 1636428365277, 1636428365546, 269, 1, 268, 0, 0, 0
870, 1, 1636428365422, 1636428365686, 264, 0, 264, 0, 0, 0
872, 1, 1636428365946, 1636428366214, 268, 0, 268, 0, 0, 0
873, 1, 1636428366253, 1636428366518, 265, 1, 264, 0, 0, 0
875, 1, 1636428366570, 1636428366838, 268, 0, 268, 0, 0, 0
876, 1, 1636428366578, 1636428366854, 276, 0, 276, 0, 0, 0
877, 1, 1636428366834, 1636428367102, 268, 0, 268, 0, 0, 0
878, 1, 1636428367265, 1636428367538, 273, 1, 272, 0, 0, 0
879, 1, 1636428367345, 1636428367610, 265, 1, 264, 0, 0, 0
880, 1, 1636428367350, 1636428367618, 268, 0, 268, 0, 0, 0
881, 1, 1636428367814, 1636428368082, 268, 0, 268, 0, 0, 0
882, 1, 1636428368322, 1636428368586, 264, 0, 264, 0, 0, 0
883, 1, 1636428368473, 1636428368746, 273, 1, 272, 0, 0, 0
884, 1, 1636428368502, 1636428368770, 268, 0, 268, 0, 0, 0
885, 1, 1636428368910, 1636428369178, 268, 1, 267, 0, 0, 0
886, 1, 1636428369202, 1636428369465, 263, 0, 263, 0, 0, 0
887, 1, 1636428369221, 1636428369489, 268, 1, 267, 0, 0, 0
888, 1, 1636428369409, 1636428369678, 269, 1, 268, 0, 1, 1
889, 1, 1636428369889, 1636428370158, 269, 0, 269, 0, 0, 0
890, 1, 1636428370374, 1636428370638, 264, 0, 264, 0, 0, 0
891, 1, 1636428370390, 1636428370654, 264, 0, 264, 0, 0, 0
892, 1, 1636428370546, 1636428370813, 267, 0, 267, 0, 0, 0
893, 1, 1636428370938, 1636428371202, 264, 0, 264, 0, 0, 0
894, 1, 1636428371173, 1636428371437, 264, 1, 263, 0, 0, 0
895, 1, 1636428371298, 1636428371566, 268, 0, 268, 0, 0, 0
896, 1, 1636428371350, 1636428371614, 264, 0, 264, 0, 0, 0
897, 1, 1636428372030, 1636428372298, 268, 0, 268, 0, 0, 0
898, 1, 1636428372361, 1636428372626, 265, 1, 264, 0, 0, 0
899, 1, 1636428372450, 1636428372713, 263, 0, 263, 0, 0, 0
900, 1, 1636428372450, 1636428372717, 267, 0, 267, 0, 0, 0
901, 1, 1636428372598, 1636428372861, 263, 0, 263, 0, 0, 0
902, 1, 1636428372882, 1636428373150, 268, 0, 268, 0, 0, 0
903, 1, 1636428373266, 1636428373530, 264, 0, 264, 0, 0, 0
904, 1, 1636428373297, 1636428373570, 273, 1, 272, 0, 0, 0
905, 1, 1636428373322, 1636428373590, 268, 0, 268, 0, 0, 0
906, 1, 1636428373921, 1636428374194, 273, 1, 272, 0, 0, 0
907, 1, 1636428374345, 1636428374609, 264, 1, 263, 0, 0, 0
910, 1, 1636428374529, 1636428374797, 268, 2, 266, 0, 1, 1
909, 1, 1636428374529, 1636428374798, 269, 1, 268, 0, 0, 0
908, 1, 1636428374529, 1636428374798, 269, 2, 267, 0, 1, 1
911, 1, 1636428374829, 1636428375106, 277, 1, 276, 0, 0, 0
912, 1, 1636428375242, 1636428375506, 264, 0, 264, 0, 0, 0
913, 1, 1636428375249, 1636428375518, 269, 1, 268, 0, 0, 0
914, 1, 1636428375329, 1636428375598, 269, 1, 268, 1, 0, 1
915, 1, 1636428375885, 1636428376154, 269, 0, 269, 0, 0, 0
916, 1, 1636428376213, 1636428376482, 269, 1, 268, 0, 0, 0
917, 1, 1636428376370, 1636428376637, 267, 0, 267, 0, 0, 0
918, 1, 1636428376490, 1636428376757, 267, 0, 267, 0, 0, 0
919, 1, 1636428376646, 1636428376914, 268, 0, 268, 0, 0, 0
920, 1, 1636428376721, 1636428376986, 265, 1, 264, 0, 0, 0
921, 1, 1636428376810, 1636428377073, 263, 0, 263, 0, 0, 0
922, 1, 1636428377142, 1636428377410, 268, 0, 268, 0, 0, 0
923, 1, 1636428377161, 1636428377433, 272, 1, 271, 0, 1, 1
924, 1, 1636428377254, 1636428377518, 264, 0, 264, 0, 0, 0
925, 1, 1636428377862, 1636428378134, 272, 0, 272, 0, 0, 0
926, 1, 1636428378110, 1636428378373, 263, 0, 263, 0, 0, 0
927, 1, 1636428378290, 1636428378557, 267, 0, 267, 0, 0, 0
928, 1, 1636428378370, 1636428378634, 264, 0, 264, 0, 0, 0
929, 1, 1636428378433, 1636428378698, 265, 1, 264, 0, 0, 0
931, 1, 1636428378745, 1636428379010, 265, 1, 264, 0, 0, 0
930, 1, 1636428378745, 1636428379010, 265, 1, 264, 0, 0, 0
932, 1, 1636428379134, 1636428379402, 268, 0, 268, 0, 0, 0
933, 1, 1636428379194, 1636428379458, 264, 0, 264, 0, 0, 0
934, 1, 1636428379241, 1636428379509, 268, 0, 268, 0, 0, 0
935, 1, 1636428379733, 1636428380002, 269, 1, 268, 0, 0, 0
936, 1, 1636428380170, 1636428380434, 264, 0, 264, 0, 0, 0
937, 1, 1636428380302, 1636428380570, 268, 0, 268, 0, 0, 0
938, 1, 1636428380326, 1636428380590, 264, 0, 264, 0, 0, 0
939, 1, 1636428380413, 1636428380678, 265, 1, 264, 0, 0, 0
940, 1, 1636428380798, 1636428381061, 263, 0, 263, 0, 0, 0
941, 1, 1636428380849, 1636428381113, 264, 0, 264, 0, 0, 0
942, 1, 1636428381025, 1636428381290, 265, 0, 265, 0, 0, 0
943, 1, 1636428381217, 1636428381486, 269, 1, 268, 0, 0, 0
944, 1, 1636428381257, 1636428381522, 265, 1, 264, 0, 0, 0
945, 1, 1636428381790, 1636428382053, 263, 0, 263, 0, 0, 0
946, 1, 1636428382201, 1636428382469, 268, 1, 267, 0, 0, 0
947, 1, 1636428382338, 1636428382606, 268, 0, 268, 0, 0, 0
949, 1, 1636428382357, 1636428382629, 272, 1, 271, 0, 0, 0
959, 1, 1636428382394, 1636428382662, 268, 1, 267, 0, 0, 0
953, 1, 1636428382394, 1636428382662, 268, 1, 267, 0, 1, 1
948, 1, 1636428382394, 1636428382662, 268, 0, 268, 0, 0, 0
960, 1, 1636428382854, 1636428383117, 263, 0, 263, 0, 0, 0
961, 1, 1636428382862, 1636428383125, 263, 0, 263, 0, 0, 0
962, 1, 1636428383078, 1636428383342, 264, 0, 264, 0, 0, 0
963, 1, 1636428383106, 1636428383374, 268, 0, 268, 0, 0, 0
964, 1, 1636428383137, 1636428383406, 269, 1, 268, 0, 0, 0
965, 1, 1636428383830, 1636428384098, 268, 0, 268, 0, 0, 0
966, 1, 1636428384129, 1636428384394, 265, 1, 264, 0, 0, 0
967, 1, 1636428384393, 1636428384657, 264, 1, 263, 0, 0, 0
968, 1, 1636428384418, 1636428384686, 268, 0, 268, 0, 0, 0
969, 1, 1636428384437, 1636428384706, 269, 1, 268, 0, 0, 0
970, 1, 1636428384461, 1636428384721, 260, 0, 260, 0, 0, 0
971, 1, 1636428384489, 1636428384753, 264, 1, 263, 1, 0, 1
972, 1, 1636428384789, 1636428385058, 269, 0, 269, 0, 0, 0
973, 1, 1636428384853, 1636428385117, 264, 1, 263, 1, 0, 1
975, 1, 1636428385141, 1636428385414, 273, 1, 272, 0, 0, 0
976, 1, 1636428385161, 1636428385426, 265, 0, 265, 0, 0, 0
977, 1, 1636428385758, 1636428386030, 272, 0, 272, 0, 0, 0
979, 1, 1636428386277, 1636428386542, 265, 1, 264, 0, 0, 0
980, 1, 1636428386429, 1636428386697, 268, 1, 267, 0, 0, 0
981, 1, 1636428386458, 1636428386721, 263, 0, 263, 0, 0, 0
982, 1, 1636428386705, 1636428386974, 269, 0, 269, 0, 0, 0
985, 1, 1636428386782, 1636428387049, 267, 0, 267, 0, 0, 0
986, 1, 1636428387069, 1636428387338, 269, 1, 268, 0, 0, 0
987, 1, 1636428387226, 1636428387494, 268, 0, 268, 0, 0, 0
990, 1, 1636428388357, 1636428388626, 269, 1, 268, 0, 0, 0
991, 1, 1636428388433, 1636428388701, 268, 1, 267, 0, 0, 0
992, 1, 1636428388477, 1636428388742, 265, 1, 264, 0, 0, 0
993, 1, 1636428388870, 1636428389142, 272, 0, 272, 0, 0, 0
995, 1, 1636428389150, 1636428389418, 268, 0, 268, 0, 0, 0
996, 1, 1636428390410, 1636428390674, 264, 0, 264, 0, 0, 0
997, 1, 1636428390445, 1636428390710, 265, 1, 264, 0, 1, 1
999, 1, 1636428390922, 1636428391186, 264, 0, 264, 0, 0, 0
1001, 1, 1636428392685, 1636428392949, 264, 1, 263, 0, 0, 0
983, 1, 1636428392726, 1636428392990, 264, 0, 264, 0, 0, 0
1002, 1, 1636428392817, 1636428393081, 264, 1, 263, 1, 0, 1
1003, 1, 1636428393029, 1636428393294, 265, 1, 264, 0, 0, 0
1011, 1, 1636428393021, 1636428393294, 273, 1, 272, 0, 0, 0
1006, 1, 1636428393033, 1636428393301, 268, 0, 268, 0, 0, 0
1004, 1, 1636428393305, 1636428393574, 269, 1, 268, 0, 0, 0
1013, 1, 1636428394374, 1636428394638, 264, 0, 264, 0, 0, 0
1014, 1, 1636428394554, 1636428394826, 272, 0, 272, 0, 0, 0
1015, 1, 1636428394877, 1636428395153, 276, 1, 275, 1, 0, 1
1017, 1, 1636428395009, 1636428395274, 265, 1, 264, 0, 0, 0
1018, 1, 1636428395021, 1636428395290, 269, 1, 268, 0, 1, 1
1016, 1, 1636428395161, 1636428395430, 269, 0, 269, 0, 0, 0
1019, 1, 1636428395522, 1636428395790, 268, 0, 268, 0, 0, 0
1020, 1, 1636428396294, 1636428396557, 263, 1, 262, 0, 0, 0
1021, 1, 1636428396517, 1636428396806, 289, 1, 288, 0, 1, 1
1022, 1, 1636428396546, 1636428396817, 271, 0, 271, 0, 0, 0
1023, 1, 1636428396809, 1636428397074, 265, 0, 265, 0, 0, 0
1025, 1, 1636428396986, 1636428397253, 267, 0, 267, 0, 0, 0
1024, 1, 1636428397082, 1636428397350, 268, 0, 268, 0, 0, 0
1027, 1, 1636428397173, 1636428397438, 265, 1, 264, 1, 0, 1
1028, 1, 1636428397465, 1636428397766, 301, 1, 300, 0, 0, 0
1029, 1, 1636428398133, 1636428398398, 265, 1, 264, 0, 0, 0
1030, 1, 1636428398298, 1636428398569, 271, 0, 271, 0, 0, 0
1031, 1, 1636428398537, 1636428398802, 265, 1, 264, 0, 0, 0
1032, 1, 1636428398546, 1636428398809, 263, 0, 263, 0, 0, 0
1033, 1, 1636428398650, 1636428398914, 264, 0, 264, 0, 0, 0
1034, 1, 1636428398821, 1636428399085, 264, 0, 264, 0, 0, 0
1036, 1, 1636428398942, 1636428399214, 272, 0, 272, 0, 0, 0
1035, 1, 1636428399093, 1636428399362, 269, 1, 268, 0, 0, 0
1037, 1, 1636428399178, 1636428399442, 264, 0, 264, 0, 0, 0
1038, 1, 1636428399369, 1636428399642, 273, 1, 272, 0, 0, 0
1039, 1, 1636428399450, 1636428399713, 263, 0, 263, 0, 0, 0
1040, 1, 1636428400146, 1636428400413, 267, 0, 267, 0, 0, 0
1041, 1, 1636428400262, 1636428400525, 263, 0, 263, 0, 0, 0
1042, 1, 1636428400413, 1636428400681, 268, 1, 267, 0, 0, 0
1000, 1, 1636428400457, 1636428400721, 264, 0, 264, 0, 0, 0
1043, 1, 1636428400498, 1636428400761, 263, 0, 263, 0, 0, 0
1044, 1, 1636428400645, 1636428400909, 264, 1, 263, 0, 0, 0
1045, 1, 1636428400701, 1636428400969, 268, 1, 267, 0, 0, 0
1047, 1, 1636428400858, 1636428401122, 264, 0, 264, 0, 0, 0
1048, 1, 1636428400913, 1636428401178, 265, 1, 264, 0, 0, 0
1046, 1, 1636428400982, 1636428401253, 271, 0, 271, 0, 0, 0
1050, 1, 1636428401150, 1636428401413, 263, 0, 263, 0, 0, 0
1049, 1, 1636428401178, 1636428401449, 271, 0, 271, 0, 0, 0
1051, 1, 1636428401349, 1636428401626, 277, 0, 277, 0, 0, 0
1052, 1, 1636428401466, 1636428401734, 268, 0, 268, 0, 0, 0
1053, 1, 1636428402069, 1636428402334, 265, 1, 264, 0, 0, 0
1054, 1, 1636428402238, 1636428402513, 275, 0, 275, 0, 0, 0
1055, 1, 1636428402349, 1636428402617, 268, 1, 267, 0, 0, 0
1056, 1, 1636428402385, 1636428402650, 265, 1, 264, 0, 0, 0
1057, 1, 1636428402614, 1636428402878, 264, 0, 264, 0, 0, 0
1058, 1, 1636428402625, 1636428402894, 269, 0, 269, 0, 0, 0
1060, 1, 1636428402853, 1636428403273, 420, 1, 419, 0, 1, 1
1059, 1, 1636428403098, 1636428403365, 267, 0, 267, 0, 0, 0
1061, 1, 1636428403193, 1636428403490, 297, 1, 296, 0, 1, 1
1062, 1, 1636428403313, 1636428403577, 264, 1, 263, 0, 0, 0
1065, 1, 1636428403405, 1636428403673, 268, 1, 267, 0, 0, 0
1064, 1, 1636428403413, 1636428403677, 264, 0, 264, 0, 0, 0
1063, 1, 1636428403417, 1636428403685, 268, 0, 268, 0, 0, 0
1026, 1, 1636428403445, 1636428403709, 264, 1, 263, 1, 0, 1
1066, 1, 1636428403585, 1636428403849, 264, 1, 263, 0, 0, 0
1070, 1, 1636428403917, 1636428404185, 268, 1, 267, 1, 0, 1
1072, 1, 1636428404037, 1636428404305, 268, 0, 268, 0, 0, 0
1074, 1, 1636428404349, 1636428404618, 269, 1, 268, 0, 0, 0
1075, 1, 1636428404381, 1636428404645, 264, 0, 264, 0, 0, 0
1076, 1, 1636428404425, 1636428404689, 264, 1, 263, 0, 0, 0
1077, 1, 1636428404581, 1636428404849, 268, 1, 267, 0, 1, 1
1078, 1, 1636428404677, 1636428404950, 273, 1, 272, 0, 0, 0
1079, 1, 1636428404766, 1636428405029, 263, 0, 263, 0, 0, 0
1081, 1, 1636428404905, 1636428405169, 264, 1, 263, 0, 0, 0
1082, 1, 1636428405177, 1636428405441, 264, 1, 263, 0, 0, 0
1083, 1, 1636428405201, 1636428405466, 265, 1, 264, 1, 0, 1
1084, 1, 1636428405257, 1636428405522, 265, 1, 264, 0, 0, 0
1085, 1, 1636428405353, 1636428405621, 268, 0, 268, 0, 0, 0
1086, 1, 1636428405398, 1636428405662, 264, 0, 264, 0, 0, 0
1087, 1, 1636428405806, 1636428406074, 268, 0, 268, 0, 0, 0
1088, 1, 1636428406061, 1636428406325, 264, 1, 263, 0, 0, 0
1089, 1, 1636428406273, 1636428406537, 264, 1, 263, 0, 1, 1
1090, 1, 1636428406345, 1636428406618, 273, 1, 272, 0, 1, 1
1091, 1, 1636428406381, 1636428406650, 269, 1, 268, 0, 1, 1
1092, 1, 1636428406597, 1636428406865, 268, 1, 267, 1, 0, 1
1093, 1, 1636428406726, 1636428406998, 272, 0, 272, 0, 0, 0
1094, 1, 1636428406761, 1636428407030, 269, 1, 268, 0, 0, 0
1095, 1, 1636428406898, 1636428407162, 264, 0, 264, 0, 0, 0
1096, 1, 1636428407061, 1636428407326, 265, 1, 264, 1, 0, 1
1097, 1, 1636428407161, 1636428407426, 265, 1, 264, 0, 0, 0
1098, 1, 1636428407241, 1636428407514, 273, 1, 272, 0, 0, 0
1099, 1, 1636428407358, 1636428407622, 264, 0, 264, 0, 0, 0
1101, 1, 1636428407826, 1636428408090, 264, 0, 264, 0, 0, 0
1102, 1, 1636428408066, 1636428408338, 272, 0, 272, 0, 0, 0
1103, 1, 1636428408233, 1636428408498, 265, 1, 264, 1, 0, 1
1104, 1, 1636428408341, 1636428408610, 269, 1, 268, 0, 1, 1
1105, 1, 1636428408373, 1636428408638, 265, 1, 264, 1, 0, 1
1106, 1, 1636428408602, 1636428408866, 264, 0, 264, 0, 0, 0
1107, 1, 1636428408665, 1636428408929, 264, 1, 263, 0, 0, 0
1108, 1, 1636428408753, 1636428409017, 264, 1, 263, 0, 0, 0
1109, 1, 1636428408845, 1636428409110, 265, 1, 264, 1, 0, 1
1110, 1, 1636428409157, 1636428409422, 265, 1, 264, 1, 0, 1
1111, 1, 1636428409165, 1636428409429, 264, 1, 263, 0, 1, 1
1112, 1, 1636428409326, 1636428409594, 268, 0, 268, 0, 0, 0
1113, 1, 1636428409354, 1636428409618, 264, 0, 264, 0, 0, 0
1114, 1, 1636428409754, 1636428410026, 272, 0, 272, 0, 0, 0
1115, 1, 1636428409994, 1636428410266, 272, 0, 272, 0, 0, 0
1116, 1, 1636428410298, 1636428410562, 264, 0, 264, 0, 0, 0
1117, 1, 1636428410333, 1636428410598, 265, 1, 264, 0, 0, 0
1118, 1, 1636428410437, 1636428410702, 265, 1, 264, 0, 0, 0
1119, 1, 1636428410478, 1636428410754, 276, 0, 276, 0, 0, 0
1120, 1, 1636428410562, 1636428410830, 268, 0, 268, 0, 0, 0
1121, 1, 1636428410754, 1636428411022, 268, 0, 268, 0, 0, 0
1122, 1, 1636428410826, 1636428411090, 264, 0, 264, 0, 0, 0
1123, 1, 1636428411158, 1636428411426, 268, 0, 268, 0, 0, 0
1125, 1, 1636428411233, 1636428411501, 268, 1, 267, 0, 1, 1
1124, 1, 1636428411233, 1636428411501, 268, 1, 267, 1, 0, 1
1126, 1, 1636428411402, 1636428411670, 268, 0, 268, 0, 0, 0
1127, 1, 1636428411629, 1636428411894, 265, 1, 264, 1, 0, 1
1128, 1, 1636428412077, 1636428412346, 269, 1, 268, 0, 0, 0
1129, 1, 1636428412273, 1636428412546, 273, 1, 272, 1, 0, 1
1130, 1, 1636428412338, 1636428412605, 267, 0, 267, 0, 0, 0
1131, 1, 1636428412517, 1636428412785, 268, 1, 267, 0, 0, 0
1132, 1, 1636428412569, 1636428412838, 269, 0, 269, 0, 0, 0
1133, 1, 1636428412638, 1636428412901, 263, 0, 263, 0, 0, 0
1134, 1, 1636428412750, 1636428413013, 263, 0, 263, 0, 0, 0
1135, 1, 1636428412873, 1636428413138, 265, 1, 264, 0, 0, 0
1136, 1, 1636428413037, 1636428413306, 269, 1, 268, 0, 0, 0
1137, 1, 1636428413313, 1636428413578, 265, 1, 264, 0, 0, 0
1138, 1, 1636428413317, 1636428413582, 265, 1, 264, 0, 1, 1
1139, 1, 1636428413629, 1636428413898, 269, 1, 268, 0, 1, 1
1140, 1, 1636428413810, 1636428414089, 279, 0, 279, 0, 0, 0
1141, 1, 1636428414129, 1636428414389, 260, 0, 260, 0, 0, 0
1142, 1, 1636428414157, 1636428414421, 264, 0, 264, 0, 0, 0
1100, 1, 1636428414173, 1636428414433, 260, 0, 260, 0, 0, 0
1145, 1, 1636428414353, 1636428414613, 260, 1, 259, 1, 0, 1
1146, 1, 1636428414358, 1636428414626, 268, 0, 268, 0, 0, 0
1147, 1, 1636428414533, 1636428414801, 268, 1, 267, 0, 0, 0
1150, 1, 1636428414637, 1636428414905, 268, 1, 267, 1, 0, 1
1149, 1, 1636428414641, 1636428414905, 264, 1, 263, 0, 0, 0
1151, 1, 1636428414765, 1636428415030, 265, 1, 264, 0, 0, 0
1080, 2, 1636428404949, 1636428415051, 10102, 0, 10102, 0, 0, 0
1152, 1, 1636428414797, 1636428415062, 265, 1, 264, 0, 1, 1
1148, 1, 1636428414805, 1636428415074, 269, 0, 269, 0, 0, 0
1153, 1, 1636428414813, 1636428415081, 268, 1, 267, 0, 1, 1
1154, 1, 1636428415190, 1636428415454, 264, 0, 264, 0, 0, 0
1155, 1, 1636428415190, 1636428415454, 264, 0, 264, 0, 0, 0
1156, 1, 1636428415410, 1636428415674, 264, 0, 264, 0, 0, 0
1157, 1, 1636428415437, 1636428415706, 269, 1, 268, 0, 0, 0
1158, 1, 1636428415533, 1636428415798, 265, 1, 264, 0, 0, 0
1160, 1, 1636428415814, 1636428416078, 264, 0, 264, 0, 0, 0
1161, 1, 1636428416098, 1636428416369, 271, 0, 271, 0, 0, 0
1162, 1, 1636428416266, 1636428416529, 263, 0, 263, 0, 0, 0
1163, 1, 1636428416313, 1636428416581, 268, 1, 267, 0, 0, 0
1164, 1, 1636428416365, 1636428416633, 268, 0, 268, 0, 0, 0
1166, 1, 1636428416453, 1636428416717, 264, 0, 264, 0, 0, 0
1167, 1, 1636428416657, 1636428416922, 265, 1, 264, 0, 0, 0
1168, 1, 1636428416678, 1636428416942, 264, 0, 264, 0, 0, 0
1170, 1, 1636428416750, 1636428417014, 264, 0, 264, 0, 0, 0
1172, 1, 1636428416886, 1636428417150, 264, 0, 264, 0, 0, 0
1173, 1, 1636428417197, 1636428417461, 264, 1, 263, 1, 0, 1
1174, 1, 1636428417410, 1636428417677, 267, 0, 267, 0, 0, 0
1175, 1, 1636428417446, 1636428417709, 263, 0, 263, 0, 0, 0
1177, 1, 1636428417722, 1636428417990, 268, 0, 268, 0, 0, 0
1178, 1, 1636428418213, 1636428418481, 268, 1, 267, 1, 0, 1
1179, 1, 1636428418278, 1636428418542, 264, 0, 264, 0, 0, 0
1180, 1, 1636428418298, 1636428418561, 263, 0, 263, 0, 0, 0
1182, 1, 1636428418533, 1636428418797, 264, 1, 263, 0, 0, 0
1184, 1, 1636428418789, 1636428419054, 265, 1, 264, 1, 0, 1
1185, 1, 1636428418850, 1636428419118, 268, 0, 268, 0, 0, 0
1186, 1, 1636428418922, 1636428419186, 264, 0, 264, 0, 0, 0
1187, 1, 1636428419306, 1636428419570, 264, 0, 264, 0, 0, 0
1192, 1, 1636428420330, 1636428420593, 263, 0, 263, 0, 0, 0
1193, 1, 1636428420377, 1636428420645, 268, 1, 267, 1, 0, 1
1194, 1, 1636428420641, 1636428420906, 265, 1, 264, 0, 1, 1
1195, 1, 1636428420762, 1636428421026, 264, 0, 264, 0, 0, 0
1196, 1, 1636428420809, 1636428421073, 264, 1, 263, 0, 1, 1
1199, 1, 1636428422342, 1636428422613, 271, 0, 271, 0, 0, 0
1200, 1, 1636428422377, 1636428422645, 268, 1, 267, 0, 0, 0
1201, 1, 1636428422638, 1636428422906, 268, 0, 268, 0, 0, 0
1203, 1, 1636428422801, 1636428423066, 265, 1, 264, 1, 0, 1
1204, 1, 1636428424377, 1636428424641, 264, 0, 264, 0, 0, 0
1205, 1, 1636428424421, 1636428424682, 261, 0, 261, 0, 0, 0
1206, 1, 1636428424602, 1636428424866, 264, 0, 264, 0, 0, 0
1208, 1, 1636428424722, 1636428424994, 272, 0, 272, 0, 0, 0
1209, 1, 1636428424769, 1636428425033, 264, 1, 263, 0, 0, 0
1207, 1, 1636428424873, 1636428425138, 265, 1, 264, 0, 0, 0
1210, 1, 1636428425989, 1636428426253, 264, 1, 263, 1, 0, 1
1211, 1, 1636428426390, 1636428426654, 264, 0, 264, 0, 0, 0
1212, 1, 1636428426453, 1636428426717, 264, 1, 263, 0, 0, 0
1213, 1, 1636428426525, 1636428426902, 377, 1, 376, 1, 0, 1
1214, 1, 1636428426905, 1636428427170, 265, 1, 264, 0, 1, 1
1215, 1, 1636428426909, 1636428427170, 261, 0, 261, 0, 0, 0
1216, 1, 1636428426998, 1636428427262, 264, 0, 264, 0, 0, 0
1217, 1, 1636428427129, 1636428427394, 265, 0, 265, 0, 0, 0
1218, 1, 1636428427278, 1636428427566, 288, 0, 288, 0, 0, 0
1219, 1, 1636428427870, 1636428428134, 264, 0, 264, 0, 0, 0
1220, 1, 1636428427885, 1636428428157, 272, 1, 271, 0, 0, 0
1221, 1, 1636428428381, 1636428428654, 273, 1, 272, 0, 0, 0
1222, 1, 1636428428470, 1636428428781, 311, 0, 311, 0, 0, 0
1223, 1, 1636428428534, 1636428428798, 264, 0, 264, 0, 0, 0
1225, 1, 1636428428701, 1636428428965, 264, 0, 264, 0, 0, 0
1224, 1, 1636428428789, 1636428429053, 264, 1, 263, 0, 1, 1
1227, 1, 1636428428873, 1636428429141, 268, 0, 268, 0, 0, 0
1226, 1, 1636428428917, 1636428429181, 264, 1, 263, 1, 0, 1
1228, 1, 1636428429041, 1636428429306, 265, 1, 264, 1, 0, 1
1229, 1, 1636428429082, 1636428429369, 287, 0, 287, 0, 0, 0
1230, 1, 1636428429113, 1636428429385, 272, 1, 271, 1, 0, 1
1231, 1, 1636428429718, 1636428429982, 264, 0, 264, 0, 0, 0
1233, 1, 1636428429837, 1636428430097, 260, 0, 260, 0, 0, 0
1232, 1, 1636428429869, 1636428430138, 269, 0, 269, 0, 0, 0
1234, 1, 1636428430261, 1636428430530, 269, 1, 268, 0, 0, 0
1235, 1, 1636428430354, 1636428430617, 263, 0, 263, 0, 0, 0
1237, 1, 1636428430565, 1636428430830, 265, 1, 264, 0, 0, 0
1238, 1, 1636428430597, 1636428430862, 265, 1, 264, 0, 0, 0
1236, 1, 1636428430625, 1636428430889, 264, 1, 263, 0, 1, 1
1239, 1, 1636428430633, 1636428430897, 264, 1, 263, 0, 1, 1
1240, 1, 1636428430805, 1636428431070, 265, 1, 264, 1, 0, 1
1243, 1, 1636428430986, 1636428431254, 268, 0, 268, 0, 0, 0
1242, 1, 1636428430986, 1636428431254, 268, 0, 268, 0, 0, 0
1244, 1, 1636428431046, 1636428431309, 263, 0, 263, 0, 0, 0
1245, 1, 1636428431346, 1636428431610, 264, 0, 264, 0, 0, 0
1246, 1, 1636428431670, 1636428431933, 263, 0, 263, 0, 0, 0
1247, 1, 1636428431725, 1636428431989, 264, 1, 263, 0, 1, 1
1249, 1, 1636428431766, 1636428432029, 263, 0, 263, 0, 0, 0
1248, 1, 1636428431777, 1636428432045, 268, 1, 267, 1, 0, 1
1250, 1, 1636428432197, 1636428432462, 265, 1, 264, 0, 1, 1
1251, 1, 1636428432426, 1636428432689, 263, 0, 263, 0, 0, 0
1252, 1, 1636428432473, 1636428432757, 284, 1, 283, 0, 1, 1
1253, 1, 1636428432533, 1636428432797, 264, 1, 263, 0, 0, 0
1255, 1, 1636428432682, 1636428432945, 263, 0, 263, 0, 0, 0
1254, 1, 1636428432698, 1636428432961, 263, 0, 263, 0, 0, 0
1257, 1, 1636428432926, 1636428433190, 264, 0, 264, 0, 0, 0
1258, 1, 1636428432981, 1636428433246, 265, 1, 264, 1, 0, 1
1259, 1, 1636428432981, 1636428433246, 265, 1, 264, 0, 0, 0
1260, 1, 1636428433069, 1636428433334, 265, 0, 265, 0, 0, 0
1261, 1, 1636428433217, 1636428433482, 265, 1, 264, 0, 0, 0
1262, 1, 1636428433625, 1636428433894, 269, 1, 268, 0, 1, 1
1263, 1, 1636428433662, 1636428433925, 263, 0, 263, 0, 0, 0
1264, 1, 1636428433665, 1636428433934, 269, 1, 268, 0, 0, 0
1265, 1, 1636428433774, 1636428434046, 272, 0, 272, 0, 0, 0
1266, 1, 1636428434221, 1636428434485, 264, 1, 263, 0, 0, 0
1267, 1, 1636428434305, 1636428434574, 269, 1, 268, 1, 0, 1
1268, 1, 1636428434469, 1636428434733, 264, 1, 263, 0, 1, 1
1270, 1, 1636428434585, 1636428434846, 261, 0, 261, 0, 0, 0
1269, 1, 1636428434581, 1636428434846, 265, 1, 264, 1, 0, 1
1271, 1, 1636428434605, 1636428434870, 265, 1, 264, 1, 0, 1
1272, 1, 1636428434809, 1636428435077, 268, 0, 268, 0, 0, 0
1273, 1, 1636428434937, 1636428435202, 265, 1, 264, 0, 0, 0
1274, 1, 1636428434993, 1636428435257, 264, 1, 263, 0, 0, 0
1275, 1, 1636428435014, 1636428435286, 272, 0, 272, 0, 0, 0
1276, 1, 1636428435165, 1636428435433, 268, 1, 267, 0, 0, 0
1277, 1, 1636428435569, 1636428435834, 265, 1, 264, 1, 0, 1
1278, 1, 1636428435661, 1636428435926, 265, 1, 264, 1, 0, 1
1279, 1, 1636428435698, 1636428435961, 263, 0, 263, 0, 0, 0
1280, 1, 1636428435810, 1636428436078, 268, 0, 268, 0, 0, 0
1281, 1, 1636428436137, 1636428436402, 265, 1, 264, 0, 0, 0
1282, 1, 1636428436225, 1636428436494, 269, 1, 268, 1, 0, 1
1284, 1, 1636428436469, 1636428436737, 268, 1, 267, 0, 0, 0
1286, 1, 1636428436497, 1636428436762, 265, 1, 264, 0, 0, 0
1283, 1, 1636428436502, 1636428436765, 263, 0, 263, 0, 0, 0
1285, 1, 1636428436502, 1636428436766, 264, 0, 264, 0, 0, 0
1287, 1, 1636428436813, 1636428437082, 269, 1, 268, 0, 0, 0
1288, 1, 1636428436878, 1636428437146, 268, 0, 268, 0, 0, 0
1289, 1, 1636428436989, 1636428437258, 269, 1, 268, 0, 1, 1
1291, 1, 1636428437081, 1636428437350, 269, 1, 268, 0, 0, 0
1292, 1, 1636428437081, 1636428437350, 269, 2, 267, 0, 0, 0
1293, 1, 1636428437117, 1636428437381, 264, 0, 264, 0, 0, 0
1294, 1, 1636428437149, 1636428437414, 265, 1, 264, 0, 1, 1
1290, 1, 1636428437357, 1636428437622, 265, 1, 264, 0, 0, 0
1295, 1, 1636428437497, 1636428437761, 264, 1, 263, 0, 0, 0
1296, 1, 1636428437697, 1636428437962, 265, 1, 264, 0, 1, 1
1297, 1, 1636428437729, 1636428437993, 264, 1, 263, 0, 0, 0
1298, 1, 1636428437901, 1636428438166, 265, 1, 264, 0, 0, 0
1299, 1, 1636428438022, 1636428438286, 264, 0, 264, 0, 0, 0
1300, 1, 1636428438358, 1636428438622, 264, 0, 264, 0, 0, 0
1301, 1, 1636428438437, 1636428438701, 264, 1, 263, 0, 0, 0
1303, 1, 1636428438482, 1636428438745, 263, 0, 263, 0, 0, 0
1304, 1, 1636428438509, 1636428438782, 273, 1, 272, 0, 1, 1
1302, 1, 1636428438629, 1636428438894, 265, 1, 264, 0, 1, 1
1305, 1, 1636428438817, 1636428439086, 269, 1, 268, 0, 1, 1
1306, 1, 1636428438857, 1636428439121, 264, 4, 260, 0, 0, 0
1307, 1, 1636428438905, 1636428439166, 261, 0, 261, 0, 0, 0
1308, 1, 1636428438977, 1636428439241, 264, 1, 263, 0, 0, 0
1309, 1, 1636428439018, 1636428439281, 263, 0, 263, 0, 0, 0
1312, 1, 1636428439166, 1636428439433, 267, 0, 267, 0, 0, 0
1311, 1, 1636428439169, 1636428439433, 264, 1, 263, 0, 1, 1
1310, 1, 1636428439289, 1636428439557, 268, 1, 267, 0, 0, 0
1313, 1, 1636428439497, 1636428439762, 265, 1, 264, 0, 1, 1
1314, 1, 1636428439733, 1636428440006, 273, 0, 273, 0, 0, 0
1315, 1, 1636428439762, 1636428440026, 264, 0, 264, 0, 0, 0
1316, 1, 1636428439798, 1636428440061, 263, 0, 263, 0, 0, 0
1317, 1, 1636428440037, 1636428440305, 268, 1, 267, 0, 1, 1
1318, 1, 1636428440361, 1636428440625, 264, 1, 263, 1, 0, 1
1319, 1, 1636428440369, 1636428440633, 264, 1, 263, 0, 0, 0
1320, 1, 1636428440397, 1636428440662, 265, 1, 264, 0, 1, 1
1321, 1, 1636428440637, 1636428440901, 264, 1, 263, 0, 0, 0
1322, 1, 1636428440669, 1636428440933, 264, 1, 263, 1, 0, 1
1323, 1, 1636428440837, 1636428441102, 265, 1, 264, 0, 0, 0
1324, 1, 1636428440841, 1636428441109, 268, 0, 268, 0, 0, 0
1325, 1, 1636428440909, 1636428441173, 264, 1, 263, 1, 0, 1
1326, 1, 1636428440945, 1636428441209, 264, 1, 263, 0, 0, 0
1328, 1, 1636428441033, 1636428441294, 261, 0, 261, 0, 0, 0
1329, 1, 1636428441077, 1636428441341, 264, 0, 264, 0, 0, 0
1327, 1, 1636428441181, 1636428441445, 264, 0, 264, 0, 0, 0
1330, 1, 1636428441253, 1636428441517, 264, 0, 264, 0, 0, 0
1331, 1, 1636428441297, 1636428441565, 268, 1, 267, 0, 1, 1
1332, 1, 1636428441537, 1636428441798, 261, 0, 261, 0, 0, 0
1333, 1, 1636428441733, 1636428441997, 264, 1, 263, 0, 0, 0
1334, 1, 1636428441781, 1636428442045, 264, 1, 263, 0, 0, 0
1335, 1, 1636428441846, 1636428442113, 267, 0, 267, 0, 0, 0
1336, 1, 1636428441905, 1636428442169, 264, 1, 263, 0, 0, 0
1337, 1, 1636428442345, 1636428442609, 264, 1, 263, 0, 0, 0
1338, 1, 1636428442370, 1636428442633, 263, 0, 263, 0, 0, 0
1339, 1, 1636428442437, 1636428442749, 312, 0, 312, 0, 0, 0
1341, 1, 1636428442577, 1636428442849, 272, 1, 271, 0, 0, 0
1340, 1, 1636428442669, 1636428442937, 268, 1, 267, 0, 0, 0
1344, 1, 1636428442849, 1636428443117, 268, 1, 267, 0, 1, 1
1345, 1, 1636428442890, 1636428443153, 263, 0, 263, 0, 0, 0
1342, 1, 1636428442890, 1636428443153, 263, 0, 263, 0, 0, 0
1343, 1, 1636428442897, 1636428443161, 264, 0, 264, 0, 0, 0
1347, 1, 1636428443013, 1636428443281, 268, 0, 268, 0, 0, 0
1348, 1, 1636428443058, 1636428443321, 263, 0, 263, 0, 0, 0
1346, 1, 1636428443113, 1636428443382, 269, 5, 264, 5, 0, 5
1349, 1, 1636428443149, 1636428443417, 268, 1, 267, 0, 1, 1
1350, 1, 1636428443161, 1636428443429, 268, 1, 267, 0, 0, 0
1351, 1, 1636428443285, 1636428443549, 264, 1, 263, 0, 0, 0
1352, 1, 1636428443581, 1636428443850, 269, 1, 268, 0, 0, 0
1353, 1, 1636428443754, 1636428444017, 263, 0, 263, 0, 0, 0
1354, 1, 1636428443781, 1636428444050, 269, 0, 269, 0, 0, 0
1355, 1, 1636428443925, 1636428444194, 269, 1, 268, 1, 0, 1
1356, 1, 1636428443957, 1636428444229, 272, 1, 271, 0, 0, 0
1357, 1, 1636428444298, 1636428444561, 263, 0, 263, 0, 0, 0
1358, 1, 1636428444389, 1636428444653, 264, 1, 263, 1, 0, 1
1359, 1, 1636428444397, 1636428444665, 268, 0, 268, 0, 0, 0
1360, 1, 1636428444577, 1636428444845, 268, 1, 267, 0, 0, 0
1361, 1, 1636428444585, 1636428444849, 264, 0, 264, 0, 0, 0
1362, 1, 1636428444865, 1636428445133, 268, 1, 267, 0, 1, 1
1364, 1, 1636428444921, 1636428445185, 264, 1, 263, 0, 0, 0
1363, 1, 1636428444921, 1636428445193, 272, 1, 271, 0, 0, 0
1365, 1, 1636428444933, 1636428445201, 268, 0, 268, 0, 0, 0
1366, 1, 1636428444941, 1636428445213, 272, 0, 272, 0, 0, 0
1367, 1, 1636428445009, 1636428445273, 264, 1, 263, 1, 0, 1
1369, 1, 1636428445093, 1636428445357, 264, 1, 263, 0, 0, 0
1368, 1, 1636428445141, 1636428445401, 260, 0, 260, 0, 0, 0
1370, 1, 1636428445241, 1636428445510, 269, 0, 269, 0, 0, 0
1371, 1, 1636428445254, 1636428445521, 267, 0, 267, 0, 0, 0
1372, 1, 1636428445526, 1636428445794, 268, 0, 268, 0, 0, 0
1373, 1, 1636428445770, 1636428446034, 264, 0, 264, 0, 0, 0
1374, 1, 1636428445861, 1636428446125, 264, 1, 263, 0, 0, 0
1375, 1, 1636428445885, 1636428446150, 265, 1, 264, 0, 0, 0
1376, 1, 1636428445990, 1636428446253, 263, 0, 263, 0, 0, 0
1377, 1, 1636428446317, 1636428446577, 260, 0, 260, 0, 0, 0
1378, 1, 1636428446313, 1636428446585, 272, 1, 271, 1, 0, 1
1379, 1, 1636428446325, 1636428446594, 269, 1, 268, 0, 0, 0
1380, 1, 1636428446593, 1636428446857, 264, 1, 263, 0, 0, 0
1381, 1, 1636428446613, 1636428446874, 261, 0, 261, 0, 0, 0
1382, 1, 1636428446837, 1636428447106, 269, 1, 268, 1, 0, 1
1383, 1, 1636428446885, 1636428447153, 268, 1, 267, 0, 0, 0
1384, 1, 1636428446897, 1636428447161, 264, 1, 263, 0, 0, 0
1385, 1, 1636428446897, 1636428447169, 272, 1, 271, 0, 0, 0
1386, 1, 1636428446953, 1636428447218, 265, 1, 264, 0, 0, 0
1387, 1, 1636428447013, 1636428447286, 273, 1, 272, 0, 0, 0
1388, 1, 1636428447013, 1636428447286, 273, 1, 272, 0, 0, 0
1389, 1, 1636428447230, 1636428447494, 264, 0, 264, 0, 0, 0
1390, 1, 1636428447305, 1636428447573, 268, 1, 267, 0, 0, 0
1391, 1, 1636428447325, 1636428447593, 268, 1, 267, 1, 0, 1
1392, 1, 1636428447590, 1636428447854, 264, 0, 264, 0, 0, 0
1393, 1, 1636428447801, 1636428448066, 265, 1, 264, 1, 0, 1
1394, 1, 1636428447857, 1636428448122, 265, 0, 265, 0, 0, 0
1395, 1, 1636428447921, 1636428448185, 264, 1, 263, 0, 0, 0
1396, 1, 1636428447937, 1636428448206, 269, 1, 268, 0, 1, 1
1397, 1, 1636428448261, 1636428448530, 269, 0, 269, 0, 0, 0
1398, 1, 1636428448289, 1636428448558, 269, 1, 268, 0, 0, 0
1399, 1, 1636428448449, 1636428448717, 268, 1, 267, 1, 0, 1
1401, 1, 1636428448729, 1636428448993, 264, 1, 263, 0, 0, 0
1400, 1, 1636428448729, 1636428448993, 264, 1, 263, 0, 0, 0
1402, 1, 1636428448857, 1636428449121, 264, 1, 263, 0, 1, 1
1403, 1, 1636428448881, 1636428449142, 261, 0, 261, 0, 0, 0
1404, 1, 1636428448877, 1636428449142, 265, 1, 264, 0, 0, 0
1405, 1, 1636428448889, 1636428449153, 264, 0, 264, 0, 0, 0
1406, 1, 1636428448909, 1636428449169, 260, 1, 259, 0, 0, 0
1409, 1, 1636428449086, 1636428449350, 264, 0, 264, 0, 0, 0
1410, 1, 1636428449213, 1636428449477, 264, 1, 263, 0, 0, 0
1411, 1, 1636428449382, 1636428449645, 263, 0, 263, 0, 0, 0
1412, 1, 1636428449657, 1636428449921, 264, 1, 263, 0, 1, 1
1413, 1, 1636428449810, 1636428450074, 264, 0, 264, 0, 0, 0
1414, 1, 1636428449874, 1636428450138, 264, 0, 264, 0, 0, 0
1415, 1, 1636428449945, 1636428450210, 265, 1, 264, 1, 0, 1
1416, 1, 1636428449997, 1636428450266, 269, 1, 268, 1, 0, 1
1418, 1, 1636428450317, 1636428450582, 265, 0, 265, 0, 0, 0
1419, 1, 1636428450369, 1636428450633, 264, 1, 263, 1, 0, 1
1421, 1, 1636428450601, 1636428450870, 269, 1, 268, 0, 0, 0
1420, 1, 1636428450641, 1636428450910, 269, 1, 268, 0, 1, 1
1422, 1, 1636428450781, 1636428451046, 265, 1, 264, 0, 0, 0
1423, 1, 1636428450890, 1636428451154, 264, 0, 264, 0, 0, 0
1425, 1, 1636428450925, 1636428451190, 265, 1, 264, 1, 0, 1
1426, 1, 1636428450941, 1636428451206, 265, 1, 264, 0, 1, 1
1427, 1, 1636428451005, 1636428451274, 269, 1, 268, 0, 0, 0
1428, 1, 1636428451277, 1636428451541, 264, 1, 263, 0, 0, 0
1429, 1, 1636428451457, 1636428451722, 265, 1, 264, 1, 0, 1
1430, 1, 1636428451729, 1636428451994, 265, 1, 264, 1, 0, 1
1431, 1, 1636428451802, 1636428452069, 267, 0, 267, 0, 0, 0
1433, 1, 1636428451893, 1636428452162, 269, 1, 268, 1, 0, 1
1432, 1, 1636428451893, 1636428452162, 269, 1, 268, 1, 0, 1
1434, 1, 1636428452062, 1636428452326, 264, 0, 264, 0, 0, 0
1435, 1, 1636428452321, 1636428452590, 269, 1, 268, 0, 1, 1
1436, 1, 1636428452385, 1636428452653, 268, 1, 267, 1, 0, 1
1437, 1, 1636428452661, 1636428452925, 264, 1, 263, 0, 1, 1
1438, 1, 1636428452685, 1636428452949, 264, 1, 263, 0, 1, 1
1439, 1, 1636428452805, 1636428453069, 264, 1, 263, 0, 0, 0
1440, 1, 1636428452873, 1636428453138, 265, 1, 264, 0, 0, 0
1441, 1, 1636428452893, 1636428453158, 265, 1, 264, 0, 0, 0
1442, 1, 1636428453017, 1636428453289, 272, 0, 272, 0, 0, 0
1443, 1, 1636428453061, 1636428453330, 269, 1, 268, 0, 0, 0
1444, 1, 1636428453333, 1636428453601, 268, 0, 268, 0, 0, 0
1445, 1, 1636428453378, 1636428453642, 264, 0, 264, 0, 0, 0
1446, 1, 1636428453689, 1636428453953, 264, 1, 263, 0, 1, 1
1447, 1, 1636428453774, 1636428454037, 263, 0, 263, 0, 0, 0
1448, 1, 1636428453889, 1636428454158, 269, 1, 268, 0, 0, 0
1449, 1, 1636428454009, 1636428454273, 264, 1, 263, 0, 0, 0
1450, 1, 1636428454034, 1636428454297, 263, 0, 263, 0, 0, 0
1451, 1, 1636428454309, 1636428454573, 264, 1, 263, 0, 0, 0
1452, 1, 1636428454421, 1636428454690, 269, 1, 268, 0, 0, 0
1453, 1, 1636428454697, 1636428454966, 269, 1, 268, 0, 1, 1
1454, 1, 1636428454745, 1636428455010, 265, 1, 264, 0, 0, 0
1455, 1, 1636428454845, 1636428455117, 272, 0, 272, 0, 0, 0
1456, 1, 1636428454854, 1636428455121, 267, 0, 267, 0, 0, 0
1457, 1, 1636428454889, 1636428455161, 272, 0, 272, 0, 0, 0
1458, 1, 1636428454929, 1636428455198, 269, 1, 268, 0, 0, 0
1459, 1, 1636428455125, 1636428455390, 265, 0, 265, 0, 0, 0
1460, 1, 1636428455313, 1636428455578, 265, 1, 264, 0, 1, 1
1461, 1, 1636428455441, 1636428455709, 268, 1, 267, 0, 0, 0
1462, 1, 1636428455754, 1636428456021, 267, 0, 267, 0, 0, 0
1463, 1, 1636428455841, 1636428456105, 264, 1, 263, 0, 0, 0
1464, 1, 1636428455981, 1636428456245, 264, 1, 263, 0, 0, 0
1465, 1, 1636428456002, 1636428456266, 264, 0, 264, 0, 0, 0
1466, 1, 1636428456117, 1636428456381, 264, 1, 263, 0, 0, 0
1467, 1, 1636428456377, 1636428456642, 265, 1, 264, 0, 0, 0
1468, 1, 1636428456410, 1636428456677, 267, 0, 267, 0, 0, 0
1469, 1, 1636428456689, 1636428456957, 268, 1, 267, 0, 0, 0
1470, 1, 1636428456722, 1636428456985, 263, 0, 263, 0, 0, 0
1471, 1, 1636428456850, 1636428457113, 263, 0, 263, 0, 0, 0
1472, 1, 1636428456957, 1636428457225, 268, 1, 267, 0, 0, 0
1473, 1, 1636428456969, 1636428457233, 264, 1, 263, 1, 0, 1
1474, 1, 1636428456969, 1636428457233, 264, 1, 263, 0, 1, 1
1475, 1, 1636428457093, 1636428457358, 265, 1, 264, 0, 0, 0
1476, 1, 1636428457390, 1636428457653, 263, 0, 263, 0, 0, 0
1477, 1, 1636428457558, 1636428457822, 264, 0, 264, 0, 0, 0
1478, 1, 1636428457833, 1636428458101, 268, 1, 267, 0, 0, 0
1479, 1, 1636428457918, 1636428458181, 263, 0, 263, 0, 0, 0
1480, 1, 1636428457969, 1636428458233, 264, 1, 263, 0, 0, 0
1481, 1, 1636428458105, 1636428458369, 264, 1, 263, 1, 0, 1
1482, 1, 1636428458165, 1636428458429, 264, 1, 263, 1, 0, 1
1483, 1, 1636428458385, 1636428458650, 265, 1, 264, 0, 0, 0
1485, 1, 1636428458453, 1636428458718, 265, 1, 264, 0, 0, 0
1484, 1, 1636428458658, 1636428458921, 263, 0, 263, 0, 0, 0
1486, 1, 1636428458802, 1636428459098, 296, 0, 296, 0, 0, 0
1487, 1, 1636428458925, 1636428459189, 264, 0, 264, 0, 0, 0
1488, 1, 1636428459018, 1636428459281, 263, 0, 263, 0, 0, 0
1490, 1, 1636428459057, 1636428459321, 264, 0, 264, 0, 0, 0
1489, 1, 1636428459101, 1636428459373, 272, 1, 271, 0, 1, 1
1491, 1, 1636428459189, 1636428459457, 268, 1, 267, 1, 0, 1
1492, 1, 1636428459445, 1636428459709, 264, 1, 263, 0, 0, 0
1494, 1, 1636428459505, 1636428459774, 269, 1, 268, 1, 0, 1
1493, 1, 1636428459505, 1636428459774, 269, 1, 268, 1, 0, 1
1495, 1, 1636428459525, 1636428459789, 264, 0, 264, 0, 0, 0
1496, 1, 1636428459801, 1636428460065, 264, 1, 263, 0, 0, 0
1497, 1, 1636428460021, 1636428460334, 313, 0, 313, 0, 0, 0
1498, 1, 1636428460102, 1636428460369, 267, 0, 267, 0, 0, 0
1499, 1, 1636428460157, 1636428460421, 264, 1, 263, 0, 0, 0
1500, 1, 1636428460165, 1636428460429, 264, 1, 263, 0, 0, 0
1424, 1, 1636428460289, 1636428460549, 260, 1, 259, 1, 0, 1
1501, 1, 1636428460469, 1636428460730, 261, 0, 261, 0, 0, 0
1503, 1, 1636428460557, 1636428460821, 264, 1, 263, 0, 0, 0
1504, 1, 1636428460641, 1636428460909, 268, 1, 267, 0, 0, 0
1502, 1, 1636428460741, 1636428461009, 268, 1, 267, 0, 0, 0
1506, 1, 1636428460886, 1636428461149, 263, 0, 263, 0, 0, 0
1505, 1, 1636428460913, 1636428461178, 265, 0, 265, 0, 0, 0
1507, 1, 1636428460949, 1636428461213, 264, 1, 263, 1, 0, 1
1508, 1, 1636428460953, 1636428461221, 268, 1, 267, 0, 0, 0
1510, 1, 1636428461069, 1636428461333, 264, 1, 263, 1, 0, 1
1511, 1, 1636428461161, 1636428461433, 272, 1, 271, 0, 0, 0
1509, 1, 1636428461185, 1636428461454, 269, 0, 269, 0, 0, 0
1512, 1, 1636428461338, 1636428461602, 264, 0, 264, 0, 0, 0
1514, 1, 1636428461445, 1636428461705, 260, 0, 260, 0, 0, 0
1513, 1, 1636428461437, 1636428461713, 276, 1, 275, 0, 0, 0
1515, 1, 1636428461658, 1636428461930, 272, 0, 272, 0, 0, 0
1516, 1, 1636428461937, 1636428462206, 269, 1, 268, 0, 1, 1
1518, 1, 1636428462093, 1636428462357, 264, 1, 263, 1, 0, 1
1519, 1, 1636428462134, 1636428462398, 264, 0, 264, 0, 0, 0
1520, 1, 1636428462261, 1636428462529, 268, 1, 267, 1, 0, 1
1521, 1, 1636428462562, 1636428462829, 267, 0, 267, 0, 0, 0
1523, 1, 1636428462573, 1636428462841, 268, 1, 267, 0, 0, 0
1525, 1, 1636428462773, 1636428463046, 273, 1, 272, 0, 1, 1
1526, 1, 1636428462825, 1636428463090, 265, 1, 264, 0, 0, 0
1522, 1, 1636428462837, 1636428463101, 264, 0, 264, 0, 0, 0
1527, 1, 1636428462873, 1636428463141, 268, 1, 267, 0, 0, 0
1528, 1, 1636428462985, 1636428463249, 264, 1, 263, 0, 0, 0
1529, 1, 1636428463033, 1636428463297, 264, 1, 263, 0, 1, 1
1530, 1, 1636428463065, 1636428463334, 269, 1, 268, 1, 0, 1
1531, 1, 1636428463149, 1636428463413, 264, 1, 263, 0, 0, 0
1532, 1, 1636428463265, 1636428463533, 268, 1, 267, 0, 0, 0
1533, 1, 1636428463553, 1636428463817, 264, 1, 263, 1, 0, 1
1534, 1, 1636428463569, 1636428463837, 268, 1, 267, 0, 0, 0
1535, 1, 1636428463677, 1636428463942, 265, 1, 264, 0, 0, 0
1536, 1, 1636428463954, 1636428464218, 264, 0, 264, 0, 0, 0
1537, 1, 1636428464061, 1636428464325, 264, 1, 263, 1, 0, 1
1539, 1, 1636428464201, 1636428464465, 264, 1, 263, 1, 0, 1
1538, 1, 1636428464205, 1636428464469, 264, 1, 263, 0, 1, 1
1540, 1, 1636428464457, 1636428464726, 269, 1, 268, 1, 0, 1
1542, 1, 1636428464697, 1636428464961, 264, 1, 263, 0, 0, 0
1543, 1, 1636428464717, 1636428464986, 269, 0, 269, 0, 0, 0
1541, 1, 1636428464737, 1636428465005, 268, 1, 267, 0, 0, 0
1544, 1, 1636428464854, 1636428465117, 263, 0, 263, 0, 0, 0
1545, 1, 1636428464977, 1636428465241, 264, 1, 263, 0, 0, 0
1546, 1, 1636428465002, 1636428465265, 263, 0, 263, 0, 0, 0
1547, 1, 1636428465049, 1636428465318, 269, 1, 268, 0, 0, 0
1548, 1, 1636428465109, 1636428465373, 264, 1, 263, 1, 0, 1
1549, 1, 1636428465281, 1636428465545, 264, 1, 263, 0, 1, 1
1550, 1, 1636428465317, 1636428465585, 268, 1, 267, 0, 0, 0
1551, 1, 1636428465490, 1636428465754, 264, 0, 264, 0, 0, 0
1552, 1, 1636428465521, 1636428465785, 264, 1, 263, 1, 0, 1
1553, 1, 1636428465673, 1636428465942, 269, 1, 268, 1, 0, 1
1555, 1, 1636428466105, 1636428466369, 264, 1, 263, 0, 0, 0
1556, 1, 1636428466138, 1636428466401, 263, 0, 263, 0, 0, 0
1557, 1, 1636428466174, 1636428466442, 268, 0, 268, 0, 0, 0
1558, 1, 1636428466381, 1636428466649, 268, 0, 268, 0, 0, 0
1560, 1, 1636428466597, 1636428466861, 264, 1, 263, 1, 0, 1
1561, 1, 1636428466601, 1636428466869, 268, 1, 267, 0, 0, 0
1559, 1, 1636428466657, 1636428466921, 264, 1, 263, 0, 0, 0
1562, 1, 1636428466942, 1636428467213, 271, 0, 271, 0, 0, 0
1563, 1, 1636428466953, 1636428467221, 268, 1, 267, 0, 0, 0
1564, 1, 1636428467005, 1636428467265, 260, 0, 260, 0, 0, 0
1567, 1, 1636428467097, 1636428467366, 269, 0, 269, 0, 0, 0
1565, 1, 1636428467221, 1636428467490, 269, 1, 268, 0, 0, 0
1568, 1, 1636428467385, 1636428467650, 265, 1, 264, 1, 0, 1
1569, 1, 1636428467397, 1636428467662, 265, 1, 264, 0, 0, 0
1570, 1, 1636428467574, 1636428467842, 268, 0, 268, 0, 0, 0
1571, 1, 1636428467801, 1636428468070, 269, 0, 269, 0, 0, 0
1572, 1, 1636428468093, 1636428468362, 269, 1, 268, 1, 0, 1
1573, 1, 1636428468106, 1636428468369, 263, 0, 263, 0, 0, 0
1574, 1, 1636428468133, 1636428468397, 264, 1, 263, 0, 1, 1
1575, 1, 1636428468273, 1636428468542, 269, 1, 268, 1, 0, 1
1577, 1, 1636428468506, 1636428468770, 264, 0, 264, 0, 0, 0
1576, 1, 1636428468545, 1636428468809, 264, 1, 263, 0, 0, 0
1578, 1, 1636428468641, 1636428468906, 265, 0, 265, 0, 0, 0
1579, 1, 1636428468937, 1636428469206, 269, 1, 268, 1, 0, 1
1580, 1, 1636428469013, 1636428469281, 268, 1, 267, 0, 0, 0
1583, 1, 1636428469182, 1636428469445, 263, 0, 263, 0, 0, 0
1581, 1, 1636428469209, 1636428469474, 265, 1, 264, 1, 0, 1
1584, 1, 1636428469261, 1636428469525, 264, 1, 263, 0, 0, 0
1585, 1, 1636428469273, 1636428469538, 265, 1, 264, 0, 0, 0
1586, 1, 1636428469678, 1636428469942, 264, 0, 264, 0, 0, 0
1587, 1, 1636428469745, 1636428470014, 269, 1, 268, 0, 0, 0
1588, 1, 1636428470009, 1636428470277, 268, 1, 267, 0, 1, 1
1589, 1, 1636428470122, 1636428470393, 271, 0, 271, 0, 0, 0
1590, 1, 1636428470177, 1636428470441, 264, 1, 263, 0, 0, 0
1591, 1, 1636428470189, 1636428470453, 264, 1, 263, 0, 0, 0
1593, 1, 1636428470425, 1636428470693, 268, 1, 267, 1, 0, 1
1592, 1, 1636428470449, 1636428470714, 265, 0, 265, 0, 0, 0
1594, 1, 1636428470685, 1636428470950, 265, 1, 264, 0, 0, 0
1595, 1, 1636428470818, 1636428471081, 263, 0, 263, 0, 0, 0
1597, 1, 1636428471058, 1636428471321, 263, 0, 263, 0, 0, 0
1598, 1, 1636428471077, 1636428471346, 269, 1, 268, 0, 1, 1
1596, 1, 1636428471089, 1636428471353, 264, 1, 263, 0, 1, 1
1600, 1, 1636428471317, 1636428471589, 272, 1, 271, 1, 0, 1
1599, 1, 1636428471353, 1636428471622, 269, 1, 268, 0, 0, 0
1601, 1, 1636428471674, 1636428471938, 264, 0, 264, 0, 0, 0
1602, 1, 1636428471738, 1636428472002, 264, 0, 264, 0, 0, 0
1603, 1, 1636428471894, 1636428472158, 264, 0, 264, 0, 0, 0
1604, 1, 1636428472090, 1636428472357, 267, 0, 267, 0, 0, 0
1605, 1, 1636428472157, 1636428472421, 264, 1, 263, 0, 0, 0
1606, 1, 1636428472221, 1636428472485, 264, 1, 263, 1, 0, 1
1607, 1, 1636428472374, 1636428472677, 303, 0, 303, 0, 0, 0
1608, 1, 1636428472434, 1636428472705, 271, 0, 271, 0, 0, 0
1610, 1, 1636428472693, 1636428472953, 260, 0, 260, 0, 0, 0
1609, 1, 1636428472709, 1636428472978, 269, 0, 269, 0, 0, 0
1611, 1, 1636428472858, 1636428473121, 263, 0, 263, 0, 0, 0
1612, 1, 1636428472986, 1636428473249, 263, 0, 263, 0, 0, 0
1614, 1, 1636428472986, 1636428473253, 267, 0, 267, 0, 0, 0
1615, 1, 1636428472993, 1636428473265, 272, 1, 271, 0, 1, 1
1613, 1, 1636428473129, 1636428473398, 269, 0, 269, 0, 0, 0
1616, 1, 1636428473253, 1636428473517, 264, 0, 264, 0, 0, 0
1617, 1, 1636428473293, 1636428473562, 269, 0, 269, 0, 0, 0
1618, 1, 1636428473562, 1636428473830, 268, 0, 268, 0, 0, 0
1619, 1, 1636428473609, 1636428473874, 265, 0, 265, 0, 0, 0
1620, 1, 1636428473929, 1636428474193, 264, 1, 263, 0, 1, 1
1621, 1, 1636428473989, 1636428474257, 268, 1, 267, 1, 0, 1
1622, 1, 1636428474061, 1636428474325, 264, 1, 263, 0, 0, 0
1623, 1, 1636428474153, 1636428474417, 264, 1, 263, 0, 0, 0
1624, 1, 1636428474257, 1636428474525, 268, 1, 267, 1, 0, 1
1625, 1, 1636428474281, 1636428474549, 268, 0, 268, 0, 0, 0
1626, 1, 1636428474561, 1636428474826, 265, 1, 264, 0, 1, 1
1627, 1, 1636428474594, 1636428474861, 267, 0, 267, 0, 0, 0
1628, 1, 1636428474797, 1636428475061, 264, 1, 263, 0, 1, 1
1629, 1, 1636428474826, 1636428475097, 271, 1, 270, 0, 1, 1
1630, 1, 1636428474873, 1636428475137, 264, 0, 264, 0, 0, 0
1631, 1, 1636428474925, 1636428475190, 265, 1, 264, 1, 0, 1
1632, 1, 1636428475069, 1636428475334, 265, 1, 264, 0, 0, 0
1633, 1, 1636428475205, 1636428475470, 265, 1, 264, 0, 0, 0
1634, 1, 1636428475326, 1636428475593, 267, 0, 267, 0, 0, 0
1635, 1, 1636428475566, 1636428475830, 264, 0, 264, 0, 0, 0
1636, 1, 1636428475649, 1636428475914, 265, 1, 264, 0, 1, 1
1637, 1, 1636428475949, 1636428476222, 273, 1, 272, 0, 0, 0
1566, 1, 1636428476045, 1636428476309, 264, 1, 263, 1, 0, 1
1639, 1, 1636428476129, 1636428476397, 268, 0, 268, 0, 0, 0
1640, 1, 1636428476137, 1636428476405, 268, 1, 267, 0, 1, 1
1638, 1, 1636428476137, 1636428476409, 272, 1, 271, 1, 0, 1
1641, 1, 1636428476249, 1636428476513, 264, 1, 263, 0, 0, 0
1643, 1, 1636428476389, 1636428476653, 264, 0, 264, 0, 0, 0
1642, 1, 1636428476413, 1636428476678, 265, 0, 265, 0, 0, 0
1644, 1, 1636428476521, 1636428476785, 264, 0, 264, 0, 0, 0
1645, 1, 1636428476645, 1636428476910, 265, 1, 264, 0, 0, 0
1647, 1, 1636428476749, 1636428477013, 264, 0, 264, 0, 0, 0
1646, 1, 1636428476770, 1636428477034, 264, 0, 264, 0, 0, 0
1648, 1, 1636428476789, 1636428477058, 269, 1, 268, 0, 0, 0
1650, 1, 1636428476821, 1636428477085, 264, 1, 263, 0, 1, 1
1651, 1, 1636428477001, 1636428477269, 268, 1, 267, 0, 0, 0
1649, 1, 1636428477017, 1636428477294, 277, 1, 276, 0, 1, 1
1652, 1, 1636428477305, 1636428477573, 268, 1, 267, 0, 1, 1
1653, 1, 1636428477333, 1636428477597, 264, 1, 263, 0, 0, 0
1654, 1, 1636428477621, 1636428477889, 268, 1, 267, 0, 0, 0
1655, 1, 1636428477629, 1636428477893, 264, 1, 263, 1, 0, 1
1656, 1, 1636428477878, 1636428478149, 271, 0, 271, 0, 0, 0
1657, 1, 1636428478002, 1636428478266, 264, 0, 264, 0, 0, 0
1658, 1, 1636428478109, 1636428478369, 260, 0, 260, 0, 0, 0
1659, 1, 1636428478177, 1636428478442, 265, 1, 264, 0, 0, 0
1660, 1, 1636428478201, 1636428478469, 268, 1, 267, 0, 1, 1
1661, 1, 1636428478277, 1636428478546, 269, 1, 268, 0, 0, 0
1663, 1, 1636428478422, 1636428478685, 263, 0, 263, 0, 0, 0
1662, 1, 1636428478445, 1636428478709, 264, 0, 264, 0, 0, 0
1665, 1, 1636428478733, 1636428478993, 260, 0, 260, 0, 0, 0
1664, 1, 1636428478729, 1636428479001, 272, 1, 271, 1, 0, 1
1666, 1, 1636428478757, 1636428479021, 264, 1, 263, 0, 0, 0
1667, 1, 1636428478802, 1636428479081, 279, 0, 279, 0, 0, 0
1668, 1, 1636428478802, 1636428479081, 279, 0, 279, 0, 0, 0
1669, 1, 1636428479093, 1636428479357, 264, 1, 263, 0, 0, 0
1670, 1, 1636428479093, 1636428479357, 264, 1, 263, 1, 0, 1
1671, 1, 1636428479253, 1636428479517, 264, 0, 264, 0, 0, 0
1672, 1, 1636428479297, 1636428479565, 268, 0, 268, 0, 0, 0
1673, 1, 1636428479377, 1636428479645, 268, 0, 268, 0, 0, 0
1674, 1, 1636428479529, 1636428479797, 268, 1, 267, 0, 0, 0
1675, 1, 1636428479710, 1636428479974, 264, 0, 264, 0, 0, 0
1676, 1, 1636428479933, 1636428480198, 265, 1, 264, 0, 0, 0
1677, 1, 1636428479945, 1636428480209, 264, 1, 263, 0, 1, 1
1678, 1, 1636428480121, 1636428480385, 264, 1, 263, 1, 0, 1
1680, 1, 1636428480149, 1636428480422, 273, 1, 272, 1, 0, 1
1679, 1, 1636428480213, 1636428480477, 264, 0, 264, 0, 0, 0
1681, 1, 1636428480233, 1636428480501, 268, 1, 267, 1, 0, 1
1683, 1, 1636428480401, 1636428480665, 264, 0, 264, 0, 0, 0
1682, 1, 1636428480513, 1636428480781, 268, 1, 267, 0, 0, 0
1684, 1, 1636428480689, 1636428480961, 272, 1, 271, 0, 0, 0
1685, 1, 1636428480745, 1636428481009, 264, 1, 263, 0, 1, 1
1687, 1, 1636428480781, 1636428481045, 264, 2, 262, 0, 0, 0
1686, 1, 1636428480781, 1636428481049, 268, 1, 267, 1, 0, 1
1688, 1, 1636428480821, 1636428481089, 268, 0, 268, 0, 0, 0
1689, 1, 1636428481009, 1636428481273, 264, 1, 263, 1, 0, 1
1690, 1, 1636428481178, 1636428481442, 264, 0, 264, 0, 0, 0
1691, 1, 1636428481229, 1636428481493, 264, 1, 263, 1, 0, 1
1692, 1, 1636428481269, 1636428481534, 265, 1, 264, 0, 1, 1
1693, 1, 1636428481290, 1636428481558, 268, 0, 268, 0, 0, 0
1694, 1, 1636428481585, 1636428481850, 265, 1, 264, 1, 0, 1
1695, 1, 1636428481653, 1636428481922, 269, 1, 268, 0, 1, 1
1696, 1, 1636428481853, 1636428482117, 264, 1, 263, 0, 1, 1
1697, 1, 1636428481946, 1636428482209, 263, 0, 263, 0, 0, 0
1699, 1, 1636428482161, 1636428482425, 264, 1, 263, 0, 0, 0
1700, 1, 1636428482177, 1636428482445, 268, 1, 267, 0, 1, 1
1698, 1, 1636428482217, 1636428482486, 269, 1, 268, 0, 1, 1
1701, 1, 1636428482265, 1636428482534, 269, 1, 268, 0, 1, 1
1703, 1, 1636428482469, 1636428482737, 268, 0, 268, 0, 0, 0
1702, 1, 1636428482541, 1636428482813, 272, 1, 271, 0, 1, 1
1704, 1, 1636428482765, 1636428483029, 264, 1, 263, 1, 0, 1
1705, 1, 1636428482794, 1636428483058, 264, 0, 264, 0, 0, 0
1706, 1, 1636428482801, 1636428483069, 268, 1, 267, 0, 0, 0
1707, 1, 1636428482813, 1636428483081, 268, 1, 267, 1, 0, 1
1708, 1, 1636428482861, 1636428483129, 268, 0, 268, 0, 0, 0
1709, 1, 1636428483069, 1636428483337, 268, 1, 267, 0, 0, 0
1710, 1, 1636428483113, 1636428483378, 265, 1, 264, 0, 0, 0
1711, 1, 1636428483174, 1636428483441, 267, 0, 267, 0, 0, 0
1712, 1, 1636428483325, 1636428483590, 265, 1, 264, 0, 0, 0
1713, 1, 1636428483405, 1636428483670, 265, 1, 264, 1, 0, 1
1714, 1, 1636428483506, 1636428483769, 263, 0, 263, 0, 0, 0
1715, 1, 1636428483717, 1636428483981, 264, 1, 263, 0, 1, 1
1716, 1, 1636428483898, 1636428484165, 267, 0, 267, 0, 0, 0
1717, 1, 1636428483970, 1636428484237, 267, 0, 267, 0, 0, 0
1718, 1, 1636428484162, 1636428484433, 271, 0, 271, 0, 0, 0
1719, 1, 1636428484245, 1636428484509, 264, 1, 263, 0, 0, 0
1720, 1, 1636428484273, 1636428484541, 268, 1, 267, 0, 0, 0
1721, 1, 1636428484306, 1636428484569, 263, 0, 263, 0, 0, 0
1722, 1, 1636428484545, 1636428484810, 265, 1, 264, 0, 1, 1
1723, 1, 1636428484586, 1636428484853, 267, 0, 267, 0, 0, 0
1724, 1, 1636428484657, 1636428484925, 268, 1, 267, 0, 0, 0
1725, 1, 1636428484829, 1636428485093, 264, 1, 263, 0, 0, 0
1726, 1, 1636428484837, 1636428485101, 264, 1, 263, 0, 0, 0
1727, 1, 1636428484853, 1636428485118, 265, 1, 264, 1, 0, 1
1728, 1, 1636428484921, 1636428485186, 265, 1, 264, 1, 0, 1
1729, 1, 1636428485118, 1636428485381, 263, 0, 263, 0, 0, 0
1730, 1, 1636428485141, 1636428485405, 264, 0, 264, 0, 0, 0
1731, 1, 1636428485161, 1636428485426, 265, 0, 265, 0, 0, 0
1732, 1, 1636428485298, 1636428485570, 272, 0, 272, 0, 0, 0
1733, 1, 1636428485381, 1636428485646, 265, 1, 264, 1, 0, 1
1734, 1, 1636428485541, 1636428485806, 265, 1, 264, 0, 0, 0
1735, 1, 1636428485713, 1636428485977, 264, 1, 263, 0, 0, 0
1736, 1, 1636428485934, 1636428486198, 264, 0, 264, 0, 0, 0
1737, 1, 1636428486006, 1636428486273, 267, 0, 267, 0, 0, 0
1738, 1, 1636428486177, 1636428486442, 265, 1, 264, 1, 0, 1
1740, 1, 1636428486249, 1636428486513, 264, 1, 263, 0, 0, 0
1741, 1, 1636428486269, 1636428486537, 268, 1, 267, 0, 1, 1
1739, 1, 1636428486281, 1636428486549, 268, 1, 267, 0, 0, 0
1743, 1, 1636428486533, 1636428486805, 272, 1, 271, 1, 0, 1
1742, 1, 1636428486541, 1636428486809, 268, 1, 267, 1, 0, 1
1744, 1, 1636428486565, 1636428486829, 264, 1, 263, 0, 1, 1
1746, 1, 1636428486821, 1636428487085, 264, 0, 264, 0, 0, 0
1745, 1, 1636428486821, 1636428487089, 268, 0, 268, 0, 0, 0
1747, 1, 1636428486846, 1636428487109, 263, 0, 263, 0, 0, 0
1749, 1, 1636428486957, 1636428487225, 268, 1, 267, 1, 0, 1
1748, 1, 1636428487098, 1636428487362, 264, 0, 264, 0, 0, 0
1750, 1, 1636428487166, 1636428487438, 272, 0, 272, 0, 0, 0
1751, 1, 1636428487166, 1636428487438, 272, 1, 271, 0, 0, 0
1752, 1, 1636428487313, 1636428487578, 265, 1, 264, 0, 1, 1
1753, 1, 1636428487514, 1636428487777, 263, 0, 263, 0, 0, 0
1754, 1, 1636428487653, 1636428487925, 272, 1, 271, 1, 0, 1
1755, 1, 1636428487741, 1636428488006, 265, 1, 264, 1, 0, 1
1756, 1, 1636428487818, 1636428488081, 263, 0, 263, 0, 0, 0
1757, 1, 1636428488102, 1636428488366, 264, 0, 264, 0, 0, 0
1759, 1, 1636428488266, 1636428488529, 263, 0, 263, 0, 0, 0
1760, 1, 1636428488285, 1636428488549, 264, 1, 263, 0, 0, 0
1761, 1, 1636428488322, 1636428488586, 264, 0, 264, 0, 0, 0
1758, 1, 1636428488369, 1636428488634, 265, 1, 264, 1, 0, 1
1763, 1, 1636428488525, 1636428488793, 268, 1, 267, 1, 0, 1
1762, 1, 1636428488593, 1636428488858, 265, 0, 265, 0, 0, 0
1764, 1, 1636428488689, 1636428488953, 264, 1, 263, 1, 0, 1
1765, 1, 1636428488833, 1636428489098, 265, 1, 264, 1, 0, 1
1766, 1, 1636428488857, 1636428489122, 265, 1, 264, 0, 0, 0
1767, 1, 1636428488949, 1636428489213, 264, 1, 263, 0, 0, 0
1769, 1, 1636428489085, 1636428489353, 268, 1, 267, 0, 0, 0
1768, 1, 1636428489113, 1636428489381, 268, 1, 267, 0, 1, 1
1771, 1, 1636428489193, 1636428489461, 268, 1, 267, 0, 0, 0
1770, 1, 1636428489225, 1636428489489, 264, 1, 263, 0, 0, 0
1772, 1, 1636428489397, 1636428489662, 265, 1, 264, 1, 0, 1
1773, 1, 1636428489425, 1636428489689, 264, 1, 263, 1, 0, 1
1774, 1, 1636428489633, 1636428489902, 269, 1, 268, 1, 0, 1
1775, 1, 1636428489693, 1636428489961, 268, 1, 267, 0, 0, 0
1776, 1, 1636428489833, 1636428490098, 265, 0, 265, 0, 0, 0
1777, 1, 1636428489998, 1636428490265, 267, 0, 267, 0, 0, 0
1779, 1, 1636428490249, 1636428490513, 264, 1, 263, 0, 0, 0
1778, 1, 1636428490273, 1636428490537, 264, 1, 263, 0, 1, 1
1780, 1, 1636428490333, 1636428490597, 264, 1, 263, 1, 0, 1
1781, 1, 1636428490341, 1636428490606, 265, 1, 264, 0, 0, 0
1782, 1, 1636428490549, 1636428490818, 269, 1, 268, 0, 0, 0
1784, 1, 1636428490581, 1636428490845, 264, 1, 263, 1, 0, 1
1783, 1, 1636428490613, 1636428490877, 264, 0, 264, 0, 0, 0
1785, 1, 1636428490897, 1636428491161, 264, 1, 263, 0, 0, 0
1786, 1, 1636428490917, 1636428491181, 264, 1, 263, 0, 0, 0
1787, 1, 1636428490929, 1636428491201, 272, 1, 271, 0, 0, 0
1788, 1, 1636428491021, 1636428491293, 272, 1, 271, 0, 0, 0
1789, 1, 1636428491193, 1636428491458, 265, 1, 264, 0, 1, 1
1790, 1, 1636428491205, 1636428491473, 268, 0, 268, 0, 0, 0
1792, 1, 1636428491281, 1636428491546, 265, 1, 264, 0, 1, 1
1791, 1, 1636428491281, 1636428491549, 268, 1, 267, 0, 1, 1
1793, 1, 1636428491389, 1636428491657, 268, 0, 268, 0, 0, 0
1794, 1, 1636428491642, 1636428491905, 263, 0, 263, 0, 0, 0
1795, 1, 1636428491781, 1636428492045, 264, 1, 263, 0, 0, 0
1796, 1, 1636428491893, 1636428492162, 269, 1, 268, 1, 0, 1
1797, 1, 1636428492022, 1636428492289, 267, 0, 267, 0, 0, 0
1799, 1, 1636428492293, 1636428492557, 264, 1, 263, 1, 0, 1
1800, 1, 1636428492297, 1636428492566, 269, 1, 268, 0, 1, 1
1798, 1, 1636428492297, 1636428492566, 269, 1, 268, 0, 0, 0
1801, 1, 1636428492461, 1636428492721, 260, 0, 260, 0, 0, 0
1803, 1, 1636428492593, 1636428492861, 268, 0, 268, 0, 0, 0
1802, 1, 1636428492597, 1636428492865, 268, 1, 267, 0, 1, 1
1804, 1, 1636428492733, 1636428493002, 269, 0, 269, 0, 0, 0
1805, 1, 1636428492905, 1636428493178, 273, 1, 272, 0, 0, 0
1806, 1, 1636428493001, 1636428493265, 264, 1, 263, 0, 0, 0
1807, 1, 1636428493017, 1636428493285, 268, 1, 267, 0, 0, 0
1809, 1, 1636428493157, 1636428493421, 264, 1, 263, 1, 0, 1
1811, 1, 1636428493173, 1636428493437, 264, 1, 263, 0, 0, 0
1808, 1, 1636428493185, 1636428493454, 269, 1, 268, 0, 0, 0
1812, 1, 1636428493285, 1636428493549, 264, 1, 263, 1, 0, 1
1810, 1, 1636428493293, 1636428493562, 269, 1, 268, 1, 0, 1
1813, 1, 1636428493397, 1636428493661, 264, 1, 263, 0, 0, 0
1814, 1, 1636428493754, 1636428494018, 264, 0, 264, 0, 0, 0
1815, 1, 1636428493862, 1636428494125, 263, 0, 263, 0, 0, 0
1816, 1, 1636428493865, 1636428494129, 264, 1, 263, 0, 0, 0
1817, 1, 1636428494101, 1636428494369, 268, 1, 267, 0, 1, 1
1818, 1, 1636428494213, 1636428494477, 264, 1, 263, 1, 0, 1
1819, 1, 1636428494306, 1636428494573, 267, 0, 267, 0, 0, 0
1820, 1, 1636428494377, 1636428494642, 265, 1, 264, 0, 0, 0
1821, 1, 1636428494381, 1636428494657, 276, 1, 275, 0, 0, 0
1823, 1, 1636428494637, 1636428494901, 264, 1, 263, 0, 0, 0
1824, 1, 1636428494650, 1636428494922, 272, 0, 272, 0, 0, 0
1822, 1, 1636428494657, 1636428494922, 265, 1, 264, 0, 0, 0
1826, 1, 1636428494913, 1636428495178, 265, 1, 264, 0, 1, 1
1825, 1, 1636428494933, 1636428495206, 273, 1, 272, 0, 1, 1
1827, 1, 1636428495097, 1636428495361, 264, 0, 264, 0, 0, 0
1828, 1, 1636428495185, 1636428495449, 264, 1, 263, 0, 0, 0
1829, 1, 1636428495189, 1636428495453, 264, 1, 263, 0, 0, 0
1830, 1, 1636428495213, 1636428495477, 264, 1, 263, 0, 0, 0
1832, 1, 1636428495314, 1636428495578, 264, 0, 264, 0, 0, 0
1831, 1, 1636428495369, 1636428495637, 268, 0, 268, 0, 0, 0
1833, 1, 1636428495405, 1636428495678, 273, 1, 272, 0, 0, 0
1834, 1, 1636428495713, 1636428495978, 265, 1, 264, 0, 1, 1
1835, 1, 1636428495889, 1636428496157, 268, 1, 267, 1, 0, 1
1836, 1, 1636428495909, 1636428496185, 276, 1, 275, 0, 0, 0
1837, 1, 1636428496177, 1636428496441, 264, 1, 263, 0, 0, 0
1838, 1, 1636428496225, 1636428496493, 268, 1, 267, 0, 1, 1
1839, 1, 1636428496281, 1636428496549, 268, 0, 268, 0, 0, 0
1840, 1, 1636428496453, 1636428496721, 268, 1, 267, 0, 1, 1
1841, 1, 1636428496465, 1636428496729, 264, 1, 263, 0, 0, 0
1842, 1, 1636428496601, 1636428496865, 264, 1, 263, 0, 0, 0
1844, 1, 1636428496705, 1636428496970, 265, 1, 264, 1, 0, 1
1843, 1, 1636428496741, 1636428497014, 273, 1, 272, 1, 0, 1
1845, 1, 1636428496837, 1636428497101, 264, 1, 263, 1, 0, 1
1846, 1, 1636428497017, 1636428497281, 264, 1, 263, 0, 0, 0
1847, 1, 1636428497105, 1636428497373, 268, 1, 267, 1, 0, 1
1848, 1, 1636428497134, 1636428497397, 263, 0, 263, 0, 0, 0
1849, 1, 1636428497245, 1636428497509, 264, 1, 263, 0, 0, 0
1851, 1, 1636428497301, 1636428497569, 268, 1, 267, 1, 0, 1
1850, 1, 1636428497401, 1636428497669, 268, 1, 267, 1, 0, 1
1852, 1, 1636428497417, 1636428497681, 264, 1, 263, 1, 0, 1
1853, 1, 1636428497477, 1636428497741, 264, 1, 263, 1, 0, 1
1854, 1, 1636428497757, 1636428498021, 264, 1, 263, 0, 0, 0
1855, 1, 1636428497881, 1636428498149, 268, 1, 267, 0, 1, 1
1856, 1, 1636428497901, 1636428498165, 264, 1, 263, 1, 0, 1
1857, 1, 1636428498046, 1636428498313, 267, 0, 267, 0, 0, 0
1858, 1, 1636428498293, 1636428498557, 264, 0, 264, 0, 0, 0
1859, 1, 1636428498297, 1636428498562, 265, 1, 264, 0, 1, 1
1860, 1, 1636428498317, 1636428498581, 264, 1, 263, 0, 1, 1
1861, 1, 1636428498525, 1636428498785, 260, 0, 260, 0, 0, 0
1862, 1, 1636428498657, 1636428498925, 268, 1, 267, 0, 0, 0
1863, 1, 1636428498657, 1636428498933, 276, 1, 275, 1, 0, 1
1864, 1, 1636428498794, 1636428499062, 268, 0, 268, 0, 0, 0
1865, 1, 1636428498902, 1636428499170, 268, 0, 268, 0, 0, 0
1866, 1, 1636428499073, 1636428499338, 265, 1, 264, 1, 0, 1
1867, 1, 1636428499178, 1636428499442, 264, 0, 264, 0, 0, 0
1868, 1, 1636428499185, 1636428499457, 272, 1, 271, 0, 1, 1
1869, 1, 1636428499233, 1636428499497, 264, 1, 263, 1, 0, 1
1871, 1, 1636428499361, 1636428499625, 264, 1, 263, 0, 0, 0
1872, 1, 1636428499429, 1636428499694, 265, 1, 264, 0, 0, 0
1870, 1, 1636428499465, 1636428499738, 273, 1, 272, 0, 1, 1
1873, 1, 1636428499505, 1636428499770, 265, 1, 264, 0, 0, 0
1874, 1, 1636428499677, 1636428499950, 273, 1, 272, 0, 1, 1
1875, 1, 1636428499834, 1636428500101, 267, 0, 267, 0, 0, 0
1876, 1, 1636428499950, 1636428500221, 271, 0, 271, 0, 0, 0
1877, 1, 1636428500137, 1636428500401, 264, 1, 263, 1, 0, 1
1878, 1, 1636428500174, 1636428500437, 263, 0, 263, 0, 0, 0
1879, 1, 1636428500317, 1636428500585, 268, 1, 267, 0, 1, 1
1880, 1, 1636428500409, 1636428500673, 264, 1, 263, 1, 0, 1
1881, 1, 1636428500409, 1636428500673, 264, 1, 263, 0, 1, 1
1882, 1, 1636428500626, 1636428500890, 264, 0, 264, 0, 0, 0
1883, 1, 1636428500713, 1636428500977, 264, 1, 263, 1, 0, 1
1884, 1, 1636428500721, 1636428500985, 264, 1, 263, 0, 0, 0
1885, 1, 1636428500917, 1636428501185, 268, 1, 267, 1, 0, 1
1886, 1, 1636428500985, 1636428501249, 264, 1, 263, 1, 0, 1
1887, 1, 1636428501113, 1636428501377, 264, 1, 263, 0, 0, 0
1888, 1, 1636428501130, 1636428501394, 264, 0, 264, 0, 0, 0
1889, 1, 1636428501230, 1636428501497, 267, 0, 267, 0, 0, 0
1891, 1, 1636428501277, 1636428501541, 264, 0, 264, 0, 0, 0
1892, 1, 1636428501358, 1636428501625, 267, 0, 267, 0, 0, 0
1893, 1, 1636428501385, 1636428501650, 265, 1, 264, 1, 0, 1
1890, 1, 1636428501409, 1636428501677, 268, 1, 267, 1, 0, 1
1894, 1, 1636428501745, 1636428502009, 264, 1, 263, 1, 0, 1
1896, 1, 1636428501973, 1636428502238, 265, 1, 264, 0, 0, 0
1895, 1, 1636428501973, 1636428502238, 265, 1, 264, 0, 0, 0
1897, 1, 1636428502197, 1636428502461, 264, 0, 264, 0, 0, 0
1898, 1, 1636428502249, 1636428502517, 268, 1, 267, 0, 0, 0
1899, 1, 1636428502285, 1636428502549, 264, 1, 263, 0, 0, 0
1901, 1, 1636428502521, 1636428502785, 264, 1, 263, 0, 0, 0
1902, 1, 1636428502529, 1636428502805, 276, 0, 276, 0, 0, 0
1900, 1, 1636428502525, 1636428502805, 280, 0, 280, 0, 0, 0
1903, 1, 1636428502813, 1636428503077, 264, 1, 263, 0, 0, 0
1904, 1, 1636428502845, 1636428503114, 269, 1, 268, 1, 0, 1
1905, 1, 1636428502849, 1636428503114, 265, 1, 264, 0, 1, 1
1906, 1, 1636428503014, 1636428503281, 267, 0, 267, 0, 0, 0
1908, 1, 1636428503114, 1636428503378, 264, 1, 263, 0, 0, 0
1909, 1, 1636428503249, 1636428503514, 265, 1, 264, 1, 0, 1
1911, 1, 1636428503305, 1636428503573, 268, 1, 267, 0, 0, 0
1912, 1, 1636428503402, 1636428503670, 268, 0, 268, 0, 0, 0
1913, 1, 1636428503493, 1636428503757, 264, 1, 263, 1, 0, 1
1910, 1, 1636428503521, 1636428503785, 264, 1, 263, 0, 1, 1
1914, 1, 1636428503765, 1636428504029, 264, 1, 263, 0, 1, 1
1915, 1, 1636428503857, 1636428504125, 268, 1, 267, 1, 0, 1
1916, 1, 1636428504014, 1636428504278, 264, 0, 264, 0, 0, 0
1917, 1, 1636428504225, 1636428504489, 264, 1, 263, 0, 0, 0
1918, 1, 1636428504309, 1636428504577, 268, 1, 267, 1, 0, 1
1921, 1, 1636428504441, 1636428504706, 265, 1, 264, 1, 0, 1
1920, 1, 1636428504497, 1636428504762, 265, 0, 265, 0, 0, 0
1922, 1, 1636428504573, 1636428504841, 268, 1, 267, 1, 0, 1
1923, 1, 1636428504721, 1636428504985, 264, 1, 263, 0, 0, 0
1924, 1, 1636428504861, 1636428505125, 264, 1, 263, 1, 0, 1
1925, 1, 1636428504873, 1636428505137, 264, 1, 263, 1, 0, 1
1926, 1, 1636428504909, 1636428505185, 276, 1, 275, 0, 0, 0
1927, 1, 1636428505217, 1636428505485, 268, 1, 267, 0, 1, 1
1928, 1, 1636428505298, 1636428505565, 267, 0, 267, 0, 0, 0
1930, 1, 1636428505414, 1636428505677, 263, 0, 263, 0, 0, 0
1931, 1, 1636428505521, 1636428505786, 265, 1, 264, 1, 0, 1
1929, 1, 1636428505565, 1636428505834, 269, 1, 268, 1, 0, 1
1933, 1, 1636428505649, 1636428505917, 268, 1, 267, 1, 0, 1
1934, 1, 1636428505913, 1636428506178, 265, 1, 264, 1, 0, 1
1935, 1, 1636428506081, 1636428506354, 273, 1, 272, 0, 0, 0
1939, 1, 1636428506470, 1636428506738, 268, 0, 268, 0, 0, 0
1940, 1, 1636428506497, 1636428506761, 264, 1, 263, 0, 0, 0
1941, 1, 1636428506797, 1636428507062, 265, 1, 264, 1, 0, 1
1942, 1, 1636428506854, 1636428507118, 264, 0, 264, 0, 0, 0
1944, 1, 1636428507030, 1636428507298, 268, 0, 268, 0, 0, 0
1945, 1, 1636428507301, 1636428507566, 265, 0, 265, 0, 0, 0
1947, 1, 1636428507365, 1636428507633, 268, 1, 267, 1, 0, 1
1949, 1, 1636428507525, 1636428507790, 265, 0, 265, 0, 0, 0
1948, 1, 1636428507641, 1636428507906, 265, 1, 264, 0, 0, 0
1950, 1, 1636428507705, 1636428507974, 269, 1, 268, 0, 0, 0
1951, 1, 1636428508021, 1636428508290, 269, 1, 268, 0, 1, 1
1953, 1, 1636428508342, 1636428508605, 263, 0, 263, 0, 0, 0
1954, 1, 1636428508601, 1636428508866, 265, 1, 264, 1, 0, 1
1955, 1, 1636428508866, 1636428509134, 268, 0, 268, 0, 0, 0
1956, 1, 1636428508954, 1636428509217, 263, 0, 263, 0, 0, 0
1957, 1, 1636428508966, 1636428509233, 267, 0, 267, 0, 0, 0
1958, 1, 1636428509302, 1636428509569, 267, 0, 267, 0, 0, 0
1961, 1, 1636428509533, 1636428509798, 265, 0, 265, 0, 0, 0
1959, 1, 1636428509578, 1636428509842, 264, 0, 264, 0, 0, 0
1963, 1, 1636428509902, 1636428510170, 268, 0, 268, 0, 0, 0
1964, 1, 1636428510306, 1636428510577, 271, 0, 271, 0, 0, 0
1965, 1, 1636428510545, 1636428510810, 265, 0, 265, 0, 0, 0
1966, 1, 1636428510742, 1636428511013, 271, 0, 271, 0, 0, 0
1967, 1, 1636428510910, 1636428511177, 267, 0, 267, 0, 0, 0
1968, 1, 1636428510917, 1636428511181, 264, 1, 263, 0, 0, 0
1969, 1, 1636428511217, 1636428511486, 269, 1, 268, 0, 0, 0
1970, 1, 1636428511493, 1636428511762, 269, 1, 268, 0, 0, 0
1971, 1, 1636428511574, 1636428511837, 263, 0, 263, 0, 0, 0
1972, 1, 1636428511801, 1636428512066, 265, 1, 264, 0, 0, 0
1973, 1, 1636428512394, 1636428512657, 263, 0, 263, 0, 0, 0
1974, 1, 1636428512446, 1636428512709, 263, 0, 263, 0, 0, 0
1976, 1, 1636428512898, 1636428513166, 268, 0, 268, 0, 0, 0
1977, 1, 1636428513018, 1636428513294, 276, 0, 276, 0, 0, 0
1978, 1, 1636428513213, 1636428513477, 264, 1, 263, 1, 0, 1
1937, 1, 1636428513213, 1636428513481, 268, 1, 267, 1, 0, 1
1980, 1, 1636428513562, 1636428513829, 267, 0, 267, 0, 0, 0
1981, 1, 1636428513570, 1636428513833, 263, 0, 263, 0, 0, 0
1982, 1, 1636428513722, 1636428513986, 264, 0, 264, 0, 0, 0
1983, 1, 1636428513946, 1636428514210, 264, 0, 264, 0, 0, 0
1984, 1, 1636428514289, 1636428514562, 273, 1, 272, 1, 0, 1
1985, 1, 1636428514466, 1636428514730, 264, 0, 264, 0, 0, 0
1986, 1, 1636428514781, 1636428515045, 264, 1, 263, 0, 0, 0
1987, 1, 1636428515001, 1636428515265, 264, 0, 264, 0, 0, 0
1988, 1, 1636428515033, 1636428515298, 265, 1, 264, 0, 0, 0
1989, 1, 1636428515506, 1636428515770, 264, 0, 264, 0, 0, 0
1990, 1, 1636428515589, 1636428515858, 269, 1, 268, 0, 0, 0
1991, 1, 1636428515770, 1636428516034, 264, 0, 264, 0, 0, 0
1992, 1, 1636428515954, 1636428516225, 271, 0, 271, 0, 0, 0
1993, 1, 1636428516210, 1636428516490, 280, 0, 280, 0, 0, 0
1994, 1, 1636428516529, 1636428516798, 269, 1, 268, 0, 1, 1
1995, 1, 1636428516853, 1636428517125, 272, 1, 271, 0, 1, 1
1996, 1, 1636428516881, 1636428517149, 268, 1, 267, 1, 0, 1
1997, 1, 1636428517078, 1636428517341, 263, 0, 263, 0, 0, 0
1998, 1, 1636428517553, 1636428517817, 264, 1, 263, 0, 0, 0
1999, 1, 1636428517645, 1636428517910, 265, 1, 264, 0, 0, 0
2000, 1, 1636428517718, 1636428517981, 263, 0, 263, 0, 0, 0
2001, 1, 1636428518002, 1636428518266, 264, 0, 264, 0, 0, 0
2002, 1, 1636428518105, 1636428518369, 264, 1, 263, 0, 0, 0
2003, 1, 1636428518466, 1636428518733, 267, 0, 267, 0, 0, 0
2004, 1, 1636428518757, 1636428519025, 268, 1, 267, 0, 0, 0
2005, 1, 1636428518805, 1636428519070, 265, 1, 264, 0, 0, 0
2006, 1, 1636428518954, 1636428519230, 276, 0, 276, 0, 0, 0
2007, 1, 1636428519634, 1636428519898, 264, 0, 264, 0, 0, 0
2008, 1, 1636428519698, 1636428519961, 263, 0, 263, 0, 0, 0
2009, 1, 1636428519789, 1636428520054, 265, 1, 264, 1, 0, 1
2010, 1, 1636428520066, 1636428520334, 268, 0, 268, 0, 0, 0
2011, 1, 1636428520221, 1636428520486, 265, 1, 264, 1, 0, 1
2012, 1, 1636428520414, 1636428520682, 268, 0, 268, 0, 0, 0
2013, 1, 1636428520754, 1636428521022, 268, 0, 268, 0, 0, 0
2014, 1, 1636428520862, 1636428521130, 268, 0, 268, 0, 0, 0
2015, 1, 1636428520874, 1636428521141, 267, 0, 267, 0, 0, 0
2016, 1, 1636428521642, 1636428521906, 264, 0, 264, 0, 0, 0
2017, 1, 1636428521658, 1636428521922, 264, 0, 264, 0, 0, 0
2018, 1, 1636428521774, 1636428522042, 268, 0, 268, 0, 0, 0
2019, 1, 1636428521933, 1636428522202, 269, 1, 268, 0, 0, 0
2020, 1, 1636428522225, 1636428522490, 265, 1, 264, 1, 0, 1
2021, 1, 1636428522542, 1636428522814, 272, 0, 272, 0, 0, 0
2022, 1, 1636428522821, 1636428523085, 264, 1, 263, 0, 1, 1
2023, 1, 1636428522877, 1636428523142, 265, 1, 264, 0, 1, 1
2024, 1, 1636428522958, 1636428523222, 264, 0, 264, 0, 0, 0
2025, 1, 1636428523177, 1636428523446, 269, 1, 268, 0, 0, 0
1979, 2, 1636428513477, 1636428523570, 10093, 0, 10093, 0, 0, 0
2026, 1, 1636428523709, 1636428523973, 264, 1, 263, 0, 0, 0
2027, 1, 1636428523797, 1636428524061, 264, 1, 263, 0, 0, 0
2028, 1, 1636428523797, 1636428524070, 273, 1, 272, 0, 0, 0
2030, 1, 1636428523926, 1636428524190, 264, 0, 264, 0, 0, 0
2037, 1, 1636428523981, 1636428524254, 273, 1, 272, 0, 1, 1
2039, 1, 1636428524061, 1636428524326, 265, 1, 264, 0, 0, 0
2038, 1, 1636428524077, 1636428524349, 272, 1, 271, 0, 0, 0
2029, 1, 1636428524266, 1636428524533, 267, 0, 267, 0, 0, 0
2040, 1, 1636428524326, 1636428524590, 264, 0, 264, 0, 0, 0
2041, 1, 1636428524530, 1636428524794, 264, 0, 264, 0, 0, 0
2034, 1, 1636428524545, 1636428524814, 269, 0, 269, 0, 0, 0
2042, 1, 1636428524805, 1636428525074, 269, 1, 268, 0, 0, 0
2043, 1, 1636428524885, 1636428525150, 265, 0, 265, 0, 0, 0
2044, 1, 1636428524974, 1636428525242, 268, 0, 268, 0, 0, 0
2045, 1, 1636428525114, 1636428525382, 268, 0, 268, 0, 0, 0
2046, 1, 1636428525658, 1636428525925, 267, 0, 267, 0, 0, 0
2047, 1, 1636428525678, 1636428525946, 268, 0, 268, 0, 0, 0
2049, 1, 1636428525777, 1636428526045, 268, 1, 267, 0, 0, 0
2052, 1, 1636428525861, 1636428526125, 264, 1, 263, 1, 0, 1
2053, 1, 1636428525997, 1636428526265, 268, 1, 267, 0, 1, 1
2054, 1, 1636428526058, 1636428526322, 264, 0, 264, 0, 0, 0
2055, 1, 1636428526210, 1636428526477, 267, 0, 267, 0, 0, 0
2056, 1, 1636428526562, 1636428526825, 263, 0, 263, 0, 0, 0
2057, 1, 1636428526774, 1636428527042, 268, 0, 268, 0, 0, 0
2058, 1, 1636428526841, 1636428527109, 268, 1, 267, 0, 1, 1
2059, 1, 1636428526866, 1636428527129, 263, 0, 263, 0, 0, 0
2060, 1, 1636428527150, 1636428527418, 268, 0, 268, 0, 0, 0
2061, 1, 1636428527633, 1636428527902, 269, 1, 268, 0, 1, 1
2062, 1, 1636428527669, 1636428527934, 265, 1, 264, 0, 0, 0
2063, 1, 1636428527810, 1636428528077, 267, 0, 267, 0, 0, 0
2064, 1, 1636428527961, 1636428528226, 265, 1, 264, 1, 0, 1
2065, 1, 1636428528085, 1636428528358, 273, 1, 272, 0, 0, 0
2066, 1, 1636428528114, 1636428528381, 267, 0, 267, 0, 0, 0
2068, 1, 1636428528645, 1636428528913, 268, 1, 267, 0, 0, 0
2069, 1, 1636428528669, 1636428528945, 276, 0, 276, 0, 0, 0
2071, 1, 1636428528945, 1636428529209, 264, 1, 263, 1, 0, 1
2072, 1, 1636428529066, 1636428529330, 264, 0, 264, 0, 0, 0
2074, 1, 1636428529745, 1636428530009, 264, 0, 264, 0, 0, 0
2075, 1, 1636428529813, 1636428530077, 264, 0, 264, 0, 0, 0
2076, 1, 1636428529877, 1636428530141, 264, 0, 264, 0, 0, 0
2077, 1, 1636428530001, 1636428530270, 269, 0, 269, 0, 0, 0
2078, 1, 1636428530093, 1636428530358, 265, 0, 265, 0, 0, 0
2079, 1, 1636428530653, 1636428530921, 268, 0, 268, 0, 0, 0
2081, 1, 1636428530926, 1636428531198, 272, 0, 272, 0, 0, 0
2083, 1, 1636428531701, 1636428531965, 264, 1, 263, 1, 0, 1
2084, 1, 1636428531717, 1636428531986, 269, 1, 268, 0, 1, 1
2087, 1, 1636428531985, 1636428532250, 265, 1, 264, 0, 0, 0
2086, 1, 1636428531997, 1636428532265, 268, 1, 267, 1, 0, 1
2088, 1, 1636428532665, 1636428532934, 269, 1, 268, 0, 0, 0
2089, 1, 1636428532941, 1636428533214, 273, 1, 272, 0, 0, 0
2090, 1, 1636428533726, 1636428534150, 424, 0, 424, 0, 0, 0
2091, 1, 1636428533973, 1636428534237, 264, 1, 263, 1, 0, 1
2092, 1, 1636428534065, 1636428534333, 268, 1, 267, 0, 0, 0
2093, 1, 1636428534157, 1636428534422, 265, 1, 264, 0, 1, 1
2096, 1, 1636428534546, 1636428534814, 268, 0, 268, 0, 0, 0
2101, 1, 1636428535825, 1636428536093, 268, 1, 267, 0, 1, 1
2102, 1, 1636428535877, 1636428536145, 268, 1, 267, 0, 1, 1
2103, 1, 1636428535913, 1636428536178, 265, 1, 264, 0, 1, 1
2104, 1, 1636428536157, 1636428536426, 269, 1, 268, 0, 0, 0
2106, 1, 1636428536297, 1636428536565, 268, 1, 267, 1, 0, 1
2108, 1, 1636428536509, 1636428536778, 269, 0, 269, 0, 0, 0
2107, 1, 1636428536573, 1636428536842, 269, 0, 269, 0, 0, 0
2105, 1, 1636428536849, 1636428537122, 273, 1, 272, 0, 1, 1
2109, 1, 1636428537637, 1636428537906, 269, 0, 269, 0, 0, 0
2110, 1, 1636428537914, 1636428538178, 264, 0, 264, 0, 0, 0
2111, 1, 1636428537974, 1636428538265, 291, 0, 291, 0, 0, 0
2112, 1, 1636428538181, 1636428538450, 269, 1, 268, 1, 0, 1
2114, 1, 1636428538185, 1636428538454, 269, 1, 268, 0, 0, 0
2116, 1, 1636428538566, 1636428538834, 268, 0, 268, 0, 0, 0
2117, 1, 1636428538574, 1636428538838, 264, 0, 264, 0, 0, 0
2118, 1, 1636428539226, 1636428539494, 268, 0, 268, 0, 0, 0
2119, 1, 1636428539661, 1636428539933, 272, 0, 272, 0, 0, 0
2080, 1, 1636428539705, 1636428539977, 272, 1, 271, 0, 0, 0
2120, 1, 1636428539834, 1636428540101, 267, 0, 267, 0, 0, 0
2123, 1, 1636428540061, 1636428540333, 272, 0, 272, 0, 0, 0
2122, 1, 1636428540106, 1636428540374, 268, 0, 268, 0, 0, 0
2124, 1, 1636428540106, 1636428540374, 268, 0, 268, 0, 0, 0
2126, 1, 1636428540570, 1636428540838, 268, 0, 268, 0, 0, 0
2127, 1, 1636428540578, 1636428540841, 263, 0, 263, 0, 0, 0
2128, 1, 1636428541218, 1636428541481, 263, 0, 263, 0, 0, 0
2129, 1, 1636428541434, 1636428541698, 264, 0, 264, 0, 0, 0
2131, 1, 1636428541757, 1636428542029, 272, 1, 271, 1, 0, 1
2133, 1, 1636428542026, 1636428542289, 263, 0, 263, 0, 0, 0
2132, 1, 1636428542037, 1636428542301, 264, 1, 263, 0, 1, 1
2134, 1, 1636428542089, 1636428542357, 268, 1, 267, 1, 0, 1
2135, 1, 1636428542242, 1636428542506, 264, 0, 264, 0, 0, 0
2137, 1, 1636428542537, 1636428542805, 268, 1, 267, 0, 0, 0
2136, 1, 1636428542530, 1636428542806, 276, 0, 276, 0, 0, 0
2138, 1, 1636428543202, 1636428543465, 263, 0, 263, 0, 0, 0
2139, 1, 1636428543413, 1636428543681, 268, 1, 267, 0, 0, 0
2140, 1, 1636428543657, 1636428543926, 269, 1, 268, 1, 0, 1
2141, 1, 1636428543933, 1636428544202, 269, 1, 268, 0, 0, 0
2142, 1, 1636428544070, 1636428544334, 264, 0, 264, 0, 0, 0
2143, 1, 1636428544089, 1636428544354, 265, 1, 264, 0, 0, 0
2144, 1, 1636428544230, 1636428544494, 264, 0, 264, 0, 0, 0
2145, 1, 1636428544614, 1636428544878, 264, 0, 264, 0, 0, 0
2100, 1, 1636428544749, 1636428545018, 269, 0, 269, 0, 0, 0
2146, 1, 1636428544789, 1636428545058, 269, 1, 268, 0, 0, 0
2147, 1, 1636428545085, 1636428545349, 264, 0, 264, 0, 0, 0
2148, 1, 1636428545105, 1636428545373, 268, 1, 267, 1, 0, 1
2149, 1, 1636428545181, 1636428545445, 264, 1, 263, 1, 0, 1
2153, 1, 1636428545405, 1636428545673, 268, 1, 267, 0, 0, 0
2154, 1, 1636428545489, 1636428545757, 268, 1, 267, 0, 0, 0
2155, 1, 1636428545761, 1636428546025, 264, 1, 263, 1, 0, 1
2157, 1, 1636428546002, 1636428546266, 264, 0, 264, 0, 0, 0
2156, 1, 1636428546037, 1636428546305, 268, 0, 268, 0, 0, 0
2158, 1, 1636428546109, 1636428546373, 264, 1, 263, 0, 0, 0
2159, 1, 1636428546205, 1636428546470, 265, 1, 264, 0, 1, 1
2160, 1, 1636428546461, 1636428546725, 264, 1, 263, 0, 1, 1
2161, 1, 1636428546522, 1636428546789, 267, 0, 267, 0, 0, 0
2162, 1, 1636428547093, 1636428547357, 264, 1, 263, 1, 0, 1
2163, 1, 1636428547106, 1636428547369, 263, 0, 263, 0, 0, 0
2164, 1, 1636428547134, 1636428547401, 267, 0, 267, 0, 0, 0
2165, 1, 1636428547313, 1636428547582, 269, 1, 268, 0, 0, 0
2166, 1, 1636428547494, 1636428547766, 272, 0, 272, 0, 0, 0
2167, 1, 1636428547769, 1636428548033, 264, 1, 263, 1, 0, 1
2169, 1, 1636428547970, 1636428548249, 279, 0, 279, 0, 0, 0
2170, 1, 1636428548026, 1636428548290, 264, 0, 264, 0, 0, 0
2168, 1, 1636428548077, 1636428548341, 264, 1, 263, 0, 1, 1
2171, 1, 1636428548290, 1636428548553, 263, 0, 263, 0, 0, 0
2172, 1, 1636428548425, 1636428548694, 269, 1, 268, 0, 0, 0
2174, 1, 1636428548565, 1636428548834, 269, 1, 268, 0, 0, 0
2173, 1, 1636428548565, 1636428548834, 269, 1, 268, 1, 0, 1
2175, 1, 1636428548841, 1636428549109, 268, 0, 268, 0, 0, 0
2176, 1, 1636428548982, 1636428549246, 264, 0, 264, 0, 0, 0
2177, 1, 1636428549133, 1636428549397, 264, 1, 263, 0, 1, 1
2178, 1, 1636428549253, 1636428549518, 265, 1, 264, 0, 1, 1
2179, 1, 1636428549342, 1636428549605, 263, 0, 263, 0, 0, 0
2180, 1, 1636428549433, 1636428549706, 273, 1, 272, 1, 0, 1
2181, 1, 1636428549713, 1636428549982, 269, 0, 269, 0, 0, 0
2183, 1, 1636428549921, 1636428550186, 265, 1, 264, 1, 0, 1
2182, 1, 1636428550010, 1636428550277, 267, 0, 267, 0, 0, 0
2184, 1, 1636428550042, 1636428550309, 267, 0, 267, 0, 0, 0
2185, 1, 1636428550225, 1636428550490, 265, 0, 265, 0, 0, 0
2187, 1, 1636428550365, 1636428550626, 261, 0, 261, 0, 0, 0
2130, 1, 1636428550405, 1636428550670, 265, 1, 264, 0, 0, 0
2188, 1, 1636428550453, 1636428550714, 261, 0, 261, 0, 0, 0
2189, 1, 1636428550673, 1636428550938, 265, 0, 265, 0, 0, 0
2190, 1, 1636428550721, 1636428550989, 268, 1, 267, 0, 0, 0
2192, 1, 1636428550937, 1636428551201, 264, 1, 263, 0, 0, 0
2193, 1, 1636428551077, 1636428551341, 264, 1, 263, 1, 0, 1
2195, 1, 1636428551305, 1636428551570, 265, 1, 264, 1, 0, 1
2196, 1, 1636428551353, 1636428551622, 269, 1, 268, 0, 0, 0
2197, 1, 1636428551466, 1636428551734, 268, 0, 268, 0, 0, 0
2198, 1, 1636428551581, 1636428551846, 265, 1, 264, 0, 1, 1
2200, 1, 1636428551857, 1636428552122, 265, 1, 264, 1, 0, 1
2199, 1, 1636428551865, 1636428552133, 268, 1, 267, 0, 0, 0
2201, 1, 1636428552149, 1636428552414, 265, 1, 264, 1, 0, 1
2202, 1, 1636428552158, 1636428552426, 268, 0, 268, 0, 0, 0
2203, 1, 1636428552274, 1636428552537, 263, 0, 263, 0, 0, 0
2204, 1, 1636428552549, 1636428552818, 269, 1, 268, 0, 1, 1
2205, 1, 1636428552561, 1636428552825, 264, 0, 264, 0, 0, 0
2206, 1, 1636428552714, 1636428552981, 267, 0, 267, 0, 0, 0
2207, 1, 1636428553025, 1636428553298, 273, 0, 273, 0, 0, 0
2208, 1, 1636428553170, 1636428553433, 263, 0, 263, 0, 0, 0
2209, 1, 1636428553234, 1636428553497, 263, 0, 263, 0, 0, 0
2210, 1, 1636428553398, 1636428553662, 264, 0, 264, 0, 0, 0
2211, 1, 1636428553549, 1636428553818, 269, 1, 268, 1, 0, 1
2212, 1, 1636428553665, 1636428553933, 268, 1, 267, 0, 1, 1
2213, 1, 1636428553850, 1636428554113, 263, 0, 263, 0, 0, 0
2214, 1, 1636428553941, 1636428554206, 265, 1, 264, 1, 0, 1
2215, 1, 1636428554042, 1636428554305, 263, 0, 263, 0, 0, 0
2216, 1, 1636428554161, 1636428554426, 265, 1, 264, 1, 0, 1
2217, 1, 1636428554253, 1636428554526, 273, 1, 272, 0, 1, 1
2218, 1, 1636428554425, 1636428554689, 264, 1, 263, 0, 0, 0
2219, 1, 1636428554598, 1636428554861, 263, 0, 263, 0, 0, 0
2220, 1, 1636428554662, 1636428554930, 268, 0, 268, 0, 0, 0
2221, 1, 1636428554917, 1636428555318, 401, 1, 400, 0, 0, 0
2222, 1, 1636428555145, 1636428555413, 268, 1, 267, 0, 0, 0
2223, 1, 1636428555325, 1636428555586, 261, 0, 261, 0, 0, 0
2224, 1, 1636428555369, 1636428555633, 264, 1, 263, 0, 0, 0
2225, 1, 1636428555457, 1636428555717, 260, 0, 260, 0, 0, 0
2226, 1, 1636428555633, 1636428555902, 269, 1, 268, 1, 0, 1
2230, 1, 1636428555910, 1636428556181, 271, 0, 271, 0, 0, 0
2231, 1, 1636428555921, 1636428556185, 264, 1, 263, 0, 1, 1
2232, 1, 1636428555957, 1636428556222, 265, 0, 265, 0, 0, 0
2233, 1, 1636428556225, 1636428556493, 268, 1, 267, 0, 1, 1
2234, 1, 1636428556254, 1636428556517, 263, 0, 263, 0, 0, 0
2235, 1, 1636428556321, 1636428556590, 269, 1, 268, 0, 0, 0
2236, 1, 1636428556557, 1636428556825, 268, 1, 267, 1, 0, 1
2237, 1, 1636428556637, 1636428556909, 272, 1, 271, 0, 0, 0
2238, 1, 1636428556869, 1636428557146, 277, 1, 276, 0, 0, 0
2239, 1, 1636428557125, 1636428557390, 265, 0, 265, 0, 0, 0
2240, 1, 1636428557146, 1636428557409, 263, 0, 263, 0, 0, 0
2241, 1, 1636428557294, 1636428557557, 263, 0, 263, 0, 0, 0
2242, 1, 1636428557353, 1636428557617, 264, 1, 263, 0, 1, 1
2243, 1, 1636428557569, 1636428557837, 268, 1, 267, 0, 0, 0
2245, 1, 1636428557829, 1636428558093, 264, 0, 264, 0, 0, 0
2244, 1, 1636428557841, 1636428558109, 268, 0, 268, 0, 0, 0
2246, 1, 1636428557990, 1636428558257, 267, 0, 267, 0, 0, 0
2248, 1, 1636428558198, 1636428558461, 263, 1, 262, 0, 1, 1
2247, 1, 1636428558198, 1636428558461, 263, 0, 263, 0, 0, 0
2249, 1, 1636428558221, 1636428558485, 264, 0, 264, 0, 0, 0
2250, 1, 1636428558537, 1636428558805, 268, 1, 267, 1, 0, 1
2251, 1, 1636428558578, 1636428558842, 264, 0, 264, 0, 0, 0
2252, 1, 1636428558842, 1636428559109, 267, 0, 267, 0, 0, 0
2253, 1, 1636428559129, 1636428559397, 268, 1, 267, 1, 0, 1
2254, 1, 1636428559166, 1636428559438, 272, 0, 272, 0, 0, 0
2255, 1, 1636428559193, 1636428559461, 268, 1, 267, 1, 0, 1
2256, 1, 1636428559249, 1636428559513, 264, 1, 263, 0, 1, 1
2257, 1, 1636428559441, 1636428559710, 269, 1, 268, 0, 1, 1
2258, 1, 1636428559721, 1636428559986, 265, 1, 264, 1, 0, 1
2259, 1, 1636428559786, 1636428560049, 263, 0, 263, 0, 0, 0
2260, 1, 1636428559926, 1636428560190, 264, 0, 264, 0, 0, 0
2262, 1, 1636428560085, 1636428560350, 265, 1, 264, 0, 0, 0
2263, 1, 1636428560094, 1636428560357, 263, 0, 263, 0, 0, 0
2261, 1, 1636428560093, 1636428560366, 273, 1, 272, 0, 0, 0
2264, 1, 1636428560469, 1636428560738, 269, 1, 268, 1, 0, 1
2265, 1, 1636428560554, 1636428560821, 267, 0, 267, 0, 0, 0
2194, 1, 1636428560766, 1636428561034, 268, 0, 268, 0, 0, 0
2267, 1, 1636428560962, 1636428561233, 271, 0, 271, 0, 0, 0
2269, 1, 1636428561066, 1636428561330, 264, 0, 264, 0, 0, 0
2271, 1, 1636428561229, 1636428561494, 265, 1, 264, 1, 0, 1
2274, 1, 1636428561513, 1636428561774, 261, 1, 260, 0, 0, 0
2275, 1, 1636428561733, 1636428561997, 264, 1, 263, 0, 0, 0
2276, 1, 1636428561825, 1636428562093, 268, 1, 267, 0, 0, 0
2277, 1, 1636428561837, 1636428562102, 265, 1, 264, 0, 0, 0
2278, 1, 1636428562001, 1636428562265, 264, 1, 263, 0, 0, 0
2279, 1, 1636428562038, 1636428562301, 263, 0, 263, 0, 0, 0
2280, 1, 1636428562225, 1636428562490, 265, 0, 265, 0, 0, 0
2281, 1, 1636428562346, 1636428562614, 268, 0, 268, 0, 0, 0
2282, 1, 1636428562621, 1636428562889, 268, 0, 268, 0, 0, 0
2284, 1, 1636428563038, 1636428563306, 268, 0, 268, 0, 0, 0
2285, 1, 1636428563146, 1636428563414, 268, 0, 268, 0, 0, 0
2287, 1, 1636428563714, 1636428563985, 271, 0, 271, 0, 0, 0
2289, 1, 1636428563885, 1636428564150, 265, 1, 264, 0, 0, 0
2290, 1, 1636428563914, 1636428564177, 263, 0, 263, 0, 0, 0
2291, 1, 1636428563917, 1636428564186, 269, 1, 268, 1, 0, 1
2292, 1, 1636428564213, 1636428564478, 265, 1, 264, 0, 1, 1
2293, 1, 1636428564245, 1636428564510, 265, 1, 264, 0, 0, 0
2294, 1, 1636428564610, 1636428564874, 264, 0, 264, 0, 0, 0
2295, 1, 1636428565134, 1636428565402, 268, 0, 268, 0, 0, 0
2296, 1, 1636428565142, 1636428565410, 268, 0, 268, 0, 0, 0
2299, 1, 1636428565953, 1636428566217, 264, 1, 263, 1, 0, 1
2298, 1, 1636428565953, 1636428566217, 264, 1, 263, 1, 0, 1
2300, 1, 1636428565953, 1636428566217, 264, 1, 263, 1, 0, 1
2297, 1, 1636428565953, 1636428566221, 268, 1, 267, 1, 0, 1
2304, 1, 1636428566229, 1636428566493, 264, 1, 263, 0, 1, 1
2305, 1, 1636428566238, 1636428566505, 267, 0, 267, 0, 0, 0
2306, 1, 1636428566645, 1636428566917, 272, 1, 271, 0, 0, 0
2308, 1, 1636428567094, 1636428567362, 268, 0, 268, 0, 0, 0
2309, 1, 1636428567762, 1636428568030, 268, 0, 268, 0, 0, 0
2310, 1, 1636428567797, 1636428568061, 264, 1, 263, 0, 0, 0
2311, 1, 1636428567837, 1636428568101, 264, 0, 264, 0, 0, 0
2312, 1, 1636428567882, 1636428568146, 264, 0, 264, 0, 0, 0
2313, 1, 1636428568189, 1636428568453, 264, 1, 263, 0, 1, 1
2314, 1, 1636428568273, 1636428568546, 273, 1, 272, 0, 1, 1
2315, 1, 1636428568677, 1636428568946, 269, 1, 268, 1, 0, 1
2316, 1, 1636428569034, 1636428569305, 271, 0, 271, 0, 0, 0
2317, 1, 1636428569666, 1636428569930, 264, 0, 264, 0, 0, 0
2318, 1, 1636428569678, 1636428569941, 263, 0, 263, 0, 0, 0
2319, 1, 1636428569886, 1636428570149, 263, 0, 263, 0, 0, 0
2320, 1, 1636428570145, 1636428570410, 265, 1, 264, 0, 0, 0
2321, 1, 1636428570254, 1636428570525, 271, 0, 271, 0, 0, 0
2322, 1, 1636428570682, 1636428570945, 263, 0, 263, 0, 0, 0
2323, 1, 1636428571102, 1636428571370, 268, 0, 268, 0, 0, 0
2326, 1, 1636428571685, 1636428571950, 265, 1, 264, 0, 0, 0
2327, 1, 1636428571750, 1636428572018, 268, 0, 268, 0, 0, 0
2328, 1, 1636428571774, 1636428572042, 268, 0, 268, 0, 0, 0
2330, 1, 1636428572162, 1636428572430, 268, 0, 268, 0, 0, 0
2331, 1, 1636428572278, 1636428572546, 268, 0, 268, 0, 0, 0
2332, 1, 1636428572778, 1636428573054, 276, 0, 276, 0, 0, 0
2288, 1, 1636428573629, 1636428573902, 273, 0, 273, 0, 0, 0
2334, 1, 1636428573770, 1636428574037, 267, 0, 267, 0, 0, 0
2335, 1, 1636428573906, 1636428574170, 264, 0, 264, 0, 0, 0
2338, 1, 1636428574338, 1636428574610, 272, 0, 272, 0, 0, 0
2339, 1, 1636428574841, 1636428575110, 269, 1, 268, 0, 1, 1
2340, 1, 1636428575637, 1636428575901, 264, 1, 263, 0, 0, 0
2341, 1, 1636428575914, 1636428576182, 268, 0, 268, 0, 0, 0
2342, 1, 1636428576397, 1636428576661, 264, 1, 263, 0, 0, 0
2344, 1, 1636428576614, 1636428576877, 263, 0, 263, 0, 0, 0
2346, 1, 1636428576745, 1636428577018, 273, 1, 272, 0, 0, 0
2345, 1, 1636428576885, 1636428577149, 264, 0, 264, 0, 0, 0
2343, 1, 1636428577157, 1636428577422, 265, 1, 264, 1, 0, 1
2347, 1, 1636428577589, 1636428577853, 264, 1, 263, 1, 0, 1
2348, 1, 1636428577802, 1636428578070, 268, 0, 268, 0, 0, 0
2349, 1, 1636428578358, 1636428578626, 268, 0, 268, 0, 0, 0
2353, 1, 1636428578762, 1636428579030, 268, 0, 268, 0, 0, 0
2354, 1, 1636428579637, 1636428579905, 268, 1, 267, 1, 0, 1
2355, 1, 1636428579825, 1636428580093, 268, 1, 267, 0, 0, 0
2356, 1, 1636428580321, 1636428580589, 268, 1, 267, 0, 0, 0
2357, 1, 1636428580726, 1636428580990, 264, 0, 264, 0, 0, 0
2358, 1, 1636428581509, 1636428581774, 265, 1, 264, 0, 1, 1
2359, 1, 1636428581598, 1636428581865, 267, 0, 267, 0, 0, 0
2360, 1, 1636428581730, 1636428581994, 264, 0, 264, 0, 0, 0
2361, 1, 1636428581806, 1636428582073, 267, 0, 267, 0, 0, 0
2362, 1, 1636428582178, 1636428582441, 263, 0, 263, 0, 0, 0
2363, 1, 1636428582389, 1636428582658, 269, 1, 268, 0, 0, 0
2364, 1, 1636428582790, 1636428583058, 268, 0, 268, 0, 0, 0
2367, 1, 1636428583710, 1636428584014, 304, 0, 304, 0, 0, 0
2369, 1, 1636428583841, 1636428584110, 269, 0, 269, 0, 0, 0
2371, 1, 1636428584317, 1636428584582, 265, 1, 264, 0, 0, 0
2372, 1, 1636428584402, 1636428584669, 267, 0, 267, 0, 0, 0
2374, 1, 1636428584810, 1636428585074, 264, 0, 264, 0, 0, 0
2376, 1, 1636428585718, 1636428585982, 264, 0, 264, 0, 0, 0
2378, 1, 1636428586286, 1636428586550, 264, 0, 264, 0, 0, 0
2379, 1, 1636428586690, 1636428586953, 263, 0, 263, 0, 0, 0
2380, 1, 1636428587730, 1636428587994, 264, 0, 264, 0, 0, 0
2381, 1, 1636428588338, 1636428588674, 336, 0, 336, 0, 0, 0
2382, 1, 1636428588766, 1636428589030, 264, 0, 264, 0, 0, 0
2383, 1, 1636428588941, 1636428589206, 265, 0, 265, 0, 0, 0
2386, 1, 1636428589826, 1636428590094, 268, 0, 268, 0, 0, 0
2387, 1, 1636428590458, 1636428590725, 267, 0, 267, 0, 0, 0
2388, 1, 1636428590757, 1636428591026, 269, 1, 268, 0, 0, 0
2389, 1, 1636428590914, 1636428591182, 268, 0, 268, 0, 0, 0
2390, 1, 1636428591730, 1636428591994, 264, 0, 264, 0, 0, 0
2391, 1, 1636428592390, 1636428592653, 263, 0, 263, 0, 0, 0
2392, 1, 1636428592697, 1636428592969, 272, 0, 272, 0, 0, 0
2393, 1, 1636428592830, 1636428593098, 268, 0, 268, 0, 0, 0
2394, 1, 1636428593701, 1636428593966, 265, 0, 265, 0, 0, 0
2396, 1, 1636428593958, 1636428594222, 264, 0, 264, 0, 0, 0
2398, 1, 1636428594345, 1636428594614, 269, 1, 268, 0, 0, 0
2400, 1, 1636428594689, 1636428594958, 269, 1, 268, 0, 1, 1
2401, 1, 1636428594898, 1636428595162, 264, 0, 264, 0, 0, 0
2402, 1, 1636428595578, 1636428595842, 264, 0, 264, 0, 0, 0
2377, 1, 1636428595713, 1636428595977, 264, 1, 263, 0, 1, 1
2403, 1, 1636428595981, 1636428596246, 265, 1, 264, 0, 1, 1
2406, 1, 1636428596390, 1636428596657, 267, 0, 267, 0, 0, 0
2407, 1, 1636428596725, 1636428596994, 269, 0, 269, 0, 0, 0
2408, 1, 1636428596826, 1636428597097, 271, 0, 271, 0, 0, 0
2409, 1, 1636428597554, 1636428597826, 272, 0, 272, 0, 0, 0
2410, 1, 1636428597850, 1636428598122, 272, 0, 272, 0, 0, 0
2411, 1, 1636428598345, 1636428598614, 269, 1, 268, 0, 0, 0
2412, 1, 1636428598685, 1636428599033, 348, 1, 347, 0, 1, 1
2413, 1, 1636428598858, 1636428599125, 267, 0, 267, 0, 0, 0
2416, 1, 1636428599533, 1636428599798, 265, 1, 264, 0, 0, 0
2417, 1, 1636428599882, 1636428600150, 268, 0, 268, 0, 0, 0
2418, 1, 1636428600378, 1636428600642, 264, 0, 264, 0, 0, 0
2419, 1, 1636428600769, 1636428601037, 268, 1, 267, 0, 1, 1
2420, 1, 1636428600898, 1636428601166, 268, 0, 268, 0, 0, 0
2421, 1, 1636428601610, 1636428601878, 268, 0, 268, 0, 0, 0
2422, 1, 1636428601785, 1636428602058, 273, 1, 272, 1, 0, 1
2423, 1, 1636428602266, 1636428602530, 264, 0, 264, 0, 0, 0
2424, 1, 1636428602674, 1636428602938, 264, 0, 264, 0, 0, 0
2425, 1, 1636428602797, 1636428603066, 269, 1, 268, 1, 0, 1
2426, 1, 1636428603522, 1636428603798, 276, 0, 276, 0, 0, 0
2427, 1, 1636428603957, 1636428604226, 269, 1, 268, 0, 0, 0
2429, 1, 1636428604381, 1636428604654, 273, 1, 272, 1, 0, 1
2431, 1, 1636428604718, 1636428604986, 268, 0, 268, 0, 0, 0
2432, 1, 1636428604786, 1636428605050, 264, 0, 264, 0, 0, 0
2434, 1, 1636428605602, 1636428605870, 268, 0, 268, 0, 0, 0
2435, 1, 1636428605954, 1636428606218, 264, 0, 264, 0, 0, 0
2405, 1, 1636428606054, 1636428606317, 263, 0, 263, 0, 0, 0
2437, 1, 1636428606377, 1636428606645, 268, 1, 267, 0, 1, 1
2438, 1, 1636428606590, 1636428606858, 268, 0, 268, 0, 0, 0
2440, 1, 1636428606794, 1636428607062, 268, 0, 268, 0, 0, 0
2441, 1, 1636428607610, 1636428607877, 267, 0, 267, 0, 0, 0
2442, 1, 1636428607822, 1636428608090, 268, 0, 268, 0, 0, 0
2443, 1, 1636428608250, 1636428608522, 272, 0, 272, 0, 0, 0
2444, 1, 1636428608514, 1636428608778, 264, 0, 264, 0, 0, 0
2445, 1, 1636428608665, 1636428608934, 269, 1, 268, 1, 0, 1
2446, 1, 1636428609798, 1636428610070, 272, 0, 272, 0, 0, 0
2449, 1, 1636428610190, 1636428610458, 268, 0, 268, 0, 0, 0
2450, 1, 1636428610449, 1636428610714, 265, 0, 265, 0, 0, 0
2451, 1, 1636428610637, 1636428610906, 269, 1, 268, 1, 0, 1
2452, 1, 1636428611902, 1636428612174, 272, 0, 272, 0, 0, 0
2453, 1, 1636428612294, 1636428612558, 264, 0, 264, 0, 0, 0
2454, 1, 1636428612573, 1636428612837, 264, 1, 263, 1, 0, 1
2455, 1, 1636428612745, 1636428613018, 273, 1, 272, 0, 0, 0
2456, 1, 1636428613794, 1636428614058, 264, 0, 264, 0, 0, 0
2457, 1, 1636428614194, 1636428614478, 284, 0, 284, 0, 0, 0
2458, 1, 1636428614478, 1636428614741, 263, 0, 263, 0, 0, 0
2460, 1, 1636428614638, 1636428614902, 264, 0, 264, 0, 0, 0
2463, 1, 1636428615882, 1636428616154, 272, 0, 272, 0, 0, 0
2464, 1, 1636428616270, 1636428616534, 264, 0, 264, 0, 0, 0
2439, 1, 1636428616402, 1636428616670, 268, 0, 268, 0, 0, 0
2465, 1, 1636428616670, 1636428616938, 268, 0, 268, 0, 0, 0
2468, 1, 1636428617845, 1636428618118, 273, 1, 272, 0, 1, 1
2470, 1, 1636428618658, 1636428618930, 272, 0, 272, 0, 0, 0
2471, 1, 1636428619930, 1636428620194, 264, 0, 264, 0, 0, 0
2474, 1, 1636428620710, 1636428620986, 276, 0, 276, 0, 0, 0
2475, 1, 1636428622030, 1636428622298, 268, 0, 268, 0, 0, 0
2476, 1, 1636428622742, 1636428623006, 264, 0, 264, 0, 0, 0
2477, 1, 1636428623894, 1636428624162, 268, 0, 268, 0, 0, 0
2478, 1, 1636428624646, 1636428624914, 268, 0, 268, 0, 0, 0
2467, 1, 1636428626749, 1636428627017, 268, 1, 267, 0, 0, 0
2483, 1, 1636428637098, 1636428637361, 263, 0, 263, 0, 0, 0
2491, 1, 1636428640994, 1636428641266, 272, 0, 272, 0, 0, 0
2492, 1, 1636428641266, 1636428641534, 268, 1, 267, 0, 0, 0
2493, 1, 1636428642846, 1636428643114, 268, 0, 268, 0, 0, 0
2494, 1, 1636428643121, 1636428643390, 269, 1, 268, 1, 0, 1
2495, 1, 1636428644954, 1636428645226, 272, 0, 272, 0, 0, 0
2496, 1, 1636428645253, 1636428645522, 269, 1, 268, 1, 0, 1
2498, 1, 1636428645826, 1636428646094, 268, 0, 268, 0, 0, 0
2499, 1, 1636428646286, 1636428646553, 267, 0, 267, 0, 0, 0
2500, 1, 1636428646981, 1636428647245, 264, 1, 263, 0, 0, 0
2501, 1, 1636428647258, 1636428647525, 267, 0, 267, 0, 0, 0
2490, 1, 1636428647445, 1636428647714, 269, 1, 268, 0, 0, 0
2502, 1, 1636428647705, 1636428647970, 265, 1, 264, 0, 0, 0
2503, 1, 1636428647789, 1636428648054, 265, 1, 264, 1, 0, 1
2504, 1, 1636428648153, 1636428648417, 264, 1, 263, 1, 0, 1
2505, 1, 1636428648170, 1636428648433, 263, 0, 263, 0, 0, 0
2506, 1, 1636428648850, 1636428649118, 268, 0, 268, 0, 0, 0
2507, 1, 1636428649125, 1636428649398, 273, 1, 272, 1, 0, 1
2508, 1, 1636428649602, 1636428649869, 267, 0, 267, 0, 0, 0
2509, 1, 1636428649818, 1636428650085, 267, 0, 267, 0, 0, 0
2510, 1, 1636428650050, 1636428650318, 268, 0, 268, 0, 0, 0
2511, 1, 1636428650277, 1636428650542, 265, 1, 264, 0, 1, 1
2512, 1, 1636428650826, 1636428651090, 264, 0, 264, 0, 0, 0
2513, 1, 1636428651101, 1636428651366, 265, 1, 264, 0, 0, 0
2514, 1, 1636428651714, 1636428651982, 268, 0, 268, 0, 0, 0
2515, 1, 1636428651890, 1636428652158, 268, 0, 268, 0, 0, 0
2516, 1, 1636428652158, 1636428652422, 264, 0, 264, 0, 0, 0
2517, 1, 1636428652349, 1636428652621, 272, 1, 271, 1, 0, 1
2518, 1, 1636428652886, 1636428653150, 264, 0, 264, 0, 0, 0
2519, 1, 1636428653161, 1636428653430, 269, 1, 268, 1, 0, 1
2520, 1, 1636428653725, 1636428653989, 264, 1, 263, 0, 1, 1
2521, 1, 1636428653758, 1636428654022, 264, 0, 264, 0, 0, 0
2522, 1, 1636428654226, 1636428654494, 268, 0, 268, 0, 0, 0
2523, 1, 1636428654317, 1636428654581, 264, 1, 263, 0, 0, 0
2524, 1, 1636428654762, 1636428655029, 267, 0, 267, 0, 0, 0
2525, 1, 1636428655034, 1636428655302, 268, 0, 268, 0, 0, 0
2526, 1, 1636428655638, 1636428655906, 268, 0, 268, 0, 0, 0
2527, 1, 1636428655649, 1636428655918, 269, 1, 268, 0, 1, 1
2528, 1, 1636428656154, 1636428656417, 263, 0, 263, 0, 0, 0
2529, 1, 1636428656294, 1636428656558, 264, 0, 264, 0, 0, 0
2530, 1, 1636428656802, 1636428657066, 264, 0, 264, 0, 0, 0
2531, 1, 1636428657077, 1636428657346, 269, 1, 268, 0, 0, 0
2532, 1, 1636428657533, 1636428657802, 269, 1, 268, 0, 0, 0
2533, 1, 1636428657745, 1636428658010, 265, 0, 265, 0, 0, 0
2534, 1, 1636428658042, 1636428658309, 267, 0, 267, 0, 0, 0
2535, 1, 1636428658397, 1636428658666, 269, 1, 268, 0, 1, 1
2536, 1, 1636428659622, 1636428659886, 264, 0, 264, 0, 0, 0
2537, 1, 1636428659637, 1636428659901, 264, 0, 264, 0, 0, 0
2538, 1, 1636428660142, 1636428660405, 263, 0, 263, 0, 0, 0
2539, 1, 1636428660281, 1636428660542, 261, 0, 261, 0, 0, 0
2540, 1, 1636428661518, 1636428661790, 272, 0, 272, 0, 0, 0
2541, 1, 1636428661709, 1636428661973, 264, 1, 263, 0, 0, 0
2542, 1, 1636428662017, 1636428662282, 265, 0, 265, 0, 0, 0
2543, 1, 1636428662421, 1636428662694, 273, 1, 272, 1, 0, 1
2544, 1, 1636428663554, 1636428663822, 268, 0, 268, 0, 0, 0
2545, 1, 1636428664106, 1636428664370, 264, 0, 264, 0, 0, 0
