Xid, State, StartTime, EndTime, TransactionTime, ExecuteTime, CommunicationTime, ReadTime, WriteTime, DBTime
55, 1, 1636426225760, 1636426226256, 496, 80, 416, 36, 6, 42
58, 1, 1636426226606, 1636426227007, 401, 4, 397, 2, 1, 3
62, 1, 1636426227283, 1636426227695, 412, 2, 410, 0, 1, 1
65, 1, 1636426227962, 1636426228367, 405, 3, 402, 0, 1, 1
68, 1, 1636426228634, 1636426229034, 400, 4, 396, 2, 0, 2
71, 1, 1636426229302, 1636426229706, 404, 4, 400, 1, 1, 2
75, 1, 1636426229974, 1636426230382, 408, 3, 405, 0, 0, 0
78, 1, 1636426230650, 1636426231050, 400, 4, 396, 1, 0, 1
81, 1, 1636426231318, 1636426231734, 416, 2, 414, 1, 0, 1
84, 1, 1636426232002, 1636426232402, 400, 3, 397, 1, 1, 2
87, 1, 1636426232670, 1636426233074, 404, 3, 401, 1, 1, 2
90, 1, 1636426233346, 1636426233755, 409, 2, 407, 0, 0, 0
93, 1, 1636426234022, 1636426234430, 408, 2, 406, 1, 1, 2
96, 1, 1636426234698, 1636426235098, 400, 2, 398, 0, 1, 1
99, 1, 1636426235366, 1636426235770, 404, 3, 401, 0, 0, 0
102, 1, 1636426236042, 1636426236443, 401, 7, 394, 1, 0, 1
105, 1, 1636426236710, 1636426237070, 360, 3, 357, 0, 0, 0
108, 1, 1636426237338, 1636426237698, 360, 1, 359, 0, 1, 1
111, 1, 1636426237966, 1636426238326, 360, 2, 358, 1, 0, 1
114, 1, 1636426238594, 1636426238958, 364, 2, 362, 1, 0, 1
117, 1, 1636426239226, 1636426239590, 364, 3, 361, 1, 0, 1
120, 1, 1636426239862, 1636426240222, 360, 3, 357, 0, 1, 1
123, 1, 1636426240490, 1636426240854, 364, 2, 362, 0, 1, 1
126, 1, 1636426241122, 1636426241482, 360, 3, 357, 0, 0, 0
129, 1, 1636426241746, 1636426242110, 364, 2, 362, 0, 1, 1
132, 1, 1636426242378, 1636426242734, 356, 2, 354, 0, 1, 1
135, 1, 1636426242998, 1636426243362, 364, 1, 363, 0, 1, 1
138, 1, 1636426243626, 1636426243990, 364, 1, 363, 0, 0, 0
141, 1, 1636426244258, 1636426244622, 364, 2, 362, 0, 0, 0
144, 1, 1636426244886, 1636426245258, 372, 2, 370, 0, 0, 0
147, 1, 1636426245526, 1636426245886, 360, 3, 357, 0, 0, 0
150, 1, 1636426246153, 1636426246510, 357, 1, 356, 1, 0, 1
154, 1, 1636426246778, 1636426247138, 360, 1, 359, 0, 1, 1
157, 1, 1636426247406, 1636426247770, 364, 2, 362, 1, 1, 2
160, 1, 1636426248038, 1636426248402, 364, 1, 363, 0, 1, 1
163, 1, 1636426248670, 1636426249030, 360, 0, 360, 0, 0, 0
166, 1, 1636426249298, 1636426249653, 355, 1, 354, 0, 1, 1
169, 1, 1636426249921, 1636426250282, 361, 1, 360, 0, 0, 0
172, 1, 1636426250550, 1636426250913, 363, 1, 362, 0, 0, 0
175, 1, 1636426251186, 1636426251550, 364, 1, 363, 0, 0, 0
178, 1, 1636426251818, 1636426252182, 364, 1, 363, 0, 0, 0
181, 1, 1636426252450, 1636426252814, 364, 1, 363, 0, 0, 0
184, 1, 1636426253082, 1636426253446, 364, 2, 362, 0, 1, 1
187, 1, 1636426253710, 1636426254074, 364, 0, 364, 0, 0, 0
190, 1, 1636426254342, 1636426254698, 356, 1, 355, 0, 0, 0
193, 1, 1636426254966, 1636426255334, 368, 1, 367, 0, 1, 1
196, 1, 1636426255594, 1636426255958, 364, 0, 364, 0, 0, 0
199, 1, 1636426256222, 1636426256578, 356, 1, 355, 0, 0, 0
202, 1, 1636426256846, 1636426257210, 364, 1, 363, 0, 0, 0
205, 1, 1636426257478, 1636426257834, 356, 0, 356, 0, 0, 0
208, 1, 1636426258098, 1636426258458, 360, 0, 360, 0, 0, 0
211, 1, 1636426258722, 1636426259082, 360, 0, 360, 0, 0, 0
214, 1, 1636426259350, 1636426259718, 368, 0, 368, 0, 0, 0
217, 1, 1636426259986, 1636426260350, 364, 1, 363, 0, 0, 0
220, 1, 1636426260618, 1636426260978, 360, 1, 359, 0, 0, 0
223, 1, 1636426261246, 1636426261610, 364, 0, 364, 0, 0, 0
226, 1, 1636426261878, 1636426262229, 351, 1, 350, 0, 0, 0
229, 1, 1636426262498, 1636426262862, 364, 0, 364, 0, 0, 0
232, 1, 1636426263130, 1636426263490, 360, 0, 360, 0, 0, 0
235, 1, 1636426263758, 1636426264118, 360, 2, 358, 0, 0, 0
238, 1, 1636426264386, 1636426264746, 360, 0, 360, 0, 0, 0
241, 1, 1636426265014, 1636426265374, 360, 0, 360, 0, 0, 0
244, 1, 1636426265642, 1636426266006, 364, 1, 363, 0, 0, 0
247, 1, 1636426266274, 1636426266634, 360, 0, 360, 0, 0, 0
250, 1, 1636426266902, 1636426267266, 364, 2, 362, 0, 0, 0
253, 1, 1636426267533, 1636426267894, 361, 1, 360, 0, 0, 0
256, 1, 1636426268162, 1636426268526, 364, 0, 364, 0, 0, 0
259, 1, 1636426268794, 1636426269158, 364, 1, 363, 0, 0, 0
262, 1, 1636426269425, 1636426269790, 365, 1, 364, 0, 0, 0
265, 1, 1636426270058, 1636426270410, 352, 2, 350, 1, 0, 1
268, 1, 1636426270678, 1636426271042, 364, 0, 364, 0, 0, 0
271, 1, 1636426271306, 1636426271666, 360, 1, 359, 1, 0, 1
274, 1, 1636426271934, 1636426272290, 356, 0, 356, 0, 0, 0
277, 1, 1636426272558, 1636426272918, 360, 1, 359, 0, 0, 0
280, 1, 1636426273186, 1636426273546, 360, 0, 360, 0, 0, 0
283, 1, 1636426273810, 1636426274169, 359, 1, 358, 0, 0, 0
286, 1, 1636426274438, 1636426274802, 364, 1, 363, 0, 0, 0
289, 1, 1636426275070, 1636426275426, 356, 0, 356, 0, 0, 0
292, 1, 1636426275694, 1636426276058, 364, 1, 363, 0, 0, 0
295, 1, 1636426276326, 1636426276686, 360, 1, 359, 0, 0, 0
298, 1, 1636426276950, 1636426277310, 360, 2, 358, 0, 0, 0
301, 1, 1636426277578, 1636426277938, 360, 1, 359, 1, 0, 1
304, 1, 1636426278206, 1636426278570, 364, 1, 363, 0, 0, 0
307, 1, 1636426278838, 1636426279198, 360, 0, 360, 0, 0, 0
310, 1, 1636426279466, 1636426279822, 356, 2, 354, 0, 0, 0
313, 1, 1636426280089, 1636426280450, 361, 2, 359, 0, 0, 0
316, 1, 1636426280714, 1636426281078, 364, 0, 364, 0, 0, 0
319, 1, 1636426281342, 1636426281706, 364, 2, 362, 0, 0, 0
322, 1, 1636426281974, 1636426282330, 356, 0, 356, 0, 0, 0
325, 1, 1636426282597, 1636426282962, 365, 2, 363, 1, 0, 1
328, 1, 1636426283230, 1636426283589, 359, 0, 359, 0, 0, 0
331, 1, 1636426283858, 1636426284213, 355, 1, 354, 0, 0, 0
334, 1, 1636426284482, 1636426284842, 360, 1, 359, 0, 0, 0
337, 1, 1636426285109, 1636426285474, 365, 2, 363, 0, 1, 1
341, 1, 1636426285742, 1636426286106, 364, 0, 364, 0, 0, 0
344, 1, 1636426286374, 1636426286734, 360, 0, 360, 0, 0, 0
347, 1, 1636426287002, 1636426287366, 364, 1, 363, 0, 0, 0
350, 1, 1636426287633, 1636426287994, 361, 3, 358, 0, 0, 0
353, 1, 1636426288262, 1636426288626, 364, 1, 363, 0, 0, 0
356, 1, 1636426288894, 1636426289254, 360, 0, 360, 0, 0, 0
359, 1, 1636426289522, 1636426289890, 368, 0, 368, 0, 0, 0
362, 1, 1636426290158, 1636426290518, 360, 0, 360, 0, 0, 0
365, 1, 1636426290786, 1636426291150, 364, 0, 364, 0, 0, 0
368, 1, 1636426291418, 1636426291770, 352, 0, 352, 0, 0, 0
371, 1, 1636426292038, 1636426292398, 360, 1, 359, 0, 0, 0
374, 1, 1636426292670, 1636426293034, 364, 0, 364, 0, 0, 0
377, 1, 1636426293306, 1636426293666, 360, 1, 359, 0, 0, 0
380, 1, 1636426293934, 1636426294294, 360, 1, 359, 0, 0, 0
383, 1, 1636426294562, 1636426294922, 360, 0, 360, 0, 0, 0
386, 1, 1636426295190, 1636426295550, 360, 0, 360, 0, 0, 0
389, 1, 1636426295817, 1636426296178, 361, 1, 360, 1, 0, 1
392, 1, 1636426296446, 1636426296810, 364, 0, 364, 0, 0, 0
395, 1, 1636426297078, 1636426297442, 364, 1, 363, 1, 0, 1
398, 1, 1636426297710, 1636426298070, 360, 2, 358, 0, 0, 0
401, 1, 1636426298338, 1636426298698, 360, 1, 359, 0, 0, 0
404, 1, 1636426298966, 1636426299322, 356, 1, 355, 0, 0, 0
407, 1, 1636426299589, 1636426299950, 361, 1, 360, 0, 0, 0
410, 1, 1636426300218, 1636426300574, 356, 2, 354, 2, 0, 2
413, 1, 1636426300846, 1636426301206, 360, 3, 357, 1, 1, 2
416, 1, 1636426301473, 1636426301837, 364, 1, 363, 0, 1, 1
419, 1, 1636426302101, 1636426302466, 365, 1, 364, 1, 0, 1
422, 1, 1636426302734, 1636426303093, 359, 0, 359, 0, 0, 0
425, 1, 1636426303357, 1636426303722, 365, 1, 364, 1, 0, 1
428, 1, 1636426303990, 1636426304354, 364, 0, 364, 0, 0, 0
431, 1, 1636426304622, 1636426304986, 364, 0, 364, 0, 0, 0
434, 1, 1636426305254, 1636426305617, 363, 0, 363, 0, 0, 0
437, 1, 1636426305885, 1636426306249, 364, 1, 363, 0, 0, 0
440, 1, 1636426306513, 1636426306874, 361, 2, 359, 0, 0, 0
443, 1, 1636426307138, 1636426307502, 364, 1, 363, 0, 1, 1
446, 1, 1636426307770, 1636426308122, 352, 2, 350, 0, 0, 0
449, 1, 1636426308394, 1636426308754, 360, 2, 358, 1, 0, 1
452, 1, 1636426309026, 1636426309390, 364, 1, 363, 1, 0, 1
455, 1, 1636426309658, 1636426310018, 360, 0, 360, 0, 0, 0
458, 1, 1636426310286, 1636426310646, 360, 0, 360, 0, 0, 0
461, 1, 1636426310913, 1636426311270, 357, 1, 356, 0, 0, 0
464, 1, 1636426311542, 1636426311902, 360, 0, 360, 0, 0, 0
467, 1, 1636426312170, 1636426312525, 355, 0, 355, 0, 0, 0
470, 1, 1636426312794, 1636426313154, 360, 0, 360, 0, 0, 0
473, 1, 1636426313421, 1636426313782, 361, 1, 360, 0, 0, 0
476, 1, 1636426314050, 1636426314418, 368, 0, 368, 0, 0, 0
479, 1, 1636426314685, 1636426315050, 365, 3, 362, 0, 0, 0
482, 1, 1636426315318, 1636426315682, 364, 1, 363, 1, 0, 1
485, 1, 1636426315949, 1636426316306, 357, 2, 355, 0, 0, 0
488, 1, 1636426316574, 1636426316938, 364, 0, 364, 0, 0, 0
491, 1, 1636426317206, 1636426317566, 360, 0, 360, 0, 0, 0
494, 1, 1636426317833, 1636426318194, 361, 1, 360, 0, 0, 0
497, 1, 1636426318462, 1636426318826, 364, 0, 364, 0, 0, 0
500, 1, 1636426319094, 1636426319458, 364, 1, 363, 1, 0, 1
503, 1, 1636426319730, 1636426320090, 360, 0, 360, 0, 0, 0
506, 1, 1636426320358, 1636426320718, 360, 2, 358, 0, 1, 1
509, 1, 1636426320986, 1636426321345, 359, 2, 357, 1, 1, 2
512, 1, 1636426321614, 1636426321970, 356, 1, 355, 0, 0, 0
515, 1, 1636426322238, 1636426322594, 356, 0, 356, 0, 0, 0
519, 1, 1636426322866, 1636426323218, 352, 1, 351, 1, 0, 1
522, 1, 1636426323485, 1636426323842, 357, 2, 355, 0, 0, 0
525, 1, 1636426324110, 1636426324470, 360, 0, 360, 0, 0, 0
528, 1, 1636426324734, 1636426325098, 364, 0, 364, 0, 0, 0
531, 1, 1636426325361, 1636426325709, 348, 1, 347, 1, 0, 1
534, 1, 1636426325973, 1636426326329, 356, 1, 355, 0, 0, 0
537, 1, 1636426326594, 1636426326957, 363, 2, 361, 1, 0, 1
539, 1, 1636426327222, 1636426327582, 360, 1, 359, 0, 0, 0
541, 1, 1636426327850, 1636426328210, 360, 0, 360, 0, 0, 0
543, 1, 1636426328478, 1636426328842, 364, 0, 364, 0, 0, 0
545, 1, 1636426329102, 1636426329462, 360, 1, 359, 0, 0, 0
547, 1, 1636426329730, 1636426330094, 364, 0, 364, 0, 0, 0
549, 1, 1636426330358, 1636426330722, 364, 0, 364, 0, 0, 0
551, 1, 1636426330990, 1636426331354, 364, 1, 363, 0, 0, 0
553, 1, 1636426331622, 1636426331986, 364, 0, 364, 0, 0, 0
555, 1, 1636426332253, 1636426332618, 365, 2, 363, 0, 0, 0
557, 1, 1636426332886, 1636426333254, 368, 0, 368, 0, 0, 0
559, 1, 1636426333521, 1636426333886, 365, 2, 363, 0, 1, 1
561, 1, 1636426334149, 1636426334514, 365, 1, 364, 0, 1, 1
563, 1, 1636426334782, 1636426335146, 364, 0, 364, 0, 0, 0
565, 1, 1636426335410, 1636426335774, 364, 0, 364, 0, 0, 0
567, 1, 1636426336038, 1636426336398, 360, 0, 360, 0, 0, 0
569, 1, 1636426336666, 1636426337030, 364, 2, 362, 0, 0, 0
571, 1, 1636426337298, 1636426337658, 360, 0, 360, 0, 0, 0
573, 1, 1636426337926, 1636426338286, 360, 1, 359, 0, 0, 0
575, 1, 1636426338550, 1636426338910, 360, 2, 358, 0, 0, 0
577, 1, 1636426339178, 1636426339542, 364, 0, 364, 0, 0, 0
579, 1, 1636426339810, 1636426340174, 364, 1, 363, 0, 0, 0
581, 1, 1636426340442, 1636426340806, 364, 1, 363, 0, 0, 0
583, 1, 1636426341074, 1636426341438, 364, 0, 364, 0, 0, 0
584, 1, 1636426341706, 1636426342070, 364, 0, 364, 0, 0, 0
585, 1, 1636426342337, 1636426342698, 361, 0, 361, 0, 0, 0
586, 1, 1636426342966, 1636426343326, 360, 1, 359, 0, 0, 0
587, 1, 1636426343594, 1636426343958, 364, 0, 364, 0, 0, 0
588, 1, 1636426344226, 1636426344590, 364, 0, 364, 0, 0, 0
589, 1, 1636426344853, 1636426345214, 361, 0, 361, 0, 0, 0
590, 1, 1636426345481, 1636426345846, 365, 1, 364, 0, 0, 0
591, 1, 1636426346114, 1636426346478, 364, 0, 364, 0, 0, 0
592, 1, 1636426346746, 1636426347110, 364, 0, 364, 0, 0, 0
593, 1, 1636426347382, 1636426347750, 368, 0, 368, 0, 0, 0
594, 1, 1636426348018, 1636426348381, 363, 0, 363, 0, 0, 0
595, 1, 1636426348646, 1636426349006, 360, 0, 360, 0, 0, 0
596, 1, 1636426349274, 1636426349638, 364, 0, 364, 0, 0, 0
597, 1, 1636426349902, 1636426350262, 360, 1, 359, 0, 0, 0
598, 1, 1636426350530, 1636426350890, 360, 2, 358, 0, 0, 0
599, 1, 1636426351158, 1636426351522, 364, 0, 364, 0, 0, 0
600, 1, 1636426351790, 1636426352150, 360, 0, 360, 0, 0, 0
1, 1, 1636426901866, 1636426902018, 152, 11, 141, 0, 0, 0
2, 1, 1636426903266, 1636426903402, 136, 0, 136, 0, 0, 0
3, 1, 1636426903878, 1636426904014, 136, 0, 136, 0, 0, 0
4, 1, 1636426904662, 1636426904798, 136, 1, 135, 0, 0, 0
5, 1, 1636426905317, 1636426905458, 141, 1, 140, 0, 0, 0
6, 1, 1636426905450, 1636426905586, 136, 0, 136, 0, 0, 0
7, 1, 1636426905986, 1636426906122, 136, 0, 136, 0, 0, 0
8, 1, 1636426906622, 1636426906757, 135, 0, 135, 0, 0, 0
9, 1, 1636426907161, 1636426907298, 137, 1, 136, 0, 1, 1
10, 1, 1636426907209, 1636426907342, 133, 2, 131, 0, 0, 0
12, 1, 1636426907750, 1636426907885, 135, 0, 135, 0, 0, 0
11, 1, 1636426907793, 1636426907930, 137, 1, 136, 0, 0, 0
13, 1, 1636426908386, 1636426908518, 132, 0, 132, 0, 0, 0
14, 1, 1636426908510, 1636426908646, 136, 0, 136, 0, 0, 0
15, 1, 1636426909170, 1636426909306, 136, 0, 136, 0, 0, 0
16, 1, 1636426909382, 1636426909518, 136, 2, 134, 1, 0, 1
17, 1, 1636426909842, 1636426909933, 91, 1, 90, 0, 0, 0
18, 1, 1636426909878, 1636426909974, 96, 0, 96, 0, 0, 0
19, 1, 1636426910386, 1636426910478, 92, 0, 92, 0, 0, 0
20, 1, 1636426910470, 1636426910562, 92, 0, 92, 0, 0, 0
21, 1, 1636426910878, 1636426910969, 91, 0, 91, 0, 0, 0
23, 1, 1636426911002, 1636426911094, 92, 1, 91, 0, 1, 1
22, 1, 1636426911002, 1636426911094, 92, 1, 91, 0, 1, 1
24, 1, 1636426911502, 1636426911594, 92, 0, 92, 0, 0, 0
25, 1, 1636426911522, 1636426911614, 92, 0, 92, 0, 0, 0
26, 1, 1636426911533, 1636426911626, 93, 1, 92, 0, 0, 0
27, 1, 1636426912009, 1636426912102, 93, 1, 92, 0, 0, 0
28, 1, 1636426912118, 1636426912210, 92, 0, 92, 0, 0, 0
29, 1, 1636426912225, 1636426912314, 89, 1, 88, 0, 0, 0
30, 1, 1636426912642, 1636426912734, 92, 0, 92, 0, 0, 0
31, 1, 1636426912886, 1636426912977, 91, 0, 91, 0, 0, 0
32, 1, 1636426913181, 1636426913274, 93, 1, 92, 1, 0, 1
33, 1, 1636426913445, 1636426913534, 89, 0, 89, 0, 0, 0
34, 1, 1636426913618, 1636426913709, 91, 0, 91, 0, 0, 0
35, 1, 1636426913702, 1636426913794, 92, 0, 92, 0, 0, 0
36, 1, 1636426913785, 1636426913878, 93, 1, 92, 0, 0, 0
37, 1, 1636426914114, 1636426914206, 92, 0, 92, 0, 0, 0
38, 1, 1636426914241, 1636426914330, 89, 0, 89, 0, 0, 0
39, 1, 1636426914246, 1636426914337, 91, 0, 91, 0, 0, 0
40, 1, 1636426914650, 1636426914742, 92, 0, 92, 0, 0, 0
41, 1, 1636426914781, 1636426914869, 88, 1, 87, 0, 0, 0
42, 1, 1636426914906, 1636426914998, 92, 0, 92, 0, 0, 0
43, 1, 1636426914998, 1636426915090, 92, 0, 92, 0, 0, 0
44, 1, 1636426915146, 1636426915238, 92, 0, 92, 0, 0, 0
45, 1, 1636426915438, 1636426915529, 91, 0, 91, 0, 0, 0
46, 1, 1636426915614, 1636426915706, 92, 0, 92, 0, 0, 0
47, 1, 1636426915625, 1636426915718, 93, 1, 92, 0, 0, 0
48, 1, 1636426915894, 1636426915986, 92, 0, 92, 0, 0, 0
49, 1, 1636426916309, 1636426916401, 92, 1, 91, 0, 0, 0
50, 1, 1636426916346, 1636426916438, 92, 0, 92, 0, 0, 0
51, 1, 1636426916874, 1636426916966, 92, 0, 92, 0, 0, 0
52, 1, 1636426916970, 1636426917062, 92, 0, 92, 0, 0, 0
53, 1, 1636426917601, 1636426917693, 92, 1, 91, 1, 0, 1
54, 1, 1636426917609, 1636426917705, 96, 1, 95, 0, 1, 1
55, 1, 1636426917697, 1636426917786, 89, 0, 89, 0, 0, 0
56, 1, 1636426917797, 1636426917890, 93, 1, 92, 0, 0, 0
58, 1, 1636426918066, 1636426918158, 92, 0, 92, 0, 0, 0
57, 1, 1636426918150, 1636426918242, 92, 0, 92, 0, 0, 0
59, 1, 1636426918293, 1636426918382, 89, 0, 89, 0, 0, 0
60, 1, 1636426918526, 1636426918618, 92, 0, 92, 0, 0, 0
61, 1, 1636426918818, 1636426918910, 92, 0, 92, 0, 0, 0
62, 1, 1636426918834, 1636426918925, 91, 0, 91, 0, 0, 0
63, 1, 1636426919170, 1636426919262, 92, 1, 91, 0, 1, 1
64, 1, 1636426919274, 1636426919370, 96, 0, 96, 0, 0, 0
65, 1, 1636426919449, 1636426919538, 89, 0, 89, 0, 0, 0
66, 1, 1636426919737, 1636426919830, 93, 1, 92, 0, 1, 1
67, 1, 1636426919781, 1636426919870, 89, 0, 89, 0, 0, 0
68, 1, 1636426919902, 1636426919994, 92, 0, 92, 0, 0, 0
69, 1, 1636426920250, 1636426920342, 92, 0, 92, 0, 0, 0
70, 1, 1636426920482, 1636426920574, 92, 0, 92, 0, 0, 0
71, 1, 1636426920781, 1636426920874, 93, 1, 92, 0, 0, 0
72, 1, 1636426921138, 1636426921230, 92, 0, 92, 0, 0, 0
73, 1, 1636426921322, 1636426921415, 93, 0, 93, 0, 0, 0
74, 1, 1636426921526, 1636426921618, 92, 0, 92, 0, 0, 0
76, 1, 1636426921881, 1636426921970, 89, 1, 88, 0, 0, 0
77, 1, 1636426921970, 1636426922062, 92, 0, 92, 0, 0, 0
75, 1, 1636426921982, 1636426922078, 96, 0, 96, 0, 0, 0
79, 1, 1636426922342, 1636426922434, 92, 0, 92, 0, 0, 0
78, 1, 1636426922445, 1636426922538, 93, 1, 92, 0, 0, 0
80, 1, 1636426922462, 1636426922553, 91, 0, 91, 0, 0, 0
81, 1, 1636426923005, 1636426923098, 93, 1, 92, 0, 0, 0
82, 1, 1636426923074, 1636426923166, 92, 1, 91, 0, 1, 1
83, 1, 1636426923121, 1636426923213, 92, 1, 91, 0, 1, 1
84, 1, 1636426923577, 1636426923670, 93, 1, 92, 0, 0, 0
86, 1, 1636426923697, 1636426923785, 88, 0, 88, 0, 0, 0
87, 1, 1636426923773, 1636426923866, 93, 1, 92, 1, 0, 1
85, 1, 1636426924034, 1636426924122, 88, 0, 88, 0, 0, 0
88, 1, 1636426924230, 1636426924322, 92, 0, 92, 0, 0, 0
90, 1, 1636426924437, 1636426924529, 92, 1, 91, 0, 0, 0
89, 1, 1636426924482, 1636426924573, 91, 0, 91, 0, 0, 0
91, 1, 1636426924890, 1636426924981, 91, 0, 91, 0, 0, 0
92, 1, 1636426925086, 1636426925178, 92, 0, 92, 0, 0, 0
93, 1, 1636426925354, 1636426925445, 91, 0, 91, 0, 0, 0
94, 1, 1636426925701, 1636426925794, 93, 1, 92, 0, 1, 1
95, 1, 1636426925881, 1636426925973, 92, 1, 91, 0, 0, 0
96, 1, 1636426925925, 1636426926017, 92, 1, 91, 0, 0, 0
97, 1, 1636426926153, 1636426926246, 93, 1, 92, 0, 0, 0
99, 1, 1636426926378, 1636426926470, 92, 0, 92, 0, 0, 0
98, 1, 1636426926385, 1636426926482, 97, 1, 96, 0, 1, 1
100, 1, 1636426926609, 1636426926702, 93, 1, 92, 0, 0, 0
101, 1, 1636426926918, 1636426927010, 92, 0, 92, 0, 0, 0
102, 1, 1636426927114, 1636426927206, 92, 0, 92, 0, 0, 0
103, 1, 1636426927294, 1636426927386, 92, 0, 92, 0, 0, 0
105, 1, 1636426927606, 1636426927698, 92, 0, 92, 0, 0, 0
108, 1, 1636426927726, 1636426927818, 92, 0, 92, 0, 0, 0
106, 1, 1636426928058, 1636426928150, 92, 0, 92, 0, 0, 0
109, 1, 1636426928470, 1636426928562, 92, 0, 92, 0, 0, 0
111, 1, 1636426929142, 1636426929234, 92, 0, 92, 0, 0, 0
113, 1, 1636426929414, 1636426929506, 92, 0, 92, 0, 0, 0
114, 1, 1636426929842, 1636426929934, 92, 0, 92, 0, 0, 0
116, 1, 1636426929914, 1636426930006, 92, 0, 92, 0, 0, 0
117, 1, 1636426930302, 1636426930394, 92, 0, 92, 0, 0, 0
119, 1, 1636426930409, 1636426930502, 93, 1, 92, 1, 0, 1
121, 1, 1636426931170, 1636426931257, 87, 0, 87, 0, 0, 0
122, 1, 1636426931209, 1636426931301, 92, 1, 91, 0, 0, 0
123, 1, 1636426931229, 1636426931318, 89, 0, 89, 0, 0, 0
124, 1, 1636426931678, 1636426931770, 92, 0, 92, 0, 0, 0
125, 1, 1636426931782, 1636426931874, 92, 0, 92, 0, 0, 0
126, 1, 1636426932138, 1636426932230, 92, 0, 92, 0, 0, 0
127, 1, 1636426932750, 1636426932841, 91, 0, 91, 0, 0, 0
128, 1, 1636426933214, 1636426933306, 92, 0, 92, 0, 0, 0
129, 1, 1636426933490, 1636426933582, 92, 0, 92, 0, 0, 0
130, 1, 1636426933966, 1636426934058, 92, 0, 92, 0, 0, 0
131, 1, 1636426934158, 1636426934250, 92, 0, 92, 0, 0, 0
133, 1, 1636426934470, 1636426934562, 92, 0, 92, 0, 0, 0
132, 1, 1636426934614, 1636426934706, 92, 0, 92, 0, 0, 0
134, 1, 1636426935242, 1636426935329, 87, 0, 87, 0, 0, 0
135, 1, 1636426935270, 1636426935362, 92, 0, 92, 0, 0, 0
136, 1, 1636426935385, 1636426935477, 92, 1, 91, 0, 0, 0
137, 1, 1636426935726, 1636426935817, 91, 0, 91, 0, 0, 0
138, 1, 1636426935858, 1636426935950, 92, 0, 92, 0, 0, 0
139, 1, 1636426936186, 1636426936278, 92, 0, 92, 0, 0, 0
140, 1, 1636426936881, 1636426936973, 92, 1, 91, 0, 0, 0
141, 1, 1636426937366, 1636426937458, 92, 0, 92, 0, 0, 0
142, 1, 1636426937777, 1636426937870, 93, 1, 92, 1, 0, 1
143, 1, 1636426938038, 1636426938130, 92, 0, 92, 0, 0, 0
145, 1, 1636426938177, 1636426938269, 92, 1, 91, 1, 0, 1
146, 1, 1636426938438, 1636426938530, 92, 0, 92, 0, 0, 0
147, 1, 1636426938537, 1636426938630, 93, 1, 92, 0, 0, 0
144, 1, 1636426938638, 1636426938730, 92, 0, 92, 0, 0, 0
148, 1, 1636426938893, 1636426938986, 93, 1, 92, 0, 0, 0
149, 1, 1636426939129, 1636426939218, 89, 1, 88, 1, 0, 1
150, 1, 1636426939342, 1636426939434, 92, 0, 92, 0, 0, 0
151, 1, 1636426939345, 1636426939437, 92, 1, 91, 0, 0, 0
152, 1, 1636426939610, 1636426939738, 128, 1, 127, 0, 0, 0
153, 1, 1636426939653, 1636426939745, 92, 1, 91, 0, 1, 1
154, 1, 1636426939830, 1636426939922, 92, 0, 92, 0, 0, 0
155, 1, 1636426940201, 1636426940294, 93, 1, 92, 0, 0, 0
156, 1, 1636426940294, 1636426940386, 92, 1, 91, 0, 0, 0
157, 1, 1636426940294, 1636426940386, 92, 1, 91, 0, 0, 0
120, 1, 1636426940329, 1636426940422, 93, 1, 92, 0, 0, 0
158, 1, 1636426940749, 1636426940842, 93, 1, 92, 0, 0, 0
159, 1, 1636426940929, 1636426941022, 93, 1, 92, 0, 0, 0
160, 1, 1636426941205, 1636426941298, 93, 1, 92, 0, 0, 0
161, 1, 1636426941386, 1636426941477, 91, 0, 91, 0, 0, 0
162, 1, 1636426941454, 1636426941546, 92, 0, 92, 0, 0, 0
163, 1, 1636426941925, 1636426942018, 93, 1, 92, 0, 0, 0
165, 1, 1636426942266, 1636426942358, 92, 0, 92, 0, 0, 0
164, 1, 1636426942390, 1636426942481, 91, 0, 91, 0, 0, 0
166, 1, 1636426942509, 1636426942597, 88, 0, 88, 0, 0, 0
167, 1, 1636426942762, 1636426942854, 92, 0, 92, 0, 0, 0
168, 1, 1636426942865, 1636426942957, 92, 1, 91, 0, 0, 0
169, 1, 1636426943001, 1636426943094, 93, 1, 92, 0, 0, 0
170, 1, 1636426943310, 1636426943402, 92, 0, 92, 0, 0, 0
171, 1, 1636426943390, 1636426943477, 87, 0, 87, 0, 0, 0
172, 1, 1636426943413, 1636426943505, 92, 1, 91, 0, 0, 0
173, 1, 1636426943457, 1636426943546, 89, 1, 88, 1, 0, 1
174, 1, 1636426943978, 1636426944070, 92, 0, 92, 0, 0, 0
175, 1, 1636426944013, 1636426944102, 89, 0, 89, 0, 0, 0
176, 1, 1636426944057, 1636426944150, 93, 1, 92, 0, 1, 1
177, 1, 1636426944434, 1636426944526, 92, 0, 92, 0, 0, 0
178, 1, 1636426944481, 1636426944574, 93, 1, 92, 0, 0, 0
179, 1, 1636426944661, 1636426944757, 96, 1, 95, 0, 0, 0
180, 1, 1636426944950, 1636426945042, 92, 0, 92, 0, 0, 0
181, 1, 1636426945117, 1636426945210, 93, 1, 92, 0, 0, 0
182, 1, 1636426945246, 1636426945338, 92, 0, 92, 0, 0, 0
183, 1, 1636426945614, 1636426945706, 92, 0, 92, 0, 0, 0
185, 1, 1636426946002, 1636426946097, 95, 0, 95, 0, 0, 0
184, 1, 1636426946069, 1636426946162, 93, 1, 92, 1, 0, 1
186, 1, 1636426946498, 1636426946590, 92, 0, 92, 0, 0, 0
187, 1, 1636426946697, 1636426946785, 88, 1, 87, 0, 1, 1
188, 1, 1636426946734, 1636426946826, 92, 0, 92, 0, 0, 0
189, 1, 1636426947066, 1636426947153, 87, 0, 87, 0, 0, 0
191, 1, 1636426947105, 1636426947197, 92, 1, 91, 1, 0, 1
190, 1, 1636426947145, 1636426947238, 93, 1, 92, 0, 0, 0
192, 1, 1636426947221, 1636426947313, 92, 1, 91, 0, 0, 0
193, 1, 1636426947682, 1636426947774, 92, 0, 92, 0, 0, 0
194, 1, 1636426947718, 1636426947810, 92, 0, 92, 0, 0, 0
195, 1, 1636426947841, 1636426947934, 93, 1, 92, 0, 0, 0
196, 1, 1636426947846, 1636426947938, 92, 0, 92, 0, 0, 0
197, 1, 1636426948174, 1636426948266, 92, 0, 92, 0, 0, 0
198, 1, 1636426948302, 1636426948394, 92, 0, 92, 0, 0, 0
199, 1, 1636426948453, 1636426948545, 92, 1, 91, 0, 0, 0
200, 1, 1636426948754, 1636426948846, 92, 0, 92, 0, 0, 0
201, 1, 1636426948913, 1636426949006, 93, 1, 92, 0, 0, 0
202, 1, 1636426949093, 1636426949186, 93, 1, 92, 0, 0, 0
203, 1, 1636426949521, 1636426949610, 89, 0, 89, 0, 0, 0
205, 1, 1636426949790, 1636426949882, 92, 0, 92, 0, 0, 0
204, 1, 1636426949974, 1636426950066, 92, 0, 92, 0, 0, 0
206, 1, 1636426950286, 1636426950378, 92, 0, 92, 0, 0, 0
207, 1, 1636426950466, 1636426950558, 92, 0, 92, 0, 0, 0
208, 1, 1636426950566, 1636426950658, 92, 0, 92, 0, 0, 0
211, 1, 1636426950941, 1636426951030, 89, 0, 89, 0, 0, 0
210, 1, 1636426950949, 1636426951037, 88, 0, 88, 0, 0, 0
209, 1, 1636426951026, 1636426951118, 92, 0, 92, 0, 0, 0
214, 1, 1636426951514, 1636426951606, 92, 0, 92, 0, 0, 0
215, 1, 1636426951613, 1636426951706, 93, 1, 92, 0, 0, 0
217, 1, 1636426951977, 1636426952070, 93, 1, 92, 0, 0, 0
218, 1, 1636426952166, 1636426952258, 92, 0, 92, 0, 0, 0
220, 1, 1636426952626, 1636426952718, 92, 0, 92, 0, 0, 0
222, 1, 1636426953146, 1636426953238, 92, 0, 92, 0, 0, 0
223, 1, 1636426953222, 1636426953314, 92, 0, 92, 0, 0, 0
224, 1, 1636426953678, 1636426953770, 92, 0, 92, 0, 0, 0
227, 1, 1636426954258, 1636426954349, 91, 0, 91, 0, 0, 0
228, 1, 1636426954270, 1636426954362, 92, 0, 92, 0, 0, 0
229, 1, 1636426954726, 1636426954818, 92, 0, 92, 0, 0, 0
231, 1, 1636426955001, 1636426955094, 93, 1, 92, 0, 0, 0
232, 1, 1636426955314, 1636426955406, 92, 0, 92, 0, 0, 0
235, 1, 1636426955866, 1636426955958, 92, 0, 92, 0, 0, 0
236, 1, 1636426956326, 1636426956418, 92, 0, 92, 0, 0, 0
237, 1, 1636426956930, 1636426957022, 92, 1, 91, 0, 0, 0
238, 1, 1636426957034, 1636426957126, 92, 0, 92, 0, 0, 0
239, 1, 1636426957482, 1636426957574, 92, 0, 92, 0, 0, 0
240, 1, 1636426958094, 1636426958186, 92, 0, 92, 0, 0, 0
242, 1, 1636426958666, 1636426958758, 92, 0, 92, 0, 0, 0
243, 1, 1636426958786, 1636426958878, 92, 0, 92, 0, 0, 0
244, 1, 1636426959121, 1636426959209, 88, 0, 88, 0, 0, 0
245, 1, 1636426959674, 1636426959765, 91, 0, 91, 0, 0, 0
246, 1, 1636426960154, 1636426960246, 92, 0, 92, 0, 0, 0
247, 1, 1636426961138, 1636426961230, 92, 0, 92, 0, 0, 0
248, 1, 1636426961221, 1636426961314, 93, 1, 92, 0, 0, 0
249, 1, 1636426961674, 1636426961765, 91, 0, 91, 0, 0, 0
252, 1, 1636426962094, 1636426962185, 91, 0, 91, 0, 0, 0
254, 1, 1636426962706, 1636426962798, 92, 0, 92, 0, 0, 0
255, 1, 1636426962850, 1636426962942, 92, 0, 92, 0, 0, 0
257, 1, 1636426963286, 1636426963377, 91, 0, 91, 0, 0, 0
260, 1, 1636426964094, 1636426964186, 92, 0, 92, 0, 0, 0
262, 1, 1636426964550, 1636426964641, 91, 0, 91, 0, 0, 0
263, 1, 1636426964986, 1636426965078, 92, 0, 92, 0, 0, 0
264, 1, 1636426965166, 1636426965257, 91, 0, 91, 0, 0, 0
265, 1, 1636426965261, 1636426965366, 105, 0, 105, 0, 0, 0
241, 1, 1636426965718, 1636426965809, 91, 0, 91, 0, 0, 0
266, 1, 1636426965726, 1636426965818, 92, 0, 92, 0, 0, 0
267, 1, 1636426965934, 1636426966026, 92, 0, 92, 0, 0, 0
269, 1, 1636426966166, 1636426966258, 92, 0, 92, 0, 0, 0
268, 1, 1636426966394, 1636426966486, 92, 0, 92, 0, 0, 0
271, 1, 1636426966710, 1636426966801, 91, 0, 91, 0, 0, 0
272, 1, 1636426966778, 1636426966870, 92, 0, 92, 0, 0, 0
270, 1, 1636426966842, 1636426966934, 92, 0, 92, 0, 0, 0
273, 1, 1636426967521, 1636426967614, 93, 1, 92, 0, 0, 0
274, 1, 1636426968190, 1636426968282, 92, 0, 92, 0, 0, 0
275, 1, 1636426968718, 1636426968809, 91, 0, 91, 0, 0, 0
276, 1, 1636426968770, 1636426968862, 92, 0, 92, 0, 0, 0
277, 1, 1636426969397, 1636426969489, 92, 1, 91, 0, 0, 0
278, 1, 1636426969430, 1636426969522, 92, 0, 92, 0, 0, 0
279, 1, 1636426969886, 1636426969978, 92, 0, 92, 0, 0, 0
280, 1, 1636426970046, 1636426970138, 92, 1, 91, 0, 1, 1
281, 1, 1636426970126, 1636426970218, 92, 0, 92, 0, 0, 0
283, 1, 1636426970489, 1636426970581, 92, 1, 91, 0, 1, 1
282, 1, 1636426970505, 1636426970597, 92, 1, 91, 0, 0, 0
285, 1, 1636426970626, 1636426970717, 91, 0, 91, 0, 0, 0
284, 1, 1636426970954, 1636426971046, 92, 0, 92, 0, 0, 0
286, 1, 1636426971361, 1636426971454, 93, 1, 92, 0, 1, 1
287, 1, 1636426972154, 1636426972246, 92, 0, 92, 0, 0, 0
291, 1, 1636426972678, 1636426972769, 91, 0, 91, 0, 0, 0
292, 1, 1636426973065, 1636426973170, 105, 0, 105, 0, 0, 0
294, 1, 1636426973358, 1636426973450, 92, 0, 92, 0, 0, 0
296, 1, 1636426973642, 1636426973738, 96, 0, 96, 0, 0, 0
261, 1, 1636426973869, 1636426973961, 92, 1, 91, 0, 0, 0
298, 1, 1636426974006, 1636426974097, 91, 0, 91, 0, 0, 0
299, 1, 1636426974057, 1636426974149, 92, 1, 91, 0, 0, 0
297, 1, 1636426974093, 1636426974185, 92, 1, 91, 0, 1, 1
302, 1, 1636426974473, 1636426974561, 88, 0, 88, 0, 0, 0
303, 1, 1636426974517, 1636426974605, 88, 0, 88, 0, 0, 0
305, 1, 1636426974785, 1636426974878, 93, 1, 92, 0, 0, 0
301, 1, 1636426974918, 1636426975010, 92, 0, 92, 0, 0, 0
306, 1, 1636426975166, 1636426975258, 92, 0, 92, 0, 0, 0
307, 1, 1636426975998, 1636426976090, 92, 0, 92, 0, 0, 0
308, 1, 1636426976534, 1636426976626, 92, 0, 92, 0, 0, 0
309, 1, 1636426977178, 1636426977269, 91, 0, 91, 0, 0, 0
310, 1, 1636426977218, 1636426977309, 91, 0, 91, 0, 0, 0
311, 1, 1636426977350, 1636426977442, 92, 0, 92, 0, 0, 0
312, 1, 1636426977806, 1636426977902, 96, 0, 96, 0, 0, 0
313, 1, 1636426977930, 1636426978022, 92, 0, 92, 0, 0, 0
316, 1, 1636426978322, 1636426978414, 92, 0, 92, 0, 0, 0
315, 1, 1636426978386, 1636426978477, 91, 0, 91, 0, 0, 0
317, 1, 1636426978778, 1636426978870, 92, 0, 92, 0, 0, 0
318, 1, 1636426978825, 1636426978917, 92, 0, 92, 0, 0, 0
314, 1, 1636426978838, 1636426978930, 92, 0, 92, 0, 0, 0
319, 1, 1636426979434, 1636426979526, 92, 0, 92, 0, 0, 0
320, 1, 1636426980270, 1636426980362, 92, 0, 92, 0, 0, 0
321, 1, 1636426980802, 1636426980894, 92, 0, 92, 0, 0, 0
322, 1, 1636426980953, 1636426981046, 93, 1, 92, 0, 0, 0
323, 1, 1636426981277, 1636426981370, 93, 1, 92, 0, 0, 0
324, 1, 1636426981486, 1636426981582, 96, 0, 96, 0, 0, 0
325, 1, 1636426981733, 1636426981826, 93, 1, 92, 0, 0, 0
326, 1, 1636426982170, 1636426982261, 91, 0, 91, 0, 0, 0
329, 1, 1636426982610, 1636426982702, 92, 0, 92, 0, 0, 0
330, 1, 1636426982693, 1636426982786, 93, 1, 92, 1, 0, 1
331, 1, 1636426982869, 1636426982962, 93, 1, 92, 1, 0, 1
333, 1, 1636426983093, 1636426983182, 89, 0, 89, 0, 0, 0
336, 1, 1636426983698, 1636426983790, 92, 0, 92, 0, 0, 0
304, 1, 1636426984221, 1636426984314, 93, 1, 92, 0, 0, 0
338, 1, 1636426984525, 1636426984618, 93, 1, 92, 0, 0, 0
341, 1, 1636426984954, 1636426985046, 92, 0, 92, 0, 0, 0
342, 1, 1636426985061, 1636426985153, 92, 1, 91, 0, 0, 0
344, 1, 1636426985742, 1636426985834, 92, 0, 92, 0, 0, 0
346, 1, 1636426986334, 1636426986425, 91, 0, 91, 0, 0, 0
347, 1, 1636426986429, 1636426986518, 89, 0, 89, 0, 0, 0
348, 1, 1636426986605, 1636426986702, 97, 1, 96, 0, 1, 1
353, 1, 1636426988870, 1636426988958, 88, 0, 88, 0, 0, 0
356, 1, 1636426990258, 1636426990350, 92, 0, 92, 0, 0, 0
358, 1, 1636426990565, 1636426990658, 93, 1, 92, 1, 0, 1
359, 1, 1636426992870, 1636426992962, 92, 0, 92, 0, 0, 0
365, 1, 1636426994218, 1636426994310, 92, 0, 92, 0, 0, 0
367, 1, 1636426994557, 1636426994650, 93, 1, 92, 0, 0, 0
340, 1, 1636426994562, 1636426994653, 91, 0, 91, 0, 0, 0
345, 1, 1636426995541, 1636426995634, 93, 1, 92, 0, 0, 0
372, 1, 1636426996893, 1636426996989, 96, 1, 95, 0, 1, 1
374, 1, 1636426997414, 1636426997505, 91, 1, 90, 0, 1, 1
373, 1, 1636426997414, 1636426997506, 92, 1, 91, 0, 1, 1
375, 1, 1636426998074, 1636426998166, 92, 0, 92, 0, 0, 0
376, 1, 1636426998314, 1636426998406, 92, 0, 92, 0, 0, 0
377, 1, 1636426998562, 1636426998654, 92, 0, 92, 0, 0, 0
378, 1, 1636426998954, 1636426999046, 92, 0, 92, 0, 0, 0
379, 1, 1636426999498, 1636426999590, 92, 0, 92, 0, 0, 0
357, 1, 1636426999826, 1636426999917, 91, 0, 91, 0, 0, 0
380, 1, 1636427000169, 1636427000261, 92, 1, 91, 1, 0, 1
381, 1, 1636427000626, 1636427000718, 92, 0, 92, 0, 0, 0
382, 1, 1636427001029, 1636427001122, 93, 1, 92, 0, 1, 1
383, 1, 1636427001618, 1636427001709, 91, 0, 91, 0, 0, 0
384, 1, 1636427001649, 1636427001741, 92, 1, 91, 0, 1, 1
385, 1, 1636427002074, 1636427002166, 92, 0, 92, 0, 0, 0
386, 1, 1636427002481, 1636427002574, 93, 1, 92, 0, 0, 0
387, 1, 1636427002514, 1636427002606, 92, 0, 92, 0, 0, 0
388, 1, 1636427002874, 1636427002966, 92, 0, 92, 0, 0, 0
391, 1, 1636427003406, 1636427003586, 180, 0, 180, 0, 0, 0
393, 1, 1636427004062, 1636427004154, 92, 0, 92, 0, 0, 0
395, 1, 1636427004354, 1636427004446, 92, 0, 92, 0, 0, 0
394, 1, 1636427004521, 1636427004613, 92, 1, 91, 0, 0, 0
398, 1, 1636427004709, 1636427004801, 92, 1, 91, 0, 0, 0
396, 1, 1636427004809, 1636427004902, 93, 1, 92, 0, 0, 0
369, 1, 1636427004909, 1636427005002, 93, 1, 92, 0, 0, 0
400, 1, 1636427005522, 1636427005614, 92, 0, 92, 0, 0, 0
402, 1, 1636427005610, 1636427005701, 91, 0, 91, 0, 0, 0
371, 1, 1636427005894, 1636427005986, 92, 0, 92, 0, 0, 0
403, 1, 1636427005973, 1636427006065, 92, 1, 91, 0, 0, 0
404, 1, 1636427006198, 1636427006290, 92, 0, 92, 0, 0, 0
407, 1, 1636427006778, 1636427006870, 92, 0, 92, 0, 0, 0
408, 1, 1636427006798, 1636427006890, 92, 0, 92, 0, 0, 0
409, 1, 1636427007302, 1636427007393, 91, 0, 91, 0, 0, 0
410, 1, 1636427008174, 1636427008265, 91, 0, 91, 0, 0, 0
412, 1, 1636427008358, 1636427008450, 92, 0, 92, 0, 0, 0
414, 1, 1636427008474, 1636427008566, 92, 0, 92, 0, 0, 0
411, 1, 1636427008618, 1636427008709, 91, 0, 91, 0, 0, 0
413, 1, 1636427008826, 1636427008918, 92, 0, 92, 0, 0, 0
415, 1, 1636427009405, 1636427009498, 93, 1, 92, 1, 0, 1
417, 1, 1636427009534, 1636427009626, 92, 0, 92, 0, 0, 0
416, 1, 1636427009861, 1636427009954, 93, 1, 92, 0, 0, 0
418, 1, 1636427009949, 1636427010042, 93, 1, 92, 0, 1, 1
419, 1, 1636427010505, 1636427010598, 93, 1, 92, 0, 0, 0
420, 1, 1636427010662, 1636427010753, 91, 0, 91, 0, 0, 0
421, 1, 1636427011190, 1636427011282, 92, 0, 92, 0, 0, 0
422, 1, 1636427011986, 1636427012078, 92, 0, 92, 0, 0, 0
423, 1, 1636427012054, 1636427012150, 96, 0, 96, 0, 0, 0
424, 1, 1636427012438, 1636427012530, 92, 0, 92, 0, 0, 0
425, 1, 1636427012514, 1636427012606, 92, 0, 92, 0, 0, 0
426, 1, 1636427012678, 1636427012770, 92, 0, 92, 0, 0, 0
427, 1, 1636427013602, 1636427013694, 92, 0, 92, 0, 0, 0
428, 1, 1636427013657, 1636427013750, 93, 1, 92, 0, 0, 0
431, 1, 1636427013802, 1636427013937, 135, 0, 135, 0, 0, 0
430, 1, 1636427014058, 1636427014150, 92, 0, 92, 0, 0, 0
429, 1, 1636427014109, 1636427014202, 93, 1, 92, 0, 1, 1
432, 1, 1636427014166, 1636427014257, 91, 0, 91, 0, 0, 0
433, 1, 1636427014354, 1636427014446, 92, 0, 92, 0, 0, 0
434, 1, 1636427014958, 1636427015050, 92, 0, 92, 0, 0, 0
401, 1, 1636427015253, 1636427015342, 89, 0, 89, 0, 0, 0
435, 1, 1636427015409, 1636427015502, 93, 1, 92, 1, 0, 1
440, 1, 1636427015958, 1636427016050, 92, 0, 92, 0, 0, 0
406, 1, 1636427016249, 1636427016337, 88, 1, 87, 0, 0, 0
442, 1, 1636427016385, 1636427016477, 92, 1, 91, 1, 0, 1
441, 1, 1636427016410, 1636427016501, 91, 0, 91, 0, 0, 0
443, 1, 1636427016602, 1636427016693, 91, 0, 91, 0, 0, 0
445, 1, 1636427016750, 1636427016842, 92, 0, 92, 0, 0, 0
444, 1, 1636427016842, 1636427016934, 92, 0, 92, 0, 0, 0
446, 1, 1636427017057, 1636427017150, 93, 1, 92, 0, 0, 0
448, 1, 1636427017742, 1636427017834, 92, 0, 92, 0, 0, 0
450, 1, 1636427017841, 1636427017934, 93, 1, 92, 0, 0, 0
451, 1, 1636427018197, 1636427018290, 93, 1, 92, 1, 0, 1
452, 1, 1636427018197, 1636427018290, 93, 1, 92, 0, 1, 1
453, 1, 1636427018241, 1636427018329, 88, 0, 88, 0, 0, 0
454, 1, 1636427019098, 1636427019189, 91, 0, 91, 0, 0, 0
455, 1, 1636427019558, 1636427019650, 92, 0, 92, 0, 0, 0
456, 1, 1636427020277, 1636427020365, 88, 0, 88, 0, 0, 0
458, 1, 1636427020502, 1636427020594, 92, 0, 92, 0, 0, 0
460, 1, 1636427020594, 1636427020686, 92, 0, 92, 0, 0, 0
457, 1, 1636427020726, 1636427020817, 91, 0, 91, 0, 0, 0
461, 1, 1636427020950, 1636427021042, 92, 0, 92, 0, 0, 0
463, 1, 1636427021542, 1636427021633, 91, 0, 91, 0, 0, 0
466, 1, 1636427021930, 1636427022022, 92, 0, 92, 0, 0, 0
464, 1, 1636427022002, 1636427022094, 92, 0, 92, 0, 0, 0
467, 1, 1636427022078, 1636427022170, 92, 0, 92, 0, 0, 0
468, 1, 1636427022866, 1636427022958, 92, 0, 92, 0, 0, 0
469, 1, 1636427023330, 1636427023422, 92, 0, 92, 0, 0, 0
470, 1, 1636427024134, 1636427024226, 92, 0, 92, 0, 0, 0
472, 1, 1636427024302, 1636427024394, 92, 0, 92, 0, 0, 0
473, 1, 1636427024538, 1636427024629, 91, 0, 91, 0, 0, 0
471, 1, 1636427024589, 1636427024681, 92, 1, 91, 0, 0, 0
474, 1, 1636427024762, 1636427024854, 92, 0, 92, 0, 0, 0
478, 1, 1636427025742, 1636427025834, 92, 0, 92, 0, 0, 0
480, 1, 1636427026034, 1636427026126, 92, 0, 92, 0, 0, 0
481, 1, 1636427026101, 1636427026194, 93, 1, 92, 1, 0, 1
477, 1, 1636427026193, 1636427026286, 93, 1, 92, 0, 0, 0
483, 1, 1636427027062, 1636427027154, 92, 0, 92, 0, 0, 0
484, 1, 1636427027517, 1636427027645, 128, 1, 127, 0, 1, 1
485, 1, 1636427027953, 1636427028046, 93, 1, 92, 0, 0, 0
487, 1, 1636427028086, 1636427028178, 92, 0, 92, 0, 0, 0
489, 1, 1636427028330, 1636427028422, 92, 0, 92, 0, 0, 0
486, 1, 1636427028414, 1636427028505, 91, 0, 91, 0, 0, 0
490, 1, 1636427028490, 1636427028581, 91, 0, 91, 0, 0, 0
488, 1, 1636427028537, 1636427028625, 88, 0, 88, 0, 0, 0
491, 1, 1636427028942, 1636427029034, 92, 0, 92, 0, 0, 0
492, 1, 1636427029718, 1636427029810, 92, 0, 92, 0, 0, 0
493, 1, 1636427030002, 1636427030094, 92, 0, 92, 0, 0, 0
494, 1, 1636427030025, 1636427030118, 93, 1, 92, 0, 0, 0
495, 1, 1636427030501, 1636427030594, 93, 1, 92, 0, 1, 1
496, 1, 1636427030902, 1636427030993, 91, 0, 91, 0, 0, 0
465, 1, 1636427031034, 1636427031126, 92, 0, 92, 0, 0, 0
498, 1, 1636427031378, 1636427031470, 92, 0, 92, 0, 0, 0
497, 1, 1636427031389, 1636427031485, 96, 1, 95, 0, 0, 0
499, 1, 1636427031826, 1636427031918, 92, 0, 92, 0, 0, 0
500, 1, 1636427031841, 1636427031930, 89, 1, 88, 0, 1, 1
503, 1, 1636427032262, 1636427032353, 91, 0, 91, 0, 0, 0
502, 1, 1636427032298, 1636427032390, 92, 0, 92, 0, 0, 0
505, 1, 1636427032490, 1636427032582, 92, 0, 92, 0, 0, 0
504, 1, 1636427032714, 1636427032805, 91, 0, 91, 0, 0, 0
501, 1, 1636427032750, 1636427032842, 92, 0, 92, 0, 0, 0
506, 1, 1636427032825, 1636427032918, 93, 1, 92, 0, 0, 0
507, 1, 1636427033286, 1636427033377, 91, 0, 91, 0, 0, 0
508, 1, 1636427033874, 1636427033966, 92, 0, 92, 0, 0, 0
509, 1, 1636427033934, 1636427034025, 91, 0, 91, 0, 0, 0
510, 1, 1636427033941, 1636427034037, 96, 1, 95, 1, 0, 1
511, 1, 1636427034398, 1636427034490, 92, 0, 92, 0, 0, 0
512, 1, 1636427034810, 1636427034902, 92, 0, 92, 0, 0, 0
513, 1, 1636427035286, 1636427035378, 92, 0, 92, 0, 0, 0
514, 1, 1636427035297, 1636427035385, 88, 0, 88, 0, 0, 0
515, 1, 1636427035734, 1636427035825, 91, 0, 91, 0, 0, 0
516, 1, 1636427035821, 1636427035914, 93, 0, 93, 0, 0, 0
482, 1, 1636427035954, 1636427036045, 91, 0, 91, 0, 0, 0
519, 1, 1636427036166, 1636427036258, 92, 0, 92, 0, 0, 0
520, 1, 1636427036273, 1636427036365, 92, 1, 91, 1, 0, 1
523, 1, 1636427036286, 1636427036378, 92, 0, 92, 0, 0, 0
522, 1, 1636427036622, 1636427036713, 91, 0, 91, 0, 0, 0
524, 1, 1636427036725, 1636427036814, 89, 0, 89, 0, 0, 0
526, 1, 1636427036738, 1636427036830, 92, 0, 92, 0, 0, 0
527, 1, 1636427037190, 1636427037282, 92, 0, 92, 0, 0, 0
528, 1, 1636427037673, 1636427037766, 93, 1, 92, 0, 0, 0
529, 1, 1636427037790, 1636427037882, 92, 0, 92, 0, 0, 0
531, 1, 1636427038117, 1636427038205, 88, 0, 88, 0, 0, 0
530, 1, 1636427038245, 1636427038338, 93, 0, 93, 0, 0, 0
532, 1, 1636427038810, 1636427038902, 92, 0, 92, 0, 0, 0
533, 1, 1636427039062, 1636427039154, 92, 0, 92, 0, 0, 0
535, 1, 1636427039298, 1636427039390, 92, 0, 92, 0, 0, 0
534, 1, 1636427039513, 1636427039606, 93, 1, 92, 0, 0, 0
536, 1, 1636427039754, 1636427039846, 92, 0, 92, 0, 0, 0
538, 1, 1636427040042, 1636427040133, 91, 0, 91, 0, 0, 0
537, 1, 1636427040206, 1636427040298, 92, 0, 92, 0, 0, 0
540, 1, 1636427040326, 1636427040418, 92, 0, 92, 0, 0, 0
539, 1, 1636427040501, 1636427040593, 92, 1, 91, 0, 0, 0
542, 1, 1636427040585, 1636427040678, 93, 1, 92, 0, 1, 1
541, 1, 1636427040661, 1636427040750, 89, 0, 89, 0, 0, 0
543, 1, 1636427041042, 1636427041134, 92, 0, 92, 0, 0, 0
544, 1, 1636427041713, 1636427041805, 92, 1, 91, 0, 0, 0
545, 1, 1636427041841, 1636427041934, 93, 0, 93, 0, 0, 0
546, 1, 1636427041850, 1636427041942, 92, 0, 92, 0, 0, 0
547, 1, 1636427042310, 1636427042402, 92, 0, 92, 0, 0, 0
548, 1, 1636427042694, 1636427042785, 91, 0, 91, 0, 0, 0
549, 1, 1636427043118, 1636427043210, 92, 0, 92, 0, 0, 0
550, 1, 1636427043182, 1636427043274, 92, 0, 92, 0, 0, 0
552, 1, 1636427043574, 1636427043666, 92, 0, 92, 0, 0, 0
551, 1, 1636427043634, 1636427043726, 92, 0, 92, 0, 0, 0
553, 1, 1636427044078, 1636427044170, 92, 0, 92, 0, 0, 0
555, 1, 1636427044134, 1636427044225, 91, 0, 91, 0, 0, 0
556, 1, 1636427044249, 1636427044341, 92, 1, 91, 1, 0, 1
554, 1, 1636427044534, 1636427044625, 91, 0, 91, 0, 0, 0
557, 1, 1636427044706, 1636427044798, 92, 0, 92, 0, 0, 0
558, 1, 1636427044805, 1636427044898, 93, 1, 92, 0, 1, 1
559, 1, 1636427045257, 1636427045350, 93, 1, 92, 0, 1, 1
560, 1, 1636427045598, 1636427045690, 92, 0, 92, 0, 0, 0
561, 1, 1636427045598, 1636427045690, 92, 0, 92, 0, 0, 0
562, 1, 1636427046049, 1636427046174, 125, 1, 124, 0, 1, 1
525, 1, 1636427046305, 1636427046402, 97, 1, 96, 1, 0, 1
564, 1, 1636427046442, 1636427046530, 88, 0, 88, 0, 0, 0
565, 1, 1636427046530, 1636427046622, 92, 0, 92, 0, 0, 0
567, 1, 1636427046826, 1636427046914, 88, 0, 88, 0, 0, 0
569, 1, 1636427047278, 1636427047369, 91, 0, 91, 0, 0, 0
570, 1, 1636427047362, 1636427047453, 91, 0, 91, 0, 0, 0
572, 1, 1636427047734, 1636427047826, 92, 0, 92, 0, 0, 0
571, 1, 1636427047817, 1636427047910, 93, 1, 92, 1, 0, 1
573, 1, 1636427047981, 1636427048073, 92, 1, 91, 1, 0, 1
574, 1, 1636427048274, 1636427048373, 99, 0, 99, 0, 0, 0
575, 1, 1636427048298, 1636427048389, 91, 0, 91, 0, 0, 0
576, 1, 1636427048746, 1636427048838, 92, 0, 92, 0, 0, 0
577, 1, 1636427048746, 1636427048838, 92, 1, 91, 0, 0, 0
578, 1, 1636427048962, 1636427049054, 92, 0, 92, 0, 0, 0
579, 1, 1636427049417, 1636427049510, 93, 0, 93, 0, 0, 0
580, 1, 1636427049473, 1636427049566, 93, 1, 92, 1, 0, 1
581, 1, 1636427049741, 1636427049833, 92, 1, 91, 1, 0, 1
582, 1, 1636427049766, 1636427049857, 91, 0, 91, 0, 0, 0
583, 1, 1636427050122, 1636427050214, 92, 0, 92, 0, 0, 0
584, 1, 1636427050429, 1636427050522, 93, 1, 92, 0, 0, 0
585, 1, 1636427050846, 1636427050938, 92, 0, 92, 0, 0, 0
586, 1, 1636427051086, 1636427051177, 91, 0, 91, 0, 0, 0
587, 1, 1636427051502, 1636427051594, 92, 0, 92, 0, 0, 0
588, 1, 1636427051621, 1636427051714, 93, 1, 92, 0, 0, 0
589, 1, 1636427051953, 1636427052042, 89, 0, 89, 0, 0, 0
590, 1, 1636427051978, 1636427052073, 95, 0, 95, 0, 0, 0
591, 1, 1636427051997, 1636427052090, 93, 1, 92, 0, 0, 0
592, 1, 1636427052398, 1636427052490, 92, 0, 92, 0, 0, 0
593, 1, 1636427052434, 1636427052526, 92, 0, 92, 0, 0, 0
595, 1, 1636427052686, 1636427052782, 96, 0, 96, 0, 0, 0
594, 1, 1636427052854, 1636427052946, 92, 0, 92, 0, 0, 0
596, 1, 1636427053150, 1636427053242, 92, 0, 92, 0, 0, 0
597, 1, 1636427053485, 1636427053574, 89, 0, 89, 0, 0, 0
598, 1, 1636427053733, 1636427053826, 93, 1, 92, 0, 0, 0
599, 1, 1636427053909, 1636427054002, 93, 1, 92, 1, 0, 1
600, 1, 1636427054126, 1636427054218, 92, 0, 92, 0, 0, 0
601, 1, 1636427054210, 1636427054302, 92, 0, 92, 0, 0, 0
602, 1, 1636427054641, 1636427054734, 93, 1, 92, 0, 1, 1
603, 1, 1636427054866, 1636427054958, 92, 0, 92, 0, 0, 0
604, 1, 1636427055270, 1636427055361, 91, 0, 91, 0, 0, 0
605, 1, 1636427055401, 1636427055494, 93, 1, 92, 0, 0, 0
606, 1, 1636427055750, 1636427055842, 92, 0, 92, 0, 0, 0
607, 1, 1636427056174, 1636427056310, 136, 0, 136, 0, 0, 0
608, 1, 1636427056229, 1636427056322, 93, 1, 92, 1, 0, 1
609, 1, 1636427056309, 1636427056402, 93, 1, 92, 0, 0, 0
611, 1, 1636427056430, 1636427056521, 91, 0, 91, 0, 0, 0
568, 1, 1636427056653, 1636427056745, 92, 1, 91, 0, 1, 1
612, 1, 1636427056669, 1636427056765, 96, 1, 95, 1, 0, 1
610, 1, 1636427056682, 1636427056773, 91, 0, 91, 0, 0, 0
613, 1, 1636427056889, 1636427056978, 89, 0, 89, 0, 0, 0
614, 1, 1636427057242, 1636427057333, 91, 0, 91, 0, 0, 0
617, 1, 1636427057441, 1636427057533, 92, 0, 92, 0, 0, 0
618, 1, 1636427057497, 1636427057586, 89, 0, 89, 0, 0, 0
615, 1, 1636427057693, 1636427057789, 96, 1, 95, 0, 1, 1
619, 1, 1636427057922, 1636427058013, 91, 0, 91, 0, 0, 0
620, 1, 1636427057978, 1636427058069, 91, 0, 91, 0, 0, 0
621, 1, 1636427058085, 1636427058178, 93, 1, 92, 0, 0, 0
616, 1, 1636427058150, 1636427058242, 92, 0, 92, 0, 0, 0
622, 1, 1636427058586, 1636427058678, 92, 0, 92, 0, 0, 0
623, 1, 1636427058794, 1636427058886, 92, 0, 92, 0, 0, 0
624, 1, 1636427059118, 1636427059210, 92, 0, 92, 0, 0, 0
625, 1, 1636427059462, 1636427059554, 92, 0, 92, 0, 0, 0
626, 1, 1636427059946, 1636427060038, 92, 0, 92, 0, 0, 0
627, 1, 1636427060137, 1636427060230, 93, 1, 92, 0, 0, 0
628, 1, 1636427060353, 1636427060445, 92, 1, 91, 0, 0, 0
629, 1, 1636427060421, 1636427060513, 92, 1, 91, 1, 0, 1
630, 1, 1636427060434, 1636427060525, 91, 0, 91, 0, 0, 0
632, 1, 1636427060737, 1636427060830, 93, 1, 92, 1, 0, 1
631, 1, 1636427060877, 1636427060970, 93, 1, 92, 0, 1, 1
633, 1, 1636427060889, 1636427060981, 92, 1, 91, 0, 0, 0
634, 1, 1636427061049, 1636427061141, 92, 1, 91, 0, 1, 1
636, 1, 1636427061117, 1636427061210, 93, 1, 92, 0, 1, 1
638, 1, 1636427061514, 1636427061606, 92, 0, 92, 0, 0, 0
639, 1, 1636427061810, 1636427061902, 92, 0, 92, 0, 0, 0
640, 1, 1636427061917, 1636427062010, 93, 1, 92, 1, 0, 1
641, 1, 1636427062013, 1636427062106, 93, 0, 93, 0, 0, 0
642, 1, 1636427062582, 1636427062674, 92, 0, 92, 0, 0, 0
644, 1, 1636427063109, 1636427063198, 89, 0, 89, 0, 0, 0
643, 1, 1636427063109, 1636427063206, 97, 0, 97, 0, 0, 0
645, 1, 1636427063781, 1636427063874, 93, 0, 93, 0, 0, 0
646, 1, 1636427063810, 1636427063902, 92, 0, 92, 0, 0, 0
647, 1, 1636427064229, 1636427064321, 92, 1, 91, 1, 0, 1
648, 1, 1636427064233, 1636427064325, 92, 1, 91, 1, 0, 1
649, 1, 1636427064270, 1636427064362, 92, 0, 92, 0, 0, 0
650, 1, 1636427064409, 1636427064501, 92, 1, 91, 0, 1, 1
651, 1, 1636427064750, 1636427064841, 91, 0, 91, 0, 0, 0
652, 1, 1636427064801, 1636427064894, 93, 1, 92, 0, 0, 0
654, 1, 1636427064857, 1636427064945, 88, 0, 88, 0, 0, 0
655, 1, 1636427064893, 1636427064986, 93, 1, 92, 0, 0, 0
653, 1, 1636427065205, 1636427065298, 93, 1, 92, 0, 1, 1
656, 1, 1636427065398, 1636427065490, 92, 0, 92, 0, 0, 0
657, 1, 1636427065810, 1636427065902, 92, 0, 92, 0, 0, 0
658, 1, 1636427066106, 1636427066198, 92, 0, 92, 0, 0, 0
659, 1, 1636427066238, 1636427066330, 92, 0, 92, 0, 0, 0
660, 1, 1636427066466, 1636427066557, 91, 0, 91, 0, 0, 0
661, 1, 1636427066914, 1636427067005, 91, 0, 91, 0, 0, 0
662, 1, 1636427067002, 1636427067094, 92, 0, 92, 0, 0, 0
663, 1, 1636427067554, 1636427067649, 95, 0, 95, 0, 0, 0
664, 1, 1636427067694, 1636427067785, 91, 0, 91, 0, 0, 0
665, 1, 1636427067930, 1636427068022, 92, 0, 92, 0, 0, 0
666, 1, 1636427068090, 1636427068182, 92, 0, 92, 0, 0, 0
667, 1, 1636427068178, 1636427068269, 91, 0, 91, 0, 0, 0
668, 1, 1636427068301, 1636427068394, 93, 1, 92, 0, 1, 1
669, 1, 1636427068626, 1636427068718, 92, 0, 92, 0, 0, 0
670, 1, 1636427068646, 1636427068737, 91, 0, 91, 0, 0, 0
671, 1, 1636427068649, 1636427068746, 97, 1, 96, 0, 1, 1
673, 1, 1636427069094, 1636427069185, 91, 0, 91, 0, 0, 0
672, 1, 1636427069102, 1636427069194, 92, 0, 92, 0, 0, 0
674, 1, 1636427069161, 1636427069250, 89, 0, 89, 0, 0, 0
675, 1, 1636427069718, 1636427069810, 92, 0, 92, 0, 0, 0
676, 1, 1636427070150, 1636427070242, 92, 0, 92, 0, 0, 0
677, 1, 1636427070377, 1636427070470, 93, 1, 92, 0, 1, 1
678, 1, 1636427070406, 1636427070498, 92, 0, 92, 0, 0, 0
679, 1, 1636427070761, 1636427070854, 93, 1, 92, 0, 0, 0
680, 1, 1636427070834, 1636427070938, 104, 0, 104, 0, 0, 0
681, 1, 1636427071457, 1636427071549, 92, 1, 91, 1, 0, 1
683, 1, 1636427071549, 1636427071642, 93, 0, 93, 0, 0, 0
682, 1, 1636427071581, 1636427071673, 92, 0, 92, 0, 0, 0
685, 1, 1636427072033, 1636427072126, 93, 1, 92, 0, 0, 0
684, 1, 1636427072042, 1636427072133, 91, 0, 91, 0, 0, 0
686, 1, 1636427072145, 1636427072238, 93, 1, 92, 0, 0, 0
687, 1, 1636427072210, 1636427072301, 91, 0, 91, 0, 0, 0
688, 1, 1636427072229, 1636427072322, 93, 1, 92, 1, 0, 1
689, 1, 1636427072485, 1636427072577, 92, 1, 91, 0, 0, 0
691, 1, 1636427072706, 1636427072798, 92, 0, 92, 0, 0, 0
690, 1, 1636427072942, 1636427073033, 91, 0, 91, 0, 0, 0
692, 1, 1636427073162, 1636427073254, 92, 0, 92, 0, 0, 0
693, 1, 1636427073257, 1636427073350, 93, 1, 92, 0, 0, 0
694, 1, 1636427073318, 1636427073406, 88, 0, 88, 0, 0, 0
695, 1, 1636427073790, 1636427073881, 91, 0, 91, 0, 0, 0
696, 1, 1636427073926, 1636427074018, 92, 0, 92, 0, 0, 0
697, 1, 1636427074446, 1636427074538, 92, 0, 92, 0, 0, 0
698, 1, 1636427074638, 1636427074730, 92, 0, 92, 0, 0, 0
699, 1, 1636427074958, 1636427075050, 92, 0, 92, 0, 0, 0
700, 1, 1636427075406, 1636427075498, 92, 0, 92, 0, 0, 0
701, 1, 1636427075498, 1636427075590, 92, 0, 92, 0, 0, 0
704, 1, 1636427075954, 1636427076046, 92, 0, 92, 0, 0, 0
707, 1, 1636427076302, 1636427076393, 91, 0, 91, 0, 0, 0
708, 1, 1636427076374, 1636427076466, 92, 0, 92, 0, 0, 0
711, 1, 1636427076669, 1636427076762, 93, 1, 92, 0, 0, 0
712, 1, 1636427076822, 1636427076914, 92, 0, 92, 0, 0, 0
713, 1, 1636427077278, 1636427077370, 92, 0, 92, 0, 0, 0
714, 1, 1636427077402, 1636427077494, 92, 0, 92, 0, 0, 0
715, 1, 1636427077574, 1636427077666, 92, 0, 92, 0, 0, 0
716, 1, 1636427077922, 1636427078014, 92, 0, 92, 0, 0, 0
717, 1, 1636427078230, 1636427078322, 92, 0, 92, 0, 0, 0
718, 1, 1636427078737, 1636427078830, 93, 1, 92, 0, 1, 1
719, 1, 1636427078877, 1636427078970, 93, 1, 92, 0, 0, 0
720, 1, 1636427079269, 1636427079362, 93, 1, 92, 0, 0, 0
721, 1, 1636427079362, 1636427079458, 96, 0, 96, 0, 0, 0
722, 1, 1636427079821, 1636427079914, 93, 1, 92, 0, 0, 0
723, 1, 1636427080022, 1636427080114, 92, 0, 92, 0, 0, 0
724, 1, 1636427080346, 1636427080438, 92, 0, 92, 0, 0, 0
725, 1, 1636427080453, 1636427080550, 97, 1, 96, 0, 0, 0
726, 1, 1636427080634, 1636427080729, 95, 0, 95, 0, 0, 0
727, 1, 1636427081241, 1636427081333, 92, 1, 91, 0, 0, 0
728, 1, 1636427081357, 1636427081441, 84, 0, 84, 0, 0, 0
729, 1, 1636427081441, 1636427081534, 93, 1, 92, 0, 0, 0
730, 1, 1636427081842, 1636427081934, 92, 0, 92, 0, 0, 0
731, 1, 1636427082102, 1636427082194, 92, 0, 92, 0, 0, 0
732, 1, 1636427082562, 1636427082654, 92, 0, 92, 0, 0, 0
733, 1, 1636427083037, 1636427083129, 92, 1, 91, 0, 0, 0
734, 1, 1636427083074, 1636427083165, 91, 0, 91, 0, 0, 0
735, 1, 1636427083085, 1636427083182, 97, 1, 96, 0, 0, 0
736, 1, 1636427083490, 1636427083582, 92, 0, 92, 0, 0, 0
737, 1, 1636427084014, 1636427084106, 92, 0, 92, 0, 0, 0
738, 1, 1636427084378, 1636427084470, 92, 0, 92, 0, 0, 0
739, 1, 1636427084470, 1636427084562, 92, 0, 92, 0, 0, 0
740, 1, 1636427084502, 1636427084594, 92, 0, 92, 0, 0, 0
741, 1, 1636427085222, 1636427085313, 91, 0, 91, 0, 0, 0
742, 1, 1636427085309, 1636427085401, 92, 1, 91, 0, 0, 0
743, 1, 1636427085370, 1636427085522, 152, 0, 152, 0, 0, 0
744, 1, 1636427085834, 1636427085958, 124, 0, 124, 0, 0, 0
745, 1, 1636427086050, 1636427086146, 96, 0, 96, 0, 0, 0
746, 1, 1636427086237, 1636427086329, 92, 1, 91, 1, 0, 1
747, 1, 1636427086237, 1636427086330, 93, 1, 92, 0, 1, 1
749, 1, 1636427086573, 1636427086666, 93, 1, 92, 0, 0, 0
748, 1, 1636427086690, 1636427086777, 87, 0, 87, 0, 0, 0
750, 1, 1636427086753, 1636427086842, 89, 0, 89, 0, 0, 0
753, 1, 1636427086998, 1636427087090, 92, 0, 92, 0, 0, 0
754, 1, 1636427087065, 1636427087157, 92, 1, 91, 0, 0, 0
752, 1, 1636427087141, 1636427087233, 92, 1, 91, 0, 1, 1
755, 1, 1636427087233, 1636427087326, 93, 1, 92, 0, 0, 0
751, 1, 1636427087593, 1636427087685, 92, 0, 92, 0, 0, 0
756, 1, 1636427087681, 1636427087769, 88, 0, 88, 0, 0, 0
757, 1, 1636427087725, 1636427087813, 88, 0, 88, 0, 0, 0
758, 1, 1636427088362, 1636427088453, 91, 0, 91, 0, 0, 0
759, 1, 1636427088618, 1636427088710, 92, 0, 92, 0, 0, 0
760, 1, 1636427088810, 1636427088901, 91, 0, 91, 0, 0, 0
761, 1, 1636427089182, 1636427089274, 92, 0, 92, 0, 0, 0
762, 1, 1636427089474, 1636427089566, 92, 0, 92, 0, 0, 0
763, 1, 1636427089617, 1636427089710, 93, 0, 93, 0, 0, 0
764, 1, 1636427089886, 1636427089977, 91, 0, 91, 0, 0, 0
765, 1, 1636427089966, 1636427090057, 91, 0, 91, 0, 0, 0
767, 1, 1636427090157, 1636427090249, 92, 1, 91, 0, 1, 1
768, 1, 1636427090237, 1636427090330, 93, 1, 92, 1, 0, 1
766, 1, 1636427090341, 1636427090433, 92, 1, 91, 0, 0, 0
769, 1, 1636427090609, 1636427090701, 92, 1, 91, 0, 0, 0
770, 1, 1636427090693, 1636427090786, 93, 1, 92, 0, 0, 0
771, 1, 1636427090713, 1636427090805, 92, 1, 91, 0, 0, 0
773, 1, 1636427090786, 1636427090877, 91, 0, 91, 0, 0, 0
772, 1, 1636427090793, 1636427090886, 93, 1, 92, 0, 1, 1
774, 1, 1636427091250, 1636427091341, 91, 0, 91, 0, 0, 0
775, 1, 1636427091454, 1636427091545, 91, 0, 91, 0, 0, 0
776, 1, 1636427091689, 1636427091782, 93, 1, 92, 1, 0, 1
777, 1, 1636427091910, 1636427092002, 92, 0, 92, 0, 0, 0
778, 1, 1636427092142, 1636427092234, 92, 0, 92, 0, 0, 0
779, 1, 1636427092494, 1636427092586, 92, 0, 92, 0, 0, 0
780, 1, 1636427092650, 1636427092742, 92, 0, 92, 0, 0, 0
781, 1, 1636427092874, 1636427092966, 92, 0, 92, 0, 0, 0
782, 1, 1636427093306, 1636427093398, 92, 0, 92, 0, 0, 0
783, 1, 1636427093550, 1636427093641, 91, 0, 91, 0, 0, 0
784, 1, 1636427093677, 1636427093769, 92, 1, 91, 1, 0, 1
785, 1, 1636427094138, 1636427094229, 91, 0, 91, 0, 0, 0
786, 1, 1636427094206, 1636427094297, 91, 0, 91, 0, 0, 0
787, 1, 1636427094233, 1636427094326, 93, 1, 92, 1, 0, 1
788, 1, 1636427094261, 1636427094354, 93, 1, 92, 0, 0, 0
789, 1, 1636427094590, 1636427094681, 91, 0, 91, 0, 0, 0
790, 1, 1636427094625, 1636427094717, 92, 1, 91, 0, 0, 0
791, 1, 1636427094709, 1636427094801, 92, 0, 92, 0, 0, 0
793, 1, 1636427094746, 1636427094837, 91, 0, 91, 0, 0, 0
794, 1, 1636427094778, 1636427094869, 91, 0, 91, 0, 0, 0
792, 1, 1636427095046, 1636427095137, 91, 0, 91, 0, 0, 0
795, 1, 1636427095354, 1636427095445, 91, 0, 91, 0, 0, 0
796, 1, 1636427095429, 1636427095522, 93, 1, 92, 1, 0, 1
797, 1, 1636427095814, 1636427095906, 92, 0, 92, 0, 0, 0
798, 1, 1636427095878, 1636427095969, 91, 0, 91, 0, 0, 0
799, 1, 1636427096190, 1636427096282, 92, 0, 92, 0, 0, 0
800, 1, 1636427096662, 1636427096754, 92, 0, 92, 0, 0, 0
801, 1, 1636427097005, 1636427097097, 92, 1, 91, 0, 0, 0
802, 1, 1636427097038, 1636427097130, 92, 0, 92, 0, 0, 0
803, 1, 1636427097710, 1636427097802, 92, 0, 92, 0, 0, 0
804, 1, 1636427097837, 1636427097930, 93, 1, 92, 0, 0, 0
807, 1, 1636427098133, 1636427098226, 93, 1, 92, 0, 1, 1
806, 1, 1636427098133, 1636427098226, 93, 1, 92, 0, 1, 1
805, 1, 1636427098293, 1636427098386, 93, 1, 92, 1, 0, 1
808, 1, 1636427098449, 1636427098541, 92, 1, 91, 0, 0, 0
809, 1, 1636427098613, 1636427098706, 93, 1, 92, 0, 0, 0
810, 1, 1636427098665, 1636427098761, 96, 1, 95, 0, 0, 0
811, 1, 1636427098742, 1636427098834, 92, 0, 92, 0, 0, 0
813, 1, 1636427098885, 1636427098977, 92, 1, 91, 0, 0, 0
812, 1, 1636427098897, 1636427098989, 92, 1, 91, 1, 0, 1
814, 1, 1636427099189, 1636427099282, 93, 1, 92, 1, 0, 1
815, 1, 1636427099194, 1636427099285, 91, 0, 91, 0, 0, 0
816, 1, 1636427099221, 1636427099310, 89, 0, 89, 0, 0, 0
818, 1, 1636427099645, 1636427099738, 93, 0, 93, 0, 0, 0
817, 1, 1636427099669, 1636427099762, 93, 0, 93, 0, 0, 0
819, 1, 1636427100418, 1636427100509, 91, 0, 91, 0, 0, 0
820, 1, 1636427100502, 1636427100594, 92, 0, 92, 0, 0, 0
821, 1, 1636427101022, 1636427101113, 91, 0, 91, 0, 0, 0
822, 1, 1636427101101, 1636427101193, 92, 1, 91, 1, 0, 1
823, 1, 1636427101554, 1636427101645, 91, 0, 91, 0, 0, 0
824, 1, 1636427101638, 1636427101729, 91, 0, 91, 0, 0, 0
825, 1, 1636427101829, 1636427101922, 93, 1, 92, 0, 0, 0
827, 1, 1636427102077, 1636427102165, 88, 1, 87, 1, 0, 1
826, 1, 1636427102089, 1636427102177, 88, 1, 87, 1, 0, 1
828, 1, 1636427102310, 1636427102402, 92, 0, 92, 0, 0, 0
829, 1, 1636427102449, 1636427102537, 88, 0, 88, 0, 0, 0
830, 1, 1636427102546, 1636427102637, 91, 0, 91, 0, 0, 0
831, 1, 1636427102574, 1636427102666, 92, 0, 92, 0, 0, 0
833, 1, 1636427102761, 1636427102853, 92, 1, 91, 0, 0, 0
832, 1, 1636427102897, 1636427102989, 92, 1, 91, 0, 0, 0
834, 1, 1636427102997, 1636427103085, 88, 1, 87, 0, 1, 1
835, 1, 1636427103357, 1636427103450, 93, 1, 92, 0, 0, 0
836, 1, 1636427103357, 1636427103450, 93, 1, 92, 0, 0, 0
837, 1, 1636427103805, 1636427103898, 93, 1, 92, 0, 1, 1
838, 1, 1636427103810, 1636427103901, 91, 0, 91, 0, 0, 0
839, 1, 1636427104597, 1636427104694, 97, 1, 96, 0, 0, 0
840, 1, 1636427104678, 1636427104770, 92, 0, 92, 0, 0, 0
841, 1, 1636427104866, 1636427104958, 92, 0, 92, 0, 0, 0
842, 1, 1636427105281, 1636427105374, 93, 1, 92, 0, 0, 0
843, 1, 1636427105586, 1636427105681, 95, 0, 95, 0, 0, 0
844, 1, 1636427105674, 1636427105766, 92, 0, 92, 0, 0, 0
845, 1, 1636427105945, 1636427106041, 96, 1, 95, 0, 1, 1
846, 1, 1636427106126, 1636427106217, 91, 0, 91, 0, 0, 0
847, 1, 1636427106133, 1636427106226, 93, 1, 92, 1, 0, 1
848, 1, 1636427106473, 1636427106565, 92, 1, 91, 0, 0, 0
849, 1, 1636427106593, 1636427106685, 92, 1, 91, 0, 1, 1
850, 1, 1636427106625, 1636427106717, 92, 1, 91, 0, 1, 1
851, 1, 1636427106641, 1636427106729, 88, 0, 88, 0, 0, 0
854, 1, 1636427106990, 1636427107082, 92, 0, 92, 0, 0, 0
852, 1, 1636427107050, 1636427107141, 91, 0, 91, 0, 0, 0
853, 1, 1636427107077, 1636427107166, 89, 1, 88, 0, 0, 0
855, 1, 1636427107314, 1636427107406, 92, 0, 92, 0, 0, 0
856, 1, 1636427107382, 1636427107473, 91, 0, 91, 0, 0, 0
857, 1, 1636427107770, 1636427107862, 92, 0, 92, 0, 0, 0
858, 1, 1636427107834, 1636427107926, 92, 0, 92, 0, 0, 0
859, 1, 1636427108713, 1636427108805, 92, 1, 91, 0, 0, 0
860, 1, 1636427108738, 1636427108829, 91, 0, 91, 0, 0, 0
861, 1, 1636427108765, 1636427108857, 92, 1, 91, 0, 1, 1
862, 1, 1636427109425, 1636427109518, 93, 0, 93, 0, 0, 0
863, 1, 1636427109482, 1636427109577, 95, 0, 95, 0, 0, 0
864, 1, 1636427109677, 1636427109770, 93, 1, 92, 0, 1, 1
865, 1, 1636427109942, 1636427110033, 91, 0, 91, 0, 0, 0
866, 1, 1636427110037, 1636427110130, 93, 1, 92, 0, 1, 1
867, 1, 1636427110210, 1636427110302, 92, 0, 92, 0, 0, 0
868, 1, 1636427110501, 1636427110594, 93, 1, 92, 0, 1, 1
869, 1, 1636427110557, 1636427110649, 92, 1, 91, 0, 0, 0
870, 1, 1636427110598, 1636427110690, 92, 0, 92, 0, 0, 0
872, 1, 1636427110718, 1636427110810, 92, 0, 92, 0, 0, 0
871, 1, 1636427110957, 1636427111049, 92, 1, 91, 0, 0, 0
874, 1, 1636427111109, 1636427111201, 92, 1, 91, 0, 0, 0
875, 1, 1636427111157, 1636427111249, 92, 0, 92, 0, 0, 0
873, 1, 1636427111177, 1636427111269, 92, 1, 91, 1, 0, 1
876, 1, 1636427111177, 1636427111269, 92, 1, 91, 0, 0, 0
878, 1, 1636427111605, 1636427111701, 96, 1, 95, 1, 0, 1
877, 1, 1636427111630, 1636427111722, 92, 0, 92, 0, 0, 0
879, 1, 1636427112489, 1636427112582, 93, 1, 92, 1, 0, 1
880, 1, 1636427112646, 1636427112738, 92, 0, 92, 0, 0, 0
881, 1, 1636427112882, 1636427112974, 92, 0, 92, 0, 0, 0
882, 1, 1636427113330, 1636427113421, 91, 0, 91, 0, 0, 0
883, 1, 1636427113361, 1636427113454, 93, 1, 92, 0, 0, 0
884, 1, 1636427113797, 1636427113890, 93, 1, 92, 1, 0, 1
885, 1, 1636427113821, 1636427113914, 93, 0, 93, 0, 0, 0
886, 1, 1636427113941, 1636427114034, 93, 0, 93, 0, 0, 0
887, 1, 1636427114002, 1636427114093, 91, 0, 91, 0, 0, 0
888, 1, 1636427114386, 1636427114477, 91, 0, 91, 0, 0, 0
889, 1, 1636427114386, 1636427114477, 91, 0, 91, 0, 0, 0
890, 1, 1636427114522, 1636427114614, 92, 0, 92, 0, 0, 0
892, 1, 1636427114813, 1636427114906, 93, 1, 92, 0, 0, 0
891, 1, 1636427114838, 1636427114930, 92, 0, 92, 0, 0, 0
893, 1, 1636427114953, 1636427115045, 92, 1, 91, 1, 0, 1
894, 1, 1636427114953, 1636427115045, 92, 1, 91, 0, 0, 0
897, 1, 1636427115342, 1636427115434, 92, 0, 92, 0, 0, 0
895, 1, 1636427115410, 1636427115502, 92, 0, 92, 0, 0, 0
896, 1, 1636427115417, 1636427115510, 93, 1, 92, 0, 0, 0
898, 1, 1636427115797, 1636427115890, 93, 1, 92, 0, 1, 1
899, 1, 1636427116534, 1636427116626, 92, 0, 92, 0, 0, 0
900, 1, 1636427116814, 1636427116906, 92, 0, 92, 0, 0, 0
901, 1, 1636427116966, 1636427117058, 92, 0, 92, 0, 0, 0
902, 1, 1636427117377, 1636427117469, 92, 1, 91, 0, 0, 0
903, 1, 1636427117574, 1636427117666, 92, 0, 92, 0, 0, 0
904, 1, 1636427117649, 1636427117741, 92, 1, 91, 0, 0, 0
905, 1, 1636427117829, 1636427117922, 93, 0, 93, 0, 0, 0
906, 1, 1636427117890, 1636427117982, 92, 0, 92, 0, 0, 0
907, 1, 1636427118074, 1636427118165, 91, 0, 91, 0, 0, 0
908, 1, 1636427118301, 1636427118390, 89, 1, 88, 1, 0, 1
909, 1, 1636427118390, 1636427118482, 92, 0, 92, 0, 0, 0
910, 1, 1636427118590, 1636427118682, 92, 0, 92, 0, 0, 0
911, 1, 1636427118717, 1636427118809, 92, 1, 91, 1, 0, 1
913, 1, 1636427118846, 1636427118938, 92, 0, 92, 0, 0, 0
912, 1, 1636427118846, 1636427118938, 92, 0, 92, 0, 0, 0
915, 1, 1636427119070, 1636427119162, 92, 0, 92, 0, 0, 0
914, 1, 1636427119165, 1636427119258, 93, 1, 92, 0, 1, 1
916, 1, 1636427119526, 1636427119622, 96, 0, 96, 0, 0, 0
917, 1, 1636427119661, 1636427119754, 93, 1, 92, 0, 0, 0
918, 1, 1636427120118, 1636427120210, 92, 0, 92, 0, 0, 0
919, 1, 1636427120434, 1636427120526, 92, 0, 92, 0, 0, 0
920, 1, 1636427120901, 1636427120993, 92, 1, 91, 1, 0, 1
921, 1, 1636427121126, 1636427121218, 92, 0, 92, 0, 0, 0
922, 1, 1636427121398, 1636427121490, 92, 0, 92, 0, 0, 0
923, 1, 1636427121665, 1636427121758, 93, 1, 92, 0, 0, 0
924, 1, 1636427121678, 1636427121769, 91, 0, 91, 0, 0, 0
925, 1, 1636427121729, 1636427121822, 93, 1, 92, 1, 0, 1
926, 1, 1636427121849, 1636427121942, 93, 1, 92, 0, 0, 0
927, 1, 1636427122346, 1636427122438, 92, 0, 92, 0, 0, 0
928, 1, 1636427122402, 1636427122494, 92, 0, 92, 0, 0, 0
929, 1, 1636427122541, 1636427122634, 93, 1, 92, 0, 0, 0
930, 1, 1636427122813, 1636427122905, 92, 1, 91, 0, 0, 0
931, 1, 1636427122905, 1636427122998, 93, 1, 92, 0, 0, 0
932, 1, 1636427122937, 1636427123025, 88, 0, 88, 0, 0, 0
933, 1, 1636427123085, 1636427123174, 89, 1, 88, 0, 0, 0
934, 1, 1636427123141, 1636427123234, 93, 1, 92, 0, 0, 0
935, 1, 1636427123269, 1636427123362, 93, 1, 92, 0, 0, 0
937, 1, 1636427123581, 1636427123674, 93, 1, 92, 0, 1, 1
936, 1, 1636427123589, 1636427123681, 92, 1, 91, 0, 0, 0
938, 1, 1636427124042, 1636427124134, 92, 0, 92, 0, 0, 0
939, 1, 1636427124365, 1636427124458, 93, 1, 92, 0, 1, 1
940, 1, 1636427125222, 1636427125314, 92, 0, 92, 0, 0, 0
941, 1, 1636427125321, 1636427125414, 93, 1, 92, 0, 0, 0
942, 1, 1636427125417, 1636427125509, 92, 1, 91, 1, 0, 1
943, 1, 1636427125830, 1636427125922, 92, 0, 92, 0, 0, 0
944, 1, 1636427125922, 1636427126013, 91, 0, 91, 0, 0, 0
945, 1, 1636427125982, 1636427126073, 91, 0, 91, 0, 0, 0
946, 1, 1636427126033, 1636427126125, 92, 1, 91, 0, 0, 0
947, 1, 1636427126033, 1636427126125, 92, 1, 91, 0, 0, 0
948, 1, 1636427126570, 1636427126661, 91, 0, 91, 0, 0, 0
949, 1, 1636427126593, 1636427126686, 93, 1, 92, 0, 0, 0
950, 1, 1636427126601, 1636427126693, 92, 1, 91, 0, 0, 0
951, 1, 1636427126818, 1636427126905, 87, 0, 87, 0, 0, 0
952, 1, 1636427127097, 1636427127190, 93, 1, 92, 1, 0, 1
953, 1, 1636427127126, 1636427127217, 91, 0, 91, 0, 0, 0
954, 1, 1636427127153, 1636427127250, 97, 1, 96, 0, 0, 0
955, 1, 1636427127569, 1636427127661, 92, 1, 91, 0, 0, 0
957, 1, 1636427127586, 1636427127678, 92, 0, 92, 0, 0, 0
956, 1, 1636427127613, 1636427127706, 93, 1, 92, 0, 0, 0
958, 1, 1636427128021, 1636427128113, 92, 1, 91, 1, 0, 1
959, 1, 1636427128550, 1636427128642, 92, 0, 92, 0, 0, 0
960, 1, 1636427129182, 1636427129274, 92, 0, 92, 0, 0, 0
961, 1, 1636427129194, 1636427129285, 91, 0, 91, 0, 0, 0
962, 1, 1636427129297, 1636427129390, 93, 1, 92, 1, 0, 1
963, 1, 1636427129730, 1636427129821, 91, 0, 91, 0, 0, 0
965, 1, 1636427129749, 1636427129841, 92, 1, 91, 0, 0, 0
964, 1, 1636427129757, 1636427129845, 88, 0, 88, 0, 0, 0
966, 1, 1636427129789, 1636427129882, 93, 0, 93, 0, 0, 0
967, 1, 1636427129941, 1636427130033, 92, 1, 91, 1, 0, 1
968, 1, 1636427130290, 1636427130382, 92, 0, 92, 0, 0, 0
969, 1, 1636427130477, 1636427130570, 93, 1, 92, 1, 0, 1
970, 1, 1636427130585, 1636427130674, 89, 1, 88, 0, 1, 1
971, 1, 1636427130934, 1636427131025, 91, 0, 91, 0, 0, 0
972, 1, 1636427130998, 1636427131089, 91, 0, 91, 0, 0, 0
973, 1, 1636427131077, 1636427131170, 93, 1, 92, 0, 0, 0
974, 1, 1636427131125, 1636427131217, 92, 1, 91, 0, 0, 0
975, 1, 1636427131454, 1636427131546, 92, 0, 92, 0, 0, 0
976, 1, 1636427131549, 1636427131641, 92, 0, 92, 0, 0, 0
977, 1, 1636427131618, 1636427131710, 92, 0, 92, 0, 0, 0
978, 1, 1636427132074, 1636427132166, 92, 0, 92, 0, 0, 0
979, 1, 1636427132274, 1636427132366, 92, 0, 92, 0, 0, 0
980, 1, 1636427133054, 1636427133146, 92, 0, 92, 0, 0, 0
981, 1, 1636427133334, 1636427133425, 91, 0, 91, 0, 0, 0
982, 1, 1636427133350, 1636427133446, 96, 0, 96, 0, 0, 0
983, 1, 1636427133506, 1636427133598, 92, 0, 92, 0, 0, 0
984, 1, 1636427133797, 1636427133886, 89, 0, 89, 0, 0, 0
985, 1, 1636427133829, 1636427133922, 93, 1, 92, 1, 0, 1
986, 1, 1636427133949, 1636427134042, 93, 0, 93, 0, 0, 0
987, 1, 1636427134089, 1636427134182, 93, 1, 92, 1, 0, 1
988, 1, 1636427134233, 1636427134326, 93, 1, 92, 0, 0, 0
989, 1, 1636427134389, 1636427134482, 93, 1, 92, 1, 0, 1
990, 1, 1636427134582, 1636427134673, 91, 0, 91, 0, 0, 0
991, 1, 1636427134806, 1636427134898, 92, 0, 92, 0, 0, 0
992, 1, 1636427134957, 1636427135049, 92, 1, 91, 0, 0, 0
993, 1, 1636427135166, 1636427135253, 87, 0, 87, 0, 0, 0
994, 1, 1636427135169, 1636427135257, 88, 1, 87, 0, 0, 0
995, 1, 1636427135617, 1636427135713, 96, 1, 95, 0, 1, 1
996, 1, 1636427135661, 1636427135754, 93, 1, 92, 1, 0, 1
997, 1, 1636427135737, 1636427135829, 92, 1, 91, 1, 0, 1
999, 1, 1636427136033, 1636427136125, 92, 1, 91, 0, 1, 1
998, 1, 1636427136190, 1636427136282, 92, 0, 92, 0, 0, 0
1000, 1, 1636427137218, 1636427137313, 95, 0, 95, 0, 0, 0
1001, 1, 1636427137414, 1636427137505, 91, 0, 91, 0, 0, 0
1002, 1, 1636427137618, 1636427137710, 92, 0, 92, 0, 0, 0
1004, 1, 1636427137669, 1636427137757, 88, 1, 87, 1, 0, 1
1003, 1, 1636427137677, 1636427137765, 88, 1, 87, 0, 0, 0
1005, 1, 1636427138006, 1636427138098, 92, 0, 92, 0, 0, 0
1006, 1, 1636427138262, 1636427138353, 91, 0, 91, 0, 0, 0
1007, 1, 1636427138373, 1636427138466, 93, 0, 93, 0, 0, 0
1008, 1, 1636427138533, 1636427138630, 97, 1, 96, 0, 0, 0
1009, 1, 1636427138573, 1636427138666, 93, 1, 92, 0, 0, 0
1010, 1, 1636427138730, 1636427138821, 91, 0, 91, 0, 0, 0
1011, 1, 1636427138765, 1636427138858, 93, 1, 92, 0, 0, 0
1012, 1, 1636427138985, 1636427139078, 93, 0, 93, 0, 0, 0
1013, 1, 1636427139310, 1636427139402, 92, 0, 92, 0, 0, 0
1014, 1, 1636427139329, 1636427139422, 93, 1, 92, 0, 0, 0
1015, 1, 1636427139549, 1636427139641, 92, 1, 91, 0, 0, 0
1017, 1, 1636427139794, 1636427139885, 91, 0, 91, 0, 0, 0
1018, 1, 1636427139941, 1636427140033, 92, 1, 91, 0, 0, 0
1016, 1, 1636427140001, 1636427140094, 93, 1, 92, 0, 1, 1
1019, 1, 1636427140198, 1636427140290, 92, 0, 92, 0, 0, 0
1020, 1, 1636427141238, 1636427141330, 92, 0, 92, 0, 0, 0
1021, 1, 1636427141485, 1636427141577, 92, 1, 91, 0, 0, 0
1022, 1, 1636427141509, 1636427141602, 93, 1, 92, 0, 0, 0
1023, 1, 1636427141537, 1636427141629, 92, 1, 91, 0, 0, 0
1024, 1, 1636427141690, 1636427141781, 91, 0, 91, 0, 0, 0
1025, 1, 1636427142157, 1636427142253, 96, 1, 95, 0, 0, 0
1026, 1, 1636427142189, 1636427142281, 92, 1, 91, 1, 0, 1
1027, 1, 1636427142305, 1636427142398, 93, 1, 92, 1, 0, 1
1028, 1, 1636427142537, 1636427142630, 93, 1, 92, 0, 1, 1
1029, 1, 1636427142618, 1636427142710, 92, 0, 92, 0, 0, 0
1030, 1, 1636427142713, 1636427142805, 92, 1, 91, 0, 0, 0
1031, 1, 1636427142849, 1636427142942, 93, 1, 92, 1, 0, 1
1032, 1, 1636427143177, 1636427143269, 92, 1, 91, 1, 0, 1
1033, 1, 1636427143205, 1636427143298, 93, 1, 92, 1, 0, 1
1034, 1, 1636427143293, 1636427143386, 93, 1, 92, 0, 0, 0
1035, 1, 1636427143449, 1636427143542, 93, 1, 92, 0, 0, 0
1036, 1, 1636427143741, 1636427143837, 96, 1, 95, 0, 0, 0
1038, 1, 1636427143881, 1636427143973, 92, 0, 92, 0, 0, 0
1037, 1, 1636427143905, 1636427143997, 92, 1, 91, 0, 1, 1
1039, 1, 1636427144253, 1636427144346, 93, 1, 92, 0, 0, 0
1040, 1, 1636427145205, 1636427145298, 93, 1, 92, 0, 0, 0
1041, 1, 1636427145526, 1636427145618, 92, 0, 92, 0, 0, 0
1042, 1, 1636427145550, 1636427145641, 91, 0, 91, 0, 0, 0
1043, 1, 1636427145630, 1636427145722, 92, 0, 92, 0, 0, 0
1044, 1, 1636427145661, 1636427145754, 93, 1, 92, 0, 1, 1
1045, 1, 1636427145957, 1636427146050, 93, 1, 92, 0, 0, 0
1046, 1, 1636427146214, 1636427146306, 92, 0, 92, 0, 0, 0
1047, 1, 1636427146334, 1636427146426, 92, 0, 92, 0, 0, 0
1048, 1, 1636427146561, 1636427146653, 92, 1, 91, 0, 1, 1
1049, 1, 1636427146586, 1636427146677, 91, 0, 91, 0, 0, 0
1050, 1, 1636427146613, 1636427146705, 92, 1, 91, 1, 0, 1
1051, 1, 1636427146970, 1636427147061, 91, 0, 91, 0, 0, 0
1052, 1, 1636427146997, 1636427147089, 92, 1, 91, 0, 1, 1
1053, 1, 1636427147193, 1636427147285, 92, 1, 91, 1, 0, 1
1054, 1, 1636427147225, 1636427147317, 92, 1, 91, 1, 0, 1
1055, 1, 1636427147321, 1636427147414, 93, 1, 92, 0, 1, 1
1056, 1, 1636427147454, 1636427147545, 91, 0, 91, 0, 0, 0
1057, 1, 1636427147681, 1636427147777, 96, 1, 95, 0, 0, 0
1058, 1, 1636427148026, 1636427148118, 92, 0, 92, 0, 0, 0
1059, 1, 1636427148326, 1636427148418, 92, 0, 92, 0, 0, 0
1060, 1, 1636427149277, 1636427149365, 88, 1, 87, 0, 0, 0
1061, 1, 1636427149321, 1636427149413, 92, 1, 91, 0, 0, 0
1062, 1, 1636427149481, 1636427149574, 93, 1, 92, 0, 0, 0
1063, 1, 1636427149545, 1636427149638, 93, 1, 92, 1, 0, 1
1064, 1, 1636427149814, 1636427149905, 91, 0, 91, 0, 0, 0
1065, 1, 1636427150046, 1636427150137, 91, 0, 91, 0, 0, 0
1066, 1, 1636427150189, 1636427150282, 93, 1, 92, 0, 1, 1
1067, 1, 1636427150285, 1636427150378, 93, 1, 92, 0, 0, 0
1068, 1, 1636427150342, 1636427150433, 91, 0, 91, 0, 0, 0
1069, 1, 1636427150749, 1636427150842, 93, 1, 92, 0, 1, 1
1070, 1, 1636427150890, 1636427150981, 91, 0, 91, 0, 0, 0
1071, 1, 1636427150945, 1636427151037, 92, 1, 91, 1, 0, 1
1072, 1, 1636427150997, 1636427151089, 92, 1, 91, 0, 1, 1
1073, 1, 1636427151166, 1636427151261, 95, 0, 95, 0, 0, 0
1075, 1, 1636427151289, 1636427151382, 93, 1, 92, 1, 0, 1
1076, 1, 1636427151341, 1636427151434, 93, 1, 92, 0, 0, 0
1074, 1, 1636427151445, 1636427151538, 93, 1, 92, 1, 0, 1
1077, 1, 1636427151741, 1636427151830, 89, 1, 88, 0, 0, 0
1078, 1, 1636427151877, 1636427151970, 93, 0, 93, 0, 0, 0
1079, 1, 1636427152362, 1636427152454, 92, 0, 92, 0, 0, 0
1080, 1, 1636427153345, 1636427153437, 92, 0, 92, 0, 0, 0
1081, 1, 1636427153390, 1636427153482, 92, 0, 92, 0, 0, 0
1082, 1, 1636427153581, 1636427153674, 93, 1, 92, 0, 1, 1
1083, 1, 1636427153737, 1636427153830, 93, 1, 92, 1, 0, 1
1084, 1, 1636427153869, 1636427153961, 92, 1, 91, 0, 1, 1
1085, 1, 1636427154006, 1636427154094, 88, 0, 88, 0, 0, 0
1086, 1, 1636427154122, 1636427154213, 91, 0, 91, 0, 0, 0
1087, 1, 1636427154405, 1636427154498, 93, 1, 92, 1, 0, 1
1088, 1, 1636427154438, 1636427154529, 91, 0, 91, 0, 0, 0
1089, 1, 1636427154845, 1636427154937, 92, 0, 92, 0, 0, 0
1090, 1, 1636427154890, 1636427154982, 92, 0, 92, 0, 0, 0
1091, 1, 1636427154914, 1636427155005, 91, 0, 91, 0, 0, 0
1092, 1, 1636427154957, 1636427155045, 88, 1, 87, 0, 1, 1
1093, 1, 1636427155098, 1636427155190, 92, 0, 92, 0, 0, 0
1094, 1, 1636427155345, 1636427155438, 93, 1, 92, 0, 1, 1
1095, 1, 1636427155590, 1636427155681, 91, 0, 91, 0, 0, 0
1096, 1, 1636427155613, 1636427155706, 93, 1, 92, 0, 0, 0
1098, 1, 1636427155737, 1636427155830, 93, 1, 92, 0, 1, 1
1097, 1, 1636427156042, 1636427156134, 92, 0, 92, 0, 0, 0
1099, 1, 1636427156586, 1636427156678, 92, 0, 92, 0, 0, 0
1100, 1, 1636427157273, 1636427157366, 93, 1, 92, 1, 0, 1
1101, 1, 1636427157321, 1636427157413, 92, 1, 91, 0, 1, 1
1102, 1, 1636427157569, 1636427157662, 93, 0, 93, 0, 0, 0
1103, 1, 1636427157621, 1636427157713, 92, 1, 91, 0, 0, 0
1104, 1, 1636427157689, 1636427157782, 93, 1, 92, 0, 1, 1
1105, 1, 1636427157757, 1636427157850, 93, 1, 92, 0, 0, 0
1106, 1, 1636427157809, 1636427157902, 93, 1, 92, 1, 0, 1
1107, 1, 1636427158585, 1636427158677, 92, 0, 92, 0, 0, 0
1108, 1, 1636427158589, 1636427158681, 92, 1, 91, 0, 0, 0
1109, 1, 1636427158630, 1636427158721, 91, 0, 91, 0, 0, 0
1110, 1, 1636427158734, 1636427158826, 92, 0, 92, 0, 0, 0
1111, 1, 1636427158794, 1636427158881, 87, 0, 87, 0, 0, 0
1113, 1, 1636427159242, 1636427159334, 92, 0, 92, 0, 0, 0
1112, 1, 1636427159242, 1636427159334, 92, 0, 92, 0, 0, 0
1114, 1, 1636427159289, 1636427159381, 92, 0, 92, 0, 0, 0
1115, 1, 1636427159353, 1636427159445, 92, 1, 91, 0, 1, 1
1116, 1, 1636427159545, 1636427159638, 93, 1, 92, 1, 0, 1
1118, 1, 1636427159673, 1636427159766, 93, 1, 92, 1, 0, 1
1117, 1, 1636427160001, 1636427160098, 97, 0, 97, 0, 0, 0
1119, 1, 1636427160754, 1636427160846, 92, 0, 92, 0, 0, 0
1120, 1, 1636427161022, 1636427161114, 92, 0, 92, 0, 0, 0
1121, 1, 1636427161278, 1636427161369, 91, 0, 91, 0, 0, 0
1122, 1, 1636427161369, 1636427161457, 88, 1, 87, 0, 1, 1
1123, 1, 1636427161405, 1636427161497, 92, 0, 92, 0, 0, 0
1124, 1, 1636427161505, 1636427161589, 84, 0, 84, 0, 0, 0
1125, 1, 1636427161609, 1636427161697, 88, 0, 88, 0, 0, 0
1126, 1, 1636427161765, 1636427161858, 93, 1, 92, 1, 0, 1
1127, 1, 1636427162293, 1636427162386, 93, 1, 92, 0, 0, 0
1128, 1, 1636427162477, 1636427162570, 93, 1, 92, 0, 0, 0
1129, 1, 1636427162621, 1636427162714, 93, 1, 92, 0, 0, 0
1130, 1, 1636427162746, 1636427162838, 92, 0, 92, 0, 0, 0
1131, 1, 1636427162865, 1636427162958, 93, 1, 92, 0, 0, 0
1132, 1, 1636427163049, 1636427163142, 93, 1, 92, 1, 0, 1
1133, 1, 1636427163157, 1636427163249, 92, 1, 91, 0, 1, 1
1134, 1, 1636427163197, 1636427163290, 93, 1, 92, 1, 0, 1
1135, 1, 1636427163390, 1636427163482, 92, 0, 92, 0, 0, 0
1136, 1, 1636427163629, 1636427163721, 92, 1, 91, 0, 0, 0
1138, 1, 1636427163690, 1636427163782, 92, 0, 92, 0, 0, 0
1137, 1, 1636427164081, 1636427164174, 93, 1, 92, 0, 0, 0
1139, 1, 1636427164905, 1636427164998, 93, 1, 92, 0, 1, 1
1140, 1, 1636427164978, 1636427165069, 91, 0, 91, 0, 0, 0
1141, 1, 1636427165113, 1636427165206, 93, 0, 93, 0, 0, 0
1142, 1, 1636427165378, 1636427165469, 91, 0, 91, 0, 0, 0
1143, 1, 1636427165482, 1636427165573, 91, 0, 91, 0, 0, 0
1144, 1, 1636427165489, 1636427165582, 93, 1, 92, 0, 0, 0
1145, 1, 1636427165497, 1636427165590, 93, 1, 92, 0, 1, 1
1146, 1, 1636427165810, 1636427165902, 92, 0, 92, 0, 0, 0
1147, 1, 1636427166390, 1636427166482, 92, 0, 92, 0, 0, 0
1148, 1, 1636427166514, 1636427166605, 91, 0, 91, 0, 0, 0
1149, 1, 1636427166521, 1636427166613, 92, 1, 91, 0, 1, 1
1150, 1, 1636427166650, 1636427166742, 92, 0, 92, 0, 0, 0
1151, 1, 1636427166745, 1636427166837, 92, 0, 92, 0, 0, 0
1152, 1, 1636427167150, 1636427167242, 92, 0, 92, 0, 0, 0
1153, 1, 1636427167166, 1636427167258, 92, 0, 92, 0, 0, 0
1154, 1, 1636427167317, 1636427167410, 93, 1, 92, 0, 0, 0
1155, 1, 1636427167341, 1636427167434, 93, 1, 92, 0, 1, 1
1156, 1, 1636427167690, 1636427167781, 91, 0, 91, 0, 0, 0
1157, 1, 1636427167770, 1636427167862, 92, 0, 92, 0, 0, 0
1158, 1, 1636427168225, 1636427168318, 93, 1, 92, 0, 0, 0
1159, 1, 1636427168878, 1636427168970, 92, 0, 92, 0, 0, 0
1160, 1, 1636427169142, 1636427169238, 96, 0, 96, 0, 0, 0
1161, 1, 1636427169229, 1636427169326, 97, 1, 96, 1, 0, 1
1162, 1, 1636427169317, 1636427169410, 93, 1, 92, 0, 0, 0
1163, 1, 1636427169386, 1636427169478, 92, 0, 92, 0, 0, 0
1164, 1, 1636427169525, 1636427169617, 92, 1, 91, 0, 0, 0
1165, 1, 1636427169577, 1636427169665, 88, 1, 87, 0, 0, 0
1166, 1, 1636427169989, 1636427170081, 92, 0, 92, 0, 0, 0
1167, 1, 1636427170429, 1636427170521, 92, 0, 92, 0, 0, 0
1168, 1, 1636427170469, 1636427170561, 92, 0, 92, 0, 0, 0
1169, 1, 1636427170501, 1636427170594, 93, 1, 92, 0, 0, 0
1170, 1, 1636427170641, 1636427170729, 88, 1, 87, 1, 0, 1
1171, 1, 1636427170822, 1636427170917, 95, 0, 95, 0, 0, 0
1172, 1, 1636427171034, 1636427171126, 92, 0, 92, 0, 0, 0
1173, 1, 1636427171330, 1636427171421, 91, 0, 91, 0, 0, 0
1174, 1, 1636427171590, 1636427171681, 91, 0, 91, 0, 0, 0
1175, 1, 1636427171621, 1636427171714, 93, 1, 92, 0, 0, 0
1177, 1, 1636427171634, 1636427171726, 92, 0, 92, 0, 0, 0
1176, 1, 1636427171637, 1636427171726, 89, 0, 89, 0, 0, 0
1178, 1, 1636427172098, 1636427172190, 92, 0, 92, 0, 0, 0
1179, 1, 1636427173113, 1636427173205, 92, 0, 92, 0, 0, 0
1180, 1, 1636427173157, 1636427173249, 92, 1, 91, 0, 1, 1
1181, 1, 1636427173281, 1636427173374, 93, 1, 92, 0, 0, 0
1182, 1, 1636427173370, 1636427173462, 92, 0, 92, 0, 0, 0
1183, 1, 1636427173433, 1636427173526, 93, 1, 92, 0, 1, 1
1184, 1, 1636427173557, 1636427173650, 93, 1, 92, 0, 0, 0
1185, 1, 1636427173629, 1636427173726, 97, 1, 96, 1, 0, 1
1186, 1, 1636427174130, 1636427174222, 92, 0, 92, 0, 0, 0
1187, 1, 1636427174229, 1636427174322, 93, 1, 92, 0, 0, 0
1188, 1, 1636427174394, 1636427174486, 92, 0, 92, 0, 0, 0
1189, 1, 1636427174582, 1636427174673, 91, 0, 91, 0, 0, 0
1190, 1, 1636427174718, 1636427174810, 92, 0, 92, 0, 0, 0
1191, 1, 1636427174861, 1636427174954, 93, 1, 92, 0, 1, 1
1192, 1, 1636427174938, 1636427175029, 91, 0, 91, 0, 0, 0
1193, 1, 1636427175498, 1636427175590, 92, 0, 92, 0, 0, 0
1194, 1, 1636427175538, 1636427175630, 92, 0, 92, 0, 0, 0
1195, 1, 1636427175754, 1636427175846, 92, 0, 92, 0, 0, 0
1196, 1, 1636427175781, 1636427175873, 92, 1, 91, 0, 0, 0
1198, 1, 1636427175833, 1636427175926, 93, 1, 92, 0, 0, 0
1197, 1, 1636427176238, 1636427176330, 92, 0, 92, 0, 0, 0
1199, 1, 1636427176898, 1636427176989, 91, 0, 91, 0, 0, 0
1200, 1, 1636427176917, 1636427177006, 89, 1, 88, 0, 0, 0
1201, 1, 1636427177238, 1636427177329, 91, 0, 91, 0, 0, 0
1202, 1, 1636427177274, 1636427177361, 87, 0, 87, 0, 0, 0
1203, 1, 1636427177402, 1636427177493, 91, 0, 91, 0, 0, 0
1204, 1, 1636427177422, 1636427177514, 92, 0, 92, 0, 0, 0
1205, 1, 1636427177629, 1636427177721, 92, 0, 92, 0, 0, 0
1206, 1, 1636427178034, 1636427178126, 92, 0, 92, 0, 0, 0
1207, 1, 1636427178206, 1636427178298, 92, 0, 92, 0, 0, 0
1208, 1, 1636427178501, 1636427178593, 92, 1, 91, 1, 0, 1
1209, 1, 1636427178510, 1636427178601, 91, 0, 91, 0, 0, 0
1210, 1, 1636427178717, 1636427178809, 92, 0, 92, 0, 0, 0
1211, 1, 1636427179118, 1636427179210, 92, 0, 92, 0, 0, 0
1212, 1, 1636427179177, 1636427179269, 92, 1, 91, 0, 1, 1
1213, 1, 1636427179441, 1636427179534, 93, 1, 92, 0, 0, 0
1214, 1, 1636427179621, 1636427179713, 92, 1, 91, 1, 0, 1
1216, 1, 1636427179630, 1636427179722, 92, 0, 92, 0, 0, 0
1217, 1, 1636427179830, 1636427179921, 91, 0, 91, 0, 0, 0
1218, 1, 1636427180013, 1636427180105, 92, 0, 92, 0, 0, 0
1215, 1, 1636427180074, 1636427180166, 92, 0, 92, 0, 0, 0
1219, 1, 1636427180861, 1636427180954, 93, 1, 92, 0, 0, 0
1220, 1, 1636427180973, 1636427181069, 96, 1, 95, 0, 0, 0
1221, 1, 1636427181138, 1636427181234, 96, 0, 96, 0, 0, 0
1222, 1, 1636427181281, 1636427181373, 92, 1, 91, 0, 1, 1
1223, 1, 1636427181482, 1636427181573, 91, 0, 91, 0, 0, 0
1224, 1, 1636427181593, 1636427181686, 93, 1, 92, 0, 1, 1
1225, 1, 1636427181930, 1636427182026, 96, 0, 96, 0, 0, 0
1226, 1, 1636427182225, 1636427182318, 93, 1, 92, 0, 0, 0
1227, 1, 1636427182357, 1636427182450, 93, 1, 92, 1, 0, 1
1228, 1, 1636427182537, 1636427182630, 93, 1, 92, 0, 1, 1
1229, 1, 1636427182798, 1636427182890, 92, 0, 92, 0, 0, 0
1230, 1, 1636427182826, 1636427182918, 92, 0, 92, 0, 0, 0
1231, 1, 1636427182853, 1636427182950, 97, 1, 96, 0, 0, 0
1232, 1, 1636427183217, 1636427183310, 93, 1, 92, 1, 0, 1
1233, 1, 1636427183478, 1636427183569, 91, 0, 91, 0, 0, 0
1234, 1, 1636427183505, 1636427183598, 93, 1, 92, 0, 0, 0
1236, 1, 1636427183766, 1636427183857, 91, 0, 91, 0, 0, 0
1237, 1, 1636427183789, 1636427183882, 93, 1, 92, 0, 0, 0
1238, 1, 1636427183909, 1636427183998, 89, 1, 88, 0, 0, 0
1235, 1, 1636427183962, 1636427184053, 91, 0, 91, 0, 0, 0
1239, 1, 1636427184654, 1636427184746, 92, 0, 92, 0, 0, 0
1240, 1, 1636427184930, 1636427185022, 92, 0, 92, 0, 0, 0
1241, 1, 1636427185033, 1636427185126, 93, 1, 92, 0, 0, 0
1242, 1, 1636427185246, 1636427185338, 92, 0, 92, 0, 0, 0
1243, 1, 1636427185674, 1636427185765, 91, 0, 91, 0, 0, 0
1244, 1, 1636427185750, 1636427185842, 92, 0, 92, 0, 0, 0
1245, 1, 1636427185750, 1636427185842, 92, 0, 92, 0, 0, 0
1246, 1, 1636427186081, 1636427186174, 93, 1, 92, 0, 0, 0
1247, 1, 1636427186514, 1636427186606, 92, 0, 92, 0, 0, 0
1248, 1, 1636427186554, 1636427186646, 92, 0, 92, 0, 0, 0
1249, 1, 1636427186926, 1636427187018, 92, 0, 92, 0, 0, 0
1250, 1, 1636427186981, 1636427187077, 96, 1, 95, 0, 0, 0
1251, 1, 1636427187066, 1636427187158, 92, 0, 92, 0, 0, 0
1252, 1, 1636427187374, 1636427187466, 92, 0, 92, 0, 0, 0
1253, 1, 1636427187433, 1636427187522, 89, 1, 88, 1, 0, 1
1254, 1, 1636427187477, 1636427187566, 89, 0, 89, 0, 0, 0
1256, 1, 1636427187858, 1636427187949, 91, 0, 91, 0, 0, 0
1255, 1, 1636427187885, 1636427187978, 93, 1, 92, 0, 1, 1
1257, 1, 1636427187913, 1636427188010, 97, 1, 96, 0, 0, 0
1258, 1, 1636427187969, 1636427188061, 92, 1, 91, 1, 0, 1
1259, 1, 1636427188717, 1636427188810, 93, 1, 92, 0, 0, 0
1260, 1, 1636427188910, 1636427189002, 92, 0, 92, 0, 0, 0
1261, 1, 1636427188929, 1636427189021, 92, 1, 91, 0, 0, 0
1262, 1, 1636427189194, 1636427189286, 92, 0, 92, 0, 0, 0
1263, 1, 1636427189374, 1636427189466, 92, 0, 92, 0, 0, 0
1264, 1, 1636427189702, 1636427189793, 91, 0, 91, 0, 0, 0
1265, 1, 1636427189782, 1636427189873, 91, 0, 91, 0, 0, 0
1266, 1, 1636427189942, 1636427190034, 92, 0, 92, 0, 0, 0
1267, 1, 1636427190394, 1636427190486, 92, 0, 92, 0, 0, 0
1268, 1, 1636427190710, 1636427190802, 92, 0, 92, 0, 0, 0
1269, 1, 1636427191017, 1636427191106, 89, 1, 88, 1, 0, 1
1270, 1, 1636427191105, 1636427191198, 93, 1, 92, 0, 0, 0
1271, 1, 1636427191218, 1636427191309, 91, 0, 91, 0, 0, 0
1272, 1, 1636427191229, 1636427191322, 93, 1, 92, 1, 0, 1
1273, 1, 1636427191406, 1636427191497, 91, 0, 91, 0, 0, 0
1274, 1, 1636427191446, 1636427191538, 92, 0, 92, 0, 0, 0
1275, 1, 1636427191902, 1636427191994, 92, 0, 92, 0, 0, 0
1276, 1, 1636427191926, 1636427192017, 91, 0, 91, 0, 0, 0
1277, 1, 1636427192041, 1636427192134, 93, 1, 92, 0, 0, 0
1278, 1, 1636427192162, 1636427192254, 92, 0, 92, 0, 0, 0
1279, 1, 1636427192782, 1636427192873, 91, 0, 91, 0, 0, 0
1280, 1, 1636427192877, 1636427192970, 93, 1, 92, 0, 0, 0
1281, 1, 1636427193046, 1636427193134, 88, 0, 88, 0, 0, 0
1282, 1, 1636427193446, 1636427193538, 92, 0, 92, 0, 0, 0
1283, 1, 1636427193478, 1636427193570, 92, 0, 92, 0, 0, 0
1284, 1, 1636427193789, 1636427193882, 93, 1, 92, 0, 0, 0
1285, 1, 1636427193950, 1636427194041, 91, 0, 91, 0, 0, 0
1286, 1, 1636427194057, 1636427194149, 92, 1, 91, 0, 1, 1
1287, 1, 1636427194434, 1636427194526, 92, 0, 92, 0, 0, 0
1288, 1, 1636427194573, 1636427194666, 93, 1, 92, 1, 0, 1
1289, 1, 1636427195093, 1636427195190, 97, 1, 96, 0, 0, 0
1290, 1, 1636427195121, 1636427195214, 93, 1, 92, 0, 0, 0
1291, 1, 1636427195141, 1636427195237, 96, 1, 95, 1, 0, 1
1292, 1, 1636427195250, 1636427195342, 92, 0, 92, 0, 0, 0
1293, 1, 1636427195409, 1636427195502, 93, 1, 92, 1, 0, 1
1294, 1, 1636427195445, 1636427195541, 96, 1, 95, 0, 0, 0
1295, 1, 1636427195902, 1636427195994, 92, 0, 92, 0, 0, 0
1296, 1, 1636427196025, 1636427196117, 92, 1, 91, 1, 0, 1
1297, 1, 1636427196165, 1636427196257, 92, 1, 91, 0, 0, 0
1298, 1, 1636427196354, 1636427196446, 92, 0, 92, 0, 0, 0
1299, 1, 1636427196638, 1636427196729, 91, 0, 91, 0, 0, 0
1300, 1, 1636427196825, 1636427196918, 93, 1, 92, 0, 0, 0
1301, 1, 1636427196834, 1636427196926, 92, 0, 92, 0, 0, 0
1302, 1, 1636427197654, 1636427197746, 92, 0, 92, 0, 0, 0
1303, 1, 1636427197773, 1636427197862, 89, 0, 89, 0, 0, 0
1304, 1, 1636427197818, 1636427197909, 91, 0, 91, 0, 0, 0
1305, 1, 1636427197954, 1636427198042, 88, 0, 88, 0, 0, 0
1306, 1, 1636427198281, 1636427198374, 93, 1, 92, 0, 0, 0
1307, 1, 1636427198522, 1636427198614, 92, 0, 92, 0, 0, 0
1308, 1, 1636427198738, 1636427198830, 92, 0, 92, 0, 0, 0
1309, 1, 1636427199025, 1636427199117, 92, 1, 91, 0, 0, 0
1310, 1, 1636427199110, 1636427199202, 92, 0, 92, 0, 0, 0
1311, 1, 1636427199133, 1636427199229, 96, 1, 95, 0, 0, 0
1312, 1, 1636427199261, 1636427199353, 92, 1, 91, 0, 0, 0
1313, 1, 1636427199346, 1636427199438, 92, 0, 92, 0, 0, 0
1314, 1, 1636427199353, 1636427199442, 89, 1, 88, 1, 0, 1
1315, 1, 1636427199798, 1636427199890, 92, 0, 92, 0, 0, 0
1316, 1, 1636427200057, 1636427200150, 93, 1, 92, 0, 1, 1
1317, 1, 1636427200182, 1636427200274, 92, 0, 92, 0, 0, 0
1318, 1, 1636427200241, 1636427200333, 92, 1, 91, 0, 0, 0
1319, 1, 1636427200385, 1636427200478, 93, 1, 92, 0, 1, 1
1320, 1, 1636427200690, 1636427200782, 92, 0, 92, 0, 0, 0
1321, 1, 1636427200965, 1636427201058, 93, 1, 92, 0, 0, 0
1322, 1, 1636427201569, 1636427201661, 92, 0, 92, 0, 0, 0
1323, 1, 1636427201673, 1636427201765, 92, 1, 91, 0, 0, 0
1324, 1, 1636427201706, 1636427201797, 91, 0, 91, 0, 0, 0
1326, 1, 1636427202153, 1636427202246, 93, 1, 92, 0, 0, 0
1325, 1, 1636427202157, 1636427202249, 92, 1, 91, 0, 1, 1
1327, 1, 1636427202758, 1636427202854, 96, 0, 96, 0, 0, 0
1329, 1, 1636427202845, 1636427202938, 93, 1, 92, 1, 0, 1
1328, 1, 1636427202854, 1636427202946, 92, 0, 92, 0, 0, 0
1330, 1, 1636427203005, 1636427203097, 92, 0, 92, 0, 0, 0
1331, 1, 1636427203050, 1636427203142, 92, 0, 92, 0, 0, 0
1332, 1, 1636427203421, 1636427203513, 92, 1, 91, 0, 0, 0
1334, 1, 1636427203574, 1636427203661, 87, 0, 87, 0, 0, 0
1333, 1, 1636427203574, 1636427203661, 87, 0, 87, 0, 0, 0
1335, 1, 1636427203881, 1636427203974, 93, 1, 92, 0, 0, 0
1336, 1, 1636427203894, 1636427203986, 92, 0, 92, 0, 0, 0
1337, 1, 1636427204081, 1636427204173, 92, 1, 91, 0, 0, 0
1338, 1, 1636427204169, 1636427204261, 92, 1, 91, 0, 1, 1
1339, 1, 1636427204373, 1636427204465, 92, 1, 91, 0, 0, 0
1340, 1, 1636427204397, 1636427204490, 93, 1, 92, 1, 0, 1
1341, 1, 1636427204861, 1636427204954, 93, 1, 92, 1, 0, 1
1342, 1, 1636427205350, 1636427205442, 92, 0, 92, 0, 0, 0
1343, 1, 1636427205585, 1636427205678, 93, 1, 92, 1, 0, 1
1344, 1, 1636427205757, 1636427205850, 93, 1, 92, 0, 1, 1
1345, 1, 1636427206245, 1636427206337, 92, 1, 91, 0, 0, 0
1346, 1, 1636427206282, 1636427206374, 92, 0, 92, 0, 0, 0
1347, 1, 1636427206542, 1636427206634, 92, 0, 92, 0, 0, 0
1348, 1, 1636427206649, 1636427206742, 93, 1, 92, 0, 0, 0
1349, 1, 1636427207001, 1636427207093, 92, 1, 91, 0, 0, 0
1350, 1, 1636427207086, 1636427207177, 91, 0, 91, 0, 0, 0
1351, 1, 1636427207173, 1636427207261, 88, 0, 88, 0, 0, 0
1352, 1, 1636427207206, 1636427207297, 91, 0, 91, 0, 0, 0
1353, 1, 1636427207502, 1636427207593, 91, 0, 91, 0, 0, 0
1354, 1, 1636427207621, 1636427207713, 92, 1, 91, 0, 0, 0
1355, 1, 1636427207662, 1636427207754, 92, 0, 92, 0, 0, 0
1356, 1, 1636427207882, 1636427207973, 91, 0, 91, 0, 0, 0
1357, 1, 1636427207950, 1636427208042, 92, 0, 92, 0, 0, 0
1358, 1, 1636427208374, 1636427208466, 92, 0, 92, 0, 0, 0
1359, 1, 1636427208377, 1636427208470, 93, 1, 92, 1, 0, 1
1360, 1, 1636427208497, 1636427208589, 92, 1, 91, 0, 0, 0
1361, 1, 1636427208893, 1636427208986, 93, 0, 93, 0, 0, 0
1362, 1, 1636427209554, 1636427209645, 91, 0, 91, 0, 0, 0
1363, 1, 1636427209626, 1636427209722, 96, 0, 96, 0, 0, 0
1364, 1, 1636427209914, 1636427210006, 92, 0, 92, 0, 0, 0
1365, 1, 1636427210078, 1636427210169, 91, 0, 91, 0, 0, 0
1366, 1, 1636427210294, 1636427210382, 88, 0, 88, 0, 0, 0
1367, 1, 1636427210561, 1636427210654, 93, 1, 92, 0, 0, 0
1368, 1, 1636427210617, 1636427210706, 89, 1, 88, 1, 0, 1
1369, 1, 1636427210866, 1636427210958, 92, 0, 92, 0, 0, 0
1370, 1, 1636427210866, 1636427210958, 92, 0, 92, 0, 0, 0
1372, 1, 1636427211282, 1636427211373, 91, 0, 91, 0, 0, 0
1371, 1, 1636427211286, 1636427211377, 91, 0, 91, 0, 0, 0
1373, 1, 1636427211593, 1636427211686, 93, 0, 93, 0, 0, 0
1374, 1, 1636427211745, 1636427211837, 92, 1, 91, 0, 0, 0
1375, 1, 1636427211758, 1636427211850, 92, 0, 92, 0, 0, 0
1376, 1, 1636427211817, 1636427211909, 92, 1, 91, 0, 0, 0
1377, 1, 1636427211857, 1636427211949, 92, 1, 91, 0, 0, 0
1378, 1, 1636427212338, 1636427212429, 91, 0, 91, 0, 0, 0
1379, 1, 1636427212522, 1636427212614, 92, 0, 92, 0, 0, 0
1380, 1, 1636427212749, 1636427212842, 93, 1, 92, 0, 0, 0
1381, 1, 1636427213158, 1636427213250, 92, 0, 92, 0, 0, 0
1382, 1, 1636427213857, 1636427213946, 89, 1, 88, 0, 1, 1
1383, 1, 1636427213901, 1636427213993, 92, 1, 91, 0, 0, 0
1384, 1, 1636427213913, 1636427214005, 92, 1, 91, 1, 0, 1
1385, 1, 1636427214065, 1636427214157, 92, 1, 91, 1, 0, 1
1386, 1, 1636427214366, 1636427214458, 92, 0, 92, 0, 0, 0
1387, 1, 1636427214690, 1636427214782, 92, 0, 92, 0, 0, 0
1388, 1, 1636427214889, 1636427214981, 92, 0, 92, 0, 0, 0
1389, 1, 1636427214941, 1636427215033, 92, 1, 91, 0, 1, 1
1390, 1, 1636427215077, 1636427215165, 88, 1, 87, 0, 0, 0
1391, 1, 1636427215161, 1636427215254, 93, 1, 92, 0, 0, 0
1392, 1, 1636427215341, 1636427215433, 92, 0, 92, 0, 0, 0
1393, 1, 1636427215526, 1636427215618, 92, 0, 92, 0, 0, 0
1394, 1, 1636427215826, 1636427215921, 95, 0, 95, 0, 0, 0
1395, 1, 1636427215901, 1636427215993, 92, 1, 91, 0, 0, 0
1396, 1, 1636427215909, 1636427215997, 88, 1, 87, 1, 0, 1
1397, 1, 1636427216122, 1636427216209, 87, 0, 87, 0, 0, 0
1398, 1, 1636427216534, 1636427216626, 92, 0, 92, 0, 0, 0
1399, 1, 1636427216650, 1636427216742, 92, 0, 92, 0, 0, 0
1400, 1, 1636427216733, 1636427216826, 93, 1, 92, 0, 0, 0
1401, 1, 1636427217042, 1636427217134, 92, 0, 92, 0, 0, 0
1402, 1, 1636427218010, 1636427218101, 91, 0, 91, 0, 0, 0
1403, 1, 1636427218138, 1636427218225, 87, 0, 87, 0, 0, 0
1404, 1, 1636427218161, 1636427218253, 92, 1, 91, 0, 0, 0
1405, 1, 1636427218197, 1636427218289, 92, 0, 92, 0, 0, 0
1407, 1, 1636427218542, 1636427218633, 91, 0, 91, 0, 0, 0
1406, 1, 1636427218649, 1636427218742, 93, 1, 92, 1, 0, 1
1408, 1, 1636427218854, 1636427218946, 92, 0, 92, 0, 0, 0
1409, 1, 1636427219005, 1636427219097, 92, 1, 91, 0, 1, 1
1410, 1, 1636427219329, 1636427219421, 92, 1, 91, 0, 1, 1
1411, 1, 1636427219401, 1636427219494, 93, 1, 92, 0, 0, 0
1412, 1, 1636427219465, 1636427219557, 92, 1, 91, 0, 0, 0
1413, 1, 1636427219649, 1636427219741, 92, 1, 91, 1, 0, 1
1415, 1, 1636427219778, 1636427219874, 96, 1, 95, 0, 0, 0
1414, 1, 1636427219853, 1636427219946, 93, 1, 92, 0, 0, 0
1416, 1, 1636427219874, 1636427219965, 91, 0, 91, 0, 0, 0
1417, 1, 1636427220422, 1636427220514, 92, 0, 92, 0, 0, 0
1418, 1, 1636427220486, 1636427220578, 92, 0, 92, 0, 0, 0
1419, 1, 1636427220594, 1636427220690, 96, 0, 96, 0, 0, 0
1420, 1, 1636427220674, 1636427220765, 91, 0, 91, 0, 0, 0
1421, 1, 1636427221230, 1636427221322, 92, 0, 92, 0, 0, 0
1422, 1, 1636427221946, 1636427222037, 91, 0, 91, 0, 0, 0
1424, 1, 1636427222033, 1636427222122, 89, 1, 88, 1, 0, 1
1423, 1, 1636427222029, 1636427222122, 93, 0, 93, 0, 0, 0
1425, 1, 1636427222213, 1636427222305, 92, 0, 92, 0, 0, 0
1427, 1, 1636427222446, 1636427222538, 92, 0, 92, 0, 0, 0
1426, 1, 1636427222486, 1636427222578, 92, 0, 92, 0, 0, 0
1428, 1, 1636427222993, 1636427223086, 93, 1, 92, 0, 0, 0
1429, 1, 1636427222998, 1636427223094, 96, 0, 96, 0, 0, 0
1430, 1, 1636427223277, 1636427223370, 93, 1, 92, 1, 0, 1
1431, 1, 1636427223341, 1636427223433, 92, 1, 91, 1, 0, 1
1434, 1, 1636427223714, 1636427223806, 92, 0, 92, 0, 0, 0
1433, 1, 1636427223798, 1636427223889, 91, 0, 91, 0, 0, 0
1436, 1, 1636427223954, 1636427224046, 92, 0, 92, 0, 0, 0
1435, 1, 1636427224170, 1636427224261, 91, 0, 91, 0, 0, 0
1437, 1, 1636427224221, 1636427224306, 85, 0, 85, 0, 0, 0
1432, 1, 1636427224245, 1636427224334, 89, 0, 89, 0, 0, 0
1438, 1, 1636427224582, 1636427224674, 92, 0, 92, 0, 0, 0
1439, 1, 1636427224746, 1636427224837, 91, 0, 91, 0, 0, 0
1440, 1, 1636427224777, 1636427224870, 93, 1, 92, 1, 0, 1
1441, 1, 1636427225061, 1636427225154, 93, 1, 92, 0, 0, 0
1442, 1, 1636427226014, 1636427226105, 91, 0, 91, 0, 0, 0
1443, 1, 1636427226190, 1636427226281, 91, 0, 91, 0, 0, 0
1444, 1, 1636427226329, 1636427226421, 92, 1, 91, 0, 1, 1
1445, 1, 1636427226366, 1636427226458, 92, 0, 92, 0, 0, 0
1447, 1, 1636427226497, 1636427226590, 93, 1, 92, 0, 1, 1
1446, 1, 1636427226785, 1636427226878, 93, 1, 92, 0, 1, 1
1448, 1, 1636427227242, 1636427227333, 91, 0, 91, 0, 0, 0
1449, 1, 1636427227278, 1636427227369, 91, 0, 91, 0, 0, 0
1450, 1, 1636427227466, 1636427227557, 91, 0, 91, 0, 0, 0
1451, 1, 1636427227490, 1636427227582, 92, 0, 92, 0, 0, 0
1452, 1, 1636427227577, 1636427227669, 92, 1, 91, 1, 0, 1
1453, 1, 1636427227762, 1636427227854, 92, 0, 92, 0, 0, 0
1454, 1, 1636427227917, 1636427228010, 93, 1, 92, 0, 0, 0
1456, 1, 1636427228094, 1636427228185, 91, 0, 91, 0, 0, 0
1455, 1, 1636427228218, 1636427228310, 92, 0, 92, 0, 0, 0
1457, 1, 1636427228518, 1636427228609, 91, 0, 91, 0, 0, 0
1458, 1, 1636427228633, 1636427228726, 93, 1, 92, 1, 0, 1
1459, 1, 1636427228814, 1636427228905, 91, 0, 91, 0, 0, 0
1460, 1, 1636427228834, 1636427228926, 92, 0, 92, 0, 0, 0
1461, 1, 1636427228881, 1636427228973, 92, 0, 92, 0, 0, 0
1462, 1, 1636427229962, 1636427230054, 92, 0, 92, 0, 0, 0
1463, 1, 1636427230317, 1636427230409, 92, 1, 91, 1, 0, 1
1464, 1, 1636427230365, 1636427230457, 92, 0, 92, 0, 0, 0
1465, 1, 1636427230385, 1636427230473, 88, 1, 87, 0, 0, 0
1466, 1, 1636427230513, 1636427230606, 93, 1, 92, 0, 0, 0
1467, 1, 1636427230818, 1636427230909, 91, 0, 91, 0, 0, 0
1468, 1, 1636427231178, 1636427231273, 95, 0, 95, 0, 0, 0
1469, 1, 1636427231217, 1636427231313, 96, 1, 95, 1, 0, 1
1471, 1, 1636427231253, 1636427231346, 93, 1, 92, 1, 0, 1
1470, 1, 1636427231253, 1636427231346, 93, 1, 92, 1, 0, 1
1473, 1, 1636427231613, 1636427231705, 92, 1, 91, 1, 0, 1
1472, 1, 1636427231630, 1636427231721, 91, 0, 91, 0, 0, 0
1474, 1, 1636427231649, 1636427231741, 92, 1, 91, 0, 0, 0
1476, 1, 1636427232029, 1636427232121, 92, 0, 92, 0, 0, 0
1475, 1, 1636427232102, 1636427232193, 91, 0, 91, 0, 0, 0
1477, 1, 1636427232622, 1636427232713, 91, 0, 91, 0, 0, 0
1478, 1, 1636427232641, 1636427232734, 93, 1, 92, 0, 0, 0
1479, 1, 1636427232661, 1636427232754, 93, 1, 92, 0, 1, 1
1480, 1, 1636427232701, 1636427232790, 89, 1, 88, 0, 0, 0
1481, 1, 1636427232841, 1636427232934, 93, 1, 92, 1, 0, 1
1482, 1, 1636427234142, 1636427234237, 95, 0, 95, 0, 0, 0
1483, 1, 1636427234169, 1636427234261, 92, 0, 92, 0, 0, 0
1484, 1, 1636427234217, 1636427234309, 92, 0, 92, 0, 0, 0
1485, 1, 1636427234309, 1636427234401, 92, 1, 91, 0, 1, 1
1487, 1, 1636427234517, 1636427234605, 88, 1, 87, 0, 0, 0
1486, 1, 1636427234597, 1636427234689, 92, 1, 91, 0, 0, 0
1488, 1, 1636427234957, 1636427235045, 88, 0, 88, 0, 0, 0
1489, 1, 1636427235001, 1636427235093, 92, 1, 91, 1, 0, 1
1490, 1, 1636427235238, 1636427235330, 92, 0, 92, 0, 0, 0
1491, 1, 1636427235361, 1636427235453, 92, 1, 91, 0, 1, 1
1492, 1, 1636427235393, 1636427235485, 92, 1, 91, 0, 0, 0
1493, 1, 1636427235489, 1636427235582, 93, 0, 93, 0, 0, 0
1494, 1, 1636427235870, 1636427235962, 92, 0, 92, 0, 0, 0
1495, 1, 1636427235949, 1636427236042, 93, 1, 92, 1, 0, 1
1496, 1, 1636427236173, 1636427236265, 92, 1, 91, 0, 1, 1
1497, 1, 1636427236313, 1636427236406, 93, 0, 93, 0, 0, 0
1498, 1, 1636427236453, 1636427236541, 88, 1, 87, 0, 0, 0
1499, 1, 1636427236482, 1636427236569, 87, 0, 87, 0, 0, 0
1500, 1, 1636427236522, 1636427236614, 92, 0, 92, 0, 0, 0
1501, 1, 1636427236725, 1636427236818, 93, 1, 92, 1, 0, 1
1502, 1, 1636427237913, 1636427238006, 93, 1, 92, 1, 0, 1
1503, 1, 1636427238006, 1636427238098, 92, 0, 92, 0, 0, 0
1504, 1, 1636427238130, 1636427238221, 91, 0, 91, 0, 0, 0
1505, 1, 1636427238217, 1636427238309, 92, 1, 91, 1, 0, 1
1506, 1, 1636427238457, 1636427238550, 93, 1, 92, 0, 0, 0
1507, 1, 1636427238633, 1636427238725, 92, 1, 91, 0, 0, 0
1508, 1, 1636427238837, 1636427238929, 92, 1, 91, 0, 0, 0
1509, 1, 1636427238953, 1636427239045, 92, 1, 91, 0, 0, 0
1510, 1, 1636427238970, 1636427239062, 92, 0, 92, 0, 0, 0
1511, 1, 1636427239214, 1636427239305, 91, 0, 91, 0, 0, 0
1512, 1, 1636427239254, 1636427239349, 95, 0, 95, 0, 0, 0
1513, 1, 1636427239458, 1636427239554, 96, 0, 96, 0, 0, 0
1514, 1, 1636427239577, 1636427239670, 93, 1, 92, 0, 0, 0
1515, 1, 1636427239913, 1636427240006, 93, 1, 92, 0, 0, 0
1516, 1, 1636427240018, 1636427240109, 91, 0, 91, 0, 0, 0
1517, 1, 1636427240145, 1636427240233, 88, 1, 87, 1, 0, 1
1518, 1, 1636427240330, 1636427240421, 91, 0, 91, 0, 0, 0
1519, 1, 1636427240366, 1636427240457, 91, 0, 91, 0, 0, 0
1520, 1, 1636427240774, 1636427240865, 91, 0, 91, 0, 0, 0
1521, 1, 1636427240998, 1636427241089, 91, 0, 91, 0, 0, 0
1522, 1, 1636427242029, 1636427242121, 92, 1, 91, 0, 1, 1
1523, 1, 1636427242033, 1636427242125, 92, 1, 91, 1, 0, 1
1524, 1, 1636427242166, 1636427242257, 91, 0, 91, 0, 0, 0
1526, 1, 1636427242362, 1636427242454, 92, 0, 92, 0, 0, 0
1527, 1, 1636427242369, 1636427242457, 88, 1, 87, 0, 0, 0
1525, 1, 1636427242481, 1636427242574, 93, 1, 92, 0, 0, 0
1528, 1, 1636427242838, 1636427242930, 92, 0, 92, 0, 0, 0
1529, 1, 1636427243037, 1636427243129, 92, 1, 91, 1, 0, 1
1530, 1, 1636427243078, 1636427243170, 92, 0, 92, 0, 0, 0
1531, 1, 1636427243245, 1636427243337, 92, 1, 91, 0, 1, 1
1532, 1, 1636427243282, 1636427243373, 91, 0, 91, 0, 0, 0
1533, 1, 1636427243421, 1636427243510, 89, 0, 89, 0, 0, 0
1535, 1, 1636427243853, 1636427243946, 93, 1, 92, 0, 0, 0
1536, 1, 1636427243877, 1636427243965, 88, 1, 87, 0, 1, 1
1534, 1, 1636427243874, 1636427243965, 91, 0, 91, 0, 0, 0
1538, 1, 1636427244122, 1636427244214, 92, 0, 92, 0, 0, 0
1537, 1, 1636427244329, 1636427244422, 93, 0, 93, 0, 0, 0
1539, 1, 1636427244361, 1636427244454, 93, 0, 93, 0, 0, 0
1540, 1, 1636427244549, 1636427244642, 93, 1, 92, 0, 1, 1
1541, 1, 1636427245258, 1636427245350, 92, 0, 92, 0, 0, 0
1542, 1, 1636427245837, 1636427245930, 93, 1, 92, 0, 0, 0
1543, 1, 1636427246086, 1636427246177, 91, 0, 91, 0, 0, 0
1544, 1, 1636427246357, 1636427246449, 92, 0, 92, 0, 0, 0
1545, 1, 1636427246426, 1636427246518, 92, 0, 92, 0, 0, 0
1546, 1, 1636427246506, 1636427246598, 92, 0, 92, 0, 0, 0
1547, 1, 1636427246689, 1636427246782, 93, 1, 92, 0, 0, 0
1548, 1, 1636427246769, 1636427246862, 93, 1, 92, 0, 1, 1
1549, 1, 1636427247141, 1636427247229, 88, 1, 87, 0, 0, 0
1550, 1, 1636427247182, 1636427247273, 91, 0, 91, 0, 0, 0
1551, 1, 1636427247241, 1636427247334, 93, 0, 93, 0, 0, 0
1552, 1, 1636427247485, 1636427247578, 93, 1, 92, 0, 0, 0
1554, 1, 1636427247541, 1636427247629, 88, 1, 87, 1, 0, 1
1555, 1, 1636427247809, 1636427247902, 93, 1, 92, 0, 1, 1
1553, 1, 1636427247941, 1636427248037, 96, 0, 96, 0, 0, 0
1556, 1, 1636427247986, 1636427248078, 92, 0, 92, 0, 0, 0
1557, 1, 1636427248154, 1636427248246, 92, 0, 92, 0, 0, 0
1559, 1, 1636427248321, 1636427248414, 93, 0, 93, 0, 0, 0
1558, 1, 1636427248397, 1636427248490, 93, 1, 92, 0, 0, 0
1560, 1, 1636427248434, 1636427248525, 91, 0, 91, 0, 0, 0
1561, 1, 1636427248937, 1636427249030, 93, 1, 92, 0, 0, 0
1562, 1, 1636427249942, 1636427250034, 92, 0, 92, 0, 0, 0
1563, 1, 1636427250113, 1636427250202, 89, 0, 89, 0, 0, 0
1564, 1, 1636427250157, 1636427250249, 92, 0, 92, 0, 0, 0
1565, 1, 1636427250610, 1636427250702, 92, 0, 92, 0, 0, 0
1566, 1, 1636427250657, 1636427250749, 92, 0, 92, 0, 0, 0
1567, 1, 1636427250782, 1636427250874, 92, 0, 92, 0, 0, 0
1568, 1, 1636427250869, 1636427250962, 93, 1, 92, 0, 0, 0
1569, 1, 1636427251274, 1636427251366, 92, 0, 92, 0, 0, 0
1570, 1, 1636427251338, 1636427251430, 92, 0, 92, 0, 0, 0
1572, 1, 1636427251373, 1636427251465, 92, 0, 92, 0, 0, 0
1573, 1, 1636427251437, 1636427251529, 92, 1, 91, 0, 0, 0
1574, 1, 1636427251445, 1636427251533, 88, 1, 87, 1, 0, 1
1571, 1, 1636427251730, 1636427251822, 92, 0, 92, 0, 0, 0
1575, 1, 1636427251793, 1636427251886, 93, 1, 92, 0, 1, 1
1576, 1, 1636427251822, 1636427251913, 91, 0, 91, 0, 0, 0
1577, 1, 1636427251978, 1636427252069, 91, 0, 91, 0, 0, 0
1578, 1, 1636427252213, 1636427252305, 92, 1, 91, 0, 0, 0
1579, 1, 1636427252606, 1636427252697, 91, 0, 91, 0, 0, 0
1580, 1, 1636427252641, 1636427252734, 93, 1, 92, 0, 0, 0
1581, 1, 1636427252818, 1636427252909, 91, 0, 91, 0, 0, 0
1582, 1, 1636427253638, 1636427253730, 92, 0, 92, 0, 0, 0
1583, 1, 1636427253990, 1636427254081, 91, 0, 91, 0, 0, 0
1584, 1, 1636427254105, 1636427254198, 93, 0, 93, 0, 0, 0
1586, 1, 1636427254477, 1636427254570, 93, 1, 92, 0, 0, 0
1585, 1, 1636427254562, 1636427254654, 92, 0, 92, 0, 0, 0
1587, 1, 1636427254782, 1636427254874, 92, 0, 92, 0, 0, 0
1588, 1, 1636427254906, 1636427254997, 91, 0, 91, 0, 0, 0
1589, 1, 1636427254970, 1636427255061, 91, 0, 91, 0, 0, 0
1590, 1, 1636427255158, 1636427255249, 91, 0, 91, 0, 0, 0
1591, 1, 1636427255261, 1636427255353, 92, 1, 91, 1, 0, 1
1593, 1, 1636427255393, 1636427255486, 93, 1, 92, 0, 0, 0
1594, 1, 1636427255418, 1636427255510, 92, 0, 92, 0, 0, 0
1592, 1, 1636427255425, 1636427255517, 92, 1, 91, 0, 0, 0
1595, 1, 1636427255618, 1636427255709, 91, 0, 91, 0, 0, 0
1596, 1, 1636427255813, 1636427255906, 93, 1, 92, 0, 0, 0
1597, 1, 1636427255909, 1636427256001, 92, 1, 91, 0, 1, 1
1598, 1, 1636427256286, 1636427256373, 87, 0, 87, 0, 0, 0
1599, 1, 1636427256602, 1636427256694, 92, 0, 92, 0, 0, 0
1600, 1, 1636427256678, 1636427256770, 92, 0, 92, 0, 0, 0
1601, 1, 1636427256762, 1636427256854, 92, 0, 92, 0, 0, 0
1602, 1, 1636427257698, 1636427257790, 92, 0, 92, 0, 0, 0
1603, 1, 1636427257910, 1636427258002, 92, 0, 92, 0, 0, 0
1604, 1, 1636427258157, 1636427258250, 93, 1, 92, 0, 1, 1
1605, 1, 1636427258614, 1636427258706, 92, 0, 92, 0, 0, 0
1606, 1, 1636427258686, 1636427258777, 91, 0, 91, 0, 0, 0
1607, 1, 1636427258793, 1636427258885, 92, 0, 92, 0, 0, 0
1608, 1, 1636427258801, 1636427258893, 92, 0, 92, 0, 0, 0
1610, 1, 1636427259245, 1636427259338, 93, 1, 92, 0, 0, 0
1609, 1, 1636427259245, 1636427259338, 93, 1, 92, 0, 0, 0
1611, 1, 1636427259425, 1636427259517, 92, 1, 91, 1, 0, 1
1612, 1, 1636427259458, 1636427259550, 92, 0, 92, 0, 0, 0
1614, 1, 1636427259597, 1636427259690, 93, 1, 92, 0, 1, 1
1613, 1, 1636427259697, 1636427259789, 92, 1, 91, 0, 0, 0
1615, 1, 1636427259710, 1636427259802, 92, 0, 92, 0, 0, 0
1616, 1, 1636427259841, 1636427259930, 89, 1, 88, 0, 0, 0
1617, 1, 1636427260149, 1636427260245, 96, 1, 95, 0, 1, 1
1618, 1, 1636427260322, 1636427260414, 92, 0, 92, 0, 0, 0
1619, 1, 1636427260465, 1636427260558, 93, 1, 92, 1, 0, 1
1620, 1, 1636427260809, 1636427260902, 93, 1, 92, 1, 0, 1
1621, 1, 1636427260925, 1636427261017, 92, 1, 91, 0, 0, 0
1622, 1, 1636427261402, 1636427261494, 92, 0, 92, 0, 0, 0
1623, 1, 1636427261874, 1636427261966, 92, 0, 92, 0, 0, 0
1624, 1, 1636427262445, 1636427262538, 93, 1, 92, 0, 0, 0
1626, 1, 1636427262638, 1636427262729, 91, 0, 91, 0, 0, 0
1627, 1, 1636427262673, 1636427262770, 97, 1, 96, 1, 0, 1
1625, 1, 1636427262902, 1636427262993, 91, 0, 91, 0, 0, 0
1628, 1, 1636427262929, 1636427263022, 93, 1, 92, 0, 0, 0
1629, 1, 1636427263009, 1636427263102, 93, 1, 92, 1, 0, 1
1630, 1, 1636427263125, 1636427263217, 92, 1, 91, 0, 0, 0
1631, 1, 1636427263281, 1636427263374, 93, 1, 92, 0, 1, 1
1632, 1, 1636427263461, 1636427263553, 92, 1, 91, 0, 1, 1
1633, 1, 1636427263534, 1636427263621, 87, 0, 87, 0, 0, 0
1634, 1, 1636427263553, 1636427263645, 92, 1, 91, 1, 0, 1
1635, 1, 1636427263698, 1636427263789, 91, 0, 91, 0, 0, 0
1636, 1, 1636427263781, 1636427263869, 88, 1, 87, 1, 0, 1
1637, 1, 1636427263906, 1636427263998, 92, 0, 92, 0, 0, 0
1638, 1, 1636427264146, 1636427264238, 92, 0, 92, 0, 0, 0
1639, 1, 1636427264382, 1636427264474, 92, 0, 92, 0, 0, 0
1640, 1, 1636427264805, 1636427264898, 93, 0, 93, 0, 0, 0
1641, 1, 1636427264922, 1636427265014, 92, 0, 92, 0, 0, 0
1642, 1, 1636427265314, 1636427265406, 92, 0, 92, 0, 0, 0
1643, 1, 1636427265626, 1636427265718, 92, 0, 92, 0, 0, 0
1644, 1, 1636427266421, 1636427266510, 89, 0, 89, 0, 0, 0
1645, 1, 1636427266441, 1636427266534, 93, 0, 93, 0, 0, 0
1647, 1, 1636427266753, 1636427266846, 93, 1, 92, 0, 0, 0
1646, 1, 1636427266874, 1636427266965, 91, 0, 91, 0, 0, 0
1648, 1, 1636427266910, 1636427267002, 92, 0, 92, 0, 0, 0
1649, 1, 1636427266925, 1636427267022, 97, 0, 97, 0, 0, 0
1650, 1, 1636427267166, 1636427267254, 88, 0, 88, 0, 0, 0
1651, 1, 1636427267278, 1636427267370, 92, 0, 92, 0, 0, 0
1652, 1, 1636427267370, 1636427267461, 91, 0, 91, 0, 0, 0
1653, 1, 1636427267477, 1636427267565, 88, 1, 87, 0, 1, 1
1654, 1, 1636427267513, 1636427267606, 93, 1, 92, 0, 0, 0
1655, 1, 1636427267529, 1636427267622, 93, 1, 92, 0, 1, 1
1656, 1, 1636427267685, 1636427267774, 89, 1, 88, 0, 0, 0
1657, 1, 1636427267773, 1636427267866, 93, 1, 92, 0, 0, 0
1658, 1, 1636427268006, 1636427268097, 91, 0, 91, 0, 0, 0
1659, 1, 1636427268465, 1636427268558, 93, 0, 93, 0, 0, 0
1660, 1, 1636427268469, 1636427268562, 93, 0, 93, 0, 0, 0
1661, 1, 1636427268733, 1636427268826, 93, 1, 92, 0, 0, 0
1662, 1, 1636427269401, 1636427269494, 93, 1, 92, 1, 0, 1
1663, 1, 1636427269405, 1636427269498, 93, 1, 92, 0, 0, 0
1664, 1, 1636427270109, 1636427270202, 93, 1, 92, 0, 0, 0
1666, 1, 1636427270393, 1636427270481, 88, 1, 87, 0, 0, 0
1667, 1, 1636427270533, 1636427270626, 93, 1, 92, 0, 1, 1
1665, 1, 1636427270566, 1636427270658, 92, 0, 92, 0, 0, 0
1668, 1, 1636427270778, 1636427270870, 92, 0, 92, 0, 0, 0
1669, 1, 1636427271009, 1636427271101, 92, 1, 91, 0, 0, 0
1670, 1, 1636427271105, 1636427271198, 93, 1, 92, 0, 0, 0
1671, 1, 1636427271237, 1636427271330, 93, 1, 92, 1, 0, 1
1672, 1, 1636427271253, 1636427271345, 92, 1, 91, 1, 0, 1
1673, 1, 1636427271301, 1636427271389, 88, 1, 87, 0, 0, 0
1674, 1, 1636427271353, 1636427271445, 92, 1, 91, 0, 0, 0
1675, 1, 1636427271477, 1636427271570, 93, 1, 92, 0, 1, 1
1676, 1, 1636427271602, 1636427271694, 92, 0, 92, 0, 0, 0
1677, 1, 1636427271782, 1636427271870, 88, 0, 88, 0, 0, 0
1678, 1, 1636427272313, 1636427272405, 92, 1, 91, 1, 0, 1
1679, 1, 1636427272330, 1636427272422, 92, 0, 92, 0, 0, 0
1680, 1, 1636427272354, 1636427272445, 91, 0, 91, 0, 0, 0
1681, 1, 1636427272526, 1636427272618, 92, 0, 92, 0, 0, 0
1682, 1, 1636427273242, 1636427273334, 92, 0, 92, 0, 0, 0
1683, 1, 1636427273614, 1636427273706, 92, 0, 92, 0, 0, 0
1684, 1, 1636427274349, 1636427274442, 93, 1, 92, 0, 1, 1
1686, 1, 1636427274469, 1636427274562, 93, 0, 93, 0, 0, 0
1687, 1, 1636427274742, 1636427274834, 92, 0, 92, 0, 0, 0
1685, 1, 1636427274806, 1636427274897, 91, 0, 91, 0, 0, 0
1688, 1, 1636427274933, 1636427275025, 92, 1, 91, 0, 1, 1
1689, 1, 1636427275037, 1636427275130, 93, 1, 92, 0, 0, 0
1690, 1, 1636427275269, 1636427275361, 92, 0, 92, 0, 0, 0
1691, 1, 1636427275281, 1636427275374, 93, 1, 92, 1, 0, 1
1692, 1, 1636427275314, 1636427275405, 91, 0, 91, 0, 0, 0
1693, 1, 1636427275374, 1636427275465, 91, 1, 90, 0, 0, 0
1694, 1, 1636427275374, 1636427275466, 92, 1, 91, 0, 1, 1
1695, 1, 1636427275521, 1636427275614, 93, 1, 92, 1, 0, 1
1696, 1, 1636427275826, 1636427275918, 92, 0, 92, 0, 0, 0
1697, 1, 1636427275853, 1636427275946, 93, 1, 92, 0, 0, 0
1698, 1, 1636427276293, 1636427276385, 92, 1, 91, 0, 0, 0
1699, 1, 1636427276309, 1636427276401, 92, 1, 91, 0, 0, 0
1700, 1, 1636427276453, 1636427276545, 92, 1, 91, 1, 0, 1
1701, 1, 1636427276770, 1636427276862, 92, 0, 92, 0, 0, 0
1702, 1, 1636427277394, 1636427277486, 92, 0, 92, 0, 0, 0
1703, 1, 1636427277758, 1636427277850, 92, 0, 92, 0, 0, 0
1704, 1, 1636427278154, 1636427278246, 92, 0, 92, 0, 0, 0
1706, 1, 1636427278325, 1636427278414, 89, 1, 88, 0, 1, 1
1705, 1, 1636427278614, 1636427278702, 88, 0, 88, 0, 0, 0
1707, 1, 1636427279045, 1636427279133, 88, 1, 87, 1, 0, 1
1708, 1, 1636427279066, 1636427279157, 91, 0, 91, 0, 0, 0
1709, 1, 1636427279181, 1636427279274, 93, 1, 92, 0, 0, 0
1710, 1, 1636427279265, 1636427279357, 92, 1, 91, 0, 1, 1
1711, 1, 1636427279274, 1636427279361, 87, 0, 87, 0, 0, 0
1712, 1, 1636427279297, 1636427279389, 92, 1, 91, 1, 0, 1
1713, 1, 1636427279337, 1636427279430, 93, 1, 92, 0, 1, 1
1714, 1, 1636427279493, 1636427279589, 96, 1, 95, 0, 0, 0
1715, 1, 1636427279773, 1636427279866, 93, 1, 92, 1, 0, 1
1716, 1, 1636427279802, 1636427279890, 88, 0, 88, 0, 0, 0
1717, 1, 1636427279970, 1636427280057, 87, 0, 87, 0, 0, 0
1718, 1, 1636427280001, 1636427280098, 97, 0, 97, 0, 0, 0
1719, 1, 1636427280345, 1636427280438, 93, 1, 92, 1, 0, 1
1720, 1, 1636427280494, 1636427280585, 91, 0, 91, 0, 0, 0
1721, 1, 1636427280721, 1636427280813, 92, 1, 91, 1, 0, 1
1722, 1, 1636427281514, 1636427281606, 92, 0, 92, 0, 0, 0
1723, 1, 1636427281978, 1636427282069, 91, 0, 91, 0, 0, 0
1724, 1, 1636427282017, 1636427282110, 93, 1, 92, 0, 0, 0
1725, 1, 1636427282294, 1636427282385, 91, 0, 91, 0, 0, 0
1726, 1, 1636427282750, 1636427282842, 92, 0, 92, 0, 0, 0
1727, 1, 1636427282981, 1636427283074, 93, 1, 92, 0, 1, 1
1728, 1, 1636427283074, 1636427283165, 91, 0, 91, 0, 0, 0
1729, 1, 1636427283202, 1636427283298, 96, 0, 96, 0, 0, 0
1730, 1, 1636427283357, 1636427283450, 93, 1, 92, 1, 0, 1
1731, 1, 1636427283497, 1636427283590, 93, 1, 92, 0, 0, 0
1732, 1, 1636427283510, 1636427283601, 91, 0, 91, 0, 0, 0
1733, 1, 1636427283545, 1636427283633, 88, 0, 88, 0, 0, 0
1734, 1, 1636427283590, 1636427283677, 87, 0, 87, 0, 0, 0
1735, 1, 1636427283665, 1636427283757, 92, 0, 92, 0, 0, 0
1736, 1, 1636427283710, 1636427283802, 92, 0, 92, 0, 0, 0
1737, 1, 1636427283966, 1636427284058, 92, 0, 92, 0, 0, 0
1738, 1, 1636427284073, 1636427284166, 93, 1, 92, 0, 0, 0
1739, 1, 1636427284114, 1636427284206, 92, 0, 92, 0, 0, 0
1740, 1, 1636427284722, 1636427284814, 92, 0, 92, 0, 0, 0
1741, 1, 1636427284910, 1636427285002, 92, 0, 92, 0, 0, 0
1742, 1, 1636427285682, 1636427285774, 92, 0, 92, 0, 0, 0
1743, 1, 1636427285909, 1636427286002, 93, 1, 92, 0, 0, 0
1744, 1, 1636427286178, 1636427286270, 92, 0, 92, 0, 0, 0
1746, 1, 1636427286293, 1636427286386, 93, 0, 93, 0, 0, 0
1745, 1, 1636427286638, 1636427286730, 92, 0, 92, 0, 0, 0
1747, 1, 1636427286889, 1636427286981, 92, 1, 91, 0, 0, 0
1748, 1, 1636427287025, 1636427287118, 93, 1, 92, 0, 1, 1
1749, 1, 1636427287105, 1636427287197, 92, 0, 92, 0, 0, 0
1750, 1, 1636427287146, 1636427287238, 92, 0, 92, 0, 0, 0
1751, 1, 1636427287226, 1636427287318, 92, 0, 92, 0, 0, 0
1752, 1, 1636427287329, 1636427287422, 93, 1, 92, 0, 0, 0
1753, 1, 1636427287422, 1636427287513, 91, 0, 91, 0, 0, 0
1754, 1, 1636427287601, 1636427287694, 93, 1, 92, 1, 0, 1
1755, 1, 1636427287662, 1636427287754, 92, 0, 92, 0, 0, 0
1756, 1, 1636427287833, 1636427287926, 93, 1, 92, 0, 1, 1
1758, 1, 1636427288054, 1636427288146, 92, 0, 92, 0, 0, 0
1759, 1, 1636427288121, 1636427288214, 93, 1, 92, 1, 0, 1
1757, 1, 1636427288290, 1636427288382, 92, 0, 92, 0, 0, 0
1760, 1, 1636427288898, 1636427288990, 92, 0, 92, 0, 0, 0
1761, 1, 1636427289010, 1636427289102, 92, 0, 92, 0, 0, 0
1762, 1, 1636427289974, 1636427290066, 92, 0, 92, 0, 0, 0
1763, 1, 1636427289978, 1636427290066, 88, 0, 88, 0, 0, 0
1764, 1, 1636427290058, 1636427290146, 88, 0, 88, 0, 0, 0
1765, 1, 1636427290286, 1636427290381, 95, 0, 95, 0, 0, 0
1767, 1, 1636427290593, 1636427290686, 93, 1, 92, 0, 1, 1
1766, 1, 1636427290737, 1636427290830, 93, 1, 92, 1, 0, 1
1768, 1, 1636427290998, 1636427291089, 91, 0, 91, 0, 0, 0
1769, 1, 1636427291089, 1636427291181, 92, 1, 91, 1, 0, 1
1770, 1, 1636427291278, 1636427291374, 96, 0, 96, 0, 0, 0
1771, 1, 1636427291365, 1636427291458, 93, 0, 93, 0, 0, 0
1773, 1, 1636427291389, 1636427291481, 92, 1, 91, 0, 0, 0
1772, 1, 1636427291389, 1636427291481, 92, 1, 91, 1, 0, 1
1774, 1, 1636427291546, 1636427291637, 91, 0, 91, 0, 0, 0
1775, 1, 1636427291617, 1636427291709, 92, 0, 92, 0, 0, 0
1776, 1, 1636427291662, 1636427291754, 92, 0, 92, 0, 0, 0
1777, 1, 1636427292006, 1636427292098, 92, 0, 92, 0, 0, 0
1778, 1, 1636427292121, 1636427292213, 92, 0, 92, 0, 0, 0
1779, 1, 1636427292225, 1636427292318, 93, 1, 92, 0, 0, 0
1780, 1, 1636427293182, 1636427293274, 92, 0, 92, 0, 0, 0
1781, 1, 1636427293185, 1636427293274, 89, 1, 88, 1, 0, 1
1782, 1, 1636427293926, 1636427294014, 88, 0, 88, 0, 0, 0
1783, 1, 1636427294034, 1636427294126, 92, 0, 92, 0, 0, 0
1784, 1, 1636427294146, 1636427294238, 92, 0, 92, 0, 0, 0
1785, 1, 1636427294553, 1636427294646, 93, 1, 92, 0, 1, 1
1786, 1, 1636427294577, 1636427294665, 88, 0, 88, 0, 0, 0
1787, 1, 1636427294754, 1636427294845, 91, 0, 91, 0, 0, 0
1788, 1, 1636427295021, 1636427295114, 93, 1, 92, 1, 0, 1
1789, 1, 1636427295037, 1636427295129, 92, 1, 91, 1, 0, 1
1790, 1, 1636427295069, 1636427295161, 92, 0, 92, 0, 0, 0
1791, 1, 1636427295113, 1636427295206, 93, 1, 92, 0, 0, 0
1792, 1, 1636427295386, 1636427295482, 96, 0, 96, 0, 0, 0
1793, 1, 1636427295485, 1636427295577, 92, 1, 91, 0, 0, 0
1794, 1, 1636427295606, 1636427295697, 91, 0, 91, 0, 0, 0
1795, 1, 1636427295717, 1636427295810, 93, 1, 92, 1, 0, 1
1796, 1, 1636427295910, 1636427296002, 92, 0, 92, 0, 0, 0
1798, 1, 1636427296005, 1636427296097, 92, 1, 91, 0, 0, 0
1797, 1, 1636427296057, 1636427296150, 93, 1, 92, 1, 0, 1
1799, 1, 1636427296202, 1636427296294, 92, 0, 92, 0, 0, 0
1800, 1, 1636427297418, 1636427297510, 92, 0, 92, 0, 0, 0
1801, 1, 1636427297481, 1636427297574, 93, 1, 92, 0, 1, 1
1802, 1, 1636427297866, 1636427297958, 92, 0, 92, 0, 0, 0
1803, 1, 1636427298141, 1636427298230, 89, 1, 88, 0, 0, 0
1804, 1, 1636427298321, 1636427298413, 92, 1, 91, 1, 0, 1
1805, 1, 1636427298341, 1636427298434, 93, 1, 92, 0, 0, 0
1807, 1, 1636427298485, 1636427298577, 92, 1, 91, 0, 0, 0
1808, 1, 1636427298577, 1636427298669, 92, 1, 91, 0, 1, 1
1809, 1, 1636427298805, 1636427298893, 88, 1, 87, 0, 1, 1
1806, 1, 1636427298805, 1636427298893, 88, 0, 88, 0, 0, 0
1810, 1, 1636427299014, 1636427299105, 91, 0, 91, 0, 0, 0
1811, 1, 1636427299102, 1636427299194, 92, 0, 92, 0, 0, 0
1812, 1, 1636427299270, 1636427299362, 92, 0, 92, 0, 0, 0
1813, 1, 1636427299317, 1636427299409, 92, 0, 92, 0, 0, 0
1814, 1, 1636427299721, 1636427299813, 92, 0, 92, 0, 0, 0
1815, 1, 1636427299766, 1636427299857, 91, 0, 91, 0, 0, 0
1816, 1, 1636427299794, 1636427299885, 91, 0, 91, 0, 0, 0
1817, 1, 1636427299954, 1636427300045, 91, 0, 91, 0, 0, 0
1818, 1, 1636427299990, 1636427300082, 92, 0, 92, 0, 0, 0
1819, 1, 1636427300242, 1636427300334, 92, 0, 92, 0, 0, 0
1820, 1, 1636427301174, 1636427301266, 92, 0, 92, 0, 0, 0
1821, 1, 1636427302010, 1636427302101, 91, 0, 91, 0, 0, 0
1822, 1, 1636427302069, 1636427302162, 93, 1, 92, 0, 0, 0
1823, 1, 1636427302194, 1636427302286, 92, 0, 92, 0, 0, 0
1825, 1, 1636427302542, 1636427302629, 87, 0, 87, 0, 0, 0
1824, 1, 1636427302653, 1636427302745, 92, 1, 91, 1, 0, 1
1826, 1, 1636427302774, 1636427302866, 92, 0, 92, 0, 0, 0
1827, 1, 1636427302793, 1636427302885, 92, 1, 91, 0, 1, 1
1828, 1, 1636427302885, 1636427302977, 92, 1, 91, 1, 0, 1
1830, 1, 1636427303153, 1636427303246, 93, 0, 93, 0, 0, 0
1829, 1, 1636427303230, 1636427303322, 92, 0, 92, 0, 0, 0
1832, 1, 1636427303597, 1636427303689, 92, 1, 91, 1, 0, 1
1831, 1, 1636427303609, 1636427303702, 93, 1, 92, 0, 1, 1
1833, 1, 1636427303649, 1636427303741, 92, 1, 91, 1, 0, 1
1835, 1, 1636427303917, 1636427304009, 92, 0, 92, 0, 0, 0
1834, 1, 1636427304053, 1636427304142, 89, 0, 89, 0, 0, 0
1836, 1, 1636427304070, 1636427304162, 92, 0, 92, 0, 0, 0
1837, 1, 1636427304117, 1636427304209, 92, 0, 92, 0, 0, 0
1838, 1, 1636427305030, 1636427305122, 92, 0, 92, 0, 0, 0
1839, 1, 1636427305902, 1636427305994, 92, 0, 92, 0, 0, 0
1841, 1, 1636427306261, 1636427306354, 93, 1, 92, 0, 1, 1
1840, 1, 1636427306353, 1636427306446, 93, 1, 92, 0, 0, 0
1842, 1, 1636427306377, 1636427306469, 92, 1, 91, 0, 0, 0
1843, 1, 1636427306497, 1636427306589, 92, 1, 91, 0, 1, 1
1844, 1, 1636427306677, 1636427306766, 89, 1, 88, 0, 1, 1
1845, 1, 1636427306778, 1636427306874, 96, 0, 96, 0, 0, 0
1847, 1, 1636427306866, 1636427306954, 88, 0, 88, 0, 0, 0
1846, 1, 1636427306949, 1636427307042, 93, 1, 92, 0, 0, 0
1848, 1, 1636427307357, 1636427307449, 92, 1, 91, 0, 0, 0
1849, 1, 1636427307421, 1636427307518, 97, 1, 96, 0, 1, 1
1850, 1, 1636427307645, 1636427307738, 93, 1, 92, 0, 0, 0
1851, 1, 1636427307877, 1636427307969, 92, 1, 91, 0, 1, 1
1853, 1, 1636427307966, 1636427308057, 91, 0, 91, 0, 0, 0
1852, 1, 1636427308098, 1636427308190, 92, 0, 92, 0, 0, 0
1854, 1, 1636427308385, 1636427308478, 93, 1, 92, 0, 0, 0
1855, 1, 1636427308742, 1636427308834, 92, 0, 92, 0, 0, 0
1856, 1, 1636427310077, 1636427310169, 92, 1, 91, 0, 0, 0
1857, 1, 1636427310513, 1636427310609, 96, 1, 95, 0, 0, 0
1858, 1, 1636427310525, 1636427310613, 88, 0, 88, 0, 0, 0
1859, 1, 1636427310553, 1636427310641, 88, 0, 88, 0, 0, 0
1860, 1, 1636427310557, 1636427310649, 92, 1, 91, 0, 0, 0
1861, 1, 1636427310709, 1636427310801, 92, 1, 91, 1, 0, 1
1862, 1, 1636427310769, 1636427310861, 92, 1, 91, 0, 0, 0
1864, 1, 1636427310902, 1636427310994, 92, 0, 92, 0, 0, 0
1863, 1, 1636427311165, 1636427311257, 92, 1, 91, 0, 0, 0
1865, 1, 1636427311458, 1636427311554, 96, 0, 96, 0, 0, 0
1866, 1, 1636427311641, 1636427311733, 92, 0, 92, 0, 0, 0
1867, 1, 1636427311682, 1636427311774, 92, 0, 92, 0, 0, 0
1868, 1, 1636427311913, 1636427312005, 92, 1, 91, 0, 0, 0
1870, 1, 1636427312086, 1636427312178, 92, 0, 92, 0, 0, 0
1869, 1, 1636427312133, 1636427312225, 92, 0, 92, 0, 0, 0
1871, 1, 1636427312637, 1636427312730, 93, 0, 93, 0, 0, 0
1872, 1, 1636427313030, 1636427313122, 92, 0, 92, 0, 0, 0
1873, 1, 1636427314014, 1636427314106, 92, 0, 92, 0, 0, 0
1875, 1, 1636427314234, 1636427314326, 92, 0, 92, 0, 0, 0
1876, 1, 1636427314349, 1636427314441, 92, 1, 91, 0, 0, 0
1874, 1, 1636427314466, 1636427314557, 91, 0, 91, 0, 0, 0
1877, 1, 1636427314621, 1636427314713, 92, 1, 91, 1, 0, 1
1878, 1, 1636427314757, 1636427314849, 92, 1, 91, 0, 0, 0
1880, 1, 1636427314886, 1636427314973, 87, 0, 87, 0, 0, 0
1879, 1, 1636427314881, 1636427314973, 92, 1, 91, 0, 1, 1
1881, 1, 1636427315210, 1636427315302, 92, 0, 92, 0, 0, 0
1882, 1, 1636427315365, 1636427315457, 92, 1, 91, 0, 0, 0
1883, 1, 1636427315378, 1636427315469, 91, 0, 91, 0, 0, 0
1885, 1, 1636427315766, 1636427315857, 91, 0, 91, 0, 0, 0
1886, 1, 1636427315822, 1636427315913, 91, 0, 91, 0, 0, 0
1884, 1, 1636427315822, 1636427315914, 92, 0, 92, 0, 0, 0
1887, 1, 1636427316222, 1636427316314, 92, 0, 92, 0, 0, 0
1888, 1, 1636427316405, 1636427316497, 92, 1, 91, 1, 0, 1
1889, 1, 1636427316806, 1636427316898, 92, 0, 92, 0, 0, 0
1890, 1, 1636427318110, 1636427318201, 91, 0, 91, 0, 0, 0
1891, 1, 1636427318617, 1636427318713, 96, 0, 96, 0, 0, 0
1892, 1, 1636427318661, 1636427318749, 88, 0, 88, 0, 0, 0
1893, 1, 1636427318930, 1636427319017, 87, 0, 87, 0, 0, 0
1894, 1, 1636427318958, 1636427319050, 92, 0, 92, 0, 0, 0
1895, 1, 1636427318977, 1636427319069, 92, 0, 92, 0, 0, 0
1897, 1, 1636427319274, 1636427319366, 92, 0, 92, 0, 0, 0
1896, 1, 1636427319426, 1636427319518, 92, 0, 92, 0, 0, 0
1898, 1, 1636427319729, 1636427319822, 93, 0, 93, 0, 0, 0
1899, 1, 1636427319790, 1636427319882, 92, 0, 92, 0, 0, 0
1900, 1, 1636427319909, 1636427320005, 96, 0, 96, 0, 0, 0
1901, 1, 1636427320241, 1636427320337, 96, 0, 96, 0, 0, 0
1902, 1, 1636427320281, 1636427320374, 93, 0, 93, 0, 0, 0
1903, 1, 1636427321818, 1636427321910, 92, 0, 92, 0, 0, 0
1904, 1, 1636427322550, 1636427322637, 87, 0, 87, 0, 0, 0
1905, 1, 1636427322653, 1636427322746, 93, 1, 92, 1, 0, 1
1906, 1, 1636427322709, 1636427322802, 93, 0, 93, 0, 0, 0
1907, 1, 1636427323221, 1636427323313, 92, 1, 91, 0, 0, 0
1909, 1, 1636427323262, 1636427323353, 91, 0, 91, 0, 0, 0
1908, 1, 1636427323262, 1636427323353, 91, 0, 91, 0, 0, 0
1912, 1, 1636427323626, 1636427323717, 91, 0, 91, 0, 0, 0
1911, 1, 1636427323677, 1636427323770, 93, 1, 92, 0, 1, 1
1910, 1, 1636427323709, 1636427323802, 93, 1, 92, 0, 0, 0
1913, 1, 1636427324101, 1636427324189, 88, 1, 87, 0, 0, 0
1914, 1, 1636427324126, 1636427324218, 92, 0, 92, 0, 0, 0
1915, 1, 1636427324205, 1636427324298, 93, 1, 92, 1, 0, 1
1916, 1, 1636427325522, 1636427325614, 92, 0, 92, 0, 0, 0
1917, 1, 1636427326478, 1636427326570, 92, 0, 92, 0, 0, 0
1918, 1, 1636427326777, 1636427326870, 93, 1, 92, 1, 0, 1
1919, 1, 1636427326921, 1636427327014, 93, 1, 92, 1, 0, 1
1920, 1, 1636427326941, 1636427327034, 93, 1, 92, 0, 0, 0
1921, 1, 1636427327142, 1636427327234, 92, 0, 92, 0, 0, 0
1922, 1, 1636427327373, 1636427327465, 92, 0, 92, 0, 0, 0
1923, 1, 1636427327417, 1636427327510, 93, 1, 92, 0, 1, 1
1925, 1, 1636427327825, 1636427327917, 92, 0, 92, 0, 0, 0
1924, 1, 1636427327869, 1636427327962, 93, 0, 93, 0, 0, 0
1926, 1, 1636427328081, 1636427328174, 93, 1, 92, 1, 0, 1
1927, 1, 1636427329434, 1636427329526, 92, 0, 92, 0, 0, 0
1928, 1, 1636427330650, 1636427330745, 95, 0, 95, 0, 0, 0
1929, 1, 1636427330670, 1636427330761, 91, 0, 91, 0, 0, 0
1930, 1, 1636427330821, 1636427330913, 92, 1, 91, 0, 0, 0
1931, 1, 1636427330837, 1636427330929, 92, 1, 91, 1, 0, 1
1932, 1, 1636427330997, 1636427331090, 93, 1, 92, 0, 1, 1
1933, 1, 1636427331298, 1636427331390, 92, 0, 92, 0, 0, 0
1934, 1, 1636427331437, 1636427331530, 93, 1, 92, 0, 1, 1
1935, 1, 1636427331754, 1636427331845, 91, 0, 91, 0, 0, 0
1937, 1, 1636427331874, 1636427331966, 92, 0, 92, 0, 0, 0
1936, 1, 1636427331897, 1636427331989, 92, 1, 91, 0, 0, 0
1938, 1, 1636427333522, 1636427333614, 92, 0, 92, 0, 0, 0
1939, 1, 1636427334450, 1636427334537, 87, 0, 87, 0, 0, 0
1940, 1, 1636427334613, 1636427334705, 92, 1, 91, 0, 0, 0
1941, 1, 1636427334921, 1636427335014, 93, 1, 92, 1, 0, 1
1942, 1, 1636427334929, 1636427335017, 88, 0, 88, 0, 0, 0
1943, 1, 1636427334973, 1636427335065, 92, 1, 91, 0, 0, 0
1944, 1, 1636427335381, 1636427335474, 93, 1, 92, 1, 0, 1
1945, 1, 1636427335402, 1636427335494, 92, 0, 92, 0, 0, 0
1947, 1, 1636427335838, 1636427335930, 92, 0, 92, 0, 0, 0
1948, 1, 1636427335846, 1636427335937, 91, 0, 91, 0, 0, 0
1946, 1, 1636427335858, 1636427335949, 91, 0, 91, 0, 0, 0
1949, 1, 1636427337362, 1636427337454, 92, 0, 92, 0, 0, 0
1950, 1, 1636427338289, 1636427338382, 93, 1, 92, 0, 0, 0
1951, 1, 1636427338585, 1636427338677, 92, 1, 91, 0, 1, 1
1952, 1, 1636427338765, 1636427338858, 93, 1, 92, 1, 0, 1
1953, 1, 1636427339177, 1636427339269, 92, 1, 91, 0, 0, 0
1954, 1, 1636427339222, 1636427339314, 92, 0, 92, 0, 0, 0
1955, 1, 1636427339458, 1636427339550, 92, 0, 92, 0, 0, 0
1956, 1, 1636427339670, 1636427339762, 92, 0, 92, 0, 0, 0
1957, 1, 1636427339930, 1636427340021, 91, 0, 91, 0, 0, 0
1958, 1, 1636427341510, 1636427341602, 92, 0, 92, 0, 0, 0
1959, 1, 1636427342466, 1636427342558, 92, 0, 92, 0, 0, 0
1960, 1, 1636427342909, 1636427343001, 92, 1, 91, 0, 0, 0
1961, 1, 1636427342946, 1636427343037, 91, 0, 91, 0, 0, 0
1962, 1, 1636427343410, 1636427343502, 92, 0, 92, 0, 0, 0
1963, 1, 1636427343438, 1636427343530, 92, 0, 92, 0, 0, 0
1964, 1, 1636427343869, 1636427343962, 93, 1, 92, 0, 0, 0
1965, 1, 1636427343890, 1636427343982, 92, 0, 92, 0, 0, 0
1966, 1, 1636427345554, 1636427345646, 92, 0, 92, 0, 0, 0
1967, 1, 1636427346769, 1636427346857, 88, 1, 87, 0, 0, 0
1968, 1, 1636427346854, 1636427346946, 92, 0, 92, 0, 0, 0
1969, 1, 1636427346957, 1636427347050, 93, 1, 92, 1, 0, 1
1970, 1, 1636427347481, 1636427347573, 92, 1, 91, 0, 0, 0
1971, 1, 1636427347617, 1636427347714, 97, 0, 97, 0, 0, 0
1973, 1, 1636427348037, 1636427348129, 92, 0, 92, 0, 0, 0
1972, 1, 1636427348082, 1636427348174, 92, 0, 92, 0, 0, 0
1974, 1, 1636427350801, 1636427350894, 93, 1, 92, 0, 0, 0
1975, 1, 1636427351014, 1636427351105, 91, 0, 91, 0, 0, 0
1976, 1, 1636427351734, 1636427351826, 92, 0, 92, 0, 0, 0
1977, 1, 1636427352194, 1636427352285, 91, 0, 91, 0, 0, 0
1978, 1, 1636427354510, 1636427354602, 92, 0, 92, 0, 0, 0
1979, 1, 1636427354898, 1636427354990, 92, 0, 92, 0, 0, 0
1980, 1, 1636427355545, 1636427355638, 93, 1, 92, 1, 0, 1
1981, 1, 1636427356002, 1636427356094, 92, 0, 92, 0, 0, 0
1982, 1, 1636427358418, 1636427358510, 92, 0, 92, 0, 0, 0
1983, 1, 1636427358566, 1636427358657, 91, 0, 91, 0, 0, 0
1984, 1, 1636427359342, 1636427359434, 92, 0, 92, 0, 0, 0
1985, 1, 1636427359798, 1636427359890, 92, 0, 92, 0, 0, 0
1986, 1, 1636427362426, 1636427362518, 92, 0, 92, 0, 0, 0
1987, 1, 1636427362502, 1636427362594, 92, 0, 92, 0, 0, 0
1988, 1, 1636427363586, 1636427363674, 88, 0, 88, 0, 0, 0
1989, 1, 1636427364037, 1636427364130, 93, 1, 92, 0, 1, 1
1990, 1, 1636427366346, 1636427366438, 92, 0, 92, 0, 0, 0
1991, 1, 1636427366397, 1636427366490, 93, 1, 92, 0, 0, 0
1992, 1, 1636427367542, 1636427367634, 92, 0, 92, 0, 0, 0
1993, 1, 1636427367998, 1636427368089, 91, 0, 91, 0, 0, 0
1994, 1, 1636427370158, 1636427370250, 92, 0, 92, 0, 0, 0
1995, 1, 1636427371726, 1636427371818, 92, 0, 92, 0, 0, 0
1996, 1, 1636427372182, 1636427372274, 92, 0, 92, 0, 0, 0
1997, 1, 1636427375490, 1636427375582, 92, 0, 92, 0, 0, 0
1998, 1, 1636427375949, 1636427376041, 92, 1, 91, 0, 0, 0
1999, 1, 1636427379778, 1636427379870, 92, 0, 92, 0, 0, 0
2000, 1, 1636427380225, 1636427380318, 93, 1, 92, 0, 0, 0
2001, 1, 1636427507282, 1636427507374, 92, 0, 92, 0, 0, 0
2002, 1, 1636427511150, 1636427511242, 92, 0, 92, 0, 0, 0
2003, 1, 1636427515062, 1636427515154, 92, 0, 92, 0, 0, 0
2004, 1, 1636427519242, 1636427519334, 92, 0, 92, 0, 0, 0
2005, 1, 1636427523414, 1636427523506, 92, 0, 92, 0, 0, 0
2006, 1, 1636427527326, 1636427527418, 92, 0, 92, 0, 0, 0
2007, 1, 1636427531362, 1636427531454, 92, 0, 92, 0, 0, 0
2008, 1, 1636427535417, 1636427535510, 93, 1, 92, 1, 0, 1
2009, 1, 1636427539490, 1636427539582, 92, 0, 92, 0, 0, 0
2010, 1, 1636427543709, 1636427543802, 93, 1, 92, 1, 0, 1
2011, 1, 1636427547446, 1636427547538, 92, 0, 92, 0, 0, 0
2012, 1, 1636427551238, 1636427551330, 92, 0, 92, 0, 0, 0
2013, 1, 1636427555090, 1636427555182, 92, 0, 92, 0, 0, 0
2014, 1, 1636427559410, 1636427559502, 92, 0, 92, 0, 0, 0
2015, 1, 1636427563197, 1636427563290, 93, 1, 92, 1, 0, 1
2016, 1, 1636427567393, 1636427567486, 93, 1, 92, 0, 0, 0
2017, 1, 1636427571230, 1636427571322, 92, 0, 92, 0, 0, 0
2018, 1, 1636427575125, 1636427575218, 93, 1, 92, 0, 0, 0
2019, 1, 1636427579446, 1636427579538, 92, 0, 92, 0, 0, 0
2020, 1, 1636427583522, 1636427583613, 91, 0, 91, 0, 0, 0
2021, 1, 1636427587214, 1636427587306, 92, 0, 92, 0, 0, 0
2022, 1, 1636427591038, 1636427591130, 92, 0, 92, 0, 0, 0
2023, 1, 1636427605682, 1636427605774, 92, 0, 92, 0, 0, 0
2024, 1, 1636427606674, 1636427606766, 92, 0, 92, 0, 0, 0
2025, 1, 1636427607658, 1636427607750, 92, 0, 92, 0, 0, 0
2026, 1, 1636427608682, 1636427608774, 92, 0, 92, 0, 0, 0
2027, 1, 1636427609713, 1636427609806, 93, 1, 92, 0, 0, 0
2028, 1, 1636427610714, 1636427610801, 87, 0, 87, 0, 0, 0
2029, 1, 1636427611726, 1636427611818, 92, 0, 92, 0, 0, 0
2030, 1, 1636427612746, 1636427612838, 92, 0, 92, 0, 0, 0
2031, 1, 1636427613778, 1636427613870, 92, 0, 92, 0, 0, 0
2032, 1, 1636427614782, 1636427614873, 91, 0, 91, 0, 0, 0
2033, 1, 1636427615754, 1636427615845, 91, 0, 91, 0, 0, 0
2034, 1, 1636427616722, 1636427616814, 92, 0, 92, 0, 0, 0
2035, 1, 1636427617710, 1636427617802, 92, 0, 92, 0, 0, 0
2036, 1, 1636427618721, 1636427618814, 93, 0, 93, 0, 0, 0
2037, 1, 1636427619702, 1636427619794, 92, 0, 92, 0, 0, 0
2038, 1, 1636427620733, 1636427620826, 93, 1, 92, 0, 0, 0
2039, 1, 1636427621730, 1636427621822, 92, 0, 92, 0, 0, 0
2040, 1, 1636427622718, 1636427622809, 91, 0, 91, 0, 0, 0
2041, 1, 1636427623722, 1636427623814, 92, 0, 92, 0, 0, 0
2042, 1, 1636427624730, 1636427624822, 92, 0, 92, 0, 0, 0
2043, 1, 1636427625718, 1636427625810, 92, 0, 92, 0, 0, 0
2044, 1, 1636427626686, 1636427626778, 92, 0, 92, 0, 0, 0
2045, 1, 1636427627678, 1636427627770, 92, 0, 92, 0, 0, 0
2046, 1, 1636427628657, 1636427628750, 93, 1, 92, 1, 0, 1
2047, 1, 1636427629674, 1636427629766, 92, 0, 92, 0, 0, 0
2048, 1, 1636427630686, 1636427630778, 92, 0, 92, 0, 0, 0
2049, 1, 1636427631669, 1636427631762, 93, 1, 92, 0, 0, 0
2050, 1, 1636427632646, 1636427632737, 91, 0, 91, 0, 0, 0
2051, 1, 1636427633654, 1636427633746, 92, 0, 92, 0, 0, 0
2052, 1, 1636427634682, 1636427634774, 92, 0, 92, 0, 0, 0
2053, 1, 1636427635662, 1636427635754, 92, 0, 92, 0, 0, 0
2054, 1, 1636427636650, 1636427636742, 92, 0, 92, 0, 0, 0
2055, 1, 1636427637626, 1636427637718, 92, 0, 92, 0, 0, 0
2056, 1, 1636427638634, 1636427638726, 92, 0, 92, 0, 0, 0
2057, 1, 1636427639602, 1636427639694, 92, 0, 92, 0, 0, 0
2058, 1, 1636427640606, 1636427640698, 92, 0, 92, 0, 0, 0
2059, 1, 1636427641590, 1636427641682, 92, 0, 92, 0, 0, 0
2060, 1, 1636427642586, 1636427642678, 92, 0, 92, 0, 0, 0
2061, 1, 1636427643622, 1636427643714, 92, 0, 92, 0, 0, 0
2062, 1, 1636427644630, 1636427644722, 92, 0, 92, 0, 0, 0
2063, 1, 1636427645645, 1636427645737, 92, 1, 91, 0, 1, 1
2064, 1, 1636427646626, 1636427646717, 91, 0, 91, 0, 0, 0
2065, 1, 1636427647610, 1636427647702, 92, 0, 92, 0, 0, 0
2066, 1, 1636427648614, 1636427648706, 92, 0, 92, 0, 0, 0
2067, 1, 1636427649622, 1636427649714, 92, 0, 92, 0, 0, 0
2068, 1, 1636427650602, 1636427650694, 92, 0, 92, 0, 0, 0
2069, 1, 1636427651614, 1636427651706, 92, 0, 92, 0, 0, 0
2070, 1, 1636427652650, 1636427652742, 92, 0, 92, 0, 0, 0
2071, 1, 1636427653646, 1636427653738, 92, 0, 92, 0, 0, 0
2072, 1, 1636427654617, 1636427654710, 93, 1, 92, 0, 1, 1
2073, 1, 1636427655630, 1636427655722, 92, 0, 92, 0, 0, 0
2074, 1, 1636427656662, 1636427656754, 92, 0, 92, 0, 0, 0
2075, 1, 1636427657694, 1636427657786, 92, 0, 92, 0, 0, 0
2076, 1, 1636427658666, 1636427658758, 92, 0, 92, 0, 0, 0
2077, 1, 1636427659686, 1636427659778, 92, 0, 92, 0, 0, 0
2078, 1, 1636427660690, 1636427660782, 92, 0, 92, 0, 0, 0
2079, 1, 1636427661706, 1636427661798, 92, 0, 92, 0, 0, 0
2080, 1, 1636427662702, 1636427662793, 91, 0, 91, 0, 0, 0
2081, 1, 1636427663714, 1636427663806, 92, 0, 92, 0, 0, 0
2082, 1, 1636427664746, 1636427664838, 92, 0, 92, 0, 0, 0
2083, 1, 1636427665762, 1636427665854, 92, 0, 92, 0, 0, 0
2084, 1, 1636427666778, 1636427666869, 91, 0, 91, 0, 0, 0
2085, 1, 1636427667770, 1636427667862, 92, 0, 92, 0, 0, 0
2086, 1, 1636427668794, 1636427668886, 92, 0, 92, 0, 0, 0
2087, 1, 1636427669822, 1636427669914, 92, 0, 92, 0, 0, 0
2088, 1, 1636427670834, 1636427670926, 92, 0, 92, 0, 0, 0
2089, 1, 1636427671810, 1636427671902, 92, 0, 92, 0, 0, 0
2090, 1, 1636427672790, 1636427672882, 92, 0, 92, 0, 0, 0
2091, 1, 1636427673773, 1636427673865, 92, 1, 91, 0, 0, 0
2092, 1, 1636427674778, 1636427674870, 92, 0, 92, 0, 0, 0
2093, 1, 1636427675818, 1636427675910, 92, 0, 92, 0, 0, 0
2094, 1, 1636427676798, 1636427676889, 91, 0, 91, 0, 0, 0
2095, 1, 1636427677758, 1636427677850, 92, 0, 92, 0, 0, 0
2096, 1, 1636427678762, 1636427678854, 92, 0, 92, 0, 0, 0
2097, 1, 1636427679762, 1636427679854, 92, 0, 92, 0, 0, 0
2098, 1, 1636427680746, 1636427680838, 92, 0, 92, 0, 0, 0
2099, 1, 1636427681714, 1636427681806, 92, 0, 92, 0, 0, 0
2100, 1, 1636427682718, 1636427682810, 92, 0, 92, 0, 0, 0
2101, 1, 1636427683738, 1636427683830, 92, 0, 92, 0, 0, 0
2102, 1, 1636427684750, 1636427684842, 92, 0, 92, 0, 0, 0
2103, 1, 1636427685746, 1636427685838, 92, 0, 92, 0, 0, 0
2104, 1, 1636427686746, 1636427686838, 92, 0, 92, 0, 0, 0
2105, 1, 1636427687714, 1636427687806, 92, 0, 92, 0, 0, 0
2106, 1, 1636427688718, 1636427688810, 92, 0, 92, 0, 0, 0
2107, 1, 1636427689698, 1636427689790, 92, 0, 92, 0, 0, 0
2108, 1, 1636427690722, 1636427690813, 91, 0, 91, 0, 0, 0
2109, 1, 1636427691733, 1636427691826, 93, 1, 92, 0, 0, 0
2110, 1, 1636427692694, 1636427692786, 92, 0, 92, 0, 0, 0
2111, 1, 1636427693686, 1636427693778, 92, 0, 92, 0, 0, 0
2112, 1, 1636427694662, 1636427694753, 91, 0, 91, 0, 0, 0
2113, 1, 1636427695634, 1636427695726, 92, 0, 92, 0, 0, 0
2114, 1, 1636427696606, 1636427696698, 92, 0, 92, 0, 0, 0
2115, 1, 1636427697634, 1636427697726, 92, 0, 92, 0, 0, 0
2116, 1, 1636427698602, 1636427698694, 92, 0, 92, 0, 0, 0
2117, 1, 1636427699630, 1636427699722, 92, 0, 92, 0, 0, 0
2118, 1, 1636427700657, 1636427700749, 92, 1, 91, 0, 0, 0
2119, 1, 1636427701661, 1636427701754, 93, 1, 92, 0, 1, 1
2120, 1, 1636427702662, 1636427702754, 92, 0, 92, 0, 0, 0
2121, 1, 1636427703662, 1636427703754, 92, 0, 92, 0, 0, 0
2122, 1, 1636427704669, 1636427704762, 93, 1, 92, 1, 0, 1
2123, 1, 1636427742841, 1636427742934, 93, 1, 92, 1, 0, 1
2124, 1, 1636427743770, 1636427743862, 92, 0, 92, 0, 0, 0
2125, 1, 1636427744746, 1636427744838, 92, 0, 92, 0, 0, 0
2126, 1, 1636427745778, 1636427745870, 92, 0, 92, 0, 0, 0
2127, 1, 1636427746801, 1636427746894, 93, 0, 93, 0, 0, 0
2128, 1, 1636427747806, 1636427747898, 92, 0, 92, 0, 0, 0
2129, 1, 1636427748813, 1636427748906, 93, 1, 92, 1, 0, 1
2130, 1, 1636427749834, 1636427749926, 92, 0, 92, 0, 0, 0
2131, 1, 1636427750870, 1636427750961, 91, 0, 91, 0, 0, 0
2132, 1, 1636427751865, 1636427751958, 93, 1, 92, 0, 0, 0
2133, 1, 1636427752833, 1636427752922, 89, 0, 89, 0, 0, 0
2134, 1, 1636427753830, 1636427753922, 92, 0, 92, 0, 0, 0
2135, 1, 1636427754817, 1636427754910, 93, 1, 92, 1, 0, 1
2136, 1, 1636427755830, 1636427755922, 92, 0, 92, 0, 0, 0
2137, 1, 1636427756806, 1636427756897, 91, 0, 91, 0, 0, 0
2138, 1, 1636427757842, 1636427757934, 92, 0, 92, 0, 0, 0
2139, 1, 1636427758837, 1636427758930, 93, 1, 92, 0, 0, 0
2140, 1, 1636427759814, 1636427759906, 92, 0, 92, 0, 0, 0
2141, 1, 1636427760814, 1636427760905, 91, 0, 91, 0, 0, 0
2142, 1, 1636427761826, 1636427761918, 92, 0, 92, 0, 0, 0
2143, 1, 1636427762794, 1636427762886, 92, 0, 92, 0, 0, 0
2144, 1, 1636427763762, 1636427763854, 92, 0, 92, 0, 0, 0
2145, 1, 1636427764746, 1636427764838, 92, 0, 92, 0, 0, 0
2146, 1, 1636427765734, 1636427765826, 92, 0, 92, 0, 0, 0
2147, 1, 1636427766742, 1636427766834, 92, 0, 92, 0, 0, 0
2148, 1, 1636427767762, 1636427767854, 92, 0, 92, 0, 0, 0
2149, 1, 1636427768742, 1636427768834, 92, 0, 92, 0, 0, 0
2150, 1, 1636427769722, 1636427769813, 91, 0, 91, 0, 0, 0
2151, 1, 1636427770753, 1636427770846, 93, 1, 92, 0, 0, 0
2152, 1, 1636427771778, 1636427771870, 92, 0, 92, 0, 0, 0
2153, 1, 1636427772766, 1636427772858, 92, 0, 92, 0, 0, 0
2154, 1, 1636427773757, 1636427773850, 93, 1, 92, 1, 0, 1
2155, 1, 1636427774729, 1636427774822, 93, 1, 92, 0, 0, 0
2156, 1, 1636427775738, 1636427775830, 92, 0, 92, 0, 0, 0
2157, 1, 1636427776706, 1636427776798, 92, 0, 92, 0, 0, 0
2158, 1, 1636427777710, 1636427777802, 92, 0, 92, 0, 0, 0
2159, 1, 1636427778686, 1636427778774, 88, 0, 88, 0, 0, 0
2160, 1, 1636427779682, 1636427779774, 92, 0, 92, 0, 0, 0
2161, 1, 1636427780714, 1636427780806, 92, 0, 92, 0, 0, 0
2162, 1, 1636427781726, 1636427781818, 92, 0, 92, 0, 0, 0
2163, 1, 1636427782742, 1636427782834, 92, 0, 92, 0, 0, 0
2164, 1, 1636427783722, 1636427783814, 92, 0, 92, 0, 0, 0
2165, 1, 1636427784714, 1636427784805, 91, 0, 91, 0, 0, 0
2166, 1, 1636427785722, 1636427785818, 96, 0, 96, 0, 0, 0
2167, 1, 1636427786730, 1636427786822, 92, 0, 92, 0, 0, 0
2168, 1, 1636427787710, 1636427787802, 92, 0, 92, 0, 0, 0
2169, 1, 1636427788722, 1636427788814, 92, 0, 92, 0, 0, 0
2170, 1, 1636427789750, 1636427789842, 92, 0, 92, 0, 0, 0
2171, 1, 1636427790746, 1636427790838, 92, 0, 92, 0, 0, 0
2172, 1, 1636427791722, 1636427791813, 91, 0, 91, 0, 0, 0
2173, 1, 1636427792730, 1636427792821, 91, 0, 91, 0, 0, 0
2174, 1, 1636427793762, 1636427793854, 92, 0, 92, 0, 0, 0
2175, 1, 1636427794794, 1636427794886, 92, 0, 92, 0, 0, 0
2176, 1, 1636427795766, 1636427795858, 92, 0, 92, 0, 0, 0
2177, 1, 1636427796790, 1636427796882, 92, 0, 92, 0, 0, 0
2178, 1, 1636427797826, 1636427797918, 92, 0, 92, 0, 0, 0
2179, 1, 1636427798846, 1636427798938, 92, 0, 92, 0, 0, 0
2180, 1, 1636427799821, 1636427799914, 93, 0, 93, 0, 0, 0
2181, 1, 1636427800830, 1636427800922, 92, 0, 92, 0, 0, 0
2182, 1, 1636427801842, 1636427801934, 92, 0, 92, 0, 0, 0
2183, 1, 1636427802850, 1636427802942, 92, 0, 92, 0, 0, 0
2184, 1, 1636427803870, 1636427803962, 92, 0, 92, 0, 0, 0
2185, 1, 1636427804858, 1636427804950, 92, 0, 92, 0, 0, 0
2186, 1, 1636427805886, 1636427805978, 92, 0, 92, 0, 0, 0
2187, 1, 1636427806910, 1636427807001, 91, 0, 91, 0, 0, 0
2188, 1, 1636427807946, 1636427808038, 92, 0, 92, 0, 0, 0
2189, 1, 1636427808926, 1636427809018, 92, 0, 92, 0, 0, 0
2190, 1, 1636427809910, 1636427810002, 92, 0, 92, 0, 0, 0
2191, 1, 1636427810890, 1636427810982, 92, 0, 92, 0, 0, 0
2192, 1, 1636427811901, 1636427811993, 92, 1, 91, 1, 0, 1
2193, 1, 1636427812921, 1636427813013, 92, 1, 91, 0, 0, 0
2194, 1, 1636427813902, 1636427813994, 92, 0, 92, 0, 0, 0
2195, 1, 1636427814870, 1636427814962, 92, 0, 92, 0, 0, 0
2196, 1, 1636427815878, 1636427815970, 92, 0, 92, 0, 0, 0
2197, 1, 1636427816866, 1636427816958, 92, 0, 92, 0, 0, 0
2198, 1, 1636427817858, 1636427817950, 92, 0, 92, 0, 0, 0
2199, 1, 1636427818845, 1636427818938, 93, 1, 92, 1, 0, 1
2200, 1, 1636427819874, 1636427819966, 92, 0, 92, 0, 0, 0
2201, 1, 1636427820890, 1636427820982, 92, 0, 92, 0, 0, 0
2202, 1, 1636427821902, 1636427821994, 92, 0, 92, 0, 0, 0
2203, 1, 1636427822898, 1636427822990, 92, 0, 92, 0, 0, 0
2204, 1, 1636427823894, 1636427823986, 92, 0, 92, 0, 0, 0
2205, 1, 1636427824862, 1636427824954, 92, 0, 92, 0, 0, 0
2206, 1, 1636427825874, 1636427825966, 92, 0, 92, 0, 0, 0
2207, 1, 1636427826854, 1636427826946, 92, 0, 92, 0, 0, 0
2208, 1, 1636427827874, 1636427827966, 92, 0, 92, 0, 0, 0
2209, 1, 1636427828886, 1636427828978, 92, 0, 92, 0, 0, 0
2210, 1, 1636427829878, 1636427829970, 92, 0, 92, 0, 0, 0
2211, 1, 1636427830842, 1636427830934, 92, 0, 92, 0, 0, 0
2212, 1, 1636427831818, 1636427831910, 92, 0, 92, 0, 0, 0
2213, 1, 1636427832809, 1636427832902, 93, 0, 93, 0, 0, 0
2214, 1, 1636427833782, 1636427833873, 91, 0, 91, 0, 0, 0
2215, 1, 1636427834810, 1636427834902, 92, 0, 92, 0, 0, 0
2216, 1, 1636427835782, 1636427835874, 92, 0, 92, 0, 0, 0
2217, 1, 1636427836805, 1636427836898, 93, 1, 92, 0, 0, 0
2218, 1, 1636427837834, 1636427837926, 92, 0, 92, 0, 0, 0
2219, 1, 1636427838874, 1636427838966, 92, 0, 92, 0, 0, 0
2220, 1, 1636427839870, 1636427839962, 92, 0, 92, 0, 0, 0
2221, 1, 1636427840906, 1636427840998, 92, 0, 92, 0, 0, 0
2222, 1, 1636427841914, 1636427842002, 88, 0, 88, 0, 0, 0
