Xid, State, StartTime, EndTime, TransactionTime, ExecuteTime, CommunicationTime, ReadTime, WriteTime, DBTime
77, 1, 1636423690807, 1636423691314, 507, 89, 418, 32, 5, 37
80, 1, 1636423691658, 1636423692071, 413, 4, 409, 2, 1, 3
84, 1, 1636423692338, 1636423692750, 412, 4, 408, 2, 1, 3
87, 1, 1636423693018, 1636423693431, 413, 4, 409, 2, 0, 2
90, 1, 1636423693698, 1636423694107, 409, 4, 405, 0, 1, 1
93, 1, 1636423694374, 1636423694786, 412, 4, 408, 2, 0, 2
96, 1, 1636423695058, 1636423695466, 408, 3, 405, 0, 1, 1
99, 1, 1636423695734, 1636423696142, 408, 3, 405, 3, 0, 3
103, 1, 1636423696410, 1636423696830, 420, 4, 416, 1, 0, 1
106, 1, 1636423697102, 1636423697510, 408, 4, 404, 2, 0, 2
109, 1, 1636423697778, 1636423698186, 408, 4, 404, 1, 0, 1
112, 1, 1636423698454, 1636423698862, 408, 4, 404, 2, 0, 2
115, 1, 1636423699130, 1636423699538, 408, 2, 406, 0, 1, 1
118, 1, 1636423699810, 1636423700218, 408, 3, 405, 1, 0, 1
122, 1, 1636423700486, 1636423700894, 408, 3, 405, 1, 0, 1
125, 1, 1636423701162, 1636423701571, 409, 6, 403, 0, 1, 1
128, 1, 1636423701838, 1636423702202, 364, 3, 361, 0, 1, 1
131, 1, 1636423702474, 1636423702838, 364, 2, 362, 0, 1, 1
134, 1, 1636423703106, 1636423703466, 360, 1, 359, 0, 1, 1
137, 1, 1636423703734, 1636423704098, 364, 3, 361, 0, 1, 1
140, 1, 1636423704366, 1636423704730, 364, 2, 362, 1, 0, 1
143, 1, 1636423704994, 1636423705358, 364, 2, 362, 0, 0, 0
146, 1, 1636423705626, 1636423705990, 364, 2, 362, 0, 1, 1
149, 1, 1636423706254, 1636423706618, 364, 2, 362, 1, 0, 1
152, 1, 1636423706886, 1636423707250, 364, 2, 362, 0, 1, 1
155, 1, 1636423707518, 1636423707878, 360, 2, 358, 0, 0, 0
158, 1, 1636423708146, 1636423708510, 364, 1, 363, 0, 1, 1
161, 1, 1636423708782, 1636423709146, 364, 1, 363, 0, 1, 1
164, 1, 1636423709414, 1636423709778, 364, 3, 361, 0, 0, 0
167, 1, 1636423710046, 1636423710410, 364, 3, 361, 0, 0, 0
170, 1, 1636423710674, 1636423711038, 364, 2, 362, 0, 0, 0
173, 1, 1636423711306, 1636423711670, 364, 1, 363, 0, 0, 0
176, 1, 1636423711938, 1636423712302, 364, 2, 362, 0, 0, 0
179, 1, 1636423712570, 1636423712934, 364, 1, 363, 0, 0, 0
182, 1, 1636423713202, 1636423713566, 364, 0, 364, 0, 0, 0
185, 1, 1636423713834, 1636423714198, 364, 2, 362, 0, 0, 0
188, 1, 1636423714466, 1636423714826, 360, 1, 359, 0, 0, 0
191, 1, 1636423715094, 1636423715458, 364, 2, 362, 0, 0, 0
194, 1, 1636423715722, 1636423716082, 360, 1, 359, 0, 0, 0
197, 1, 1636423716350, 1636423716714, 364, 1, 363, 0, 0, 0
200, 1, 1636423716982, 1636423717342, 360, 1, 359, 0, 0, 0
203, 1, 1636423717610, 1636423717974, 364, 0, 364, 0, 0, 0
206, 1, 1636423718246, 1636423718610, 364, 2, 362, 0, 1, 1
209, 1, 1636423718882, 1636423719246, 364, 1, 363, 0, 0, 0
212, 1, 1636423719510, 1636423719874, 364, 0, 364, 0, 0, 0
215, 1, 1636423720142, 1636423720506, 364, 2, 362, 0, 0, 0
218, 1, 1636423720778, 1636423721142, 364, 1, 363, 0, 0, 0
221, 1, 1636423721406, 1636423721770, 364, 3, 361, 0, 0, 0
224, 1, 1636423722038, 1636423722402, 364, 1, 363, 0, 0, 0
227, 1, 1636423722670, 1636423723034, 364, 0, 364, 0, 0, 0
230, 1, 1636423723306, 1636423723670, 364, 1, 363, 0, 0, 0
233, 1, 1636423723938, 1636423724302, 364, 1, 363, 0, 0, 0
236, 1, 1636423724570, 1636423724934, 364, 1, 363, 0, 0, 0
239, 1, 1636423725202, 1636423725566, 364, 0, 364, 0, 0, 0
242, 1, 1636423725834, 1636423726198, 364, 1, 363, 0, 0, 0
245, 1, 1636423726466, 1636423726830, 364, 1, 363, 0, 0, 0
248, 1, 1636423727098, 1636423727462, 364, 0, 364, 0, 0, 0
251, 1, 1636423727730, 1636423728094, 364, 1, 363, 0, 0, 0
254, 1, 1636423728362, 1636423728722, 360, 0, 360, 0, 0, 0
257, 1, 1636423728990, 1636423729354, 364, 0, 364, 0, 0, 0
260, 1, 1636423729626, 1636423729990, 364, 1, 363, 0, 0, 0
263, 1, 1636423730258, 1636423730622, 364, 1, 363, 0, 0, 0
266, 1, 1636423730890, 1636423731258, 368, 1, 367, 0, 0, 0
269, 1, 1636423731526, 1636423731890, 364, 0, 364, 0, 0, 0
272, 1, 1636423732158, 1636423732521, 363, 5, 358, 3, 1, 4
275, 1, 1636423732786, 1636423733146, 360, 1, 359, 0, 0, 0
278, 1, 1636423733413, 1636423733774, 361, 1, 360, 1, 0, 1
281, 1, 1636423734042, 1636423734406, 364, 2, 362, 0, 0, 0
284, 1, 1636423734678, 1636423735042, 364, 1, 363, 0, 0, 0
287, 1, 1636423735310, 1636423735665, 355, 0, 355, 0, 0, 0
290, 1, 1636423735933, 1636423736290, 357, 1, 356, 0, 0, 0
293, 1, 1636423736558, 1636423736922, 364, 0, 364, 0, 0, 0
296, 1, 1636423737190, 1636423737554, 364, 0, 364, 0, 0, 0
299, 1, 1636423737822, 1636423738186, 364, 0, 364, 0, 0, 0
302, 1, 1636423738454, 1636423738818, 364, 1, 363, 0, 0, 0
305, 1, 1636423739086, 1636423739445, 359, 0, 359, 0, 0, 0
308, 1, 1636423739714, 1636423740074, 360, 2, 358, 0, 1, 1
311, 1, 1636423740337, 1636423740702, 365, 2, 363, 0, 0, 0
314, 1, 1636423740970, 1636423741338, 368, 2, 366, 0, 0, 0
317, 1, 1636423741613, 1636423741977, 364, 1, 363, 0, 1, 1
320, 1, 1636423742241, 1636423742614, 373, 2, 371, 1, 1, 2
323, 1, 1636423742881, 1636423743242, 361, 2, 359, 0, 0, 0
326, 1, 1636423743505, 1636423743862, 357, 2, 355, 1, 0, 1
329, 1, 1636423744125, 1636423744490, 365, 1, 364, 0, 1, 1
332, 1, 1636423744754, 1636423745110, 356, 1, 355, 0, 0, 0
335, 1, 1636423745378, 1636423745738, 360, 2, 358, 1, 0, 1
338, 1, 1636423746010, 1636423746378, 368, 0, 368, 0, 0, 0
341, 1, 1636423746650, 1636423747014, 364, 0, 364, 0, 0, 0
344, 1, 1636423747286, 1636423747650, 364, 0, 364, 0, 0, 0
347, 1, 1636423747918, 1636423748282, 364, 1, 363, 0, 0, 0
350, 1, 1636423748550, 1636423748910, 360, 0, 360, 0, 0, 0
353, 1, 1636423749178, 1636423749542, 364, 1, 363, 0, 0, 0
356, 1, 1636423749809, 1636423750173, 364, 1, 363, 0, 0, 0
359, 1, 1636423750442, 1636423750806, 364, 1, 363, 0, 0, 0
362, 1, 1636423751081, 1636423751450, 369, 1, 368, 1, 0, 1
365, 1, 1636423751722, 1636423752086, 364, 1, 363, 1, 0, 1
368, 1, 1636423752354, 1636423752718, 364, 1, 363, 0, 0, 0
371, 1, 1636423752981, 1636423753342, 361, 1, 360, 0, 0, 0
374, 1, 1636423753610, 1636423753974, 364, 1, 363, 0, 0, 0
377, 1, 1636423754250, 1636423754613, 363, 2, 361, 0, 0, 0
381, 1, 1636423754882, 1636423755246, 364, 0, 364, 0, 0, 0
384, 1, 1636423755518, 1636423755882, 364, 1, 363, 0, 0, 0
387, 1, 1636423756146, 1636423756506, 360, 1, 359, 0, 0, 0
390, 1, 1636423756770, 1636423757134, 364, 1, 363, 0, 0, 0
393, 1, 1636423757398, 1636423757766, 368, 0, 368, 0, 0, 0
396, 1, 1636423758030, 1636423758394, 364, 1, 363, 0, 0, 0
399, 1, 1636423758657, 1636423759026, 369, 2, 367, 0, 0, 0
402, 1, 1636423759294, 1636423759653, 359, 1, 358, 0, 0, 0
405, 1, 1636423759922, 1636423760281, 359, 0, 359, 0, 0, 0
408, 1, 1636423760546, 1636423760910, 364, 1, 363, 0, 0, 0
411, 1, 1636423761178, 1636423761541, 363, 0, 363, 0, 0, 0
414, 1, 1636423761806, 1636423762170, 364, 0, 364, 0, 0, 0
417, 1, 1636423762434, 1636423762797, 363, 1, 362, 0, 0, 0
420, 1, 1636423763066, 1636423763430, 364, 0, 364, 0, 0, 0
423, 1, 1636423763693, 1636423764058, 365, 2, 363, 1, 0, 1
426, 1, 1636423764326, 1636423764690, 364, 1, 363, 0, 0, 0
429, 1, 1636423764962, 1636423765326, 364, 0, 364, 0, 0, 0
432, 1, 1636423765590, 1636423765954, 364, 0, 364, 0, 0, 0
435, 1, 1636423766222, 1636423766586, 364, 0, 364, 0, 0, 0
438, 1, 1636423766854, 1636423767222, 368, 1, 367, 0, 0, 0
441, 1, 1636423767490, 1636423767850, 360, 0, 360, 0, 0, 0
444, 1, 1636423768118, 1636423768481, 363, 1, 362, 0, 0, 0
447, 1, 1636423768750, 1636423769114, 364, 1, 363, 0, 0, 0
450, 1, 1636423769377, 1636423769746, 369, 1, 368, 0, 0, 0
453, 1, 1636423770014, 1636423770378, 364, 0, 364, 0, 0, 0
456, 1, 1636423770646, 1636423771010, 364, 0, 364, 0, 0, 0
459, 1, 1636423771278, 1636423771630, 352, 0, 352, 0, 0, 0
462, 1, 1636423771898, 1636423772262, 364, 1, 363, 0, 0, 0
465, 1, 1636423772530, 1636423772894, 364, 1, 363, 0, 0, 0
468, 1, 1636423773162, 1636423773526, 364, 0, 364, 0, 0, 0
471, 1, 1636423773797, 1636423774162, 365, 1, 364, 0, 0, 0
474, 1, 1636423774430, 1636423774794, 364, 2, 362, 2, 0, 2
477, 1, 1636423775062, 1636423775426, 364, 1, 363, 0, 0, 0
480, 1, 1636423775694, 1636423776058, 364, 0, 364, 0, 0, 0
483, 1, 1636423776326, 1636423776690, 364, 1, 363, 1, 0, 1
486, 1, 1636423776958, 1636423777322, 364, 0, 364, 0, 0, 0
489, 1, 1636423777589, 1636423777954, 365, 1, 364, 0, 0, 0
492, 1, 1636423778222, 1636423778586, 364, 0, 364, 0, 0, 0
495, 1, 1636423778850, 1636423779205, 355, 0, 355, 0, 0, 0
498, 1, 1636423779473, 1636423779838, 365, 1, 364, 1, 0, 1
501, 1, 1636423780106, 1636423780470, 364, 1, 363, 0, 0, 0
504, 1, 1636423780738, 1636423781102, 364, 0, 364, 0, 0, 0
507, 1, 1636423781370, 1636423781734, 364, 1, 363, 0, 0, 0
510, 1, 1636423782002, 1636423782366, 364, 0, 364, 0, 0, 0
513, 1, 1636423782634, 1636423783002, 368, 0, 368, 0, 0, 0
516, 1, 1636423783270, 1636423783634, 364, 0, 364, 0, 0, 0
519, 1, 1636423783902, 1636423784266, 364, 0, 364, 0, 0, 0
522, 1, 1636423784534, 1636423784898, 364, 0, 364, 0, 0, 0
525, 1, 1636423785166, 1636423785530, 364, 2, 362, 0, 0, 0
527, 1, 1636423785798, 1636423786162, 364, 2, 362, 1, 0, 1
529, 1, 1636423786430, 1636423786794, 364, 1, 363, 0, 1, 1
531, 1, 1636423787061, 1636423787426, 365, 1, 364, 0, 0, 0
533, 1, 1636423787689, 1636423788053, 364, 1, 363, 0, 0, 0
535, 1, 1636423788321, 1636423788686, 365, 1, 364, 0, 0, 0
537, 1, 1636423788954, 1636423789318, 364, 0, 364, 0, 0, 0
539, 1, 1636423789586, 1636423789946, 360, 0, 360, 0, 0, 0
541, 1, 1636423790218, 1636423790582, 364, 0, 364, 0, 0, 0
543, 1, 1636423790850, 1636423791214, 364, 0, 364, 0, 0, 0
545, 1, 1636423791482, 1636423791842, 360, 0, 360, 0, 0, 0
547, 1, 1636423792109, 1636423792474, 365, 1, 364, 0, 0, 0
549, 1, 1636423792742, 1636423793106, 364, 0, 364, 0, 0, 0
551, 1, 1636423793374, 1636423793729, 355, 0, 355, 0, 0, 0
553, 1, 1636423793994, 1636423794358, 364, 0, 364, 0, 0, 0
555, 1, 1636423794626, 1636423794990, 364, 1, 363, 0, 0, 0
557, 1, 1636423795258, 1636423795622, 364, 0, 364, 0, 0, 0
559, 1, 1636423795886, 1636423796250, 364, 0, 364, 0, 0, 0
561, 1, 1636423796518, 1636423796882, 364, 0, 364, 0, 0, 0
563, 1, 1636423797158, 1636423797522, 364, 0, 364, 0, 0, 0
565, 1, 1636423797790, 1636423798154, 364, 0, 364, 0, 0, 0
567, 1, 1636423798422, 1636423798786, 364, 0, 364, 0, 0, 0
569, 1, 1636423799054, 1636423799421, 367, 0, 367, 0, 0, 0
571, 1, 1636423799689, 1636423800050, 361, 1, 360, 0, 0, 0
573, 1, 1636423800318, 1636423800682, 364, 0, 364, 0, 0, 0
574, 1, 1636423800950, 1636423801310, 360, 0, 360, 0, 0, 0
575, 1, 1636423801577, 1636423801942, 365, 2, 363, 0, 0, 0
576, 1, 1636423802210, 1636423802574, 364, 0, 364, 0, 0, 0
577, 1, 1636423802842, 1636423803206, 364, 0, 364, 0, 0, 0
578, 1, 1636423803474, 1636423803834, 360, 1, 359, 0, 0, 0
579, 1, 1636423804102, 1636423804466, 364, 0, 364, 0, 0, 0
580, 1, 1636423804734, 1636423805098, 364, 1, 363, 0, 0, 0
581, 1, 1636423805365, 1636423805734, 369, 3, 366, 2, 0, 2
582, 1, 1636423806005, 1636423806370, 365, 1, 364, 0, 0, 0
583, 1, 1636423806642, 1636423807002, 360, 0, 360, 0, 0, 0
584, 1, 1636423807270, 1636423807634, 364, 0, 364, 0, 0, 0
585, 1, 1636423807902, 1636423808266, 364, 0, 364, 0, 0, 0
586, 1, 1636423808533, 1636423808902, 369, 1, 368, 1, 0, 1
587, 1, 1636423809166, 1636423809530, 364, 0, 364, 0, 0, 0
588, 1, 1636423809798, 1636423810162, 364, 1, 363, 1, 0, 1
589, 1, 1636423810429, 1636423810794, 365, 1, 364, 1, 0, 1
590, 1, 1636423811062, 1636423811425, 363, 0, 363, 0, 0, 0
591, 1, 1636423811694, 1636423812058, 364, 0, 364, 0, 0, 0
592, 1, 1636423812329, 1636423812694, 365, 1, 364, 0, 0, 0
593, 1, 1636423812962, 1636423813326, 364, 2, 362, 1, 0, 1
594, 1, 1636423813594, 1636423813954, 360, 0, 360, 0, 0, 0
595, 1, 1636423814221, 1636423814590, 369, 1, 368, 0, 0, 0
596, 1, 1636423814858, 1636423815218, 360, 0, 360, 0, 0, 0
597, 1, 1636423815486, 1636423815850, 364, 0, 364, 0, 0, 0
598, 1, 1636423816118, 1636423816482, 364, 1, 363, 0, 0, 0
599, 1, 1636423816750, 1636423817114, 364, 1, 363, 0, 0, 0
600, 1, 1636423817382, 1636423817746, 364, 0, 364, 0, 0, 0
601, 1, 1636423994986, 1636423995130, 144, 11, 133, 0, 0, 0
602, 1, 1636423995585, 1636423995721, 136, 1, 135, 0, 0, 0
603, 1, 1636423996174, 1636423996309, 135, 0, 135, 0, 0, 0
604, 1, 1636423996258, 1636423996394, 136, 2, 134, 1, 1, 2
605, 1, 1636423996753, 1636423996890, 137, 1, 136, 0, 0, 0
606, 1, 1636423996838, 1636423996973, 135, 0, 135, 0, 0, 0
607, 1, 1636423997342, 1636423997474, 132, 0, 132, 0, 0, 0
608, 1, 1636423997426, 1636423997562, 136, 0, 136, 0, 0, 0
609, 1, 1636423997545, 1636423997678, 133, 1, 132, 0, 0, 0
610, 1, 1636423997926, 1636423998062, 136, 0, 136, 0, 0, 0
611, 1, 1636423998006, 1636423998142, 136, 0, 136, 0, 0, 0
612, 1, 1636423998141, 1636423998277, 136, 1, 135, 0, 0, 0
613, 1, 1636423998514, 1636423998649, 135, 0, 135, 0, 0, 0
614, 1, 1636423998585, 1636423998718, 133, 1, 132, 0, 0, 0
615, 1, 1636423998729, 1636423998865, 136, 1, 135, 0, 0, 0
616, 1, 1636423998917, 1636423999050, 133, 1, 132, 0, 0, 0
617, 1, 1636423999014, 1636423999106, 92, 0, 92, 0, 0, 0
618, 1, 1636423999078, 1636423999170, 92, 0, 92, 0, 0, 0
619, 1, 1636423999229, 1636423999322, 93, 1, 92, 0, 0, 0
620, 1, 1636423999410, 1636423999501, 91, 0, 91, 0, 0, 0
621, 1, 1636423999493, 1636423999586, 93, 1, 92, 0, 0, 0
622, 1, 1636423999537, 1636423999630, 93, 1, 92, 1, 0, 1
623, 1, 1636423999730, 1636423999821, 91, 0, 91, 0, 0, 0
624, 1, 1636423999970, 1636424000062, 92, 1, 91, 0, 1, 1
625, 1, 1636424000109, 1636424000202, 93, 1, 92, 1, 0, 1
627, 1, 1636424000134, 1636424000225, 91, 0, 91, 0, 0, 0
626, 1, 1636424000150, 1636424000245, 95, 0, 95, 0, 0, 0
628, 1, 1636424000245, 1636424000338, 93, 1, 92, 0, 0, 0
629, 1, 1636424000518, 1636424000610, 92, 0, 92, 0, 0, 0
630, 1, 1636424000725, 1636424000818, 93, 1, 92, 0, 0, 0
631, 1, 1636424000761, 1636424000853, 92, 1, 91, 0, 0, 0
632, 1, 1636424000806, 1636424000898, 92, 0, 92, 0, 0, 0
633, 1, 1636424001129, 1636424001222, 93, 1, 92, 0, 0, 0
634, 1, 1636424001365, 1636424001457, 92, 1, 91, 0, 0, 0
635, 1, 1636424001386, 1636424001478, 92, 0, 92, 0, 0, 0
636, 1, 1636424001405, 1636424001498, 93, 1, 92, 0, 0, 0
638, 1, 1636424001622, 1636424001714, 92, 0, 92, 0, 0, 0
637, 1, 1636424001822, 1636424001913, 91, 0, 91, 0, 0, 0
639, 1, 1636424001841, 1636424001934, 93, 1, 92, 0, 0, 0
641, 1, 1636424002034, 1636424002126, 92, 0, 92, 0, 0, 0
643, 1, 1636424002190, 1636424002282, 92, 1, 91, 1, 0, 1
644, 1, 1636424002402, 1636424002494, 92, 0, 92, 0, 0, 0
647, 1, 1636424002693, 1636424002786, 93, 1, 92, 1, 0, 1
648, 1, 1636424002785, 1636424002877, 92, 2, 90, 0, 0, 0
649, 1, 1636424002857, 1636424002945, 88, 0, 88, 0, 0, 0
651, 1, 1636424003021, 1636424003110, 89, 0, 89, 0, 0, 0
652, 1, 1636424003306, 1636424003398, 92, 0, 92, 0, 0, 0
653, 1, 1636424003426, 1636424003518, 92, 0, 92, 0, 0, 0
655, 1, 1636424003630, 1636424003722, 92, 0, 92, 0, 0, 0
656, 1, 1636424003782, 1636424003873, 91, 0, 91, 0, 0, 0
657, 1, 1636424004085, 1636424004177, 92, 1, 91, 1, 0, 1
659, 1, 1636424004221, 1636424004313, 92, 1, 91, 1, 0, 1
660, 1, 1636424004325, 1636424004417, 92, 1, 91, 0, 0, 0
662, 1, 1636424004353, 1636424004446, 93, 1, 92, 1, 0, 1
661, 1, 1636424004377, 1636424004470, 93, 1, 92, 1, 0, 1
664, 1, 1636424004929, 1636424005022, 93, 1, 92, 0, 0, 0
665, 1, 1636424004958, 1636424005050, 92, 0, 92, 0, 0, 0
666, 1, 1636424005010, 1636424005102, 92, 0, 92, 0, 0, 0
668, 1, 1636424005542, 1636424005634, 92, 0, 92, 0, 0, 0
669, 1, 1636424005609, 1636424005697, 88, 0, 88, 0, 0, 0
670, 1, 1636424005634, 1636424005726, 92, 0, 92, 0, 0, 0
671, 1, 1636424005653, 1636424005742, 89, 1, 88, 0, 0, 0
672, 1, 1636424005742, 1636424005834, 92, 1, 91, 0, 0, 0
673, 1, 1636424006138, 1636424006230, 92, 0, 92, 0, 0, 0
674, 1, 1636424006162, 1636424006254, 92, 0, 92, 0, 0, 0
675, 1, 1636424006329, 1636424006426, 97, 1, 96, 0, 0, 0
676, 1, 1636424006338, 1636424006433, 95, 0, 95, 0, 0, 0
677, 1, 1636424006685, 1636424006774, 89, 0, 89, 0, 0, 0
678, 1, 1636424006766, 1636424006862, 96, 0, 96, 0, 0, 0
679, 1, 1636424006909, 1636424007002, 93, 1, 92, 0, 0, 0
680, 1, 1636424007010, 1636424007102, 92, 0, 92, 0, 0, 0
681, 1, 1636424007030, 1636424007122, 92, 0, 92, 0, 0, 0
683, 1, 1636424007258, 1636424007351, 93, 0, 93, 0, 0, 0
684, 1, 1636424007370, 1636424007462, 92, 0, 92, 0, 0, 0
685, 1, 1636424007469, 1636424007562, 93, 1, 92, 1, 0, 1
687, 1, 1636424007729, 1636424007822, 93, 1, 92, 1, 0, 1
688, 1, 1636424007866, 1636424007958, 92, 0, 92, 0, 0, 0
689, 1, 1636424008070, 1636424008162, 92, 0, 92, 0, 0, 0
690, 1, 1636424008273, 1636424008365, 92, 1, 91, 0, 0, 0
691, 1, 1636424008285, 1636424008378, 93, 1, 92, 1, 0, 1
693, 1, 1636424008502, 1636424008593, 91, 0, 91, 0, 0, 0
694, 1, 1636424008698, 1636424008790, 92, 0, 92, 0, 0, 0
695, 1, 1636424008841, 1636424008934, 93, 1, 92, 0, 0, 0
697, 1, 1636424009186, 1636424009278, 92, 0, 92, 0, 0, 0
698, 1, 1636424009445, 1636424009538, 93, 1, 92, 0, 0, 0
699, 1, 1636424009581, 1636424009674, 93, 1, 92, 0, 0, 0
701, 1, 1636424009781, 1636424009874, 93, 1, 92, 0, 0, 0
702, 1, 1636424010078, 1636424010170, 92, 0, 92, 0, 0, 0
704, 1, 1636424010570, 1636424010662, 92, 0, 92, 0, 0, 0
706, 1, 1636424010866, 1636424010958, 92, 0, 92, 0, 0, 0
707, 1, 1636424011178, 1636424011270, 92, 0, 92, 0, 0, 0
710, 1, 1636424012258, 1636424012390, 132, 0, 132, 0, 0, 0
713, 1, 1636424012717, 1636424012825, 108, 1, 107, 0, 1, 1
712, 1, 1636424012717, 1636424012825, 108, 0, 108, 0, 0, 0
714, 1, 1636424013189, 1636424013282, 93, 1, 92, 1, 0, 1
715, 1, 1636424013189, 1636424013282, 93, 1, 92, 0, 0, 0
717, 1, 1636424013534, 1636424013626, 92, 0, 92, 0, 0, 0
716, 1, 1636424013646, 1636424013738, 92, 0, 92, 0, 0, 0
718, 1, 1636424013885, 1636424013994, 109, 1, 108, 0, 0, 0
719, 1, 1636424013889, 1636424013994, 105, 1, 104, 0, 0, 0
720, 1, 1636424014102, 1636424014194, 92, 0, 92, 0, 0, 0
722, 1, 1636424014358, 1636424014450, 92, 1, 91, 0, 1, 1
721, 1, 1636424014358, 1636424014450, 92, 1, 91, 0, 0, 0
723, 1, 1636424014553, 1636424014646, 93, 1, 92, 0, 0, 0
724, 1, 1636424014814, 1636424014906, 92, 0, 92, 0, 0, 0
725, 1, 1636424014941, 1636424015034, 93, 1, 92, 1, 0, 1
726, 1, 1636424015125, 1636424015221, 96, 1, 95, 0, 0, 0
728, 1, 1636424015169, 1636424015262, 93, 1, 92, 0, 0, 0
729, 1, 1636424015181, 1636424015274, 93, 1, 92, 1, 0, 1
727, 1, 1636424015262, 1636424015354, 92, 0, 92, 0, 0, 0
730, 1, 1636424015625, 1636424015717, 92, 1, 91, 1, 0, 1
731, 1, 1636424015642, 1636424015734, 92, 0, 92, 0, 0, 0
732, 1, 1636424015713, 1636424015806, 93, 1, 92, 1, 0, 1
733, 1, 1636424015849, 1636424015938, 89, 0, 89, 0, 0, 0
734, 1, 1636424016082, 1636424016174, 92, 0, 92, 0, 0, 0
735, 1, 1636424016242, 1636424016333, 91, 0, 91, 0, 0, 0
736, 1, 1636424016366, 1636424016457, 91, 0, 91, 0, 0, 0
737, 1, 1636424016453, 1636424016545, 92, 1, 91, 1, 0, 1
739, 1, 1636424016486, 1636424016577, 91, 0, 91, 0, 0, 0
738, 1, 1636424016541, 1636424016629, 88, 0, 88, 0, 0, 0
740, 1, 1636424016949, 1636424017042, 93, 1, 92, 0, 1, 1
741, 1, 1636424016949, 1636424017042, 93, 1, 92, 0, 1, 1
742, 1, 1636424017042, 1636424017134, 92, 0, 92, 0, 0, 0
743, 1, 1636424017130, 1636424017222, 92, 0, 92, 0, 0, 0
744, 1, 1636424017406, 1636424017497, 91, 0, 91, 0, 0, 0
745, 1, 1636424017445, 1636424017549, 104, 1, 103, 0, 0, 0
746, 1, 1636424017549, 1636424017641, 92, 1, 91, 0, 0, 0
747, 1, 1636424017670, 1636424017761, 91, 0, 91, 0, 0, 0
749, 1, 1636424017770, 1636424017866, 96, 0, 96, 0, 0, 0
748, 1, 1636424017777, 1636424017870, 93, 1, 92, 0, 0, 0
750, 1, 1636424017858, 1636424017950, 92, 0, 92, 0, 0, 0
751, 1, 1636424018058, 1636424018154, 96, 0, 96, 0, 0, 0
752, 1, 1636424018229, 1636424018321, 92, 1, 91, 0, 1, 1
753, 1, 1636424018238, 1636424018329, 91, 0, 91, 0, 0, 0
754, 1, 1636424018301, 1636424018393, 92, 1, 91, 0, 0, 0
755, 1, 1636424018382, 1636424018474, 92, 0, 92, 0, 0, 0
756, 1, 1636424018686, 1636424018778, 92, 0, 92, 0, 0, 0
757, 1, 1636424018693, 1636424018786, 93, 1, 92, 0, 0, 0
758, 1, 1636424018777, 1636424018870, 93, 1, 92, 0, 0, 0
759, 1, 1636424018941, 1636424019034, 93, 1, 92, 0, 0, 0
760, 1, 1636424018981, 1636424019074, 93, 0, 93, 0, 0, 0
763, 1, 1636424019118, 1636424019209, 91, 0, 91, 0, 0, 0
762, 1, 1636424019146, 1636424019237, 91, 1, 90, 0, 0, 0
761, 1, 1636424019146, 1636424019241, 95, 0, 95, 0, 0, 0
766, 1, 1636424019434, 1636424019550, 116, 0, 116, 0, 0, 0
767, 1, 1636424019573, 1636424019662, 89, 1, 88, 0, 0, 0
765, 1, 1636424019638, 1636424019730, 92, 0, 92, 0, 0, 0
768, 1, 1636424019641, 1636424019733, 92, 0, 92, 0, 0, 0
769, 1, 1636424019725, 1636424019818, 93, 1, 92, 0, 0, 0
771, 1, 1636424019957, 1636424020049, 92, 1, 91, 0, 1, 1
772, 1, 1636424020042, 1636424020134, 92, 0, 92, 0, 0, 0
774, 1, 1636424020234, 1636424020326, 92, 0, 92, 0, 0, 0
775, 1, 1636424020329, 1636424020421, 92, 1, 91, 0, 0, 0
777, 1, 1636424020377, 1636424020473, 96, 1, 95, 1, 0, 1
778, 1, 1636424020473, 1636424020562, 89, 1, 88, 0, 0, 0
779, 1, 1636424020653, 1636424020745, 92, 1, 91, 1, 0, 1
781, 1, 1636424020833, 1636424020926, 93, 1, 92, 0, 0, 0
783, 1, 1636424020925, 1636424021017, 92, 1, 91, 0, 0, 0
784, 1, 1636424020985, 1636424021073, 88, 1, 87, 0, 0, 0
785, 1, 1636424021137, 1636424021229, 92, 1, 91, 0, 0, 0
787, 1, 1636424021274, 1636424021366, 92, 0, 92, 0, 0, 0
788, 1, 1636424021558, 1636424021650, 92, 0, 92, 0, 0, 0
790, 1, 1636424021730, 1636424021833, 103, 0, 103, 0, 0, 0
791, 1, 1636424021833, 1636424021922, 89, 0, 89, 0, 0, 0
793, 1, 1636424021833, 1636424021925, 92, 0, 92, 0, 0, 0
711, 1, 1636424021969, 1636424022062, 93, 1, 92, 0, 0, 0
794, 1, 1636424022189, 1636424022281, 92, 1, 91, 0, 0, 0
797, 1, 1636424022285, 1636424022378, 93, 1, 92, 0, 0, 0
796, 1, 1636424022321, 1636424022414, 93, 1, 92, 0, 0, 0
799, 1, 1636424022597, 1636424022690, 93, 1, 92, 0, 0, 0
800, 1, 1636424022777, 1636424022870, 93, 1, 92, 1, 0, 1
801, 1, 1636424022870, 1636424022962, 92, 0, 92, 0, 0, 0
803, 1, 1636424023114, 1636424023205, 91, 0, 91, 0, 0, 0
804, 1, 1636424023161, 1636424023257, 96, 1, 95, 0, 1, 1
805, 1, 1636424023570, 1636424023662, 92, 0, 92, 0, 0, 0
807, 1, 1636424023678, 1636424023774, 96, 0, 96, 0, 0, 0
810, 1, 1636424024170, 1636424024262, 92, 0, 92, 0, 0, 0
811, 1, 1636424024466, 1636424024553, 87, 0, 87, 0, 0, 0
812, 1, 1636424024477, 1636424024562, 85, 0, 85, 0, 0, 0
813, 1, 1636424024918, 1636424025010, 92, 0, 92, 0, 0, 0
814, 1, 1636424025006, 1636424025098, 92, 0, 92, 0, 0, 0
815, 1, 1636424025446, 1636424025538, 92, 0, 92, 0, 0, 0
816, 1, 1636424025738, 1636424025830, 92, 0, 92, 0, 0, 0
817, 1, 1636424025806, 1636424025898, 92, 0, 92, 0, 0, 0
818, 1, 1636424026198, 1636424026289, 91, 0, 91, 0, 0, 0
819, 1, 1636424026310, 1636424026402, 92, 0, 92, 0, 0, 0
820, 1, 1636424026833, 1636424026926, 93, 1, 92, 0, 1, 1
821, 1, 1636424027046, 1636424027137, 91, 0, 91, 0, 0, 0
822, 1, 1636424027205, 1636424027298, 93, 1, 92, 0, 0, 0
823, 1, 1636424027498, 1636424027590, 92, 0, 92, 0, 0, 0
824, 1, 1636424027662, 1636424027754, 92, 0, 92, 0, 0, 0
825, 1, 1636424028218, 1636424028310, 92, 0, 92, 0, 0, 0
826, 1, 1636424028386, 1636424028478, 92, 0, 92, 0, 0, 0
827, 1, 1636424028553, 1636424028646, 93, 1, 92, 1, 0, 1
828, 1, 1636424028837, 1636424028926, 89, 0, 89, 0, 0, 0
829, 1, 1636424029010, 1636424029150, 140, 0, 140, 0, 0, 0
830, 1, 1636424029498, 1636424029589, 91, 0, 91, 0, 0, 0
831, 1, 1636424029778, 1636424029874, 96, 0, 96, 0, 0, 0
832, 1, 1636424029966, 1636424030058, 92, 0, 92, 0, 0, 0
833, 1, 1636424030241, 1636424030334, 93, 1, 92, 0, 0, 0
835, 1, 1636424030421, 1636424030533, 112, 0, 112, 0, 0, 0
837, 1, 1636424030426, 1636424030533, 107, 0, 107, 0, 0, 0
836, 1, 1636424030426, 1636424030533, 107, 0, 107, 0, 0, 0
839, 1, 1636424030837, 1636424030929, 92, 1, 91, 0, 0, 0
838, 1, 1636424030898, 1636424030990, 92, 1, 91, 0, 0, 0
834, 1, 1636424030898, 1636424030990, 92, 1, 91, 0, 0, 0
841, 1, 1636424031141, 1636424031230, 89, 0, 89, 0, 0, 0
843, 1, 1636424031237, 1636424031329, 92, 1, 91, 0, 0, 0
840, 1, 1636424031362, 1636424031469, 107, 1, 106, 0, 0, 0
842, 1, 1636424031362, 1636424031469, 107, 1, 106, 0, 0, 0
844, 1, 1636424031594, 1636424031685, 91, 0, 91, 0, 0, 0
848, 1, 1636424031697, 1636424031789, 92, 1, 91, 0, 0, 0
849, 1, 1636424031697, 1636424031789, 92, 1, 91, 0, 0, 0
845, 1, 1636424031829, 1636424031918, 89, 0, 89, 0, 0, 0
850, 1, 1636424031906, 1636424031998, 92, 0, 92, 0, 0, 0
851, 1, 1636424032150, 1636424032253, 103, 0, 103, 0, 0, 0
853, 1, 1636424032281, 1636424032373, 92, 1, 91, 0, 0, 0
855, 1, 1636424032433, 1636424032525, 92, 1, 91, 0, 0, 0
857, 1, 1636424032545, 1636424032638, 93, 1, 92, 1, 0, 1
858, 1, 1636424032582, 1636424032674, 92, 0, 92, 0, 0, 0
856, 1, 1636424032613, 1636424032706, 93, 1, 92, 0, 1, 1
859, 1, 1636424032733, 1636424032825, 92, 1, 91, 0, 0, 0
861, 1, 1636424032926, 1636424033018, 92, 0, 92, 0, 0, 0
862, 1, 1636424033017, 1636424033110, 93, 1, 92, 0, 0, 0
863, 1, 1636424033029, 1636424033122, 93, 1, 92, 0, 0, 0
852, 1, 1636424033182, 1636424033274, 92, 0, 92, 0, 0, 0
864, 1, 1636424033214, 1636424033305, 91, 0, 91, 0, 0, 0
865, 1, 1636424033517, 1636424033609, 92, 0, 92, 0, 0, 0
867, 1, 1636424033609, 1636424033702, 93, 1, 92, 0, 0, 0
866, 1, 1636424033638, 1636424033809, 171, 0, 171, 0, 0, 0
868, 1, 1636424033757, 1636424033849, 92, 1, 91, 0, 1, 1
871, 1, 1636424033901, 1636424033997, 96, 1, 95, 0, 0, 0
873, 1, 1636424033901, 1636424033997, 96, 2, 94, 0, 1, 1
872, 1, 1636424033901, 1636424033998, 97, 2, 95, 0, 1, 1
869, 1, 1636424033969, 1636424034062, 93, 1, 92, 0, 0, 0
870, 1, 1636424034165, 1636424034257, 92, 1, 91, 0, 0, 0
876, 1, 1636424034209, 1636424034302, 93, 1, 92, 0, 0, 0
875, 1, 1636424034213, 1636424034302, 89, 0, 89, 0, 0, 0
878, 1, 1636424034361, 1636424034454, 93, 1, 92, 1, 0, 1
879, 1, 1636424034397, 1636424034490, 93, 1, 92, 0, 1, 1
880, 1, 1636424034545, 1636424034637, 92, 1, 91, 0, 0, 0
877, 1, 1636424034617, 1636424034710, 93, 1, 92, 0, 0, 0
882, 1, 1636424034849, 1636424034937, 88, 0, 88, 0, 0, 0
883, 1, 1636424034877, 1636424034969, 92, 1, 91, 1, 0, 1
884, 1, 1636424035058, 1636424035150, 92, 0, 92, 0, 0, 0
888, 1, 1636424035218, 1636424035309, 91, 0, 91, 0, 0, 0
889, 1, 1636424035225, 1636424035318, 93, 1, 92, 0, 0, 0
886, 1, 1636424035293, 1636424035385, 92, 1, 91, 0, 0, 0
887, 1, 1636424035337, 1636424035430, 93, 1, 92, 0, 0, 0
892, 1, 1636424035485, 1636424035578, 93, 1, 92, 0, 0, 0
890, 1, 1636424035513, 1636424035605, 92, 1, 91, 0, 0, 0
894, 1, 1636424035661, 1636424035754, 93, 1, 92, 0, 0, 0
893, 1, 1636424035790, 1636424035882, 92, 0, 92, 0, 0, 0
896, 1, 1636424035941, 1636424036033, 92, 1, 91, 1, 0, 1
895, 1, 1636424036113, 1636424036206, 93, 1, 92, 0, 0, 0
897, 1, 1636424036150, 1636424036242, 92, 0, 92, 0, 0, 0
898, 1, 1636424036361, 1636424036454, 93, 2, 91, 0, 0, 0
900, 1, 1636424036542, 1636424036633, 91, 0, 91, 0, 0, 0
899, 1, 1636424036569, 1636424036662, 93, 1, 92, 1, 0, 1
901, 1, 1636424036606, 1636424036697, 91, 0, 91, 0, 0, 0
902, 1, 1636424036621, 1636424036713, 92, 1, 91, 0, 0, 0
903, 1, 1636424036814, 1636424036910, 96, 0, 96, 0, 0, 0
904, 1, 1636424036845, 1636424036937, 92, 0, 92, 0, 0, 0
906, 1, 1636424036981, 1636424037069, 88, 0, 88, 0, 0, 0
905, 1, 1636424036998, 1636424037090, 92, 0, 92, 0, 0, 0
907, 1, 1636424037238, 1636424037330, 92, 0, 92, 0, 0, 0
908, 1, 1636424037438, 1636424037529, 91, 0, 91, 0, 0, 0
909, 1, 1636424037449, 1636424037541, 92, 1, 91, 1, 0, 1
910, 1, 1636424037709, 1636424037801, 92, 0, 92, 0, 0, 0
911, 1, 1636424037894, 1636424037989, 95, 0, 95, 0, 0, 0
913, 1, 1636424037909, 1636424038001, 92, 1, 91, 0, 0, 0
914, 1, 1636424037981, 1636424038078, 97, 1, 96, 0, 0, 0
915, 1, 1636424038157, 1636424038249, 92, 0, 92, 0, 0, 0
917, 1, 1636424038233, 1636424038326, 93, 1, 92, 0, 0, 0
918, 1, 1636424038329, 1636424038422, 93, 1, 92, 1, 0, 1
919, 1, 1636424038562, 1636424038654, 92, 0, 92, 0, 0, 0
920, 1, 1636424038789, 1636424038885, 96, 1, 95, 0, 1, 1
921, 1, 1636424038833, 1636424038926, 93, 1, 92, 0, 0, 0
924, 1, 1636424039214, 1636424039306, 92, 0, 92, 0, 0, 0
923, 1, 1636424039245, 1636424039337, 92, 1, 91, 1, 0, 1
925, 1, 1636424039286, 1636424039377, 91, 0, 91, 0, 0, 0
927, 1, 1636424039502, 1636424039593, 91, 0, 91, 0, 0, 0
928, 1, 1636424039645, 1636424039738, 93, 1, 92, 0, 0, 0
930, 1, 1636424039949, 1636424040041, 92, 1, 91, 1, 0, 1
929, 1, 1636424040097, 1636424040190, 93, 1, 92, 0, 0, 0
931, 1, 1636424040162, 1636424040254, 92, 0, 92, 0, 0, 0
932, 1, 1636424040553, 1636424040646, 93, 1, 92, 0, 1, 1
933, 1, 1636424040558, 1636424040649, 91, 0, 91, 0, 0, 0
934, 1, 1636424040565, 1636424040657, 92, 1, 91, 0, 0, 0
935, 1, 1636424040778, 1636424040869, 91, 0, 91, 0, 0, 0
936, 1, 1636424040946, 1636424041038, 92, 0, 92, 0, 0, 0
938, 1, 1636424041274, 1636424041366, 92, 0, 92, 0, 0, 0
937, 1, 1636424041402, 1636424041558, 156, 0, 156, 0, 0, 0
939, 1, 1636424041561, 1636424041657, 96, 1, 95, 1, 0, 1
941, 1, 1636424041854, 1636424041945, 91, 0, 91, 0, 0, 0
942, 1, 1636424041882, 1636424041978, 96, 0, 96, 0, 0, 0
940, 1, 1636424041913, 1636424042002, 89, 0, 89, 0, 0, 0
944, 1, 1636424041961, 1636424042077, 116, 1, 115, 0, 1, 1
945, 1, 1636424042169, 1636424042266, 97, 1, 96, 0, 0, 0
946, 1, 1636424042298, 1636424042390, 92, 0, 92, 0, 0, 0
943, 1, 1636424042437, 1636424042534, 97, 1, 96, 0, 0, 0
948, 1, 1636424042573, 1636424042681, 108, 1, 107, 1, 0, 1
949, 1, 1636424042777, 1636424042869, 92, 1, 91, 0, 0, 0
950, 1, 1636424042861, 1636424042945, 84, 0, 84, 0, 0, 0
947, 1, 1636424042889, 1636424042982, 93, 1, 92, 0, 0, 0
953, 1, 1636424043181, 1636424043269, 88, 0, 88, 0, 0, 0
954, 1, 1636424043201, 1636424043294, 93, 1, 92, 0, 1, 1
955, 1, 1636424043213, 1636424043302, 89, 0, 89, 0, 0, 0
951, 1, 1636424043225, 1636424043317, 92, 1, 91, 0, 1, 1
952, 1, 1636424043354, 1636424043445, 91, 0, 91, 0, 0, 0
957, 1, 1636424043405, 1636424043497, 92, 1, 91, 0, 0, 0
958, 1, 1636424043633, 1636424043726, 93, 1, 92, 0, 1, 1
956, 1, 1636424043665, 1636424043801, 136, 1, 135, 1, 0, 1
960, 1, 1636424043981, 1636424044074, 93, 1, 92, 0, 0, 0
961, 1, 1636424044085, 1636424044177, 92, 1, 91, 1, 0, 1
962, 1, 1636424044149, 1636424044242, 93, 1, 92, 1, 0, 1
959, 1, 1636424044161, 1636424044254, 93, 1, 92, 0, 1, 1
963, 1, 1636424044245, 1636424044341, 96, 1, 95, 1, 0, 1
966, 1, 1636424044517, 1636424044609, 92, 1, 91, 0, 0, 0
964, 1, 1636424044573, 1636424044666, 93, 1, 92, 1, 0, 1
968, 1, 1636424044573, 1636424044666, 93, 1, 92, 1, 0, 1
967, 1, 1636424044573, 1636424044666, 93, 1, 92, 1, 0, 1
965, 1, 1636424044609, 1636424044702, 93, 1, 92, 0, 1, 1
970, 1, 1636424044749, 1636424044842, 93, 1, 92, 0, 1, 1
972, 1, 1636424044973, 1636424045066, 93, 1, 92, 0, 0, 0
971, 1, 1636424044973, 1636424045066, 93, 1, 92, 1, 0, 1
969, 1, 1636424045065, 1636424045157, 92, 1, 91, 0, 0, 0
975, 1, 1636424045318, 1636424045409, 91, 0, 91, 0, 0, 0
974, 1, 1636424045417, 1636424045505, 88, 0, 88, 0, 0, 0
976, 1, 1636424045425, 1636424045517, 92, 1, 91, 1, 0, 1
977, 1, 1636424045493, 1636424045577, 84, 0, 84, 0, 0, 0
973, 1, 1636424045525, 1636424045614, 89, 1, 88, 0, 0, 0
978, 1, 1636424045537, 1636424045621, 84, 0, 84, 0, 0, 0
979, 1, 1636424045853, 1636424045941, 88, 0, 88, 0, 0, 0
982, 1, 1636424045865, 1636424045953, 88, 0, 88, 0, 0, 0
980, 1, 1636424045873, 1636424045961, 88, 0, 88, 0, 0, 0
983, 1, 1636424045897, 1636424045985, 88, 0, 88, 0, 0, 0
984, 1, 1636424045909, 1636424045998, 89, 0, 89, 0, 0, 0
981, 1, 1636424045965, 1636424046057, 92, 0, 92, 0, 0, 0
986, 1, 1636424046113, 1636424046206, 93, 1, 92, 0, 0, 0
987, 1, 1636424046193, 1636424046289, 96, 1, 95, 0, 1, 1
988, 1, 1636424046209, 1636424046302, 93, 1, 92, 0, 1, 1
985, 1, 1636424046314, 1636424046405, 91, 0, 91, 0, 0, 0
991, 1, 1636424046613, 1636424046701, 88, 0, 88, 0, 0, 0
990, 1, 1636424046657, 1636424046746, 89, 0, 89, 0, 0, 0
992, 1, 1636424046701, 1636424046793, 92, 1, 91, 0, 0, 0
989, 1, 1636424046773, 1636424046865, 92, 1, 91, 0, 0, 0
993, 1, 1636424046845, 1636424046937, 92, 1, 91, 1, 0, 1
994, 1, 1636424046881, 1636424046969, 88, 0, 88, 0, 0, 0
995, 1, 1636424047102, 1636424047193, 91, 0, 91, 0, 0, 0
997, 1, 1636424047149, 1636424047233, 84, 0, 84, 0, 0, 0
998, 1, 1636424047149, 1636424047237, 88, 1, 87, 0, 1, 1
999, 1, 1636424047189, 1636424047273, 84, 0, 84, 0, 0, 0
996, 1, 1636424047217, 1636424047302, 85, 0, 85, 0, 0, 0
1000, 1, 1636424047213, 1636424047302, 89, 0, 89, 0, 0, 0
1002, 1, 1636424047493, 1636424047585, 92, 1, 91, 0, 0, 0
1003, 1, 1636424047561, 1636424047653, 92, 1, 91, 0, 0, 0
1004, 1, 1636424047577, 1636424047665, 88, 0, 88, 0, 0, 0
1001, 1, 1636424047585, 1636424047721, 136, 1, 135, 1, 0, 1
1006, 1, 1636424047902, 1636424047994, 92, 0, 92, 0, 0, 0
1007, 1, 1636424048057, 1636424048150, 93, 1, 92, 0, 1, 1
1005, 1, 1636424048077, 1636424048173, 96, 1, 95, 0, 0, 0
1008, 1, 1636424048149, 1636424048237, 88, 1, 87, 0, 0, 0
1010, 1, 1636424048157, 1636424048253, 96, 1, 95, 0, 0, 0
1009, 1, 1636424048177, 1636424048273, 96, 1, 95, 0, 0, 0
1011, 1, 1636424048237, 1636424048329, 92, 1, 91, 0, 0, 0
1017, 1, 1636424048481, 1636424048569, 88, 0, 88, 0, 0, 0
1018, 1, 1636424048489, 1636424048577, 88, 0, 88, 0, 0, 0
1013, 1, 1636424048505, 1636424048597, 92, 0, 92, 0, 0, 0
1012, 1, 1636424048537, 1636424048626, 89, 1, 88, 0, 1, 1
1015, 1, 1636424048609, 1636424048701, 92, 0, 92, 0, 0, 0
1016, 1, 1636424048625, 1636424048717, 92, 1, 91, 0, 0, 0
1020, 1, 1636424048806, 1636424048902, 96, 0, 96, 0, 0, 0
1022, 1, 1636424048961, 1636424049053, 92, 1, 91, 0, 0, 0
926, 1, 1636424049006, 1636424049098, 92, 1, 91, 0, 1, 1
1025, 1, 1636424049285, 1636424049378, 93, 0, 93, 0, 0, 0
1024, 1, 1636424049310, 1636424049401, 91, 0, 91, 0, 0, 0
1026, 1, 1636424049409, 1636424049502, 93, 1, 92, 0, 0, 0
1028, 1, 1636424049438, 1636424049529, 91, 0, 91, 0, 0, 0
1029, 1, 1636424049465, 1636424049558, 93, 1, 92, 1, 0, 1
1036, 1, 1636424049825, 1636424049914, 89, 0, 89, 0, 0, 0
1037, 1, 1636424049861, 1636424049954, 93, 1, 92, 1, 0, 1
1034, 1, 1636424049869, 1636424049957, 88, 1, 87, 0, 0, 0
1033, 1, 1636424049917, 1636424050005, 88, 0, 88, 0, 0, 0
1038, 1, 1636424050114, 1636424050206, 92, 0, 92, 0, 0, 0
1040, 1, 1636424050597, 1636424050690, 93, 1, 92, 0, 0, 0
1042, 1, 1636424050653, 1636424050746, 93, 1, 92, 0, 0, 0
1044, 1, 1636424050850, 1636424050941, 91, 0, 91, 0, 0, 0
1047, 1, 1636424051202, 1636424051290, 88, 0, 88, 0, 0, 0
1048, 1, 1636424051238, 1636424051330, 92, 0, 92, 0, 0, 0
1046, 1, 1636424051302, 1636424051394, 92, 0, 92, 0, 0, 0
1049, 1, 1636424051498, 1636424051590, 92, 0, 92, 0, 0, 0
1051, 1, 1636424051982, 1636424052074, 92, 0, 92, 0, 0, 0
1052, 1, 1636424052165, 1636424052258, 93, 1, 92, 1, 0, 1
1054, 1, 1636424052493, 1636424052586, 93, 1, 92, 0, 1, 1
1053, 1, 1636424052622, 1636424052714, 92, 0, 92, 0, 0, 0
1056, 1, 1636424052866, 1636424052957, 91, 0, 91, 0, 0, 0
1057, 1, 1636424053306, 1636424053398, 92, 0, 92, 0, 0, 0
1058, 1, 1636424053434, 1636424053530, 96, 0, 96, 0, 0, 0
1060, 1, 1636424053822, 1636424053913, 91, 0, 91, 0, 0, 0
1059, 1, 1636424053894, 1636424053986, 92, 0, 92, 0, 0, 0
1062, 1, 1636424054590, 1636424054681, 91, 0, 91, 0, 0, 0
1063, 1, 1636424054790, 1636424054882, 92, 0, 92, 0, 0, 0
1065, 1, 1636424055117, 1636424055210, 93, 1, 92, 0, 0, 0
1064, 1, 1636424055250, 1636424055342, 92, 0, 92, 0, 0, 0
1066, 1, 1636424055942, 1636424056034, 92, 0, 92, 0, 0, 0
1067, 1, 1636424056177, 1636424056270, 93, 1, 92, 0, 0, 0
1068, 1, 1636424056394, 1636424056486, 92, 0, 92, 0, 0, 0
1069, 1, 1636424056634, 1636424056725, 91, 0, 91, 0, 0, 0
1070, 1, 1636424057333, 1636424057421, 88, 0, 88, 0, 0, 0
1071, 1, 1636424057469, 1636424057566, 97, 1, 96, 0, 0, 0
1073, 1, 1636424057781, 1636424057874, 93, 1, 92, 0, 0, 0
1072, 1, 1636424057929, 1636424058018, 89, 0, 89, 0, 0, 0
1074, 1, 1636424058657, 1636424058777, 120, 1, 119, 1, 0, 1
1075, 1, 1636424058777, 1636424058865, 88, 0, 88, 0, 0, 0
1076, 1, 1636424058961, 1636424059053, 92, 0, 92, 0, 0, 0
1079, 1, 1636424059189, 1636424059282, 93, 1, 92, 0, 0, 0
1080, 1, 1636424059269, 1636424059362, 93, 1, 92, 0, 0, 0
1078, 1, 1636424059273, 1636424059370, 97, 1, 96, 0, 0, 0
1077, 1, 1636424059437, 1636424059653, 216, 1, 215, 1, 0, 1
1043, 1, 1636424059789, 1636424059881, 92, 1, 91, 0, 0, 0
1082, 1, 1636424059837, 1636424059925, 88, 0, 88, 0, 0, 0
1083, 1, 1636424059953, 1636424060041, 88, 0, 88, 0, 0, 0
1081, 1, 1636424060006, 1636424060122, 116, 0, 116, 0, 0, 0
1085, 1, 1636424060053, 1636424060141, 88, 1, 87, 0, 0, 0
1087, 1, 1636424060053, 1636424060145, 92, 1, 91, 0, 0, 0
1088, 1, 1636424060121, 1636424060213, 92, 1, 91, 0, 0, 0
1090, 1, 1636424060221, 1636424060318, 97, 1, 96, 0, 1, 1
1089, 1, 1636424060245, 1636424060337, 92, 1, 91, 1, 0, 1
1086, 1, 1636424060293, 1636424060381, 88, 0, 88, 0, 0, 0
1093, 1, 1636424060469, 1636424060562, 93, 1, 92, 0, 1, 1
1094, 1, 1636424060485, 1636424060577, 92, 1, 91, 0, 0, 0
1091, 1, 1636424060501, 1636424060593, 92, 1, 91, 0, 0, 0
1095, 1, 1636424060562, 1636424060653, 91, 0, 91, 0, 0, 0
1096, 1, 1636424060709, 1636424060802, 93, 1, 92, 1, 0, 1
1097, 1, 1636424061013, 1636424061105, 92, 1, 91, 0, 0, 0
1098, 1, 1636424061018, 1636424061109, 91, 0, 91, 0, 0, 0
1099, 1, 1636424061245, 1636424061338, 93, 1, 92, 1, 0, 1
1100, 1, 1636424061261, 1636424061353, 92, 1, 91, 0, 0, 0
1103, 1, 1636424061353, 1636424061450, 97, 1, 96, 1, 0, 1
1104, 1, 1636424061361, 1636424061450, 89, 1, 88, 0, 0, 0
1101, 1, 1636424061461, 1636424061554, 93, 1, 92, 1, 0, 1
1102, 1, 1636424061461, 1636424061557, 96, 1, 95, 0, 0, 0
1105, 1, 1636424061513, 1636424061601, 88, 0, 88, 0, 0, 0
1108, 1, 1636424061762, 1636424061854, 92, 0, 92, 0, 0, 0
1107, 1, 1636424061821, 1636424061914, 93, 1, 92, 1, 0, 1
1109, 1, 1636424061821, 1636424061914, 93, 1, 92, 0, 0, 0
1106, 1, 1636424061913, 1636424062001, 88, 1, 87, 0, 0, 0
1111, 1, 1636424062001, 1636424062094, 93, 0, 93, 0, 0, 0
1112, 1, 1636424062218, 1636424062309, 91, 0, 91, 0, 0, 0
1113, 1, 1636424062405, 1636424062493, 88, 1, 87, 1, 0, 1
1061, 1, 1636424062537, 1636424062629, 92, 1, 91, 0, 1, 1
1115, 1, 1636424062582, 1636424062673, 91, 0, 91, 0, 0, 0
1117, 1, 1636424062629, 1636424062717, 88, 0, 88, 0, 0, 0
1116, 1, 1636424062669, 1636424062761, 92, 1, 91, 1, 0, 1
1122, 1, 1636424062833, 1636424062925, 92, 1, 91, 1, 0, 1
1123, 1, 1636424062841, 1636424062938, 97, 1, 96, 0, 1, 1
1121, 1, 1636424062853, 1636424062942, 89, 0, 89, 0, 0, 0
1125, 1, 1636424063078, 1636424063170, 92, 0, 92, 0, 0, 0
1127, 1, 1636424063305, 1636424063397, 92, 1, 91, 1, 0, 1
1128, 1, 1636424063325, 1636424063422, 97, 1, 96, 1, 0, 1
1130, 1, 1636424063498, 1636424063590, 92, 0, 92, 0, 0, 0
1129, 1, 1636424063533, 1636424063626, 93, 1, 92, 0, 1, 1
1132, 1, 1636424063986, 1636424064078, 92, 0, 92, 0, 0, 0
1134, 1, 1636424064033, 1636424064122, 89, 1, 88, 0, 1, 1
1135, 1, 1636424064185, 1636424064277, 92, 1, 91, 0, 0, 0
1136, 1, 1636424064189, 1636424064281, 92, 1, 91, 0, 1, 1
1138, 1, 1636424064490, 1636424064581, 91, 0, 91, 0, 0, 0
1139, 1, 1636424064721, 1636424064818, 97, 1, 96, 0, 0, 0
1141, 1, 1636424064805, 1636424064898, 93, 1, 92, 1, 0, 1
1143, 1, 1636424065345, 1636424065438, 93, 1, 92, 0, 1, 1
1144, 1, 1636424065501, 1636424065589, 88, 1, 87, 1, 0, 1
1145, 1, 1636424065534, 1636424065625, 91, 0, 91, 0, 0, 0
1146, 1, 1636424065802, 1636424065894, 92, 0, 92, 0, 0, 0
1147, 1, 1636424066050, 1636424066138, 88, 0, 88, 0, 0, 0
1150, 1, 1636424066801, 1636424066893, 92, 1, 91, 0, 0, 0
1151, 1, 1636424066934, 1636424067026, 92, 0, 92, 0, 0, 0
1153, 1, 1636424067350, 1636424067442, 92, 0, 92, 0, 0, 0
1154, 1, 1636424068157, 1636424068250, 93, 1, 92, 0, 0, 0
1155, 1, 1636424068237, 1636424068330, 93, 1, 92, 1, 0, 1
1156, 1, 1636424068685, 1636424068778, 93, 1, 92, 0, 0, 0
1157, 1, 1636424069550, 1636424069642, 92, 0, 92, 0, 0, 0
1158, 1, 1636424069550, 1636424069642, 92, 0, 92, 0, 0, 0
1159, 1, 1636424070105, 1636424070202, 97, 1, 96, 0, 1, 1
1162, 1, 1636424070858, 1636424070950, 92, 0, 92, 0, 0, 0
1163, 1, 1636424070870, 1636424070962, 92, 0, 92, 0, 0, 0
1164, 1, 1636424071406, 1636424071498, 92, 0, 92, 0, 0, 0
1167, 1, 1636424072170, 1636424072261, 91, 0, 91, 0, 0, 0
1166, 1, 1636424072162, 1636424072265, 103, 0, 103, 0, 0, 0
1120, 1, 1636424072398, 1636424072486, 88, 0, 88, 0, 0, 0
1169, 1, 1636424072758, 1636424072849, 91, 0, 91, 0, 0, 0
1171, 1, 1636424072990, 1636424073082, 92, 0, 92, 0, 0, 0
1170, 1, 1636424072990, 1636424073082, 92, 0, 92, 0, 0, 0
1173, 1, 1636424073442, 1636424073534, 92, 0, 92, 0, 0, 0
1174, 1, 1636424073477, 1636424073569, 92, 1, 91, 0, 0, 0
1175, 1, 1636424073553, 1636424073645, 92, 1, 91, 0, 0, 0
1176, 1, 1636424073561, 1636424073653, 92, 1, 91, 1, 0, 1
1177, 1, 1636424074105, 1636424074193, 88, 1, 87, 0, 0, 0
1180, 1, 1636424074193, 1636424074290, 97, 1, 96, 1, 0, 1
1178, 1, 1636424074162, 1636424074290, 128, 0, 128, 0, 0, 0
1179, 1, 1636424074189, 1636424074290, 101, 0, 101, 0, 0, 0
1181, 1, 1636424074290, 1636424074385, 95, 1, 94, 0, 1, 1
1182, 1, 1636424074658, 1636424074750, 92, 0, 92, 0, 0, 0
1184, 1, 1636424074721, 1636424074813, 92, 1, 91, 0, 0, 0
1183, 1, 1636424074750, 1636424074846, 96, 0, 96, 0, 0, 0
1185, 1, 1636424074853, 1636424074946, 93, 1, 92, 0, 0, 0
1186, 1, 1636424074929, 1636424075021, 92, 1, 91, 1, 0, 1
1187, 1, 1636424075217, 1636424075314, 97, 1, 96, 1, 0, 1
1188, 1, 1636424075398, 1636424075493, 95, 0, 95, 0, 0, 0
1189, 1, 1636424075473, 1636424075566, 93, 1, 92, 0, 1, 1
1190, 1, 1636424075505, 1636424075593, 88, 0, 88, 0, 0, 0
1193, 1, 1636424075566, 1636424075658, 92, 0, 92, 0, 0, 0
1191, 1, 1636424075681, 1636424075769, 88, 0, 88, 0, 0, 0
1195, 1, 1636424075953, 1636424076038, 85, 0, 85, 0, 0, 0
1194, 1, 1636424076022, 1636424076113, 91, 0, 91, 0, 0, 0
1196, 1, 1636424076038, 1636424076129, 91, 0, 91, 0, 0, 0
1197, 1, 1636424076129, 1636424076217, 88, 0, 88, 0, 0, 0
1198, 1, 1636424076246, 1636424076338, 92, 0, 92, 0, 0, 0
1199, 1, 1636424076397, 1636424076490, 93, 1, 92, 0, 0, 0
1200, 1, 1636424076465, 1636424076561, 96, 1, 95, 0, 1, 1
1201, 1, 1636424076742, 1636424076833, 91, 0, 91, 0, 0, 0
1202, 1, 1636424076789, 1636424076877, 88, 0, 88, 0, 0, 0
1203, 1, 1636424076826, 1636424076918, 92, 0, 92, 0, 0, 0
1204, 1, 1636424076853, 1636424076946, 93, 1, 92, 1, 0, 1
1205, 1, 1636424076937, 1636424077029, 92, 1, 91, 0, 0, 0
1206, 1, 1636424077029, 1636424077121, 92, 0, 92, 0, 0, 0
1192, 1, 1636424077162, 1636424077253, 91, 0, 91, 0, 0, 0
1208, 1, 1636424077281, 1636424077373, 92, 1, 91, 0, 0, 0
1207, 1, 1636424077385, 1636424077473, 88, 0, 88, 0, 0, 0
1211, 1, 1636424077429, 1636424077521, 92, 1, 91, 0, 0, 0
1209, 1, 1636424077429, 1636424077521, 92, 1, 91, 0, 1, 1
1210, 1, 1636424077481, 1636424077569, 88, 0, 88, 0, 0, 0
1212, 1, 1636424077557, 1636424077654, 97, 1, 96, 0, 0, 0
1214, 1, 1636424077689, 1636424077785, 96, 1, 95, 0, 0, 0
1213, 1, 1636424077730, 1636424077821, 91, 0, 91, 0, 0, 0
1215, 1, 1636424077845, 1636424077938, 93, 1, 92, 1, 0, 1
1217, 1, 1636424078102, 1636424078193, 91, 0, 91, 0, 0, 0
1218, 1, 1636424078113, 1636424078205, 92, 1, 91, 0, 1, 1
1216, 1, 1636424078185, 1636424078278, 93, 1, 92, 0, 0, 0
1219, 1, 1636424078197, 1636424078289, 92, 1, 91, 0, 0, 0
1220, 1, 1636424078249, 1636424078337, 88, 0, 88, 0, 0, 0
1221, 1, 1636424078317, 1636424078410, 93, 1, 92, 0, 0, 0
1223, 1, 1636424078654, 1636424078745, 91, 0, 91, 0, 0, 0
1224, 1, 1636424078701, 1636424078789, 88, 0, 88, 0, 0, 0
1226, 1, 1636424078713, 1636424078797, 84, 0, 84, 0, 0, 0
1225, 1, 1636424078705, 1636424078797, 92, 1, 91, 1, 0, 1
1222, 1, 1636424078777, 1636424078870, 93, 1, 92, 1, 0, 1
1228, 1, 1636424078938, 1636424079029, 91, 0, 91, 0, 0, 0
1229, 1, 1636424078994, 1636424079085, 91, 0, 91, 0, 0, 0
1227, 1, 1636424079105, 1636424079197, 92, 1, 91, 0, 0, 0
1230, 1, 1636424079145, 1636424079237, 92, 1, 91, 0, 0, 0
1231, 1, 1636424079437, 1636424079525, 88, 0, 88, 0, 0, 0
1234, 1, 1636424079478, 1636424079569, 91, 1, 90, 0, 0, 0
1233, 1, 1636424079478, 1636424079569, 91, 0, 91, 0, 0, 0
1235, 1, 1636424079549, 1636424079637, 88, 0, 88, 0, 0, 0
1232, 1, 1636424079565, 1636424079657, 92, 1, 91, 1, 0, 1
1236, 1, 1636424079593, 1636424079682, 89, 0, 89, 0, 0, 0
1238, 1, 1636424079941, 1636424080033, 92, 1, 91, 0, 0, 0
1240, 1, 1636424079989, 1636424080077, 88, 0, 88, 0, 0, 0
1239, 1, 1636424080001, 1636424080089, 88, 0, 88, 0, 0, 0
1237, 1, 1636424080037, 1636424080125, 88, 0, 88, 0, 0, 0
1241, 1, 1636424080101, 1636424080194, 93, 1, 92, 0, 0, 0
1243, 1, 1636424080265, 1636424080358, 93, 0, 93, 0, 0, 0
1244, 1, 1636424080381, 1636424080473, 92, 1, 91, 1, 0, 1
1242, 1, 1636424080389, 1636424080482, 93, 1, 92, 0, 1, 1
1245, 1, 1636424080449, 1636424080542, 93, 1, 92, 0, 1, 1
1247, 1, 1636424080801, 1636424080898, 97, 1, 96, 0, 1, 1
1246, 1, 1636424080801, 1636424080898, 97, 1, 96, 0, 0, 0
1248, 1, 1636424080845, 1636424080933, 88, 0, 88, 0, 0, 0
1249, 1, 1636424080885, 1636424080977, 92, 1, 91, 0, 0, 0
1251, 1, 1636424080977, 1636424081069, 92, 1, 91, 1, 0, 1
1254, 1, 1636424081249, 1636424081338, 89, 1, 88, 1, 0, 1
1257, 1, 1636424081385, 1636424081478, 93, 1, 92, 0, 0, 0
1256, 1, 1636424081418, 1636424081510, 92, 0, 92, 0, 0, 0
1258, 1, 1636424081418, 1636424081510, 92, 0, 92, 0, 0, 0
1260, 1, 1636424081565, 1636424081657, 92, 1, 91, 0, 0, 0
1261, 1, 1636424081669, 1636424081761, 92, 1, 91, 1, 0, 1
1262, 1, 1636424081733, 1636424081825, 92, 1, 91, 0, 1, 1
1264, 1, 1636424082102, 1636424082193, 91, 0, 91, 0, 0, 0
1265, 1, 1636424082114, 1636424082205, 91, 0, 91, 0, 0, 0
1267, 1, 1636424082238, 1636424082330, 92, 0, 92, 0, 0, 0
1269, 1, 1636424082518, 1636424082606, 88, 0, 88, 0, 0, 0
1270, 1, 1636424082697, 1636424082789, 92, 1, 91, 1, 0, 1
1271, 1, 1636424082718, 1636424082810, 92, 0, 92, 0, 0, 0
1172, 1, 1636424082726, 1636424082817, 91, 0, 91, 0, 0, 0
1272, 1, 1636424082810, 1636424082901, 91, 0, 91, 0, 0, 0
1274, 1, 1636424082953, 1636424083045, 92, 1, 91, 0, 0, 0
1276, 1, 1636424083085, 1636424083174, 89, 0, 89, 0, 0, 0
1278, 1, 1636424083449, 1636424083538, 89, 1, 88, 0, 0, 0
1279, 1, 1636424083470, 1636424083561, 91, 0, 91, 0, 0, 0
1281, 1, 1636424083874, 1636424083966, 92, 0, 92, 0, 0, 0
1283, 1, 1636424084057, 1636424084146, 89, 1, 88, 0, 0, 0
1284, 1, 1636424084146, 1636424084238, 92, 0, 92, 0, 0, 0
1285, 1, 1636424084342, 1636424084433, 91, 0, 91, 0, 0, 0
1286, 1, 1636424084430, 1636424084521, 91, 0, 91, 0, 0, 0
1288, 1, 1636424084833, 1636424084925, 92, 1, 91, 1, 0, 1
1287, 1, 1636424084833, 1636424084925, 92, 1, 91, 1, 0, 1
1289, 1, 1636424085154, 1636424085246, 92, 0, 92, 0, 0, 0
1290, 1, 1636424085346, 1636424085438, 92, 0, 92, 0, 0, 0
1291, 1, 1636424085485, 1636424085577, 92, 1, 91, 0, 1, 1
1292, 1, 1636424085633, 1636424085730, 97, 1, 96, 1, 0, 1
1293, 1, 1636424085806, 1636424085898, 92, 0, 92, 0, 0, 0
1294, 1, 1636424086129, 1636424086222, 93, 1, 92, 0, 0, 0
1295, 1, 1636424086214, 1636424086306, 92, 0, 92, 0, 0, 0
1296, 1, 1636424086577, 1636424086670, 93, 1, 92, 0, 0, 0
1298, 1, 1636424086858, 1636424086949, 91, 0, 91, 0, 0, 0
1299, 1, 1636424086909, 1636424086997, 88, 0, 88, 0, 0, 0
1300, 1, 1636424087085, 1636424087174, 89, 0, 89, 0, 0, 0
1301, 1, 1636424087414, 1636424087506, 92, 0, 92, 0, 0, 0
1302, 1, 1636424087570, 1636424087662, 92, 0, 92, 0, 0, 0
1303, 1, 1636424087902, 1636424087994, 92, 0, 92, 0, 0, 0
1304, 1, 1636424088202, 1636424088293, 91, 0, 91, 0, 0, 0
1306, 1, 1636424088457, 1636424088550, 93, 1, 92, 1, 0, 1
1308, 1, 1636424088937, 1636424089030, 93, 1, 92, 0, 0, 0
1309, 1, 1636424089194, 1636424089286, 92, 0, 92, 0, 0, 0
1310, 1, 1636424089570, 1636424089662, 92, 0, 92, 0, 0, 0
1311, 1, 1636424089810, 1636424089902, 92, 0, 92, 0, 0, 0
1312, 1, 1636424090294, 1636424090386, 92, 0, 92, 0, 0, 0
1313, 1, 1636424090505, 1636424090598, 93, 1, 92, 1, 0, 1
1314, 1, 1636424091022, 1636424091109, 87, 0, 87, 0, 0, 0
1315, 1, 1636424091201, 1636424091294, 93, 1, 92, 1, 0, 1
1318, 1, 1636424091686, 1636424091778, 92, 0, 92, 0, 0, 0
1319, 1, 1636424091854, 1636424091990, 136, 0, 136, 0, 0, 0
1320, 1, 1636424092082, 1636424092174, 92, 0, 92, 0, 0, 0
1329, 1, 1636424093202, 1636424093294, 92, 0, 92, 0, 0, 0
1331, 1, 1636424093261, 1636424093389, 128, 1, 127, 0, 1, 1
1326, 1, 1636424093393, 1636424093486, 93, 1, 92, 0, 0, 0
1335, 1, 1636424094074, 1636424094166, 92, 0, 92, 0, 0, 0
1337, 1, 1636424094533, 1636424094626, 93, 1, 92, 0, 1, 1
1339, 1, 1636424095354, 1636424095446, 92, 0, 92, 0, 0, 0
1340, 1, 1636424095837, 1636424095930, 93, 1, 92, 0, 0, 0
1341, 1, 1636424096678, 1636424096770, 92, 0, 92, 0, 0, 0
1343, 1, 1636424097210, 1636424097301, 91, 0, 91, 0, 0, 0
1344, 1, 1636424097926, 1636424098018, 92, 0, 92, 0, 0, 0
1345, 1, 1636424098482, 1636424098605, 123, 0, 123, 0, 0, 0
1346, 1, 1636424098550, 1636424098641, 91, 0, 91, 0, 0, 0
1347, 1, 1636424099050, 1636424099141, 91, 0, 91, 0, 0, 0
1348, 1, 1636424099198, 1636424099290, 92, 0, 92, 0, 0, 0
1349, 1, 1636424099794, 1636424099885, 91, 0, 91, 0, 0, 0
1350, 1, 1636424099873, 1636424099966, 93, 1, 92, 1, 0, 1
1351, 1, 1636424100301, 1636424100394, 93, 1, 92, 1, 0, 1
1352, 1, 1636424100525, 1636424100617, 92, 1, 91, 0, 0, 0
1353, 1, 1636424101114, 1636424101206, 92, 0, 92, 0, 0, 0
1354, 1, 1636424101237, 1636424101333, 96, 1, 95, 1, 0, 1
1355, 1, 1636424101621, 1636424101710, 89, 0, 89, 0, 0, 0
1357, 1, 1636424101734, 1636424101825, 91, 0, 91, 0, 0, 0
1358, 1, 1636424101926, 1636424102017, 91, 0, 91, 0, 0, 0
1356, 1, 1636424102190, 1636424102302, 112, 0, 112, 0, 0, 0
1328, 1, 1636424102393, 1636424102490, 97, 1, 96, 0, 0, 0
1361, 1, 1636424102481, 1636424102570, 89, 0, 89, 0, 0, 0
1362, 1, 1636424102570, 1636424102662, 92, 0, 92, 0, 0, 0
1360, 1, 1636424102662, 1636424102750, 88, 0, 88, 0, 0, 0
1366, 1, 1636424102929, 1636424103022, 93, 1, 92, 0, 0, 0
1367, 1, 1636424102937, 1636424103025, 88, 0, 88, 0, 0, 0
1370, 1, 1636424103125, 1636424103237, 112, 1, 111, 0, 0, 0
1371, 1, 1636424103237, 1636424103329, 92, 0, 92, 0, 0, 0
1368, 1, 1636424103385, 1636424103474, 89, 0, 89, 0, 0, 0
1372, 1, 1636424103593, 1636424103694, 101, 1, 100, 1, 0, 1
1373, 1, 1636424103601, 1636424103694, 93, 1, 92, 0, 0, 0
1338, 1, 1636424103705, 1636424103794, 89, 0, 89, 0, 0, 0
1375, 1, 1636424103794, 1636424103885, 91, 0, 91, 0, 0, 0
1376, 1, 1636424103954, 1636424104073, 119, 0, 119, 0, 0, 0
1342, 1, 1636424104206, 1636424104297, 91, 0, 91, 0, 0, 0
1379, 1, 1636424104305, 1636424104397, 92, 1, 91, 1, 0, 1
1382, 1, 1636424104305, 1636424104398, 93, 1, 92, 0, 0, 0
1380, 1, 1636424104305, 1636424104397, 92, 1, 91, 0, 0, 0
1383, 1, 1636424104385, 1636424104477, 92, 1, 91, 1, 0, 1
1384, 1, 1636424104481, 1636424104574, 93, 1, 92, 0, 0, 0
1381, 1, 1636424104761, 1636424104853, 92, 1, 91, 0, 0, 0
1387, 1, 1636424104870, 1636424104961, 91, 0, 91, 0, 0, 0
1388, 1, 1636424104917, 1636424105006, 89, 0, 89, 0, 0, 0
1389, 1, 1636424105157, 1636424105246, 89, 0, 89, 0, 0, 0
1390, 1, 1636424105310, 1636424105402, 92, 0, 92, 0, 0, 0
1391, 1, 1636424105554, 1636424105645, 91, 0, 91, 0, 0, 0
1393, 1, 1636424105661, 1636424105753, 92, 1, 91, 0, 0, 0
1394, 1, 1636424105677, 1636424105765, 88, 1, 87, 0, 0, 0
1395, 1, 1636424105689, 1636424105781, 92, 1, 91, 1, 0, 1
1396, 1, 1636424105761, 1636424105849, 88, 0, 88, 0, 0, 0
1392, 1, 1636424106009, 1636424106101, 92, 1, 91, 0, 0, 0
1397, 1, 1636424106189, 1636424106281, 92, 1, 91, 1, 0, 1
1398, 1, 1636424106230, 1636424106322, 92, 0, 92, 0, 0, 0
1399, 1, 1636424106497, 1636424106589, 92, 1, 91, 0, 0, 0
1400, 1, 1636424106645, 1636424106737, 92, 1, 91, 0, 0, 0
1401, 1, 1636424106858, 1636424106950, 92, 0, 92, 0, 0, 0
1403, 1, 1636424107005, 1636424107097, 92, 1, 91, 0, 0, 0
1404, 1, 1636424107018, 1636424107109, 91, 0, 91, 0, 0, 0
1405, 1, 1636424107026, 1636424107118, 92, 0, 92, 0, 0, 0
1406, 1, 1636424107041, 1636424107134, 93, 1, 92, 0, 1, 1
1402, 1, 1636424107313, 1636424107406, 93, 1, 92, 1, 0, 1
1407, 1, 1636424107497, 1636424107590, 93, 1, 92, 1, 0, 1
1408, 1, 1636424107590, 1636424107686, 96, 0, 96, 0, 0, 0
1409, 1, 1636424107770, 1636424107861, 91, 0, 91, 0, 0, 0
1410, 1, 1636424108006, 1636424108102, 96, 0, 96, 0, 0, 0
1411, 1, 1636424108186, 1636424108277, 91, 0, 91, 0, 0, 0
1412, 1, 1636424108290, 1636424108381, 91, 0, 91, 0, 0, 0
1415, 1, 1636424108301, 1636424108393, 92, 1, 91, 1, 0, 1
1413, 1, 1636424108301, 1636424108393, 92, 1, 91, 0, 1, 1
1416, 1, 1636424108346, 1636424108438, 92, 0, 92, 0, 0, 0
1414, 1, 1636424108646, 1636424108738, 92, 0, 92, 0, 0, 0
1417, 1, 1636424108866, 1636424108957, 91, 0, 91, 0, 0, 0
1418, 1, 1636424108949, 1636424109041, 92, 1, 91, 0, 0, 0
1419, 1, 1636424109038, 1636424109129, 91, 0, 91, 0, 0, 0
1420, 1, 1636424109273, 1636424109366, 93, 1, 92, 0, 0, 0
1421, 1, 1636424109557, 1636424109649, 92, 1, 91, 0, 0, 0
1422, 1, 1636424109589, 1636424109681, 92, 1, 91, 1, 0, 1
1423, 1, 1636424109597, 1636424109685, 88, 0, 88, 0, 0, 0
1424, 1, 1636424109641, 1636424109729, 88, 0, 88, 0, 0, 0
1426, 1, 1636424109737, 1636424109826, 89, 0, 89, 0, 0, 0
1425, 1, 1636424110045, 1636424110138, 93, 1, 92, 0, 0, 0
1427, 1, 1636424110229, 1636424110317, 88, 0, 88, 0, 0, 0
1428, 1, 1636424110286, 1636424110373, 87, 0, 87, 0, 0, 0
1429, 1, 1636424110385, 1636424110478, 93, 0, 93, 0, 0, 0
1430, 1, 1636424110578, 1636424110670, 92, 0, 92, 0, 0, 0
1431, 1, 1636424110865, 1636424110958, 93, 1, 92, 0, 1, 1
1432, 1, 1636424110882, 1636424110969, 87, 0, 87, 0, 0, 0
1433, 1, 1636424110917, 1636424111009, 92, 1, 91, 1, 0, 1
1435, 1, 1636424110985, 1636424111073, 88, 0, 88, 0, 0, 0
1436, 1, 1636424111109, 1636424111202, 93, 1, 92, 1, 0, 1
1434, 1, 1636424111317, 1636424111410, 93, 1, 92, 1, 0, 1
1437, 1, 1636424111561, 1636424111654, 93, 1, 92, 0, 0, 0
1438, 1, 1636424111593, 1636424111681, 88, 0, 88, 0, 0, 0
1439, 1, 1636424111741, 1636424111833, 92, 1, 91, 1, 0, 1
1440, 1, 1636424111866, 1636424111957, 91, 0, 91, 0, 0, 0
1441, 1, 1636424112146, 1636424112237, 91, 0, 91, 0, 0, 0
1442, 1, 1636424112170, 1636424112261, 91, 0, 91, 0, 0, 0
1444, 1, 1636424112270, 1636424112362, 92, 0, 92, 0, 0, 0
1445, 1, 1636424112325, 1636424112417, 92, 1, 91, 1, 0, 1
1446, 1, 1636424112413, 1636424112505, 92, 1, 91, 0, 0, 0
1443, 1, 1636424112626, 1636424112769, 143, 0, 143, 0, 0, 0
1447, 1, 1636424112862, 1636424112953, 91, 0, 91, 0, 0, 0
1369, 1, 1636424112901, 1636424112993, 92, 1, 91, 0, 0, 0
1448, 1, 1636424112961, 1636424113054, 93, 1, 92, 0, 0, 0
1449, 1, 1636424113038, 1636424113129, 91, 0, 91, 0, 0, 0
1452, 1, 1636424113137, 1636424113229, 92, 1, 91, 0, 0, 0
1450, 1, 1636424113165, 1636424113262, 97, 1, 96, 0, 1, 1
1453, 1, 1636424113453, 1636424113546, 93, 1, 92, 0, 0, 0
1455, 1, 1636424113553, 1636424113645, 92, 1, 91, 0, 1, 1
1456, 1, 1636424113582, 1636424113673, 91, 0, 91, 0, 0, 0
1454, 1, 1636424113633, 1636424113725, 92, 1, 91, 1, 0, 1
1457, 1, 1636424113633, 1636424113729, 96, 1, 95, 1, 0, 1
1459, 1, 1636424113717, 1636424113810, 93, 1, 92, 0, 0, 0
1458, 1, 1636424114009, 1636424114105, 96, 1, 95, 0, 0, 0
1451, 1, 1636424114094, 1636424114185, 91, 0, 91, 0, 0, 0
1460, 1, 1636424114173, 1636424114265, 92, 1, 91, 0, 1, 1
1462, 1, 1636424114394, 1636424114485, 91, 0, 91, 0, 0, 0
1466, 1, 1636424114394, 1636424114486, 92, 1, 91, 0, 0, 0
1463, 1, 1636424114394, 1636424114486, 92, 0, 92, 0, 0, 0
1468, 1, 1636424114485, 1636424114581, 96, 1, 95, 0, 1, 1
1469, 1, 1636424114485, 1636424114581, 96, 1, 95, 1, 0, 1
1386, 1, 1636424114525, 1636424114617, 92, 0, 92, 0, 0, 0
1461, 1, 1636424114549, 1636424114645, 96, 1, 95, 1, 0, 1
1471, 1, 1636424114778, 1636424114869, 91, 0, 91, 0, 0, 0
1470, 1, 1636424114785, 1636424114877, 92, 1, 91, 1, 0, 1
1472, 1, 1636424114849, 1636424114941, 92, 1, 91, 0, 1, 1
1465, 1, 1636424114849, 1636424114945, 96, 1, 95, 1, 0, 1
1474, 1, 1636424114921, 1636424115009, 88, 1, 87, 0, 0, 0
1475, 1, 1636424114937, 1636424115026, 89, 1, 88, 0, 0, 0
1473, 1, 1636424114933, 1636424115026, 93, 1, 92, 1, 0, 1
1476, 1, 1636424114949, 1636424115041, 92, 1, 91, 0, 0, 0
1478, 1, 1636424114985, 1636424115073, 88, 0, 88, 0, 0, 0
1477, 1, 1636424115366, 1636424115458, 92, 0, 92, 0, 0, 0
1480, 1, 1636424115489, 1636424115586, 97, 1, 96, 0, 0, 0
1481, 1, 1636424115633, 1636424115725, 92, 1, 91, 0, 0, 0
1482, 1, 1636424115657, 1636424115749, 92, 1, 91, 0, 0, 0
1484, 1, 1636424115673, 1636424115765, 92, 1, 91, 0, 1, 1
1485, 1, 1636424115729, 1636424115821, 92, 0, 92, 0, 0, 0
1486, 1, 1636424115765, 1636424115857, 92, 1, 91, 1, 0, 1
1487, 1, 1636424115794, 1636424115885, 91, 0, 91, 0, 0, 0
1488, 1, 1636424116029, 1636424116114, 85, 0, 85, 0, 0, 0
1489, 1, 1636424116033, 1636424116125, 92, 1, 91, 0, 0, 0
1483, 1, 1636424116114, 1636424116205, 91, 0, 91, 0, 0, 0
1490, 1, 1636424116133, 1636424116221, 88, 0, 88, 0, 0, 0
1491, 1, 1636424116213, 1636424116305, 92, 1, 91, 1, 0, 1
1492, 1, 1636424116237, 1636424116325, 88, 0, 88, 0, 0, 0
1494, 1, 1636424116293, 1636424116385, 92, 1, 91, 1, 0, 1
1495, 1, 1636424116305, 1636424116397, 92, 1, 91, 1, 0, 1
1496, 1, 1636424116321, 1636424116409, 88, 0, 88, 0, 0, 0
1493, 1, 1636424116669, 1636424116758, 89, 1, 88, 1, 0, 1
1497, 1, 1636424116845, 1636424116930, 85, 0, 85, 0, 0, 0
1498, 1, 1636424116933, 1636424117034, 101, 0, 101, 0, 0, 0
1499, 1, 1636424116977, 1636424117081, 104, 0, 104, 0, 0, 0
1501, 1, 1636424117005, 1636424117093, 88, 1, 87, 0, 0, 0
1502, 1, 1636424117034, 1636424117122, 88, 1, 87, 0, 0, 0
1503, 1, 1636424117081, 1636424117166, 85, 0, 85, 0, 0, 0
1504, 1, 1636424117165, 1636424117257, 92, 1, 91, 0, 0, 0
1505, 1, 1636424117297, 1636424117389, 92, 1, 91, 0, 0, 0
1506, 1, 1636424117357, 1636424117445, 88, 0, 88, 0, 0, 0
1500, 1, 1636424117433, 1636424117525, 92, 1, 91, 1, 0, 1
1507, 1, 1636424117477, 1636424117569, 92, 1, 91, 1, 0, 1
1510, 1, 1636424117581, 1636424117669, 88, 0, 88, 0, 0, 0
1511, 1, 1636424117598, 1636424117689, 91, 0, 91, 0, 0, 0
1509, 1, 1636424117617, 1636424117710, 93, 1, 92, 0, 1, 1
1512, 1, 1636424117617, 1636424117710, 93, 1, 92, 0, 0, 0
1508, 1, 1636424117926, 1636424118017, 91, 0, 91, 0, 0, 0
1513, 1, 1636424118029, 1636424118122, 93, 1, 92, 0, 0, 0
1515, 1, 1636424118277, 1636424118365, 88, 0, 88, 0, 0, 0
1516, 1, 1636424118318, 1636424118409, 91, 0, 91, 0, 0, 0
1517, 1, 1636424118318, 1636424118409, 91, 1, 90, 0, 0, 0
1519, 1, 1636424118405, 1636424118493, 88, 1, 87, 1, 0, 1
1520, 1, 1636424118417, 1636424118501, 84, 0, 84, 0, 0, 0
1514, 1, 1636424118485, 1636424118577, 92, 1, 91, 1, 0, 1
1521, 1, 1636424118493, 1636424118589, 96, 1, 95, 0, 0, 0
1522, 1, 1636424118649, 1636424118737, 88, 1, 87, 0, 1, 1
1523, 1, 1636424118705, 1636424118797, 92, 1, 91, 0, 0, 0
1518, 1, 1636424118721, 1636424118809, 88, 0, 88, 0, 0, 0
1524, 1, 1636424118862, 1636424118953, 91, 0, 91, 0, 0, 0
1525, 1, 1636424118897, 1636424118985, 88, 0, 88, 0, 0, 0
1526, 1, 1636424118909, 1636424118997, 88, 0, 88, 0, 0, 0
1527, 1, 1636424118917, 1636424119005, 88, 0, 88, 0, 0, 0
1528, 1, 1636424118941, 1636424119029, 88, 0, 88, 0, 0, 0
1530, 1, 1636424119018, 1636424119110, 92, 0, 92, 0, 0, 0
1529, 1, 1636424119369, 1636424119461, 92, 1, 91, 0, 0, 0
1531, 1, 1636424119473, 1636424119565, 92, 1, 91, 1, 0, 1
1532, 1, 1636424119641, 1636424119733, 92, 1, 91, 1, 0, 1
1533, 1, 1636424119669, 1636424119761, 92, 1, 91, 0, 0, 0
1534, 1, 1636424119681, 1636424119773, 92, 1, 91, 0, 0, 0
1536, 1, 1636424119693, 1636424119781, 88, 1, 87, 0, 0, 0
1537, 1, 1636424119785, 1636424119874, 89, 0, 89, 0, 0, 0
1538, 1, 1636424119785, 1636424119874, 89, 0, 89, 0, 0, 0
1539, 1, 1636424119977, 1636424120069, 92, 1, 91, 0, 1, 1
1540, 1, 1636424119997, 1636424120094, 97, 1, 96, 1, 0, 1
1535, 1, 1636424120093, 1636424120186, 93, 1, 92, 0, 0, 0
1542, 1, 1636424120198, 1636424120289, 91, 0, 91, 0, 0, 0
1541, 1, 1636424120233, 1636424120325, 92, 1, 91, 0, 0, 0
1544, 1, 1636424120245, 1636424120333, 88, 1, 87, 0, 0, 0
1543, 1, 1636424120245, 1636424120341, 96, 1, 95, 0, 1, 1
1545, 1, 1636424120257, 1636424120345, 88, 0, 88, 0, 0, 0
1547, 1, 1636424120373, 1636424120465, 92, 1, 91, 0, 0, 0
1546, 1, 1636424120705, 1636424120801, 96, 1, 95, 0, 0, 0
1548, 1, 1636424120793, 1636424120886, 93, 1, 92, 1, 0, 1
1549, 1, 1636424120982, 1636424121069, 87, 0, 87, 0, 0, 0
1550, 1, 1636424121017, 1636424121109, 92, 1, 91, 1, 0, 1
1551, 1, 1636424121025, 1636424121113, 88, 1, 87, 0, 0, 0
1553, 1, 1636424121029, 1636424121118, 89, 0, 89, 0, 0, 0
1554, 1, 1636424121117, 1636424121209, 92, 1, 91, 0, 0, 0
1555, 1, 1636424121125, 1636424121221, 96, 1, 95, 1, 0, 1
1556, 1, 1636424121277, 1636424121370, 93, 0, 93, 0, 0, 0
1557, 1, 1636424121329, 1636424121425, 96, 1, 95, 0, 0, 0
1552, 1, 1636424121469, 1636424121561, 92, 1, 91, 0, 1, 1
1558, 1, 1636424121510, 1636424121602, 92, 0, 92, 0, 0, 0
1560, 1, 1636424121565, 1636424121653, 88, 0, 88, 0, 0, 0
1559, 1, 1636424121577, 1636424121670, 93, 1, 92, 0, 0, 0
1561, 1, 1636424121577, 1636424121670, 93, 1, 92, 0, 0, 0
1562, 1, 1636424121602, 1636424121694, 92, 0, 92, 0, 0, 0
1564, 1, 1636424121697, 1636424121790, 93, 1, 92, 0, 0, 0
1563, 1, 1636424121970, 1636424122062, 92, 0, 92, 0, 0, 0
1565, 1, 1636424122094, 1636424122185, 91, 0, 91, 0, 0, 0
1566, 1, 1636424122305, 1636424122397, 92, 0, 92, 0, 0, 0
1568, 1, 1636424122313, 1636424122410, 97, 1, 96, 0, 0, 0
1567, 1, 1636424122313, 1636424122410, 97, 1, 96, 0, 0, 0
1570, 1, 1636424122377, 1636424122466, 89, 0, 89, 0, 0, 0
1572, 1, 1636424122465, 1636424122561, 96, 1, 95, 1, 0, 1
1571, 1, 1636424122465, 1636424122561, 96, 1, 95, 0, 0, 0
1573, 1, 1636424122545, 1636424122638, 93, 1, 92, 0, 0, 0
1574, 1, 1636424122689, 1636424122781, 92, 1, 91, 1, 0, 1
1569, 1, 1636424122774, 1636424122865, 91, 0, 91, 0, 0, 0
1575, 1, 1636424122889, 1636424122978, 89, 0, 89, 0, 0, 0
1576, 1, 1636424122933, 1636424123029, 96, 0, 96, 0, 0, 0
1577, 1, 1636424122933, 1636424123029, 96, 1, 95, 0, 0, 0
1578, 1, 1636424122941, 1636424123029, 88, 0, 88, 0, 0, 0
1581, 1, 1636424122981, 1636424123074, 93, 1, 92, 0, 0, 0
1580, 1, 1636424122981, 1636424123074, 93, 1, 92, 0, 0, 0
1579, 1, 1636424123329, 1636424123421, 92, 1, 91, 0, 0, 0
1582, 1, 1636424123406, 1636424123497, 91, 0, 91, 0, 0, 0
1583, 1, 1636424123569, 1636424123662, 93, 1, 92, 1, 0, 1
1584, 1, 1636424123594, 1636424123689, 95, 0, 95, 0, 0, 0
1586, 1, 1636424123669, 1636424123762, 93, 1, 92, 1, 0, 1
1587, 1, 1636424123673, 1636424123769, 96, 0, 96, 0, 0, 0
1589, 1, 1636424123833, 1636424123925, 92, 1, 91, 0, 0, 0
1590, 1, 1636424123841, 1636424123933, 92, 1, 91, 1, 0, 1
1591, 1, 1636424123969, 1636424124061, 92, 1, 91, 1, 0, 1
1585, 1, 1636424124053, 1636424124141, 88, 0, 88, 0, 0, 0
1588, 1, 1636424124133, 1636424124310, 177, 1, 176, 1, 0, 1
1596, 1, 1636424124309, 1636424124402, 93, 1, 92, 0, 1, 1
1592, 1, 1636424124309, 1636424124402, 93, 1, 92, 0, 1, 1
1593, 1, 1636424124309, 1636424124402, 93, 1, 92, 0, 1, 1
1598, 1, 1636424124401, 1636424124493, 92, 1, 91, 0, 0, 0
1594, 1, 1636424124673, 1636424124766, 93, 1, 92, 0, 0, 0
1595, 1, 1636424124766, 1636424124857, 91, 1, 90, 0, 0, 0
1597, 1, 1636424124766, 1636424124857, 91, 1, 90, 0, 1, 1
1600, 1, 1636424124853, 1636424124945, 92, 1, 91, 0, 0, 0
1601, 1, 1636424124898, 1636424124989, 91, 0, 91, 0, 0, 0
1603, 1, 1636424125013, 1636424125109, 96, 1, 95, 1, 0, 1
1605, 1, 1636424125153, 1636424125245, 92, 1, 91, 0, 0, 0
1606, 1, 1636424125161, 1636424125249, 88, 0, 88, 0, 0, 0
1607, 1, 1636424125173, 1636424125265, 92, 1, 91, 0, 1, 1
1608, 1, 1636424125354, 1636424125445, 91, 0, 91, 0, 0, 0
1602, 1, 1636424125354, 1636424125445, 91, 0, 91, 0, 0, 0
1609, 1, 1636424125505, 1636424125598, 93, 1, 92, 0, 1, 1
1613, 1, 1636424125597, 1636424125689, 92, 1, 91, 0, 0, 0
1614, 1, 1636424125625, 1636424125718, 93, 1, 92, 1, 0, 1
1615, 1, 1636424125625, 1636424125718, 93, 1, 92, 1, 0, 1
1617, 1, 1636424125693, 1636424125781, 88, 0, 88, 0, 0, 0
1618, 1, 1636424125721, 1636424125810, 89, 0, 89, 0, 0, 0
1610, 1, 1636424125810, 1636424125905, 95, 0, 95, 0, 0, 0
1611, 1, 1636424125957, 1636424126049, 92, 1, 91, 0, 1, 1
1616, 1, 1636424126049, 1636424126141, 92, 1, 91, 0, 0, 0
1619, 1, 1636424126182, 1636424126277, 95, 0, 95, 0, 0, 0
1620, 1, 1636424126182, 1636424126277, 95, 0, 95, 0, 0, 0
1622, 1, 1636424126358, 1636424126450, 92, 0, 92, 0, 0, 0
1612, 1, 1636424126409, 1636424126505, 96, 1, 95, 0, 1, 1
1623, 1, 1636424126437, 1636424126529, 92, 1, 91, 0, 1, 1
1624, 1, 1636424126477, 1636424126569, 92, 1, 91, 1, 0, 1
1625, 1, 1636424126561, 1636424126653, 92, 1, 91, 0, 0, 0
1621, 1, 1636424126633, 1636424126726, 93, 1, 92, 1, 0, 1
1626, 1, 1636424126697, 1636424126785, 88, 1, 87, 0, 1, 1
1629, 1, 1636424126885, 1636424126977, 92, 1, 91, 0, 0, 0
1630, 1, 1636424126905, 1636424126993, 88, 0, 88, 0, 0, 0
1631, 1, 1636424126933, 1636424127021, 88, 0, 88, 0, 0, 0
1633, 1, 1636424126961, 1636424127046, 85, 0, 85, 0, 0, 0
1634, 1, 1636424127005, 1636424127093, 88, 1, 87, 0, 0, 0
1636, 1, 1636424127113, 1636424127210, 97, 1, 96, 1, 0, 1
1632, 1, 1636424127337, 1636424127430, 93, 1, 92, 0, 1, 1
1637, 1, 1636424127529, 1636424127621, 92, 1, 91, 1, 0, 1
1638, 1, 1636424127577, 1636424127665, 88, 0, 88, 0, 0, 0
1640, 1, 1636424127710, 1636424127801, 91, 0, 91, 0, 0, 0
1641, 1, 1636424127786, 1636424127877, 91, 0, 91, 0, 0, 0
1642, 1, 1636424127813, 1636424127909, 96, 1, 95, 0, 1, 1
1643, 1, 1636424127905, 1636424127997, 92, 1, 91, 0, 1, 1
1644, 1, 1636424127985, 1636424128077, 92, 1, 91, 0, 0, 0
1639, 1, 1636424128021, 1636424128105, 84, 1, 83, 0, 0, 0
1645, 1, 1636424128157, 1636424128249, 92, 1, 91, 0, 1, 1
1646, 1, 1636424128189, 1636424128281, 92, 1, 91, 1, 0, 1
1647, 1, 1636424128281, 1636424128374, 93, 1, 92, 1, 0, 1
1649, 1, 1636424128293, 1636424128385, 92, 1, 91, 0, 1, 1
1650, 1, 1636424128333, 1636424128425, 92, 0, 92, 0, 0, 0
1651, 1, 1636424128397, 1636424128490, 93, 1, 92, 1, 0, 1
1648, 1, 1636424128605, 1636424128697, 92, 1, 91, 0, 0, 0
1652, 1, 1636424128869, 1636424128961, 92, 1, 91, 1, 0, 1
1653, 1, 1636424128957, 1636424129049, 92, 1, 91, 1, 0, 1
1655, 1, 1636424129001, 1636424129093, 92, 1, 91, 0, 0, 0
1656, 1, 1636424129109, 1636424129197, 88, 0, 88, 0, 0, 0
1657, 1, 1636424129153, 1636424129241, 88, 0, 88, 0, 0, 0
1658, 1, 1636424129173, 1636424129265, 92, 1, 91, 0, 0, 0
1659, 1, 1636424129353, 1636424129449, 96, 1, 95, 1, 0, 1
1654, 1, 1636424129405, 1636424129493, 88, 1, 87, 0, 0, 0
1660, 1, 1636424129469, 1636424129561, 92, 1, 91, 0, 1, 1
1661, 1, 1636424129485, 1636424129577, 92, 1, 91, 1, 0, 1
1663, 1, 1636424129629, 1636424129722, 93, 1, 92, 0, 0, 0
1664, 1, 1636424129629, 1636424129722, 93, 1, 92, 0, 0, 0
1665, 1, 1636424129657, 1636424129749, 92, 1, 91, 0, 1, 1
1666, 1, 1636424129665, 1636424129757, 92, 1, 91, 0, 1, 1
1662, 1, 1636424129917, 1636424130009, 92, 1, 91, 0, 1, 1
1667, 1, 1636424130169, 1636424130262, 93, 1, 92, 0, 0, 0
1668, 1, 1636424130246, 1636424130342, 96, 0, 96, 0, 0, 0
1670, 1, 1636424130406, 1636424130502, 96, 0, 96, 0, 0, 0
1671, 1, 1636424130461, 1636424130549, 88, 0, 88, 0, 0, 0
1672, 1, 1636424130501, 1636424130593, 92, 1, 91, 0, 0, 0
1673, 1, 1636424130513, 1636424130605, 92, 1, 91, 0, 1, 1
1674, 1, 1636424130621, 1636424130713, 92, 1, 91, 0, 1, 1
1669, 1, 1636424130701, 1636424130793, 92, 1, 91, 1, 0, 1
1676, 1, 1636424130906, 1636424130998, 92, 0, 92, 0, 0, 0
1678, 1, 1636424130942, 1636424131033, 91, 0, 91, 0, 0, 0
1679, 1, 1636424131001, 1636424131094, 93, 1, 92, 1, 0, 1
1680, 1, 1636424131029, 1636424131122, 93, 1, 92, 1, 0, 1
1681, 1, 1636424131053, 1636424131146, 93, 1, 92, 0, 0, 0
1682, 1, 1636424131465, 1636424131557, 92, 1, 91, 1, 0, 1
1683, 1, 1636424131573, 1636424131662, 89, 0, 89, 0, 0, 0
1686, 1, 1636424131734, 1636424131826, 92, 0, 92, 0, 0, 0
1689, 1, 1636424131917, 1636424132009, 92, 1, 91, 0, 0, 0
1684, 1, 1636424132021, 1636424132114, 93, 1, 92, 0, 1, 1
1691, 1, 1636424132258, 1636424132350, 92, 0, 92, 0, 0, 0
1693, 1, 1636424132390, 1636424132482, 92, 0, 92, 0, 0, 0
1694, 1, 1636424132410, 1636424132502, 92, 0, 92, 0, 0, 0
1698, 1, 1636424133078, 1636424133170, 92, 0, 92, 0, 0, 0
1699, 1, 1636424133210, 1636424133302, 92, 0, 92, 0, 0, 0
1700, 1, 1636424133657, 1636424133750, 93, 1, 92, 0, 1, 1
1701, 1, 1636424133729, 1636424133822, 93, 1, 92, 1, 0, 1
1702, 1, 1636424133746, 1636424133838, 92, 0, 92, 0, 0, 0
1703, 1, 1636424134461, 1636424134554, 93, 1, 92, 0, 0, 0
1704, 1, 1636424134486, 1636424134618, 132, 0, 132, 0, 0, 0
1705, 1, 1636424134986, 1636424135077, 91, 0, 91, 0, 0, 0
1706, 1, 1636424135021, 1636424135114, 93, 1, 92, 1, 0, 1
1707, 1, 1636424135118, 1636424135210, 92, 0, 92, 0, 0, 0
1708, 1, 1636424135333, 1636424135422, 89, 0, 89, 0, 0, 0
1709, 1, 1636424135437, 1636424135530, 93, 1, 92, 0, 1, 1
1710, 1, 1636424135737, 1636424135830, 93, 1, 92, 1, 0, 1
1711, 1, 1636424135770, 1636424135862, 92, 0, 92, 0, 0, 0
1712, 1, 1636424136218, 1636424136314, 96, 0, 96, 0, 0, 0
1713, 1, 1636424136294, 1636424136381, 87, 0, 87, 0, 0, 0
1714, 1, 1636424136381, 1636424136478, 97, 1, 96, 1, 0, 1
1715, 1, 1636424136714, 1636424136809, 95, 0, 95, 0, 0, 0
1716, 1, 1636424136714, 1636424136809, 95, 0, 95, 0, 0, 0
1718, 1, 1636424137105, 1636424137193, 88, 0, 88, 0, 0, 0
1717, 1, 1636424137105, 1636424137197, 92, 1, 91, 0, 0, 0
1722, 1, 1636424137537, 1636424137630, 93, 1, 92, 1, 0, 1
1721, 1, 1636424137561, 1636424137650, 89, 0, 89, 0, 0, 0
1723, 1, 1636424137650, 1636424137742, 92, 0, 92, 0, 0, 0
1725, 1, 1636424138002, 1636424138093, 91, 0, 91, 0, 0, 0
1724, 1, 1636424138014, 1636424138109, 95, 0, 95, 0, 0, 0
1726, 1, 1636424138021, 1636424138118, 97, 1, 96, 0, 0, 0
1727, 1, 1636424138362, 1636424138450, 88, 0, 88, 0, 0, 0
1728, 1, 1636424138449, 1636424138542, 93, 1, 92, 0, 0, 0
1729, 1, 1636424138542, 1636424138633, 91, 0, 91, 0, 0, 0
1730, 1, 1636424138825, 1636424138914, 89, 1, 88, 0, 1, 1
1731, 1, 1636424139006, 1636424139098, 92, 0, 92, 0, 0, 0
1732, 1, 1636424139101, 1636424139190, 89, 0, 89, 0, 0, 0
1733, 1, 1636424139330, 1636424139422, 92, 0, 92, 0, 0, 0
1734, 1, 1636424139377, 1636424139469, 92, 1, 91, 0, 0, 0
1735, 1, 1636424139649, 1636424139742, 93, 1, 92, 0, 0, 0
1736, 1, 1636424139830, 1636424139925, 95, 0, 95, 0, 0, 0
1738, 1, 1636424140162, 1636424140254, 92, 0, 92, 0, 0, 0
1739, 1, 1636424140286, 1636424140377, 91, 0, 91, 0, 0, 0
1740, 1, 1636424140485, 1636424140578, 93, 1, 92, 0, 1, 1
1741, 1, 1636424140646, 1636424140738, 92, 0, 92, 0, 0, 0
1742, 1, 1636424140717, 1636424140809, 92, 1, 91, 0, 1, 1
1743, 1, 1636424140966, 1636424141058, 92, 0, 92, 0, 0, 0
1745, 1, 1636424141125, 1636424141218, 93, 1, 92, 0, 0, 0
1747, 1, 1636424141433, 1636424141526, 93, 1, 92, 0, 0, 0
1748, 1, 1636424141709, 1636424141805, 96, 1, 95, 1, 0, 1
1749, 1, 1636424141889, 1636424141977, 88, 1, 87, 0, 0, 0
1750, 1, 1636424141973, 1636424142101, 128, 1, 127, 1, 0, 1
1751, 1, 1636424142025, 1636424142117, 92, 1, 91, 0, 0, 0
1754, 1, 1636424142269, 1636424142358, 89, 1, 88, 0, 0, 0
1752, 1, 1636424142269, 1636424142361, 92, 2, 90, 0, 0, 0
1753, 1, 1636424142269, 1636424142361, 92, 1, 91, 0, 0, 0
1695, 1, 1636424142305, 1636424142393, 88, 0, 88, 0, 0, 0
1755, 1, 1636424142349, 1636424142441, 92, 0, 92, 0, 0, 0
1756, 1, 1636424142445, 1636424142538, 93, 1, 92, 0, 1, 1
1758, 1, 1636424142713, 1636424142854, 141, 1, 140, 1, 0, 1
1759, 1, 1636424142733, 1636424142854, 121, 1, 120, 1, 0, 1
1737, 1, 1636424142985, 1636424143077, 92, 1, 91, 0, 0, 0
1761, 1, 1636424143033, 1636424143122, 89, 1, 88, 0, 0, 0
1760, 1, 1636424143033, 1636424143125, 92, 1, 91, 0, 1, 1
1762, 1, 1636424143121, 1636424143214, 93, 1, 92, 0, 0, 0
1764, 1, 1636424143214, 1636424143305, 91, 0, 91, 0, 0, 0
1763, 1, 1636424143249, 1636424143341, 92, 1, 91, 0, 0, 0
1766, 1, 1636424143329, 1636424143421, 92, 0, 92, 0, 0, 0
1768, 1, 1636424143429, 1636424143517, 88, 1, 87, 0, 1, 1
1767, 1, 1636424143429, 1636424143518, 89, 1, 88, 1, 0, 1
1769, 1, 1636424143457, 1636424143545, 88, 0, 88, 0, 0, 0
1771, 1, 1636424143630, 1636424143721, 91, 0, 91, 0, 0, 0
1770, 1, 1636424143661, 1636424143749, 88, 0, 88, 0, 0, 0
1765, 1, 1636424143697, 1636424143789, 92, 1, 91, 0, 1, 1
1772, 1, 1636424143718, 1636424143810, 92, 0, 92, 0, 0, 0
1773, 1, 1636424143902, 1636424143994, 92, 0, 92, 0, 0, 0
1774, 1, 1636424144005, 1636424144101, 96, 1, 95, 0, 0, 0
1775, 1, 1636424144237, 1636424144329, 92, 1, 91, 0, 1, 1
1776, 1, 1636424144325, 1636424144417, 92, 1, 91, 1, 0, 1
1777, 1, 1636424144361, 1636424144453, 92, 1, 91, 0, 0, 0
1778, 1, 1636424144474, 1636424144565, 91, 0, 91, 0, 0, 0
1779, 1, 1636424144485, 1636424144574, 89, 1, 88, 0, 0, 0
1781, 1, 1636424144629, 1636424144722, 93, 1, 92, 0, 0, 0
1782, 1, 1636424144761, 1636424144853, 92, 1, 91, 0, 0, 0
1783, 1, 1636424144817, 1636424144909, 92, 1, 91, 1, 0, 1
1784, 1, 1636424144821, 1636424144910, 89, 0, 89, 0, 0, 0
1780, 1, 1636424144921, 1636424145013, 92, 1, 91, 1, 0, 1
1786, 1, 1636424144957, 1636424145053, 96, 1, 95, 0, 0, 0
1787, 1, 1636424145017, 1636424145110, 93, 1, 92, 0, 0, 0
1788, 1, 1636424145218, 1636424145309, 91, 0, 91, 0, 0, 0
1785, 1, 1636424145269, 1636424145357, 88, 0, 88, 0, 0, 0
1789, 1, 1636424145374, 1636424145466, 92, 0, 92, 0, 0, 0
1792, 1, 1636424145638, 1636424145730, 92, 0, 92, 0, 0, 0
1791, 1, 1636424145633, 1636424145730, 97, 1, 96, 0, 1, 1
1790, 1, 1636424145713, 1636424145806, 93, 0, 93, 0, 0, 0
1793, 1, 1636424145777, 1636424145869, 92, 1, 91, 0, 0, 0
1794, 1, 1636424145790, 1636424145882, 92, 0, 92, 0, 0, 0
1796, 1, 1636424145902, 1636424145994, 92, 0, 92, 0, 0, 0
1797, 1, 1636424146089, 1636424146181, 92, 1, 91, 1, 0, 1
1798, 1, 1636424146161, 1636424146249, 88, 0, 88, 0, 0, 0
1799, 1, 1636424146173, 1636424146266, 93, 1, 92, 0, 1, 1
1800, 1, 1636424146205, 1636424146293, 88, 0, 88, 0, 0, 0
1795, 1, 1636424146229, 1636424146317, 88, 0, 88, 0, 0, 0
1801, 1, 1636424146257, 1636424146346, 89, 0, 89, 0, 0, 0
1802, 1, 1636424146365, 1636424146457, 92, 1, 91, 0, 0, 0
1803, 1, 1636424146545, 1636424146638, 93, 1, 92, 1, 0, 1
1804, 1, 1636424146993, 1636424147145, 152, 1, 151, 1, 0, 1
1806, 1, 1636424147033, 1636424147149, 116, 0, 116, 0, 0, 0
1805, 1, 1636424147013, 1636424147149, 136, 0, 136, 0, 0, 0
1810, 1, 1636424147241, 1636424147333, 92, 1, 91, 0, 0, 0
1811, 1, 1636424147381, 1636424147465, 84, 0, 84, 0, 0, 0
1813, 1, 1636424147449, 1636424147541, 92, 1, 91, 0, 1, 1
1807, 1, 1636424147501, 1636424147593, 92, 1, 91, 0, 0, 0
1816, 1, 1636424147509, 1636424147601, 92, 1, 91, 0, 1, 1
1817, 1, 1636424147553, 1636424147646, 93, 1, 92, 0, 0, 0
1818, 1, 1636424147634, 1636424147726, 92, 0, 92, 0, 0, 0
1819, 1, 1636424147826, 1636424147918, 92, 0, 92, 0, 0, 0
1821, 1, 1636424148326, 1636424148417, 91, 0, 91, 0, 0, 0
1822, 1, 1636424148393, 1636424148485, 92, 1, 91, 1, 0, 1
1823, 1, 1636424148430, 1636424148521, 91, 0, 91, 0, 0, 0
1825, 1, 1636424148657, 1636424148754, 97, 1, 96, 1, 0, 1
1824, 1, 1636424148850, 1636424148941, 91, 0, 91, 0, 0, 0
1827, 1, 1636424148897, 1636424148989, 92, 1, 91, 0, 0, 0
1828, 1, 1636424148905, 1636424148998, 93, 1, 92, 1, 0, 1
1830, 1, 1636424149122, 1636424149213, 91, 0, 91, 0, 0, 0
1829, 1, 1636424149301, 1636424149393, 92, 1, 91, 1, 0, 1
1831, 1, 1636424149602, 1636424149693, 91, 0, 91, 0, 0, 0
1832, 1, 1636424149718, 1636424149809, 91, 0, 91, 0, 0, 0
1833, 1, 1636424149750, 1636424149842, 92, 0, 92, 0, 0, 0
1834, 1, 1636424149817, 1636424149909, 92, 1, 91, 0, 0, 0
1835, 1, 1636424149989, 1636424150077, 88, 0, 88, 0, 0, 0
1836, 1, 1636424150265, 1636424150354, 89, 0, 89, 0, 0, 0
1837, 1, 1636424150273, 1636424150361, 88, 0, 88, 0, 0, 0
1838, 1, 1636424150341, 1636424150434, 93, 1, 92, 0, 0, 0
1839, 1, 1636424150445, 1636424150537, 92, 1, 91, 1, 0, 1
1841, 1, 1636424150989, 1636424151097, 108, 1, 107, 1, 0, 1
1840, 1, 1636424150969, 1636424151097, 128, 1, 127, 0, 1, 1
1842, 1, 1636424151097, 1636424151190, 93, 1, 92, 0, 0, 0
1843, 1, 1636424151189, 1636424151281, 92, 1, 91, 0, 0, 0
1757, 1, 1636424151229, 1636424151318, 89, 0, 89, 0, 0, 0
1844, 1, 1636424151365, 1636424151453, 88, 0, 88, 0, 0, 0
1847, 1, 1636424151537, 1636424151629, 92, 1, 91, 0, 0, 0
1848, 1, 1636424151537, 1636424151630, 93, 1, 92, 0, 0, 0
1849, 1, 1636424151717, 1636424151813, 96, 1, 95, 1, 0, 1
1850, 1, 1636424151813, 1636424151906, 93, 1, 92, 0, 1, 1
1852, 1, 1636424152233, 1636424152326, 93, 1, 92, 1, 0, 1
1853, 1, 1636424152326, 1636424152413, 87, 0, 87, 0, 0, 0
1854, 1, 1636424152413, 1636424152501, 88, 0, 88, 0, 0, 0
1855, 1, 1636424152457, 1636424152546, 89, 0, 89, 0, 0, 0
1856, 1, 1636424152630, 1636424152722, 92, 0, 92, 0, 0, 0
1858, 1, 1636424152841, 1636424152934, 93, 0, 93, 0, 0, 0
1857, 1, 1636424152842, 1636424152934, 92, 0, 92, 0, 0, 0
1859, 1, 1636424152998, 1636424153086, 88, 0, 88, 0, 0, 0
1860, 1, 1636424153086, 1636424153178, 92, 0, 92, 0, 0, 0
1861, 1, 1636424153534, 1636424153626, 92, 0, 92, 0, 0, 0
1862, 1, 1636424153653, 1636424153746, 93, 1, 92, 0, 0, 0
1863, 1, 1636424153769, 1636424153861, 92, 1, 91, 1, 0, 1
1864, 1, 1636424153810, 1636424153902, 92, 0, 92, 0, 0, 0
1865, 1, 1636424153906, 1636424153997, 91, 0, 91, 0, 0, 0
1866, 1, 1636424154109, 1636424154198, 89, 0, 89, 0, 0, 0
1867, 1, 1636424154129, 1636424154221, 92, 0, 92, 0, 0, 0
1868, 1, 1636424154354, 1636424154446, 92, 0, 92, 0, 0, 0
1869, 1, 1636424154365, 1636424154458, 93, 1, 92, 0, 1, 1
1870, 1, 1636424154858, 1636424154950, 92, 0, 92, 0, 0, 0
1871, 1, 1636424154933, 1636424155022, 89, 0, 89, 0, 0, 0
1872, 1, 1636424155094, 1636424155186, 92, 0, 92, 0, 0, 0
1873, 1, 1636424155114, 1636424155205, 91, 0, 91, 0, 0, 0
1874, 1, 1636424155193, 1636424155286, 93, 1, 92, 0, 1, 1
1875, 1, 1636424155442, 1636424155534, 92, 0, 92, 0, 0, 0
1876, 1, 1636424155522, 1636424155614, 92, 1, 91, 0, 0, 0
1877, 1, 1636424155654, 1636424155745, 91, 0, 91, 0, 0, 0
1878, 1, 1636424155718, 1636424155810, 92, 0, 92, 0, 0, 0
1879, 1, 1636424156221, 1636424156313, 92, 1, 91, 0, 0, 0
1880, 1, 1636424156246, 1636424156338, 92, 0, 92, 0, 0, 0
1881, 1, 1636424156365, 1636424156457, 92, 1, 91, 0, 0, 0
1882, 1, 1636424156413, 1636424156502, 89, 0, 89, 0, 0, 0
1883, 1, 1636424156501, 1636424156594, 93, 1, 92, 0, 0, 0
1885, 1, 1636424156862, 1636424156953, 91, 0, 91, 0, 0, 0
1886, 1, 1636424156953, 1636424157077, 124, 1, 123, 0, 0, 0
1887, 1, 1636424157077, 1636424157170, 93, 1, 92, 0, 0, 0
1826, 1, 1636424157209, 1636424157306, 97, 1, 96, 0, 0, 0
1888, 1, 1636424157553, 1636424157649, 96, 1, 95, 1, 0, 1
1889, 1, 1636424157649, 1636424157741, 92, 1, 91, 0, 0, 0
1890, 1, 1636424157689, 1636424157781, 92, 1, 91, 0, 0, 0
1892, 1, 1636424157801, 1636424157894, 93, 0, 93, 0, 0, 0
1897, 1, 1636424157857, 1636424157945, 88, 0, 88, 0, 0, 0
1898, 1, 1636424157894, 1636424157985, 91, 0, 91, 0, 0, 0
1891, 1, 1636424158106, 1636424158198, 92, 0, 92, 0, 0, 0
1899, 1, 1636424158214, 1636424158306, 92, 0, 92, 0, 0, 0
1900, 1, 1636424158313, 1636424158410, 97, 1, 96, 0, 0, 0
1901, 1, 1636424158365, 1636424158457, 92, 0, 92, 0, 0, 0
1902, 1, 1636424158633, 1636424158725, 92, 1, 91, 0, 1, 1
1903, 1, 1636424158870, 1636424158962, 92, 0, 92, 0, 0, 0
1904, 1, 1636424158934, 1636424159025, 91, 0, 91, 0, 0, 0
1905, 1, 1636424158977, 1636424159070, 93, 1, 92, 1, 0, 1
1907, 1, 1636424159178, 1636424159273, 95, 0, 95, 0, 0, 0
1909, 1, 1636424159249, 1636424159337, 88, 1, 87, 0, 0, 0
1908, 1, 1636424159249, 1636424159338, 89, 1, 88, 0, 0, 0
1906, 1, 1636424159378, 1636424159465, 87, 0, 87, 0, 0, 0
1910, 1, 1636424159473, 1636424159565, 92, 1, 91, 0, 1, 1
1911, 1, 1636424159701, 1636424159793, 92, 1, 91, 1, 0, 1
1912, 1, 1636424159705, 1636424159797, 92, 1, 91, 0, 0, 0
1913, 1, 1636424159901, 1636424159997, 96, 1, 95, 0, 1, 1
1915, 1, 1636424160242, 1636424160334, 92, 1, 91, 0, 0, 0
1914, 1, 1636424160242, 1636424160334, 92, 0, 92, 0, 0, 0
1917, 1, 1636424160325, 1636424160417, 92, 1, 91, 1, 0, 1
1918, 1, 1636424160517, 1636424160609, 92, 1, 91, 0, 0, 0
1919, 1, 1636424160569, 1636424160661, 92, 1, 91, 0, 1, 1
1920, 1, 1636424160597, 1636424160689, 92, 1, 91, 0, 0, 0
1916, 1, 1636424160693, 1636424160777, 84, 0, 84, 0, 0, 0
1921, 1, 1636424160874, 1636424160966, 92, 0, 92, 0, 0, 0
1922, 1, 1636424161026, 1636424161118, 92, 0, 92, 0, 0, 0
1923, 1, 1636424161038, 1636424161130, 92, 0, 92, 0, 0, 0
1924, 1, 1636424161214, 1636424161306, 92, 0, 92, 0, 0, 0
1925, 1, 1636424161505, 1636424161597, 92, 1, 91, 0, 0, 0
1926, 1, 1636424161634, 1636424161725, 91, 0, 91, 0, 0, 0
1929, 1, 1636424161702, 1636424161793, 91, 0, 91, 0, 0, 0
1930, 1, 1636424161809, 1636424161902, 93, 1, 92, 0, 0, 0
1884, 1, 1636424161913, 1636424162005, 92, 1, 91, 0, 0, 0
1933, 1, 1636424161965, 1636424162053, 88, 0, 88, 0, 0, 0
1927, 1, 1636424162089, 1636424162182, 93, 1, 92, 0, 1, 1
1935, 1, 1636424162193, 1636424162285, 92, 1, 91, 0, 1, 1
1936, 1, 1636424162329, 1636424162421, 92, 1, 91, 0, 1, 1
1937, 1, 1636424162433, 1636424162526, 93, 1, 92, 0, 1, 1
1939, 1, 1636424162565, 1636424162653, 88, 0, 88, 0, 0, 0
1938, 1, 1636424162585, 1636424162682, 97, 0, 97, 0, 0, 0
1940, 1, 1636424162793, 1636424162885, 92, 1, 91, 1, 0, 1
1941, 1, 1636424162918, 1636424163009, 91, 0, 91, 0, 0, 0
1942, 1, 1636424162969, 1636424163061, 92, 1, 91, 0, 0, 0
1945, 1, 1636424163241, 1636424163334, 93, 1, 92, 1, 0, 1
1944, 1, 1636424163241, 1636424163334, 93, 1, 92, 1, 0, 1
1943, 1, 1636424163374, 1636424163465, 91, 0, 91, 0, 0, 0
1946, 1, 1636424163521, 1636424163613, 92, 1, 91, 1, 0, 1
1947, 1, 1636424163698, 1636424163790, 92, 0, 92, 0, 0, 0
1948, 1, 1636424163825, 1636424163918, 93, 1, 92, 0, 0, 0
1949, 1, 1636424163897, 1636424163989, 92, 1, 91, 0, 1, 1
1950, 1, 1636424163905, 1636424163998, 93, 1, 92, 1, 0, 1
1951, 1, 1636424164154, 1636424164246, 92, 0, 92, 0, 0, 0
1952, 1, 1636424164257, 1636424164350, 93, 0, 93, 0, 0, 0
1955, 1, 1636424164414, 1636424164506, 92, 0, 92, 0, 0, 0
1953, 1, 1636424164605, 1636424164693, 88, 0, 88, 0, 0, 0
1956, 1, 1636424164605, 1636424164697, 92, 1, 91, 0, 1, 1
1954, 1, 1636424164709, 1636424164802, 93, 1, 92, 0, 1, 1
1957, 1, 1636424164861, 1636424164953, 92, 1, 91, 0, 0, 0
1958, 1, 1636424164921, 1636424165009, 88, 1, 87, 1, 0, 1
1959, 1, 1636424165125, 1636424165217, 92, 1, 91, 1, 0, 1
1961, 1, 1636424165261, 1636424165353, 92, 0, 92, 0, 0, 0
1962, 1, 1636424165370, 1636424165461, 91, 0, 91, 0, 0, 0
1963, 1, 1636424165577, 1636424165670, 93, 1, 92, 1, 0, 1
1964, 1, 1636424165586, 1636424165677, 91, 0, 91, 0, 0, 0
1966, 1, 1636424165717, 1636424165810, 93, 1, 92, 0, 1, 1
1967, 1, 1636424165977, 1636424166069, 92, 1, 91, 0, 0, 0
1965, 1, 1636424166029, 1636424166122, 93, 1, 92, 0, 0, 0
1968, 1, 1636424166186, 1636424166278, 92, 0, 92, 0, 0, 0
1969, 1, 1636424166253, 1636424166346, 93, 1, 92, 0, 0, 0
1970, 1, 1636424166490, 1636424166581, 91, 0, 91, 0, 0, 0
1971, 1, 1636424166581, 1636424166673, 92, 1, 91, 1, 0, 1
1972, 1, 1636424166641, 1636424166737, 96, 1, 95, 1, 0, 1
1973, 1, 1636424166889, 1636424166981, 92, 1, 91, 0, 1, 1
1974, 1, 1636424166969, 1636424167061, 92, 1, 91, 1, 0, 1
1976, 1, 1636424167085, 1636424167173, 88, 0, 88, 0, 0, 0
1977, 1, 1636424167313, 1636424167406, 93, 1, 92, 0, 0, 0
1975, 1, 1636424167425, 1636424167518, 93, 1, 92, 0, 0, 0
1978, 1, 1636424167554, 1636424167646, 92, 0, 92, 0, 0, 0
1979, 1, 1636424167613, 1636424167865, 252, 1, 251, 0, 0, 0
1980, 1, 1636424167965, 1636424168058, 93, 1, 92, 1, 0, 1
1932, 1, 1636424167998, 1636424168089, 91, 0, 91, 0, 0, 0
1981, 1, 1636424168045, 1636424168138, 93, 1, 92, 0, 1, 1
1982, 1, 1636424168093, 1636424168181, 88, 1, 87, 0, 0, 0
1983, 1, 1636424168157, 1636424168245, 88, 1, 87, 0, 0, 0
1984, 1, 1636424168261, 1636424168349, 88, 0, 88, 0, 0, 0
1985, 1, 1636424168270, 1636424168366, 96, 0, 96, 0, 0, 0
1988, 1, 1636424168305, 1636424168397, 92, 0, 92, 0, 0, 0
1990, 1, 1636424168381, 1636424168474, 93, 1, 92, 0, 0, 0
1992, 1, 1636424168653, 1636424168745, 92, 1, 91, 0, 0, 0
1987, 1, 1636424168709, 1636424168801, 92, 1, 91, 0, 0, 0
1986, 1, 1636424168729, 1636424168821, 92, 1, 91, 1, 0, 1
1989, 1, 1636424168753, 1636424168841, 88, 0, 88, 0, 0, 0
1993, 1, 1636424168853, 1636424168950, 97, 1, 96, 1, 0, 1
1994, 1, 1636424168917, 1636424169013, 96, 1, 95, 1, 0, 1
1995, 1, 1636424169238, 1636424169330, 92, 0, 92, 0, 0, 0
1996, 1, 1636424169318, 1636424169410, 92, 0, 92, 0, 0, 0
1997, 1, 1636424169321, 1636424169414, 93, 1, 92, 0, 1, 1
1999, 1, 1636424169526, 1636424169617, 91, 0, 91, 0, 0, 0
1998, 1, 1636424169526, 1636424169618, 92, 0, 92, 0, 0, 0
2000, 1, 1636424169533, 1636424169629, 96, 0, 96, 0, 0, 0
2003, 1, 1636424169593, 1636424169685, 92, 1, 91, 0, 1, 1
2005, 1, 1636424169774, 1636424169865, 91, 0, 91, 0, 0, 0
2006, 1, 1636424169906, 1636424169998, 92, 0, 92, 0, 0, 0
2002, 1, 1636424169974, 1636424170065, 91, 0, 91, 0, 0, 0
2001, 1, 1636424169985, 1636424170073, 88, 1, 87, 0, 1, 1
2004, 1, 1636424170037, 1636424170130, 93, 1, 92, 1, 0, 1
2007, 1, 1636424170205, 1636424170293, 88, 1, 87, 1, 0, 1
2008, 1, 1636424170245, 1636424170337, 92, 1, 91, 1, 0, 1
2010, 1, 1636424170650, 1636424170741, 91, 0, 91, 0, 0, 0
2011, 1, 1636424170697, 1636424170785, 88, 0, 88, 0, 0, 0
2012, 1, 1636424170821, 1636424170913, 92, 1, 91, 0, 1, 1
2013, 1, 1636424170833, 1636424170925, 92, 0, 92, 0, 0, 0
2014, 1, 1636424170857, 1636424170945, 88, 0, 88, 0, 0, 0
2016, 1, 1636424170873, 1636424170969, 96, 1, 95, 0, 1, 1
2019, 1, 1636424171117, 1636424171210, 93, 1, 92, 1, 0, 1
2020, 1, 1636424171177, 1636424171270, 93, 0, 93, 0, 0, 0
2015, 1, 1636424171281, 1636424171365, 84, 0, 84, 0, 0, 0
2018, 1, 1636424171305, 1636424171398, 93, 1, 92, 0, 0, 0
2017, 1, 1636424171325, 1636424171417, 92, 1, 91, 0, 1, 1
2021, 1, 1636424171513, 1636424171602, 89, 0, 89, 0, 0, 0
2022, 1, 1636424171602, 1636424171717, 115, 0, 115, 0, 0, 0
2023, 1, 1636424171945, 1636424172038, 93, 1, 92, 1, 0, 1
2024, 1, 1636424172038, 1636424172129, 91, 0, 91, 0, 0, 0
2025, 1, 1636424172093, 1636424172181, 88, 1, 87, 0, 0, 0
2027, 1, 1636424172133, 1636424172221, 88, 0, 88, 0, 0, 0
2028, 1, 1636424172205, 1636424172297, 92, 1, 91, 0, 0, 0
2031, 1, 1636424172217, 1636424172305, 88, 0, 88, 0, 0, 0
2034, 1, 1636424172409, 1636424172498, 89, 0, 89, 0, 0, 0
2026, 1, 1636424172485, 1636424172582, 97, 1, 96, 0, 1, 1
2033, 1, 1636424172573, 1636424172666, 93, 1, 92, 0, 0, 0
2032, 1, 1636424172662, 1636424172754, 92, 0, 92, 0, 0, 0
2038, 1, 1636424172870, 1636424172962, 92, 0, 92, 0, 0, 0
2037, 1, 1636424172941, 1636424173033, 92, 1, 91, 0, 0, 0
2039, 1, 1636424173261, 1636424173357, 96, 1, 95, 0, 0, 0
2040, 1, 1636424173313, 1636424173402, 89, 0, 89, 0, 0, 0
2041, 1, 1636424173333, 1636424173425, 92, 1, 91, 0, 1, 1
2036, 1, 1636424173389, 1636424173481, 92, 1, 91, 1, 0, 1
2044, 1, 1636424173481, 1636424173573, 92, 1, 91, 0, 0, 0
2046, 1, 1636424173598, 1636424173690, 92, 0, 92, 0, 0, 0
2048, 1, 1636424173701, 1636424173793, 92, 1, 91, 0, 0, 0
2042, 1, 1636424173757, 1636424173849, 92, 1, 91, 0, 0, 0
2045, 1, 1636424173933, 1636424174026, 93, 1, 92, 1, 0, 1
2049, 1, 1636424174065, 1636424174157, 92, 1, 91, 1, 0, 1
2050, 1, 1636424174121, 1636424174213, 92, 1, 91, 0, 1, 1
2051, 1, 1636424174157, 1636424174249, 92, 1, 91, 0, 1, 1
2053, 1, 1636424174625, 1636424174713, 88, 1, 87, 0, 1, 1
2054, 1, 1636424174673, 1636424174765, 92, 1, 91, 0, 0, 0
2056, 1, 1636424174817, 1636424174909, 92, 1, 91, 0, 1, 1
2058, 1, 1636424174901, 1636424175038, 137, 1, 136, 0, 0, 0
2055, 1, 1636424175133, 1636424175225, 92, 1, 91, 0, 0, 0
2059, 1, 1636424175133, 1636424175225, 92, 1, 91, 0, 0, 0
2057, 1, 1636424175269, 1636424175361, 92, 1, 91, 0, 0, 0
2060, 1, 1636424175373, 1636424175465, 92, 1, 91, 0, 0, 0
2061, 1, 1636424175481, 1636424175574, 93, 1, 92, 0, 1, 1
2063, 1, 1636424175509, 1636424175598, 89, 0, 89, 0, 0, 0
2062, 1, 1636424175597, 1636424175690, 93, 1, 92, 0, 0, 0
2064, 1, 1636424176049, 1636424176141, 92, 1, 91, 1, 0, 1
2065, 1, 1636424176058, 1636424176145, 87, 0, 87, 0, 0, 0
2067, 1, 1636424176177, 1636424176269, 92, 1, 91, 0, 0, 0
2068, 1, 1636424176213, 1636424176305, 92, 1, 91, 0, 0, 0
2070, 1, 1636424176377, 1636424176473, 96, 1, 95, 0, 1, 1
2066, 1, 1636424176510, 1636424176601, 91, 0, 91, 0, 0, 0
2069, 1, 1636424176629, 1636424176722, 93, 1, 92, 0, 1, 1
2071, 1, 1636424176709, 1636424176802, 93, 1, 92, 1, 0, 1
2072, 1, 1636424176769, 1636424176857, 88, 0, 88, 0, 0, 0
2074, 1, 1636424176817, 1636424176910, 93, 1, 92, 1, 0, 1
2073, 1, 1636424176825, 1636424176910, 85, 0, 85, 0, 0, 0
2075, 1, 1636424177317, 1636424177410, 93, 1, 92, 1, 0, 1
2076, 1, 1636424177342, 1636424177434, 92, 0, 92, 0, 0, 0
2078, 1, 1636424177541, 1636424177634, 93, 1, 92, 0, 0, 0
2080, 1, 1636424177613, 1636424177706, 93, 1, 92, 1, 0, 1
2081, 1, 1636424177686, 1636424177777, 91, 0, 91, 0, 0, 0
2077, 1, 1636424177797, 1636424177890, 93, 1, 92, 1, 0, 1
2079, 1, 1636424177998, 1636424178085, 87, 0, 87, 0, 0, 0
2082, 1, 1636424178053, 1636424178145, 92, 1, 91, 0, 0, 0
2083, 1, 1636424178073, 1636424178169, 96, 1, 95, 1, 0, 1
2084, 1, 1636424178137, 1636424178225, 88, 0, 88, 0, 0, 0
2085, 1, 1636424178165, 1636424178258, 93, 1, 92, 0, 1, 1
2086, 1, 1636424178613, 1636424178705, 92, 1, 91, 0, 0, 0
2087, 1, 1636424178661, 1636424178750, 89, 0, 89, 0, 0, 0
2089, 1, 1636424178866, 1636424178957, 91, 0, 91, 0, 0, 0
2090, 1, 1636424178913, 1636424179005, 92, 1, 91, 1, 0, 1
2092, 1, 1636424178913, 1636424179005, 92, 0, 92, 0, 0, 0
2093, 1, 1636424179061, 1636424179154, 93, 1, 92, 1, 0, 1
2088, 1, 1636424179061, 1636424179154, 93, 1, 92, 0, 0, 0
2091, 1, 1636424179317, 1636424179410, 93, 1, 92, 0, 1, 1
2095, 1, 1636424179406, 1636424179497, 91, 0, 91, 0, 0, 0
2094, 1, 1636424179406, 1636424179497, 91, 0, 91, 0, 0, 0
2096, 1, 1636424179513, 1636424179606, 93, 1, 92, 0, 0, 0
2097, 1, 1636424179522, 1636424179614, 92, 0, 92, 0, 0, 0
2098, 1, 1636424179949, 1636424180037, 88, 1, 87, 0, 1, 1
2099, 1, 1636424179981, 1636424180069, 88, 0, 88, 0, 0, 0
2101, 1, 1636424180154, 1636424180245, 91, 0, 91, 0, 0, 0
2102, 1, 1636424180193, 1636424180286, 93, 1, 92, 0, 1, 1
2103, 1, 1636424180218, 1636424180309, 91, 0, 91, 0, 0, 0
2100, 1, 1636424180417, 1636424180509, 92, 1, 91, 0, 0, 0
2105, 1, 1636424180453, 1636424180546, 93, 1, 92, 1, 0, 1
2035, 1, 1636424180553, 1636424180650, 97, 1, 96, 0, 0, 0
2104, 1, 1636424180649, 1636424180741, 92, 1, 91, 1, 0, 1
2106, 1, 1636424180705, 1636424180798, 93, 1, 92, 1, 0, 1
2107, 1, 1636424180761, 1636424180854, 93, 1, 92, 0, 1, 1
2108, 1, 1636424180861, 1636424180953, 92, 1, 91, 0, 0, 0
2109, 1, 1636424180906, 1636424180997, 91, 0, 91, 0, 0, 0
2110, 1, 1636424181238, 1636424181329, 91, 0, 91, 0, 0, 0
2111, 1, 1636424181317, 1636424181406, 89, 1, 88, 1, 0, 1
2112, 1, 1636424181369, 1636424181461, 92, 1, 91, 0, 0, 0
2114, 1, 1636424181461, 1636424181553, 92, 1, 91, 1, 0, 1
2115, 1, 1636424181525, 1636424181617, 92, 0, 92, 0, 0, 0
2117, 1, 1636424181593, 1636424181685, 92, 1, 91, 0, 0, 0
2113, 1, 1636424181765, 1636424181857, 92, 1, 91, 0, 0, 0
2118, 1, 1636424181850, 1636424181942, 92, 0, 92, 0, 0, 0
2116, 1, 1636424181978, 1636424182125, 147, 0, 147, 0, 0, 0
2119, 1, 1636424182125, 1636424182217, 92, 1, 91, 0, 1, 1
2120, 1, 1636424182129, 1636424182218, 89, 1, 88, 0, 1, 1
2121, 1, 1636424182129, 1636424182221, 92, 1, 91, 0, 1, 1
2122, 1, 1636424182305, 1636424182398, 93, 1, 92, 0, 1, 1
2123, 1, 1636424182470, 1636424182562, 92, 0, 92, 0, 0, 0
2124, 1, 1636424182525, 1636424182621, 96, 1, 95, 1, 0, 1
2126, 1, 1636424182757, 1636424182853, 96, 1, 95, 0, 0, 0
2129, 1, 1636424182797, 1636424182890, 93, 1, 92, 1, 0, 1
2130, 1, 1636424182825, 1636424182917, 92, 1, 91, 0, 0, 0
2125, 1, 1636424182981, 1636424183069, 88, 0, 88, 0, 0, 0
2132, 1, 1636424182985, 1636424183073, 88, 0, 88, 0, 0, 0
2133, 1, 1636424183153, 1636424183241, 88, 0, 88, 0, 0, 0
2131, 1, 1636424183249, 1636424183333, 84, 0, 84, 0, 0, 0
2134, 1, 1636424183321, 1636424183409, 88, 0, 88, 0, 0, 0
2135, 1, 1636424183397, 1636424183485, 88, 0, 88, 0, 0, 0
2136, 1, 1636424183413, 1636424183510, 97, 1, 96, 0, 0, 0
2137, 1, 1636424183601, 1636424183694, 93, 1, 92, 1, 0, 1
2052, 1, 1636424183618, 1636424183709, 91, 0, 91, 0, 0, 0
2138, 1, 1636424183769, 1636424183861, 92, 1, 91, 1, 0, 1
2139, 1, 1636424183785, 1636424183878, 93, 1, 92, 0, 0, 0
2141, 1, 1636424183969, 1636424184061, 92, 1, 91, 0, 0, 0
2142, 1, 1636424184105, 1636424184197, 92, 1, 91, 1, 0, 1
2146, 1, 1636424184205, 1636424184293, 88, 0, 88, 0, 0, 0
2140, 1, 1636424184241, 1636424184333, 92, 1, 91, 0, 0, 0
2149, 1, 1636424184425, 1636424184518, 93, 1, 92, 1, 0, 1
2145, 1, 1636424184550, 1636424184642, 92, 0, 92, 0, 0, 0
2150, 1, 1636424184697, 1636424184790, 93, 1, 92, 0, 1, 1
2151, 1, 1636424184717, 1636424184809, 92, 0, 92, 0, 0, 0
2152, 1, 1636424184761, 1636424184849, 88, 0, 88, 0, 0, 0
2153, 1, 1636424184885, 1636424184973, 88, 0, 88, 0, 0, 0
2154, 1, 1636424185122, 1636424185213, 91, 0, 91, 0, 0, 0
2156, 1, 1636424185154, 1636424185245, 91, 0, 91, 0, 0, 0
2157, 1, 1636424185301, 1636424185385, 84, 0, 84, 0, 0, 0
2158, 1, 1636424185457, 1636424185549, 92, 1, 91, 0, 1, 1
2159, 1, 1636424185494, 1636424185586, 92, 0, 92, 0, 0, 0
2155, 1, 1636424185578, 1636424185670, 92, 0, 92, 0, 0, 0
2160, 1, 1636424185914, 1636424186006, 92, 0, 92, 0, 0, 0
2162, 1, 1636424186086, 1636424186177, 91, 0, 91, 0, 0, 0
2163, 1, 1636424186102, 1636424186193, 91, 0, 91, 0, 0, 0
2164, 1, 1636424186109, 1636424186206, 97, 1, 96, 0, 1, 1
2166, 1, 1636424186446, 1636424186537, 91, 0, 91, 0, 0, 0
2167, 1, 1636424186481, 1636424186574, 93, 1, 92, 1, 0, 1
2169, 1, 1636424186574, 1636424186665, 91, 0, 91, 0, 0, 0
2170, 1, 1636424186801, 1636424186893, 92, 1, 91, 0, 0, 0
2171, 1, 1636424186809, 1636424186901, 92, 1, 91, 0, 0, 0
2168, 1, 1636424186938, 1636424187030, 92, 0, 92, 0, 0, 0
2172, 1, 1636424187265, 1636424187358, 93, 1, 92, 0, 0, 0
2173, 1, 1636424187358, 1636424187450, 92, 0, 92, 0, 0, 0
2174, 1, 1636424187373, 1636424187469, 96, 0, 96, 0, 0, 0
2175, 1, 1636424187418, 1636424187509, 91, 0, 91, 0, 0, 0
2176, 1, 1636424187786, 1636424187878, 92, 0, 92, 0, 0, 0
2179, 1, 1636424187873, 1636424187966, 93, 1, 92, 0, 1, 1
2180, 1, 1636424188090, 1636424188182, 92, 0, 92, 0, 0, 0
2181, 1, 1636424188182, 1636424188273, 91, 0, 91, 0, 0, 0
2182, 1, 1636424188634, 1636424188725, 91, 0, 91, 0, 0, 0
2183, 1, 1636424188666, 1636424188757, 91, 0, 91, 0, 0, 0
2184, 1, 1636424188706, 1636424188802, 96, 0, 96, 0, 0, 0
2185, 1, 1636424188713, 1636424188802, 89, 1, 88, 0, 0, 0
2186, 1, 1636424189149, 1636424189242, 93, 1, 92, 0, 0, 0
2187, 1, 1636424189225, 1636424189322, 97, 1, 96, 0, 1, 1
2188, 1, 1636424189385, 1636424189478, 93, 1, 92, 0, 0, 0
2189, 1, 1636424189493, 1636424189586, 93, 1, 92, 0, 0, 0
2190, 1, 1636424189945, 1636424190037, 92, 1, 91, 1, 0, 1
2191, 1, 1636424189945, 1636424190037, 92, 1, 91, 0, 1, 1
2192, 1, 1636424189989, 1636424190082, 93, 0, 93, 0, 0, 0
2193, 1, 1636424190081, 1636424190169, 88, 1, 87, 0, 0, 0
2194, 1, 1636424190434, 1636424190526, 92, 0, 92, 0, 0, 0
2195, 1, 1636424190582, 1636424190673, 91, 0, 91, 0, 0, 0
2196, 1, 1636424190653, 1636424190746, 93, 1, 92, 1, 0, 1
2197, 1, 1636424190866, 1636424190958, 92, 0, 92, 0, 0, 0
2199, 1, 1636424191273, 1636424191361, 88, 0, 88, 0, 0, 0
2200, 1, 1636424191286, 1636424191377, 91, 0, 91, 0, 0, 0
2198, 1, 1636424191317, 1636424191405, 88, 0, 88, 0, 0, 0
2201, 1, 1636424191358, 1636424191450, 92, 0, 92, 0, 0, 0
2202, 1, 1636424191830, 1636424191922, 92, 0, 92, 0, 0, 0
2203, 1, 1636424191961, 1636424192057, 96, 1, 95, 0, 0, 0
2204, 1, 1636424192045, 1636424192133, 88, 0, 88, 0, 0, 0
2207, 1, 1636424192538, 1636424192637, 99, 0, 99, 0, 0, 0
2208, 1, 1636424192633, 1636424192726, 93, 1, 92, 1, 0, 1
2148, 1, 1636424192773, 1636424192865, 92, 1, 91, 1, 0, 1
2209, 1, 1636424192773, 1636424192865, 92, 1, 91, 0, 1, 1
2210, 1, 1636424193229, 1636424193322, 93, 1, 92, 1, 0, 1
2211, 1, 1636424193242, 1636424193334, 92, 0, 92, 0, 0, 0
2212, 1, 1636424193349, 1636424193442, 93, 1, 92, 0, 1, 1
2213, 1, 1636424193466, 1636424193558, 92, 0, 92, 0, 0, 0
2215, 1, 1636424193530, 1636424193622, 92, 0, 92, 0, 0, 0
2214, 1, 1636424193922, 1636424194066, 144, 0, 144, 0, 0, 0
2217, 1, 1636424193942, 1636424194066, 124, 0, 124, 0, 0, 0
2218, 1, 1636424194166, 1636424194257, 91, 0, 91, 0, 0, 0
2219, 1, 1636424194550, 1636424194642, 92, 0, 92, 0, 0, 0
2220, 1, 1636424194614, 1636424194706, 92, 0, 92, 0, 0, 0
2224, 1, 1636424194713, 1636424194806, 93, 1, 92, 0, 0, 0
2222, 1, 1636424194733, 1636424194826, 93, 1, 92, 0, 1, 1
2225, 1, 1636424194738, 1636424194829, 91, 0, 91, 0, 0, 0
2228, 1, 1636424195234, 1636424195326, 92, 0, 92, 0, 0, 0
2229, 1, 1636424195429, 1636424195566, 137, 1, 136, 0, 0, 0
2230, 1, 1636424195893, 1636424196029, 136, 1, 135, 0, 1, 1
2233, 1, 1636424196033, 1636424196121, 88, 0, 88, 0, 0, 0
2235, 1, 1636424196121, 1636424196210, 89, 1, 88, 0, 0, 0
2234, 1, 1636424196125, 1636424196213, 88, 0, 88, 0, 0, 0
2237, 1, 1636424196790, 1636424196882, 92, 0, 92, 0, 0, 0
2238, 1, 1636424197197, 1636424197289, 92, 1, 91, 1, 0, 1
2239, 1, 1636424197342, 1636424197433, 91, 0, 91, 0, 0, 0
2240, 1, 1636424197366, 1636424197457, 91, 0, 91, 0, 0, 0
2242, 1, 1636424198057, 1636424198150, 93, 1, 92, 1, 0, 1
2244, 1, 1636424198130, 1636424198222, 92, 0, 92, 0, 0, 0
2245, 1, 1636424198557, 1636424198650, 93, 1, 92, 0, 0, 0
2243, 1, 1636424198582, 1636424198670, 88, 0, 88, 0, 0, 0
2246, 1, 1636424198626, 1636424198722, 96, 0, 96, 0, 0, 0
2247, 1, 1636424198653, 1636424198746, 93, 1, 92, 0, 0, 0
2248, 1, 1636424199330, 1636424199421, 91, 0, 91, 0, 0, 0
2249, 1, 1636424199361, 1636424199454, 93, 1, 92, 0, 0, 0
2250, 1, 1636424199786, 1636424199877, 91, 0, 91, 0, 0, 0
2251, 1, 1636424199902, 1636424199994, 92, 0, 92, 0, 0, 0
2252, 1, 1636424199986, 1636424200077, 91, 0, 91, 0, 0, 0
2253, 1, 1636424200650, 1636424200742, 92, 0, 92, 0, 0, 0
2254, 1, 1636424200718, 1636424200810, 92, 0, 92, 0, 0, 0
2255, 1, 1636424201174, 1636424201265, 91, 0, 91, 0, 0, 0
2256, 1, 1636424201202, 1636424201293, 91, 0, 91, 0, 0, 0
2257, 1, 1636424201286, 1636424201378, 92, 0, 92, 0, 0, 0
2258, 1, 1636424201922, 1636424202014, 92, 0, 92, 0, 0, 0
2259, 1, 1636424202133, 1636424202226, 93, 1, 92, 0, 1, 1
2261, 1, 1636424202553, 1636424202645, 92, 0, 92, 0, 0, 0
2260, 1, 1636424202581, 1636424202670, 89, 0, 89, 0, 0, 0
2262, 1, 1636424202585, 1636424202677, 92, 1, 91, 0, 0, 0
2265, 1, 1636424203226, 1636424203318, 92, 0, 92, 0, 0, 0
2266, 1, 1636424203430, 1636424203521, 91, 0, 91, 0, 0, 0
2267, 1, 1636424203885, 1636424203977, 92, 1, 91, 0, 0, 0
2231, 1, 1636424203926, 1636424204018, 92, 0, 92, 0, 0, 0
2268, 1, 1636424203926, 1636424204018, 92, 1, 91, 0, 0, 0
2269, 1, 1636424203973, 1636424204065, 92, 1, 91, 1, 0, 1
2270, 1, 1636424204382, 1636424204474, 92, 0, 92, 0, 0, 0
2271, 1, 1636424204546, 1636424204750, 204, 0, 204, 0, 0, 0
2275, 1, 1636424205149, 1636424205242, 93, 1, 92, 1, 0, 1
2277, 1, 1636424205342, 1636424205433, 91, 0, 91, 0, 0, 0
2278, 1, 1636424205489, 1636424205581, 92, 1, 91, 0, 0, 0
2279, 1, 1636424205497, 1636424205594, 97, 1, 96, 0, 1, 1
2282, 1, 1636424205886, 1636424205978, 92, 0, 92, 0, 0, 0
2280, 1, 1636424205978, 1636424206070, 92, 0, 92, 0, 0, 0
2283, 1, 1636424206437, 1636424206533, 96, 1, 95, 0, 0, 0
2284, 1, 1636424206449, 1636424206537, 88, 1, 87, 0, 1, 1
2241, 1, 1636424206465, 1636424206561, 96, 1, 95, 1, 0, 1
2285, 1, 1636424206706, 1636424206797, 91, 0, 91, 0, 0, 0
2287, 1, 1636424206745, 1636424206838, 93, 1, 92, 1, 0, 1
2288, 1, 1636424206753, 1636424206841, 88, 0, 88, 0, 0, 0
2286, 1, 1636424206885, 1636424206977, 92, 1, 91, 0, 0, 0
2291, 1, 1636424207190, 1636424207282, 92, 0, 92, 0, 0, 0
2289, 1, 1636424207197, 1636424207290, 93, 1, 92, 1, 0, 1
2290, 1, 1636424207341, 1636424207434, 93, 1, 92, 1, 0, 1
2292, 1, 1636424207653, 1636424207741, 88, 0, 88, 0, 0, 0
2293, 1, 1636424207777, 1636424207870, 93, 1, 92, 1, 0, 1
2294, 1, 1636424207994, 1636424208086, 92, 0, 92, 0, 0, 0
2295, 1, 1636424208005, 1636424208097, 92, 1, 91, 1, 0, 1
2297, 1, 1636424208078, 1636424208169, 91, 0, 91, 0, 0, 0
2296, 1, 1636424208106, 1636424208197, 91, 0, 91, 0, 0, 0
2300, 1, 1636424208521, 1636424208614, 93, 1, 92, 0, 0, 0
2298, 1, 1636424208530, 1636424208621, 91, 0, 91, 0, 0, 0
2299, 1, 1636424208561, 1636424208650, 89, 0, 89, 0, 0, 0
2301, 1, 1636424208982, 1636424209074, 92, 0, 92, 0, 0, 0
2302, 1, 1636424209141, 1636424209234, 93, 1, 92, 1, 0, 1
2303, 1, 1636424209314, 1636424209406, 92, 0, 92, 0, 0, 0
2305, 1, 1636424209390, 1636424209482, 92, 0, 92, 0, 0, 0
2304, 1, 1636424209429, 1636424209518, 89, 0, 89, 0, 0, 0
2307, 1, 1636424209874, 1636424209966, 92, 0, 92, 0, 0, 0
2306, 1, 1636424209877, 1636424209966, 89, 1, 88, 0, 0, 0
2308, 1, 1636424210485, 1636424210578, 93, 0, 93, 0, 0, 0
2309, 1, 1636424210589, 1636424210682, 93, 1, 92, 0, 0, 0
2310, 1, 1636424210694, 1636424210785, 91, 0, 91, 0, 0, 0
2311, 1, 1636424211150, 1636424211242, 92, 0, 92, 0, 0, 0
2312, 1, 1636424211773, 1636424211865, 92, 1, 91, 0, 0, 0
2313, 1, 1636424211854, 1636424211946, 92, 0, 92, 0, 0, 0
2314, 1, 1636424212421, 1636424212514, 93, 1, 92, 1, 0, 1
2272, 1, 1636424212845, 1636424212938, 93, 1, 92, 1, 0, 1
2315, 1, 1636424213122, 1636424213214, 92, 0, 92, 0, 0, 0
2317, 1, 1636424213122, 1636424213214, 92, 0, 92, 0, 0, 0
2318, 1, 1636424213133, 1636424213221, 88, 0, 88, 0, 0, 0
2320, 1, 1636424213717, 1636424213810, 93, 1, 92, 0, 0, 0
2321, 1, 1636424214318, 1636424214414, 96, 0, 96, 0, 0, 0
2322, 1, 1636424214481, 1636424214574, 93, 1, 92, 0, 1, 1
2323, 1, 1636424215058, 1636424215150, 92, 0, 92, 0, 0, 0
2324, 1, 1636424215186, 1636424215278, 92, 0, 92, 0, 0, 0
2326, 1, 1636424215510, 1636424215605, 95, 0, 95, 0, 0, 0
2327, 1, 1636424215638, 1636424215729, 91, 0, 91, 0, 0, 0
2325, 1, 1636424215638, 1636424215729, 91, 0, 91, 0, 0, 0
2329, 1, 1636424215789, 1636424215881, 92, 1, 91, 1, 0, 1
2328, 1, 1636424215970, 1636424216062, 92, 0, 92, 0, 0, 0
2330, 1, 1636424216369, 1636424216461, 92, 1, 91, 0, 0, 0
2331, 1, 1636424216469, 1636424216562, 93, 1, 92, 0, 0, 0
2333, 1, 1636424216777, 1636424216870, 93, 1, 92, 1, 0, 1
2332, 1, 1636424216925, 1636424217018, 93, 1, 92, 0, 0, 0
2334, 1, 1636424216954, 1636424217046, 92, 0, 92, 0, 0, 0
2335, 1, 1636424217230, 1636424217322, 92, 0, 92, 0, 0, 0
2337, 1, 1636424217745, 1636424217833, 88, 0, 88, 0, 0, 0
2338, 1, 1636424217810, 1636424217902, 92, 0, 92, 0, 0, 0
2340, 1, 1636424218086, 1636424218182, 96, 0, 96, 0, 0, 0
2339, 1, 1636424218269, 1636424218365, 96, 1, 95, 0, 0, 0
2341, 1, 1636424218345, 1636424218433, 88, 0, 88, 0, 0, 0
2342, 1, 1636424218542, 1636424218634, 92, 0, 92, 0, 0, 0
2344, 1, 1636424219130, 1636424219222, 92, 0, 92, 0, 0, 0
2346, 1, 1636424219450, 1636424219541, 91, 0, 91, 0, 0, 0
2345, 1, 1636424219586, 1636424219677, 91, 0, 91, 0, 0, 0
2347, 1, 1636424219622, 1636424219713, 91, 0, 91, 0, 0, 0
2348, 1, 1636424219905, 1636424219998, 93, 1, 92, 0, 1, 1
2349, 1, 1636424220438, 1636424220530, 92, 0, 92, 0, 0, 0
2351, 1, 1636424220777, 1636424220869, 92, 1, 91, 1, 0, 1
2350, 1, 1636424220893, 1636424220986, 93, 1, 92, 0, 0, 0
2352, 1, 1636424220913, 1636424221006, 93, 1, 92, 0, 0, 0
2353, 1, 1636424221234, 1636424221326, 92, 0, 92, 0, 0, 0
2354, 1, 1636424221786, 1636424221878, 92, 0, 92, 0, 0, 0
2356, 1, 1636424222118, 1636424222209, 91, 0, 91, 0, 0, 0
2355, 1, 1636424222242, 1636424222334, 92, 0, 92, 0, 0, 0
2357, 1, 1636424222249, 1636424222342, 93, 1, 92, 1, 0, 1
2358, 1, 1636424222570, 1636424222662, 92, 0, 92, 0, 0, 0
2359, 1, 1636424223165, 1636424223258, 93, 1, 92, 0, 0, 0
2361, 1, 1636424223390, 1636424223481, 91, 0, 91, 0, 0, 0
2336, 1, 1636424223517, 1636424223606, 89, 0, 89, 0, 0, 0
2362, 1, 1636424223561, 1636424223653, 92, 0, 92, 0, 0, 0
2360, 1, 1636424223613, 1636424223705, 92, 1, 91, 0, 0, 0
2363, 1, 1636424223841, 1636424223937, 96, 1, 95, 1, 0, 1
2365, 1, 1636424223882, 1636424223974, 92, 0, 92, 0, 0, 0
2367, 1, 1636424224478, 1636424224570, 92, 0, 92, 0, 0, 0
2369, 1, 1636424224782, 1636424224874, 92, 0, 92, 0, 0, 0
2370, 1, 1636424224906, 1636424224998, 92, 0, 92, 0, 0, 0
2368, 1, 1636424224930, 1636424225021, 91, 0, 91, 0, 0, 0
2372, 1, 1636424225126, 1636424225218, 92, 0, 92, 0, 0, 0
2371, 1, 1636424225241, 1636424225334, 93, 1, 92, 0, 0, 0
2373, 1, 1636424225789, 1636424225882, 93, 0, 93, 0, 0, 0
2375, 1, 1636424226173, 1636424226265, 92, 1, 91, 0, 0, 0
2374, 1, 1636424226241, 1636424226334, 93, 1, 92, 1, 0, 1
2376, 1, 1636424226265, 1636424226357, 92, 1, 91, 0, 0, 0
2378, 1, 1636424226526, 1636424226618, 92, 0, 92, 0, 0, 0
2377, 1, 1636424226629, 1636424226721, 92, 1, 91, 1, 0, 1
2379, 1, 1636424227162, 1636424227254, 92, 0, 92, 0, 0, 0
2381, 1, 1636424227498, 1636424227589, 91, 0, 91, 0, 0, 0
2382, 1, 1636424227549, 1636424227641, 92, 1, 91, 0, 1, 1
2380, 1, 1636424227618, 1636424227709, 91, 0, 91, 0, 0, 0
2384, 1, 1636424227893, 1636424227986, 93, 1, 92, 1, 0, 1
2383, 1, 1636424227953, 1636424228046, 93, 1, 92, 0, 1, 1
2385, 1, 1636424228510, 1636424228601, 91, 0, 91, 0, 0, 0
2387, 1, 1636424228802, 1636424228894, 92, 0, 92, 0, 0, 0
2386, 1, 1636424228970, 1636424229057, 87, 0, 87, 0, 0, 0
2388, 1, 1636424228970, 1636424229057, 87, 1, 86, 0, 0, 0
2389, 1, 1636424229253, 1636424229341, 88, 0, 88, 0, 0, 0
2391, 1, 1636424229281, 1636424229369, 88, 0, 88, 0, 0, 0
2390, 1, 1636424229317, 1636424229410, 93, 1, 92, 1, 0, 1
2394, 1, 1636424230078, 1636424230170, 92, 0, 92, 0, 0, 0
2396, 1, 1636424230294, 1636424230385, 91, 0, 91, 0, 0, 0
2395, 1, 1636424230533, 1636424230625, 92, 1, 91, 0, 1, 1
2397, 1, 1636424230574, 1636424230666, 92, 0, 92, 0, 0, 0
2398, 1, 1636424230666, 1636424230757, 91, 0, 91, 0, 0, 0
2399, 1, 1636424231369, 1636424231462, 93, 1, 92, 0, 0, 0
2401, 1, 1636424231630, 1636424231722, 92, 0, 92, 0, 0, 0
2400, 1, 1636424231825, 1636424231913, 88, 0, 88, 0, 0, 0
2402, 1, 1636424231973, 1636424232066, 93, 1, 92, 1, 0, 1
2403, 1, 1636424231981, 1636424232073, 92, 1, 91, 0, 0, 0
2404, 1, 1636424232658, 1636424232750, 92, 0, 92, 0, 0, 0
2406, 1, 1636424233030, 1636424233122, 92, 0, 92, 0, 0, 0
2405, 1, 1636424233117, 1636424233214, 97, 1, 96, 0, 1, 1
2407, 1, 1636424233278, 1636424233370, 92, 0, 92, 0, 0, 0
2408, 1, 1636424233341, 1636424233430, 89, 1, 88, 1, 0, 1
2409, 1, 1636424234326, 1636424234418, 92, 0, 92, 0, 0, 0
2412, 1, 1636424234625, 1636424234717, 92, 1, 91, 1, 0, 1
2410, 1, 1636424234646, 1636424234738, 92, 0, 92, 0, 0, 0
2413, 1, 1636424234706, 1636424234798, 92, 0, 92, 0, 0, 0
2411, 1, 1636424235102, 1636424235193, 91, 0, 91, 0, 0, 0
2414, 1, 1636424235682, 1636424235774, 92, 0, 92, 0, 0, 0
2417, 1, 1636424236006, 1636424236097, 91, 0, 91, 0, 0, 0
2418, 1, 1636424236090, 1636424236178, 88, 0, 88, 0, 0, 0
2419, 1, 1636424237030, 1636424237122, 92, 0, 92, 0, 0, 0
2421, 1, 1636424237389, 1636424237482, 93, 1, 92, 0, 1, 1
2422, 1, 1636424238322, 1636424238414, 92, 0, 92, 0, 0, 0
2423, 1, 1636424238661, 1636424238754, 93, 1, 92, 0, 1, 1
2424, 1, 1636424239726, 1636424239813, 87, 0, 87, 0, 0, 0
2425, 1, 1636424239949, 1636424240041, 92, 1, 91, 0, 0, 0
2426, 1, 1636424240166, 1636424240257, 91, 0, 91, 0, 0, 0
2427, 1, 1636424240622, 1636424240714, 92, 0, 92, 0, 0, 0
2428, 1, 1636424241070, 1636424241162, 92, 0, 92, 0, 0, 0
2429, 1, 1636424241218, 1636424241309, 91, 0, 91, 0, 0, 0
2433, 1, 1636424242562, 1636424242654, 92, 0, 92, 0, 0, 0
2434, 1, 1636424243833, 1636424243926, 93, 0, 93, 0, 0, 0
2435, 1, 1636424245162, 1636424245254, 92, 0, 92, 0, 0, 0
2436, 1, 1636424246158, 1636424246250, 92, 0, 92, 0, 0, 0
2438, 1, 1636424246525, 1636424246617, 92, 1, 91, 0, 0, 0
2437, 1, 1636424246613, 1636424246705, 92, 1, 91, 0, 0, 0
2439, 1, 1636424247422, 1636424247514, 92, 0, 92, 0, 0, 0
2441, 1, 1636424247642, 1636424247734, 92, 0, 92, 0, 0, 0
2442, 1, 1636424247801, 1636424247893, 92, 1, 91, 0, 0, 0
2440, 1, 1636424247873, 1636424247966, 93, 1, 92, 0, 0, 0
2443, 1, 1636424248745, 1636424248838, 93, 1, 92, 0, 0, 0
2445, 1, 1636424248890, 1636424248982, 92, 0, 92, 0, 0, 0
2446, 1, 1636424249102, 1636424249194, 92, 0, 92, 0, 0, 0
2444, 1, 1636424249202, 1636424249294, 92, 0, 92, 0, 0, 0
2447, 1, 1636424250025, 1636424250118, 93, 1, 92, 0, 0, 0
2449, 1, 1636424250198, 1636424250289, 91, 0, 91, 0, 0, 0
2450, 1, 1636424250426, 1636424250517, 91, 0, 91, 0, 0, 0
2448, 1, 1636424250477, 1636424250570, 93, 1, 92, 1, 0, 1
2451, 1, 1636424251321, 1636424251414, 93, 1, 92, 0, 0, 0
2453, 1, 1636424251581, 1636424251673, 92, 1, 91, 0, 1, 1
2454, 1, 1636424251670, 1636424251762, 92, 0, 92, 0, 0, 0
2452, 1, 1636424251777, 1636424251869, 92, 0, 92, 0, 0, 0
2456, 1, 1636424251818, 1636424251910, 92, 0, 92, 0, 0, 0
2455, 1, 1636424252126, 1636424252222, 96, 0, 96, 0, 0, 0
2457, 1, 1636424252642, 1636424252734, 92, 0, 92, 0, 0, 0
2458, 1, 1636424252653, 1636424252746, 93, 1, 92, 0, 1, 1
2460, 1, 1636424252838, 1636424252929, 91, 0, 91, 0, 0, 0
2461, 1, 1636424252910, 1636424253002, 92, 0, 92, 0, 0, 0
2459, 1, 1636424253110, 1636424253206, 96, 0, 96, 0, 0, 0
2463, 1, 1636424253190, 1636424253282, 92, 0, 92, 0, 0, 0
2462, 1, 1636424253366, 1636424253457, 91, 0, 91, 0, 0, 0
2464, 1, 1636424253894, 1636424253985, 91, 0, 91, 0, 0, 0
2465, 1, 1636424253945, 1636424254037, 92, 0, 92, 0, 0, 0
2467, 1, 1636424254241, 1636424254333, 92, 1, 91, 0, 0, 0
2466, 1, 1636424254393, 1636424254486, 93, 1, 92, 0, 1, 1
2470, 1, 1636424254581, 1636424254673, 92, 1, 91, 0, 1, 1
2471, 1, 1636424255197, 1636424255290, 93, 1, 92, 0, 1, 1
2472, 1, 1636424255289, 1636424255382, 93, 1, 92, 0, 0, 0
2474, 1, 1636424255514, 1636424255606, 92, 0, 92, 0, 0, 0
2473, 1, 1636424255750, 1636424255841, 91, 0, 91, 0, 0, 0
2475, 1, 1636424255885, 1636424255978, 93, 0, 93, 0, 0, 0
2476, 1, 1636424256562, 1636424256654, 92, 0, 92, 0, 0, 0
2477, 1, 1636424256650, 1636424256742, 92, 0, 92, 0, 0, 0
2479, 1, 1636424256906, 1636424256998, 92, 0, 92, 0, 0, 0
2478, 1, 1636424257106, 1636424257197, 91, 0, 91, 0, 0, 0
2480, 1, 1636424257253, 1636424257346, 93, 1, 92, 0, 0, 0
2481, 1, 1636424257866, 1636424257957, 91, 0, 91, 0, 0, 0
2482, 1, 1636424257934, 1636424258026, 92, 0, 92, 0, 0, 0
2484, 1, 1636424258302, 1636424258394, 92, 0, 92, 0, 0, 0
2483, 1, 1636424258389, 1636424258482, 93, 1, 92, 0, 0, 0
2485, 1, 1636424258585, 1636424258678, 93, 1, 92, 0, 0, 0
2486, 1, 1636424259222, 1636424259313, 91, 0, 91, 0, 0, 0
2487, 1, 1636424259329, 1636424259418, 89, 0, 89, 0, 0, 0
2489, 1, 1636424259630, 1636424259722, 92, 0, 92, 0, 0, 0
2488, 1, 1636424259777, 1636424259870, 93, 1, 92, 0, 0, 0
2490, 1, 1636424259942, 1636424260033, 91, 0, 91, 0, 0, 0
2491, 1, 1636424260490, 1636424260582, 92, 0, 92, 0, 0, 0
2492, 1, 1636424260729, 1636424260822, 93, 1, 92, 0, 0, 0
2494, 1, 1636424260930, 1636424261022, 92, 0, 92, 0, 0, 0
2493, 1, 1636424261185, 1636424261278, 93, 1, 92, 0, 0, 0
2495, 1, 1636424261222, 1636424261310, 88, 0, 88, 0, 0, 0
2496, 1, 1636424261885, 1636424261978, 93, 1, 92, 0, 0, 0
2497, 1, 1636424262062, 1636424262154, 92, 0, 92, 0, 0, 0
2499, 1, 1636424262205, 1636424262298, 93, 1, 92, 0, 0, 0
2498, 1, 1636424262518, 1636424262610, 92, 0, 92, 0, 0, 0
2500, 1, 1636424262601, 1636424262694, 93, 1, 92, 0, 0, 0
2501, 1, 1636424263282, 1636424263374, 92, 0, 92, 0, 0, 0
2502, 1, 1636424263458, 1636424263550, 92, 0, 92, 0, 0, 0
2503, 1, 1636424263918, 1636424264006, 88, 0, 88, 0, 0, 0
2504, 1, 1636424263998, 1636424264090, 92, 0, 92, 0, 0, 0
2507, 1, 1636424264594, 1636424264685, 91, 0, 91, 0, 0, 0
2506, 1, 1636424264618, 1636424264710, 92, 0, 92, 0, 0, 0
2508, 1, 1636424264737, 1636424264830, 93, 1, 92, 1, 0, 1
2505, 1, 1636424265070, 1636424265162, 92, 0, 92, 0, 0, 0
2509, 1, 1636424265194, 1636424265286, 92, 0, 92, 0, 0, 0
2510, 1, 1636424265305, 1636424265397, 92, 1, 91, 0, 0, 0
2511, 1, 1636424265878, 1636424265969, 91, 0, 91, 0, 0, 0
2514, 1, 1636424266106, 1636424266197, 91, 0, 91, 0, 0, 0
2515, 1, 1636424266566, 1636424266658, 92, 0, 92, 0, 0, 0
2517, 1, 1636424267154, 1636424267246, 92, 0, 92, 0, 0, 0
2518, 1, 1636424267454, 1636424267546, 92, 0, 92, 0, 0, 0
2519, 1, 1636424267910, 1636424268002, 92, 0, 92, 0, 0, 0
2520, 1, 1636424268517, 1636424268606, 89, 0, 89, 0, 0, 0
2521, 1, 1636424268774, 1636424268866, 92, 0, 92, 0, 0, 0
2522, 1, 1636424269229, 1636424269322, 93, 1, 92, 0, 0, 0
2523, 1, 1636424269882, 1636424269978, 96, 0, 96, 0, 0, 0
2524, 1, 1636424270162, 1636424270254, 92, 0, 92, 0, 0, 0
2525, 1, 1636424270618, 1636424270710, 92, 0, 92, 0, 0, 0
2526, 1, 1636424271225, 1636424271318, 93, 1, 92, 1, 0, 1
2527, 1, 1636424271529, 1636424271621, 92, 1, 91, 1, 0, 1
2528, 1, 1636424271982, 1636424272074, 92, 0, 92, 0, 0, 0
2529, 1, 1636424272522, 1636424272614, 92, 0, 92, 0, 0, 0
2532, 1, 1636424273822, 1636424273914, 92, 0, 92, 0, 0, 0
2533, 1, 1636424275086, 1636424275178, 92, 0, 92, 0, 0, 0
2516, 1, 1636424275938, 1636424276030, 92, 0, 92, 0, 0, 0
2534, 1, 1636424276362, 1636424276454, 92, 0, 92, 0, 0, 0
2535, 1, 1636424276609, 1636424276702, 93, 1, 92, 0, 1, 1
2537, 1, 1636424276642, 1636424276734, 92, 0, 92, 0, 0, 0
2536, 1, 1636424277065, 1636424277154, 89, 0, 89, 0, 0, 0
2538, 1, 1636424277758, 1636424277850, 92, 0, 92, 0, 0, 0
2539, 1, 1636424277890, 1636424277982, 92, 0, 92, 0, 0, 0
2540, 1, 1636424279025, 1636424279118, 93, 1, 92, 0, 1, 1
2541, 1, 1636424279217, 1636424279309, 92, 1, 91, 0, 0, 0
2542, 1, 1636424280302, 1636424280394, 92, 0, 92, 0, 0, 0
2543, 1, 1636424280570, 1636424280662, 92, 0, 92, 0, 0, 0
2544, 1, 1636424281665, 1636424281757, 92, 1, 91, 0, 0, 0
2545, 1, 1636424281850, 1636424281941, 91, 0, 91, 0, 0, 0
2546, 1, 1636424282938, 1636424283030, 92, 0, 92, 0, 0, 0
2547, 1, 1636424283114, 1636424283205, 91, 0, 91, 0, 0, 0
2549, 1, 1636424283121, 1636424283214, 93, 1, 92, 0, 0, 0
2548, 1, 1636424283566, 1636424283658, 92, 0, 92, 0, 0, 0
2550, 1, 1636424284242, 1636424284334, 92, 0, 92, 0, 0, 0
2551, 1, 1636424284397, 1636424284489, 92, 1, 91, 0, 1, 1
2553, 1, 1636424284409, 1636424284502, 93, 1, 92, 0, 0, 0
2552, 1, 1636424284854, 1636424284946, 92, 0, 92, 0, 0, 0
2554, 1, 1636424285566, 1636424285658, 92, 0, 92, 0, 0, 0
2555, 1, 1636424285710, 1636424285801, 91, 0, 91, 0, 0, 0
2556, 1, 1636424285717, 1636424285809, 92, 1, 91, 0, 0, 0
2557, 1, 1636424286166, 1636424286258, 92, 0, 92, 0, 0, 0
2558, 1, 1636424286950, 1636424287042, 92, 0, 92, 0, 0, 0
2559, 1, 1636424287061, 1636424287154, 93, 0, 93, 0, 0, 0
2561, 1, 1636424287069, 1636424287162, 93, 1, 92, 0, 0, 0
2560, 1, 1636424287518, 1636424287610, 92, 0, 92, 0, 0, 0
2562, 1, 1636424288290, 1636424288381, 91, 0, 91, 0, 0, 0
2563, 1, 1636424288390, 1636424288481, 91, 0, 91, 0, 0, 0
2565, 1, 1636424288437, 1636424288526, 89, 0, 89, 0, 0, 0
2564, 1, 1636424288850, 1636424288942, 92, 0, 92, 0, 0, 0
2566, 1, 1636424289630, 1636424289722, 92, 0, 92, 0, 0, 0
2568, 1, 1636424289730, 1636424289822, 92, 0, 92, 0, 0, 0
2569, 1, 1636424290185, 1636424290278, 93, 1, 92, 1, 0, 1
2570, 1, 1636424290938, 1636424291029, 91, 0, 91, 0, 0, 0
2571, 1, 1636424290997, 1636424291089, 92, 1, 91, 1, 0, 1
2572, 1, 1636424291446, 1636424291538, 92, 0, 92, 0, 0, 0
2573, 1, 1636424292302, 1636424292389, 87, 0, 87, 0, 0, 0
2574, 1, 1636424292357, 1636424292449, 92, 0, 92, 0, 0, 0
2575, 1, 1636424292810, 1636424292902, 92, 0, 92, 0, 0, 0
2576, 1, 1636424293630, 1636424293722, 92, 0, 92, 0, 0, 0
2577, 1, 1636424293742, 1636424293834, 92, 0, 92, 0, 0, 0
2578, 1, 1636424294201, 1636424294294, 93, 1, 92, 0, 0, 0
2579, 1, 1636424294966, 1636424295057, 91, 0, 91, 0, 0, 0
2580, 1, 1636424295053, 1636424295137, 84, 0, 84, 0, 0, 0
2581, 1, 1636424295497, 1636424295590, 93, 0, 93, 0, 0, 0
2582, 1, 1636424296238, 1636424296330, 92, 0, 92, 0, 0, 0
2583, 1, 1636424297626, 1636424297718, 92, 0, 92, 0, 0, 0
2584, 1, 1636424299018, 1636424299110, 92, 0, 92, 0, 0, 0
2585, 1, 1636424300026, 1636424300117, 91, 0, 91, 0, 0, 0
2586, 1, 1636424300330, 1636424300422, 92, 0, 92, 0, 0, 0
2587, 1, 1636424301286, 1636424301378, 92, 0, 92, 0, 0, 0
2588, 1, 1636424302650, 1636424302742, 92, 0, 92, 0, 0, 0
2589, 1, 1636424303946, 1636424304038, 92, 0, 92, 0, 0, 0
2590, 1, 1636424305334, 1636424305426, 92, 0, 92, 0, 0, 0
2591, 1, 1636424306710, 1636424306802, 92, 0, 92, 0, 0, 0
2593, 1, 1636424318350, 1636424318442, 92, 0, 92, 0, 0, 0
2594, 1, 1636424319602, 1636424319694, 92, 0, 92, 0, 0, 0
2595, 1, 1636424320910, 1636424321002, 92, 0, 92, 0, 0, 0
2596, 1, 1636424322262, 1636424322354, 92, 0, 92, 0, 0, 0
2597, 1, 1636424323598, 1636424323690, 92, 0, 92, 0, 0, 0
2598, 1, 1636424324954, 1636424325046, 92, 0, 92, 0, 0, 0
2599, 1, 1636424326226, 1636424326318, 92, 0, 92, 0, 0, 0
2600, 1, 1636424327614, 1636424327706, 92, 0, 92, 0, 0, 0
2601, 1, 1636424485438, 1636424485530, 92, 0, 92, 0, 0, 0
2602, 1, 1636424485930, 1636424486022, 92, 0, 92, 0, 0, 0
2603, 1, 1636424486502, 1636424486594, 92, 0, 92, 0, 0, 0
2604, 1, 1636424487178, 1636424487270, 92, 0, 92, 0, 0, 0
2605, 1, 1636424487302, 1636424487393, 91, 0, 91, 0, 0, 0
2606, 1, 1636424487794, 1636424487885, 91, 0, 91, 0, 0, 0
2607, 1, 1636424487797, 1636424487885, 88, 1, 87, 0, 1, 1
2608, 1, 1636424488430, 1636424488522, 92, 0, 92, 0, 0, 0
2609, 1, 1636424488498, 1636424488590, 92, 0, 92, 0, 0, 0
2610, 1, 1636424489037, 1636424489130, 93, 0, 93, 0, 0, 0
2611, 1, 1636424489046, 1636424489138, 92, 0, 92, 0, 0, 0
2612, 1, 1636424489250, 1636424489342, 92, 0, 92, 0, 0, 0
2613, 1, 1636424489666, 1636424489758, 92, 0, 92, 0, 0, 0
2614, 1, 1636424489742, 1636424489833, 91, 0, 91, 0, 0, 0
2615, 1, 1636424489789, 1636424489885, 96, 5, 91, 0, 0, 0
2616, 1, 1636424490322, 1636424490414, 92, 0, 92, 0, 0, 0
2617, 1, 1636424490429, 1636424490521, 92, 1, 91, 1, 0, 1
2618, 1, 1636424490445, 1636424490538, 93, 1, 92, 1, 0, 1
2619, 1, 1636424490874, 1636424490966, 92, 0, 92, 0, 0, 0
2620, 1, 1636424490994, 1636424491085, 91, 0, 91, 0, 0, 0
2621, 1, 1636424491033, 1636424491126, 93, 1, 92, 0, 1, 1
2622, 1, 1636424491290, 1636424491381, 91, 0, 91, 0, 0, 0
2623, 1, 1636424491618, 1636424491710, 92, 0, 92, 0, 0, 0
2624, 1, 1636424491693, 1636424491786, 93, 1, 92, 1, 0, 1
2625, 1, 1636424491789, 1636424491882, 93, 1, 92, 0, 0, 0
2626, 1, 1636424492290, 1636424492381, 91, 0, 91, 0, 0, 0
2627, 1, 1636424492322, 1636424492413, 91, 0, 91, 0, 0, 0
2628, 1, 1636424492381, 1636424492469, 88, 1, 87, 0, 1, 1
2629, 1, 1636424492481, 1636424492574, 93, 0, 93, 0, 0, 0
2630, 1, 1636424492777, 1636424492870, 93, 1, 92, 0, 0, 0
2631, 1, 1636424492986, 1636424493078, 92, 0, 92, 0, 0, 0
2632, 1, 1636424493009, 1636424493101, 92, 1, 91, 1, 0, 1
2633, 1, 1636424493101, 1636424493193, 92, 1, 91, 0, 0, 0
2634, 1, 1636424493374, 1636424493474, 100, 0, 100, 0, 0, 0
2635, 1, 1636424493554, 1636424493645, 91, 0, 91, 0, 0, 0
2636, 1, 1636424493630, 1636424493721, 91, 0, 91, 0, 0, 0
2637, 1, 1636424493641, 1636424493733, 92, 1, 91, 1, 0, 1
2638, 1, 1636424493913, 1636424494006, 93, 1, 92, 0, 0, 0
2639, 1, 1636424494150, 1636424494241, 91, 0, 91, 0, 0, 0
2640, 1, 1636424494257, 1636424494349, 92, 1, 91, 1, 0, 1
2641, 1, 1636424494269, 1636424494362, 93, 1, 92, 1, 0, 1
2642, 1, 1636424494421, 1636424494514, 93, 1, 92, 1, 0, 1
2643, 1, 1636424494613, 1636424494705, 92, 1, 91, 0, 0, 0
2644, 1, 1636424494729, 1636424494822, 93, 0, 93, 0, 0, 0
2646, 1, 1636424495025, 1636424495117, 92, 1, 91, 0, 1, 1
2645, 1, 1636424495025, 1636424495118, 93, 1, 92, 1, 0, 1
2647, 1, 1636424495089, 1636424495181, 92, 1, 91, 1, 0, 1
2648, 1, 1636424495102, 1636424495194, 92, 0, 92, 0, 0, 0
2650, 1, 1636424495486, 1636424495578, 92, 0, 92, 0, 0, 0
2649, 1, 1636424495541, 1636424495634, 93, 1, 92, 0, 0, 0
2651, 1, 1636424495550, 1636424495641, 91, 0, 91, 0, 0, 0
2652, 1, 1636424495689, 1636424495781, 92, 0, 92, 0, 0, 0
2654, 1, 1636424495998, 1636424496089, 91, 0, 91, 0, 0, 0
2655, 1, 1636424496081, 1636424496169, 88, 1, 87, 1, 0, 1
2656, 1, 1636424496097, 1636424496186, 89, 1, 88, 0, 0, 0
2657, 1, 1636424496118, 1636424496210, 92, 0, 92, 0, 0, 0
2658, 1, 1636424496277, 1636424496369, 92, 1, 91, 0, 0, 0
2653, 1, 1636424496453, 1636424496549, 96, 1, 95, 0, 0, 0
2661, 1, 1636424496682, 1636424496773, 91, 0, 91, 0, 0, 0
2662, 1, 1636424496758, 1636424496850, 92, 0, 92, 0, 0, 0
2663, 1, 1636424496934, 1636424497025, 91, 0, 91, 0, 0, 0
2665, 1, 1636424497049, 1636424497142, 93, 1, 92, 0, 1, 1
2667, 1, 1636424497198, 1636424497290, 92, 0, 92, 0, 0, 0
2669, 1, 1636424497382, 1636424497474, 92, 0, 92, 0, 0, 0
2668, 1, 1636424497501, 1636424497594, 93, 1, 92, 0, 1, 1
2670, 1, 1636424497654, 1636424497746, 92, 0, 92, 0, 0, 0
2673, 1, 1636424497814, 1636424497906, 92, 0, 92, 0, 0, 0
2675, 1, 1636424498065, 1636424498149, 84, 0, 84, 0, 0, 0
2676, 1, 1636424498077, 1636424498161, 84, 0, 84, 0, 0, 0
2677, 1, 1636424498137, 1636424498229, 92, 1, 91, 0, 0, 0
2679, 1, 1636424498677, 1636424498769, 92, 1, 91, 0, 0, 0
2680, 1, 1636424498885, 1636424498973, 88, 0, 88, 0, 0, 0
2682, 1, 1636424499061, 1636424499149, 88, 0, 88, 0, 0, 0
2683, 1, 1636424499193, 1636424499282, 89, 0, 89, 0, 0, 0
2685, 1, 1636424499329, 1636424499425, 96, 1, 95, 1, 0, 1
2686, 1, 1636424499341, 1636424499438, 97, 1, 96, 1, 0, 1
2684, 1, 1636424499505, 1636424499593, 88, 1, 87, 0, 1, 1
2688, 1, 1636424500030, 1636424500122, 92, 0, 92, 0, 0, 0
2689, 1, 1636424500129, 1636424500222, 93, 1, 92, 0, 0, 0
2691, 1, 1636424500626, 1636424500722, 96, 0, 96, 0, 0, 0
2692, 1, 1636424500917, 1636424501006, 89, 1, 88, 0, 0, 0
2693, 1, 1636424501137, 1636424501230, 93, 0, 93, 0, 0, 0
2696, 1, 1636424501381, 1636424501473, 92, 1, 91, 0, 1, 1
2697, 1, 1636424501425, 1636424501518, 93, 1, 92, 0, 0, 0
2698, 1, 1636424502069, 1636424502162, 93, 1, 92, 0, 1, 1
2700, 1, 1636424502642, 1636424502734, 92, 0, 92, 0, 0, 0
2702, 1, 1636424503177, 1636424503270, 93, 1, 92, 1, 0, 1
2703, 1, 1636424503482, 1636424503574, 92, 0, 92, 0, 0, 0
2708, 1, 1636424505474, 1636424505566, 92, 0, 92, 0, 0, 0
2709, 1, 1636424507221, 1636424507309, 88, 1, 87, 0, 0, 0
2710, 1, 1636424507233, 1636424507321, 88, 1, 87, 0, 0, 0
2713, 1, 1636424507337, 1636424507429, 92, 1, 91, 0, 1, 1
2711, 1, 1636424507677, 1636424507770, 93, 1, 92, 0, 0, 0
2712, 1, 1636424507677, 1636424507770, 93, 1, 92, 0, 1, 1
2714, 1, 1636424508134, 1636424508226, 92, 0, 92, 0, 0, 0
2716, 1, 1636424508458, 1636424508550, 92, 0, 92, 0, 0, 0
2717, 1, 1636424508749, 1636424508842, 93, 1, 92, 0, 0, 0
2718, 1, 1636424509070, 1636424509161, 91, 0, 91, 0, 0, 0
2719, 1, 1636424509141, 1636424509225, 84, 0, 84, 0, 0, 0
2720, 1, 1636424509193, 1636424509285, 92, 1, 91, 0, 0, 0
2723, 1, 1636424509257, 1636424509345, 88, 1, 87, 1, 0, 1
2721, 1, 1636424509517, 1636424509609, 92, 1, 91, 0, 0, 0
2722, 1, 1636424509593, 1636424509685, 92, 1, 91, 1, 0, 1
2724, 1, 1636424509978, 1636424510069, 91, 0, 91, 0, 0, 0
2725, 1, 1636424510025, 1636424510129, 104, 0, 104, 0, 0, 0
2726, 1, 1636424510314, 1636424510409, 95, 0, 95, 0, 0, 0
2727, 1, 1636424510577, 1636424510669, 92, 1, 91, 0, 0, 0
2728, 1, 1636424510618, 1636424510710, 92, 0, 92, 0, 0, 0
2730, 1, 1636424511074, 1636424511194, 120, 0, 120, 0, 0, 0
2729, 1, 1636424511053, 1636424511194, 141, 1, 140, 1, 0, 1
2731, 1, 1636424511194, 1636424511290, 96, 0, 96, 0, 0, 0
2734, 1, 1636424511417, 1636424511509, 92, 1, 91, 0, 0, 0
2735, 1, 1636424511502, 1636424511594, 92, 0, 92, 0, 0, 0
2732, 1, 1636424511557, 1636424511650, 93, 1, 92, 0, 0, 0
2733, 1, 1636424511641, 1636424511733, 92, 1, 91, 1, 0, 1
2738, 1, 1636424511854, 1636424511946, 92, 0, 92, 0, 0, 0
2736, 1, 1636424511953, 1636424512045, 92, 1, 91, 0, 1, 1
2737, 1, 1636424512010, 1636424512121, 111, 0, 111, 0, 0, 0
2739, 1, 1636424512214, 1636424512306, 92, 0, 92, 0, 0, 0
2740, 1, 1636424512478, 1636424512570, 92, 0, 92, 0, 0, 0
2741, 1, 1636424512554, 1636424512641, 87, 0, 87, 0, 0, 0
2742, 1, 1636424512573, 1636424512669, 96, 0, 96, 0, 0, 0
2744, 1, 1636424512977, 1636424513069, 92, 1, 91, 0, 0, 0
2743, 1, 1636424513021, 1636424513113, 92, 1, 91, 1, 0, 1
2746, 1, 1636424513081, 1636424513173, 92, 1, 91, 0, 1, 1
2748, 1, 1636424513302, 1636424513394, 92, 0, 92, 0, 0, 0
2749, 1, 1636424513377, 1636424513469, 92, 1, 91, 1, 0, 1
2750, 1, 1636424513394, 1636424513485, 91, 0, 91, 0, 0, 0
2745, 1, 1636424513469, 1636424513558, 89, 1, 88, 1, 0, 1
2747, 1, 1636424513525, 1636424513621, 96, 1, 95, 0, 1, 1
2753, 1, 1636424513817, 1636424513906, 89, 1, 88, 1, 0, 1
2751, 1, 1636424513834, 1636424513925, 91, 0, 91, 0, 0, 0
2752, 1, 1636424513905, 1636424514001, 96, 1, 95, 0, 0, 0
2754, 1, 1636424513977, 1636424514070, 93, 0, 93, 0, 0, 0
2755, 1, 1636424514293, 1636424514386, 93, 1, 92, 0, 0, 0
2757, 1, 1636424514437, 1636424514529, 92, 1, 91, 0, 1, 1
2759, 1, 1636424514529, 1636424514633, 104, 0, 104, 0, 0, 0
2758, 1, 1636424514510, 1636424514633, 123, 0, 123, 0, 0, 0
2756, 1, 1636424514738, 1636424514825, 87, 0, 87, 0, 0, 0
2761, 1, 1636424514957, 1636424515045, 88, 1, 87, 1, 0, 1
2760, 1, 1636424514989, 1636424515113, 124, 1, 123, 0, 0, 0
2764, 1, 1636424515113, 1636424515205, 92, 1, 91, 0, 1, 1
2715, 1, 1636424515241, 1636424515337, 96, 1, 95, 1, 0, 1
2767, 1, 1636424515333, 1636424515425, 92, 1, 91, 0, 1, 1
2765, 1, 1636424515414, 1636424515505, 91, 0, 91, 0, 0, 0
2768, 1, 1636424515458, 1636424515550, 92, 0, 92, 0, 0, 0
2770, 1, 1636424515561, 1636424515653, 92, 1, 91, 1, 0, 1
2773, 1, 1636424515749, 1636424515842, 93, 1, 92, 0, 0, 0
2769, 1, 1636424515790, 1636424515881, 91, 0, 91, 0, 0, 0
2774, 1, 1636424515914, 1636424516005, 91, 0, 91, 0, 0, 0
2775, 1, 1636424516249, 1636424516341, 92, 1, 91, 0, 1, 1
2777, 1, 1636424516377, 1636424516470, 93, 1, 92, 0, 0, 0
2778, 1, 1636424516386, 1636424516474, 88, 0, 88, 0, 0, 0
2779, 1, 1636424516474, 1636424516562, 88, 0, 88, 0, 0, 0
2780, 1, 1636424516918, 1636424517010, 92, 0, 92, 0, 0, 0
2784, 1, 1636424517305, 1636424517398, 93, 1, 92, 0, 0, 0
2786, 1, 1636424517422, 1636424517514, 92, 0, 92, 0, 0, 0
2788, 1, 1636424517701, 1636424517794, 93, 1, 92, 0, 0, 0
2785, 1, 1636424517753, 1636424517841, 88, 0, 88, 0, 0, 0
2789, 1, 1636424517774, 1636424517866, 92, 0, 92, 0, 0, 0
2790, 1, 1636424518274, 1636424518365, 91, 0, 91, 0, 0, 0
2791, 1, 1636424518321, 1636424518410, 89, 0, 89, 0, 0, 0
2792, 1, 1636424518389, 1636424518482, 93, 1, 92, 0, 1, 1
2795, 1, 1636424519193, 1636424519281, 88, 0, 88, 0, 0, 0
2796, 1, 1636424519298, 1636424519390, 92, 0, 92, 0, 0, 0
2797, 1, 1636424519646, 1636424519738, 92, 0, 92, 0, 0, 0
2799, 1, 1636424519778, 1636424519870, 92, 0, 92, 0, 0, 0
2800, 1, 1636424520206, 1636424520298, 92, 0, 92, 0, 0, 0
2802, 1, 1636424520466, 1636424520558, 92, 0, 92, 0, 0, 0
2805, 1, 1636424521394, 1636424521486, 92, 0, 92, 0, 0, 0
2806, 1, 1636424521914, 1636424522006, 92, 0, 92, 0, 0, 0
2808, 1, 1636424522538, 1636424522629, 91, 0, 91, 0, 0, 0
2809, 1, 1636424523438, 1636424523530, 92, 0, 92, 0, 0, 0
2810, 1, 1636424523918, 1636424524010, 92, 0, 92, 0, 0, 0
2811, 1, 1636424524506, 1636424524598, 92, 0, 92, 0, 0, 0
2812, 1, 1636424525401, 1636424525557, 156, 1, 155, 0, 0, 0
2813, 1, 1636424525557, 1636424525649, 92, 1, 91, 0, 0, 0
2814, 1, 1636424525557, 1636424525649, 92, 1, 91, 0, 0, 0
2817, 1, 1636424525918, 1636424526009, 91, 0, 91, 0, 0, 0
2818, 1, 1636424526013, 1636424526106, 93, 1, 92, 0, 0, 0
2819, 1, 1636424526430, 1636424526522, 92, 0, 92, 0, 0, 0
2820, 1, 1636424526649, 1636424526742, 93, 1, 92, 0, 0, 0
2821, 1, 1636424527253, 1636424527341, 88, 0, 88, 0, 0, 0
2823, 1, 1636424527333, 1636424527425, 92, 1, 91, 0, 1, 1
2824, 1, 1636424527333, 1636424527426, 93, 1, 92, 0, 0, 0
2826, 1, 1636424527437, 1636424527530, 93, 1, 92, 0, 0, 0
2827, 1, 1636424527769, 1636424527862, 93, 1, 92, 1, 0, 1
2828, 1, 1636424527869, 1636424527961, 92, 1, 91, 1, 0, 1
2829, 1, 1636424527909, 1636424528002, 93, 1, 92, 0, 0, 0
2830, 1, 1636424528513, 1636424528605, 92, 1, 91, 0, 0, 0
2831, 1, 1636424528513, 1636424528605, 92, 1, 91, 0, 0, 0
2834, 1, 1636424529138, 1636424529229, 91, 0, 91, 0, 0, 0
2835, 1, 1636424529213, 1636424529306, 93, 1, 92, 1, 0, 1
2836, 1, 1636424529277, 1636424529365, 88, 1, 87, 0, 1, 1
2837, 1, 1636424529537, 1636424529641, 104, 1, 103, 0, 0, 0
2838, 1, 1636424529674, 1636424529766, 92, 0, 92, 0, 0, 0
2839, 1, 1636424529821, 1636424529909, 88, 0, 88, 0, 0, 0
2840, 1, 1636424529865, 1636424529953, 88, 0, 88, 0, 0, 0
2841, 1, 1636424530086, 1636424530178, 92, 0, 92, 0, 0, 0
2842, 1, 1636424530442, 1636424530534, 92, 0, 92, 0, 0, 0
2844, 1, 1636424530546, 1636424530637, 91, 0, 91, 0, 0, 0
2845, 1, 1636424531082, 1636424531173, 91, 0, 91, 0, 0, 0
2847, 1, 1636424531213, 1636424531305, 92, 1, 91, 0, 0, 0
2846, 1, 1636424531213, 1636424531306, 93, 1, 92, 0, 0, 0
2807, 1, 1636424531217, 1636424531306, 89, 0, 89, 0, 0, 0
2850, 1, 1636424531554, 1636424531646, 92, 0, 92, 0, 0, 0
2851, 1, 1636424531629, 1636424531717, 88, 0, 88, 0, 0, 0
2852, 1, 1636424531673, 1636424531761, 88, 0, 88, 0, 0, 0
2854, 1, 1636424531870, 1636424531961, 91, 0, 91, 0, 0, 0
2855, 1, 1636424532102, 1636424532194, 92, 0, 92, 0, 0, 0
2856, 1, 1636424532310, 1636424532402, 92, 0, 92, 0, 0, 0
2857, 1, 1636424532657, 1636424532750, 93, 1, 92, 1, 0, 1
2858, 1, 1636424532970, 1636424533062, 92, 0, 92, 0, 0, 0
2860, 1, 1636424533293, 1636424533382, 89, 0, 89, 0, 0, 0
2861, 1, 1636424533537, 1636424533630, 93, 1, 92, 1, 0, 1
2862, 1, 1636424533558, 1636424533650, 92, 0, 92, 0, 0, 0
2864, 1, 1636424533913, 1636424534006, 93, 1, 92, 0, 0, 0
2865, 1, 1636424534009, 1636424534102, 93, 1, 92, 0, 0, 0
2867, 1, 1636424534585, 1636424534678, 93, 0, 93, 0, 0, 0
2869, 1, 1636424535313, 1636424535406, 93, 1, 92, 0, 0, 0
2870, 1, 1636424535470, 1636424535562, 92, 0, 92, 0, 0, 0
2872, 1, 1636424535934, 1636424536026, 92, 0, 92, 0, 0, 0
2874, 1, 1636424536314, 1636424536406, 92, 0, 92, 0, 0, 0
2876, 1, 1636424536553, 1636424536649, 96, 1, 95, 1, 0, 1
2875, 1, 1636424536770, 1636424536862, 92, 0, 92, 0, 0, 0
2877, 1, 1636424537337, 1636424537430, 93, 1, 92, 0, 0, 0
2878, 1, 1636424537557, 1636424537649, 92, 1, 91, 1, 0, 1
2881, 1, 1636424537865, 1636424537958, 93, 1, 92, 0, 0, 0
2880, 1, 1636424538013, 1636424538106, 93, 1, 92, 0, 0, 0
2882, 1, 1636424538186, 1636424538278, 92, 0, 92, 0, 0, 0
2884, 1, 1636424538505, 1636424538637, 132, 1, 131, 1, 0, 1
2883, 1, 1636424538645, 1636424538738, 93, 1, 92, 0, 0, 0
2885, 1, 1636424539074, 1636424539166, 92, 0, 92, 0, 0, 0
2886, 1, 1636424539269, 1636424539362, 93, 1, 92, 0, 0, 0
2888, 1, 1636424539377, 1636424539469, 92, 1, 91, 0, 0, 0
2887, 1, 1636424539525, 1636424539617, 92, 0, 92, 0, 0, 0
2890, 1, 1636424539838, 1636424539930, 92, 0, 92, 0, 0, 0
2889, 1, 1636424539838, 1636424539930, 92, 0, 92, 0, 0, 0
2891, 1, 1636424540102, 1636424540194, 92, 0, 92, 0, 0, 0
2893, 1, 1636424540490, 1636424540582, 92, 0, 92, 0, 0, 0
2892, 1, 1636424540557, 1636424540650, 93, 1, 92, 1, 0, 1
2895, 1, 1636424540921, 1636424541014, 93, 1, 92, 1, 0, 1
2894, 1, 1636424541014, 1636424541105, 91, 0, 91, 0, 0, 0
2896, 1, 1636424541393, 1636424541485, 92, 1, 91, 0, 0, 0
2898, 1, 1636424541393, 1636424541489, 96, 1, 95, 1, 0, 1
2897, 1, 1636424541489, 1636424541581, 92, 1, 91, 0, 0, 0
2902, 1, 1636424541854, 1636424541946, 92, 0, 92, 0, 0, 0
2903, 1, 1636424542154, 1636424542250, 96, 0, 96, 0, 0, 0
2906, 1, 1636424542510, 1636424542602, 92, 0, 92, 0, 0, 0
2905, 1, 1636424542605, 1636424542698, 93, 1, 92, 0, 1, 1
2907, 1, 1636424542722, 1636424542814, 92, 0, 92, 0, 0, 0
2910, 1, 1636424543378, 1636424543470, 92, 0, 92, 0, 0, 0
2911, 1, 1636424543393, 1636424543486, 93, 1, 92, 0, 0, 0
2913, 1, 1636424543734, 1636424543825, 91, 0, 91, 0, 0, 0
2915, 1, 1636424544086, 1636424544178, 92, 0, 92, 0, 0, 0
2917, 1, 1636424544478, 1636424544570, 92, 0, 92, 0, 0, 0
2916, 1, 1636424544541, 1636424544634, 93, 1, 92, 0, 0, 0
2921, 1, 1636424545357, 1636424545450, 93, 1, 92, 0, 0, 0
2922, 1, 1636424545366, 1636424545457, 91, 0, 91, 0, 0, 0
2879, 1, 1636424545638, 1636424545733, 95, 0, 95, 0, 0, 0
2923, 1, 1636424545778, 1636424545870, 92, 0, 92, 0, 0, 0
2925, 1, 1636424546193, 1636424546289, 96, 1, 95, 0, 0, 0
2927, 1, 1636424546330, 1636424546422, 92, 0, 92, 0, 0, 0
2929, 1, 1636424546422, 1636424546513, 91, 0, 91, 0, 0, 0
2928, 1, 1636424546449, 1636424546537, 88, 0, 88, 0, 0, 0
2926, 1, 1636424546654, 1636424546745, 91, 0, 91, 0, 0, 0
2930, 1, 1636424547254, 1636424547345, 91, 0, 91, 0, 0, 0
2931, 1, 1636424547457, 1636424547550, 93, 1, 92, 1, 0, 1
2932, 1, 1636424547706, 1636424547798, 92, 0, 92, 0, 0, 0
2933, 1, 1636424548102, 1636424548194, 92, 0, 92, 0, 0, 0
2934, 1, 1636424548178, 1636424548270, 92, 0, 92, 0, 0, 0
2936, 1, 1636424548273, 1636424548366, 93, 1, 92, 0, 1, 1
2937, 1, 1636424548381, 1636424548474, 93, 1, 92, 0, 0, 0
2935, 1, 1636424548554, 1636424548646, 92, 0, 92, 0, 0, 0
2938, 1, 1636424549185, 1636424549278, 93, 1, 92, 0, 0, 0
2939, 1, 1636424549365, 1636424549457, 92, 1, 91, 0, 0, 0
2940, 1, 1636424549654, 1636424549746, 92, 0, 92, 0, 0, 0
2941, 1, 1636424550057, 1636424550150, 93, 1, 92, 0, 1, 1
2943, 1, 1636424550221, 1636424550314, 93, 1, 92, 1, 0, 1
2944, 1, 1636424550273, 1636424550366, 93, 1, 92, 0, 0, 0
2945, 1, 1636424550281, 1636424550369, 88, 0, 88, 0, 0, 0
2942, 1, 1636424550510, 1636424550602, 92, 0, 92, 0, 0, 0
2947, 1, 1636424551317, 1636424551442, 125, 1, 124, 1, 0, 1
2948, 1, 1636424551618, 1636424551710, 92, 0, 92, 0, 0, 0
2950, 1, 1636424552165, 1636424552254, 89, 1, 88, 0, 1, 1
2949, 1, 1636424552161, 1636424552254, 93, 1, 92, 1, 0, 1
2953, 1, 1636424552249, 1636424552345, 96, 1, 95, 0, 0, 0
2951, 1, 1636424552254, 1636424552345, 91, 0, 91, 0, 0, 0
2955, 1, 1636424552337, 1636424552429, 92, 1, 91, 0, 1, 1
2956, 1, 1636424552402, 1636424552493, 91, 0, 91, 0, 0, 0
2954, 1, 1636424552617, 1636424552710, 93, 1, 92, 1, 0, 1
2958, 1, 1636424553161, 1636424553254, 93, 1, 92, 0, 0, 0
2959, 1, 1636424553437, 1636424553529, 92, 1, 91, 1, 0, 1
2961, 1, 1636424553498, 1636424553590, 92, 0, 92, 0, 0, 0
2960, 1, 1636424553618, 1636424553709, 91, 0, 91, 0, 0, 0
2963, 1, 1636424554209, 1636424554294, 85, 0, 85, 0, 0, 0
2964, 1, 1636424554209, 1636424554302, 93, 0, 93, 0, 0, 0
2967, 1, 1636424554293, 1636424554386, 93, 1, 92, 0, 0, 0
2970, 1, 1636424554357, 1636424554450, 93, 1, 92, 1, 0, 1
2968, 1, 1636424554742, 1636424554838, 96, 0, 96, 0, 0, 0
2972, 1, 1636424555010, 1636424555101, 91, 0, 91, 0, 0, 0
2973, 1, 1636424555162, 1636424555250, 88, 0, 88, 0, 0, 0
2974, 1, 1636424555494, 1636424555585, 91, 0, 91, 0, 0, 0
2976, 1, 1636424555561, 1636424555653, 92, 1, 91, 0, 0, 0
2975, 1, 1636424555605, 1636424555698, 93, 1, 92, 0, 0, 0
2978, 1, 1636424556198, 1636424556289, 91, 0, 91, 0, 0, 0
2980, 1, 1636424556230, 1636424556325, 95, 0, 95, 0, 0, 0
2981, 1, 1636424556257, 1636424556350, 93, 1, 92, 1, 0, 1
2983, 1, 1636424556649, 1636424556742, 93, 1, 92, 0, 0, 0
2982, 1, 1636424556689, 1636424556782, 93, 1, 92, 0, 1, 1
2984, 1, 1636424556977, 1636424557065, 88, 0, 88, 0, 0, 0
2985, 1, 1636424557142, 1636424557233, 91, 0, 91, 0, 0, 0
2986, 1, 1636424557425, 1636424557509, 84, 0, 84, 0, 0, 0
2988, 1, 1636424557437, 1636424557525, 88, 1, 87, 0, 1, 1
2987, 1, 1636424557585, 1636424557673, 88, 1, 87, 0, 0, 0
2989, 1, 1636424558098, 1636424558190, 92, 0, 92, 0, 0, 0
2990, 1, 1636424558182, 1636424558273, 91, 0, 91, 0, 0, 0
2992, 1, 1636424558258, 1636424558349, 91, 0, 91, 0, 0, 0
2993, 1, 1636424558258, 1636424558349, 91, 0, 91, 0, 0, 0
2991, 1, 1636424558633, 1636424558725, 92, 1, 91, 0, 0, 0
2995, 1, 1636424559054, 1636424559145, 91, 0, 91, 0, 0, 0
2994, 1, 1636424559085, 1636424559177, 92, 1, 91, 0, 0, 0
2996, 1, 1636424559293, 1636424559389, 96, 0, 96, 0, 0, 0
2998, 1, 1636424559505, 1636424559598, 93, 1, 92, 0, 0, 0
2997, 1, 1636424559542, 1636424559633, 91, 0, 91, 0, 0, 0
2999, 1, 1636424560065, 1636424560158, 93, 1, 92, 0, 0, 0
3000, 1, 1636424560197, 1636424560289, 92, 1, 91, 0, 0, 0
3001, 1, 1636424560205, 1636424560301, 96, 1, 95, 0, 1, 1
3003, 1, 1636424560245, 1636424560333, 88, 0, 88, 0, 0, 0
3002, 1, 1636424560513, 1636424560606, 93, 1, 92, 0, 1, 1
3004, 1, 1636424560946, 1636424561042, 96, 0, 96, 0, 0, 0
3005, 1, 1636424561185, 1636424561277, 92, 1, 91, 0, 1, 1
2966, 1, 1636424561221, 1636424561313, 92, 0, 92, 0, 0, 0
3006, 1, 1636424561361, 1636424561445, 84, 0, 84, 0, 0, 0
3007, 1, 1636424561429, 1636424561521, 92, 0, 92, 0, 0, 0
3009, 1, 1636424561541, 1636424561634, 93, 1, 92, 0, 1, 1
3008, 1, 1636424561641, 1636424561738, 97, 1, 96, 0, 0, 0
3010, 1, 1636424561890, 1636424561982, 92, 0, 92, 0, 0, 0
3011, 1, 1636424562014, 1636424562117, 103, 0, 103, 0, 0, 0
3012, 1, 1636424562145, 1636424562238, 93, 1, 92, 0, 1, 1
3014, 1, 1636424562238, 1636424562373, 135, 0, 135, 0, 0, 0
3015, 1, 1636424562249, 1636424562377, 128, 1, 127, 0, 1, 1
3013, 1, 1636424562485, 1636424562577, 92, 1, 91, 0, 1, 1
3016, 1, 1636424562966, 1636424563058, 92, 0, 92, 0, 0, 0
3019, 1, 1636424563217, 1636424563309, 92, 1, 91, 0, 0, 0
3020, 1, 1636424563297, 1636424563389, 92, 1, 91, 1, 0, 1
3021, 1, 1636424563301, 1636424563397, 96, 1, 95, 0, 0, 0
3023, 1, 1636424563717, 1636424563809, 92, 1, 91, 0, 0, 0
3025, 1, 1636424564093, 1636424564182, 89, 1, 88, 0, 1, 1
3027, 1, 1636424564185, 1636424564270, 85, 0, 85, 0, 0, 0
3029, 1, 1636424564326, 1636424564417, 91, 0, 91, 0, 0, 0
3030, 1, 1636424564361, 1636424564457, 96, 1, 95, 0, 0, 0
3028, 1, 1636424564542, 1636424564634, 92, 0, 92, 0, 0, 0
3033, 1, 1636424564974, 1636424565070, 96, 0, 96, 0, 0, 0
3034, 1, 1636424565246, 1636424565342, 96, 0, 96, 0, 0, 0
3036, 1, 1636424565301, 1636424565394, 93, 0, 93, 0, 0, 0
3037, 1, 1636424565422, 1636424565538, 116, 0, 116, 0, 0, 0
2979, 1, 1636424565669, 1636424565762, 93, 1, 92, 1, 0, 1
3038, 1, 1636424565761, 1636424565858, 97, 1, 96, 1, 0, 1
3040, 1, 1636424566118, 1636424566209, 91, 0, 91, 0, 0, 0
3041, 1, 1636424566209, 1636424566302, 93, 1, 92, 1, 0, 1
3042, 1, 1636424566218, 1636424566310, 92, 0, 92, 0, 0, 0
3044, 1, 1636424566309, 1636424566402, 93, 1, 92, 0, 0, 0
3043, 1, 1636424566570, 1636424566661, 91, 0, 91, 0, 0, 0
3046, 1, 1636424567050, 1636424567142, 92, 0, 92, 0, 0, 0
3047, 1, 1636424567233, 1636424567326, 93, 1, 92, 0, 0, 0
3049, 1, 1636424567466, 1636424567557, 91, 0, 91, 0, 0, 0
3050, 1, 1636424567690, 1636424567782, 92, 0, 92, 0, 0, 0
3051, 1, 1636424568069, 1636424568162, 93, 1, 92, 0, 0, 0
3053, 1, 1636424568214, 1636424568306, 92, 0, 92, 0, 0, 0
3054, 1, 1636424568233, 1636424568321, 88, 0, 88, 0, 0, 0
3055, 1, 1636424568277, 1636424568366, 89, 0, 89, 0, 0, 0
3052, 1, 1636424568517, 1636424568610, 93, 1, 92, 0, 1, 1
3056, 1, 1636424568977, 1636424569070, 93, 1, 92, 0, 0, 0
3057, 1, 1636424569202, 1636424569294, 92, 0, 92, 0, 0, 0
3058, 1, 1636424569422, 1636424569513, 91, 0, 91, 0, 0, 0
3059, 1, 1636424569661, 1636424569754, 93, 1, 92, 0, 0, 0
3060, 1, 1636424570074, 1636424570162, 88, 0, 88, 0, 0, 0
3061, 1, 1636424570162, 1636424570253, 91, 0, 91, 0, 0, 0
3064, 1, 1636424570222, 1636424570313, 91, 0, 91, 0, 0, 0
3063, 1, 1636424570222, 1636424570314, 92, 0, 92, 0, 0, 0
3062, 1, 1636424570530, 1636424570622, 92, 0, 92, 0, 0, 0
3065, 1, 1636424570946, 1636424571038, 92, 0, 92, 0, 0, 0
3066, 1, 1636424571181, 1636424571274, 93, 1, 92, 0, 0, 0
3068, 1, 1636424571418, 1636424571510, 92, 0, 92, 0, 0, 0
3067, 1, 1636424571637, 1636424571730, 93, 1, 92, 0, 0, 0
3069, 1, 1636424572125, 1636424572217, 92, 1, 91, 0, 1, 1
3070, 1, 1636424572142, 1636424572234, 92, 0, 92, 0, 0, 0
3072, 1, 1636424572221, 1636424572313, 92, 0, 92, 0, 0, 0
3073, 1, 1636424572249, 1636424572342, 93, 1, 92, 1, 0, 1
3071, 1, 1636424572578, 1636424572670, 92, 0, 92, 0, 0, 0
3074, 1, 1636424572922, 1636424573014, 92, 0, 92, 0, 0, 0
3075, 1, 1636424573150, 1636424573242, 92, 0, 92, 0, 0, 0
3076, 1, 1636424573314, 1636424573406, 92, 0, 92, 0, 0, 0
3079, 1, 1636424573469, 1636424573562, 93, 1, 92, 0, 1, 1
3078, 1, 1636424573597, 1636424573690, 93, 1, 92, 0, 0, 0
3077, 1, 1636424573809, 1636424573902, 93, 1, 92, 0, 0, 0
3080, 1, 1636424573826, 1636424573918, 92, 0, 92, 0, 0, 0
3081, 1, 1636424574113, 1636424574201, 88, 0, 88, 0, 0, 0
3082, 1, 1636424574149, 1636424574237, 88, 0, 88, 0, 0, 0
3083, 1, 1636424574201, 1636424574289, 88, 0, 88, 0, 0, 0
3084, 1, 1636424574245, 1636424574337, 92, 1, 91, 0, 1, 1
3086, 1, 1636424574317, 1636424574413, 96, 1, 95, 0, 0, 0
3087, 1, 1636424574541, 1636424574634, 93, 1, 92, 0, 1, 1
3085, 1, 1636424574634, 1636424574726, 92, 0, 92, 0, 0, 0
3088, 1, 1636424574809, 1636424574901, 92, 1, 91, 1, 0, 1
3091, 1, 1636424575185, 1636424575278, 93, 1, 92, 0, 0, 0
3092, 1, 1636424575185, 1636424575278, 93, 1, 92, 0, 1, 1
3095, 1, 1636424575550, 1636424575642, 92, 0, 92, 0, 0, 0
3094, 1, 1636424575642, 1636424575734, 92, 0, 92, 0, 0, 0
3093, 1, 1636424575642, 1636424575734, 92, 1, 91, 0, 1, 1
3097, 1, 1636424575677, 1636424575766, 89, 0, 89, 0, 0, 0
3045, 1, 1636424575981, 1636424576073, 92, 1, 91, 0, 1, 1
3098, 1, 1636424576114, 1636424576205, 91, 0, 91, 0, 0, 0
3099, 1, 1636424576114, 1636424576206, 92, 0, 92, 0, 0, 0
3101, 1, 1636424576185, 1636424576277, 92, 0, 92, 0, 0, 0
3103, 1, 1636424576233, 1636424576322, 89, 0, 89, 0, 0, 0
3105, 1, 1636424576277, 1636424576369, 92, 0, 92, 0, 0, 0
3100, 1, 1636424576570, 1636424576662, 92, 0, 92, 0, 0, 0
3107, 1, 1636424576833, 1636424576925, 92, 0, 92, 0, 0, 0
3102, 1, 1636424577025, 1636424577125, 100, 1, 99, 0, 0, 0
3108, 1, 1636424577125, 1636424577217, 92, 1, 91, 0, 1, 1
3112, 1, 1636424577517, 1636424577610, 93, 0, 93, 0, 0, 0
3113, 1, 1636424577565, 1636424577657, 92, 1, 91, 1, 0, 1
3111, 1, 1636424577578, 1636424577670, 92, 0, 92, 0, 0, 0
3114, 1, 1636424577633, 1636424577721, 88, 0, 88, 0, 0, 0
3115, 1, 1636424578078, 1636424578169, 91, 0, 91, 0, 0, 0
3117, 1, 1636424578133, 1636424578221, 88, 1, 87, 0, 1, 1
3118, 1, 1636424578142, 1636424578234, 92, 0, 92, 0, 0, 0
3116, 1, 1636424578142, 1636424578234, 92, 0, 92, 0, 0, 0
3120, 1, 1636424578169, 1636424578265, 96, 1, 95, 0, 0, 0
3119, 1, 1636424578589, 1636424578677, 88, 1, 87, 0, 0, 0
3122, 1, 1636424578781, 1636424578878, 97, 1, 96, 0, 0, 0
3123, 1, 1636424579246, 1636424579342, 96, 0, 96, 0, 0, 0
3125, 1, 1636424579389, 1636424579481, 92, 0, 92, 0, 0, 0
3126, 1, 1636424579410, 1636424579502, 92, 0, 92, 0, 0, 0
3124, 1, 1636424579702, 1636424579793, 91, 0, 91, 0, 0, 0
3127, 1, 1636424579730, 1636424579822, 92, 0, 92, 0, 0, 0
3128, 1, 1636424580053, 1636424580149, 96, 1, 95, 1, 0, 1
3130, 1, 1636424580097, 1636424580185, 88, 0, 88, 0, 0, 0
3131, 1, 1636424580105, 1636424580189, 84, 0, 84, 0, 0, 0
3129, 1, 1636424580141, 1636424580233, 92, 0, 92, 0, 0, 0
3133, 1, 1636424580205, 1636424580298, 93, 1, 92, 0, 1, 1
3132, 1, 1636424580513, 1636424580606, 93, 1, 92, 1, 0, 1
3134, 1, 1636424580694, 1636424580786, 92, 0, 92, 0, 0, 0
3135, 1, 1636424580974, 1636424581066, 92, 0, 92, 0, 0, 0
3137, 1, 1636424581297, 1636424581389, 92, 1, 91, 0, 1, 1
3138, 1, 1636424581369, 1636424581462, 93, 1, 92, 0, 0, 0
3136, 1, 1636424581433, 1636424581525, 92, 1, 91, 1, 0, 1
3139, 1, 1636424581614, 1636424581705, 91, 0, 91, 0, 0, 0
3140, 1, 1636424582013, 1636424582105, 92, 1, 91, 1, 0, 1
3141, 1, 1636424582033, 1636424582126, 93, 1, 92, 0, 0, 0
3142, 1, 1636424582141, 1636424582233, 92, 1, 91, 0, 1, 1
3145, 1, 1636424582189, 1636424582281, 92, 1, 91, 0, 0, 0
3144, 1, 1636424582189, 1636424582281, 92, 1, 91, 0, 1, 1
3143, 1, 1636424582646, 1636424582737, 91, 0, 91, 0, 0, 0
3146, 1, 1636424582658, 1636424582754, 96, 0, 96, 0, 0, 0
3147, 1, 1636424582853, 1636424582946, 93, 1, 92, 1, 0, 1
3148, 1, 1636424583309, 1636424583401, 92, 1, 91, 0, 0, 0
3149, 1, 1636424583337, 1636424583430, 93, 1, 92, 0, 0, 0
3150, 1, 1636424583465, 1636424583558, 93, 1, 92, 0, 0, 0
3151, 1, 1636424583517, 1636424583605, 88, 0, 88, 0, 0, 0
3152, 1, 1636424583889, 1636424583982, 93, 1, 92, 0, 0, 0
3153, 1, 1636424584029, 1636424584118, 89, 0, 89, 0, 0, 0
3154, 1, 1636424584073, 1636424584161, 88, 0, 88, 0, 0, 0
3157, 1, 1636424584317, 1636424584410, 93, 1, 92, 0, 0, 0
3158, 1, 1636424584542, 1636424584633, 91, 0, 91, 0, 0, 0
3159, 1, 1636424584942, 1636424585034, 92, 0, 92, 0, 0, 0
3164, 1, 1636424585353, 1636424585489, 136, 1, 135, 0, 0, 0
3160, 1, 1636424585394, 1636424585493, 99, 0, 99, 0, 0, 0
3165, 1, 1636424585493, 1636424585586, 93, 1, 92, 0, 0, 0
3166, 1, 1636424585770, 1636424585862, 92, 0, 92, 0, 0, 0
3168, 1, 1636424585930, 1636424586022, 92, 0, 92, 0, 0, 0
3169, 1, 1636424585977, 1636424586069, 92, 0, 92, 0, 0, 0
3170, 1, 1636424586193, 1636424586286, 93, 1, 92, 0, 0, 0
3106, 1, 1636424586289, 1636424586381, 92, 1, 91, 0, 1, 1
3172, 1, 1636424586626, 1636424586717, 91, 0, 91, 0, 0, 0
3173, 1, 1636424586813, 1636424586905, 92, 1, 91, 0, 0, 0
3176, 1, 1636424587301, 1636424587393, 92, 1, 91, 0, 0, 0
3175, 1, 1636424587313, 1636424587405, 92, 0, 92, 0, 0, 0
3121, 1, 1636424587353, 1636424587438, 85, 0, 85, 0, 0, 0
3177, 1, 1636424587497, 1636424587585, 88, 1, 87, 0, 1, 1
3178, 1, 1636424587609, 1636424587701, 92, 1, 91, 1, 0, 1
3180, 1, 1636424587793, 1636424587886, 93, 1, 92, 0, 0, 0
3181, 1, 1636424587801, 1636424587893, 92, 1, 91, 0, 0, 0
3183, 1, 1636424588037, 1636424588129, 92, 1, 91, 1, 0, 1
3184, 1, 1636424588154, 1636424588246, 92, 0, 92, 0, 0, 0
3185, 1, 1636424588498, 1636424588593, 95, 0, 95, 0, 0, 0
3186, 1, 1636424588794, 1636424588890, 96, 0, 96, 0, 0, 0
3188, 1, 1636424589217, 1636424589309, 92, 1, 91, 0, 0, 0
3187, 1, 1636424589254, 1636424589346, 92, 0, 92, 0, 0, 0
3189, 1, 1636424589489, 1636424589574, 85, 0, 85, 0, 0, 0
3190, 1, 1636424589557, 1636424589645, 88, 0, 88, 0, 0, 0
3191, 1, 1636424589657, 1636424589745, 88, 0, 88, 0, 0, 0
3192, 1, 1636424589841, 1636424589938, 97, 1, 96, 0, 1, 1
3193, 1, 1636424590150, 1636424590242, 92, 0, 92, 0, 0, 0
3194, 1, 1636424590201, 1636424590293, 92, 1, 91, 0, 1, 1
3195, 1, 1636424590433, 1636424590526, 93, 0, 93, 0, 0, 0
3196, 1, 1636424590926, 1636424591018, 92, 0, 92, 0, 0, 0
3198, 1, 1636424591305, 1636424591397, 92, 1, 91, 0, 0, 0
3197, 1, 1636424591374, 1636424591465, 91, 0, 91, 0, 0, 0
3199, 1, 1636424591397, 1636424591485, 88, 1, 87, 0, 0, 0
3200, 1, 1636424591529, 1636424591613, 84, 0, 84, 0, 0, 0
3201, 1, 1636424591570, 1636424591661, 91, 0, 91, 0, 0, 0
3202, 1, 1636424591714, 1636424591810, 96, 0, 96, 0, 0, 0
3203, 1, 1636424592170, 1636424592261, 91, 0, 91, 0, 0, 0
3204, 1, 1636424592210, 1636424592301, 91, 0, 91, 0, 0, 0
3205, 1, 1636424592470, 1636424592562, 92, 0, 92, 0, 0, 0
3206, 1, 1636424592821, 1636424592913, 92, 1, 91, 1, 0, 1
3207, 1, 1636424593274, 1636424593366, 92, 0, 92, 0, 0, 0
3208, 1, 1636424593373, 1636424593466, 93, 1, 92, 1, 0, 1
3209, 1, 1636424593494, 1636424593582, 88, 0, 88, 0, 0, 0
3211, 1, 1636424593618, 1636424593709, 91, 0, 91, 0, 0, 0
3212, 1, 1636424593653, 1636424593746, 93, 1, 92, 0, 0, 0
3213, 1, 1636424594105, 1636424594198, 93, 1, 92, 0, 1, 1
3163, 1, 1636424594238, 1636424594326, 88, 0, 88, 0, 0, 0
3214, 1, 1636424594326, 1636424594417, 91, 0, 91, 0, 0, 0
3215, 1, 1636424594373, 1636424594461, 88, 0, 88, 0, 0, 0
3218, 1, 1636424594770, 1636424594862, 92, 0, 92, 0, 0, 0
3220, 1, 1636424595306, 1636424595398, 92, 0, 92, 0, 0, 0
3221, 1, 1636424595493, 1636424595586, 93, 1, 92, 0, 0, 0
3222, 1, 1636424595501, 1636424595594, 93, 1, 92, 0, 0, 0
3223, 1, 1636424595513, 1636424595609, 96, 1, 95, 0, 1, 1
3225, 1, 1636424595621, 1636424595709, 88, 0, 88, 0, 0, 0
3227, 1, 1636424596017, 1636424596113, 96, 1, 95, 0, 1, 1
3224, 1, 1636424596066, 1636424596158, 92, 0, 92, 0, 0, 0
3229, 1, 1636424596238, 1636424596330, 92, 0, 92, 0, 0, 0
3230, 1, 1636424596469, 1636424596561, 92, 1, 91, 0, 1, 1
3228, 1, 1636424596557, 1636424596649, 92, 1, 91, 0, 1, 1
3174, 1, 1636424596598, 1636424596685, 87, 0, 87, 0, 0, 0
3232, 1, 1636424597014, 1636424597106, 92, 0, 92, 0, 0, 0
3236, 1, 1636424597482, 1636424597569, 87, 0, 87, 0, 0, 0
3235, 1, 1636424597485, 1636424597578, 93, 1, 92, 0, 0, 0
3234, 1, 1636424597485, 1636424597578, 93, 1, 92, 0, 0, 0
3237, 1, 1636424597510, 1636424597601, 91, 0, 91, 0, 0, 0
3238, 1, 1636424597581, 1636424597666, 85, 0, 85, 0, 0, 0
3239, 1, 1636424598021, 1636424598113, 92, 1, 91, 0, 0, 0
3240, 1, 1636424598101, 1636424598193, 92, 1, 91, 0, 0, 0
3242, 1, 1636424598170, 1636424598261, 91, 0, 91, 0, 0, 0
3243, 1, 1636424598321, 1636424598414, 93, 1, 92, 0, 1, 1
3241, 1, 1636424598470, 1636424598562, 92, 0, 92, 0, 0, 0
3244, 1, 1636424598777, 1636424598870, 93, 1, 92, 0, 1, 1
3246, 1, 1636424598926, 1636424599018, 92, 0, 92, 0, 0, 0
3247, 1, 1636424599382, 1636424599473, 91, 0, 91, 0, 0, 0
3248, 1, 1636424599449, 1636424599538, 89, 1, 88, 0, 0, 0
3250, 1, 1636424599502, 1636424599593, 91, 0, 91, 0, 0, 0
3249, 1, 1636424599509, 1636424599597, 88, 1, 87, 0, 0, 0
3251, 1, 1636424599954, 1636424600049, 95, 0, 95, 0, 0, 0
3254, 1, 1636424600181, 1636424600273, 92, 1, 91, 0, 0, 0
3255, 1, 1636424600205, 1636424600297, 92, 1, 91, 1, 0, 1
3257, 1, 1636424600297, 1636424600390, 93, 1, 92, 0, 1, 1
3253, 1, 1636424600414, 1636424600506, 92, 0, 92, 0, 0, 0
3256, 1, 1636424600637, 1636424600730, 93, 1, 92, 1, 0, 1
3258, 1, 1636424600886, 1636424600978, 92, 0, 92, 0, 0, 0
3259, 1, 1636424601346, 1636424601437, 91, 0, 91, 0, 0, 0
3260, 1, 1636424601413, 1636424601501, 88, 0, 88, 0, 0, 0
3261, 1, 1636424601473, 1636424601566, 93, 1, 92, 0, 0, 0
3263, 1, 1636424601501, 1636424601593, 92, 1, 91, 0, 0, 0
3262, 1, 1636424601930, 1636424602021, 91, 0, 91, 0, 0, 0
3265, 1, 1636424602121, 1636424602213, 92, 1, 91, 0, 1, 1
3266, 1, 1636424602254, 1636424602346, 92, 0, 92, 0, 0, 0
3264, 1, 1636424602381, 1636424602474, 93, 1, 92, 0, 1, 1
3268, 1, 1636424602402, 1636424602494, 92, 0, 92, 0, 0, 0
3267, 1, 1636424602705, 1636424602801, 96, 1, 95, 0, 0, 0
3269, 1, 1636424602845, 1636424602937, 92, 1, 91, 0, 0, 0
3270, 1, 1636424603301, 1636424603393, 92, 1, 91, 0, 0, 0
3271, 1, 1636424603389, 1636424603482, 93, 0, 93, 0, 0, 0
3273, 1, 1636424603570, 1636424603662, 92, 0, 92, 0, 0, 0
3274, 1, 1636424603661, 1636424603753, 92, 1, 91, 0, 0, 0
3275, 1, 1636424603829, 1636424603921, 92, 1, 91, 1, 0, 1
3276, 1, 1636424604029, 1636424604121, 92, 1, 91, 0, 0, 0
3277, 1, 1636424604209, 1636424604301, 92, 1, 91, 0, 0, 0
3280, 1, 1636424604297, 1636424604410, 113, 1, 112, 0, 1, 1
3279, 1, 1636424604233, 1636424604413, 180, 1, 179, 1, 0, 1
3272, 1, 1636424604506, 1636424604597, 91, 0, 91, 0, 0, 0
3278, 1, 1636424604666, 1636424604790, 124, 0, 124, 0, 0, 0
3282, 1, 1636424604814, 1636424604906, 92, 0, 92, 0, 0, 0
3283, 1, 1636424604965, 1636424605049, 84, 0, 84, 0, 0, 0
3286, 1, 1636424605262, 1636424605354, 92, 0, 92, 0, 0, 0
3285, 1, 1636424605413, 1636424605506, 93, 1, 92, 0, 0, 0
3287, 1, 1636424605413, 1636424605506, 93, 1, 92, 1, 0, 1
3289, 1, 1636424605585, 1636424605682, 97, 1, 96, 0, 0, 0
3290, 1, 1636424605810, 1636424605902, 92, 0, 92, 0, 0, 0
3288, 1, 1636424605869, 1636424605961, 92, 1, 91, 0, 0, 0
3293, 1, 1636424606142, 1636424606237, 95, 0, 95, 0, 0, 0
3291, 1, 1636424606310, 1636424606397, 87, 0, 87, 0, 0, 0
3295, 1, 1636424606329, 1636424606417, 88, 0, 88, 0, 0, 0
3296, 1, 1636424606353, 1636424606450, 97, 1, 96, 0, 0, 0
3294, 1, 1636424606597, 1636424606717, 120, 0, 120, 0, 0, 0
3297, 1, 1636424606641, 1636424606733, 92, 1, 91, 0, 1, 1
3298, 1, 1636424606866, 1636424606957, 91, 0, 91, 0, 0, 0
3300, 1, 1636424607313, 1636424607402, 89, 1, 88, 1, 0, 1
3302, 1, 1636424607361, 1636424607454, 93, 1, 92, 0, 0, 0
3303, 1, 1636424607369, 1636424607458, 89, 0, 89, 0, 0, 0
3305, 1, 1636424607625, 1636424607714, 89, 0, 89, 0, 0, 0
3306, 1, 1636424607826, 1636424607918, 92, 0, 92, 0, 0, 0
3307, 1, 1636424607886, 1636424607977, 91, 0, 91, 0, 0, 0
3308, 1, 1636424608186, 1636424608285, 99, 0, 99, 0, 0, 0
3310, 1, 1636424608285, 1636424608377, 92, 1, 91, 0, 0, 0
3304, 1, 1636424608285, 1636424608378, 93, 1, 92, 0, 0, 0
3311, 1, 1636424608465, 1636424608558, 93, 1, 92, 0, 0, 0
3312, 1, 1636424608613, 1636424608705, 92, 1, 91, 1, 0, 1
3309, 1, 1636424608646, 1636424608737, 91, 0, 91, 0, 0, 0
3314, 1, 1636424608749, 1636424608842, 93, 1, 92, 0, 0, 0
3315, 1, 1636424609201, 1636424609294, 93, 1, 92, 0, 0, 0
3316, 1, 1636424609310, 1636424609402, 92, 0, 92, 0, 0, 0
3317, 1, 1636424609402, 1636424609493, 91, 0, 91, 0, 0, 0
3319, 1, 1636424609677, 1636424609770, 93, 1, 92, 0, 0, 0
3322, 1, 1636424609874, 1636424609965, 91, 0, 91, 0, 0, 0
3323, 1, 1636424610138, 1636424610229, 91, 0, 91, 0, 0, 0
3324, 1, 1636424610198, 1636424610289, 91, 0, 91, 0, 0, 0
3326, 1, 1636424610349, 1636424610442, 93, 1, 92, 0, 1, 1
3325, 1, 1636424610658, 1636424610749, 91, 0, 91, 0, 0, 0
3327, 1, 1636424610713, 1636424610806, 93, 1, 92, 0, 0, 0
3330, 1, 1636424611286, 1636424611378, 92, 0, 92, 0, 0, 0
3331, 1, 1636424611441, 1636424611534, 93, 1, 92, 0, 0, 0
3332, 1, 1636424611641, 1636424611730, 89, 0, 89, 0, 0, 0
3333, 1, 1636424611766, 1636424611857, 91, 0, 91, 0, 0, 0
3334, 1, 1636424612190, 1636424612281, 91, 0, 91, 0, 0, 0
3336, 1, 1636424612201, 1636424612293, 92, 0, 92, 0, 0, 0
3337, 1, 1636424612241, 1636424612329, 88, 0, 88, 0, 0, 0
3338, 1, 1636424612593, 1636424612685, 92, 0, 92, 0, 0, 0
3335, 1, 1636424612641, 1636424612730, 89, 0, 89, 0, 0, 0
3339, 1, 1636424613166, 1636424613258, 92, 0, 92, 0, 0, 0
3340, 1, 1636424613429, 1636424613522, 93, 1, 92, 0, 1, 1
3341, 1, 1636424613742, 1636424613834, 92, 0, 92, 0, 0, 0
3342, 1, 1636424613793, 1636424613885, 92, 1, 91, 0, 0, 0
3343, 1, 1636424614074, 1636424614166, 92, 0, 92, 0, 0, 0
3345, 1, 1636424614242, 1636424614334, 92, 0, 92, 0, 0, 0
3344, 1, 1636424614526, 1636424614618, 92, 0, 92, 0, 0, 0
3347, 1, 1636424614538, 1636424614629, 91, 0, 91, 0, 0, 0
3346, 1, 1636424614698, 1636424614789, 91, 0, 91, 0, 0, 0
3348, 1, 1636424615029, 1636424615122, 93, 1, 92, 0, 0, 0
3349, 1, 1636424615377, 1636424615470, 93, 0, 93, 0, 0, 0
3352, 1, 1636424615829, 1636424615922, 93, 1, 92, 0, 1, 1
3353, 1, 1636424615889, 1636424615981, 92, 1, 91, 0, 0, 0
3354, 1, 1636424616122, 1636424616214, 92, 0, 92, 0, 0, 0
3357, 1, 1636424616306, 1636424616397, 91, 0, 91, 0, 0, 0
3358, 1, 1636424616330, 1636424616422, 92, 0, 92, 0, 0, 0
3359, 1, 1636424616493, 1636424616585, 92, 1, 91, 0, 0, 0
3355, 1, 1636424616581, 1636424616673, 92, 1, 91, 0, 1, 1
3360, 1, 1636424617170, 1636424617266, 96, 0, 96, 0, 0, 0
3361, 1, 1636424617442, 1636424617534, 92, 0, 92, 0, 0, 0
3364, 1, 1636424617829, 1636424617922, 93, 1, 92, 1, 0, 1
3365, 1, 1636424617889, 1636424617981, 92, 1, 91, 0, 0, 0
3366, 1, 1636424618185, 1636424618278, 93, 1, 92, 0, 0, 0
3367, 1, 1636424618193, 1636424618285, 92, 1, 91, 0, 0, 0
3369, 1, 1636424618393, 1636424618486, 93, 0, 93, 0, 0, 0
3370, 1, 1636424618593, 1636424618681, 88, 0, 88, 0, 0, 0
3368, 1, 1636424618681, 1636424618769, 88, 0, 88, 0, 0, 0
3320, 1, 1636424618725, 1636424618814, 89, 0, 89, 0, 0, 0
3372, 1, 1636424619114, 1636424619206, 92, 0, 92, 0, 0, 0
3374, 1, 1636424619513, 1636424619606, 93, 1, 92, 0, 0, 0
3375, 1, 1636424619850, 1636424619942, 92, 0, 92, 0, 0, 0
3376, 1, 1636424619901, 1636424619993, 92, 0, 92, 0, 0, 0
3377, 1, 1636424620117, 1636424620209, 92, 1, 91, 0, 0, 0
3378, 1, 1636424620169, 1636424620265, 96, 1, 95, 0, 0, 0
3381, 1, 1636424620246, 1636424620338, 92, 0, 92, 0, 0, 0
3382, 1, 1636424620301, 1636424620394, 93, 1, 92, 0, 0, 0
3380, 1, 1636424620570, 1636424620661, 91, 0, 91, 0, 0, 0
3379, 1, 1636424620617, 1636424620737, 120, 0, 120, 0, 0, 0
3329, 1, 1636424620869, 1636424620957, 88, 1, 87, 0, 0, 0
3384, 1, 1636424621045, 1636424621133, 88, 1, 87, 0, 0, 0
3383, 1, 1636424621089, 1636424621177, 88, 0, 88, 0, 0, 0
3386, 1, 1636424621393, 1636424621486, 93, 1, 92, 1, 0, 1
3388, 1, 1636424621777, 1636424621870, 93, 1, 92, 0, 0, 0
3389, 1, 1636424621946, 1636424622037, 91, 0, 91, 0, 0, 0
3390, 1, 1636424622014, 1636424622106, 92, 0, 92, 0, 0, 0
3392, 1, 1636424622113, 1636424622206, 93, 1, 92, 0, 0, 0
3394, 1, 1636424622293, 1636424622385, 92, 1, 91, 0, 1, 1
3395, 1, 1636424622401, 1636424622498, 97, 1, 96, 0, 0, 0
3391, 1, 1636424622465, 1636424622557, 92, 0, 92, 0, 0, 0
3393, 1, 1636424622565, 1636424622657, 92, 1, 91, 0, 0, 0
3396, 1, 1636424622726, 1636424622817, 91, 0, 91, 0, 0, 0
3397, 1, 1636424623086, 1636424623178, 92, 0, 92, 0, 0, 0
3398, 1, 1636424623398, 1636424623490, 92, 0, 92, 0, 0, 0
3399, 1, 1636424623721, 1636424623809, 88, 0, 88, 0, 0, 0
3400, 1, 1636424623885, 1636424623969, 84, 0, 84, 0, 0, 0
3401, 1, 1636424623969, 1636424624061, 92, 1, 91, 0, 1, 1
3403, 1, 1636424624245, 1636424624341, 96, 0, 96, 0, 0, 0
3402, 1, 1636424624337, 1636424624429, 92, 1, 91, 0, 1, 1
3405, 1, 1636424624377, 1636424624465, 88, 0, 88, 0, 0, 0
3406, 1, 1636424624421, 1636424624506, 85, 0, 85, 0, 0, 0
3404, 1, 1636424624706, 1636424624798, 92, 0, 92, 0, 0, 0
3408, 1, 1636424624954, 1636424625045, 91, 0, 91, 0, 0, 0
3409, 1, 1636424625573, 1636424625665, 92, 1, 91, 0, 0, 0
3410, 1, 1636424625661, 1636424625749, 88, 0, 88, 0, 0, 0
3411, 1, 1636424625801, 1636424625893, 92, 1, 91, 0, 0, 0
3412, 1, 1636424625889, 1636424625981, 92, 1, 91, 0, 0, 0
3415, 1, 1636424626025, 1636424626117, 92, 1, 91, 0, 0, 0
3416, 1, 1636424626226, 1636424626318, 92, 0, 92, 0, 0, 0
3414, 1, 1636424626293, 1636424626385, 92, 1, 91, 0, 1, 1
3413, 1, 1636424626341, 1636424626429, 88, 0, 88, 0, 0, 0
3418, 1, 1636424626377, 1636424626470, 93, 1, 92, 0, 1, 1
3419, 1, 1636424626506, 1636424626598, 92, 0, 92, 0, 0, 0
3417, 1, 1636424626682, 1636424626773, 91, 0, 91, 0, 0, 0
3420, 1, 1636424626781, 1636424626873, 92, 1, 91, 0, 0, 0
3421, 1, 1636424626902, 1636424626994, 92, 0, 92, 0, 0, 0
3422, 1, 1636424627566, 1636424627658, 92, 0, 92, 0, 0, 0
3425, 1, 1636424627741, 1636424627829, 88, 0, 88, 0, 0, 0
3423, 1, 1636424627781, 1636424627873, 92, 1, 91, 0, 0, 0
3426, 1, 1636424627865, 1636424627958, 93, 1, 92, 0, 0, 0
3430, 1, 1636424628021, 1636424628113, 92, 1, 91, 0, 1, 1
3431, 1, 1636424628150, 1636424628241, 91, 0, 91, 0, 0, 0
3427, 1, 1636424628233, 1636424628326, 93, 1, 92, 0, 0, 0
3428, 1, 1636424628317, 1636424628410, 93, 1, 92, 0, 1, 1
3433, 1, 1636424628397, 1636424628490, 93, 1, 92, 0, 0, 0
3434, 1, 1636424628473, 1636424628565, 92, 1, 91, 0, 1, 1
3432, 1, 1636424628610, 1636424628701, 91, 0, 91, 0, 0, 0
3435, 1, 1636424628766, 1636424628902, 136, 0, 136, 0, 0, 0
3373, 1, 1636424629033, 1636424629126, 93, 0, 93, 0, 0, 0
3437, 1, 1636424629342, 1636424629434, 92, 0, 92, 0, 0, 0
3438, 1, 1636424629493, 1636424629586, 93, 1, 92, 0, 1, 1
3440, 1, 1636424629673, 1636424629765, 92, 1, 91, 1, 0, 1
3439, 1, 1636424629793, 1636424629885, 92, 1, 91, 0, 0, 0
3441, 1, 1636424629809, 1636424629901, 92, 1, 91, 0, 1, 1
3443, 1, 1636424629982, 1636424630074, 92, 0, 92, 0, 0, 0
3445, 1, 1636424630065, 1636424630158, 93, 0, 93, 0, 0, 0
3446, 1, 1636424630189, 1636424630281, 92, 0, 92, 0, 0, 0
3442, 1, 1636424630262, 1636424630353, 91, 0, 91, 0, 0, 0
3444, 1, 1636424630433, 1636424630526, 93, 1, 92, 0, 0, 0
3447, 1, 1636424630646, 1636424630738, 92, 0, 92, 0, 0, 0
3450, 1, 1636424630890, 1636424630982, 92, 0, 92, 0, 0, 0
3451, 1, 1636424631401, 1636424631498, 97, 1, 96, 0, 1, 1
3452, 1, 1636424631529, 1636424631617, 88, 0, 88, 0, 0, 0
3453, 1, 1636424631573, 1636424631665, 92, 0, 92, 0, 0, 0
3455, 1, 1636424631841, 1636424631934, 93, 1, 92, 0, 1, 1
3454, 1, 1636424631862, 1636424631953, 91, 0, 91, 0, 0, 0
3457, 1, 1636424631917, 1636424632009, 92, 1, 91, 1, 0, 1
3462, 1, 1636424632198, 1636424632290, 92, 0, 92, 0, 0, 0
3456, 1, 1636424632302, 1636424632394, 92, 0, 92, 0, 0, 0
3458, 1, 1636424632369, 1636424632462, 93, 0, 93, 0, 0, 0
3463, 1, 1636424632649, 1636424632742, 93, 1, 92, 1, 0, 1
3465, 1, 1636424633442, 1636424633534, 92, 0, 92, 0, 0, 0
3466, 1, 1636424633601, 1636424633689, 88, 1, 87, 0, 1, 1
3467, 1, 1636424633689, 1636424633778, 89, 1, 88, 0, 0, 0
3468, 1, 1636424633689, 1636424633778, 89, 1, 88, 1, 0, 1
3469, 1, 1636424633894, 1636424633986, 92, 0, 92, 0, 0, 0
3473, 1, 1636424634078, 1636424634170, 92, 0, 92, 0, 0, 0
3470, 1, 1636424634129, 1636424634213, 84, 0, 84, 0, 0, 0
3474, 1, 1636424634541, 1636424634633, 92, 1, 91, 0, 0, 0
3475, 1, 1636424634974, 1636424635066, 92, 0, 92, 0, 0, 0
3477, 1, 1636424635570, 1636424635661, 91, 0, 91, 0, 0, 0
3478, 1, 1636424635589, 1636424635685, 96, 1, 95, 0, 0, 0
3482, 1, 1636424636022, 1636424636114, 92, 0, 92, 0, 0, 0
3483, 1, 1636424636478, 1636424636570, 92, 0, 92, 0, 0, 0
3484, 1, 1636424636902, 1636424636993, 91, 0, 91, 0, 0, 0
3485, 1, 1636424637490, 1636424637606, 116, 0, 116, 0, 0, 0
3486, 1, 1636424637638, 1636424637729, 91, 0, 91, 0, 0, 0
3487, 1, 1636424637922, 1636424638014, 92, 0, 92, 0, 0, 0
3488, 1, 1636424638050, 1636424638142, 92, 0, 92, 0, 0, 0
3489, 1, 1636424638377, 1636424638466, 89, 0, 89, 0, 0, 0
3490, 1, 1636424638506, 1636424638598, 92, 0, 92, 0, 0, 0
3491, 1, 1636424639049, 1636424639138, 89, 1, 88, 0, 0, 0
3492, 1, 1636424639217, 1636424639310, 93, 1, 92, 0, 1, 1
3493, 1, 1636424639441, 1636424639534, 93, 1, 92, 0, 0, 0
3494, 1, 1636424639753, 1636424639837, 84, 0, 84, 0, 0, 0
3495, 1, 1636424639841, 1636424639929, 88, 0, 88, 0, 0, 0
3496, 1, 1636424639878, 1636424639970, 92, 0, 92, 0, 0, 0
3498, 1, 1636424640369, 1636424640458, 89, 0, 89, 0, 0, 0
3497, 1, 1636424640369, 1636424640461, 92, 0, 92, 0, 0, 0
3461, 1, 1636424640505, 1636424640597, 92, 1, 91, 0, 0, 0
3500, 1, 1636424640830, 1636424640922, 92, 0, 92, 0, 0, 0
3499, 1, 1636424640830, 1636424640922, 92, 0, 92, 0, 0, 0
3501, 1, 1636424640941, 1636424641030, 89, 0, 89, 0, 0, 0
3502, 1, 1636424641077, 1636424641166, 89, 0, 89, 0, 0, 0
3503, 1, 1636424641286, 1636424641378, 92, 0, 92, 0, 0, 0
3504, 1, 1636424641425, 1636424641517, 92, 1, 91, 0, 0, 0
3505, 1, 1636424641721, 1636424641813, 92, 0, 92, 0, 0, 0
3506, 1, 1636424641821, 1636424641910, 89, 0, 89, 0, 0, 0
3507, 1, 1636424641829, 1636424641921, 92, 0, 92, 0, 0, 0
3509, 1, 1636424642270, 1636424642361, 91, 0, 91, 0, 0, 0
3508, 1, 1636424642285, 1636424642377, 92, 1, 91, 0, 0, 0
3510, 1, 1636424642638, 1636424642729, 91, 0, 91, 0, 0, 0
3512, 1, 1636424642673, 1636424642765, 92, 1, 91, 0, 1, 1
3513, 1, 1636424642725, 1636424642826, 101, 1, 100, 0, 0, 0
3514, 1, 1636424642825, 1636424642917, 92, 1, 91, 1, 0, 1
3517, 1, 1636424643125, 1636424643218, 93, 1, 92, 0, 0, 0
3516, 1, 1636424643186, 1636424643278, 92, 0, 92, 0, 0, 0
3518, 1, 1636424643386, 1636424643478, 92, 0, 92, 0, 0, 0
3519, 1, 1636424643693, 1636424643789, 96, 1, 95, 0, 0, 0
3521, 1, 1636424643837, 1636424643950, 113, 1, 112, 0, 0, 0
3520, 1, 1636424643781, 1636424643950, 169, 0, 169, 0, 0, 0
3523, 1, 1636424644150, 1636424644242, 92, 0, 92, 0, 0, 0
3522, 1, 1636424644310, 1636424644402, 92, 0, 92, 0, 0, 0
3526, 1, 1636424644506, 1636424644597, 91, 0, 91, 0, 0, 0
3527, 1, 1636424644585, 1636424644681, 96, 1, 95, 1, 0, 1
3528, 1, 1636424644597, 1636424644685, 88, 0, 88, 0, 0, 0
3529, 1, 1636424645041, 1636424645134, 93, 1, 92, 0, 0, 0
3530, 1, 1636424645046, 1636424645137, 91, 0, 91, 0, 0, 0
3531, 1, 1636424645137, 1636424645225, 88, 1, 87, 0, 0, 0
3532, 1, 1636424645362, 1636424645453, 91, 0, 91, 0, 0, 0
3481, 1, 1636424645601, 1636424645689, 88, 1, 87, 0, 1, 1
3533, 1, 1636424645601, 1636424645693, 92, 1, 91, 0, 1, 1
3480, 1, 1636424645637, 1636424645729, 92, 1, 91, 0, 0, 0
3536, 1, 1636424645909, 1636424646002, 93, 1, 92, 0, 0, 0
3535, 1, 1636424645934, 1636424646026, 92, 0, 92, 0, 0, 0
3537, 1, 1636424645937, 1636424646029, 92, 1, 91, 0, 0, 0
3539, 1, 1636424646109, 1636424646202, 93, 1, 92, 0, 1, 1
3538, 1, 1636424646362, 1636424646453, 91, 0, 91, 0, 0, 0
3541, 1, 1636424646385, 1636424646482, 97, 1, 96, 0, 0, 0
3542, 1, 1636424646465, 1636424646557, 92, 1, 91, 0, 1, 1
3543, 1, 1636424646513, 1636424646601, 88, 0, 88, 0, 0, 0
3544, 1, 1636424646537, 1636424646629, 92, 1, 91, 1, 0, 1
3545, 1, 1636424646950, 1636424647041, 91, 0, 91, 0, 0, 0
3546, 1, 1636424646990, 1636424647081, 91, 0, 91, 0, 0, 0
3548, 1, 1636424647462, 1636424647554, 92, 0, 92, 0, 0, 0
3549, 1, 1636424647634, 1636424647725, 91, 0, 91, 0, 0, 0
3551, 1, 1636424647921, 1636424648014, 93, 1, 92, 0, 0, 0
3552, 1, 1636424647933, 1636424648025, 92, 1, 91, 0, 0, 0
3554, 1, 1636424648201, 1636424648294, 93, 0, 93, 0, 0, 0
3555, 1, 1636424648378, 1636424648469, 91, 0, 91, 0, 0, 0
3556, 1, 1636424648441, 1636424648529, 88, 0, 88, 0, 0, 0
3557, 1, 1636424648457, 1636424648542, 85, 0, 85, 0, 0, 0
3558, 1, 1636424648553, 1636424648646, 93, 1, 92, 0, 0, 0
3559, 1, 1636424648950, 1636424649041, 91, 0, 91, 0, 0, 0
3560, 1, 1636424648977, 1636424649070, 93, 1, 92, 0, 0, 0
3562, 1, 1636424649502, 1636424649594, 92, 0, 92, 0, 0, 0
3563, 1, 1636424649953, 1636424650045, 92, 1, 91, 0, 0, 0
3564, 1, 1636424649994, 1636424650086, 92, 0, 92, 0, 0, 0
3565, 1, 1636424650062, 1636424650154, 92, 0, 92, 0, 0, 0
3566, 1, 1636424650353, 1636424650445, 92, 1, 91, 0, 1, 1
3567, 1, 1636424650449, 1636424650538, 89, 0, 89, 0, 0, 0
3568, 1, 1636424650502, 1636424650594, 92, 0, 92, 0, 0, 0
3569, 1, 1636424650617, 1636424650709, 92, 1, 91, 0, 0, 0
3570, 1, 1636424650934, 1636424651026, 92, 0, 92, 0, 0, 0
3571, 1, 1636424651022, 1636424651114, 92, 0, 92, 0, 0, 0
3572, 1, 1636424651374, 1636424651465, 91, 0, 91, 0, 0, 0
3573, 1, 1636424651877, 1636424651970, 93, 1, 92, 1, 0, 1
3574, 1, 1636424651877, 1636424651970, 93, 1, 92, 0, 0, 0
3575, 1, 1636424651942, 1636424652033, 91, 0, 91, 0, 0, 0
3576, 1, 1636424652362, 1636424652497, 135, 0, 135, 0, 0, 0
3577, 1, 1636424652421, 1636424652513, 92, 1, 91, 0, 1, 1
3578, 1, 1636424652426, 1636424652521, 95, 0, 95, 0, 0, 0
3579, 1, 1636424652674, 1636424652765, 91, 0, 91, 0, 0, 0
3581, 1, 1636424653037, 1636424653126, 89, 0, 89, 0, 0, 0
3580, 1, 1636424653037, 1636424653129, 92, 0, 92, 0, 0, 0
3584, 1, 1636424653410, 1636424653502, 92, 0, 92, 0, 0, 0
3585, 1, 1636424653893, 1636424653985, 92, 1, 91, 0, 1, 1
3586, 1, 1636424653929, 1636424654018, 89, 0, 89, 0, 0, 0
3587, 1, 1636424654065, 1636424654158, 93, 1, 92, 0, 1, 1
3588, 1, 1636424654442, 1636424654533, 91, 0, 91, 0, 0, 0
3590, 1, 1636424654450, 1636424654541, 91, 0, 91, 0, 0, 0
3589, 1, 1636424654450, 1636424654541, 91, 0, 91, 0, 0, 0
3594, 1, 1636424655001, 1636424655090, 89, 0, 89, 0, 0, 0
3595, 1, 1636424655062, 1636424655154, 92, 0, 92, 0, 0, 0
3596, 1, 1636424655282, 1636424655374, 92, 0, 92, 0, 0, 0
3597, 1, 1636424655953, 1636424656041, 88, 1, 87, 0, 0, 0
3598, 1, 1636424655997, 1636424656085, 88, 0, 88, 0, 0, 0
3599, 1, 1636424656041, 1636424656141, 100, 0, 100, 0, 0, 0
3601, 1, 1636424656322, 1636424656413, 91, 0, 91, 0, 0, 0
3602, 1, 1636424656322, 1636424656413, 91, 0, 91, 0, 0, 0
3603, 1, 1636424656413, 1636424656506, 93, 0, 93, 0, 0, 0
3605, 1, 1636424657041, 1636424657129, 88, 0, 88, 0, 0, 0
3606, 1, 1636424657174, 1636424657266, 92, 0, 92, 0, 0, 0
3607, 1, 1636424657221, 1636424657313, 92, 0, 92, 0, 0, 0
3609, 1, 1636424657865, 1636424657957, 92, 0, 92, 0, 0, 0
3610, 1, 1636424657894, 1636424657986, 92, 0, 92, 0, 0, 0
3561, 1, 1636424657997, 1636424658089, 92, 1, 91, 0, 1, 1
3611, 1, 1636424658045, 1636424658133, 88, 0, 88, 0, 0, 0
3613, 1, 1636424658185, 1636424658277, 92, 1, 91, 0, 0, 0
3614, 1, 1636424658242, 1636424658329, 87, 0, 87, 0, 0, 0
3616, 1, 1636424658354, 1636424658446, 92, 0, 92, 0, 0, 0
3618, 1, 1636424658982, 1636424659073, 91, 0, 91, 0, 0, 0
3619, 1, 1636424659065, 1636424659158, 93, 1, 92, 0, 1, 1
3621, 1, 1636424659802, 1636424659894, 92, 0, 92, 0, 0, 0
3623, 1, 1636424660089, 1636424660181, 92, 1, 91, 0, 0, 0
3624, 1, 1636424660222, 1636424660313, 91, 0, 91, 0, 0, 0
3625, 1, 1636424660229, 1636424660321, 92, 1, 91, 0, 0, 0
3626, 1, 1636424660269, 1636424660357, 88, 0, 88, 0, 0, 0
3627, 1, 1636424661022, 1636424661113, 91, 0, 91, 0, 0, 0
3628, 1, 1636424661154, 1636424661245, 91, 0, 91, 0, 0, 0
3629, 1, 1636424661909, 1636424661998, 89, 0, 89, 0, 0, 0
3630, 1, 1636424662217, 1636424662305, 88, 0, 88, 0, 0, 0
3631, 1, 1636424662261, 1636424662349, 88, 0, 88, 0, 0, 0
3632, 1, 1636424662282, 1636424662373, 91, 0, 91, 0, 0, 0
3633, 1, 1636424662377, 1636424662469, 92, 1, 91, 0, 0, 0
3634, 1, 1636424663082, 1636424663173, 91, 0, 91, 0, 0, 0
3635, 1, 1636424663306, 1636424663398, 92, 0, 92, 0, 0, 0
3637, 1, 1636424663709, 1636424663802, 93, 1, 92, 0, 1, 1
3638, 1, 1636424663986, 1636424664078, 92, 0, 92, 0, 0, 0
3636, 1, 1636424664165, 1636424664257, 92, 1, 91, 0, 0, 0
3641, 1, 1636424664369, 1636424664461, 92, 1, 91, 1, 0, 1
3642, 1, 1636424664453, 1636424664610, 157, 1, 156, 1, 0, 1
3644, 1, 1636424665001, 1636424665093, 92, 0, 92, 0, 0, 0
3646, 1, 1636424665010, 1636424665102, 92, 0, 92, 0, 0, 0
3647, 1, 1636424665381, 1636424665474, 93, 1, 92, 1, 0, 1
3645, 1, 1636424665458, 1636424665553, 95, 0, 95, 0, 0, 0
3648, 1, 1636424665626, 1636424665718, 92, 0, 92, 0, 0, 0
3650, 1, 1636424665950, 1636424666089, 139, 0, 139, 0, 0, 0
3649, 1, 1636424666089, 1636424666178, 89, 0, 89, 0, 0, 0
3652, 1, 1636424666454, 1636424666546, 92, 0, 92, 0, 0, 0
3654, 1, 1636424666909, 1636424666998, 89, 0, 89, 0, 0, 0
3655, 1, 1636424666953, 1636424667045, 92, 1, 91, 0, 0, 0
3657, 1, 1636424667402, 1636424667494, 92, 0, 92, 0, 0, 0
3658, 1, 1636424667478, 1636424667570, 92, 0, 92, 0, 0, 0
3660, 1, 1636424667726, 1636424667818, 92, 0, 92, 0, 0, 0
3662, 1, 1636424667882, 1636424667974, 92, 0, 92, 0, 0, 0
3661, 1, 1636424668182, 1636424668273, 91, 0, 91, 0, 0, 0
3617, 1, 1636424668309, 1636424668401, 92, 1, 91, 1, 0, 1
3663, 1, 1636424668401, 1636424668494, 93, 1, 92, 0, 0, 0
3666, 1, 1636424668918, 1636424669009, 91, 0, 91, 0, 0, 0
3668, 1, 1636424669042, 1636424669134, 92, 0, 92, 0, 0, 0
3670, 1, 1636424669426, 1636424669518, 92, 0, 92, 0, 0, 0
3669, 1, 1636424669501, 1636424669593, 92, 1, 91, 0, 0, 0
3671, 1, 1636424669553, 1636424669645, 92, 1, 91, 0, 0, 0
3672, 1, 1636424669773, 1636424669866, 93, 1, 92, 0, 0, 0
3673, 1, 1636424669849, 1636424669942, 93, 0, 93, 0, 0, 0
3675, 1, 1636424670277, 1636424670369, 92, 1, 91, 0, 1, 1
3676, 1, 1636424670293, 1636424670389, 96, 1, 95, 0, 1, 1
3674, 1, 1636424670301, 1636424670397, 96, 1, 95, 0, 0, 0
3677, 1, 1636424671017, 1636424671109, 92, 1, 91, 0, 0, 0
3678, 1, 1636424671054, 1636424671146, 92, 0, 92, 0, 0, 0
3680, 1, 1636424671378, 1636424671470, 92, 0, 92, 0, 0, 0
3679, 1, 1636424671510, 1636424671601, 91, 0, 91, 0, 0, 0
3681, 1, 1636424671557, 1636424671646, 89, 0, 89, 0, 0, 0
3682, 1, 1636424671754, 1636424671846, 92, 0, 92, 0, 0, 0
3684, 1, 1636424671825, 1636424671921, 96, 0, 96, 0, 0, 0
3686, 1, 1636424672214, 1636424672306, 92, 0, 92, 0, 0, 0
3688, 1, 1636424673026, 1636424673118, 92, 0, 92, 0, 0, 0
3690, 1, 1636424673334, 1636424673426, 92, 0, 92, 0, 0, 0
3691, 1, 1636424673658, 1636424673750, 92, 0, 92, 0, 0, 0
3692, 1, 1636424673689, 1636424673781, 92, 1, 91, 0, 1, 1
3695, 1, 1636424674486, 1636424674578, 92, 0, 92, 0, 0, 0
3696, 1, 1636424674526, 1636424674618, 92, 0, 92, 0, 0, 0
3698, 1, 1636424675258, 1636424675354, 96, 0, 96, 0, 0, 0
3699, 1, 1636424675430, 1636424675521, 91, 0, 91, 0, 0, 0
3700, 1, 1636424675614, 1636424675705, 91, 0, 91, 0, 0, 0
3701, 1, 1636424675746, 1636424675838, 92, 0, 92, 0, 0, 0
3702, 1, 1636424676490, 1636424676578, 88, 0, 88, 0, 0, 0
3704, 1, 1636424676578, 1636424676670, 92, 0, 92, 0, 0, 0
3703, 1, 1636424676578, 1636424676670, 92, 0, 92, 0, 0, 0
3705, 1, 1636424677254, 1636424677345, 91, 0, 91, 0, 0, 0
3706, 1, 1636424677313, 1636424677405, 92, 1, 91, 0, 1, 1
3709, 1, 1636424677661, 1636424677753, 92, 0, 92, 0, 0, 0
3707, 1, 1636424677669, 1636424677761, 92, 1, 91, 0, 0, 0
3708, 1, 1636424677669, 1636424677761, 92, 1, 91, 0, 0, 0
3710, 1, 1636424678121, 1636424678214, 93, 1, 92, 1, 0, 1
3711, 1, 1636424678121, 1636424678214, 93, 1, 92, 0, 1, 1
3712, 1, 1636424678481, 1636424678573, 92, 1, 91, 0, 0, 0
3714, 1, 1636424678573, 1636424678662, 89, 0, 89, 0, 0, 0
3713, 1, 1636424678569, 1636424678662, 93, 1, 92, 0, 1, 1
3667, 1, 1636424678613, 1636424678702, 89, 0, 89, 0, 0, 0
3715, 1, 1636424678797, 1636424678890, 93, 1, 92, 0, 0, 0
3719, 1, 1636424679289, 1636424679382, 93, 1, 92, 0, 1, 1
3720, 1, 1636424679458, 1636424679545, 87, 0, 87, 0, 0, 0
3721, 1, 1636424679545, 1636424679638, 93, 1, 92, 0, 0, 0
3722, 1, 1636424679545, 1636424679638, 93, 1, 92, 1, 0, 1
3724, 1, 1636424679902, 1636424679993, 91, 0, 91, 0, 0, 0
3723, 1, 1636424679993, 1636424680082, 89, 0, 89, 0, 0, 0
3725, 1, 1636424680557, 1636424680650, 93, 1, 92, 0, 0, 0
3726, 1, 1636424680581, 1636424680674, 93, 1, 92, 0, 1, 1
3727, 1, 1636424680590, 1636424680681, 91, 0, 91, 0, 0, 0
3728, 1, 1636424680609, 1636424680701, 92, 0, 92, 0, 0, 0
3729, 1, 1636424681282, 1636424681374, 92, 0, 92, 0, 0, 0
3730, 1, 1636424681425, 1636424681518, 93, 1, 92, 0, 0, 0
3731, 1, 1636424681542, 1636424681641, 99, 0, 99, 0, 0, 0
3732, 1, 1636424681590, 1636424681682, 92, 0, 92, 0, 0, 0
3734, 1, 1636424681989, 1636424682082, 93, 1, 92, 0, 0, 0
3733, 1, 1636424682058, 1636424682146, 88, 0, 88, 0, 0, 0
3735, 1, 1636424682426, 1636424682518, 92, 0, 92, 0, 0, 0
3736, 1, 1636424682589, 1636424682677, 88, 1, 87, 1, 0, 1
3737, 1, 1636424682589, 1636424682678, 89, 1, 88, 0, 1, 1
3738, 1, 1636424682610, 1636424682701, 91, 0, 91, 0, 0, 0
3739, 1, 1636424682637, 1636424682729, 92, 0, 92, 0, 0, 0
3740, 1, 1636424682677, 1636424682766, 89, 1, 88, 0, 0, 0
3741, 1, 1636424683286, 1636424683378, 92, 0, 92, 0, 0, 0
3742, 1, 1636424683306, 1636424683398, 92, 0, 92, 0, 0, 0
3743, 1, 1636424683333, 1636424683421, 88, 0, 88, 0, 0, 0
3745, 1, 1636424683613, 1636424683706, 93, 1, 92, 0, 0, 0
3746, 1, 1636424683670, 1636424683761, 91, 0, 91, 0, 0, 0
3744, 1, 1636424683733, 1636424683825, 92, 1, 91, 1, 0, 1
3748, 1, 1636424684045, 1636424684137, 92, 1, 91, 0, 0, 0
3749, 1, 1636424684065, 1636424684157, 92, 1, 91, 1, 0, 1
3697, 1, 1636424684093, 1636424684181, 88, 0, 88, 0, 0, 0
3747, 1, 1636424684117, 1636424684205, 88, 1, 87, 0, 1, 1
3752, 1, 1636424684438, 1636424684534, 96, 0, 96, 0, 0, 0
3753, 1, 1636424684450, 1636424684549, 99, 0, 99, 0, 0, 0
3750, 1, 1636424684497, 1636424684590, 93, 1, 92, 0, 0, 0
3754, 1, 1636424684653, 1636424684745, 92, 1, 91, 0, 0, 0
3755, 1, 1636424684673, 1636424684766, 93, 1, 92, 0, 0, 0
3756, 1, 1636424684757, 1636424684849, 92, 1, 91, 0, 1, 1
3757, 1, 1636424684797, 1636424684890, 93, 1, 92, 0, 0, 0
3760, 1, 1636424685366, 1636424685458, 92, 0, 92, 0, 0, 0
3761, 1, 1636424685417, 1636424685509, 92, 1, 91, 0, 1, 1
3762, 1, 1636424685517, 1636424685610, 93, 1, 92, 0, 1, 1
3763, 1, 1636424685649, 1636424685742, 93, 1, 92, 1, 0, 1
3765, 1, 1636424685910, 1636424686001, 91, 0, 91, 0, 0, 0
3764, 1, 1636424685969, 1636424686061, 92, 1, 91, 0, 1, 1
3766, 1, 1636424686106, 1636424686198, 92, 0, 92, 0, 0, 0
3768, 1, 1636424686333, 1636424686425, 92, 1, 91, 1, 0, 1
3767, 1, 1636424686366, 1636424686458, 92, 0, 92, 0, 0, 0
3769, 1, 1636424686505, 1636424686598, 93, 1, 92, 0, 1, 1
3772, 1, 1636424686689, 1636424686782, 93, 1, 92, 1, 0, 1
3773, 1, 1636424686829, 1636424686922, 93, 1, 92, 0, 0, 0
3775, 1, 1636424687393, 1636424687477, 84, 0, 84, 0, 0, 0
3776, 1, 1636424687533, 1636424687622, 89, 0, 89, 0, 0, 0
3779, 1, 1636424687958, 1636424688049, 91, 0, 91, 0, 0, 0
3778, 1, 1636424687985, 1636424688069, 84, 0, 84, 0, 0, 0
3781, 1, 1636424688413, 1636424688506, 93, 1, 92, 0, 0, 0
3782, 1, 1636424688465, 1636424688557, 92, 0, 92, 0, 0, 0
3783, 1, 1636424688509, 1636424688602, 93, 1, 92, 0, 0, 0
3786, 1, 1636424689341, 1636424689434, 93, 1, 92, 0, 1, 1
3789, 1, 1636424689561, 1636424689654, 93, 1, 92, 1, 0, 1
3790, 1, 1636424689669, 1636424689762, 93, 1, 92, 1, 0, 1
3792, 1, 1636424689966, 1636424690058, 92, 0, 92, 0, 0, 0
3791, 1, 1636424690125, 1636424690217, 92, 1, 91, 0, 1, 1
3793, 1, 1636424690418, 1636424690510, 92, 0, 92, 0, 0, 0
3795, 1, 1636424690541, 1636424690634, 93, 0, 93, 0, 0, 0
3796, 1, 1636424691402, 1636424691494, 92, 0, 92, 0, 0, 0
3797, 1, 1636424691469, 1636424691561, 92, 1, 91, 0, 1, 1
3798, 1, 1636424691650, 1636424691742, 92, 0, 92, 0, 0, 0
3799, 1, 1636424692106, 1636424692198, 92, 0, 92, 0, 0, 0
3802, 1, 1636424692506, 1636424692598, 92, 0, 92, 0, 0, 0
3803, 1, 1636424693366, 1636424693457, 91, 0, 91, 0, 0, 0
3804, 1, 1636424693445, 1636424693538, 93, 1, 92, 0, 0, 0
3805, 1, 1636424693678, 1636424693773, 95, 0, 95, 0, 0, 0
3806, 1, 1636424694134, 1636424694226, 92, 0, 92, 0, 0, 0
3807, 1, 1636424694398, 1636424694490, 92, 0, 92, 0, 0, 0
3808, 1, 1636424694718, 1636424694810, 92, 0, 92, 0, 0, 0
3809, 1, 1636424695302, 1636424695394, 92, 0, 92, 0, 0, 0
3810, 1, 1636424695466, 1636424695557, 91, 0, 91, 0, 0, 0
3812, 1, 1636424695569, 1636424695657, 88, 0, 88, 0, 0, 0
3813, 1, 1636424695601, 1636424695693, 92, 1, 91, 0, 0, 0
3811, 1, 1636424695922, 1636424696014, 92, 0, 92, 0, 0, 0
3814, 1, 1636424696049, 1636424696142, 93, 0, 93, 0, 0, 0
3815, 1, 1636424696334, 1636424696426, 92, 0, 92, 0, 0, 0
3816, 1, 1636424696766, 1636424696858, 92, 0, 92, 0, 0, 0
3817, 1, 1636424696986, 1636424697077, 91, 0, 91, 0, 0, 0
3818, 1, 1636424696989, 1636424697090, 101, 0, 101, 0, 0, 0
3819, 1, 1636424697234, 1636424697325, 91, 0, 91, 0, 0, 0
3820, 1, 1636424697505, 1636424697598, 93, 1, 92, 0, 1, 1
3822, 1, 1636424697598, 1636424697689, 91, 0, 91, 0, 0, 0
3824, 1, 1636424697686, 1636424697777, 91, 0, 91, 0, 0, 0
3826, 1, 1636424697946, 1636424698037, 91, 0, 91, 0, 0, 0
3821, 1, 1636424697957, 1636424698049, 92, 1, 91, 0, 1, 1
3828, 1, 1636424698309, 1636424698437, 128, 0, 128, 0, 0, 0
3827, 1, 1636424698437, 1636424698525, 88, 1, 87, 0, 1, 1
3829, 1, 1636424698734, 1636424698826, 92, 0, 92, 0, 0, 0
3831, 1, 1636424698945, 1636424699033, 88, 1, 87, 1, 0, 1
3832, 1, 1636424699026, 1636424699117, 91, 0, 91, 0, 0, 0
3833, 1, 1636424699077, 1636424699165, 88, 1, 87, 0, 1, 1
3834, 1, 1636424699273, 1636424699366, 93, 0, 93, 0, 0, 0
3835, 1, 1636424699569, 1636424699661, 92, 1, 91, 0, 0, 0
3836, 1, 1636424699569, 1636424699661, 92, 1, 91, 0, 0, 0
3838, 1, 1636424699701, 1636424699794, 93, 1, 92, 0, 0, 0
3837, 1, 1636424700021, 1636424700109, 88, 0, 88, 0, 0, 0
3839, 1, 1636424700021, 1636424700109, 88, 0, 88, 0, 0, 0
3841, 1, 1636424700241, 1636424700333, 92, 1, 91, 1, 0, 1
3842, 1, 1636424700317, 1636424700410, 93, 1, 92, 0, 0, 0
3840, 1, 1636424700485, 1636424700578, 93, 1, 92, 0, 0, 0
3843, 1, 1636424700766, 1636424700858, 92, 0, 92, 0, 0, 0
3846, 1, 1636424700945, 1636424701033, 88, 0, 88, 0, 0, 0
3847, 1, 1636424701057, 1636424701150, 93, 0, 93, 0, 0, 0
3848, 1, 1636424701077, 1636424701169, 92, 1, 91, 0, 0, 0
3845, 1, 1636424701213, 1636424701302, 89, 0, 89, 0, 0, 0
3851, 1, 1636424701550, 1636424701642, 92, 0, 92, 0, 0, 0
3853, 1, 1636424701674, 1636424701762, 88, 0, 88, 0, 0, 0
3854, 1, 1636424701993, 1636424702089, 96, 1, 95, 0, 0, 0
3801, 1, 1636424702041, 1636424702129, 88, 0, 88, 0, 0, 0
3856, 1, 1636424702253, 1636424702345, 92, 1, 91, 1, 0, 1
3857, 1, 1636424702294, 1636424702385, 91, 0, 91, 0, 0, 0
3858, 1, 1636424702341, 1636424702430, 89, 0, 89, 0, 0, 0
3855, 1, 1636424702441, 1636424702534, 93, 0, 93, 0, 0, 0
3859, 1, 1636424702750, 1636424702841, 91, 0, 91, 0, 0, 0
3860, 1, 1636424702786, 1636424702877, 91, 0, 91, 0, 0, 0
3863, 1, 1636424703018, 1636424703110, 92, 0, 92, 0, 0, 0
3864, 1, 1636424703193, 1636424703285, 92, 1, 91, 0, 1, 1
3861, 1, 1636424703197, 1636424703289, 92, 1, 91, 0, 1, 1
3865, 1, 1636424703478, 1636424703569, 91, 0, 91, 0, 0, 0
3866, 1, 1636424703750, 1636424703842, 92, 0, 92, 0, 0, 0
3869, 1, 1636424704222, 1636424704313, 91, 0, 91, 0, 0, 0
3872, 1, 1636424704345, 1636424704438, 93, 0, 93, 0, 0, 0
3873, 1, 1636424704806, 1636424704898, 92, 0, 92, 0, 0, 0
3875, 1, 1636424704885, 1636424704977, 92, 1, 91, 0, 0, 0
3877, 1, 1636424705398, 1636424705490, 92, 0, 92, 0, 0, 0
3879, 1, 1636424706254, 1636424706350, 96, 0, 96, 0, 0, 0
3882, 1, 1636424707010, 1636424707101, 91, 0, 91, 0, 0, 0
3883, 1, 1636424707322, 1636424707414, 92, 0, 92, 0, 0, 0
3886, 1, 1636424708321, 1636424708409, 88, 0, 88, 0, 0, 0
3884, 1, 1636424708365, 1636424708454, 89, 1, 88, 0, 0, 0
3885, 1, 1636424708365, 1636424708457, 92, 0, 92, 0, 0, 0
3887, 1, 1636424708925, 1636424709018, 93, 1, 92, 0, 0, 0
3888, 1, 1636424709186, 1636424709277, 91, 0, 91, 0, 0, 0
3889, 1, 1636424709265, 1636424709358, 93, 1, 92, 1, 0, 1
3890, 1, 1636424710265, 1636424710353, 88, 1, 87, 0, 1, 1
3891, 1, 1636424710297, 1636424710389, 92, 1, 91, 0, 0, 0
3892, 1, 1636424710441, 1636424710530, 89, 0, 89, 0, 0, 0
3893, 1, 1636424710926, 1636424711017, 91, 0, 91, 0, 0, 0
3894, 1, 1636424710973, 1636424711062, 89, 0, 89, 0, 0, 0
3895, 1, 1636424711118, 1636424711210, 92, 0, 92, 0, 0, 0
3896, 1, 1636424711210, 1636424711301, 91, 0, 91, 0, 0, 0
3897, 1, 1636424711730, 1636424711822, 92, 0, 92, 0, 0, 0
3898, 1, 1636424711738, 1636424711826, 88, 0, 88, 0, 0, 0
3900, 1, 1636424712158, 1636424712250, 92, 0, 92, 0, 0, 0
3899, 1, 1636424712186, 1636424712277, 91, 0, 91, 0, 0, 0
3901, 1, 1636424712273, 1636424712366, 93, 1, 92, 0, 1, 1
3902, 1, 1636424712458, 1636424712550, 92, 0, 92, 0, 0, 0
3903, 1, 1636424712974, 1636424713065, 91, 0, 91, 0, 0, 0
3904, 1, 1636424713058, 1636424713149, 91, 0, 91, 0, 0, 0
3905, 1, 1636424713061, 1636424713153, 92, 1, 91, 0, 0, 0
3906, 1, 1636424713234, 1636424713325, 91, 0, 91, 0, 0, 0
3907, 1, 1636424713314, 1636424713405, 91, 0, 91, 0, 0, 0
3908, 1, 1636424713674, 1636424713765, 91, 0, 91, 0, 0, 0
3909, 1, 1636424713682, 1636424713773, 91, 0, 91, 0, 0, 0
3910, 1, 1636424714217, 1636424714305, 88, 0, 88, 0, 0, 0
3911, 1, 1636424714221, 1636424714309, 88, 1, 87, 1, 0, 1
3912, 1, 1636424714309, 1636424714402, 93, 1, 92, 0, 0, 0
3913, 1, 1636424714309, 1636424714402, 93, 1, 92, 0, 0, 0
3914, 1, 1636424714661, 1636424714754, 93, 1, 92, 1, 0, 1
3917, 1, 1636424714830, 1636424714962, 132, 0, 132, 0, 0, 0
3918, 1, 1636424714961, 1636424715057, 96, 1, 95, 0, 0, 0
3919, 1, 1636424715053, 1636424715146, 93, 1, 92, 0, 1, 1
3878, 1, 1636424715094, 1636424715185, 91, 0, 91, 0, 0, 0
3921, 1, 1636424715229, 1636424715321, 92, 1, 91, 0, 0, 0
3922, 1, 1636424715261, 1636424715353, 92, 1, 91, 0, 0, 0
3923, 1, 1636424715398, 1636424715490, 92, 0, 92, 0, 0, 0
3924, 1, 1636424715665, 1636424715758, 93, 1, 92, 0, 0, 0
3925, 1, 1636424715673, 1636424715765, 92, 1, 91, 0, 1, 1
3926, 1, 1636424715861, 1636424715954, 93, 1, 92, 0, 1, 1
3928, 1, 1636424716118, 1636424716210, 92, 0, 92, 0, 0, 0
3927, 1, 1636424716118, 1636424716210, 92, 0, 92, 0, 0, 0
3929, 1, 1636424716201, 1636424716337, 136, 1, 135, 1, 0, 1
3930, 1, 1636424716242, 1636424716337, 95, 0, 95, 0, 0, 0
3881, 1, 1636424716470, 1636424716566, 96, 0, 96, 0, 0, 0
3931, 1, 1636424716566, 1636424716657, 91, 0, 91, 0, 0, 0
3933, 1, 1636424716829, 1636424716922, 93, 1, 92, 1, 0, 1
3934, 1, 1636424716909, 1636424717006, 97, 1, 96, 0, 0, 0
3935, 1, 1636424716994, 1636424717086, 92, 0, 92, 0, 0, 0
3937, 1, 1636424717146, 1636424717237, 91, 0, 91, 0, 0, 0
3938, 1, 1636424717193, 1636424717282, 89, 0, 89, 0, 0, 0
3939, 1, 1636424717362, 1636424717454, 92, 0, 92, 0, 0, 0
3940, 1, 1636424717582, 1636424717674, 92, 0, 92, 0, 0, 0
3941, 1, 1636424717725, 1636424717817, 92, 1, 91, 0, 0, 0
3942, 1, 1636424717833, 1636424717926, 93, 1, 92, 0, 0, 0
3944, 1, 1636424718002, 1636424718094, 92, 0, 92, 0, 0, 0
3945, 1, 1636424718125, 1636424718214, 89, 0, 89, 0, 0, 0
3946, 1, 1636424718161, 1636424718250, 89, 0, 89, 0, 0, 0
3943, 1, 1636424718177, 1636424718266, 89, 0, 89, 0, 0, 0
3947, 1, 1636424718458, 1636424718550, 92, 0, 92, 0, 0, 0
3948, 1, 1636424718797, 1636424718890, 93, 1, 92, 1, 0, 1
3949, 1, 1636424718905, 1636424718998, 93, 1, 92, 0, 0, 0
3950, 1, 1636424718965, 1636424719057, 92, 1, 91, 0, 0, 0
3951, 1, 1636424719185, 1636424719269, 84, 0, 84, 0, 0, 0
3952, 1, 1636424719209, 1636424719297, 88, 0, 88, 0, 0, 0
3953, 1, 1636424719246, 1636424719337, 91, 0, 91, 0, 0, 0
3954, 1, 1636424719653, 1636424719745, 92, 1, 91, 1, 0, 1
3955, 1, 1636424719722, 1636424719813, 91, 0, 91, 0, 0, 0
3956, 1, 1636424719861, 1636424719954, 93, 1, 92, 0, 0, 0
3958, 1, 1636424720065, 1636424720157, 92, 1, 91, 0, 0, 0
3959, 1, 1636424720065, 1636424720157, 92, 1, 91, 0, 0, 0
3960, 1, 1636424720273, 1636424720365, 92, 0, 92, 0, 0, 0
3957, 1, 1636424720317, 1636424720410, 93, 1, 92, 1, 0, 1
3961, 1, 1636424720537, 1636424720630, 93, 0, 93, 0, 0, 0
3962, 1, 1636424720733, 1636424720826, 93, 1, 92, 0, 0, 0
3963, 1, 1636424720882, 1636424720974, 92, 0, 92, 0, 0, 0
3964, 1, 1636424720893, 1636424720989, 96, 1, 95, 0, 1, 1
3965, 1, 1636424721169, 1636424721266, 97, 1, 96, 0, 1, 1
3966, 1, 1636424721305, 1636424721397, 92, 1, 91, 0, 0, 0
3967, 1, 1636424721346, 1636424721437, 91, 0, 91, 0, 0, 0
3968, 1, 1636424721598, 1636424721689, 91, 0, 91, 0, 0, 0
3969, 1, 1636424721782, 1636424721873, 91, 0, 91, 0, 0, 0
3970, 1, 1636424721841, 1636424721930, 89, 0, 89, 0, 0, 0
3974, 1, 1636424722169, 1636424722254, 85, 0, 85, 0, 0, 0
3973, 1, 1636424722165, 1636424722254, 89, 0, 89, 0, 0, 0
3971, 1, 1636424722285, 1636424722378, 93, 0, 93, 0, 0, 0
3975, 1, 1636424722681, 1636424722774, 93, 1, 92, 1, 0, 1
3976, 1, 1636424722761, 1636424722854, 93, 1, 92, 1, 0, 1
3978, 1, 1636424722929, 1636424723022, 93, 1, 92, 0, 0, 0
3979, 1, 1636424723174, 1636424723270, 96, 0, 96, 0, 0, 0
3980, 1, 1636424723325, 1636424723417, 92, 1, 91, 1, 0, 1
3981, 1, 1636424723438, 1636424723530, 92, 0, 92, 0, 0, 0
3982, 1, 1636424723533, 1636424723626, 93, 1, 92, 0, 1, 1
3983, 1, 1636424723922, 1636424724013, 91, 0, 91, 0, 0, 0
3984, 1, 1636424723934, 1636424724025, 91, 0, 91, 0, 0, 0
3986, 1, 1636424724146, 1636424724238, 92, 0, 92, 0, 0, 0
3987, 1, 1636424724181, 1636424724273, 92, 1, 91, 0, 1, 1
3985, 1, 1636424724394, 1636424724530, 136, 0, 136, 0, 0, 0
3988, 1, 1636424724713, 1636424724802, 89, 0, 89, 0, 0, 0
3989, 1, 1636424724802, 1636424724893, 91, 0, 91, 0, 0, 0
3990, 1, 1636424724834, 1636424724925, 91, 0, 91, 0, 0, 0
3991, 1, 1636424724934, 1636424725050, 116, 0, 116, 0, 0, 0
3993, 1, 1636424725277, 1636424725369, 92, 0, 92, 0, 0, 0
3994, 1, 1636424725321, 1636424725410, 89, 0, 89, 0, 0, 0
3995, 1, 1636424725369, 1636424725457, 88, 0, 88, 0, 0, 0
3992, 1, 1636424725410, 1636424725502, 92, 0, 92, 0, 0, 0
3998, 1, 1636424725841, 1636424725929, 88, 0, 88, 0, 0, 0
3996, 1, 1636424725861, 1636424725953, 92, 0, 92, 0, 0, 0
3999, 1, 1636424725893, 1636424725985, 92, 1, 91, 0, 1, 1
4001, 1, 1636424726246, 1636424726337, 91, 0, 91, 0, 0, 0
4002, 1, 1636424726293, 1636424726385, 92, 1, 91, 0, 1, 1
4000, 1, 1636424726293, 1636424726385, 92, 1, 91, 0, 0, 0
4003, 1, 1636424726737, 1636424726829, 92, 1, 91, 0, 1, 1
4005, 1, 1636424726737, 1636424726830, 93, 1, 92, 0, 0, 0
4004, 1, 1636424726737, 1636424726829, 92, 1, 91, 0, 1, 1
4006, 1, 1636424726874, 1636424726962, 88, 0, 88, 0, 0, 0
4008, 1, 1636424727110, 1636424727201, 91, 0, 91, 0, 0, 0
4010, 1, 1636424727285, 1636424727377, 92, 1, 91, 0, 1, 1
4007, 1, 1636424727326, 1636424727417, 91, 0, 91, 0, 0, 0
4013, 1, 1636424727461, 1636424727553, 92, 1, 91, 0, 0, 0
4011, 1, 1636424727557, 1636424727650, 93, 0, 93, 0, 0, 0
4012, 1, 1636424727778, 1636424727866, 88, 0, 88, 0, 0, 0
4014, 1, 1636424727801, 1636424727894, 93, 1, 92, 0, 1, 1
4015, 1, 1636424727918, 1636424728009, 91, 0, 91, 0, 0, 0
4017, 1, 1636424728186, 1636424728277, 91, 0, 91, 0, 0, 0
4016, 1, 1636424728246, 1636424728338, 92, 0, 92, 0, 0, 0
4018, 1, 1636424728246, 1636424728338, 92, 0, 92, 0, 0, 0
4019, 1, 1636424728629, 1636424728726, 97, 1, 96, 0, 0, 0
4020, 1, 1636424728646, 1636424728737, 91, 0, 91, 0, 0, 0
4021, 1, 1636424728758, 1636424728849, 91, 0, 91, 0, 0, 0
4022, 1, 1636424728782, 1636424728873, 91, 0, 91, 0, 0, 0
4024, 1, 1636424729078, 1636424729170, 92, 0, 92, 0, 0, 0
4025, 1, 1636424729166, 1636424729258, 92, 0, 92, 0, 0, 0
4023, 1, 1636424729233, 1636424729325, 92, 0, 92, 0, 0, 0
4027, 1, 1636424729370, 1636424729461, 91, 0, 91, 0, 0, 0
4028, 1, 1636424729526, 1636424729618, 92, 0, 92, 0, 0, 0
4026, 1, 1636424729690, 1636424729781, 91, 0, 91, 0, 0, 0
4029, 1, 1636424729718, 1636424729810, 92, 0, 92, 0, 0, 0
4030, 1, 1636424729817, 1636424729909, 92, 1, 91, 1, 0, 1
4032, 1, 1636424730146, 1636424730237, 91, 0, 91, 0, 0, 0
4031, 1, 1636424730170, 1636424730261, 91, 0, 91, 0, 0, 0
4033, 1, 1636424730305, 1636424730397, 92, 0, 92, 0, 0, 0
4034, 1, 1636424730598, 1636424730690, 92, 0, 92, 0, 0, 0
4035, 1, 1636424730598, 1636424730690, 92, 0, 92, 0, 0, 0
4036, 1, 1636424730838, 1636424730934, 96, 0, 96, 0, 0, 0
4037, 1, 1636424730901, 1636424730994, 93, 1, 92, 0, 1, 1
4039, 1, 1636424731002, 1636424731094, 92, 0, 92, 0, 0, 0
4041, 1, 1636424731333, 1636424731425, 92, 1, 91, 0, 0, 0
4040, 1, 1636424731353, 1636424731446, 93, 1, 92, 0, 1, 1
4042, 1, 1636424731453, 1636424731546, 93, 1, 92, 0, 1, 1
4044, 1, 1636424731665, 1636424731758, 93, 0, 93, 0, 0, 0
4045, 1, 1636424731786, 1636424731878, 92, 0, 92, 0, 0, 0
4046, 1, 1636424732122, 1636424732213, 91, 0, 91, 0, 0, 0
4048, 1, 1636424732365, 1636424732461, 96, 1, 95, 0, 1, 1
4049, 1, 1636424732430, 1636424732522, 92, 0, 92, 0, 0, 0
4051, 1, 1636424732518, 1636424732610, 92, 0, 92, 0, 0, 0
3997, 1, 1636424732789, 1636424732886, 97, 1, 96, 0, 1, 1
4052, 1, 1636424733021, 1636424733118, 97, 1, 96, 0, 0, 0
4053, 1, 1636424733050, 1636424733141, 91, 0, 91, 0, 0, 0
4054, 1, 1636424733097, 1636424733185, 88, 0, 88, 0, 0, 0
4058, 1, 1636424733542, 1636424733633, 91, 0, 91, 0, 0, 0
4059, 1, 1636424733597, 1636424733690, 93, 1, 92, 0, 1, 1
4061, 1, 1636424734050, 1636424734142, 92, 0, 92, 0, 0, 0
4062, 1, 1636424734253, 1636424734341, 88, 0, 88, 0, 0, 0
4063, 1, 1636424734357, 1636424734450, 93, 1, 92, 0, 0, 0
4064, 1, 1636424734477, 1636424734569, 92, 1, 91, 1, 0, 1
4065, 1, 1636424734922, 1636424735014, 92, 0, 92, 0, 0, 0
4066, 1, 1636424734922, 1636424735014, 92, 0, 92, 0, 0, 0
4067, 1, 1636424735041, 1636424735134, 93, 0, 93, 0, 0, 0
4068, 1, 1636424735382, 1636424735474, 92, 0, 92, 0, 0, 0
4069, 1, 1636424735521, 1636424735609, 88, 0, 88, 0, 0, 0
4070, 1, 1636424735974, 1636424736066, 92, 0, 92, 0, 0, 0
4072, 1, 1636424736398, 1636424736490, 92, 0, 92, 0, 0, 0
4073, 1, 1636424736474, 1636424736566, 92, 0, 92, 0, 0, 0
4074, 1, 1636424736846, 1636424736938, 92, 0, 92, 0, 0, 0
4075, 1, 1636424736962, 1636424737054, 92, 0, 92, 0, 0, 0
4079, 1, 1636424737514, 1636424737601, 87, 0, 87, 0, 0, 0
4078, 1, 1636424737550, 1636424737642, 92, 0, 92, 0, 0, 0
4080, 1, 1636424737966, 1636424738057, 91, 0, 91, 0, 0, 0
4081, 1, 1636424738322, 1636424738409, 87, 0, 87, 0, 0, 0
4082, 1, 1636424738413, 1636424738506, 93, 0, 93, 0, 0, 0
4083, 1, 1636424738877, 1636424738969, 92, 1, 91, 1, 0, 1
4084, 1, 1636424738886, 1636424738981, 95, 0, 95, 0, 0, 0
4085, 1, 1636424739458, 1636424739550, 92, 0, 92, 0, 0, 0
4086, 1, 1636424739522, 1636424739614, 92, 0, 92, 0, 0, 0
4087, 1, 1636424739914, 1636424740005, 91, 0, 91, 0, 0, 0
4088, 1, 1636424740313, 1636424740406, 93, 1, 92, 0, 1, 1
4089, 1, 1636424740433, 1636424740525, 92, 1, 91, 1, 0, 1
4090, 1, 1636424740857, 1636424740950, 93, 0, 93, 0, 0, 0
4091, 1, 1636424740934, 1636424741025, 91, 0, 91, 0, 0, 0
4092, 1, 1636424741353, 1636424741446, 93, 1, 92, 0, 0, 0
4093, 1, 1636424741554, 1636424741645, 91, 0, 91, 0, 0, 0
4094, 1, 1636424741806, 1636424741930, 124, 0, 124, 0, 0, 0
4096, 1, 1636424742154, 1636424742246, 92, 0, 92, 0, 0, 0
4097, 1, 1636424742374, 1636424742465, 91, 0, 91, 0, 0, 0
4098, 1, 1636424742398, 1636424742489, 91, 0, 91, 0, 0, 0
4099, 1, 1636424742465, 1636424742558, 93, 1, 92, 0, 0, 0
4095, 1, 1636424742614, 1636424742701, 87, 0, 87, 0, 0, 0
4101, 1, 1636424742810, 1636424742938, 128, 0, 128, 0, 0, 0
4100, 1, 1636424742830, 1636424742938, 108, 0, 108, 0, 0, 0
4102, 1, 1636424743030, 1636424743121, 91, 0, 91, 0, 0, 0
4103, 1, 1636424743370, 1636424743461, 91, 0, 91, 0, 0, 0
4060, 1, 1636424743401, 1636424743497, 96, 1, 95, 0, 0, 0
4105, 1, 1636424743445, 1636424743529, 84, 0, 84, 0, 0, 0
4104, 1, 1636424743441, 1636424743529, 88, 0, 88, 0, 0, 0
4106, 1, 1636424743574, 1636424743665, 91, 0, 91, 0, 0, 0
4108, 1, 1636424743826, 1636424743917, 91, 0, 91, 0, 0, 0
4107, 1, 1636424743890, 1636424743981, 91, 0, 91, 0, 0, 0
4109, 1, 1636424743917, 1636424744009, 92, 1, 91, 0, 1, 1
4111, 1, 1636424744081, 1636424744173, 92, 1, 91, 0, 0, 0
4112, 1, 1636424744257, 1636424744349, 92, 1, 91, 0, 1, 1
4113, 1, 1636424744313, 1636424744405, 92, 1, 91, 0, 1, 1
4114, 1, 1636424744325, 1636424744410, 85, 0, 85, 0, 0, 0
4110, 1, 1636424744369, 1636424744457, 88, 0, 88, 0, 0, 0
4115, 1, 1636424744714, 1636424744806, 92, 0, 92, 0, 0, 0
4116, 1, 1636424744886, 1636424744977, 91, 0, 91, 0, 0, 0
4117, 1, 1636424744933, 1636424745021, 88, 0, 88, 0, 0, 0
4118, 1, 1636424745282, 1636424745373, 91, 0, 91, 0, 0, 0
4119, 1, 1636424745345, 1636424745438, 93, 1, 92, 1, 0, 1
4120, 1, 1636424745349, 1636424745445, 96, 1, 95, 0, 0, 0
4121, 1, 1636424745526, 1636424745617, 91, 0, 91, 0, 0, 0
4122, 1, 1636424745749, 1636424745841, 92, 1, 91, 0, 0, 0
4123, 1, 1636424745797, 1636424745886, 89, 0, 89, 0, 0, 0
4124, 1, 1636424745921, 1636424746014, 93, 1, 92, 0, 0, 0
4125, 1, 1636424745973, 1636424746061, 88, 0, 88, 0, 0, 0
4127, 1, 1636424746274, 1636424746365, 91, 0, 91, 0, 0, 0
4128, 1, 1636424746305, 1636424746397, 92, 1, 91, 0, 0, 0
4126, 1, 1636424746417, 1636424746509, 92, 1, 91, 0, 0, 0
4130, 1, 1636424746621, 1636424746713, 92, 1, 91, 0, 1, 1
4129, 1, 1636424746753, 1636424746869, 116, 1, 115, 0, 0, 0
4131, 1, 1636424746733, 1636424746870, 137, 1, 136, 1, 0, 1
4132, 1, 1636424746869, 1636424746958, 89, 1, 88, 0, 0, 0
4133, 1, 1636424747046, 1636424747133, 87, 0, 87, 0, 0, 0
4136, 1, 1636424747353, 1636424747441, 88, 0, 88, 0, 0, 0
4137, 1, 1636424747353, 1636424747445, 92, 1, 91, 1, 0, 1
4134, 1, 1636424747353, 1636424747446, 93, 1, 92, 0, 0, 0
4135, 1, 1636424747353, 1636424747445, 92, 1, 91, 0, 1, 1
4138, 1, 1636424747566, 1636424747657, 91, 0, 91, 0, 0, 0
4139, 1, 1636424747806, 1636424747897, 91, 0, 91, 0, 0, 0
4140, 1, 1636424747806, 1636424747897, 91, 0, 91, 0, 0, 0
4141, 1, 1636424747806, 1636424747897, 91, 1, 90, 0, 0, 0
4142, 1, 1636424748037, 1636424748130, 93, 1, 92, 0, 0, 0
4143, 1, 1636424748089, 1636424748181, 92, 1, 91, 0, 1, 1
4145, 1, 1636424748189, 1636424748285, 96, 1, 95, 0, 1, 1
4146, 1, 1636424748301, 1636424748394, 93, 0, 93, 0, 0, 0
4148, 1, 1636424748421, 1636424748513, 92, 1, 91, 1, 0, 1
4147, 1, 1636424748421, 1636424748513, 92, 1, 91, 1, 0, 1
4144, 1, 1636424748542, 1636424748634, 92, 0, 92, 0, 0, 0
4149, 1, 1636424748685, 1636424748778, 93, 0, 93, 0, 0, 0
4150, 1, 1636424748825, 1636424748917, 92, 1, 91, 0, 1, 1
4151, 1, 1636424749054, 1636424749141, 87, 0, 87, 0, 0, 0
4152, 1, 1636424749141, 1636424749229, 88, 1, 87, 1, 0, 1
4153, 1, 1636424749225, 1636424749313, 88, 0, 88, 0, 0, 0
4154, 1, 1636424749286, 1636424749378, 92, 0, 92, 0, 0, 0
4155, 1, 1636424749430, 1636424749521, 91, 0, 91, 0, 0, 0
4158, 1, 1636424749593, 1636424749685, 92, 1, 91, 0, 0, 0
4157, 1, 1636424749669, 1636424749762, 93, 0, 93, 0, 0, 0
4159, 1, 1636424749881, 1636424749973, 92, 1, 91, 0, 1, 1
4160, 1, 1636424749906, 1636424749998, 92, 0, 92, 0, 0, 0
4161, 1, 1636424749965, 1636424750057, 92, 0, 92, 0, 0, 0
4163, 1, 1636424750093, 1636424750189, 96, 1, 95, 0, 1, 1
4164, 1, 1636424750233, 1636424750317, 84, 0, 84, 0, 0, 0
4166, 1, 1636424750397, 1636424750489, 92, 1, 91, 0, 1, 1
4162, 1, 1636424750413, 1636424750505, 92, 1, 91, 0, 0, 0
4167, 1, 1636424750577, 1636424750665, 88, 0, 88, 0, 0, 0
4168, 1, 1636424750754, 1636424750845, 91, 0, 91, 0, 0, 0
4169, 1, 1636424751109, 1636424751202, 93, 1, 92, 0, 1, 1
4170, 1, 1636424751126, 1636424751218, 92, 0, 92, 0, 0, 0
4171, 1, 1636424751181, 1636424751273, 92, 1, 91, 0, 1, 1
4172, 1, 1636424751209, 1636424751301, 92, 1, 91, 0, 1, 1
4173, 1, 1636424751313, 1636424751405, 92, 1, 91, 0, 1, 1
4175, 1, 1636424751573, 1636424751665, 92, 1, 91, 0, 0, 0
4174, 1, 1636424751661, 1636424751749, 88, 0, 88, 0, 0, 0
4176, 1, 1636424751761, 1636424751849, 88, 1, 87, 0, 1, 1
4177, 1, 1636424751790, 1636424751885, 95, 0, 95, 0, 0, 0
4178, 1, 1636424752025, 1636424752117, 92, 1, 91, 0, 0, 0
4180, 1, 1636424752205, 1636424752298, 93, 1, 92, 0, 0, 0
4181, 1, 1636424752273, 1636424752366, 93, 1, 92, 0, 0, 0
4182, 1, 1636424752325, 1636424752413, 88, 0, 88, 0, 0, 0
4179, 1, 1636424752478, 1636424752570, 92, 0, 92, 0, 0, 0
4183, 1, 1636424752661, 1636424752757, 96, 1, 95, 0, 0, 0
4184, 1, 1636424752738, 1636424752829, 91, 0, 91, 0, 0, 0
4185, 1, 1636424753017, 1636424753110, 93, 1, 92, 0, 0, 0
4186, 1, 1636424753106, 1636424753197, 91, 0, 91, 0, 0, 0
4187, 1, 1636424753213, 1636424753301, 88, 0, 88, 0, 0, 0
4188, 1, 1636424753257, 1636424753345, 88, 0, 88, 0, 0, 0
4189, 1, 1636424753337, 1636424753429, 92, 1, 91, 0, 0, 0
4190, 1, 1636424753466, 1636424753558, 92, 0, 92, 0, 0, 0
4191, 1, 1636424753658, 1636424753750, 92, 0, 92, 0, 0, 0
4192, 1, 1636424753781, 1636424753874, 93, 1, 92, 0, 0, 0
4193, 1, 1636424753866, 1636424753957, 91, 0, 91, 0, 0, 0
4194, 1, 1636424754073, 1636424754166, 93, 1, 92, 0, 1, 1
4195, 1, 1636424754165, 1636424754257, 92, 1, 91, 0, 0, 0
4197, 1, 1636424754285, 1636424754377, 92, 1, 91, 0, 0, 0
4198, 1, 1636424754433, 1636424754526, 93, 1, 92, 0, 0, 0
4199, 1, 1636424754594, 1636424754685, 91, 0, 91, 0, 0, 0
4196, 1, 1636424754617, 1636424754706, 89, 1, 88, 0, 0, 0
4200, 1, 1636424754777, 1636424754869, 92, 1, 91, 1, 0, 1
4201, 1, 1636424755026, 1636424755118, 92, 0, 92, 0, 0, 0
4202, 1, 1636424755142, 1636424755233, 91, 0, 91, 0, 0, 0
4203, 1, 1636424755225, 1636424755313, 88, 0, 88, 0, 0, 0
4204, 1, 1636424755322, 1636424755414, 92, 0, 92, 0, 0, 0
4205, 1, 1636424755477, 1636424755569, 92, 1, 91, 0, 0, 0
4206, 1, 1636424755481, 1636424755573, 92, 1, 91, 0, 0, 0
4207, 1, 1636424755770, 1636424755861, 91, 0, 91, 0, 0, 0
4208, 1, 1636424755837, 1636424755930, 93, 1, 92, 0, 1, 1
4209, 1, 1636424755926, 1636424756017, 91, 0, 91, 0, 0, 0
4210, 1, 1636424756101, 1636424756193, 92, 1, 91, 1, 0, 1
4211, 1, 1636424756117, 1636424756209, 92, 1, 91, 1, 0, 1
4213, 1, 1636424756250, 1636424756342, 92, 0, 92, 0, 0, 0
4212, 1, 1636424756553, 1636424756641, 88, 1, 87, 0, 0, 0
4215, 1, 1636424756641, 1636424756734, 93, 0, 93, 0, 0, 0
4216, 1, 1636424756885, 1636424756974, 89, 0, 89, 0, 0, 0
4217, 1, 1636424756997, 1636424757089, 92, 1, 91, 0, 0, 0
4220, 1, 1636424757281, 1636424757366, 85, 0, 85, 0, 0, 0
4219, 1, 1636424757273, 1636424757366, 93, 0, 93, 0, 0, 0
4221, 1, 1636424757402, 1636424757497, 95, 0, 95, 0, 0, 0
4222, 1, 1636424757453, 1636424757542, 89, 0, 89, 0, 0, 0
4224, 1, 1636424757854, 1636424757942, 88, 0, 88, 0, 0, 0
4225, 1, 1636424757854, 1636424757942, 88, 0, 88, 0, 0, 0
4226, 1, 1636424758130, 1636424758222, 92, 0, 92, 0, 0, 0
4227, 1, 1636424758234, 1636424758326, 92, 0, 92, 0, 0, 0
4228, 1, 1636424758586, 1636424758678, 92, 0, 92, 0, 0, 0
4229, 1, 1636424758746, 1636424758838, 92, 0, 92, 0, 0, 0
4233, 1, 1636424759409, 1636424759494, 85, 0, 85, 0, 0, 0
4232, 1, 1636424759402, 1636424759494, 92, 0, 92, 0, 0, 0
4231, 1, 1636424759402, 1636424759494, 92, 0, 92, 0, 0, 0
4234, 1, 1636424759750, 1636424759841, 91, 0, 91, 0, 0, 0
4235, 1, 1636424759857, 1636424759950, 93, 1, 92, 0, 0, 0
4236, 1, 1636424759966, 1636424760053, 87, 0, 87, 0, 0, 0
4237, 1, 1636424760033, 1636424760165, 132, 0, 132, 0, 0, 0
4238, 1, 1636424760193, 1636424760286, 93, 1, 92, 1, 0, 1
4239, 1, 1636424760525, 1636424760617, 92, 1, 91, 0, 1, 1
4240, 1, 1636424760606, 1636424760698, 92, 0, 92, 0, 0, 0
4241, 1, 1636424760706, 1636424760798, 92, 0, 92, 0, 0, 0
4242, 1, 1636424761301, 1636424761393, 92, 0, 92, 0, 0, 0
4243, 1, 1636424761313, 1636424761405, 92, 1, 91, 1, 0, 1
4244, 1, 1636424761530, 1636424761621, 91, 0, 91, 0, 0, 0
4245, 1, 1636424761665, 1636424761757, 92, 0, 92, 0, 0, 0
4246, 1, 1636424761769, 1636424761857, 88, 0, 88, 0, 0, 0
4247, 1, 1636424761925, 1636424762017, 92, 1, 91, 0, 1, 1
4248, 1, 1636424761989, 1636424762082, 93, 1, 92, 1, 0, 1
4250, 1, 1636424762273, 1636424762365, 92, 1, 91, 0, 0, 0
4249, 1, 1636424762442, 1636424762533, 91, 0, 91, 0, 0, 0
4251, 1, 1636424762522, 1636424762614, 92, 0, 92, 0, 0, 0
4252, 1, 1636424762782, 1636424762874, 92, 0, 92, 0, 0, 0
4253, 1, 1636424763178, 1636424763274, 96, 0, 96, 0, 0, 0
4254, 1, 1636424763357, 1636424763449, 92, 1, 91, 0, 1, 1
4255, 1, 1636424763481, 1636424763578, 97, 1, 96, 0, 0, 0
4256, 1, 1636424763658, 1636424763750, 92, 0, 92, 0, 0, 0
4257, 1, 1636424763721, 1636424763813, 92, 1, 91, 0, 1, 1
4258, 1, 1636424763902, 1636424763993, 91, 0, 91, 0, 0, 0
4259, 1, 1636424763981, 1636424764074, 93, 1, 92, 0, 0, 0
4260, 1, 1636424764353, 1636424764446, 93, 1, 92, 0, 0, 0
4261, 1, 1636424764365, 1636424764458, 93, 1, 92, 0, 0, 0
4262, 1, 1636424764473, 1636424764566, 93, 1, 92, 1, 0, 1
4263, 1, 1636424764873, 1636424764966, 93, 1, 92, 0, 0, 0
4264, 1, 1636424765078, 1636424765170, 92, 0, 92, 0, 0, 0
4265, 1, 1636424765417, 1636424765510, 93, 1, 92, 1, 0, 1
4266, 1, 1636424765510, 1636424765601, 91, 0, 91, 0, 0, 0
4267, 1, 1636424765630, 1636424765722, 92, 0, 92, 0, 0, 0
4269, 1, 1636424765870, 1636424765962, 92, 0, 92, 0, 0, 0
4268, 1, 1636424765870, 1636424765962, 92, 0, 92, 0, 0, 0
4271, 1, 1636424766326, 1636424766421, 95, 0, 95, 0, 0, 0
4270, 1, 1636424766326, 1636424766421, 95, 0, 95, 0, 0, 0
4272, 1, 1636424766393, 1636424766481, 88, 0, 88, 0, 0, 0
4274, 1, 1636424766613, 1636424766706, 93, 1, 92, 0, 1, 1
4273, 1, 1636424766781, 1636424766874, 93, 1, 92, 0, 1, 1
4275, 1, 1636424766865, 1636424766958, 93, 1, 92, 0, 0, 0
4276, 1, 1636424767053, 1636424767145, 92, 0, 92, 0, 0, 0
4277, 1, 1636424767394, 1636424767517, 123, 0, 123, 0, 0, 0
4279, 1, 1636424767521, 1636424767609, 88, 0, 88, 0, 0, 0
4278, 1, 1636424767517, 1636424767610, 93, 1, 92, 0, 1, 1
4280, 1, 1636424767609, 1636424767701, 92, 1, 91, 0, 1, 1
4281, 1, 1636424767609, 1636424767701, 92, 1, 91, 0, 0, 0
4282, 1, 1636424767865, 1636424767958, 93, 1, 92, 0, 0, 0
4283, 1, 1636424767973, 1636424768065, 92, 1, 91, 0, 1, 1
4285, 1, 1636424768005, 1636424768098, 93, 0, 93, 0, 0, 0
4284, 1, 1636424768321, 1636424768410, 89, 0, 89, 0, 0, 0
4286, 1, 1636424768397, 1636424768490, 93, 1, 92, 0, 0, 0
4287, 1, 1636424768462, 1636424768553, 91, 0, 91, 0, 0, 0
4288, 1, 1636424768622, 1636424768714, 92, 0, 92, 0, 0, 0
4289, 1, 1636424768898, 1636424768990, 92, 0, 92, 0, 0, 0
4290, 1, 1636424768906, 1636424768997, 91, 0, 91, 0, 0, 0
4291, 1, 1636424769062, 1636424769153, 91, 0, 91, 0, 0, 0
4292, 1, 1636424769418, 1636424769509, 91, 0, 91, 0, 0, 0
4293, 1, 1636424769429, 1636424769522, 93, 1, 92, 1, 0, 1
4294, 1, 1636424769545, 1636424769637, 92, 1, 91, 0, 1, 1
4295, 1, 1636424769557, 1636424769649, 92, 1, 91, 0, 0, 0
4296, 1, 1636424769681, 1636424769773, 92, 1, 91, 0, 0, 0
4297, 1, 1636424769781, 1636424769869, 88, 1, 87, 0, 0, 0
4298, 1, 1636424769869, 1636424769962, 93, 1, 92, 1, 0, 1
4300, 1, 1636424770046, 1636424770138, 92, 0, 92, 0, 0, 0
4299, 1, 1636424770237, 1636424770329, 92, 1, 91, 1, 0, 1
4301, 1, 1636424770325, 1636424770417, 92, 1, 91, 1, 0, 1
4302, 1, 1636424770461, 1636424770553, 92, 0, 92, 0, 0, 0
4303, 1, 1636424770717, 1636424770809, 92, 1, 91, 0, 1, 1
4304, 1, 1636424770821, 1636424770913, 92, 1, 91, 1, 0, 1
4305, 1, 1636424770901, 1636424770989, 88, 1, 87, 1, 0, 1
4306, 1, 1636424771034, 1636424771126, 92, 0, 92, 0, 0, 0
4307, 1, 1636424771353, 1636424771445, 92, 1, 91, 0, 0, 0
4309, 1, 1636424771461, 1636424771553, 92, 1, 91, 1, 0, 1
4308, 1, 1636424771461, 1636424771554, 93, 1, 92, 0, 1, 1
4310, 1, 1636424771529, 1636424771621, 92, 1, 91, 0, 0, 0
4311, 1, 1636424771577, 1636424771665, 88, 1, 87, 1, 0, 1
4312, 1, 1636424771709, 1636424771806, 97, 0, 97, 0, 0, 0
4314, 1, 1636424771973, 1636424772066, 93, 1, 92, 0, 0, 0
4315, 1, 1636424772002, 1636424772094, 92, 0, 92, 0, 0, 0
4313, 1, 1636424772169, 1636424772257, 88, 0, 88, 0, 0, 0
4316, 1, 1636424772433, 1636424772522, 89, 0, 89, 0, 0, 0
4317, 1, 1636424772461, 1636424772554, 93, 1, 92, 0, 0, 0
4319, 1, 1636424772813, 1636424772906, 93, 1, 92, 0, 1, 1
4318, 1, 1636424772886, 1636424772977, 91, 0, 91, 0, 0, 0
4321, 1, 1636424773070, 1636424773161, 91, 0, 91, 0, 0, 0
4320, 1, 1636424773333, 1636424773421, 88, 0, 88, 0, 0, 0
4322, 1, 1636424773341, 1636424773429, 88, 0, 88, 0, 0, 0
4323, 1, 1636424773377, 1636424773466, 89, 0, 89, 0, 0, 0
4326, 1, 1636424773646, 1636424773738, 92, 0, 92, 0, 0, 0
4327, 1, 1636424773682, 1636424773774, 92, 0, 92, 0, 0, 0
4328, 1, 1636424774138, 1636424774230, 92, 0, 92, 0, 0, 0
4331, 1, 1636424774554, 1636424774645, 91, 0, 91, 0, 0, 0
4332, 1, 1636424774589, 1636424774678, 89, 0, 89, 0, 0, 0
4333, 1, 1636424774758, 1636424774849, 91, 0, 91, 0, 0, 0
4334, 1, 1636424774769, 1636424774861, 92, 0, 92, 0, 0, 0
4335, 1, 1636424775058, 1636424775150, 92, 0, 92, 0, 0, 0
4337, 1, 1636424775261, 1636424775354, 93, 1, 92, 1, 0, 1
4338, 1, 1636424775381, 1636424775474, 93, 0, 93, 0, 0, 0
4339, 1, 1636424775581, 1636424775674, 93, 1, 92, 1, 0, 1
4341, 1, 1636424775721, 1636424775814, 93, 0, 93, 0, 0, 0
4340, 1, 1636424776038, 1636424776129, 91, 0, 91, 0, 0, 0
4343, 1, 1636424776658, 1636424776750, 92, 0, 92, 0, 0, 0
4344, 1, 1636424776665, 1636424776757, 92, 1, 91, 0, 0, 0
4345, 1, 1636424776897, 1636424776990, 93, 1, 92, 0, 1, 1
4347, 1, 1636424777262, 1636424777354, 92, 0, 92, 0, 0, 0
4348, 1, 1636424777285, 1636424777378, 93, 1, 92, 1, 0, 1
4349, 1, 1636424777658, 1636424777749, 91, 0, 91, 0, 0, 0
4350, 1, 1636424777685, 1636424777778, 93, 1, 92, 0, 1, 1
4351, 1, 1636424778110, 1636424778202, 92, 0, 92, 0, 0, 0
4352, 1, 1636424778626, 1636424778718, 92, 0, 92, 0, 0, 0
4353, 1, 1636424778726, 1636424778818, 92, 0, 92, 0, 0, 0
4355, 1, 1636424779326, 1636424779417, 91, 0, 91, 0, 0, 0
4356, 1, 1636424779350, 1636424779442, 92, 0, 92, 0, 0, 0
4357, 1, 1636424779542, 1636424779634, 92, 0, 92, 0, 0, 0
4358, 1, 1636424779609, 1636424779702, 93, 1, 92, 0, 1, 1
4359, 1, 1636424779994, 1636424780086, 92, 0, 92, 0, 0, 0
4360, 1, 1636424780517, 1636424780606, 89, 0, 89, 0, 0, 0
4361, 1, 1636424780605, 1636424780698, 93, 1, 92, 1, 0, 1
4362, 1, 1636424781214, 1636424781306, 92, 0, 92, 0, 0, 0
4363, 1, 1636424781234, 1636424781325, 91, 0, 91, 0, 0, 0
4364, 1, 1636424781522, 1636424781614, 92, 0, 92, 0, 0, 0
4365, 1, 1636424781533, 1636424781626, 93, 1, 92, 0, 0, 0
4366, 1, 1636424781986, 1636424782078, 92, 0, 92, 0, 0, 0
4367, 1, 1636424782430, 1636424782521, 91, 0, 91, 0, 0, 0
4368, 1, 1636424782562, 1636424782654, 92, 0, 92, 0, 0, 0
4369, 1, 1636424783181, 1636424783273, 92, 1, 91, 0, 0, 0
4370, 1, 1636424783225, 1636424783333, 108, 1, 107, 0, 0, 0
4371, 1, 1636424783513, 1636424783602, 89, 0, 89, 0, 0, 0
4372, 1, 1636424783586, 1636424783678, 92, 0, 92, 0, 0, 0
4373, 1, 1636424784034, 1636424784125, 91, 0, 91, 0, 0, 0
4374, 1, 1636424784133, 1636424784226, 93, 1, 92, 0, 0, 0
4375, 1, 1636424784133, 1636424784230, 97, 1, 96, 0, 0, 0
4378, 1, 1636424784409, 1636424784501, 92, 0, 92, 0, 0, 0
4379, 1, 1636424784553, 1636424784645, 92, 1, 91, 0, 0, 0
4376, 1, 1636424784590, 1636424784678, 88, 0, 88, 0, 0, 0
4377, 1, 1636424784585, 1636424784678, 93, 1, 92, 0, 0, 0
4380, 1, 1636424785161, 1636424785257, 96, 1, 95, 0, 0, 0
4381, 1, 1636424785298, 1636424785385, 87, 0, 87, 0, 0, 0
4382, 1, 1636424785369, 1636424785461, 92, 1, 91, 0, 1, 1
4383, 1, 1636424785417, 1636424785506, 89, 0, 89, 0, 0, 0
4384, 1, 1636424785489, 1636424785581, 92, 1, 91, 0, 0, 0
4385, 1, 1636424785861, 1636424785954, 93, 1, 92, 1, 0, 1
4386, 1, 1636424785938, 1636424786030, 92, 0, 92, 0, 0, 0
4387, 1, 1636424786001, 1636424786089, 88, 0, 88, 0, 0, 0
4390, 1, 1636424786290, 1636424786381, 91, 0, 91, 0, 0, 0
4389, 1, 1636424786389, 1636424786481, 92, 1, 91, 0, 1, 1
4346, 1, 1636424786417, 1636424786513, 96, 1, 95, 0, 0, 0
4388, 1, 1636424786453, 1636424786546, 93, 1, 92, 1, 0, 1
4391, 1, 1636424786545, 1636424786638, 93, 1, 92, 0, 0, 0
4392, 1, 1636424786725, 1636424786813, 88, 0, 88, 0, 0, 0
4394, 1, 1636424787098, 1636424787190, 92, 0, 92, 0, 0, 0
4393, 1, 1636424787178, 1636424787270, 92, 0, 92, 0, 0, 0
4395, 1, 1636424787210, 1636424787297, 87, 0, 87, 0, 0, 0
4396, 1, 1636424787241, 1636424787334, 93, 1, 92, 0, 0, 0
4397, 1, 1636424787506, 1636424787598, 92, 0, 92, 0, 0, 0
4399, 1, 1636424787862, 1636424787954, 92, 0, 92, 0, 0, 0
4398, 1, 1636424787965, 1636424788058, 93, 1, 92, 0, 1, 1
4400, 1, 1636424788049, 1636424788138, 89, 1, 88, 0, 0, 0
4401, 1, 1636424788314, 1636424788409, 95, 0, 95, 0, 0, 0
4402, 1, 1636424788489, 1636424788581, 92, 1, 91, 0, 0, 0
4403, 1, 1636424788537, 1636424788641, 104, 0, 104, 0, 0, 0
4404, 1, 1636424788941, 1636424789034, 93, 0, 93, 0, 0, 0
4406, 1, 1636424789085, 1636424789178, 93, 0, 93, 0, 0, 0
4407, 1, 1636424789141, 1636424789234, 93, 1, 92, 1, 0, 1
4408, 1, 1636424789158, 1636424789249, 91, 0, 91, 0, 0, 0
4411, 1, 1636424789622, 1636424789714, 92, 0, 92, 0, 0, 0
4410, 1, 1636424790073, 1636424790162, 89, 0, 89, 0, 0, 0
4414, 1, 1636424790117, 1636424790209, 92, 1, 91, 0, 1, 1
4415, 1, 1636424790569, 1636424790661, 92, 1, 91, 0, 0, 0
4416, 1, 1636424790633, 1636424790726, 93, 1, 92, 1, 0, 1
4419, 1, 1636424791117, 1636424791210, 93, 0, 93, 0, 0, 0
4420, 1, 1636424791202, 1636424791294, 92, 0, 92, 0, 0, 0
4423, 1, 1636424792174, 1636424792265, 91, 0, 91, 0, 0, 0
4424, 1, 1636424792633, 1636424792726, 93, 1, 92, 0, 0, 0
4426, 1, 1636424793066, 1636424793158, 92, 0, 92, 0, 0, 0
4428, 1, 1636424794130, 1636424794222, 92, 0, 92, 0, 0, 0
4429, 1, 1636424794585, 1636424794678, 93, 1, 92, 0, 1, 1
4430, 1, 1636424795093, 1636424795186, 93, 1, 92, 0, 0, 0
4431, 1, 1636424796202, 1636424796293, 91, 0, 91, 0, 0, 0
4432, 1, 1636424796657, 1636424796749, 92, 1, 91, 0, 0, 0
4433, 1, 1636424796962, 1636424797054, 92, 0, 92, 0, 0, 0
4434, 1, 1636424798166, 1636424798262, 96, 0, 96, 0, 0, 0
4435, 1, 1636424798622, 1636424798713, 91, 0, 91, 0, 0, 0
4436, 1, 1636424799009, 1636424799102, 93, 1, 92, 0, 0, 0
4437, 1, 1636424799701, 1636424799789, 88, 0, 88, 0, 0, 0
4438, 1, 1636424799745, 1636424799833, 88, 0, 88, 0, 0, 0
4439, 1, 1636424800194, 1636424800285, 91, 0, 91, 0, 0, 0
4440, 1, 1636424800226, 1636424800317, 91, 0, 91, 0, 0, 0
4441, 1, 1636424800645, 1636424800737, 92, 1, 91, 0, 0, 0
4418, 1, 1636424800653, 1636424800737, 84, 0, 84, 0, 0, 0
4442, 1, 1636424800677, 1636424800769, 92, 0, 92, 0, 0, 0
4443, 1, 1636424800914, 1636424801005, 91, 0, 91, 0, 0, 0
4444, 1, 1636424800961, 1636424801050, 89, 0, 89, 0, 0, 0
4445, 1, 1636424801317, 1636424801410, 93, 0, 93, 0, 0, 0
4446, 1, 1636424801638, 1636424801729, 91, 0, 91, 0, 0, 0
4447, 1, 1636424801638, 1636424801729, 91, 0, 91, 0, 0, 0
4449, 1, 1636424801861, 1636424801954, 93, 1, 92, 1, 0, 1
4450, 1, 1636424802090, 1636424802181, 91, 0, 91, 0, 0, 0
4451, 1, 1636424802122, 1636424802213, 91, 0, 91, 0, 0, 0
4448, 1, 1636424802313, 1636424802438, 125, 0, 125, 0, 0, 0
4452, 1, 1636424802546, 1636424802637, 91, 0, 91, 0, 0, 0
4453, 1, 1636424802569, 1636424802661, 92, 1, 91, 0, 0, 0
4454, 1, 1636424802873, 1636424802966, 93, 1, 92, 0, 0, 0
4455, 1, 1636424802885, 1636424802977, 92, 1, 91, 0, 0, 0
4456, 1, 1636424803025, 1636424803118, 93, 1, 92, 0, 0, 0
4457, 1, 1636424803205, 1636424803298, 93, 1, 92, 1, 0, 1
4458, 1, 1636424803378, 1636424803470, 92, 0, 92, 0, 0, 0
4459, 1, 1636424803578, 1636424803670, 92, 0, 92, 0, 0, 0
4460, 1, 1636424803742, 1636424803834, 92, 0, 92, 0, 0, 0
4461, 1, 1636424803837, 1636424803929, 92, 1, 91, 0, 1, 1
4463, 1, 1636424804033, 1636424804126, 93, 1, 92, 1, 0, 1
4464, 1, 1636424804190, 1636424804282, 92, 0, 92, 0, 0, 0
4462, 1, 1636424804293, 1636424804386, 93, 1, 92, 0, 1, 1
4466, 1, 1636424804490, 1636424804585, 95, 0, 95, 0, 0, 0
4465, 1, 1636424804646, 1636424804738, 92, 0, 92, 0, 0, 0
4467, 1, 1636424804866, 1636424804958, 92, 0, 92, 0, 0, 0
4468, 1, 1636424804994, 1636424805085, 91, 0, 91, 0, 0, 0
4469, 1, 1636424805109, 1636424805202, 93, 1, 92, 1, 0, 1
4470, 1, 1636424805298, 1636424805389, 91, 0, 91, 0, 0, 0
4471, 1, 1636424805345, 1636424805433, 88, 0, 88, 0, 0, 0
4472, 1, 1636424805673, 1636424805766, 93, 1, 92, 0, 0, 0
4473, 1, 1636424805685, 1636424805777, 92, 1, 91, 1, 0, 1
4474, 1, 1636424805874, 1636424805970, 96, 0, 96, 0, 0, 0
4476, 1, 1636424806142, 1636424806234, 92, 0, 92, 0, 0, 0
4477, 1, 1636424806270, 1636424806362, 92, 0, 92, 0, 0, 0
4475, 1, 1636424806329, 1636424806422, 93, 1, 92, 0, 0, 0
4479, 1, 1636424806593, 1636424806681, 88, 0, 88, 0, 0, 0
4478, 1, 1636424806725, 1636424806817, 92, 1, 91, 0, 1, 1
4480, 1, 1636424806901, 1636424806993, 92, 1, 91, 1, 0, 1
4481, 1, 1636424806926, 1636424807018, 92, 0, 92, 0, 0, 0
4482, 1, 1636424807074, 1636424807166, 92, 0, 92, 0, 0, 0
4483, 1, 1636424807410, 1636424807501, 91, 0, 91, 0, 0, 0
4484, 1, 1636424807461, 1636424807554, 93, 1, 92, 0, 0, 0
4486, 1, 1636424807613, 1636424807702, 89, 1, 88, 0, 1, 1
4487, 1, 1636424807737, 1636424807826, 89, 0, 89, 0, 0, 0
4485, 1, 1636424807913, 1636424808009, 96, 1, 95, 0, 1, 1
4489, 1, 1636424808065, 1636424808158, 93, 1, 92, 0, 1, 1
4488, 1, 1636424808190, 1636424808282, 92, 0, 92, 0, 0, 0
4491, 1, 1636424808222, 1636424808310, 88, 0, 88, 0, 0, 0
4490, 1, 1636424808518, 1636424808610, 92, 0, 92, 0, 0, 0
4492, 1, 1636424808670, 1636424808761, 91, 0, 91, 0, 0, 0
4493, 1, 1636424808854, 1636424808945, 91, 0, 91, 0, 0, 0
4494, 1, 1636424808901, 1636424808989, 88, 0, 88, 0, 0, 0
4495, 1, 1636424808993, 1636424809082, 89, 0, 89, 0, 0, 0
4496, 1, 1636424809337, 1636424809430, 93, 1, 92, 0, 0, 0
4497, 1, 1636424809465, 1636424809558, 93, 0, 93, 0, 0, 0
4498, 1, 1636424809542, 1636424809634, 92, 0, 92, 0, 0, 0
4499, 1, 1636424809705, 1636424809797, 92, 1, 91, 1, 0, 1
4500, 1, 1636424809777, 1636424809869, 92, 1, 91, 0, 0, 0
4502, 1, 1636424809990, 1636424810077, 87, 0, 87, 0, 0, 0
4503, 1, 1636424810141, 1636424810234, 93, 1, 92, 0, 0, 0
4501, 1, 1636424810229, 1636424810321, 92, 1, 91, 0, 1, 1
4505, 1, 1636424810441, 1636424810533, 92, 1, 91, 0, 1, 1
4504, 1, 1636424810585, 1636424810673, 88, 0, 88, 0, 0, 0
4506, 1, 1636424810906, 1636424810998, 92, 0, 92, 0, 0, 0
4507, 1, 1636424810906, 1636424810998, 92, 0, 92, 0, 0, 0
4508, 1, 1636424810942, 1636424811034, 92, 0, 92, 0, 0, 0
4509, 1, 1636424811266, 1636424811357, 91, 0, 91, 0, 0, 0
4510, 1, 1636424811514, 1636424811601, 87, 0, 87, 0, 0, 0
4511, 1, 1636424811601, 1636424811689, 88, 0, 88, 0, 0, 0
4512, 1, 1636424811597, 1636424811690, 93, 1, 92, 1, 0, 1
4513, 1, 1636424811817, 1636424811910, 93, 1, 92, 0, 0, 0
4515, 1, 1636424812045, 1636424812138, 93, 1, 92, 0, 1, 1
4516, 1, 1636424812061, 1636424812154, 93, 1, 92, 1, 0, 1
4514, 1, 1636424812270, 1636424812361, 91, 0, 91, 0, 0, 0
4518, 1, 1636424812497, 1636424812589, 92, 1, 91, 0, 1, 1
4517, 1, 1636424812509, 1636424812602, 93, 1, 92, 0, 0, 0
4519, 1, 1636424812853, 1636424812941, 88, 0, 88, 0, 0, 0
4520, 1, 1636424812977, 1636424813069, 92, 0, 92, 0, 0, 0
4521, 1, 1636424813321, 1636424813413, 92, 1, 91, 0, 0, 0
4522, 1, 1636424813473, 1636424813566, 93, 1, 92, 0, 0, 0
4523, 1, 1636424813545, 1636424813638, 93, 1, 92, 0, 0, 0
4524, 1, 1636424813545, 1636424813638, 93, 1, 92, 1, 0, 1
4525, 1, 1636424813998, 1636424814090, 92, 0, 92, 0, 0, 0
4528, 1, 1636424814454, 1636424814546, 92, 0, 92, 0, 0, 0
4529, 1, 1636424814789, 1636424814882, 93, 1, 92, 0, 0, 0
4531, 1, 1636424815213, 1636424815306, 93, 1, 92, 1, 0, 1
4532, 1, 1636424815425, 1636424815517, 92, 1, 91, 0, 0, 0
4533, 1, 1636424815533, 1636424815626, 93, 1, 92, 1, 0, 1
4535, 1, 1636424815886, 1636424815977, 91, 0, 91, 0, 0, 0
4536, 1, 1636424816346, 1636424816438, 92, 0, 92, 0, 0, 0
4537, 1, 1636424816846, 1636424816938, 92, 0, 92, 0, 0, 0
4538, 1, 1636424817098, 1636424817190, 92, 0, 92, 0, 0, 0
4539, 1, 1636424817482, 1636424817574, 92, 0, 92, 0, 0, 0
4540, 1, 1636424817605, 1636424817697, 92, 1, 91, 0, 0, 0
4541, 1, 1636424817934, 1636424818025, 91, 0, 91, 0, 0, 0
4542, 1, 1636424818390, 1636424818482, 92, 0, 92, 0, 0, 0
4543, 1, 1636424818889, 1636424818981, 92, 1, 91, 1, 0, 1
4544, 1, 1636424819150, 1636424819241, 91, 0, 91, 0, 0, 0
4545, 1, 1636424819554, 1636424819645, 91, 0, 91, 0, 0, 0
4546, 1, 1636424819645, 1636424819737, 92, 1, 91, 1, 0, 1
4547, 1, 1636424820001, 1636424820085, 84, 0, 84, 0, 0, 0
4548, 1, 1636424820449, 1636424820542, 93, 1, 92, 0, 0, 0
4549, 1, 1636424820974, 1636424821066, 92, 0, 92, 0, 0, 0
4550, 1, 1636424821222, 1636424821314, 92, 0, 92, 0, 0, 0
4551, 1, 1636424821526, 1636424821618, 92, 0, 92, 0, 0, 0
4552, 1, 1636424821593, 1636424821685, 92, 1, 91, 0, 0, 0
4553, 1, 1636424822062, 1636424822154, 92, 0, 92, 0, 0, 0
4554, 1, 1636424822514, 1636424822606, 92, 0, 92, 0, 0, 0
4555, 1, 1636424822866, 1636424822957, 91, 0, 91, 0, 0, 0
4556, 1, 1636424823262, 1636424823354, 92, 0, 92, 0, 0, 0
4557, 1, 1636424823474, 1636424823566, 92, 0, 92, 0, 0, 0
4558, 1, 1636424823954, 1636424824046, 92, 0, 92, 0, 0, 0
4559, 1, 1636424824125, 1636424824218, 93, 1, 92, 0, 0, 0
4561, 1, 1636424824409, 1636424824505, 96, 1, 95, 1, 0, 1
4560, 1, 1636424824582, 1636424824677, 95, 0, 95, 0, 0, 0
4562, 1, 1636424825137, 1636424825230, 93, 1, 92, 0, 0, 0
4563, 1, 1636424825281, 1636424825414, 133, 1, 132, 0, 0, 0
4564, 1, 1636424825853, 1636424825946, 93, 1, 92, 0, 1, 1
4565, 1, 1636424826045, 1636424826137, 92, 1, 91, 0, 0, 0
4566, 1, 1636424826501, 1636424826594, 93, 1, 92, 0, 0, 0
4567, 1, 1636424827238, 1636424827330, 92, 0, 92, 0, 0, 0
4568, 1, 1636424827886, 1636424827978, 92, 0, 92, 0, 0, 0
4569, 1, 1636424827993, 1636424828086, 93, 1, 92, 1, 0, 1
4570, 1, 1636424828450, 1636424828542, 92, 0, 92, 0, 0, 0
4571, 1, 1636424829190, 1636424829282, 92, 0, 92, 0, 0, 0
4572, 1, 1636424829837, 1636424829929, 92, 1, 91, 0, 0, 0
4573, 1, 1636424830018, 1636424830110, 92, 0, 92, 0, 0, 0
4574, 1, 1636424830465, 1636424830558, 93, 0, 93, 0, 0, 0
4575, 1, 1636424831266, 1636424831358, 92, 0, 92, 0, 0, 0
4576, 1, 1636424831862, 1636424831954, 92, 0, 92, 0, 0, 0
4577, 1, 1636424831985, 1636424832078, 93, 1, 92, 0, 0, 0
4578, 1, 1636424832441, 1636424832534, 93, 1, 92, 0, 0, 0
4579, 1, 1636424833134, 1636424833226, 92, 0, 92, 0, 0, 0
4580, 1, 1636424833734, 1636424833826, 92, 0, 92, 0, 0, 0
4581, 1, 1636424833990, 1636424834082, 92, 0, 92, 0, 0, 0
4582, 1, 1636424834446, 1636424834538, 92, 0, 92, 0, 0, 0
4583, 1, 1636424835258, 1636424835350, 92, 0, 92, 0, 0, 0
4584, 1, 1636424835858, 1636424835950, 92, 0, 92, 0, 0, 0
4585, 1, 1636424835890, 1636424835982, 92, 0, 92, 0, 0, 0
4586, 1, 1636424836342, 1636424836434, 92, 0, 92, 0, 0, 0
4587, 1, 1636424837157, 1636424837246, 89, 0, 89, 0, 0, 0
4588, 1, 1636424837754, 1636424837846, 92, 0, 92, 0, 0, 0
4589, 1, 1636424837962, 1636424838054, 92, 0, 92, 0, 0, 0
4590, 1, 1636424838417, 1636424838510, 93, 1, 92, 0, 0, 0
4591, 1, 1636424839229, 1636424839322, 93, 1, 92, 0, 0, 0
4592, 1, 1636424839829, 1636424839921, 92, 1, 91, 0, 1, 1
4593, 1, 1636424840070, 1636424840162, 92, 0, 92, 0, 0, 0
4594, 1, 1636424840526, 1636424840618, 92, 0, 92, 0, 0, 0
4595, 1, 1636424841338, 1636424841430, 92, 0, 92, 0, 0, 0
4596, 1, 1636424841906, 1636424841998, 92, 0, 92, 0, 0, 0
4597, 1, 1636424842033, 1636424842126, 93, 1, 92, 0, 0, 0
4598, 1, 1636424842486, 1636424842578, 92, 0, 92, 0, 0, 0
4599, 1, 1636424843330, 1636424843422, 92, 0, 92, 0, 0, 0
4600, 1, 1636424843898, 1636424843990, 92, 0, 92, 0, 0, 0
4617, 1, 1636425044569, 1636425044662, 93, 1, 92, 0, 0, 0
4619, 1, 1636425045282, 1636425045374, 92, 0, 92, 0, 0, 0
4621, 1, 1636425045885, 1636425045990, 105, 1, 104, 1, 0, 1
4623, 1, 1636425046434, 1636425046550, 116, 0, 116, 0, 0, 0
4624, 1, 1636425046985, 1636425047102, 117, 1, 116, 1, 0, 1
4625, 1, 1636425047542, 1636425047682, 140, 0, 140, 0, 0, 0
4626, 1, 1636425048126, 1636425048218, 92, 0, 92, 0, 0, 0
4627, 1, 1636425048286, 1636425048378, 92, 0, 92, 0, 0, 0
4628, 1, 1636425048706, 1636425048797, 91, 0, 91, 0, 0, 0
4629, 1, 1636425049117, 1636425049205, 88, 0, 88, 0, 0, 0
4630, 1, 1636425049286, 1636425049413, 127, 0, 127, 0, 0, 0
4631, 1, 1636425049638, 1636425049729, 91, 0, 91, 0, 0, 0
4632, 1, 1636425049849, 1636425049942, 93, 1, 92, 0, 0, 0
4633, 1, 1636425050090, 1636425050182, 92, 0, 92, 0, 0, 0
4634, 1, 1636425050733, 1636425050825, 92, 1, 91, 0, 0, 0
4635, 1, 1636425051465, 1636425051550, 85, 0, 85, 0, 0, 0
4636, 1, 1636425051461, 1636425051550, 89, 0, 89, 0, 0, 0
4637, 1, 1636425051905, 1636425051990, 85, 0, 85, 0, 0, 0
4638, 1, 1636425051949, 1636425052037, 88, 0, 88, 0, 0, 0
4639, 1, 1636425052430, 1636425052545, 115, 0, 115, 0, 0, 0
4641, 1, 1636425052770, 1636425052862, 92, 0, 92, 0, 0, 0
4643, 1, 1636425053034, 1636425053126, 92, 0, 92, 0, 0, 0
4642, 1, 1636425053221, 1636425053334, 113, 1, 112, 0, 0, 0
4646, 1, 1636425053693, 1636425053786, 93, 1, 92, 0, 0, 0
4647, 1, 1636425053786, 1636425053877, 91, 0, 91, 0, 0, 0
4648, 1, 1636425054238, 1636425054330, 92, 0, 92, 0, 0, 0
4651, 1, 1636425055034, 1636425055125, 91, 0, 91, 0, 0, 0
4652, 1, 1636425055154, 1636425055246, 92, 0, 92, 0, 0, 0
4654, 1, 1636425055674, 1636425055766, 92, 0, 92, 0, 0, 0
4655, 1, 1636425055749, 1636425055841, 92, 1, 91, 1, 0, 1
4657, 1, 1636425056477, 1636425056570, 93, 1, 92, 0, 0, 0
4658, 1, 1636425056489, 1636425056581, 92, 1, 91, 1, 0, 1
4660, 1, 1636425056942, 1636425057034, 92, 0, 92, 0, 0, 0
4662, 1, 1636425057490, 1636425057582, 92, 0, 92, 0, 0, 0
4663, 1, 1636425057949, 1636425058042, 93, 1, 92, 1, 0, 1
4665, 1, 1636425058982, 1636425059073, 91, 0, 91, 0, 0, 0
4667, 1, 1636425059581, 1636425059674, 93, 1, 92, 0, 0, 0
4669, 1, 1636425060194, 1636425060286, 92, 0, 92, 0, 0, 0
4693, 1, 1636425073090, 1636425073182, 92, 0, 92, 0, 0, 0
4695, 1, 1636425073998, 1636425074090, 92, 0, 92, 0, 0, 0
4697, 1, 1636425074501, 1636425074593, 92, 1, 91, 0, 0, 0
4699, 1, 1636425074958, 1636425075050, 92, 0, 92, 0, 0, 0
4700, 1, 1636425075546, 1636425075638, 92, 0, 92, 0, 0, 0
4701, 1, 1636425076246, 1636425076338, 92, 0, 92, 0, 0, 0
4702, 1, 1636425076757, 1636425076849, 92, 1, 91, 0, 0, 0
4703, 1, 1636425077029, 1636425077113, 84, 0, 84, 0, 0, 0
4704, 1, 1636425077201, 1636425077293, 92, 1, 91, 0, 0, 0
4706, 1, 1636425077837, 1636425077925, 88, 0, 88, 0, 0, 0
4705, 1, 1636425077833, 1636425077925, 92, 1, 91, 0, 0, 0
4708, 1, 1636425078450, 1636425078542, 92, 0, 92, 0, 0, 0
4707, 1, 1636425078478, 1636425078569, 91, 0, 91, 0, 0, 0
4709, 1, 1636425078909, 1636425078993, 84, 0, 84, 0, 0, 0
4710, 1, 1636425079578, 1636425079669, 91, 0, 91, 0, 0, 0
4711, 1, 1636425079838, 1636425079930, 92, 0, 92, 0, 0, 0
4712, 1, 1636425080358, 1636425080449, 91, 0, 91, 0, 0, 0
4713, 1, 1636425080573, 1636425080666, 93, 1, 92, 0, 0, 0
4714, 1, 1636425080866, 1636425080958, 92, 0, 92, 0, 0, 0
4717, 1, 1636425081294, 1636425081386, 92, 0, 92, 0, 0, 0
4718, 1, 1636425081753, 1636425081846, 93, 1, 92, 0, 1, 1
4721, 1, 1636425082350, 1636425082441, 91, 0, 91, 0, 0, 0
4723, 1, 1636425082806, 1636425082898, 92, 0, 92, 0, 0, 0
4727, 1, 1636425083801, 1636425083890, 89, 1, 88, 0, 1, 1
4730, 1, 1636425084389, 1636425084481, 92, 1, 91, 0, 0, 0
4733, 1, 1636425085033, 1636425085126, 93, 1, 92, 0, 0, 0
4742, 1, 1636425091669, 1636425091758, 89, 1, 88, 0, 0, 0
4741, 1, 1636425091674, 1636425091761, 87, 0, 87, 0, 0, 0
4743, 1, 1636425092133, 1636425092226, 93, 1, 92, 0, 0, 0
4744, 1, 1636425092246, 1636425092337, 91, 0, 91, 0, 0, 0
4745, 1, 1636425092774, 1636425092869, 95, 0, 95, 0, 0, 0
4746, 1, 1636425092910, 1636425093002, 92, 0, 92, 0, 0, 0
4747, 1, 1636425093226, 1636425093317, 91, 0, 91, 0, 0, 0
4748, 1, 1636425093842, 1636425093934, 92, 0, 92, 0, 0, 0
4749, 1, 1636425094282, 1636425094374, 92, 0, 92, 0, 0, 0
4750, 1, 1636425094633, 1636425094729, 96, 1, 95, 0, 0, 0
4751, 1, 1636425095214, 1636425095306, 92, 0, 92, 0, 0, 0
4752, 1, 1636425095265, 1636425095386, 121, 1, 120, 0, 1, 1
4754, 1, 1636425095478, 1636425095570, 92, 0, 92, 0, 0, 0
4753, 1, 1636425095666, 1636425095757, 91, 0, 91, 0, 0, 0
4755, 1, 1636425095741, 1636425095834, 93, 1, 92, 0, 0, 0
4757, 1, 1636425095933, 1636425096026, 93, 1, 92, 0, 0, 0
4758, 1, 1636425096114, 1636425096205, 91, 0, 91, 0, 0, 0
4756, 1, 1636425096194, 1636425096326, 132, 0, 132, 0, 0, 0
4759, 1, 1636425096434, 1636425096522, 88, 0, 88, 0, 0, 0
4760, 1, 1636425096597, 1636425096686, 89, 0, 89, 0, 0, 0
4761, 1, 1636425096773, 1636425096866, 93, 1, 92, 1, 0, 1
4762, 1, 1636425096882, 1636425096974, 92, 0, 92, 0, 0, 0
4763, 1, 1636425097230, 1636425097322, 92, 0, 92, 0, 0, 0
4764, 1, 1636425097514, 1636425097606, 92, 0, 92, 0, 0, 0
4765, 1, 1636425098042, 1636425098134, 92, 0, 92, 0, 0, 0
4766, 1, 1636425098214, 1636425098305, 91, 0, 91, 0, 0, 0
4767, 1, 1636425098298, 1636425098390, 92, 0, 92, 0, 0, 0
4740, 1, 1636425098501, 1636425098594, 93, 1, 92, 1, 0, 1
4768, 1, 1636425098801, 1636425098894, 93, 1, 92, 0, 0, 0
4769, 1, 1636425098877, 1636425098970, 93, 1, 92, 0, 0, 0
4771, 1, 1636425099194, 1636425099285, 91, 0, 91, 0, 0, 0
4770, 1, 1636425099253, 1636425099345, 92, 1, 91, 0, 1, 1
4773, 1, 1636425099293, 1636425099381, 88, 0, 88, 0, 0, 0
4772, 1, 1636425099333, 1636425099425, 92, 1, 91, 0, 0, 0
4776, 1, 1636425099646, 1636425099738, 92, 0, 92, 0, 0, 0
4777, 1, 1636425099785, 1636425099878, 93, 1, 92, 0, 0, 0
4778, 1, 1636425100238, 1636425100329, 91, 0, 91, 0, 0, 0
4779, 1, 1636425100338, 1636425100430, 92, 0, 92, 0, 0, 0
4780, 1, 1636425100794, 1636425100886, 92, 0, 92, 0, 0, 0
4783, 1, 1636425101421, 1636425101514, 93, 0, 93, 0, 0, 0
4784, 1, 1636425101817, 1636425101905, 88, 0, 88, 0, 0, 0
4786, 1, 1636425102209, 1636425102302, 93, 1, 92, 0, 1, 1
4788, 1, 1636425102773, 1636425102866, 93, 1, 92, 0, 1, 1
4789, 1, 1636425102869, 1636425102962, 93, 1, 92, 0, 0, 0
4791, 1, 1636425103229, 1636425103321, 92, 1, 91, 1, 0, 1
4792, 1, 1636425103438, 1636425103529, 91, 0, 91, 0, 0, 0
4794, 1, 1636425103529, 1636425103622, 93, 1, 92, 0, 1, 1
4793, 1, 1636425103690, 1636425103782, 92, 0, 92, 0, 0, 0
4795, 1, 1636425104013, 1636425104105, 92, 1, 91, 0, 0, 0
4796, 1, 1636425104137, 1636425104229, 92, 1, 91, 0, 0, 0
4797, 1, 1636425104453, 1636425104546, 93, 1, 92, 0, 0, 0
4798, 1, 1636425105394, 1636425105486, 92, 0, 92, 0, 0, 0
4799, 1, 1636425105558, 1636425105650, 92, 0, 92, 0, 0, 0
4800, 1, 1636425106042, 1636425106134, 92, 0, 92, 0, 0, 0
4801, 1, 1636425106493, 1636425106586, 93, 1, 92, 0, 0, 0
4803, 1, 1636425106950, 1636425107042, 92, 0, 92, 0, 0, 0
4804, 1, 1636425107410, 1636425107501, 91, 0, 91, 0, 0, 0
4806, 1, 1636425107533, 1636425107625, 92, 1, 91, 0, 0, 0
4807, 1, 1636425107862, 1636425107954, 92, 0, 92, 0, 0, 0
4810, 1, 1636425109234, 1636425109377, 143, 0, 143, 0, 0, 0
4812, 1, 1636425110038, 1636425110129, 91, 0, 91, 0, 0, 0
4814, 1, 1636425110554, 1636425110646, 92, 0, 92, 0, 0, 0
4818, 1, 1636425111010, 1636425111102, 92, 0, 92, 0, 0, 0
4817, 1, 1636425111461, 1636425111554, 93, 1, 92, 0, 0, 0
4820, 1, 1636425111554, 1636425111645, 91, 0, 91, 0, 0, 0
4822, 1, 1636425112158, 1636425112286, 128, 0, 128, 0, 0, 0
4823, 1, 1636425112722, 1636425112825, 103, 0, 103, 0, 0, 0
4825, 1, 1636425113266, 1636425113357, 91, 0, 91, 0, 0, 0
4826, 1, 1636425113794, 1636425113890, 96, 0, 96, 0, 0, 0
4827, 1, 1636425114254, 1636425114346, 92, 0, 92, 0, 0, 0
4828, 1, 1636425114722, 1636425114814, 92, 0, 92, 0, 0, 0
4829, 1, 1636425115182, 1636425115274, 92, 0, 92, 0, 0, 0
4831, 1, 1636425115769, 1636425115862, 93, 1, 92, 0, 0, 0
4832, 1, 1636425116566, 1636425116698, 132, 0, 132, 0, 0, 0
4833, 1, 1636425117058, 1636425117150, 92, 0, 92, 0, 0, 0
4834, 1, 1636425117133, 1636425117222, 89, 1, 88, 0, 1, 1
4835, 1, 1636425117654, 1636425117746, 92, 0, 92, 0, 0, 0
4836, 1, 1636425117721, 1636425117838, 117, 1, 116, 0, 1, 1
4837, 1, 1636425118201, 1636425118289, 88, 0, 88, 0, 0, 0
4838, 1, 1636425118305, 1636425118398, 93, 1, 92, 0, 0, 0
4840, 1, 1636425118650, 1636425118742, 92, 0, 92, 0, 0, 0
4839, 1, 1636425118761, 1636425118854, 93, 1, 92, 0, 0, 0
4841, 1, 1636425119106, 1636425119222, 116, 0, 116, 0, 0, 0
4842, 1, 1636425119658, 1636425119750, 92, 0, 92, 0, 0, 0
4843, 1, 1636425119737, 1636425119870, 133, 1, 132, 0, 0, 0
4844, 1, 1636425120305, 1636425120398, 93, 1, 92, 0, 0, 0
4845, 1, 1636425120341, 1636425120433, 92, 1, 91, 1, 0, 1
4846, 1, 1636425120794, 1636425120886, 92, 0, 92, 0, 0, 0
4847, 1, 1636425120969, 1636425121062, 93, 1, 92, 0, 1, 1
4848, 1, 1636425121249, 1636425121341, 92, 1, 91, 0, 1, 1
4850, 1, 1636425121286, 1636425121377, 91, 0, 91, 0, 0, 0
4851, 1, 1636425121578, 1636425121669, 91, 0, 91, 0, 0, 0
4849, 1, 1636425121705, 1636425121797, 92, 1, 91, 0, 0, 0
4853, 1, 1636425121825, 1636425121913, 88, 1, 87, 0, 0, 0
4852, 1, 1636425122034, 1636425122126, 92, 0, 92, 0, 0, 0
4854, 1, 1636425122162, 1636425122254, 92, 0, 92, 0, 0, 0
4855, 1, 1636425122409, 1636425122502, 93, 1, 92, 1, 0, 1
4856, 1, 1636425122486, 1636425122578, 92, 0, 92, 0, 0, 0
4857, 1, 1636425122866, 1636425122961, 95, 0, 95, 0, 0, 0
4858, 1, 1636425122961, 1636425123054, 93, 1, 92, 1, 0, 1
4830, 1, 1636425123090, 1636425123182, 92, 0, 92, 0, 0, 0
4859, 1, 1636425123402, 1636425123494, 92, 0, 92, 0, 0, 0
4860, 1, 1636425123457, 1636425123549, 92, 1, 91, 0, 0, 0
4862, 1, 1636425123838, 1636425123929, 91, 0, 91, 0, 0, 0
4861, 1, 1636425123862, 1636425123954, 92, 0, 92, 0, 0, 0
4863, 1, 1636425124089, 1636425124181, 92, 1, 91, 0, 0, 0
4864, 1, 1636425124429, 1636425124522, 93, 1, 92, 1, 0, 1
4865, 1, 1636425124882, 1636425124974, 92, 0, 92, 0, 0, 0
4866, 1, 1636425124882, 1636425124974, 92, 0, 92, 0, 0, 0
4869, 1, 1636425125534, 1636425125626, 92, 0, 92, 0, 0, 0
4870, 1, 1636425125717, 1636425125805, 88, 0, 88, 0, 0, 0
4872, 1, 1636425125989, 1636425126082, 93, 1, 92, 1, 0, 1
4871, 1, 1636425126153, 1636425126237, 84, 0, 84, 0, 0, 0
4874, 1, 1636425126465, 1636425126557, 92, 0, 92, 0, 0, 0
4875, 1, 1636425126593, 1636425126686, 93, 1, 92, 1, 0, 1
4877, 1, 1636425126918, 1636425127010, 92, 0, 92, 0, 0, 0
4876, 1, 1636425127041, 1636425127134, 93, 1, 92, 1, 0, 1
4879, 1, 1636425127618, 1636425127710, 92, 0, 92, 0, 0, 0
4881, 1, 1636425127961, 1636425128053, 92, 0, 92, 0, 0, 0
4882, 1, 1636425128253, 1636425128346, 93, 0, 93, 0, 0, 0
4883, 1, 1636425128554, 1636425128646, 92, 0, 92, 0, 0, 0
4885, 1, 1636425128974, 1636425129065, 91, 0, 91, 0, 0, 0
4884, 1, 1636425129006, 1636425129097, 91, 0, 91, 0, 0, 0
4886, 1, 1636425129598, 1636425129690, 92, 0, 92, 0, 0, 0
4889, 1, 1636425130198, 1636425130289, 91, 0, 91, 0, 0, 0
4890, 1, 1636425130653, 1636425130746, 93, 1, 92, 0, 0, 0
4892, 1, 1636425131114, 1636425131206, 92, 0, 92, 0, 0, 0
4895, 1, 1636425132026, 1636425132118, 92, 0, 92, 0, 0, 0
4897, 1, 1636425132618, 1636425132710, 92, 0, 92, 0, 0, 0
4898, 1, 1636425133074, 1636425133166, 92, 0, 92, 0, 0, 0
4900, 1, 1636425133586, 1636425133678, 92, 0, 92, 0, 0, 0
4901, 1, 1636425134138, 1636425134230, 92, 0, 92, 0, 0, 0
4902, 1, 1636425134590, 1636425134681, 91, 0, 91, 0, 0, 0
4903, 1, 1636425135094, 1636425135186, 92, 0, 92, 0, 0, 0
4904, 1, 1636425135642, 1636425135734, 92, 0, 92, 0, 0, 0
4906, 1, 1636425136045, 1636425136133, 88, 0, 88, 0, 0, 0
4905, 1, 1636425136089, 1636425136177, 88, 0, 88, 0, 0, 0
4907, 1, 1636425136538, 1636425136630, 92, 0, 92, 0, 0, 0
4908, 1, 1636425136606, 1636425136693, 87, 0, 87, 0, 0, 0
4909, 1, 1636425137050, 1636425137142, 92, 0, 92, 0, 0, 0
4910, 1, 1636425137286, 1636425137378, 92, 0, 92, 0, 0, 0
4911, 1, 1636425137726, 1636425137818, 92, 0, 92, 0, 0, 0
4912, 1, 1636425137806, 1636425137898, 92, 0, 92, 0, 0, 0
4913, 1, 1636425138234, 1636425138325, 91, 0, 91, 0, 0, 0
4914, 1, 1636425138333, 1636425138425, 92, 0, 92, 0, 0, 0
4915, 1, 1636425138789, 1636425138882, 93, 1, 92, 0, 0, 0
4916, 1, 1636425139254, 1636425139346, 92, 0, 92, 0, 0, 0
4918, 1, 1636425139721, 1636425139830, 109, 0, 109, 0, 0, 0
4917, 1, 1636425139706, 1636425139830, 124, 0, 124, 0, 0, 0
4920, 1, 1636425140217, 1636425140314, 97, 1, 96, 0, 0, 0
4919, 1, 1636425140222, 1636425140314, 92, 0, 92, 0, 0, 0
4922, 1, 1636425140277, 1636425140361, 84, 0, 84, 0, 0, 0
4921, 1, 1636425140677, 1636425140765, 88, 0, 88, 0, 0, 0
4923, 1, 1636425140717, 1636425140809, 92, 1, 91, 0, 1, 1
4924, 1, 1636425141122, 1636425141214, 92, 0, 92, 0, 0, 0
4926, 1, 1636425141366, 1636425141458, 92, 0, 92, 0, 0, 0
4927, 1, 1636425141382, 1636425141474, 92, 0, 92, 0, 0, 0
4925, 1, 1636425141578, 1636425141682, 104, 0, 104, 0, 0, 0
4928, 1, 1636425141950, 1636425142042, 92, 0, 92, 0, 0, 0
4929, 1, 1636425142122, 1636425142210, 88, 0, 88, 0, 0, 0
4930, 1, 1636425142250, 1636425142341, 91, 0, 91, 0, 0, 0
4899, 1, 1636425142449, 1636425142541, 92, 1, 91, 0, 0, 0
4931, 1, 1636425142494, 1636425142586, 92, 0, 92, 0, 0, 0
4933, 1, 1636425142754, 1636425142845, 91, 0, 91, 0, 0, 0
4932, 1, 1636425142946, 1636425143037, 91, 0, 91, 0, 0, 0
4934, 1, 1636425143206, 1636425143297, 91, 0, 91, 0, 0, 0
4935, 1, 1636425143426, 1636425143518, 92, 0, 92, 0, 0, 0
4937, 1, 1636425143830, 1636425143921, 91, 0, 91, 0, 0, 0
4936, 1, 1636425143877, 1636425143965, 88, 0, 88, 0, 0, 0
4939, 1, 1636425143981, 1636425144069, 88, 0, 88, 0, 0, 0
4938, 1, 1636425144278, 1636425144370, 92, 0, 92, 0, 0, 0
4940, 1, 1636425144385, 1636425144478, 93, 1, 92, 0, 1, 1
4941, 1, 1636425144590, 1636425144682, 92, 0, 92, 0, 0, 0
4943, 1, 1636425144822, 1636425144914, 92, 0, 92, 0, 0, 0
4942, 1, 1636425145045, 1636425145138, 93, 1, 92, 1, 0, 1
4944, 1, 1636425145274, 1636425145365, 91, 0, 91, 0, 0, 0
4945, 1, 1636425145306, 1636425145398, 92, 0, 92, 0, 0, 0
4946, 1, 1636425145550, 1636425145642, 92, 0, 92, 0, 0, 0
4947, 1, 1636425145761, 1636425145854, 93, 1, 92, 0, 0, 0
4948, 1, 1636425146014, 1636425146106, 92, 0, 92, 0, 0, 0
4949, 1, 1636425146314, 1636425146406, 92, 0, 92, 0, 0, 0
4952, 1, 1636425146442, 1636425146534, 92, 0, 92, 0, 0, 0
4951, 1, 1636425146465, 1636425146558, 93, 1, 92, 1, 0, 1
4950, 1, 1636425146766, 1636425146858, 92, 0, 92, 0, 0, 0
4953, 1, 1636425146922, 1636425147014, 92, 0, 92, 0, 0, 0
4954, 1, 1636425147186, 1636425147278, 92, 0, 92, 0, 0, 0
4955, 1, 1636425147642, 1636425147733, 91, 0, 91, 0, 0, 0
4956, 1, 1636425147814, 1636425147905, 91, 0, 91, 0, 0, 0
4957, 1, 1636425147942, 1636425148034, 92, 0, 92, 0, 0, 0
4958, 1, 1636425148093, 1636425148186, 93, 1, 92, 0, 0, 0
4959, 1, 1636425148397, 1636425148489, 92, 1, 91, 0, 0, 0
4960, 1, 1636425148530, 1636425148622, 92, 0, 92, 0, 0, 0
4962, 1, 1636425148930, 1636425149021, 91, 0, 91, 0, 0, 0
4961, 1, 1636425148985, 1636425149078, 93, 1, 92, 1, 0, 1
4963, 1, 1636425149133, 1636425149230, 97, 1, 96, 0, 0, 0
4964, 1, 1636425149309, 1636425149402, 93, 1, 92, 0, 0, 0
4965, 1, 1636425149381, 1636425149474, 93, 1, 92, 0, 0, 0
4966, 1, 1636425149638, 1636425149729, 91, 0, 91, 0, 0, 0
4967, 1, 1636425150122, 1636425150214, 92, 0, 92, 0, 0, 0
4969, 1, 1636425150186, 1636425150277, 91, 0, 91, 0, 0, 0
4970, 1, 1636425150418, 1636425150509, 91, 0, 91, 0, 0, 0
4968, 1, 1636425150574, 1636425150665, 91, 0, 91, 0, 0, 0
4971, 1, 1636425150678, 1636425150770, 92, 0, 92, 0, 0, 0
4972, 1, 1636425151130, 1636425151222, 92, 0, 92, 0, 0, 0
4973, 1, 1636425151314, 1636425151406, 92, 0, 92, 0, 0, 0
4975, 1, 1636425151694, 1636425151785, 91, 0, 91, 0, 0, 0
4974, 1, 1636425151766, 1636425151858, 92, 0, 92, 0, 0, 0
4976, 1, 1636425151793, 1636425151886, 93, 1, 92, 1, 0, 1
4977, 1, 1636425152149, 1636425152238, 89, 0, 89, 0, 0, 0
4978, 1, 1636425152238, 1636425152330, 92, 0, 92, 0, 0, 0
4979, 1, 1636425152357, 1636425152446, 89, 0, 89, 0, 0, 0
4981, 1, 1636425152686, 1636425152778, 92, 0, 92, 0, 0, 0
4980, 1, 1636425152801, 1636425152894, 93, 1, 92, 0, 0, 0
4982, 1, 1636425153138, 1636425153230, 92, 0, 92, 0, 0, 0
4983, 1, 1636425153214, 1636425153306, 92, 0, 92, 0, 0, 0
4984, 1, 1636425153477, 1636425153570, 93, 1, 92, 0, 1, 1
4985, 1, 1636425153858, 1636425153950, 92, 0, 92, 0, 0, 0
4986, 1, 1636425153941, 1636425154034, 93, 1, 92, 0, 1, 1
4987, 1, 1636425154318, 1636425154410, 92, 0, 92, 0, 0, 0
4989, 1, 1636425154390, 1636425154482, 92, 0, 92, 0, 0, 0
4990, 1, 1636425154686, 1636425154774, 88, 0, 88, 0, 0, 0
4988, 1, 1636425154774, 1636425154866, 92, 0, 92, 0, 0, 0
4991, 1, 1636425154841, 1636425154934, 93, 1, 92, 0, 1, 1
4992, 1, 1636425155178, 1636425155270, 92, 0, 92, 0, 0, 0
4993, 1, 1636425155633, 1636425155725, 92, 0, 92, 0, 0, 0
4994, 1, 1636425155870, 1636425155962, 92, 0, 92, 0, 0, 0
4997, 1, 1636425156086, 1636425156178, 92, 0, 92, 0, 0, 0
4995, 1, 1636425156090, 1636425156181, 91, 0, 91, 0, 0, 0
4996, 1, 1636425156313, 1636425156409, 96, 1, 95, 0, 0, 0
4998, 1, 1636425156562, 1636425156653, 91, 0, 91, 0, 0, 0
5000, 1, 1636425156854, 1636425156946, 92, 0, 92, 0, 0, 0
4999, 1, 1636425157013, 1636425157110, 97, 1, 96, 0, 1, 1
5002, 1, 1636425157182, 1636425157274, 92, 0, 92, 0, 0, 0
5001, 1, 1636425157310, 1636425157402, 92, 0, 92, 0, 0, 0
5003, 1, 1636425157341, 1636425157434, 93, 1, 92, 0, 0, 0
5004, 1, 1636425157978, 1636425158069, 91, 0, 91, 0, 0, 0
5005, 1, 1636425158110, 1636425158202, 92, 0, 92, 0, 0, 0
5006, 1, 1636425158442, 1636425158534, 92, 0, 92, 0, 0, 0
5008, 1, 1636425158562, 1636425158654, 92, 0, 92, 0, 0, 0
5010, 1, 1636425158810, 1636425158898, 88, 0, 88, 0, 0, 0
5007, 1, 1636425158894, 1636425158986, 92, 0, 92, 0, 0, 0
5009, 1, 1636425159021, 1636425159114, 93, 1, 92, 1, 0, 1
5011, 1, 1636425159110, 1636425159202, 92, 0, 92, 0, 0, 0
5013, 1, 1636425159565, 1636425159654, 89, 1, 88, 0, 0, 0
5012, 1, 1636425159562, 1636425159654, 92, 0, 92, 0, 0, 0
5015, 1, 1636425160014, 1636425160102, 88, 0, 88, 0, 0, 0
5014, 1, 1636425160014, 1636425160102, 88, 0, 88, 0, 0, 0
5016, 1, 1636425160206, 1636425160298, 92, 0, 92, 0, 0, 0
5017, 1, 1636425160557, 1636425160650, 93, 1, 92, 0, 0, 0
5018, 1, 1636425160682, 1636425160774, 92, 0, 92, 0, 0, 0
5020, 1, 1636425161005, 1636425161097, 92, 1, 91, 0, 0, 0
5021, 1, 1636425161089, 1636425161181, 92, 1, 91, 0, 0, 0
5019, 1, 1636425161133, 1636425161225, 92, 1, 91, 0, 0, 0
5022, 1, 1636425161145, 1636425161237, 92, 1, 91, 0, 1, 1
5023, 1, 1636425161970, 1636425162062, 92, 0, 92, 0, 0, 0
5024, 1, 1636425161978, 1636425162065, 87, 0, 87, 0, 0, 0
5025, 1, 1636425162425, 1636425162514, 89, 0, 89, 0, 0, 0
5027, 1, 1636425162490, 1636425162582, 92, 0, 92, 0, 0, 0
5029, 1, 1636425162818, 1636425162910, 92, 0, 92, 0, 0, 0
5026, 1, 1636425162877, 1636425162970, 93, 1, 92, 1, 0, 1
5028, 1, 1636425162942, 1636425163033, 91, 0, 91, 0, 0, 0
5030, 1, 1636425163294, 1636425163386, 92, 0, 92, 0, 0, 0
5032, 1, 1636425163530, 1636425163622, 92, 0, 92, 0, 0, 0
5031, 1, 1636425163750, 1636425163842, 92, 0, 92, 0, 0, 0
5033, 1, 1636425163986, 1636425164078, 92, 0, 92, 0, 0, 0
5034, 1, 1636425164205, 1636425164298, 93, 1, 92, 0, 1, 1
5035, 1, 1636425164209, 1636425164301, 92, 1, 91, 0, 0, 0
5037, 1, 1636425164518, 1636425164609, 91, 0, 91, 0, 0, 0
5036, 1, 1636425164666, 1636425164757, 91, 0, 91, 0, 0, 0
5038, 1, 1636425164974, 1636425165066, 92, 0, 92, 0, 0, 0
5040, 1, 1636425165057, 1636425165150, 93, 1, 92, 1, 0, 1
5039, 1, 1636425165118, 1636425165210, 92, 0, 92, 0, 0, 0
5041, 1, 1636425165461, 1636425165554, 93, 1, 92, 1, 0, 1
5042, 1, 1636425165930, 1636425166022, 92, 0, 92, 0, 0, 0
5043, 1, 1636425165938, 1636425166030, 92, 0, 92, 0, 0, 0
5046, 1, 1636425166386, 1636425166478, 92, 0, 92, 0, 0, 0
5047, 1, 1636425166842, 1636425166933, 91, 0, 91, 0, 0, 0
5048, 1, 1636425167110, 1636425167202, 92, 0, 92, 0, 0, 0
5049, 1, 1636425167370, 1636425167461, 91, 0, 91, 0, 0, 0
5051, 1, 1636425167818, 1636425167910, 92, 0, 92, 0, 0, 0
5050, 1, 1636425167821, 1636425167917, 96, 0, 96, 0, 0, 0
5052, 1, 1636425168274, 1636425168365, 91, 0, 91, 0, 0, 0
5054, 1, 1636425168282, 1636425168373, 91, 0, 91, 0, 0, 0
5057, 1, 1636425168786, 1636425168878, 92, 0, 92, 0, 0, 0
5058, 1, 1636425169246, 1636425169337, 91, 0, 91, 0, 0, 0
5059, 1, 1636425169317, 1636425169410, 93, 1, 92, 0, 0, 0
5060, 1, 1636425169541, 1636425169629, 88, 0, 88, 0, 0, 0
5061, 1, 1636425170122, 1636425170213, 91, 0, 91, 0, 0, 0
5062, 1, 1636425170257, 1636425170345, 88, 0, 88, 0, 0, 0
5063, 1, 1636425170710, 1636425170801, 91, 0, 91, 0, 0, 0
5065, 1, 1636425171117, 1636425171205, 88, 0, 88, 0, 0, 0
5064, 1, 1636425171161, 1636425171253, 92, 0, 92, 0, 0, 0
5066, 1, 1636425171457, 1636425171550, 93, 1, 92, 0, 1, 1
5067, 1, 1636425171565, 1636425171658, 93, 1, 92, 0, 0, 0
5068, 1, 1636425172021, 1636425172113, 92, 1, 91, 1, 0, 1
5069, 1, 1636425172086, 1636425172174, 88, 0, 88, 0, 0, 0
5070, 1, 1636425172542, 1636425172634, 92, 0, 92, 0, 0, 0
5071, 1, 1636425173074, 1636425173162, 88, 0, 88, 0, 0, 0
5073, 1, 1636425173294, 1636425173386, 92, 0, 92, 0, 0, 0
5072, 1, 1636425173521, 1636425173613, 92, 0, 92, 0, 0, 0
5074, 1, 1636425173562, 1636425173653, 91, 0, 91, 0, 0, 0
5075, 1, 1636425174330, 1636425174421, 91, 0, 91, 0, 0, 0
5076, 1, 1636425174369, 1636425174461, 92, 1, 91, 1, 0, 1
5077, 1, 1636425174938, 1636425175030, 92, 0, 92, 0, 0, 0
5078, 1, 1636425174993, 1636425175086, 93, 1, 92, 0, 0, 0
5080, 1, 1636425175390, 1636425175482, 92, 0, 92, 0, 0, 0
5079, 1, 1636425175441, 1636425175529, 88, 0, 88, 0, 0, 0
5081, 1, 1636425175482, 1636425175573, 91, 0, 91, 0, 0, 0
5082, 1, 1636425175841, 1636425175934, 93, 1, 92, 0, 0, 0
5089, 1, 1636425176974, 1636425177066, 92, 0, 92, 0, 0, 0
5090, 1, 1636425177346, 1636425177438, 92, 0, 92, 0, 0, 0
5092, 1, 1636425178169, 1636425178261, 92, 0, 92, 0, 0, 0
5056, 1, 1636425178185, 1636425178278, 93, 1, 92, 0, 0, 0
5101, 1, 1636425179590, 1636425179682, 92, 0, 92, 0, 0, 0
5103, 1, 1636425181521, 1636425181614, 93, 1, 92, 0, 1, 1
5104, 1, 1636425182362, 1636425182454, 92, 0, 92, 0, 0, 0
5106, 1, 1636425185825, 1636425185918, 93, 1, 92, 0, 1, 1
5107, 1, 1636425186229, 1636425186322, 93, 1, 92, 0, 0, 0
5109, 1, 1636425186429, 1636425186614, 185, 1, 184, 0, 0, 0
5108, 1, 1636425186705, 1636425186797, 92, 1, 91, 0, 1, 1
5110, 1, 1636425187014, 1636425187106, 92, 0, 92, 0, 0, 0
5112, 1, 1636425187158, 1636425187250, 92, 0, 92, 0, 0, 0
5111, 1, 1636425187473, 1636425187566, 93, 1, 92, 0, 1, 1
5113, 1, 1636425187606, 1636425187698, 92, 0, 92, 0, 0, 0
5114, 1, 1636425188402, 1636425188494, 92, 0, 92, 0, 0, 0
5098, 1, 1636425188746, 1636425188838, 92, 0, 92, 0, 0, 0
5115, 1, 1636425188838, 1636425188930, 92, 0, 92, 0, 0, 0
5117, 1, 1636425189081, 1636425189173, 92, 1, 91, 0, 1, 1
5122, 1, 1636425189485, 1636425189582, 97, 1, 96, 0, 1, 1
5120, 1, 1636425189525, 1636425189614, 89, 0, 89, 0, 0, 0
5124, 1, 1636425189942, 1636425190034, 92, 0, 92, 0, 0, 0
5126, 1, 1636425190349, 1636425190437, 88, 0, 88, 0, 0, 0
5125, 1, 1636425190393, 1636425190482, 89, 1, 88, 0, 0, 0
5127, 1, 1636425190861, 1636425190957, 96, 1, 95, 0, 1, 1
5105, 1, 1636425190906, 1636425190997, 91, 0, 91, 0, 0, 0
5128, 1, 1636425191001, 1636425191093, 92, 1, 91, 0, 1, 1
5129, 1, 1636425191309, 1636425191397, 88, 0, 88, 0, 0, 0
5131, 1, 1636425191453, 1636425191541, 88, 0, 88, 0, 0, 0
5133, 1, 1636425192121, 1636425192213, 92, 1, 91, 1, 0, 1
5134, 1, 1636425192741, 1636425192829, 88, 0, 88, 0, 0, 0
5135, 1, 1636425192785, 1636425192873, 88, 0, 88, 0, 0, 0
5137, 1, 1636425193206, 1636425193298, 92, 0, 92, 0, 0, 0
5136, 1, 1636425193234, 1636425193325, 91, 0, 91, 0, 0, 0
5140, 1, 1636425194022, 1636425194113, 91, 0, 91, 0, 0, 0
5142, 1, 1636425194926, 1636425195018, 92, 0, 92, 0, 0, 0
5144, 1, 1636425195382, 1636425195474, 92, 0, 92, 0, 0, 0
5147, 1, 1636425196654, 1636425196746, 92, 0, 92, 0, 0, 0
5149, 1, 1636425197505, 1636425197598, 93, 1, 92, 0, 1, 1
5150, 1, 1636425198146, 1636425198238, 92, 0, 92, 0, 0, 0
5151, 1, 1636425198721, 1636425198814, 93, 1, 92, 0, 0, 0
5152, 1, 1636425199169, 1636425199262, 93, 0, 93, 0, 0, 0
5158, 1, 1636425200602, 1636425200693, 91, 0, 91, 0, 0, 0
5160, 1, 1636425201714, 1636425201806, 92, 0, 92, 0, 0, 0
5162, 1, 1636425202322, 1636425202414, 92, 0, 92, 0, 0, 0
5163, 1, 1636425202637, 1636425202729, 92, 1, 91, 0, 0, 0
5164, 1, 1636425203090, 1636425203182, 92, 0, 92, 0, 0, 0
5167, 1, 1636425204518, 1636425204610, 92, 0, 92, 0, 0, 0
5170, 1, 1636425205406, 1636425205498, 92, 0, 92, 0, 0, 0
5171, 1, 1636425206194, 1636425206285, 91, 0, 91, 0, 0, 0
5173, 1, 1636425206362, 1636425206454, 92, 0, 92, 0, 0, 0
5148, 1, 1636425206649, 1636425206741, 92, 0, 92, 0, 0, 0
5175, 1, 1636425206974, 1636425207066, 92, 0, 92, 0, 0, 0
5177, 1, 1636425208242, 1636425208334, 92, 0, 92, 0, 0, 0
5178, 1, 1636425209358, 1636425209573, 215, 0, 215, 0, 0, 0
5180, 1, 1636425210018, 1636425210109, 91, 0, 91, 0, 0, 0
5182, 1, 1636425210030, 1636425210121, 91, 0, 91, 0, 0, 0
5185, 1, 1636425210385, 1636425210478, 93, 1, 92, 1, 0, 1
5186, 1, 1636425210974, 1636425211065, 91, 0, 91, 0, 0, 0
5189, 1, 1636425212266, 1636425212358, 92, 0, 92, 0, 0, 0
5190, 1, 1636425213286, 1636425213378, 92, 0, 92, 0, 0, 0
5191, 1, 1636425213738, 1636425213830, 92, 0, 92, 0, 0, 0
5192, 1, 1636425214074, 1636425214165, 91, 0, 91, 0, 0, 0
5193, 1, 1636425214206, 1636425214298, 92, 0, 92, 0, 0, 0
5196, 1, 1636425214789, 1636425214878, 89, 0, 89, 0, 0, 0
5199, 1, 1636425215942, 1636425216033, 91, 0, 91, 0, 0, 0
5176, 1, 1636425216950, 1636425217042, 92, 0, 92, 0, 0, 0
5202, 1, 1636425217261, 1636425217354, 93, 1, 92, 0, 0, 0
5203, 1, 1636425217717, 1636425217809, 92, 1, 91, 0, 0, 0
5205, 1, 1636425217733, 1636425217826, 93, 1, 92, 0, 0, 0
5206, 1, 1636425218430, 1636425218521, 91, 0, 91, 0, 0, 0
5207, 1, 1636425218578, 1636425218669, 91, 0, 91, 0, 0, 0
5208, 1, 1636425219738, 1636425219830, 92, 0, 92, 0, 0, 0
5213, 1, 1636425221038, 1636425221130, 92, 0, 92, 0, 0, 0
5214, 1, 1636425221494, 1636425221586, 92, 0, 92, 0, 0, 0
5215, 1, 1636425221802, 1636425221894, 92, 0, 92, 0, 0, 0
5217, 1, 1636425222242, 1636425222334, 92, 0, 92, 0, 0, 0
5219, 1, 1636425222730, 1636425222821, 91, 0, 91, 0, 0, 0
5221, 1, 1636425223805, 1636425223897, 92, 1, 91, 0, 0, 0
5224, 1, 1636425224721, 1636425224809, 88, 0, 88, 0, 0, 0
5225, 1, 1636425225334, 1636425225457, 123, 0, 123, 0, 0, 0
5227, 1, 1636425225721, 1636425225814, 93, 1, 92, 0, 1, 1
5229, 1, 1636425226150, 1636425226242, 92, 0, 92, 0, 0, 0
5230, 1, 1636425226697, 1636425226790, 93, 1, 92, 1, 0, 1
5204, 1, 1636425227254, 1636425227346, 92, 0, 92, 0, 0, 0
5233, 1, 1636425227701, 1636425227794, 93, 1, 92, 1, 0, 1
5235, 1, 1636425228950, 1636425229042, 92, 0, 92, 0, 0, 0
5236, 1, 1636425229410, 1636425229501, 91, 0, 91, 0, 0, 0
5237, 1, 1636425229674, 1636425229766, 92, 0, 92, 0, 0, 0
5238, 1, 1636425230346, 1636425230438, 92, 0, 92, 0, 0, 0
5239, 1, 1636425230421, 1636425230514, 93, 1, 92, 0, 1, 1
5243, 1, 1636425231189, 1636425231282, 93, 1, 92, 0, 0, 0
5244, 1, 1636425231366, 1636425231457, 91, 0, 91, 0, 0, 0
5247, 1, 1636425232825, 1636425232918, 93, 1, 92, 1, 0, 1
5248, 1, 1636425233286, 1636425233378, 92, 0, 92, 0, 0, 0
5249, 1, 1636425233462, 1636425233554, 92, 0, 92, 0, 0, 0
5252, 1, 1636425234589, 1636425234682, 93, 1, 92, 0, 0, 0
5253, 1, 1636425234865, 1636425234958, 93, 1, 92, 1, 0, 1
5259, 1, 1636425236822, 1636425236914, 92, 0, 92, 0, 0, 0
5260, 1, 1636425237277, 1636425237369, 92, 1, 91, 0, 1, 1
5262, 1, 1636425237293, 1636425237421, 128, 0, 128, 0, 0, 0
5234, 1, 1636425237549, 1636425237637, 88, 0, 88, 0, 0, 0
5265, 1, 1636425238394, 1636425238486, 92, 0, 92, 0, 0, 0
5266, 1, 1636425238982, 1636425239074, 92, 0, 92, 0, 0, 0
5267, 1, 1636425240594, 1636425240686, 92, 0, 92, 0, 0, 0
5268, 1, 1636425241149, 1636425241242, 93, 1, 92, 1, 0, 1
5270, 1, 1636425241950, 1636425242042, 92, 0, 92, 0, 0, 0
5273, 1, 1636425242202, 1636425242318, 116, 0, 116, 0, 0, 0
5271, 1, 1636425242406, 1636425242497, 91, 0, 91, 0, 0, 0
5275, 1, 1636425243045, 1636425243134, 89, 0, 89, 0, 0, 0
5277, 1, 1636425244094, 1636425244186, 92, 0, 92, 0, 0, 0
5278, 1, 1636425244894, 1636425244986, 92, 0, 92, 0, 0, 0
5279, 1, 1636425244894, 1636425244986, 92, 0, 92, 0, 0, 0
5280, 1, 1636425245346, 1636425245438, 92, 0, 92, 0, 0, 0
5283, 1, 1636425245785, 1636425245877, 92, 1, 91, 0, 1, 1
5284, 1, 1636425245969, 1636425246074, 105, 1, 104, 0, 1, 1
5286, 1, 1636425246194, 1636425246286, 92, 0, 92, 0, 0, 0
5285, 1, 1636425246438, 1636425246529, 91, 0, 91, 0, 0, 0
5289, 1, 1636425246878, 1636425246970, 92, 0, 92, 0, 0, 0
5264, 1, 1636425247857, 1636425247949, 92, 1, 91, 1, 0, 1
5291, 1, 1636425247901, 1636425247993, 92, 1, 91, 0, 0, 0
5294, 1, 1636425248653, 1636425248746, 93, 1, 92, 0, 0, 0
5295, 1, 1636425249078, 1636425249170, 92, 0, 92, 0, 0, 0
5296, 1, 1636425249533, 1636425249626, 93, 1, 92, 1, 0, 1
5297, 1, 1636425249606, 1636425249698, 92, 0, 92, 0, 0, 0
5298, 1, 1636425249754, 1636425249845, 91, 0, 91, 0, 0, 0
5299, 1, 1636425250201, 1636425250293, 92, 1, 91, 0, 0, 0
5300, 1, 1636425250337, 1636425250426, 89, 0, 89, 0, 0, 0
5301, 1, 1636425250662, 1636425250753, 91, 0, 91, 0, 0, 0
5302, 1, 1636425251590, 1636425251682, 92, 0, 92, 0, 0, 0
5304, 1, 1636425252334, 1636425252425, 91, 0, 91, 0, 0, 0
5307, 1, 1636425253286, 1636425253378, 92, 0, 92, 0, 0, 0
5308, 1, 1636425253333, 1636425253425, 92, 1, 91, 1, 0, 1
5311, 1, 1636425253522, 1636425253613, 91, 0, 91, 0, 0, 0
5309, 1, 1636425253786, 1636425253878, 92, 0, 92, 0, 0, 0
5312, 1, 1636425253977, 1636425254069, 92, 1, 91, 0, 0, 0
5313, 1, 1636425254342, 1636425254433, 91, 0, 91, 0, 0, 0
5314, 1, 1636425254721, 1636425254814, 93, 1, 92, 0, 0, 0
5316, 1, 1636425255590, 1636425255682, 92, 2, 90, 1, 1, 2
5318, 1, 1636425256382, 1636425256473, 91, 0, 91, 0, 0, 0
5323, 1, 1636425257522, 1636425257613, 91, 0, 91, 0, 0, 0
5324, 1, 1636425257665, 1636425257758, 93, 1, 92, 1, 0, 1
5326, 1, 1636425258118, 1636425258213, 95, 0, 95, 0, 0, 0
5293, 1, 1636425258158, 1636425258253, 95, 0, 95, 0, 0, 0
5327, 1, 1636425258381, 1636425258474, 93, 1, 92, 1, 0, 1
5330, 1, 1636425258901, 1636425258990, 89, 0, 89, 0, 0, 0
5331, 1, 1636425259502, 1636425259594, 92, 0, 92, 0, 0, 0
5332, 1, 1636425260118, 1636425260209, 91, 0, 91, 0, 0, 0
5333, 1, 1636425261394, 1636425261486, 92, 0, 92, 0, 0, 0
5334, 1, 1636425261813, 1636425261906, 93, 1, 92, 0, 0, 0
5335, 1, 1636425261986, 1636425262078, 92, 0, 92, 0, 0, 0
5336, 1, 1636425262266, 1636425262358, 92, 0, 92, 0, 0, 0
5337, 1, 1636425262302, 1636425262394, 92, 0, 92, 0, 0, 0
5338, 1, 1636425262790, 1636425262881, 91, 0, 91, 0, 0, 0
5341, 1, 1636425263474, 1636425263565, 91, 0, 91, 0, 0, 0
5339, 1, 1636425263474, 1636425263565, 91, 0, 91, 0, 0, 0
5343, 1, 1636425264086, 1636425264178, 92, 0, 92, 0, 0, 0
5344, 1, 1636425265389, 1636425265514, 125, 1, 124, 0, 0, 0
5345, 1, 1636425265645, 1636425265734, 89, 0, 89, 0, 0, 0
5349, 1, 1636425266018, 1636425266109, 91, 0, 91, 0, 0, 0
5350, 1, 1636425266089, 1636425266182, 93, 1, 92, 1, 0, 1
5348, 1, 1636425266098, 1636425266190, 92, 0, 92, 0, 0, 0
5351, 1, 1636425266686, 1636425266778, 92, 0, 92, 0, 0, 0
5354, 1, 1636425267314, 1636425267406, 92, 0, 92, 0, 0, 0
5355, 1, 1636425267433, 1636425267530, 97, 1, 96, 0, 0, 0
5356, 1, 1636425267798, 1636425267890, 92, 0, 92, 0, 0, 0
5358, 1, 1636425268030, 1636425268121, 91, 0, 91, 0, 0, 0
5357, 1, 1636425268250, 1636425268342, 92, 0, 92, 0, 0, 0
5329, 1, 1636425268466, 1636425268557, 91, 0, 91, 0, 0, 0
5362, 1, 1636425269294, 1636425269386, 92, 0, 92, 0, 0, 0
5363, 1, 1636425269450, 1636425269541, 91, 0, 91, 0, 0, 0
5364, 1, 1636425269909, 1636425270002, 93, 1, 92, 0, 0, 0
5365, 1, 1636425270077, 1636425270170, 93, 1, 92, 0, 1, 1
5366, 1, 1636425270322, 1636425270414, 92, 0, 92, 0, 0, 0
5367, 1, 1636425270518, 1636425270610, 92, 0, 92, 0, 0, 0
5368, 1, 1636425271378, 1636425271470, 92, 0, 92, 0, 0, 0
5369, 1, 1636425271573, 1636425271669, 96, 1, 95, 0, 1, 1
5371, 1, 1636425271818, 1636425271909, 91, 0, 91, 0, 0, 0
5370, 1, 1636425271829, 1636425271921, 92, 1, 91, 0, 1, 1
5372, 1, 1636425272242, 1636425272334, 92, 0, 92, 0, 0, 0
5373, 1, 1636425273329, 1636425273421, 92, 1, 91, 0, 0, 0
5374, 1, 1636425273405, 1636425273498, 93, 1, 92, 0, 0, 0
5375, 1, 1636425273777, 1636425273870, 93, 0, 93, 0, 0, 0
5379, 1, 1636425274473, 1636425274566, 93, 1, 92, 1, 0, 1
5380, 1, 1636425274494, 1636425274585, 91, 0, 91, 0, 0, 0
5381, 1, 1636425275577, 1636425275666, 89, 0, 89, 0, 0, 0
5382, 1, 1636425275593, 1636425275681, 88, 0, 88, 0, 0, 0
5383, 1, 1636425275621, 1636425275713, 92, 0, 92, 0, 0, 0
5384, 1, 1636425276037, 1636425276130, 93, 1, 92, 0, 1, 1
5387, 1, 1636425276253, 1636425276346, 93, 1, 92, 1, 0, 1
5390, 1, 1636425277486, 1636425277577, 91, 0, 91, 0, 0, 0
5392, 1, 1636425277682, 1636425277773, 91, 0, 91, 0, 0, 0
5391, 1, 1636425277941, 1636425278033, 92, 1, 91, 1, 0, 1
5393, 1, 1636425278281, 1636425278373, 92, 0, 92, 0, 0, 0
5395, 1, 1636425278758, 1636425278849, 91, 0, 91, 0, 0, 0
5361, 1, 1636425278770, 1636425278861, 91, 0, 91, 0, 0, 0
5397, 1, 1636425279294, 1636425279386, 92, 0, 92, 0, 0, 0
5399, 1, 1636425279486, 1636425279577, 91, 0, 91, 0, 0, 0
5400, 1, 1636425279598, 1636425279690, 92, 0, 92, 0, 0, 0
5401, 1, 1636425279941, 1636425280034, 93, 1, 92, 1, 0, 1
5402, 1, 1636425280270, 1636425280362, 92, 0, 92, 0, 0, 0
5403, 1, 1636425281370, 1636425281462, 92, 0, 92, 0, 0, 0
5405, 1, 1636425281694, 1636425281786, 92, 0, 92, 0, 0, 0
5404, 1, 1636425281822, 1636425281914, 92, 0, 92, 0, 0, 0
5406, 1, 1636425282146, 1636425282237, 91, 0, 91, 0, 0, 0
5407, 1, 1636425282530, 1636425282622, 92, 0, 92, 0, 0, 0
5409, 1, 1636425283346, 1636425283438, 92, 0, 92, 0, 0, 0
5411, 1, 1636425283598, 1636425283689, 91, 0, 91, 0, 0, 0
5410, 1, 1636425283802, 1636425283894, 92, 0, 92, 0, 0, 0
5413, 1, 1636425284550, 1636425284642, 92, 0, 92, 0, 0, 0
5414, 1, 1636425284558, 1636425284650, 92, 0, 92, 0, 0, 0
5415, 1, 1636425285013, 1636425285106, 93, 1, 92, 0, 0, 0
5417, 1, 1636425285410, 1636425285502, 92, 0, 92, 0, 0, 0
5418, 1, 1636425285866, 1636425285958, 92, 0, 92, 0, 0, 0
5419, 1, 1636425286206, 1636425286298, 92, 0, 92, 0, 0, 0
5420, 1, 1636425286398, 1636425286489, 91, 0, 91, 0, 0, 0
5421, 1, 1636425286514, 1636425286606, 92, 0, 92, 0, 0, 0
5422, 1, 1636425286970, 1636425287085, 115, 0, 115, 0, 0, 0
5423, 1, 1636425287530, 1636425287622, 92, 0, 92, 0, 0, 0
5424, 1, 1636425287585, 1636425287678, 93, 1, 92, 0, 0, 0
5427, 1, 1636425287778, 1636425287869, 91, 0, 91, 0, 0, 0
5426, 1, 1636425287982, 1636425288074, 92, 0, 92, 0, 0, 0
5425, 1, 1636425288033, 1636425288125, 92, 1, 91, 0, 0, 0
5428, 1, 1636425288198, 1636425288322, 124, 0, 124, 0, 0, 0
5429, 1, 1636425288206, 1636425288322, 116, 0, 116, 0, 0, 0
5430, 1, 1636425288682, 1636425288774, 92, 0, 92, 0, 0, 0
5431, 1, 1636425288766, 1636425288857, 91, 0, 91, 0, 0, 0
5398, 1, 1636425289066, 1636425289157, 91, 0, 91, 0, 0, 0
5433, 1, 1636425289338, 1636425289429, 91, 0, 91, 0, 0, 0
5432, 1, 1636425289374, 1636425289465, 91, 0, 91, 0, 0, 0
5434, 1, 1636425289790, 1636425289881, 91, 0, 91, 0, 0, 0
5435, 1, 1636425289825, 1636425289914, 89, 0, 89, 0, 0, 0
5436, 1, 1636425289873, 1636425289961, 88, 0, 88, 0, 0, 0
5437, 1, 1636425290357, 1636425290450, 93, 1, 92, 0, 1, 1
5439, 1, 1636425290506, 1636425290597, 91, 0, 91, 0, 0, 0
5438, 1, 1636425290806, 1636425290898, 92, 0, 92, 0, 0, 0
5440, 1, 1636425291262, 1636425291353, 91, 0, 91, 0, 0, 0
5442, 1, 1636425291629, 1636425291722, 93, 1, 92, 1, 0, 1
5443, 1, 1636425291666, 1636425291757, 91, 0, 91, 0, 0, 0
5441, 1, 1636425291713, 1636425291801, 88, 0, 88, 0, 0, 0
5445, 1, 1636425291937, 1636425292030, 93, 1, 92, 0, 0, 0
5444, 1, 1636425292085, 1636425292177, 92, 1, 91, 0, 1, 1
5446, 1, 1636425292085, 1636425292178, 93, 1, 92, 1, 0, 1
5447, 1, 1636425292357, 1636425292449, 92, 1, 91, 0, 0, 0
5448, 1, 1636425292389, 1636425292481, 92, 1, 91, 0, 0, 0
5449, 1, 1636425293053, 1636425293145, 92, 1, 91, 0, 0, 0
5450, 1, 1636425293258, 1636425293350, 92, 0, 92, 0, 0, 0
5451, 1, 1636425293509, 1636425293602, 93, 1, 92, 0, 0, 0
5452, 1, 1636425293581, 1636425293673, 92, 1, 91, 1, 0, 1
5453, 1, 1636425293713, 1636425293805, 92, 1, 91, 0, 0, 0
5454, 1, 1636425293842, 1636425293933, 91, 0, 91, 0, 0, 0
5455, 1, 1636425294078, 1636425294170, 92, 0, 92, 0, 0, 0
5456, 1, 1636425294342, 1636425294434, 92, 0, 92, 0, 0, 0
5457, 1, 1636425294534, 1636425294626, 92, 0, 92, 0, 0, 0
5458, 1, 1636425294761, 1636425294853, 92, 1, 91, 0, 0, 0
5459, 1, 1636425294990, 1636425295081, 91, 0, 91, 0, 0, 0
5460, 1, 1636425295505, 1636425295597, 92, 1, 91, 1, 0, 1
5461, 1, 1636425295586, 1636425295678, 92, 0, 92, 0, 0, 0
5462, 1, 1636425295678, 1636425295769, 91, 0, 91, 0, 0, 0
5463, 1, 1636425295945, 1636425296037, 92, 1, 91, 0, 0, 0
5464, 1, 1636425295966, 1636425296062, 96, 0, 96, 0, 0, 0
5466, 1, 1636425296045, 1636425296133, 88, 0, 88, 0, 0, 0
5467, 1, 1636425296082, 1636425296173, 91, 0, 91, 0, 0, 0
5465, 1, 1636425296402, 1636425296494, 92, 0, 92, 0, 0, 0
5468, 1, 1636425296797, 1636425296890, 93, 1, 92, 0, 1, 1
5469, 1, 1636425296978, 1636425297069, 91, 0, 91, 0, 0, 0
5471, 1, 1636425297354, 1636425297446, 92, 0, 92, 0, 0, 0
5470, 1, 1636425297433, 1636425297526, 93, 1, 92, 0, 0, 0
5473, 1, 1636425297730, 1636425297822, 92, 0, 92, 0, 0, 0
5474, 1, 1636425297785, 1636425297877, 92, 1, 91, 1, 0, 1
5472, 1, 1636425297805, 1636425297894, 89, 0, 89, 0, 0, 0
5475, 1, 1636425298114, 1636425298206, 92, 0, 92, 0, 0, 0
5476, 1, 1636425298494, 1636425298586, 92, 0, 92, 0, 0, 0
5477, 1, 1636425298514, 1636425298605, 91, 0, 91, 0, 0, 0
5478, 1, 1636425298641, 1636425298734, 93, 1, 92, 0, 1, 1
5479, 1, 1636425299158, 1636425299249, 91, 0, 91, 0, 0, 0
5480, 1, 1636425299205, 1636425299293, 88, 0, 88, 0, 0, 0
5481, 1, 1636425299606, 1636425299697, 91, 0, 91, 0, 0, 0
5482, 1, 1636425299642, 1636425299733, 91, 0, 91, 0, 0, 0
5483, 1, 1636425299717, 1636425299810, 93, 1, 92, 1, 0, 1
5484, 1, 1636425299829, 1636425299922, 93, 1, 92, 0, 1, 1
5486, 1, 1636425300105, 1636425300198, 93, 1, 92, 0, 0, 0
5485, 1, 1636425300169, 1636425300258, 89, 0, 89, 0, 0, 0
5487, 1, 1636425300329, 1636425300422, 93, 1, 92, 0, 1, 1
5488, 1, 1636425300750, 1636425300842, 92, 0, 92, 0, 0, 0
5489, 1, 1636425301010, 1636425301101, 91, 0, 91, 0, 0, 0
5490, 1, 1636425301510, 1636425301606, 96, 0, 96, 0, 0, 0
5492, 1, 1636425301578, 1636425301670, 92, 0, 92, 0, 0, 0
5493, 1, 1636425301785, 1636425301877, 92, 1, 91, 0, 0, 0
5494, 1, 1636425301914, 1636425302005, 91, 0, 91, 0, 0, 0
5491, 1, 1636425301961, 1636425302049, 88, 0, 88, 0, 0, 0
5495, 1, 1636425301997, 1636425302085, 88, 0, 88, 0, 0, 0
5496, 1, 1636425302314, 1636425302406, 92, 0, 92, 0, 0, 0
5497, 1, 1636425302710, 1636425302801, 91, 0, 91, 0, 0, 0
5498, 1, 1636425302738, 1636425302829, 91, 0, 91, 0, 0, 0
5499, 1, 1636425302981, 1636425303073, 92, 1, 91, 0, 0, 0
5500, 1, 1636425303053, 1636425303146, 93, 1, 92, 0, 0, 0
5501, 1, 1636425303434, 1636425303526, 92, 0, 92, 0, 0, 0
5502, 1, 1636425303437, 1636425303529, 92, 0, 92, 0, 0, 0
5503, 1, 1636425303905, 1636425303998, 93, 1, 92, 0, 0, 0
5504, 1, 1636425303925, 1636425304018, 93, 1, 92, 0, 0, 0
5505, 1, 1636425303962, 1636425304054, 92, 0, 92, 0, 0, 0
5507, 1, 1636425304354, 1636425304446, 92, 0, 92, 0, 0, 0
5506, 1, 1636425304358, 1636425304450, 92, 0, 92, 0, 0, 0
5508, 1, 1636425304826, 1636425304918, 92, 0, 92, 0, 0, 0
5509, 1, 1636425304889, 1636425304982, 93, 1, 92, 0, 0, 0
5510, 1, 1636425305398, 1636425305490, 92, 0, 92, 0, 0, 0
5511, 1, 1636425305537, 1636425305630, 93, 1, 92, 0, 0, 0
5513, 1, 1636425305765, 1636425305853, 88, 0, 88, 0, 0, 0
5514, 1, 1636425305806, 1636425305897, 91, 0, 91, 0, 0, 0
5512, 1, 1636425305994, 1636425306085, 91, 0, 91, 0, 0, 0
5515, 1, 1636425306218, 1636425306310, 92, 0, 92, 0, 0, 0
5516, 1, 1636425306278, 1636425306369, 91, 0, 91, 0, 0, 0
5517, 1, 1636425306485, 1636425306577, 92, 1, 91, 0, 1, 1
5518, 1, 1636425306762, 1636425306854, 92, 0, 92, 0, 0, 0
5519, 1, 1636425306954, 1636425307045, 91, 0, 91, 0, 0, 0
5520, 1, 1636425306970, 1636425307062, 92, 0, 92, 0, 0, 0
5521, 1, 1636425307418, 1636425307510, 92, 0, 92, 0, 0, 0
5522, 1, 1636425307582, 1636425307674, 92, 0, 92, 0, 0, 0
5524, 1, 1636425307741, 1636425307834, 93, 1, 92, 0, 0, 0
5523, 1, 1636425307873, 1636425307966, 93, 1, 92, 0, 0, 0
5525, 1, 1636425307966, 1636425308058, 92, 0, 92, 0, 0, 0
5526, 1, 1636425308421, 1636425308514, 93, 1, 92, 1, 0, 1
5527, 1, 1636425308625, 1636425308718, 93, 1, 92, 0, 0, 0
5528, 1, 1636425308654, 1636425308746, 92, 0, 92, 0, 0, 0
5529, 1, 1636425309194, 1636425309285, 91, 0, 91, 0, 0, 0
5530, 1, 1636425309254, 1636425309350, 96, 0, 96, 0, 0, 0
5531, 1, 1636425309373, 1636425309466, 93, 1, 92, 0, 0, 0
5533, 1, 1636425309665, 1636425309762, 97, 1, 96, 0, 1, 1
5532, 1, 1636425309825, 1636425309917, 92, 1, 91, 1, 0, 1
5534, 1, 1636425309905, 1636425309998, 93, 1, 92, 0, 1, 1
5535, 1, 1636425310242, 1636425310334, 92, 0, 92, 0, 0, 0
5536, 1, 1636425310433, 1636425310525, 92, 0, 92, 0, 0, 0
5537, 1, 1636425310446, 1636425310537, 91, 0, 91, 0, 0, 0
5538, 1, 1636425310537, 1636425310630, 93, 1, 92, 1, 0, 1
5539, 1, 1636425310734, 1636425310825, 91, 0, 91, 0, 0, 0
5540, 1, 1636425311038, 1636425311130, 92, 0, 92, 0, 0, 0
5541, 1, 1636425311494, 1636425311582, 88, 0, 88, 0, 0, 0
5542, 1, 1636425311494, 1636425311585, 91, 0, 91, 0, 0, 0
5543, 1, 1636425311513, 1636425311605, 92, 1, 91, 0, 0, 0
5544, 1, 1636425311942, 1636425312034, 92, 0, 92, 0, 0, 0
5545, 1, 1636425312090, 1636425312181, 91, 0, 91, 0, 0, 0
5546, 1, 1636425312542, 1636425312634, 92, 0, 92, 0, 0, 0
5547, 1, 1636425312686, 1636425312777, 91, 0, 91, 0, 0, 0
5548, 1, 1636425312965, 1636425313057, 92, 1, 91, 0, 1, 1
5549, 1, 1636425313237, 1636425313330, 93, 1, 92, 0, 1, 1
5551, 1, 1636425313338, 1636425313430, 92, 0, 92, 0, 0, 0
5552, 1, 1636425313366, 1636425313458, 92, 0, 92, 0, 0, 0
5550, 1, 1636425313697, 1636425313790, 93, 1, 92, 0, 0, 0
5553, 1, 1636425313841, 1636425313934, 93, 1, 92, 0, 0, 0
5554, 1, 1636425313910, 1636425314001, 91, 0, 91, 0, 0, 0
5556, 1, 1636425314325, 1636425314413, 88, 0, 88, 0, 0, 0
5557, 1, 1636425314474, 1636425314566, 92, 0, 92, 0, 0, 0
5558, 1, 1636425314593, 1636425314681, 88, 0, 88, 0, 0, 0
5559, 1, 1636425314677, 1636425314770, 93, 1, 92, 0, 0, 0
5560, 1, 1636425314878, 1636425314970, 92, 0, 92, 0, 0, 0
5562, 1, 1636425315193, 1636425315281, 88, 0, 88, 0, 0, 0
5561, 1, 1636425315325, 1636425315414, 89, 0, 89, 0, 0, 0
5564, 1, 1636425315737, 1636425315825, 88, 0, 88, 0, 0, 0
5563, 1, 1636425315778, 1636425315870, 92, 0, 92, 0, 0, 0
5565, 1, 1636425315853, 1636425315946, 93, 1, 92, 0, 1, 1
5566, 1, 1636425316306, 1636425316398, 92, 0, 92, 0, 0, 0
5567, 1, 1636425316589, 1636425316678, 89, 0, 89, 0, 0, 0
5568, 1, 1636425316933, 1636425317017, 84, 0, 84, 0, 0, 0
5569, 1, 1636425317218, 1636425317310, 92, 0, 92, 0, 0, 0
5570, 1, 1636425317269, 1636425317362, 93, 1, 92, 0, 1, 1
5571, 1, 1636425317338, 1636425317430, 92, 0, 92, 0, 0, 0
5573, 1, 1636425317670, 1636425317762, 92, 0, 92, 0, 0, 0
5572, 1, 1636425317790, 1636425317882, 92, 0, 92, 0, 0, 0
5575, 1, 1636425318025, 1636425318118, 93, 1, 92, 0, 0, 0
5574, 1, 1636425318125, 1636425318218, 93, 1, 92, 0, 1, 1
5577, 1, 1636425318549, 1636425318641, 92, 1, 91, 0, 1, 1
5576, 1, 1636425318573, 1636425318670, 97, 1, 96, 0, 0, 0
5578, 1, 1636425318594, 1636425318685, 91, 0, 91, 0, 0, 0
5580, 1, 1636425319029, 1636425319122, 93, 1, 92, 1, 0, 1
5579, 1, 1636425319042, 1636425319134, 92, 0, 92, 0, 0, 0
5582, 1, 1636425319574, 1636425319666, 92, 0, 92, 0, 0, 0
5583, 1, 1636425319850, 1636425319941, 91, 0, 91, 0, 0, 0
5584, 1, 1636425320034, 1636425320126, 92, 0, 92, 0, 0, 0
5586, 1, 1636425320254, 1636425320345, 91, 0, 91, 0, 0, 0
5585, 1, 1636425320485, 1636425320578, 93, 1, 92, 0, 0, 0
5587, 1, 1636425320686, 1636425320777, 91, 0, 91, 0, 0, 0
5588, 1, 1636425320950, 1636425321042, 92, 0, 92, 0, 0, 0
5589, 1, 1636425321526, 1636425321618, 92, 0, 92, 0, 0, 0
5591, 1, 1636425321986, 1636425322078, 92, 0, 92, 0, 0, 0
5594, 1, 1636425322322, 1636425322414, 92, 0, 92, 0, 0, 0
5595, 1, 1636425322517, 1636425322610, 93, 1, 92, 0, 0, 0
5598, 1, 1636425322885, 1636425322978, 93, 1, 92, 0, 0, 0
5599, 1, 1636425323090, 1636425323182, 92, 0, 92, 0, 0, 0
5601, 1, 1636425324142, 1636425324234, 92, 0, 92, 0, 0, 0
5604, 1, 1636425324330, 1636425324422, 92, 0, 92, 0, 0, 0
5605, 1, 1636425324542, 1636425324634, 92, 0, 92, 0, 0, 0
5606, 1, 1636425324753, 1636425324846, 93, 1, 92, 0, 1, 1
5602, 1, 1636425324782, 1636425324874, 92, 0, 92, 0, 0, 0
5608, 1, 1636425325286, 1636425325378, 92, 0, 92, 0, 0, 0
5609, 1, 1636425325738, 1636425325830, 92, 0, 92, 0, 0, 0
5610, 1, 1636425326186, 1636425326278, 92, 0, 92, 0, 0, 0
5611, 1, 1636425326457, 1636425326550, 93, 1, 92, 0, 0, 0
5612, 1, 1636425326654, 1636425326746, 92, 0, 92, 0, 0, 0
5613, 1, 1636425327382, 1636425327474, 92, 0, 92, 0, 0, 0
5614, 1, 1636425327910, 1636425328002, 92, 0, 92, 0, 0, 0
5615, 1, 1636425328494, 1636425328586, 92, 0, 92, 0, 0, 0
5617, 1, 1636425328702, 1636425328794, 92, 0, 92, 0, 0, 0
5618, 1, 1636425328921, 1636425329013, 92, 1, 91, 0, 1, 1
5616, 1, 1636425328954, 1636425329046, 92, 0, 92, 0, 0, 0
5619, 1, 1636425329514, 1636425329605, 91, 0, 91, 0, 0, 0
5620, 1, 1636425329614, 1636425329706, 92, 0, 92, 0, 0, 0
5621, 1, 1636425329970, 1636425330062, 92, 0, 92, 0, 0, 0
5622, 1, 1636425330406, 1636425330498, 92, 0, 92, 0, 0, 0
5623, 1, 1636425330570, 1636425330662, 92, 0, 92, 0, 0, 0
5624, 1, 1636425330862, 1636425330954, 92, 0, 92, 0, 0, 0
5625, 1, 1636425331149, 1636425331242, 93, 1, 92, 0, 0, 0
5626, 1, 1636425331878, 1636425331970, 92, 0, 92, 0, 0, 0
5628, 1, 1636425332138, 1636425332230, 92, 0, 92, 0, 0, 0
5627, 1, 1636425332330, 1636425332421, 91, 0, 91, 0, 0, 0
5629, 1, 1636425332826, 1636425332917, 91, 1, 90, 0, 1, 1
5630, 1, 1636425332826, 1636425332918, 92, 1, 91, 0, 1, 1
5632, 1, 1636425332914, 1636425333006, 92, 0, 92, 0, 0, 0
5634, 1, 1636425333078, 1636425333170, 92, 0, 92, 0, 0, 0
5631, 1, 1636425333277, 1636425333370, 93, 0, 93, 0, 0, 0
5636, 1, 1636425333429, 1636425333521, 92, 1, 91, 0, 0, 0
5637, 1, 1636425333766, 1636425333858, 92, 0, 92, 0, 0, 0
5639, 1, 1636425334222, 1636425334314, 92, 0, 92, 0, 0, 0
5640, 1, 1636425334470, 1636425334562, 92, 0, 92, 0, 0, 0
5642, 1, 1636425334854, 1636425334946, 92, 0, 92, 0, 0, 0
5643, 1, 1636425335105, 1636425335198, 93, 1, 92, 0, 0, 0
5645, 1, 1636425335342, 1636425335434, 92, 0, 92, 0, 0, 0
5646, 1, 1636425335558, 1636425335649, 91, 0, 91, 0, 0, 0
5647, 1, 1636425336021, 1636425336114, 93, 1, 92, 1, 0, 1
5648, 1, 1636425336178, 1636425336270, 92, 0, 92, 0, 0, 0
5649, 1, 1636425336477, 1636425336569, 92, 1, 91, 0, 1, 1
5650, 1, 1636425336557, 1636425336650, 93, 1, 92, 1, 0, 1
5651, 1, 1636425336750, 1636425336841, 91, 0, 91, 0, 0, 0
5652, 1, 1636425336750, 1636425336842, 92, 0, 92, 0, 0, 0
5654, 1, 1636425337113, 1636425337206, 93, 1, 92, 0, 0, 0
5653, 1, 1636425337214, 1636425337305, 91, 0, 91, 0, 0, 0
5655, 1, 1636425337409, 1636425337501, 92, 1, 91, 1, 0, 1
5656, 1, 1636425337866, 1636425337958, 92, 0, 92, 0, 0, 0
5657, 1, 1636425338594, 1636425338685, 91, 0, 91, 0, 0, 0
5658, 1, 1636425339117, 1636425339210, 93, 1, 92, 0, 0, 0
5659, 1, 1636425339234, 1636425339325, 91, 0, 91, 0, 0, 0
5660, 1, 1636425339305, 1636425339397, 92, 1, 91, 0, 0, 0
5661, 1, 1636425339369, 1636425339461, 92, 1, 91, 0, 0, 0
5662, 1, 1636425339758, 1636425339850, 92, 0, 92, 0, 0, 0
5663, 1, 1636425340209, 1636425340301, 92, 1, 91, 0, 0, 0
5664, 1, 1636425340289, 1636425340382, 93, 1, 92, 1, 0, 1
5665, 1, 1636425340301, 1636425340394, 93, 1, 92, 0, 1, 1
5666, 1, 1636425340586, 1636425340678, 92, 0, 92, 0, 0, 0
5667, 1, 1636425340810, 1636425340902, 92, 0, 92, 0, 0, 0
5669, 1, 1636425341109, 1636425341202, 93, 1, 92, 1, 0, 1
5670, 1, 1636425341165, 1636425341258, 93, 1, 92, 0, 0, 0
5668, 1, 1636425341266, 1636425341357, 91, 0, 91, 0, 0, 0
5671, 1, 1636425341618, 1636425341710, 92, 0, 92, 0, 0, 0
5672, 1, 1636425342274, 1636425342366, 92, 0, 92, 0, 0, 0
5674, 1, 1636425343041, 1636425343134, 93, 1, 92, 1, 0, 1
5675, 1, 1636425343309, 1636425343398, 89, 0, 89, 0, 0, 0
5676, 1, 1636425343422, 1636425343513, 91, 0, 91, 0, 0, 0
5677, 1, 1636425343590, 1636425343682, 92, 0, 92, 0, 0, 0
5679, 1, 1636425343830, 1636425343921, 91, 0, 91, 0, 0, 0
5680, 1, 1636425344021, 1636425344113, 92, 1, 91, 0, 0, 0
5678, 1, 1636425344042, 1636425344138, 96, 0, 96, 0, 0, 0
5683, 1, 1636425344265, 1636425344358, 93, 1, 92, 1, 0, 1
5681, 1, 1636425344278, 1636425344370, 92, 0, 92, 0, 0, 0
5682, 1, 1636425344501, 1636425344593, 92, 1, 91, 1, 0, 1
5684, 1, 1636425344530, 1636425344621, 91, 0, 91, 0, 0, 0
5644, 1, 1636425344633, 1636425344725, 92, 1, 91, 0, 0, 0
5686, 1, 1636425344922, 1636425345013, 91, 0, 91, 0, 0, 0
5685, 1, 1636425344954, 1636425345045, 91, 0, 91, 0, 0, 0
5687, 1, 1636425345021, 1636425345114, 93, 1, 92, 0, 0, 0
5688, 1, 1636425345369, 1636425345461, 92, 1, 91, 1, 0, 1
5690, 1, 1636425345402, 1636425345494, 92, 0, 92, 0, 0, 0
5689, 1, 1636425345402, 1636425345494, 92, 0, 92, 0, 0, 0
5691, 1, 1636425345858, 1636425345950, 92, 0, 92, 0, 0, 0
5692, 1, 1636425346458, 1636425346550, 92, 0, 92, 0, 0, 0
5693, 1, 1636425347130, 1636425347222, 92, 0, 92, 0, 0, 0
5694, 1, 1636425347157, 1636425347250, 93, 1, 92, 0, 0, 0
5695, 1, 1636425347230, 1636425347322, 92, 0, 92, 0, 0, 0
5696, 1, 1636425347374, 1636425347466, 92, 0, 92, 0, 0, 0
5698, 1, 1636425347742, 1636425347834, 92, 0, 92, 0, 0, 0
5697, 1, 1636425347826, 1636425347918, 92, 0, 92, 0, 0, 0
5700, 1, 1636425348122, 1636425348214, 92, 0, 92, 0, 0, 0
5699, 1, 1636425348193, 1636425348285, 92, 1, 91, 0, 1, 1
5702, 1, 1636425348238, 1636425348329, 91, 0, 91, 0, 0, 0
5701, 1, 1636425348277, 1636425348369, 92, 1, 91, 0, 0, 0
5703, 1, 1636425348646, 1636425348738, 92, 0, 92, 0, 0, 0
5704, 1, 1636425348729, 1636425348822, 93, 1, 92, 1, 0, 1
5705, 1, 1636425348990, 1636425349086, 96, 0, 96, 0, 0, 0
5706, 1, 1636425349186, 1636425349277, 91, 0, 91, 0, 0, 0
5707, 1, 1636425349241, 1636425349334, 93, 1, 92, 0, 0, 0
5709, 1, 1636425349518, 1636425349610, 92, 0, 92, 0, 0, 0
5708, 1, 1636425349694, 1636425349785, 91, 0, 91, 0, 0, 0
5710, 1, 1636425349974, 1636425350066, 92, 0, 92, 0, 0, 0
5711, 1, 1636425350710, 1636425350801, 91, 0, 91, 0, 0, 0
5712, 1, 1636425351085, 1636425351177, 92, 1, 91, 0, 1, 1
5713, 1, 1636425351193, 1636425351286, 93, 1, 92, 0, 0, 0
5714, 1, 1636425351206, 1636425351298, 92, 0, 92, 0, 0, 0
5715, 1, 1636425351534, 1636425351626, 92, 0, 92, 0, 0, 0
5716, 1, 1636425351650, 1636425351741, 91, 0, 91, 0, 0, 0
5717, 1, 1636425351654, 1636425351745, 91, 0, 91, 0, 0, 0
5719, 1, 1636425352030, 1636425352122, 92, 0, 92, 0, 0, 0
5718, 1, 1636425352105, 1636425352198, 93, 1, 92, 0, 0, 0
5720, 1, 1636425352398, 1636425352490, 92, 0, 92, 0, 0, 0
5721, 1, 1636425352482, 1636425352574, 92, 0, 92, 0, 0, 0
5722, 1, 1636425352565, 1636425352658, 93, 1, 92, 0, 0, 0
5724, 1, 1636425352917, 1636425353009, 92, 1, 91, 1, 0, 1
5726, 1, 1636425352965, 1636425353053, 88, 1, 87, 0, 0, 0
5725, 1, 1636425352965, 1636425353057, 92, 1, 91, 0, 0, 0
5723, 1, 1636425353009, 1636425353098, 89, 0, 89, 0, 0, 0
5728, 1, 1636425353185, 1636425353277, 92, 1, 91, 0, 0, 0
5727, 1, 1636425353366, 1636425353457, 91, 0, 91, 0, 0, 0
5729, 1, 1636425353702, 1636425353794, 92, 0, 92, 0, 0, 0
5730, 1, 1636425354154, 1636425354246, 92, 0, 92, 0, 0, 0
5731, 1, 1636425355002, 1636425355094, 92, 0, 92, 0, 0, 0
5732, 1, 1636425355109, 1636425355202, 93, 1, 92, 0, 1, 1
5733, 1, 1636425355385, 1636425355470, 85, 0, 85, 0, 0, 0
5734, 1, 1636425355445, 1636425355538, 93, 1, 92, 0, 1, 1
5736, 1, 1636425355593, 1636425355686, 93, 1, 92, 0, 0, 0
5738, 1, 1636425355618, 1636425355709, 91, 0, 91, 0, 0, 0
5735, 1, 1636425355829, 1636425355921, 92, 1, 91, 1, 0, 1
5737, 1, 1636425356042, 1636425356134, 92, 0, 92, 0, 0, 0
5739, 1, 1636425356309, 1636425356401, 92, 1, 91, 0, 0, 0
5740, 1, 1636425356334, 1636425356425, 91, 0, 91, 0, 0, 0
5741, 1, 1636425356569, 1636425356662, 93, 1, 92, 0, 0, 0
5742, 1, 1636425356697, 1636425356790, 93, 1, 92, 0, 0, 0
5743, 1, 1636425356814, 1636425356909, 95, 0, 95, 0, 0, 0
5744, 1, 1636425356865, 1636425356953, 88, 0, 88, 0, 0, 0
5747, 1, 1636425357089, 1636425357181, 92, 1, 91, 0, 0, 0
5745, 1, 1636425357261, 1636425357353, 92, 1, 91, 0, 0, 0
5746, 1, 1636425357306, 1636425357397, 91, 0, 91, 0, 0, 0
5748, 1, 1636425357333, 1636425357421, 88, 1, 87, 1, 0, 1
5749, 1, 1636425357469, 1636425357562, 93, 1, 92, 0, 0, 0
5750, 1, 1636425357922, 1636425358014, 92, 0, 92, 0, 0, 0
5751, 1, 1636425359318, 1636425359406, 88, 0, 88, 0, 0, 0
5752, 1, 1636425359330, 1636425359421, 91, 0, 91, 0, 0, 0
5753, 1, 1636425359481, 1636425359574, 93, 1, 92, 0, 0, 0
5755, 1, 1636425359533, 1636425359626, 93, 1, 92, 0, 1, 1
5756, 1, 1636425359765, 1636425359858, 93, 1, 92, 0, 0, 0
5754, 1, 1636425359934, 1636425360025, 91, 0, 91, 0, 0, 0
5758, 1, 1636425359934, 1636425360025, 91, 0, 91, 0, 0, 0
5759, 1, 1636425360101, 1636425360193, 92, 1, 91, 0, 0, 0
5757, 1, 1636425360218, 1636425360309, 91, 0, 91, 0, 0, 0
5760, 1, 1636425360489, 1636425360582, 93, 0, 93, 0, 0, 0
5761, 1, 1636425360714, 1636425360805, 91, 0, 91, 0, 0, 0
5763, 1, 1636425360889, 1636425360981, 92, 1, 91, 0, 0, 0
5764, 1, 1636425360905, 1636425360997, 92, 1, 91, 1, 0, 1
5765, 1, 1636425360957, 1636425361045, 88, 1, 87, 0, 1, 1
5766, 1, 1636425361105, 1636425361198, 93, 1, 92, 1, 0, 1
5762, 1, 1636425361161, 1636425361253, 92, 1, 91, 0, 1, 1
5767, 1, 1636425361405, 1636425361494, 89, 0, 89, 0, 0, 0
5768, 1, 1636425361545, 1636425361634, 89, 0, 89, 0, 0, 0
5769, 1, 1636425361690, 1636425361782, 92, 0, 92, 0, 0, 0
5770, 1, 1636425362142, 1636425362234, 92, 0, 92, 0, 0, 0
5771, 1, 1636425363270, 1636425363361, 91, 0, 91, 0, 0, 0
5772, 1, 1636425363590, 1636425363682, 92, 0, 92, 0, 0, 0
5773, 1, 1636425363693, 1636425363786, 93, 1, 92, 1, 0, 1
5776, 1, 1636425363861, 1636425363953, 92, 1, 91, 1, 0, 1
5777, 1, 1636425363869, 1636425363965, 96, 1, 95, 0, 0, 0
5778, 1, 1636425364021, 1636425364113, 92, 1, 91, 0, 1, 1
5774, 1, 1636425364042, 1636425364137, 95, 0, 95, 0, 0, 0
5775, 1, 1636425364149, 1636425364238, 89, 1, 88, 0, 0, 0
5779, 1, 1636425364497, 1636425364590, 93, 1, 92, 0, 0, 0
5781, 1, 1636425364574, 1636425364666, 92, 0, 92, 0, 0, 0
5780, 1, 1636425364590, 1636425364685, 95, 0, 95, 0, 0, 0
5783, 1, 1636425364845, 1636425364937, 92, 1, 91, 0, 1, 1
5784, 1, 1636425364950, 1636425365041, 91, 0, 91, 0, 0, 0
5782, 1, 1636425365030, 1636425365121, 91, 0, 91, 0, 0, 0
5785, 1, 1636425365241, 1636425365334, 93, 1, 92, 0, 0, 0
5787, 1, 1636425365374, 1636425365465, 91, 0, 91, 0, 0, 0
5788, 1, 1636425365446, 1636425365538, 92, 0, 92, 0, 0, 0
5786, 1, 1636425365698, 1636425365790, 92, 0, 92, 0, 0, 0
5789, 1, 1636425365749, 1636425365837, 88, 0, 88, 0, 0, 0
5790, 1, 1636425366197, 1636425366289, 92, 1, 91, 0, 0, 0
5791, 1, 1636425367465, 1636425367558, 93, 1, 92, 0, 0, 0
5792, 1, 1636425367578, 1636425367670, 92, 0, 92, 0, 0, 0
5795, 1, 1636425367745, 1636425367841, 96, 1, 95, 0, 1, 1
5796, 1, 1636425367801, 1636425367889, 88, 1, 87, 0, 0, 0
5793, 1, 1636425367913, 1636425368006, 93, 1, 92, 1, 0, 1
5798, 1, 1636425368021, 1636425368113, 92, 1, 91, 0, 0, 0
5799, 1, 1636425368366, 1636425368457, 91, 0, 91, 0, 0, 0
5794, 1, 1636425368477, 1636425368570, 93, 0, 93, 0, 0, 0
5801, 1, 1636425368714, 1636425368805, 91, 0, 91, 0, 0, 0
5804, 1, 1636425369073, 1636425369166, 93, 1, 92, 0, 0, 0
5805, 1, 1636425369086, 1636425369177, 91, 0, 91, 0, 0, 0
5802, 1, 1636425369166, 1636425369257, 91, 0, 91, 0, 0, 0
5808, 1, 1636425369305, 1636425369398, 93, 1, 92, 1, 0, 1
5806, 1, 1636425369542, 1636425369634, 92, 0, 92, 0, 0, 0
5809, 1, 1636425369801, 1636425369894, 93, 1, 92, 0, 1, 1
5810, 1, 1636425370254, 1636425370342, 88, 0, 88, 0, 0, 0
5811, 1, 1636425371321, 1636425371410, 89, 1, 88, 0, 1, 1
5812, 1, 1636425371769, 1636425371857, 88, 1, 87, 0, 1, 1
5814, 1, 1636425371769, 1636425371861, 92, 1, 91, 0, 0, 0
5815, 1, 1636425371813, 1636425371902, 89, 1, 88, 1, 0, 1
5818, 1, 1636425372218, 1636425372310, 92, 0, 92, 0, 0, 0
5819, 1, 1636425372414, 1636425372506, 92, 0, 92, 0, 0, 0
5821, 1, 1636425372817, 1636425372909, 92, 1, 91, 0, 0, 0
5822, 1, 1636425372837, 1636425372934, 97, 1, 96, 0, 0, 0
5820, 1, 1636425372869, 1636425372962, 93, 1, 92, 1, 0, 1
5823, 1, 1636425373270, 1636425373361, 91, 0, 91, 0, 0, 0
5824, 1, 1636425373541, 1636425373633, 92, 1, 91, 1, 0, 1
5825, 1, 1636425373561, 1636425373653, 92, 1, 91, 1, 0, 1
5826, 1, 1636425374018, 1636425374110, 92, 0, 92, 0, 0, 0
5827, 1, 1636425375330, 1636425375422, 92, 0, 92, 0, 0, 0
5829, 1, 1636425375590, 1636425375682, 92, 0, 92, 0, 0, 0
5828, 1, 1636425375781, 1636425375873, 92, 1, 91, 0, 0, 0
5830, 1, 1636425376146, 1636425376238, 92, 0, 92, 0, 0, 0
5831, 1, 1636425376213, 1636425376305, 92, 1, 91, 0, 0, 0
5832, 1, 1636425376521, 1636425376613, 92, 1, 91, 0, 0, 0
5833, 1, 1636425376665, 1636425376758, 93, 1, 92, 1, 0, 1
5835, 1, 1636425376901, 1636425376994, 93, 1, 92, 0, 0, 0
5834, 1, 1636425376977, 1636425377070, 93, 1, 92, 0, 0, 0
5836, 1, 1636425377434, 1636425377526, 92, 0, 92, 0, 0, 0
5837, 1, 1636425377585, 1636425377678, 93, 1, 92, 0, 0, 0
5838, 1, 1636425377742, 1636425377833, 91, 0, 91, 0, 0, 0
5839, 1, 1636425378202, 1636425378294, 92, 0, 92, 0, 0, 0
5817, 1, 1636425378901, 1636425378997, 96, 0, 96, 0, 0, 0
5842, 1, 1636425379238, 1636425379330, 92, 0, 92, 0, 0, 0
5840, 1, 1636425379246, 1636425379338, 92, 0, 92, 0, 0, 0
5843, 1, 1636425379441, 1636425379529, 88, 0, 88, 0, 0, 0
5845, 1, 1636425379569, 1636425379661, 92, 1, 91, 0, 0, 0
5846, 1, 1636425379697, 1636425379789, 92, 1, 91, 0, 0, 0
5848, 1, 1636425380122, 1636425380214, 92, 0, 92, 0, 0, 0
5847, 1, 1636425380149, 1636425380242, 93, 1, 92, 0, 0, 0
5849, 1, 1636425380245, 1636425380338, 93, 1, 92, 0, 0, 0
5850, 1, 1636425380726, 1636425380817, 91, 0, 91, 0, 0, 0
5851, 1, 1636425380773, 1636425380861, 88, 0, 88, 0, 0, 0
5854, 1, 1636425381158, 1636425381293, 135, 0, 135, 0, 0, 0
5853, 1, 1636425381217, 1636425381313, 96, 1, 95, 0, 0, 0
5852, 1, 1636425381685, 1636425381777, 92, 1, 91, 1, 0, 1
5855, 1, 1636425381773, 1636425381865, 92, 1, 91, 0, 0, 0
5856, 1, 1636425381906, 1636425381997, 91, 0, 91, 0, 0, 0
5857, 1, 1636425382001, 1636425382089, 88, 1, 87, 0, 0, 0
5858, 1, 1636425382218, 1636425382310, 92, 0, 92, 0, 0, 0
5859, 1, 1636425382446, 1636425382537, 91, 0, 91, 0, 0, 0
5860, 1, 1636425383270, 1636425383362, 92, 0, 92, 0, 0, 0
5861, 1, 1636425383345, 1636425383437, 92, 1, 91, 0, 1, 1
5864, 1, 1636425383642, 1636425383733, 91, 0, 91, 0, 0, 0
5865, 1, 1636425383678, 1636425383769, 91, 0, 91, 0, 0, 0
5866, 1, 1636425384021, 1636425384114, 93, 1, 92, 1, 0, 1
5867, 1, 1636425384049, 1636425384141, 92, 0, 92, 0, 0, 0
5869, 1, 1636425384566, 1636425384658, 92, 0, 92, 0, 0, 0
5872, 1, 1636425385281, 1636425385370, 89, 0, 89, 0, 0, 0
5873, 1, 1636425385665, 1636425385757, 92, 1, 91, 0, 0, 0
5874, 1, 1636425385801, 1636425385898, 97, 1, 96, 0, 1, 1
5875, 1, 1636425386077, 1636425386170, 93, 1, 92, 0, 0, 0
5876, 1, 1636425386261, 1636425386354, 93, 1, 92, 0, 0, 0
5877, 1, 1636425386530, 1636425386622, 92, 0, 92, 0, 0, 0
5878, 1, 1636425387082, 1636425387173, 91, 0, 91, 0, 0, 0
5879, 1, 1636425387537, 1636425387630, 93, 0, 93, 0, 0, 0
5880, 1, 1636425387601, 1636425387694, 93, 1, 92, 0, 0, 0
5881, 1, 1636425387878, 1636425387970, 92, 0, 92, 0, 0, 0
5882, 1, 1636425387890, 1636425387981, 91, 0, 91, 0, 0, 0
5883, 1, 1636425388017, 1636425388106, 89, 0, 89, 0, 0, 0
5884, 1, 1636425388389, 1636425388482, 93, 1, 92, 0, 1, 1
5885, 1, 1636425389625, 1636425389718, 93, 1, 92, 1, 0, 1
5887, 1, 1636425389886, 1636425389977, 91, 0, 91, 0, 0, 0
5886, 1, 1636425389890, 1636425389981, 91, 0, 91, 0, 0, 0
5889, 1, 1636425389985, 1636425390077, 92, 1, 91, 0, 0, 0
5888, 1, 1636425390342, 1636425390433, 91, 0, 91, 0, 0, 0
5890, 1, 1636425390393, 1636425390481, 88, 0, 88, 0, 0, 0
5891, 1, 1636425390521, 1636425390614, 93, 1, 92, 0, 0, 0
5892, 1, 1636425390838, 1636425390930, 92, 0, 92, 0, 0, 0
5893, 1, 1636425390906, 1636425390998, 92, 0, 92, 0, 0, 0
5894, 1, 1636425391201, 1636425391294, 93, 1, 92, 0, 0, 0
5895, 1, 1636425391781, 1636425391874, 93, 1, 92, 0, 0, 0
5896, 1, 1636425391877, 1636425391973, 96, 1, 95, 0, 0, 0
5897, 1, 1636425391885, 1636425391977, 92, 1, 91, 0, 0, 0
5898, 1, 1636425392021, 1636425392110, 89, 0, 89, 0, 0, 0
5899, 1, 1636425392330, 1636425392422, 92, 0, 92, 0, 0, 0
5900, 1, 1636425393462, 1636425393554, 92, 0, 92, 0, 0, 0
5901, 1, 1636425393873, 1636425393961, 88, 0, 88, 0, 0, 0
5902, 1, 1636425393885, 1636425393973, 88, 0, 88, 0, 0, 0
5903, 1, 1636425393917, 1636425394006, 89, 0, 89, 0, 0, 0
5904, 1, 1636425394038, 1636425394130, 92, 0, 92, 0, 0, 0
5906, 1, 1636425394329, 1636425394422, 93, 1, 92, 0, 0, 0
5907, 1, 1636425394329, 1636425394422, 93, 1, 92, 1, 0, 1
5909, 1, 1636425394421, 1636425394513, 92, 1, 91, 1, 0, 1
5905, 1, 1636425394490, 1636425394581, 91, 0, 91, 0, 0, 0
5910, 1, 1636425394717, 1636425394809, 92, 1, 91, 0, 0, 0
5908, 1, 1636425394782, 1636425394882, 100, 0, 100, 0, 0, 0
5911, 1, 1636425394973, 1636425395066, 93, 1, 92, 1, 0, 1
5915, 1, 1636425395537, 1636425395626, 89, 0, 89, 0, 0, 0
5916, 1, 1636425395842, 1636425395938, 96, 0, 96, 0, 0, 0
5917, 1, 1636425396021, 1636425396114, 93, 1, 92, 0, 1, 1
5918, 1, 1636425396090, 1636425396181, 91, 0, 91, 0, 0, 0
5919, 1, 1636425396542, 1636425396634, 92, 0, 92, 0, 0, 0
5920, 1, 1636425397445, 1636425397538, 93, 1, 92, 0, 0, 0
5921, 1, 1636425397629, 1636425397722, 93, 1, 92, 0, 0, 0
5922, 1, 1636425397970, 1636425398062, 92, 0, 92, 0, 0, 0
5923, 1, 1636425398126, 1636425398217, 91, 0, 91, 0, 0, 0
5926, 1, 1636425398173, 1636425398265, 92, 1, 91, 0, 0, 0
5925, 1, 1636425398173, 1636425398266, 93, 1, 92, 0, 1, 1
5928, 1, 1636425398421, 1636425398514, 93, 1, 92, 0, 1, 1
5924, 1, 1636425398577, 1636425398665, 88, 0, 88, 0, 0, 0
5929, 1, 1636425398605, 1636425398698, 93, 1, 92, 0, 0, 0
5927, 1, 1636425398621, 1636425398710, 89, 0, 89, 0, 0, 0
5930, 1, 1636425398870, 1636425398966, 96, 0, 96, 0, 0, 0
5931, 1, 1636425399069, 1636425399162, 93, 1, 92, 1, 0, 1
5932, 1, 1636425399754, 1636425399846, 92, 0, 92, 0, 0, 0
5933, 1, 1636425399770, 1636425399862, 92, 0, 92, 0, 0, 0
5934, 1, 1636425399825, 1636425399918, 93, 1, 92, 1, 0, 1
5935, 1, 1636425400254, 1636425400346, 92, 0, 92, 0, 0, 0
5936, 1, 1636425400706, 1636425400798, 92, 0, 92, 0, 0, 0
5937, 1, 1636425401678, 1636425401770, 92, 0, 92, 0, 0, 0
5938, 1, 1636425401734, 1636425401826, 92, 0, 92, 0, 0, 0
5939, 1, 1636425401873, 1636425401966, 93, 1, 92, 0, 0, 0
5941, 1, 1636425402021, 1636425402114, 93, 1, 92, 0, 0, 0
5942, 1, 1636425402190, 1636425402282, 92, 0, 92, 0, 0, 0
5944, 1, 1636425402406, 1636425402498, 92, 0, 92, 0, 0, 0
5943, 1, 1636425402473, 1636425402562, 89, 1, 88, 0, 0, 0
5945, 1, 1636425402621, 1636425402709, 88, 0, 88, 0, 0, 0
5940, 1, 1636425402641, 1636425402726, 85, 0, 85, 0, 0, 0
5946, 1, 1636425402665, 1636425402753, 88, 0, 88, 0, 0, 0
5947, 1, 1636425403086, 1636425403177, 91, 0, 91, 0, 0, 0
5948, 1, 1636425403106, 1636425403197, 91, 0, 91, 0, 0, 0
5949, 1, 1636425403613, 1636425403706, 93, 1, 92, 0, 1, 1
5950, 1, 1636425403889, 1636425403982, 93, 1, 92, 1, 0, 1
5951, 1, 1636425404341, 1636425404434, 93, 1, 92, 0, 1, 1
5952, 1, 1636425404365, 1636425404458, 93, 1, 92, 0, 1, 1
5953, 1, 1636425404822, 1636425404914, 92, 0, 92, 0, 0, 0
5954, 1, 1636425405578, 1636425405670, 92, 0, 92, 0, 0, 0
5955, 1, 1636425405673, 1636425405770, 97, 1, 96, 0, 0, 0
5957, 1, 1636425405798, 1636425405890, 92, 0, 92, 0, 0, 0
5958, 1, 1636425405989, 1636425406081, 92, 1, 91, 0, 1, 1
5959, 1, 1636425406009, 1636425406101, 92, 1, 91, 0, 0, 0
5960, 1, 1636425406126, 1636425406217, 91, 0, 91, 0, 0, 0
5956, 1, 1636425406126, 1636425406217, 91, 1, 90, 0, 0, 0
5961, 1, 1636425406213, 1636425406305, 92, 1, 91, 0, 0, 0
5964, 1, 1636425406522, 1636425406617, 95, 0, 95, 0, 0, 0
5963, 1, 1636425406577, 1636425406669, 92, 1, 91, 0, 0, 0
5962, 1, 1636425406662, 1636425406754, 92, 0, 92, 0, 0, 0
5965, 1, 1636425406662, 1636425406754, 92, 0, 92, 0, 0, 0
5967, 1, 1636425406989, 1636425407077, 88, 0, 88, 0, 0, 0
5966, 1, 1636425407033, 1636425407121, 88, 0, 88, 0, 0, 0
5968, 1, 1636425407442, 1636425407534, 92, 0, 92, 0, 0, 0
5969, 1, 1636425407641, 1636425407734, 93, 1, 92, 0, 0, 0
5970, 1, 1636425408038, 1636425408130, 92, 0, 92, 0, 0, 0
5971, 1, 1636425408186, 1636425408278, 92, 0, 92, 0, 0, 0
5972, 1, 1636425408498, 1636425408590, 92, 0, 92, 0, 0, 0
5973, 1, 1636425408601, 1636425408694, 93, 1, 92, 0, 0, 0
5974, 1, 1636425409418, 1636425409509, 91, 0, 91, 0, 0, 0
5975, 1, 1636425409681, 1636425409774, 93, 1, 92, 0, 0, 0
5976, 1, 1636425409781, 1636425409869, 88, 1, 87, 0, 0, 0
5978, 1, 1636425410049, 1636425410142, 93, 1, 92, 0, 0, 0
5977, 1, 1636425410230, 1636425410321, 91, 0, 91, 0, 0, 0
5979, 1, 1636425410281, 1636425410369, 88, 1, 87, 0, 1, 1
5980, 1, 1636425410361, 1636425410454, 93, 1, 92, 0, 1, 1
5982, 1, 1636425410450, 1636425410541, 91, 0, 91, 0, 0, 0
5985, 1, 1636425410670, 1636425410761, 91, 0, 91, 0, 0, 0
5984, 1, 1636425410814, 1636425410905, 91, 0, 91, 0, 0, 0
5986, 1, 1636425410814, 1636425410905, 91, 0, 91, 0, 0, 0
5983, 1, 1636425410897, 1636425410985, 88, 0, 88, 0, 0, 0
5987, 1, 1636425411121, 1636425411214, 93, 1, 92, 0, 0, 0
5988, 1, 1636425411345, 1636425411438, 93, 1, 92, 0, 0, 0
5989, 1, 1636425411445, 1636425411538, 93, 1, 92, 0, 1, 1
5990, 1, 1636425411954, 1636425412046, 92, 0, 92, 0, 0, 0
5991, 1, 1636425412070, 1636425412162, 92, 0, 92, 0, 0, 0
5992, 1, 1636425412518, 1636425412610, 92, 0, 92, 0, 0, 0
5993, 1, 1636425412910, 1636425413002, 92, 0, 92, 0, 0, 0
5994, 1, 1636425413098, 1636425413190, 92, 0, 92, 0, 0, 0
5995, 1, 1636425413594, 1636425413686, 92, 0, 92, 0, 0, 0
5996, 1, 1636425413902, 1636425413994, 92, 0, 92, 0, 0, 0
5998, 1, 1636425414050, 1636425414142, 92, 0, 92, 0, 0, 0
5999, 1, 1636425414322, 1636425414417, 95, 0, 95, 0, 0, 0
6000, 1, 1636425414341, 1636425414433, 92, 1, 91, 1, 0, 1
5997, 1, 1636425414353, 1636425414445, 92, 1, 91, 0, 1, 1
6001, 1, 1636425414369, 1636425414462, 93, 0, 93, 0, 0, 0
6004, 1, 1636425414578, 1636425414669, 91, 0, 91, 0, 0, 0
6005, 1, 1636425414681, 1636425414773, 92, 1, 91, 1, 0, 1
6003, 1, 1636425414773, 1636425414861, 88, 1, 87, 0, 0, 0
6006, 1, 1636425414817, 1636425414906, 89, 0, 89, 0, 0, 0
6007, 1, 1636425415026, 1636425415118, 92, 0, 92, 0, 0, 0
6002, 1, 1636425415270, 1636425415361, 91, 0, 91, 0, 0, 0
6008, 1, 1636425415306, 1636425415398, 92, 0, 92, 0, 0, 0
6009, 1, 1636425415834, 1636425415926, 92, 0, 92, 0, 0, 0
6010, 1, 1636425416146, 1636425416238, 92, 0, 92, 0, 0, 0
6011, 1, 1636425416285, 1636425416378, 93, 1, 92, 0, 0, 0
6012, 1, 1636425416806, 1636425416898, 92, 0, 92, 0, 0, 0
6013, 1, 1636425417098, 1636425417190, 92, 0, 92, 0, 0, 0
6014, 1, 1636425417422, 1636425417514, 92, 0, 92, 0, 0, 0
6015, 1, 1636425417710, 1636425417802, 92, 0, 92, 0, 0, 0
6016, 1, 1636425418161, 1636425418258, 97, 1, 96, 0, 0, 0
6017, 1, 1636425418241, 1636425418333, 92, 1, 91, 0, 0, 0
6018, 1, 1636425418405, 1636425418497, 92, 1, 91, 0, 0, 0
6020, 1, 1636425418429, 1636425418521, 92, 1, 91, 0, 0, 0
6023, 1, 1636425418677, 1636425418770, 93, 1, 92, 0, 1, 1
6024, 1, 1636425418857, 1636425418949, 92, 1, 91, 0, 1, 1
6022, 1, 1636425418885, 1636425418977, 92, 1, 91, 0, 0, 0
6025, 1, 1636425418898, 1636425418989, 91, 0, 91, 0, 0, 0
6027, 1, 1636425419302, 1636425419393, 91, 0, 91, 0, 0, 0
6026, 1, 1636425419337, 1636425419430, 93, 1, 92, 0, 0, 0
6028, 1, 1636425419966, 1636425420054, 88, 0, 88, 0, 0, 0
6029, 1, 1636425420173, 1636425420298, 125, 1, 124, 0, 0, 0
6030, 1, 1636425420473, 1636425420566, 93, 1, 92, 1, 0, 1
6031, 1, 1636425420734, 1636425420826, 92, 0, 92, 0, 0, 0
6032, 1, 1636425420974, 1636425421065, 91, 0, 91, 0, 0, 0
6033, 1, 1636425420989, 1636425421081, 92, 1, 91, 0, 0, 0
6034, 1, 1636425421289, 1636425421382, 93, 1, 92, 1, 0, 1
6035, 1, 1636425421898, 1636425421990, 92, 0, 92, 0, 0, 0
6037, 1, 1636425422270, 1636425422362, 92, 0, 92, 0, 0, 0
6038, 1, 1636425422274, 1636425422362, 88, 0, 88, 0, 0, 0
6036, 1, 1636425422346, 1636425422438, 92, 0, 92, 0, 0, 0
6039, 1, 1636425422617, 1636425422705, 88, 1, 87, 1, 0, 1
6040, 1, 1636425422630, 1636425422721, 91, 0, 91, 0, 0, 0
6041, 1, 1636425422761, 1636425422850, 89, 0, 89, 0, 0, 0
6043, 1, 1636425422958, 1636425423050, 92, 0, 92, 0, 0, 0
6042, 1, 1636425423074, 1636425423166, 92, 0, 92, 0, 0, 0
6045, 1, 1636425423506, 1636425423598, 92, 0, 92, 0, 0, 0
6044, 1, 1636425423522, 1636425423613, 91, 0, 91, 0, 0, 0
6046, 1, 1636425423901, 1636425423994, 93, 1, 92, 0, 0, 0
6048, 1, 1636425424350, 1636425424442, 92, 0, 92, 0, 0, 0
6047, 1, 1636425424354, 1636425424445, 91, 0, 91, 0, 0, 0
6049, 1, 1636425424809, 1636425424901, 92, 1, 91, 0, 0, 0
6050, 1, 1636425424942, 1636425425033, 91, 0, 91, 0, 0, 0
6051, 1, 1636425425302, 1636425425394, 92, 0, 92, 0, 0, 0
6052, 1, 1636425425425, 1636425425518, 93, 1, 92, 1, 0, 1
6053, 1, 1636425425961, 1636425426054, 93, 1, 92, 0, 1, 1
6055, 1, 1636425426326, 1636425426417, 91, 0, 91, 0, 0, 0
6056, 1, 1636425426390, 1636425426477, 87, 0, 87, 0, 0, 0
6054, 1, 1636425426417, 1636425426509, 92, 0, 92, 0, 0, 0
6057, 1, 1636425426457, 1636425426546, 89, 1, 88, 1, 0, 1
6059, 1, 1636425426898, 1636425426989, 91, 0, 91, 0, 0, 0
6058, 1, 1636425426905, 1636425426997, 92, 1, 91, 0, 0, 0
6060, 1, 1636425426925, 1636425427013, 88, 0, 88, 0, 0, 0
6062, 1, 1636425427086, 1636425427178, 92, 0, 92, 0, 0, 0
6061, 1, 1636425427362, 1636425427454, 92, 0, 92, 0, 0, 0
6063, 1, 1636425427686, 1636425427774, 88, 0, 88, 0, 0, 0
6065, 1, 1636425428033, 1636425428122, 89, 1, 88, 0, 0, 0
6064, 1, 1636425428033, 1636425428125, 92, 1, 91, 0, 0, 0
6066, 1, 1636425428482, 1636425428574, 92, 0, 92, 0, 0, 0
6067, 1, 1636425428741, 1636425428829, 88, 0, 88, 0, 0, 0
6069, 1, 1636425428917, 1636425429009, 92, 1, 91, 1, 0, 1
6070, 1, 1636425428938, 1636425429029, 91, 0, 91, 0, 0, 0
6068, 1, 1636425429189, 1636425429281, 92, 1, 91, 0, 0, 0
6071, 1, 1636425429642, 1636425429733, 91, 0, 91, 0, 0, 0
6072, 1, 1636425429693, 1636425429785, 92, 1, 91, 1, 0, 1
6073, 1, 1636425429793, 1636425429885, 92, 1, 91, 0, 0, 0
6075, 1, 1636425430006, 1636425430097, 91, 0, 91, 0, 0, 0
6076, 1, 1636425430194, 1636425430286, 92, 0, 92, 0, 0, 0
6074, 1, 1636425430250, 1636425430342, 92, 0, 92, 0, 0, 0
6077, 1, 1636425430669, 1636425430757, 88, 1, 87, 0, 0, 0
6078, 1, 1636425430701, 1636425430794, 93, 1, 92, 0, 1, 1
6079, 1, 1636425430845, 1636425430933, 88, 0, 88, 0, 0, 0
6080, 1, 1636425431166, 1636425431257, 91, 0, 91, 0, 0, 0
6081, 1, 1636425431177, 1636425431270, 93, 1, 92, 1, 0, 1
6082, 1, 1636425431630, 1636425431721, 91, 0, 91, 0, 0, 0
6083, 1, 1636425431954, 1636425432046, 92, 0, 92, 0, 0, 0
6084, 1, 1636425432214, 1636425432306, 92, 0, 92, 0, 0, 0
6085, 1, 1636425432234, 1636425432325, 91, 0, 91, 0, 0, 0
6087, 1, 1636425432605, 1636425432698, 93, 1, 92, 0, 0, 0
6086, 1, 1636425432685, 1636425432777, 92, 1, 91, 1, 0, 1
6089, 1, 1636425432857, 1636425432950, 93, 1, 92, 1, 0, 1
6088, 1, 1636425433057, 1636425433150, 93, 1, 92, 0, 1, 1
6091, 1, 1636425433150, 1636425433237, 87, 0, 87, 0, 0, 0
6090, 1, 1636425433505, 1636425433593, 88, 0, 88, 0, 0, 0
6092, 1, 1636425433785, 1636425433877, 92, 1, 91, 0, 0, 0
6093, 1, 1636425433889, 1636425433977, 88, 1, 87, 0, 0, 0
6094, 1, 1636425433977, 1636425434070, 93, 1, 92, 1, 0, 1
6096, 1, 1636425434189, 1636425434281, 92, 1, 91, 0, 0, 0
6095, 1, 1636425434333, 1636425434421, 88, 1, 87, 0, 0, 0
6097, 1, 1636425434394, 1636425434481, 87, 0, 87, 0, 0, 0
6098, 1, 1636425434481, 1636425434569, 88, 0, 88, 0, 0, 0
6099, 1, 1636425434922, 1636425435014, 92, 0, 92, 0, 0, 0
6101, 1, 1636425435029, 1636425435122, 93, 1, 92, 0, 0, 0
6102, 1, 1636425435230, 1636425435322, 92, 0, 92, 0, 0, 0
6100, 1, 1636425435365, 1636425435457, 92, 1, 91, 0, 0, 0
6103, 1, 1636425435761, 1636425435850, 89, 0, 89, 0, 0, 0
6104, 1, 1636425435930, 1636425436021, 91, 0, 91, 0, 0, 0
6105, 1, 1636425436381, 1636425436473, 92, 1, 91, 0, 1, 1
6106, 1, 1636425436493, 1636425436581, 88, 1, 87, 0, 0, 0
6107, 1, 1636425436625, 1636425436713, 88, 0, 88, 0, 0, 0
6109, 1, 1636425436933, 1636425437030, 97, 1, 96, 0, 1, 1
6108, 1, 1636425437073, 1636425437162, 89, 0, 89, 0, 0, 0
6111, 1, 1636425437426, 1636425437522, 96, 0, 96, 0, 0, 0
6110, 1, 1636425437525, 1636425437622, 97, 1, 96, 0, 0, 0
6112, 1, 1636425437974, 1636425438066, 92, 0, 92, 0, 0, 0
6113, 1, 1636425438010, 1636425438102, 92, 0, 92, 0, 0, 0
6114, 1, 1636425438081, 1636425438174, 93, 1, 92, 0, 1, 1
6115, 1, 1636425438122, 1636425438214, 92, 0, 92, 0, 0, 0
6117, 1, 1636425438474, 1636425438565, 91, 0, 91, 0, 0, 0
6118, 1, 1636425438506, 1636425438598, 92, 0, 92, 0, 0, 0
6116, 1, 1636425438578, 1636425438670, 92, 0, 92, 0, 0, 0
6119, 1, 1636425438601, 1636425438694, 93, 1, 92, 0, 0, 0
6120, 1, 1636425439054, 1636425439146, 92, 0, 92, 0, 0, 0
6121, 1, 1636425439206, 1636425439298, 92, 0, 92, 0, 0, 0
6122, 1, 1636425439314, 1636425439406, 92, 0, 92, 0, 0, 0
6123, 1, 1636425439882, 1636425439974, 92, 0, 92, 0, 0, 0
6124, 1, 1636425440030, 1636425440122, 92, 0, 92, 0, 0, 0
6125, 1, 1636425440330, 1636425440421, 91, 0, 91, 0, 0, 0
6126, 1, 1636425440370, 1636425440462, 92, 0, 92, 0, 0, 0
6128, 1, 1636425440582, 1636425440674, 92, 0, 92, 0, 0, 0
6127, 1, 1636425440821, 1636425440910, 89, 0, 89, 0, 0, 0
6130, 1, 1636425441130, 1636425441222, 92, 0, 92, 0, 0, 0
6129, 1, 1636425441274, 1636425441366, 92, 0, 92, 0, 0, 0
6131, 1, 1636425441694, 1636425441786, 92, 0, 92, 0, 0, 0
6132, 1, 1636425441845, 1636425441937, 92, 1, 91, 0, 0, 0
6133, 1, 1636425441969, 1636425442062, 93, 1, 92, 0, 1, 1
6134, 1, 1636425442025, 1636425442121, 96, 1, 95, 0, 0, 0
6137, 1, 1636425442290, 1636425442381, 91, 0, 91, 0, 0, 0
6136, 1, 1636425442301, 1636425442394, 93, 1, 92, 1, 0, 1
6135, 1, 1636425442418, 1636425442510, 92, 0, 92, 0, 0, 0
6138, 1, 1636425442517, 1636425442610, 93, 1, 92, 0, 0, 0
6140, 1, 1636425442765, 1636425442858, 93, 1, 92, 0, 1, 1
6139, 1, 1636425442970, 1636425443061, 91, 0, 91, 0, 0, 0
6141, 1, 1636425443105, 1636425443197, 92, 0, 92, 0, 0, 0
6142, 1, 1636425443398, 1636425443489, 91, 0, 91, 0, 0, 0
6143, 1, 1636425443582, 1636425443674, 92, 0, 92, 0, 0, 0
6144, 1, 1636425443801, 1636425443894, 93, 1, 92, 1, 0, 1
6145, 1, 1636425444206, 1636425444297, 91, 0, 91, 0, 0, 0
6146, 1, 1636425444230, 1636425444322, 92, 0, 92, 0, 0, 0
6147, 1, 1636425444686, 1636425444778, 92, 0, 92, 0, 0, 0
6148, 1, 1636425444894, 1636425444986, 92, 0, 92, 0, 0, 0
6149, 1, 1636425445137, 1636425445230, 93, 1, 92, 0, 1, 1
6152, 1, 1636425445674, 1636425445766, 92, 0, 92, 0, 0, 0
6154, 1, 1636425445938, 1636425446030, 92, 0, 92, 0, 0, 0
6153, 1, 1636425446130, 1636425446222, 92, 0, 92, 0, 0, 0
6155, 1, 1636425446269, 1636425446358, 89, 1, 88, 0, 0, 0
6157, 1, 1636425446430, 1636425446522, 92, 0, 92, 0, 0, 0
6159, 1, 1636425446502, 1636425446594, 92, 0, 92, 0, 0, 0
6156, 1, 1636425446718, 1636425446810, 92, 0, 92, 0, 0, 0
6158, 1, 1636425446881, 1636425446974, 93, 1, 92, 0, 0, 0
6160, 1, 1636425447098, 1636425447189, 91, 0, 91, 0, 0, 0
6161, 1, 1636425447109, 1636425447201, 92, 1, 91, 0, 0, 0
6162, 1, 1636425447353, 1636425447446, 93, 0, 93, 0, 0, 0
6163, 1, 1636425447710, 1636425447801, 91, 0, 91, 0, 0, 0
6164, 1, 1636425447817, 1636425447906, 89, 0, 89, 0, 0, 0
6165, 1, 1636425447906, 1636425447998, 92, 0, 92, 0, 0, 0
6166, 1, 1636425448106, 1636425448198, 92, 0, 92, 0, 0, 0
6167, 1, 1636425448362, 1636425448454, 92, 0, 92, 0, 0, 0
6168, 1, 1636425448834, 1636425448929, 95, 0, 95, 0, 0, 0
6169, 1, 1636425448918, 1636425449010, 92, 0, 92, 0, 0, 0
6170, 1, 1636425449374, 1636425449466, 92, 0, 92, 0, 0, 0
6171, 1, 1636425449833, 1636425449926, 93, 1, 92, 0, 0, 0
6172, 1, 1636425449858, 1636425449950, 92, 0, 92, 0, 0, 0
6174, 1, 1636425450106, 1636425450198, 92, 0, 92, 0, 0, 0
6173, 1, 1636425450301, 1636425450394, 93, 1, 92, 0, 1, 1
6175, 1, 1636425450558, 1636425450650, 92, 0, 92, 0, 0, 0
6176, 1, 1636425450754, 1636425450845, 91, 0, 91, 0, 0, 0
6177, 1, 1636425450837, 1636425450934, 97, 1, 96, 0, 0, 0
6178, 1, 1636425450974, 1636425451065, 91, 0, 91, 0, 0, 0
6179, 1, 1636425451029, 1636425451122, 93, 1, 92, 0, 1, 1
6180, 1, 1636425451310, 1636425451402, 92, 0, 92, 0, 0, 0
6181, 1, 1636425451650, 1636425451741, 91, 0, 91, 0, 0, 0
6182, 1, 1636425451757, 1636425451850, 93, 1, 92, 0, 1, 1
6183, 1, 1636425452010, 1636425452102, 92, 0, 92, 0, 0, 0
6184, 1, 1636425452066, 1636425452158, 92, 0, 92, 0, 0, 0
6185, 1, 1636425452570, 1636425452662, 92, 0, 92, 0, 0, 0
6186, 1, 1636425452889, 1636425452982, 93, 1, 92, 0, 0, 0
6187, 1, 1636425453118, 1636425453210, 92, 0, 92, 0, 0, 0
6188, 1, 1636425453569, 1636425453657, 88, 0, 88, 0, 0, 0
6189, 1, 1636425453657, 1636425453750, 93, 1, 92, 0, 0, 0
6191, 1, 1636425453885, 1636425453973, 88, 0, 88, 0, 0, 0
6190, 1, 1636425454014, 1636425454106, 92, 0, 92, 0, 0, 0
6193, 1, 1636425454105, 1636425454198, 93, 1, 92, 0, 0, 0
6194, 1, 1636425454334, 1636425454426, 92, 0, 92, 0, 0, 0
6192, 1, 1636425454561, 1636425454654, 93, 1, 92, 0, 0, 0
6195, 1, 1636425454738, 1636425454829, 91, 0, 91, 0, 0, 0
6196, 1, 1636425455118, 1636425455234, 116, 0, 116, 0, 0, 0
6197, 1, 1636425455329, 1636425455421, 92, 0, 92, 0, 0, 0
6198, 1, 1636425455350, 1636425455442, 92, 0, 92, 0, 0, 0
6199, 1, 1636425455513, 1636425455606, 93, 1, 92, 0, 0, 0
6200, 1, 1636425455674, 1636425455765, 91, 0, 91, 0, 0, 0
6201, 1, 1636425455957, 1636425456054, 97, 1, 96, 0, 0, 0
6202, 1, 1636425456041, 1636425456133, 92, 1, 91, 0, 0, 0
6203, 1, 1636425456077, 1636425456170, 93, 1, 92, 0, 0, 0
6204, 1, 1636425456178, 1636425456270, 92, 0, 92, 0, 0, 0
6205, 1, 1636425456746, 1636425456838, 92, 0, 92, 0, 0, 0
6206, 1, 1636425456993, 1636425457086, 93, 1, 92, 0, 0, 0
6207, 1, 1636425457290, 1636425457381, 91, 0, 91, 0, 0, 0
6209, 1, 1636425457562, 1636425457650, 88, 0, 88, 0, 0, 0
6208, 1, 1636425457738, 1636425457829, 91, 0, 91, 0, 0, 0
6212, 1, 1636425457858, 1636425457949, 91, 0, 91, 0, 0, 0
6210, 1, 1636425458190, 1636425458282, 92, 0, 92, 0, 0, 0
6214, 1, 1636425458313, 1636425458405, 92, 1, 91, 1, 0, 1
6215, 1, 1636425458950, 1636425459041, 91, 0, 91, 0, 0, 0
6216, 1, 1636425459222, 1636425459314, 92, 0, 92, 0, 0, 0
6217, 1, 1636425459446, 1636425459537, 91, 0, 91, 0, 0, 0
6218, 1, 1636425459458, 1636425459550, 92, 0, 92, 0, 0, 0
6219, 1, 1636425459473, 1636425459565, 92, 1, 91, 0, 0, 0
6220, 1, 1636425459790, 1636425459881, 91, 0, 91, 0, 0, 0
6221, 1, 1636425460034, 1636425460126, 92, 0, 92, 0, 0, 0
6222, 1, 1636425460062, 1636425460154, 92, 0, 92, 0, 0, 0
6223, 1, 1636425460254, 1636425460346, 92, 0, 92, 0, 0, 0
6224, 1, 1636425460457, 1636425460550, 93, 1, 92, 1, 0, 1
6225, 1, 1636425461014, 1636425461106, 92, 0, 92, 0, 0, 0
6226, 1, 1636425461326, 1636425461418, 92, 0, 92, 0, 0, 0
6227, 1, 1636425461458, 1636425461550, 92, 0, 92, 0, 0, 0
6228, 1, 1636425461566, 1636425461658, 92, 0, 92, 0, 0, 0
6231, 1, 1636425461934, 1636425462026, 92, 0, 92, 0, 0, 0
6230, 1, 1636425462017, 1636425462110, 93, 1, 92, 0, 0, 0
6232, 1, 1636425462386, 1636425462478, 92, 0, 92, 0, 0, 0
6229, 1, 1636425462474, 1636425462566, 92, 0, 92, 0, 0, 0
6233, 1, 1636425462733, 1636425462826, 93, 0, 93, 0, 0, 0
6234, 1, 1636425463262, 1636425463354, 92, 0, 92, 0, 0, 0
6235, 1, 1636425463489, 1636425463582, 93, 1, 92, 0, 0, 0
6236, 1, 1636425463533, 1636425463622, 89, 0, 89, 0, 0, 0
6237, 1, 1636425463778, 1636425463869, 91, 0, 91, 0, 0, 0
6238, 1, 1636425463957, 1636425464053, 96, 1, 95, 1, 0, 1
6239, 1, 1636425463998, 1636425464089, 91, 0, 91, 0, 0, 0
6240, 1, 1636425464045, 1636425464133, 88, 0, 88, 0, 0, 0
6241, 1, 1636425464266, 1636425464357, 91, 0, 91, 0, 0, 0
6242, 1, 1636425464394, 1636425464486, 92, 0, 92, 0, 0, 0
6243, 1, 1636425464818, 1636425464910, 92, 0, 92, 0, 0, 0
6244, 1, 1636425465274, 1636425465366, 92, 0, 92, 0, 0, 0
6246, 1, 1636425465306, 1636425465398, 92, 0, 92, 0, 0, 0
6247, 1, 1636425465726, 1636425465818, 92, 0, 92, 0, 0, 0
6249, 1, 1636425465882, 1636425465974, 92, 0, 92, 0, 0, 0
6248, 1, 1636425466186, 1636425466278, 92, 0, 92, 0, 0, 0
6250, 1, 1636425466334, 1636425466426, 92, 0, 92, 0, 0, 0
6251, 1, 1636425466765, 1636425466858, 93, 1, 92, 0, 0, 0
6252, 1, 1636425467454, 1636425467545, 91, 0, 91, 0, 0, 0
6253, 1, 1636425467494, 1636425467586, 92, 0, 92, 0, 0, 0
6254, 1, 1636425467530, 1636425467662, 132, 0, 132, 0, 0, 0
6213, 1, 1636425467786, 1636425467878, 92, 0, 92, 0, 0, 0
6255, 1, 1636425467881, 1636425467973, 92, 1, 91, 0, 0, 0
6256, 1, 1636425467929, 1636425468017, 88, 0, 88, 0, 0, 0
6257, 1, 1636425467929, 1636425468017, 88, 0, 88, 0, 0, 0
6258, 1, 1636425468118, 1636425468210, 92, 0, 92, 0, 0, 0
6259, 1, 1636425468322, 1636425468413, 91, 0, 91, 0, 0, 0
6260, 1, 1636425468369, 1636425468457, 88, 0, 88, 0, 0, 0
6262, 1, 1636425468533, 1636425468626, 93, 1, 92, 0, 0, 0
6261, 1, 1636425468770, 1636425468862, 92, 0, 92, 0, 0, 0
6263, 1, 1636425468986, 1636425469078, 92, 0, 92, 0, 0, 0
6264, 1, 1636425469202, 1636425469294, 92, 0, 92, 0, 0, 0
6265, 1, 1636425469550, 1636425469642, 92, 0, 92, 0, 0, 0
6267, 1, 1636425469718, 1636425469810, 92, 0, 92, 0, 0, 0
6266, 1, 1636425470002, 1636425470094, 92, 0, 92, 0, 0, 0
6269, 1, 1636425470198, 1636425470290, 92, 0, 92, 0, 0, 0
6268, 1, 1636425470458, 1636425470550, 92, 0, 92, 0, 0, 0
6270, 1, 1636425470566, 1636425470658, 92, 0, 92, 0, 0, 0
6271, 1, 1636425471362, 1636425471450, 88, 0, 88, 0, 0, 0
6272, 1, 1636425471478, 1636425471570, 92, 0, 92, 0, 0, 0
6273, 1, 1636425471722, 1636425471814, 92, 0, 92, 0, 0, 0
6274, 1, 1636425471874, 1636425471966, 92, 0, 92, 0, 0, 0
6275, 1, 1636425471882, 1636425471973, 91, 0, 91, 0, 0, 0
6276, 1, 1636425472254, 1636425472346, 92, 0, 92, 0, 0, 0
6277, 1, 1636425472274, 1636425472369, 95, 0, 95, 0, 0, 0
6278, 1, 1636425472321, 1636425472410, 89, 0, 89, 0, 0, 0
6280, 1, 1636425472746, 1636425472838, 92, 0, 92, 0, 0, 0
6279, 1, 1636425472769, 1636425472862, 93, 1, 92, 1, 0, 1
6281, 1, 1636425473034, 1636425473126, 92, 0, 92, 0, 0, 0
6282, 1, 1636425473318, 1636425473410, 92, 0, 92, 0, 0, 0
6284, 1, 1636425473738, 1636425473830, 92, 0, 92, 0, 0, 0
6283, 1, 1636425473774, 1636425473866, 92, 0, 92, 0, 0, 0
6286, 1, 1636425474218, 1636425474310, 92, 0, 92, 0, 0, 0
6285, 1, 1636425474226, 1636425474318, 92, 0, 92, 0, 0, 0
6287, 1, 1636425474394, 1636425474486, 92, 0, 92, 0, 0, 0
6288, 1, 1636425475378, 1636425475469, 91, 0, 91, 0, 0, 0
6289, 1, 1636425475490, 1636425475582, 92, 0, 92, 0, 0, 0
6290, 1, 1636425475593, 1636425475685, 92, 1, 91, 1, 0, 1
6291, 1, 1636425475605, 1636425475697, 92, 1, 91, 0, 0, 0
6292, 1, 1636425475729, 1636425475818, 89, 0, 89, 0, 0, 0
6293, 1, 1636425476110, 1636425476201, 91, 0, 91, 0, 0, 0
6294, 1, 1636425476110, 1636425476202, 92, 0, 92, 0, 0, 0
6295, 1, 1636425476113, 1636425476201, 88, 0, 88, 0, 0, 0
6296, 1, 1636425476382, 1636425476474, 92, 0, 92, 0, 0, 0
6297, 1, 1636425476561, 1636425476653, 92, 1, 91, 0, 1, 1
6298, 1, 1636425476874, 1636425476965, 91, 0, 91, 0, 0, 0
6299, 1, 1636425476894, 1636425476985, 91, 0, 91, 0, 0, 0
6300, 1, 1636425477338, 1636425477430, 92, 0, 92, 0, 0, 0
6301, 1, 1636425477534, 1636425477626, 92, 0, 92, 0, 0, 0
6302, 1, 1636425477794, 1636425477886, 92, 0, 92, 0, 0, 0
6303, 1, 1636425478018, 1636425478109, 91, 0, 91, 0, 0, 0
6304, 1, 1636425478246, 1636425478337, 91, 0, 91, 0, 0, 0
6305, 1, 1636425478394, 1636425478486, 92, 0, 92, 0, 0, 0
6306, 1, 1636425479333, 1636425479425, 92, 1, 91, 0, 0, 0
6307, 1, 1636425479342, 1636425479434, 92, 0, 92, 0, 0, 0
6308, 1, 1636425479546, 1636425479637, 91, 0, 91, 0, 0, 0
6309, 1, 1636425479570, 1636425479662, 92, 0, 92, 0, 0, 0
6310, 1, 1636425479813, 1636425479906, 93, 1, 92, 0, 0, 0
6311, 1, 1636425479966, 1636425480054, 88, 0, 88, 0, 0, 0
6312, 1, 1636425480145, 1636425480237, 92, 1, 91, 0, 0, 0
6313, 1, 1636425480178, 1636425480269, 91, 0, 91, 0, 0, 0
6314, 1, 1636425480313, 1636425480402, 89, 0, 89, 0, 0, 0
6315, 1, 1636425480690, 1636425480782, 92, 0, 92, 0, 0, 0
6316, 1, 1636425480813, 1636425480906, 93, 1, 92, 0, 0, 0
6317, 1, 1636425481013, 1636425481106, 93, 1, 92, 1, 0, 1
6318, 1, 1636425481318, 1636425481410, 92, 0, 92, 0, 0, 0
6320, 1, 1636425481594, 1636425481686, 92, 0, 92, 0, 0, 0
6319, 1, 1636425481769, 1636425481862, 93, 1, 92, 1, 0, 1
6321, 1, 1636425482226, 1636425482318, 92, 0, 92, 0, 0, 0
6322, 1, 1636425482290, 1636425482382, 92, 0, 92, 0, 0, 0
6323, 1, 1636425482598, 1636425482689, 91, 0, 91, 0, 0, 0
6324, 1, 1636425483470, 1636425483562, 92, 0, 92, 0, 0, 0
6325, 1, 1636425483545, 1636425483638, 93, 1, 92, 0, 0, 0
6326, 1, 1636425483674, 1636425483766, 92, 0, 92, 0, 0, 0
6327, 1, 1636425483782, 1636425483873, 91, 0, 91, 0, 0, 0
6328, 1, 1636425483794, 1636425483886, 92, 0, 92, 0, 0, 0
6329, 1, 1636425484098, 1636425484190, 92, 0, 92, 0, 0, 0
6330, 1, 1636425484394, 1636425484485, 91, 0, 91, 0, 0, 0
6331, 1, 1636425484441, 1636425484529, 88, 0, 88, 0, 0, 0
6332, 1, 1636425484453, 1636425484546, 93, 1, 92, 0, 0, 0
6333, 1, 1636425484822, 1636425484913, 91, 0, 91, 0, 0, 0
6334, 1, 1636425484906, 1636425484997, 91, 0, 91, 0, 0, 0
6335, 1, 1636425485097, 1636425485186, 89, 0, 89, 0, 0, 0
6336, 1, 1636425485601, 1636425485693, 92, 1, 91, 0, 0, 0
6338, 1, 1636425485818, 1636425485910, 92, 0, 92, 0, 0, 0
6339, 1, 1636425486058, 1636425486149, 91, 0, 91, 0, 0, 0
6340, 1, 1636425486510, 1636425486602, 92, 0, 92, 0, 0, 0
6337, 1, 1636425486517, 1636425486609, 92, 1, 91, 0, 0, 0
6341, 1, 1636425486769, 1636425486861, 92, 1, 91, 0, 0, 0
6342, 1, 1636425487170, 1636425487262, 92, 0, 92, 0, 0, 0
6343, 1, 1636425487506, 1636425487598, 92, 0, 92, 0, 0, 0
6344, 1, 1636425487685, 1636425487773, 88, 0, 88, 0, 0, 0
6345, 1, 1636425487798, 1636425487890, 92, 0, 92, 0, 0, 0
6346, 1, 1636425487877, 1636425487970, 93, 1, 92, 0, 0, 0
6347, 1, 1636425488070, 1636425488162, 92, 0, 92, 0, 0, 0
6348, 1, 1636425488201, 1636425488294, 93, 1, 92, 0, 0, 0
6349, 1, 1636425488286, 1636425488377, 91, 0, 91, 0, 0, 0
6350, 1, 1636425488622, 1636425488710, 88, 0, 88, 0, 0, 0
6351, 1, 1636425488657, 1636425488746, 89, 0, 89, 0, 0, 0
6352, 1, 1636425488806, 1636425488898, 92, 0, 92, 0, 0, 0
6353, 1, 1636425489302, 1636425489394, 92, 0, 92, 0, 0, 0
6354, 1, 1636425489538, 1636425489630, 92, 0, 92, 0, 0, 0
6355, 1, 1636425489754, 1636425489846, 92, 0, 92, 0, 0, 0
6357, 1, 1636425490202, 1636425490294, 92, 0, 92, 0, 0, 0
6358, 1, 1636425490230, 1636425490317, 87, 0, 87, 0, 0, 0
6356, 1, 1636425490650, 1636425490742, 92, 0, 92, 0, 0, 0
6359, 1, 1636425490970, 1636425491062, 92, 0, 92, 0, 0, 0
6360, 1, 1636425491038, 1636425491130, 92, 0, 92, 0, 0, 0
6361, 1, 1636425491574, 1636425491666, 92, 0, 92, 0, 0, 0
6362, 1, 1636425491582, 1636425491674, 92, 0, 92, 0, 0, 0
6363, 1, 1636425492038, 1636425492130, 92, 0, 92, 0, 0, 0
6364, 1, 1636425492046, 1636425492138, 92, 0, 92, 0, 0, 0
6365, 1, 1636425492358, 1636425492450, 92, 0, 92, 0, 0, 0
6366, 1, 1636425492426, 1636425492517, 91, 0, 91, 0, 0, 0
6367, 1, 1636425492533, 1636425492626, 93, 1, 92, 0, 0, 0
6368, 1, 1636425492653, 1636425492746, 93, 1, 92, 0, 0, 0
6369, 1, 1636425492998, 1636425493090, 92, 0, 92, 0, 0, 0
6370, 1, 1636425493049, 1636425493142, 93, 0, 93, 0, 0, 0
6371, 1, 1636425493529, 1636425493622, 93, 1, 92, 0, 0, 0
6374, 1, 1636425493782, 1636425493874, 92, 0, 92, 0, 0, 0
6373, 1, 1636425493982, 1636425494074, 92, 0, 92, 0, 0, 0
6372, 1, 1636425494434, 1636425494526, 92, 0, 92, 0, 0, 0
6375, 1, 1636425494514, 1636425494606, 92, 0, 92, 0, 0, 0
6376, 1, 1636425494846, 1636425494938, 92, 0, 92, 0, 0, 0
6377, 1, 1636425495002, 1636425495094, 92, 0, 92, 0, 0, 0
6378, 1, 1636425495521, 1636425495614, 93, 1, 92, 0, 0, 0
6379, 1, 1636425495614, 1636425495705, 91, 0, 91, 0, 0, 0
6380, 1, 1636425496022, 1636425496114, 92, 0, 92, 0, 0, 0
6381, 1, 1636425496030, 1636425496122, 92, 0, 92, 0, 0, 0
6382, 1, 1636425496306, 1636425496402, 96, 0, 96, 0, 0, 0
6384, 1, 1636425496457, 1636425496550, 93, 1, 92, 0, 0, 0
6383, 1, 1636425496457, 1636425496550, 93, 1, 92, 1, 0, 1
6385, 1, 1636425496770, 1636425496862, 92, 0, 92, 0, 0, 0
6386, 1, 1636425496946, 1636425497038, 92, 0, 92, 0, 0, 0
6387, 1, 1636425497286, 1636425497378, 92, 0, 92, 0, 0, 0
6388, 1, 1636425497478, 1636425497570, 92, 0, 92, 0, 0, 0
6391, 1, 1636425498018, 1636425498110, 92, 0, 92, 0, 0, 0
6392, 1, 1636425498750, 1636425498842, 92, 0, 92, 0, 0, 0
6393, 1, 1636425498801, 1636425498894, 93, 1, 92, 0, 0, 0
6394, 1, 1636425499202, 1636425499294, 92, 0, 92, 0, 0, 0
6395, 1, 1636425499222, 1636425499313, 91, 0, 91, 0, 0, 0
6396, 1, 1636425499450, 1636425499542, 92, 0, 92, 0, 0, 0
6397, 1, 1636425499994, 1636425500086, 92, 0, 92, 0, 0, 0
6398, 1, 1636425500069, 1636425500158, 89, 0, 89, 0, 0, 0
6399, 1, 1636425500285, 1636425500378, 93, 1, 92, 0, 0, 0
6400, 1, 1636425500489, 1636425500582, 93, 1, 92, 0, 0, 0
6401, 1, 1636425500509, 1636425500606, 97, 1, 96, 0, 1, 1
6402, 1, 1636425500646, 1636425500737, 91, 0, 91, 0, 0, 0
6403, 1, 1636425500758, 1636425500849, 91, 0, 91, 0, 0, 0
6404, 1, 1636425501238, 1636425501329, 91, 0, 91, 0, 0, 0
6405, 1, 1636425501274, 1636425501361, 87, 0, 87, 0, 0, 0
6406, 1, 1636425501986, 1636425502078, 92, 0, 92, 0, 0, 0
6407, 1, 1636425502662, 1636425502754, 92, 0, 92, 0, 0, 0
6408, 1, 1636425502738, 1636425502830, 92, 0, 92, 0, 0, 0
6409, 1, 1636425502901, 1636425502994, 93, 1, 92, 0, 1, 1
6410, 1, 1636425502993, 1636425503086, 93, 1, 92, 0, 0, 0
6411, 1, 1636425503278, 1636425503370, 92, 0, 92, 0, 0, 0
6412, 1, 1636425503834, 1636425503926, 92, 0, 92, 0, 0, 0
6414, 1, 1636425504190, 1636425504281, 91, 0, 91, 0, 0, 0
6415, 1, 1636425504277, 1636425504370, 93, 1, 92, 0, 1, 1
6416, 1, 1636425504417, 1636425504509, 92, 0, 92, 0, 0, 0
6417, 1, 1636425504546, 1636425504638, 92, 0, 92, 0, 0, 0
6419, 1, 1636425505010, 1636425505102, 92, 0, 92, 0, 0, 0
6422, 1, 1636425506653, 1636425506746, 93, 1, 92, 0, 0, 0
6423, 1, 1636425506846, 1636425506938, 92, 0, 92, 0, 0, 0
6426, 1, 1636425507030, 1636425507121, 91, 0, 91, 0, 0, 0
6425, 1, 1636425507106, 1636425507198, 92, 0, 92, 0, 0, 0
6427, 1, 1636425507809, 1636425507902, 93, 1, 92, 0, 1, 1
6428, 1, 1636425507938, 1636425508030, 92, 0, 92, 0, 0, 0
6430, 1, 1636425508265, 1636425508358, 93, 1, 92, 0, 1, 1
6431, 1, 1636425508374, 1636425508466, 92, 0, 92, 0, 0, 0
6432, 1, 1636425508381, 1636425508474, 93, 1, 92, 0, 1, 1
6429, 1, 1636425508393, 1636425508482, 89, 0, 89, 0, 0, 0
6433, 1, 1636425508537, 1636425508630, 93, 1, 92, 0, 1, 1
6434, 1, 1636425508966, 1636425509058, 92, 0, 92, 0, 0, 0
6435, 1, 1636425510766, 1636425510858, 92, 0, 92, 0, 0, 0
6436, 1, 1636425510970, 1636425511062, 92, 0, 92, 0, 0, 0
6437, 1, 1636425511222, 1636425511314, 92, 0, 92, 0, 0, 0
6438, 1, 1636425511730, 1636425511822, 92, 0, 92, 0, 0, 0
6439, 1, 1636425512182, 1636425512274, 92, 0, 92, 0, 0, 0
6440, 1, 1636425512545, 1636425512638, 93, 1, 92, 1, 0, 1
6441, 1, 1636425512550, 1636425512641, 91, 0, 91, 0, 0, 0
6442, 1, 1636425512630, 1636425512722, 92, 0, 92, 0, 0, 0
6443, 1, 1636425514406, 1636425514498, 92, 0, 92, 0, 0, 0
6444, 1, 1636425514938, 1636425515030, 92, 0, 92, 0, 0, 0
6445, 1, 1636425515110, 1636425515202, 92, 0, 92, 0, 0, 0
6446, 1, 1636425515282, 1636425515378, 96, 0, 96, 0, 0, 0
6447, 1, 1636425515390, 1636425515482, 92, 0, 92, 0, 0, 0
6448, 1, 1636425515661, 1636425515750, 89, 0, 89, 0, 0, 0
6449, 1, 1636425515797, 1636425515890, 93, 1, 92, 0, 0, 0
6450, 1, 1636425516110, 1636425516201, 91, 0, 91, 0, 0, 0
6451, 1, 1636425516402, 1636425516494, 92, 0, 92, 0, 0, 0
6452, 1, 1636425516714, 1636425516818, 104, 0, 104, 0, 0, 0
6453, 1, 1636425516821, 1636425516914, 93, 1, 92, 0, 0, 0
6454, 1, 1636425516825, 1636425516918, 93, 1, 92, 1, 0, 1
6455, 1, 1636425517258, 1636425517350, 92, 0, 92, 0, 0, 0
6456, 1, 1636425518274, 1636425518366, 92, 0, 92, 0, 0, 0
6457, 1, 1636425519150, 1636425519241, 91, 0, 91, 0, 0, 0
6458, 1, 1636425519194, 1636425519285, 91, 0, 91, 0, 0, 0
6459, 1, 1636425519205, 1636425519298, 93, 1, 92, 0, 1, 1
6460, 1, 1636425519658, 1636425519749, 91, 0, 91, 0, 0, 0
6461, 1, 1636425519662, 1636425519754, 92, 0, 92, 0, 0, 0
6462, 1, 1636425520114, 1636425520205, 91, 0, 91, 0, 0, 0
6463, 1, 1636425520498, 1636425520590, 92, 0, 92, 0, 0, 0
6464, 1, 1636425520754, 1636425520846, 92, 0, 92, 0, 0, 0
6465, 1, 1636425520926, 1636425521017, 91, 0, 91, 0, 0, 0
6466, 1, 1636425521077, 1636425521170, 93, 1, 92, 0, 0, 0
6467, 1, 1636425522306, 1636425522398, 92, 0, 92, 0, 0, 0
6468, 1, 1636425522898, 1636425522990, 92, 0, 92, 0, 0, 0
6469, 1, 1636425523010, 1636425523102, 92, 0, 92, 0, 0, 0
6470, 1, 1636425523182, 1636425523274, 92, 0, 92, 0, 0, 0
6471, 1, 1636425523462, 1636425523554, 92, 0, 92, 0, 0, 0
6472, 1, 1636425523694, 1636425523786, 92, 0, 92, 0, 0, 0
6473, 1, 1636425524150, 1636425524242, 92, 0, 92, 0, 0, 0
6474, 1, 1636425524526, 1636425524618, 92, 0, 92, 0, 0, 0
6475, 1, 1636425524690, 1636425524782, 92, 0, 92, 0, 0, 0
6476, 1, 1636425524958, 1636425525050, 92, 0, 92, 0, 0, 0
6477, 1, 1636425525478, 1636425525570, 92, 0, 92, 0, 0, 0
6478, 1, 1636425526106, 1636425526197, 91, 0, 91, 0, 0, 0
6479, 1, 1636425526598, 1636425526689, 91, 0, 91, 0, 0, 0
6480, 1, 1636425526982, 1636425527074, 92, 0, 92, 0, 0, 0
6481, 1, 1636425527278, 1636425527370, 92, 0, 92, 0, 0, 0
6482, 1, 1636425527494, 1636425527586, 92, 0, 92, 0, 0, 0
6483, 1, 1636425527730, 1636425527822, 92, 0, 92, 0, 0, 0
6484, 1, 1636425527946, 1636425528038, 92, 0, 92, 0, 0, 0
6485, 1, 1636425528241, 1636425528330, 89, 0, 89, 0, 0, 0
6486, 1, 1636425528750, 1636425528842, 92, 0, 92, 0, 0, 0
6487, 1, 1636425528762, 1636425528854, 92, 0, 92, 0, 0, 0
6488, 1, 1636425529466, 1636425529557, 91, 0, 91, 0, 0, 0
6489, 1, 1636425529938, 1636425530030, 92, 0, 92, 0, 0, 0
6490, 1, 1636425530358, 1636425530450, 92, 0, 92, 0, 0, 0
6491, 1, 1636425530810, 1636425530902, 92, 0, 92, 0, 0, 0
6492, 1, 1636425530998, 1636425531090, 92, 0, 92, 0, 0, 0
6493, 1, 1636425531353, 1636425531446, 93, 1, 92, 0, 1, 1
6494, 1, 1636425531498, 1636425531590, 92, 0, 92, 0, 0, 0
6495, 1, 1636425531810, 1636425531902, 92, 0, 92, 0, 0, 0
6496, 1, 1636425532374, 1636425532466, 92, 0, 92, 0, 0, 0
6497, 1, 1636425532590, 1636425532682, 92, 0, 92, 0, 0, 0
6498, 1, 1636425532854, 1636425532946, 92, 0, 92, 0, 0, 0
6499, 1, 1636425533905, 1636425533994, 89, 0, 89, 0, 0, 0
6500, 1, 1636425533933, 1636425534026, 93, 1, 92, 0, 0, 0
6501, 1, 1636425534490, 1636425534582, 92, 0, 92, 0, 0, 0
6502, 1, 1636425535034, 1636425535126, 92, 0, 92, 0, 0, 0
6503, 1, 1636425535126, 1636425535217, 91, 0, 91, 0, 0, 0
6504, 1, 1636425535586, 1636425535682, 96, 0, 96, 0, 0, 0
6505, 1, 1636425535602, 1636425535694, 92, 0, 92, 0, 0, 0
6506, 1, 1636425536274, 1636425536366, 92, 0, 92, 0, 0, 0
6507, 1, 1636425536354, 1636425536446, 92, 0, 92, 0, 0, 0
6508, 1, 1636425536922, 1636425537013, 91, 0, 91, 0, 0, 0
6509, 1, 1636425537846, 1636425537938, 92, 0, 92, 0, 0, 0
6510, 1, 1636425538138, 1636425538230, 92, 0, 92, 0, 0, 0
6511, 1, 1636425538594, 1636425538686, 92, 0, 92, 0, 0, 0
6512, 1, 1636425539106, 1636425539197, 91, 0, 91, 0, 0, 0
6513, 1, 1636425539142, 1636425539234, 92, 0, 92, 0, 0, 0
6514, 1, 1636425539558, 1636425539650, 92, 0, 92, 0, 0, 0
6515, 1, 1636425539806, 1636425539898, 92, 0, 92, 0, 0, 0
6516, 1, 1636425540478, 1636425540570, 92, 0, 92, 0, 0, 0
6517, 1, 1636425540638, 1636425540730, 92, 0, 92, 0, 0, 0
6518, 1, 1636425540898, 1636425540990, 92, 0, 92, 0, 0, 0
6519, 1, 1636425542166, 1636425542257, 91, 0, 91, 0, 0, 0
6520, 1, 1636425542305, 1636425542394, 89, 0, 89, 0, 0, 0
6521, 1, 1636425542769, 1636425542858, 89, 1, 88, 0, 0, 0
6522, 1, 1636425543234, 1636425543325, 91, 0, 91, 0, 0, 0
6523, 1, 1636425543310, 1636425543402, 92, 0, 92, 0, 0, 0
6524, 1, 1636425543686, 1636425543778, 92, 0, 92, 0, 0, 0
6525, 1, 1636425543973, 1636425544066, 93, 1, 92, 0, 1, 1
6526, 1, 1636425544642, 1636425544730, 88, 0, 88, 0, 0, 0
6527, 1, 1636425544730, 1636425544822, 92, 0, 92, 0, 0, 0
6528, 1, 1636425544797, 1636425544890, 93, 1, 92, 1, 0, 1
6529, 1, 1636425546293, 1636425546382, 89, 0, 89, 0, 0, 0
6530, 1, 1636425546582, 1636425546674, 92, 0, 92, 0, 0, 0
6531, 1, 1636425547033, 1636425547126, 93, 1, 92, 0, 0, 0
6532, 1, 1636425547365, 1636425547458, 93, 1, 92, 1, 0, 1
6534, 1, 1636425547590, 1636425547681, 91, 0, 91, 0, 0, 0
6533, 1, 1636425547822, 1636425547914, 92, 0, 92, 0, 0, 0
6535, 1, 1636425548242, 1636425548333, 91, 0, 91, 0, 0, 0
6536, 1, 1636425548434, 1636425548525, 91, 0, 91, 0, 0, 0
6537, 1, 1636425548801, 1636425548889, 88, 0, 88, 0, 0, 0
6538, 1, 1636425548845, 1636425548933, 88, 0, 88, 0, 0, 0
6539, 1, 1636425550245, 1636425550333, 88, 1, 87, 0, 1, 1
6540, 1, 1636425550642, 1636425550733, 91, 0, 91, 0, 0, 0
6541, 1, 1636425550697, 1636425550785, 88, 1, 87, 1, 0, 1
6542, 1, 1636425551061, 1636425551150, 89, 0, 89, 0, 0, 0
6543, 1, 1636425551253, 1636425551346, 93, 1, 92, 0, 0, 0
6544, 1, 1636425551505, 1636425551593, 88, 1, 87, 0, 0, 0
6545, 1, 1636425552046, 1636425552138, 92, 0, 92, 0, 0, 0
6546, 1, 1636425552509, 1636425552602, 93, 1, 92, 1, 0, 1
6547, 1, 1636425552670, 1636425552762, 92, 0, 92, 0, 0, 0
6548, 1, 1636425554434, 1636425554526, 92, 0, 92, 0, 0, 0
6549, 1, 1636425554885, 1636425554978, 93, 1, 92, 0, 0, 0
6550, 1, 1636425555146, 1636425555238, 92, 0, 92, 0, 0, 0
6551, 1, 1636425555530, 1636425555622, 92, 0, 92, 0, 0, 0
6552, 1, 1636425556318, 1636425556409, 91, 0, 91, 0, 0, 0
6553, 1, 1636425556781, 1636425556874, 93, 1, 92, 1, 0, 1
6554, 1, 1636425556781, 1636425556874, 93, 1, 92, 1, 0, 1
6555, 1, 1636425558154, 1636425558246, 92, 0, 92, 0, 0, 0
6556, 1, 1636425558657, 1636425558750, 93, 1, 92, 0, 0, 0
6557, 1, 1636425559174, 1636425559266, 92, 0, 92, 0, 0, 0
6558, 1, 1636425559630, 1636425559718, 88, 0, 88, 0, 0, 0
6559, 1, 1636425560081, 1636425560174, 93, 1, 92, 0, 1, 1
6560, 1, 1636425560557, 1636425560649, 92, 1, 91, 0, 1, 1
6561, 1, 1636425560590, 1636425560682, 92, 0, 92, 0, 0, 0
6562, 1, 1636425562174, 1636425562266, 92, 0, 92, 0, 0, 0
6563, 1, 1636425562678, 1636425562770, 92, 0, 92, 0, 0, 0
6564, 1, 1636425563478, 1636425563570, 92, 0, 92, 0, 0, 0
6565, 1, 1636425564250, 1636425564342, 92, 0, 92, 0, 0, 0
6566, 1, 1636425564373, 1636425564462, 89, 0, 89, 0, 0, 0
6567, 1, 1636425564702, 1636425564794, 92, 0, 92, 0, 0, 0
6568, 1, 1636425566150, 1636425566242, 92, 0, 92, 0, 0, 0
6569, 1, 1636425566658, 1636425566750, 92, 0, 92, 0, 0, 0
6570, 1, 1636425567458, 1636425567550, 92, 0, 92, 0, 0, 0
6571, 1, 1636425568190, 1636425568282, 92, 0, 92, 0, 0, 0
6572, 1, 1636425568405, 1636425568494, 89, 0, 89, 0, 0, 0
6573, 1, 1636425568642, 1636425568734, 92, 0, 92, 0, 0, 0
6574, 1, 1636425570434, 1636425570526, 92, 0, 92, 0, 0, 0
6575, 1, 1636425570941, 1636425571034, 93, 1, 92, 0, 0, 0
6576, 1, 1636425571585, 1636425571678, 93, 1, 92, 0, 0, 0
6577, 1, 1636425572242, 1636425572333, 91, 0, 91, 0, 0, 0
6578, 1, 1636425572474, 1636425572566, 92, 0, 92, 0, 0, 0
6579, 1, 1636425572922, 1636425573014, 92, 0, 92, 0, 0, 0
6580, 1, 1636425576070, 1636425576162, 92, 0, 92, 0, 0, 0
6581, 1, 1636425579750, 1636425579842, 92, 0, 92, 0, 0, 0
6582, 1, 1636425583958, 1636425584050, 92, 0, 92, 0, 0, 0
6583, 1, 1636425588134, 1636425588226, 92, 0, 92, 0, 0, 0
6584, 1, 1636425592402, 1636425592494, 92, 0, 92, 0, 0, 0
6585, 1, 1636425596206, 1636425596298, 92, 0, 92, 0, 0, 0
6586, 1, 1636425600234, 1636425600322, 88, 0, 88, 0, 0, 0
6587, 1, 1636425603954, 1636425604046, 92, 0, 92, 0, 0, 0
6588, 1, 1636425607969, 1636425608061, 92, 1, 91, 1, 0, 1
6589, 1, 1636425611906, 1636425611998, 92, 0, 92, 0, 0, 0
6590, 1, 1636425616194, 1636425616285, 91, 0, 91, 0, 0, 0
6591, 1, 1636425620290, 1636425620382, 92, 0, 92, 0, 0, 0
6592, 1, 1636425624006, 1636425624097, 91, 0, 91, 0, 0, 0
6593, 1, 1636425627706, 1636425627797, 91, 0, 91, 0, 0, 0
6594, 1, 1636425631470, 1636425631562, 92, 0, 92, 0, 0, 0
6595, 1, 1636425635370, 1636425635462, 92, 0, 92, 0, 0, 0
6596, 1, 1636425639222, 1636425639314, 92, 0, 92, 0, 0, 0
6597, 1, 1636425643234, 1636425643326, 92, 0, 92, 0, 0, 0
6598, 1, 1636425647194, 1636425647286, 92, 0, 92, 0, 0, 0
6599, 1, 1636425651266, 1636425651358, 92, 0, 92, 0, 0, 0
6600, 1, 1636425655338, 1636425655430, 92, 0, 92, 0, 0, 0
