Xid, State, StartTime, EndTime, TransactionTime, ExecuteTime, CommunicationTime, ReadTime, WriteTime, DBTime
79, 1, 1636420181040, 1636420181547, 507, 80, 427, 35, 6, 41
82, 1, 1636420181890, 1636420182299, 409, 6, 403, 1, 1, 2
85, 1, 1636420182562, 1636420182970, 408, 4, 404, 2, 1, 3
89, 1, 1636420183238, 1636420183646, 408, 4, 404, 2, 1, 3
92, 1, 1636420183910, 1636420184319, 409, 4, 405, 2, 0, 2
95, 1, 1636420184582, 1636420184986, 404, 4, 400, 0, 0, 0
98, 1, 1636420185250, 1636420185658, 408, 4, 404, 0, 0, 0
101, 1, 1636420185922, 1636420186330, 408, 3, 405, 2, 1, 3
104, 1, 1636420186598, 1636420187017, 419, 4, 415, 3, 0, 3
108, 1, 1636420187282, 1636420187695, 413, 4, 409, 2, 0, 2
111, 1, 1636420187958, 1636420188362, 404, 2, 402, 1, 1, 2
114, 1, 1636420188626, 1636420189034, 408, 2, 406, 0, 1, 1
117, 1, 1636420189302, 1636420189710, 408, 3, 405, 2, 0, 2
120, 1, 1636420189974, 1636420190382, 408, 4, 404, 2, 0, 2
123, 1, 1636420190654, 1636420191062, 408, 2, 406, 0, 1, 1
126, 1, 1636420191326, 1636420191739, 413, 6, 407, 0, 0, 0
130, 1, 1636420192002, 1636420192366, 364, 3, 361, 2, 0, 2
133, 1, 1636420192630, 1636420192994, 364, 1, 363, 1, 0, 1
136, 1, 1636420193258, 1636420193626, 368, 2, 366, 2, 0, 2
138, 1, 1636420193890, 1636420194258, 368, 2, 366, 0, 1, 1
141, 1, 1636420194522, 1636420194886, 364, 3, 361, 2, 0, 2
145, 1, 1636420195154, 1636420195510, 356, 3, 353, 1, 0, 1
147, 1, 1636420195774, 1636420196134, 360, 1, 359, 0, 0, 0
150, 1, 1636420196398, 1636420196758, 360, 2, 358, 0, 1, 1
153, 1, 1636420197022, 1636420197386, 364, 2, 362, 0, 0, 0
156, 1, 1636420197650, 1636420198014, 364, 3, 361, 0, 0, 0
160, 1, 1636420198278, 1636420198642, 364, 0, 364, 0, 0, 0
163, 1, 1636420198906, 1636420199265, 359, 2, 357, 0, 0, 0
166, 1, 1636420199530, 1636420199894, 364, 2, 362, 0, 0, 0
168, 1, 1636420200158, 1636420200518, 360, 1, 359, 0, 0, 0
171, 1, 1636420200782, 1636420201146, 364, 1, 363, 0, 0, 0
174, 1, 1636420201410, 1636420201774, 364, 2, 362, 0, 0, 0
177, 1, 1636420202038, 1636420202394, 356, 1, 355, 0, 0, 0
180, 1, 1636420202658, 1636420203026, 368, 0, 368, 0, 0, 0
183, 1, 1636420203290, 1636420203654, 364, 1, 363, 0, 1, 1
186, 1, 1636420203918, 1636420204282, 364, 1, 363, 0, 0, 0
190, 1, 1636420204546, 1636420204910, 364, 0, 364, 0, 0, 0
192, 1, 1636420205174, 1636420205542, 368, 1, 367, 0, 1, 1
196, 1, 1636420205806, 1636420206170, 364, 1, 363, 0, 0, 0
199, 1, 1636420206434, 1636420206790, 356, 0, 356, 0, 0, 0
202, 1, 1636420207058, 1636420207426, 368, 1, 367, 0, 0, 0
206, 1, 1636420207690, 1636420208054, 364, 0, 364, 0, 0, 0
209, 1, 1636420208318, 1636420208678, 360, 1, 359, 0, 0, 0
212, 1, 1636420208942, 1636420209302, 360, 1, 359, 0, 1, 1
215, 1, 1636420209570, 1636420209934, 364, 1, 363, 0, 0, 0
218, 1, 1636420210198, 1636420210557, 359, 0, 359, 0, 0, 0
221, 1, 1636420210822, 1636420211186, 364, 0, 364, 0, 0, 0
224, 1, 1636420211450, 1636420211813, 363, 2, 361, 0, 0, 0
227, 1, 1636420212078, 1636420212442, 364, 0, 364, 0, 0, 0
230, 1, 1636420212706, 1636420213070, 364, 0, 364, 0, 0, 0
233, 1, 1636420213334, 1636420213702, 368, 1, 367, 0, 0, 0
236, 1, 1636420213965, 1636420214326, 361, 3, 358, 1, 0, 1
239, 1, 1636420214590, 1636420214958, 368, 0, 368, 0, 0, 0
242, 1, 1636420215230, 1636420215594, 364, 0, 364, 0, 0, 0
245, 1, 1636420215858, 1636420216218, 360, 1, 359, 0, 0, 0
248, 1, 1636420216486, 1636420216850, 364, 0, 364, 0, 0, 0
251, 1, 1636420217114, 1636420217478, 364, 1, 363, 1, 0, 1
254, 1, 1636420217742, 1636420218102, 360, 0, 360, 0, 0, 0
257, 1, 1636420218365, 1636420218726, 361, 1, 360, 0, 0, 0
260, 1, 1636420218990, 1636420219350, 360, 1, 359, 0, 1, 1
263, 1, 1636420219614, 1636420219974, 360, 1, 359, 0, 0, 0
266, 1, 1636420220238, 1636420220598, 360, 2, 358, 0, 0, 0
269, 1, 1636420220862, 1636420221218, 356, 0, 356, 0, 0, 0
272, 1, 1636420221482, 1636420221846, 364, 0, 364, 0, 0, 0
275, 1, 1636420222110, 1636420222474, 364, 5, 359, 3, 1, 4
278, 1, 1636420222742, 1636420223098, 356, 0, 356, 0, 0, 0
281, 1, 1636420223362, 1636420223722, 360, 0, 360, 0, 0, 0
284, 1, 1636420223986, 1636420224346, 360, 0, 360, 0, 0, 0
287, 1, 1636420224610, 1636420224970, 360, 0, 360, 0, 0, 0
290, 1, 1636420225234, 1636420225594, 360, 1, 359, 1, 0, 1
293, 1, 1636420225858, 1636420226222, 364, 1, 363, 1, 0, 1
296, 1, 1636420226489, 1636420226850, 361, 1, 360, 1, 0, 1
299, 1, 1636420227114, 1636420227478, 364, 1, 363, 0, 0, 0
302, 1, 1636420227742, 1636420228110, 368, 0, 368, 0, 0, 0
305, 1, 1636420228374, 1636420228729, 355, 2, 353, 0, 0, 0
308, 1, 1636420228994, 1636420229358, 364, 1, 363, 0, 0, 0
311, 1, 1636420229622, 1636420229982, 360, 0, 360, 0, 0, 0
314, 1, 1636420230246, 1636420230606, 360, 1, 359, 0, 0, 0
317, 1, 1636420230869, 1636420231230, 361, 1, 360, 0, 0, 0
320, 1, 1636420231498, 1636420231858, 360, 0, 360, 0, 0, 0
323, 1, 1636420232122, 1636420232482, 360, 0, 360, 0, 0, 0
326, 1, 1636420232746, 1636420233110, 364, 0, 364, 0, 0, 0
329, 1, 1636420233373, 1636420233742, 369, 2, 367, 0, 0, 0
332, 1, 1636420234006, 1636420234366, 360, 0, 360, 0, 0, 0
335, 1, 1636420234630, 1636420234982, 352, 0, 352, 0, 0, 0
338, 1, 1636420235245, 1636420235606, 361, 2, 359, 0, 0, 0
341, 1, 1636420235870, 1636420236234, 364, 0, 364, 0, 0, 0
344, 1, 1636420236497, 1636420236854, 357, 1, 356, 0, 0, 0
347, 1, 1636420237118, 1636420237481, 363, 0, 363, 0, 0, 0
350, 1, 1636420237746, 1636420238110, 364, 1, 363, 0, 0, 0
353, 1, 1636420238374, 1636420238733, 359, 0, 359, 0, 0, 0
356, 1, 1636420238998, 1636420239358, 360, 1, 359, 1, 0, 1
359, 1, 1636420239622, 1636420239986, 364, 1, 363, 0, 0, 0
362, 1, 1636420240250, 1636420240613, 363, 2, 361, 0, 0, 0
365, 1, 1636420240877, 1636420241238, 361, 2, 359, 0, 0, 0
368, 1, 1636420241502, 1636420241866, 364, 2, 362, 0, 0, 0
371, 1, 1636420242129, 1636420242490, 361, 0, 361, 0, 0, 0
374, 1, 1636420242753, 1636420243114, 361, 1, 360, 0, 0, 0
377, 1, 1636420243382, 1636420243742, 360, 0, 360, 0, 0, 0
380, 1, 1636420244005, 1636420244366, 361, 1, 360, 0, 0, 0
383, 1, 1636420244630, 1636420244989, 359, 0, 359, 0, 0, 0
386, 1, 1636420245254, 1636420245614, 360, 0, 360, 0, 0, 0
389, 1, 1636420245878, 1636420246234, 356, 1, 355, 0, 0, 0
392, 1, 1636420246498, 1636420246858, 360, 1, 359, 0, 0, 0
395, 1, 1636420247122, 1636420247482, 360, 1, 359, 1, 0, 1
398, 1, 1636420247746, 1636420248110, 364, 0, 364, 0, 0, 0
401, 1, 1636420248374, 1636420248730, 356, 1, 355, 0, 0, 0
404, 1, 1636420248994, 1636420249358, 364, 1, 363, 0, 0, 0
407, 1, 1636420249630, 1636420249990, 360, 0, 360, 0, 0, 0
410, 1, 1636420250258, 1636420250614, 356, 1, 355, 1, 0, 1
413, 1, 1636420250877, 1636420251242, 365, 2, 363, 1, 0, 1
416, 1, 1636420251505, 1636420251866, 361, 1, 360, 0, 0, 0
419, 1, 1636420252129, 1636420252485, 356, 3, 353, 2, 0, 2
422, 1, 1636420252750, 1636420253110, 360, 2, 358, 0, 0, 0
425, 1, 1636420253374, 1636420253734, 360, 0, 360, 0, 0, 0
428, 1, 1636420253998, 1636420254358, 360, 1, 359, 0, 0, 0
431, 1, 1636420254622, 1636420254982, 360, 0, 360, 0, 0, 0
434, 1, 1636420255246, 1636420255606, 360, 1, 359, 0, 0, 0
437, 1, 1636420255870, 1636420256229, 359, 1, 358, 1, 0, 1
440, 1, 1636420256494, 1636420256850, 356, 0, 356, 0, 0, 0
443, 1, 1636420257118, 1636420257474, 356, 1, 355, 1, 0, 1
447, 1, 1636420257738, 1636420258098, 360, 1, 359, 0, 0, 0
449, 1, 1636420258362, 1636420258718, 356, 1, 355, 0, 0, 0
453, 1, 1636420258982, 1636420259338, 356, 1, 355, 0, 0, 0
456, 1, 1636420259602, 1636420259958, 356, 0, 356, 0, 0, 0
459, 1, 1636420260222, 1636420260582, 360, 0, 360, 0, 0, 0
462, 1, 1636420260854, 1636420261222, 368, 0, 368, 0, 0, 0
465, 1, 1636420261486, 1636420261849, 363, 0, 363, 0, 0, 0
468, 1, 1636420262118, 1636420262478, 360, 2, 358, 0, 1, 1
471, 1, 1636420262742, 1636420263102, 360, 1, 359, 0, 0, 0
474, 1, 1636420263366, 1636420263729, 363, 0, 363, 0, 0, 0
477, 1, 1636420263993, 1636420264357, 364, 2, 362, 1, 0, 1
480, 1, 1636420264621, 1636420264982, 361, 2, 359, 0, 1, 1
483, 1, 1636420265246, 1636420265606, 360, 0, 360, 0, 0, 0
486, 1, 1636420265870, 1636420266230, 360, 1, 359, 1, 0, 1
489, 1, 1636420266493, 1636420266854, 361, 1, 360, 0, 0, 0
492, 1, 1636420267118, 1636420267478, 360, 1, 359, 1, 0, 1
495, 1, 1636420267745, 1636420268098, 353, 1, 352, 0, 0, 0
498, 1, 1636420268362, 1636420268713, 351, 1, 350, 0, 0, 0
501, 1, 1636420268978, 1636420269330, 352, 0, 352, 0, 0, 0
504, 1, 1636420269594, 1636420269950, 356, 1, 355, 0, 0, 0
506, 1, 1636420270218, 1636420270577, 359, 1, 358, 1, 0, 1
509, 1, 1636420270842, 1636420271202, 360, 1, 359, 0, 0, 0
512, 1, 1636420271466, 1636420271826, 360, 0, 360, 0, 0, 0
515, 1, 1636420272089, 1636420272450, 361, 2, 359, 0, 0, 0
519, 1, 1636420272714, 1636420273074, 360, 0, 360, 0, 0, 0
521, 1, 1636420273338, 1636420273702, 364, 2, 362, 0, 0, 0
524, 1, 1636420273970, 1636420274330, 360, 0, 360, 0, 0, 0
527, 1, 1636420274589, 1636420274938, 349, 2, 347, 2, 0, 2
529, 1, 1636420275202, 1636420275558, 356, 1, 355, 0, 0, 0
531, 1, 1636420275822, 1636420276181, 359, 1, 358, 1, 0, 1
533, 1, 1636420276450, 1636420276810, 360, 1, 359, 0, 0, 0
535, 1, 1636420277073, 1636420277434, 361, 2, 359, 0, 1, 1
537, 1, 1636420277698, 1636420278058, 360, 1, 359, 0, 0, 0
538, 1, 1636420278322, 1636420278682, 360, 1, 359, 1, 0, 1
540, 1, 1636420278946, 1636420279314, 368, 0, 368, 0, 0, 0
543, 1, 1636420279577, 1636420279934, 357, 1, 356, 0, 0, 0
545, 1, 1636420280198, 1636420280558, 360, 1, 359, 0, 0, 0
547, 1, 1636420280821, 1636420281186, 365, 2, 363, 1, 0, 1
548, 1, 1636420281450, 1636420281814, 364, 0, 364, 0, 0, 0
551, 1, 1636420282082, 1636420282442, 360, 0, 360, 0, 0, 0
553, 1, 1636420282706, 1636420283066, 360, 0, 360, 0, 0, 0
555, 1, 1636420283330, 1636420283690, 360, 0, 360, 0, 0, 0
557, 1, 1636420283954, 1636420284314, 360, 0, 360, 0, 0, 0
559, 1, 1636420284577, 1636420284938, 361, 2, 359, 0, 0, 0
561, 1, 1636420285202, 1636420285562, 360, 0, 360, 0, 0, 0
563, 1, 1636420285826, 1636420286182, 356, 0, 356, 0, 0, 0
564, 1, 1636420286445, 1636420286801, 356, 1, 355, 0, 0, 0
566, 1, 1636420287066, 1636420287426, 360, 1, 359, 0, 0, 0
568, 1, 1636420287690, 1636420288054, 364, 1, 363, 0, 0, 0
571, 1, 1636420288318, 1636420288682, 364, 0, 364, 0, 0, 0
572, 1, 1636420288946, 1636420289310, 364, 0, 364, 0, 0, 0
573, 1, 1636420289574, 1636420289934, 360, 0, 360, 0, 0, 0
574, 1, 1636420290198, 1636420290558, 360, 0, 360, 0, 0, 0
575, 1, 1636420290821, 1636420291182, 361, 2, 359, 1, 0, 1
576, 1, 1636420291446, 1636420291806, 360, 0, 360, 0, 0, 0
577, 1, 1636420292070, 1636420292434, 364, 0, 364, 0, 0, 0
578, 1, 1636420292697, 1636420293058, 361, 1, 360, 0, 0, 0
579, 1, 1636420293326, 1636420293682, 356, 1, 355, 0, 0, 0
580, 1, 1636420293946, 1636420294302, 356, 0, 356, 0, 0, 0
581, 1, 1636420294565, 1636420294926, 361, 1, 360, 0, 1, 1
582, 1, 1636420295190, 1636420295554, 364, 1, 363, 0, 0, 0
583, 1, 1636420295818, 1636420296182, 364, 0, 364, 0, 0, 0
584, 1, 1636420296446, 1636420296810, 364, 0, 364, 0, 0, 0
585, 1, 1636420297074, 1636420297434, 360, 0, 360, 0, 0, 0
586, 1, 1636420297698, 1636420298054, 356, 0, 356, 0, 0, 0
587, 1, 1636420298318, 1636420298678, 360, 1, 359, 0, 0, 0
588, 1, 1636420298942, 1636420299297, 355, 0, 355, 0, 0, 0
589, 1, 1636420299562, 1636420299922, 360, 1, 359, 0, 0, 0
590, 1, 1636420300186, 1636420300546, 360, 1, 359, 0, 0, 0
591, 1, 1636420300810, 1636420301166, 356, 1, 355, 0, 0, 0
592, 1, 1636420301430, 1636420301786, 356, 0, 356, 0, 0, 0
593, 1, 1636420302050, 1636420302410, 360, 1, 359, 1, 0, 1
594, 1, 1636420302674, 1636420303034, 360, 0, 360, 0, 0, 0
595, 1, 1636420303298, 1636420303658, 360, 0, 360, 0, 0, 0
596, 1, 1636420303922, 1636420304282, 360, 0, 360, 0, 0, 0
597, 1, 1636420304545, 1636420304910, 365, 1, 364, 0, 0, 0
598, 1, 1636420305174, 1636420305533, 359, 0, 359, 0, 0, 0
599, 1, 1636420305798, 1636420306158, 360, 1, 359, 1, 0, 1
600, 1, 1636420306422, 1636420306778, 356, 0, 356, 0, 0, 0
601, 1, 1636420525974, 1636420526298, 324, 11, 313, 0, 0, 0
602, 1, 1636420526494, 1636420526802, 308, 0, 308, 0, 0, 0
603, 1, 1636420526914, 1636420527222, 308, 0, 308, 0, 0, 0
604, 1, 1636420526994, 1636420527298, 304, 1, 303, 1, 0, 1
605, 1, 1636420527490, 1636420527797, 307, 0, 307, 0, 0, 0
606, 1, 1636420527774, 1636420528090, 316, 0, 316, 0, 0, 0
607, 1, 1636420527905, 1636420528214, 309, 0, 309, 0, 0, 0
608, 1, 1636420527997, 1636420528306, 309, 1, 308, 0, 0, 0
609, 1, 1636420528490, 1636420528798, 308, 0, 308, 0, 0, 0
610, 1, 1636420528693, 1636420529001, 308, 1, 307, 0, 0, 0
611, 1, 1636420528725, 1636420529033, 308, 1, 307, 0, 0, 0
612, 1, 1636420528914, 1636420529226, 312, 0, 312, 0, 0, 0
613, 1, 1636420528993, 1636420529302, 309, 0, 309, 0, 0, 0
614, 1, 1636420529290, 1636420529598, 308, 0, 308, 0, 0, 0
615, 1, 1636420529502, 1636420529817, 315, 0, 315, 0, 0, 0
616, 1, 1636420529629, 1636420529897, 268, 1, 267, 0, 1, 1
617, 1, 1636420529597, 1636420529906, 309, 3, 306, 0, 0, 0
618, 1, 1636420529789, 1636420530053, 264, 0, 264, 0, 0, 0
619, 1, 1636420529874, 1636420530138, 264, 0, 264, 0, 0, 0
621, 1, 1636420530097, 1636420530366, 269, 1, 268, 1, 0, 1
620, 1, 1636420530097, 1636420530366, 269, 1, 268, 1, 0, 1
622, 1, 1636420530373, 1636420530642, 269, 1, 268, 0, 0, 0
623, 1, 1636420530498, 1636420530762, 264, 0, 264, 0, 0, 0
624, 1, 1636420530593, 1636420530858, 265, 1, 264, 0, 0, 0
626, 1, 1636420530762, 1636420531030, 268, 0, 268, 0, 0, 0
625, 1, 1636420530793, 1636420531058, 265, 1, 264, 0, 0, 0
628, 1, 1636420530977, 1636420531242, 265, 1, 264, 0, 0, 0
629, 1, 1636420531085, 1636420531354, 269, 1, 268, 0, 1, 1
632, 1, 1636420531502, 1636420531766, 264, 0, 264, 0, 0, 0
631, 1, 1636420531526, 1636420531794, 268, 0, 268, 0, 0, 0
634, 1, 1636420531682, 1636420531945, 263, 0, 263, 0, 0, 0
635, 1, 1636420531801, 1636420532066, 265, 1, 264, 0, 0, 0
636, 1, 1636420531961, 1636420532226, 265, 1, 264, 0, 0, 0
637, 1, 1636420532094, 1636420532358, 264, 0, 264, 0, 0, 0
638, 1, 1636420532209, 1636420532478, 269, 1, 268, 0, 0, 0
639, 1, 1636420532418, 1636420532686, 268, 0, 268, 0, 0, 0
641, 1, 1636420532669, 1636420532938, 269, 1, 268, 1, 0, 1
642, 1, 1636420532789, 1636420533061, 272, 1, 271, 0, 0, 0
643, 1, 1636420532965, 1636420533230, 265, 1, 264, 0, 0, 0
644, 1, 1636420533106, 1636420533374, 268, 0, 268, 0, 0, 0
646, 1, 1636420533402, 1636420533666, 264, 0, 264, 0, 0, 0
647, 1, 1636420533698, 1636420533973, 275, 0, 275, 0, 0, 0
648, 1, 1636420533810, 1636420534073, 263, 0, 263, 0, 0, 0
649, 1, 1636420533866, 1636420534130, 264, 0, 264, 0, 0, 0
651, 1, 1636420534089, 1636420534358, 269, 1, 268, 1, 0, 1
653, 1, 1636420534409, 1636420534673, 264, 1, 263, 0, 0, 0
652, 1, 1636420534417, 1636420534681, 264, 1, 263, 0, 0, 0
655, 1, 1636420534754, 1636420535025, 271, 0, 271, 0, 0, 0
656, 1, 1636420534810, 1636420535074, 264, 0, 264, 0, 0, 0
658, 1, 1636420535093, 1636420535362, 269, 1, 268, 0, 0, 0
657, 1, 1636420535106, 1636420535374, 268, 0, 268, 0, 0, 0
659, 1, 1636420535302, 1636420535570, 268, 0, 268, 0, 0, 0
661, 1, 1636420535721, 1636420535993, 272, 1, 271, 0, 1, 1
662, 1, 1636420535729, 1636420535993, 264, 1, 263, 0, 1, 1
663, 1, 1636420535773, 1636420536037, 264, 1, 263, 0, 0, 0
664, 1, 1636420535990, 1636420536254, 264, 0, 264, 0, 0, 0
666, 1, 1636420536286, 1636420536562, 276, 0, 276, 0, 0, 0
667, 1, 1636420536382, 1636420536658, 276, 0, 276, 0, 0, 0
668, 1, 1636420536621, 1636420536886, 265, 0, 265, 0, 0, 0
669, 1, 1636420536725, 1636420536993, 268, 1, 267, 0, 0, 0
670, 1, 1636420536766, 1636420537029, 263, 0, 263, 0, 0, 0
672, 1, 1636420536977, 1636420537245, 268, 1, 267, 0, 0, 0
671, 1, 1636420536977, 1636420537254, 277, 1, 276, 0, 0, 0
673, 1, 1636420537261, 1636420537526, 265, 1, 264, 0, 0, 0
674, 1, 1636420537313, 1636420537582, 269, 1, 268, 0, 0, 0
675, 1, 1636420537601, 1636420537866, 265, 1, 264, 0, 0, 0
676, 1, 1636420537662, 1636420537929, 267, 0, 267, 0, 0, 0
677, 1, 1636420537733, 1636420537998, 265, 1, 264, 0, 0, 0
679, 1, 1636420537866, 1636420538134, 268, 0, 268, 0, 0, 0
680, 1, 1636420537997, 1636420538262, 265, 1, 264, 0, 0, 0
681, 1, 1636420538246, 1636420538510, 264, 0, 264, 0, 0, 0
682, 1, 1636420538350, 1636420538618, 268, 0, 268, 0, 0, 0
684, 1, 1636420538553, 1636420538818, 265, 1, 264, 0, 0, 0
685, 1, 1636420538597, 1636420538861, 264, 1, 263, 0, 0, 0
686, 1, 1636420538730, 1636420538998, 268, 0, 268, 0, 0, 0
687, 1, 1636420538853, 1636420539118, 265, 0, 265, 0, 0, 0
689, 1, 1636420539242, 1636420539506, 264, 0, 264, 0, 0, 0
690, 1, 1636420539278, 1636420539542, 264, 0, 264, 0, 0, 0
691, 1, 1636420539486, 1636420539754, 268, 0, 268, 0, 0, 0
692, 1, 1636420539542, 1636420539806, 264, 1, 263, 0, 0, 0
694, 1, 1636420539698, 1636420539966, 268, 0, 268, 0, 0, 0
696, 1, 1636420539853, 1636420540118, 265, 1, 264, 0, 0, 0
695, 1, 1636420539881, 1636420540146, 265, 1, 264, 0, 0, 0
697, 1, 1636420540233, 1636420540501, 268, 1, 267, 0, 0, 0
699, 1, 1636420540369, 1636420540638, 269, 1, 268, 0, 0, 0
700, 1, 1636420540545, 1636420540810, 265, 1, 264, 0, 1, 1
701, 1, 1636420540710, 1636420540974, 264, 0, 264, 0, 0, 0
702, 1, 1636420540769, 1636420541033, 264, 1, 263, 0, 0, 0
704, 1, 1636420541318, 1636420541585, 267, 0, 267, 0, 0, 0
705, 1, 1636420541350, 1636420541661, 311, 0, 311, 0, 0, 0
706, 1, 1636420541573, 1636420541838, 265, 1, 264, 0, 0, 0
708, 1, 1636420541701, 1636420541966, 265, 1, 264, 0, 0, 0
709, 1, 1636420541749, 1636420542014, 265, 1, 264, 0, 0, 0
711, 1, 1636420542389, 1636420542653, 264, 1, 263, 0, 0, 0
712, 1, 1636420542402, 1636420542666, 264, 0, 264, 0, 0, 0
713, 1, 1636420542697, 1636420542966, 269, 1, 268, 1, 0, 1
714, 1, 1636420542798, 1636420543062, 264, 0, 264, 0, 0, 0
715, 1, 1636420543398, 1636420543662, 264, 0, 264, 0, 0, 0
717, 1, 1636420543729, 1636420544034, 305, 1, 304, 0, 0, 0
719, 1, 1636420544386, 1636420544654, 268, 0, 268, 0, 0, 0
720, 1, 1636420544778, 1636420545042, 264, 0, 264, 0, 0, 0
721, 1, 1636420545386, 1636420545649, 263, 0, 263, 0, 0, 0
722, 1, 1636420545718, 1636420545986, 268, 0, 268, 0, 0, 0
723, 1, 1636420546350, 1636420546614, 264, 0, 264, 0, 0, 0
724, 1, 1636420546682, 1636420546950, 268, 0, 268, 0, 0, 0
725, 1, 1636420547382, 1636420547646, 264, 0, 264, 0, 0, 0
726, 1, 1636420547649, 1636420547914, 265, 1, 264, 0, 1, 1
727, 1, 1636420548438, 1636420548702, 264, 0, 264, 0, 0, 0
728, 1, 1636420548650, 1636420548918, 268, 0, 268, 0, 0, 0
729, 1, 1636420549482, 1636420549746, 264, 0, 264, 0, 0, 0
730, 1, 1636420549662, 1636420549926, 264, 0, 264, 0, 0, 0
731, 1, 1636420550462, 1636420550726, 264, 0, 264, 0, 0, 0
732, 1, 1636420550685, 1636420550950, 265, 1, 264, 0, 0, 0
733, 1, 1636420551437, 1636420551705, 268, 1, 267, 0, 0, 0
740, 1, 1636420551526, 1636420551790, 264, 0, 264, 0, 0, 0
737, 1, 1636420551526, 1636420551794, 268, 0, 268, 0, 0, 0
748, 1, 1636420551657, 1636420551921, 264, 0, 264, 0, 0, 0
751, 1, 1636420552414, 1636420552682, 268, 0, 268, 0, 0, 0
750, 1, 1636420552414, 1636420552682, 268, 1, 267, 0, 0, 0
752, 1, 1636420552441, 1636420552706, 265, 0, 265, 0, 0, 0
754, 1, 1636420552625, 1636420552890, 265, 1, 264, 0, 0, 0
755, 1, 1636420553402, 1636420553666, 264, 0, 264, 0, 0, 0
718, 1, 1636420553410, 1636420553673, 263, 1, 262, 0, 0, 0
756, 1, 1636420553410, 1636420553673, 263, 0, 263, 0, 0, 0
758, 1, 1636420553637, 1636420553902, 265, 1, 264, 0, 0, 0
757, 1, 1636420553669, 1636420553934, 265, 1, 264, 0, 1, 1
761, 1, 1636420554381, 1636420554646, 265, 1, 264, 0, 0, 0
762, 1, 1636420554386, 1636420554649, 263, 0, 263, 0, 0, 0
763, 1, 1636420554478, 1636420554742, 264, 0, 264, 0, 0, 0
764, 1, 1636420554645, 1636420554910, 265, 1, 264, 0, 0, 0
765, 1, 1636420555362, 1636420555626, 264, 0, 264, 0, 0, 0
766, 1, 1636420555370, 1636420555634, 264, 0, 264, 0, 0, 0
767, 1, 1636420555490, 1636420555758, 268, 0, 268, 0, 0, 0
768, 1, 1636420555633, 1636420555898, 265, 1, 264, 0, 0, 0
769, 1, 1636420556333, 1636420556598, 265, 1, 264, 1, 0, 1
770, 1, 1636420556393, 1636420556657, 264, 1, 263, 1, 0, 1
771, 1, 1636420556490, 1636420556754, 264, 0, 264, 0, 0, 0
772, 1, 1636420556610, 1636420556874, 264, 0, 264, 0, 0, 0
773, 1, 1636420557370, 1636420557634, 264, 0, 264, 0, 0, 0
774, 1, 1636420557421, 1636420557686, 265, 1, 264, 0, 0, 0
775, 1, 1636420557466, 1636420557734, 268, 0, 268, 0, 0, 0
776, 1, 1636420557578, 1636420557842, 264, 0, 264, 0, 0, 0
777, 1, 1636420558394, 1636420558658, 264, 0, 264, 0, 0, 0
778, 1, 1636420558430, 1636420558702, 272, 0, 272, 0, 0, 0
779, 1, 1636420558453, 1636420558718, 265, 0, 265, 0, 0, 0
780, 1, 1636420558582, 1636420558854, 272, 0, 272, 0, 0, 0
781, 1, 1636420559410, 1636420559682, 272, 0, 272, 0, 0, 0
782, 1, 1636420559430, 1636420559694, 264, 0, 264, 0, 0, 0
783, 1, 1636420559486, 1636420559750, 264, 0, 264, 0, 0, 0
784, 1, 1636420559550, 1636420559818, 268, 0, 268, 0, 0, 0
785, 1, 1636420560414, 1636420560678, 264, 0, 264, 0, 0, 0
786, 1, 1636420560450, 1636420560714, 264, 0, 264, 0, 0, 0
787, 1, 1636420560454, 1636420560717, 263, 0, 263, 0, 0, 0
788, 1, 1636420560585, 1636420560850, 265, 1, 264, 0, 0, 0
743, 2, 1636420551794, 1636420561936, 10142, 0, 10142, 0, 0, 0
789, 1, 1636420562037, 1636420562306, 269, 0, 269, 0, 0, 0
791, 1, 1636420562122, 1636420562394, 272, 0, 272, 0, 0, 0
790, 1, 1636420562122, 1636420562394, 272, 1, 271, 0, 1, 1
792, 1, 1636420562221, 1636420562485, 264, 1, 263, 0, 1, 1
794, 1, 1636420562425, 1636420562690, 265, 1, 264, 0, 0, 0
806, 1, 1636420562706, 1636420562970, 264, 0, 264, 0, 0, 0
807, 1, 1636420562794, 1636420563057, 263, 0, 263, 0, 0, 0
808, 1, 1636420562810, 1636420563078, 268, 0, 268, 0, 0, 0
809, 1, 1636420562881, 1636420563146, 265, 1, 264, 0, 1, 1
810, 1, 1636420563370, 1636420563638, 268, 0, 268, 0, 0, 0
812, 1, 1636420563725, 1636420563990, 265, 1, 264, 0, 0, 0
811, 1, 1636420563725, 1636420563990, 265, 1, 264, 0, 0, 0
760, 1, 1636420563761, 1636420564025, 264, 0, 264, 0, 0, 0
813, 1, 1636420563813, 1636420564077, 264, 1, 263, 0, 0, 0
814, 1, 1636420563853, 1636420564118, 265, 1, 264, 0, 0, 0
816, 1, 1636420564362, 1636420564626, 264, 0, 264, 0, 0, 0
818, 1, 1636420564694, 1636420564958, 264, 0, 264, 0, 0, 0
819, 1, 1636420564722, 1636420564990, 268, 0, 268, 0, 0, 0
820, 1, 1636420564777, 1636420565046, 269, 1, 268, 1, 0, 1
821, 1, 1636420564882, 1636420565150, 268, 0, 268, 0, 0, 0
822, 1, 1636420565334, 1636420565598, 264, 0, 264, 0, 0, 0
823, 1, 1636420565677, 1636420565950, 273, 1, 272, 0, 0, 0
824, 1, 1636420565737, 1636420566006, 269, 1, 268, 0, 0, 0
825, 1, 1636420565769, 1636420566034, 265, 1, 264, 0, 1, 1
826, 1, 1636420565889, 1636420566154, 265, 0, 265, 0, 0, 0
827, 1, 1636420566310, 1636420566574, 264, 0, 264, 0, 0, 0
828, 1, 1636420566657, 1636420566921, 264, 1, 263, 0, 0, 0
829, 1, 1636420566766, 1636420567030, 264, 0, 264, 0, 0, 0
830, 1, 1636420566794, 1636420567062, 268, 0, 268, 0, 0, 0
831, 1, 1636420566897, 1636420567162, 265, 1, 264, 0, 0, 0
832, 1, 1636420567338, 1636420567605, 267, 0, 267, 0, 0, 0
833, 1, 1636420567649, 1636420567917, 268, 1, 267, 1, 0, 1
834, 1, 1636420567769, 1636420568038, 269, 1, 268, 0, 0, 0
835, 1, 1636420567817, 1636420568086, 269, 1, 268, 0, 0, 0
836, 1, 1636420567914, 1636420568178, 264, 0, 264, 0, 0, 0
837, 1, 1636420568346, 1636420568618, 272, 0, 272, 0, 0, 0
838, 1, 1636420568654, 1636420568918, 264, 0, 264, 0, 0, 0
839, 1, 1636420568754, 1636420569022, 268, 0, 268, 0, 0, 0
840, 1, 1636420568817, 1636420569090, 273, 1, 272, 0, 0, 0
841, 1, 1636420568954, 1636420569218, 264, 0, 264, 0, 0, 0
842, 1, 1636420569370, 1636420569634, 264, 0, 264, 0, 0, 0
843, 1, 1636420569634, 1636420569897, 263, 0, 263, 0, 0, 0
844, 1, 1636420569777, 1636420570042, 265, 1, 264, 0, 0, 0
845, 1, 1636420569809, 1636420570074, 265, 1, 264, 0, 0, 0
846, 1, 1636420569930, 1636420570194, 264, 0, 264, 0, 0, 0
847, 1, 1636420570366, 1636420570630, 264, 0, 264, 0, 0, 0
848, 1, 1636420570630, 1636420570894, 264, 0, 264, 0, 0, 0
849, 1, 1636420570802, 1636420571065, 263, 0, 263, 0, 0, 0
850, 1, 1636420570834, 1636420571114, 280, 0, 280, 0, 0, 0
851, 1, 1636420570913, 1636420571178, 265, 1, 264, 0, 0, 0
852, 1, 1636420571365, 1636420571630, 265, 1, 264, 0, 0, 0
853, 1, 1636420571598, 1636420571862, 264, 0, 264, 0, 0, 0
854, 1, 1636420571773, 1636420572038, 265, 1, 264, 0, 0, 0
855, 1, 1636420571829, 1636420572097, 268, 1, 267, 1, 0, 1
856, 1, 1636420571894, 1636420572162, 268, 0, 268, 0, 0, 0
858, 1, 1636420572917, 1636420573185, 268, 1, 267, 0, 0, 0
859, 1, 1636420573045, 1636420573309, 264, 1, 263, 0, 0, 0
861, 1, 1636420573049, 1636420573317, 268, 0, 268, 0, 0, 0
860, 1, 1636420573053, 1636420573326, 273, 0, 273, 0, 0, 0
862, 1, 1636420573129, 1636420573394, 265, 1, 264, 0, 0, 0
863, 1, 1636420573218, 1636420573482, 264, 0, 264, 0, 0, 0
875, 1, 1636420573605, 1636420573873, 268, 1, 267, 0, 1, 1
876, 1, 1636420573722, 1636420573989, 267, 0, 267, 0, 0, 0
877, 1, 1636420573818, 1636420574082, 264, 1, 263, 0, 0, 0
878, 1, 1636420573818, 1636420574085, 267, 1, 266, 0, 1, 1
881, 1, 1636420574565, 1636420574834, 269, 1, 268, 1, 0, 1
883, 1, 1636420574665, 1636420574930, 265, 1, 264, 0, 0, 0
885, 1, 1636420574814, 1636420575078, 264, 0, 264, 0, 0, 0
886, 1, 1636420574849, 1636420575114, 265, 0, 265, 0, 0, 0
887, 1, 1636420575518, 1636420575782, 264, 0, 264, 0, 0, 0
888, 1, 1636420575661, 1636420575925, 264, 1, 263, 0, 0, 0
889, 1, 1636420575810, 1636420576074, 264, 0, 264, 0, 0, 0
890, 1, 1636420575838, 1636420576101, 263, 0, 263, 0, 0, 0
891, 1, 1636420576546, 1636420576809, 263, 0, 263, 0, 0, 0
892, 1, 1636420576666, 1636420576930, 264, 0, 264, 0, 0, 0
893, 1, 1636420576838, 1636420577105, 267, 0, 267, 0, 0, 0
894, 1, 1636420576842, 1636420577105, 263, 0, 263, 0, 0, 0
895, 1, 1636420577577, 1636420577841, 264, 1, 263, 0, 0, 0
896, 1, 1636420577670, 1636420577933, 263, 0, 263, 0, 0, 0
897, 1, 1636420577837, 1636420578106, 269, 1, 268, 0, 0, 0
898, 1, 1636420577865, 1636420578129, 264, 1, 263, 0, 0, 0
899, 1, 1636420578570, 1636420578833, 263, 1, 262, 0, 0, 0
900, 1, 1636420578685, 1636420578950, 265, 1, 264, 0, 0, 0
901, 1, 1636420578825, 1636420579089, 264, 1, 263, 0, 0, 0
902, 1, 1636420578865, 1636420579130, 265, 1, 264, 0, 0, 0
903, 1, 1636420579538, 1636420579802, 264, 0, 264, 0, 0, 0
904, 1, 1636420579654, 1636420579921, 267, 0, 267, 0, 0, 0
905, 1, 1636420579813, 1636420580078, 265, 0, 265, 0, 0, 0
906, 1, 1636420579865, 1636420580133, 268, 0, 268, 0, 0, 0
907, 1, 1636420580506, 1636420580770, 264, 0, 264, 0, 0, 0
908, 1, 1636420580634, 1636420580898, 264, 0, 264, 0, 0, 0
910, 1, 1636420580857, 1636420581129, 272, 1, 271, 0, 0, 0
909, 1, 1636420580901, 1636420581170, 269, 1, 268, 0, 0, 0
911, 1, 1636420581501, 1636420581766, 265, 1, 264, 0, 0, 0
912, 1, 1636420581650, 1636420581914, 264, 0, 264, 0, 0, 0
913, 1, 1636420581766, 1636420582034, 268, 0, 268, 0, 0, 0
914, 1, 1636420581822, 1636420582086, 264, 0, 264, 0, 0, 0
880, 1, 1636420582330, 1636420582598, 268, 0, 268, 0, 0, 0
915, 1, 1636420582518, 1636420582781, 263, 0, 263, 0, 0, 0
917, 1, 1636420582681, 1636420582946, 265, 1, 264, 1, 0, 1
918, 1, 1636420582761, 1636420583025, 264, 1, 263, 1, 0, 1
919, 1, 1636420582806, 1636420583073, 267, 1, 266, 0, 0, 0
920, 1, 1636420583021, 1636420583741, 720, 1, 719, 1, 0, 1
922, 1, 1636420583789, 1636420584054, 265, 1, 264, 0, 0, 0
921, 1, 1636420583789, 1636420584054, 265, 1, 264, 0, 0, 0
923, 1, 1636420583873, 1636420584149, 276, 1, 275, 0, 0, 0
924, 1, 1636420583873, 1636420584149, 276, 1, 275, 1, 0, 1
925, 1, 1636420583973, 1636420584238, 265, 1, 264, 0, 0, 0
936, 1, 1636420584149, 1636420584413, 264, 0, 264, 0, 0, 0
930, 1, 1636420584238, 1636420584502, 264, 1, 263, 1, 0, 1
937, 1, 1636420584505, 1636420584769, 264, 0, 264, 0, 0, 0
938, 1, 1636420584526, 1636420584838, 312, 0, 312, 0, 0, 0
939, 1, 1636420584681, 1636420584945, 264, 1, 263, 0, 0, 0
916, 1, 1636420584797, 1636420585062, 265, 0, 265, 0, 0, 0
940, 1, 1636420584838, 1636420585102, 264, 0, 264, 0, 0, 0
941, 1, 1636420584841, 1636420585109, 268, 1, 267, 0, 0, 0
946, 1, 1636420585093, 1636420585358, 265, 0, 265, 0, 0, 0
947, 1, 1636420585386, 1636420585654, 268, 0, 268, 0, 0, 0
949, 1, 1636420585505, 1636420585770, 265, 1, 264, 0, 0, 0
950, 1, 1636420585705, 1636420585974, 269, 1, 268, 0, 0, 0
952, 1, 1636420585825, 1636420586090, 265, 1, 264, 0, 0, 0
953, 1, 1636420586070, 1636420586338, 268, 0, 268, 0, 0, 0
954, 1, 1636420586345, 1636420586609, 264, 1, 263, 0, 1, 1
955, 1, 1636420586521, 1636420586786, 265, 1, 264, 0, 1, 1
956, 1, 1636420586693, 1636420586962, 269, 1, 268, 0, 0, 0
957, 1, 1636420586833, 1636420587098, 265, 1, 264, 0, 0, 0
958, 1, 1636420587098, 1636420587366, 268, 0, 268, 0, 0, 0
960, 1, 1636420587530, 1636420587794, 264, 0, 264, 0, 0, 0
961, 1, 1636420587685, 1636420587954, 269, 1, 268, 0, 0, 0
962, 1, 1636420587845, 1636420588110, 265, 1, 264, 0, 0, 0
963, 1, 1636420588106, 1636420588370, 264, 0, 264, 0, 0, 0
964, 1, 1636420588517, 1636420588782, 265, 1, 264, 1, 0, 1
966, 1, 1636420588821, 1636420589089, 268, 1, 267, 0, 0, 0
967, 1, 1636420589125, 1636420589393, 268, 1, 267, 0, 0, 0
968, 1, 1636420589486, 1636420589750, 264, 0, 264, 0, 0, 0
969, 1, 1636420589801, 1636420590070, 269, 1, 268, 0, 0, 0
970, 1, 1636420590129, 1636420590393, 264, 1, 263, 0, 1, 1
971, 1, 1636420590445, 1636420590710, 265, 1, 264, 0, 1, 1
972, 1, 1636420590818, 1636420591081, 263, 0, 263, 0, 0, 0
973, 1, 1636420591118, 1636420591382, 264, 0, 264, 0, 0, 0
974, 1, 1636420591486, 1636420591754, 268, 0, 268, 0, 0, 0
975, 1, 1636420591821, 1636420592085, 264, 1, 263, 0, 0, 0
976, 1, 1636420592105, 1636420592369, 264, 1, 263, 0, 1, 1
977, 1, 1636420592482, 1636420592746, 264, 0, 264, 0, 0, 0
978, 1, 1636420592802, 1636420593070, 268, 0, 268, 0, 0, 0
979, 1, 1636420593138, 1636420593406, 268, 0, 268, 0, 0, 0
980, 1, 1636420593513, 1636420593777, 264, 1, 263, 0, 0, 0
981, 1, 1636420594205, 1636420594470, 265, 0, 265, 0, 0, 0
982, 1, 1636420594434, 1636420594702, 268, 0, 268, 0, 0, 0
983, 1, 1636420594553, 1636420594818, 265, 1, 264, 0, 1, 1
951, 1, 1636420594981, 1636420595250, 269, 2, 267, 0, 0, 0
987, 1, 1636420594981, 1636420595250, 269, 1, 268, 0, 0, 0
993, 1, 1636420594981, 1636420595250, 269, 1, 268, 1, 0, 1
994, 1, 1636420595165, 1636420595430, 265, 0, 265, 0, 0, 0
996, 1, 1636420595438, 1636420595702, 264, 0, 264, 0, 0, 0
999, 1, 1636420595521, 1636420595786, 265, 1, 264, 0, 1, 1
1000, 1, 1636420595654, 1636420595918, 264, 0, 264, 0, 0, 0
997, 1, 1636420595705, 1636420595970, 265, 1, 264, 0, 0, 0
1003, 1, 1636420595813, 1636420596078, 265, 1, 264, 0, 0, 0
1001, 1, 1636420595970, 1636420596234, 264, 1, 263, 1, 0, 1
1004, 1, 1636420596121, 1636420596386, 265, 1, 264, 0, 0, 0
1005, 1, 1636420596314, 1636420596578, 264, 0, 264, 0, 0, 0
1007, 1, 1636420596538, 1636420596802, 264, 0, 264, 0, 0, 0
1008, 1, 1636420596629, 1636420596894, 265, 1, 264, 0, 0, 0
1009, 1, 1636420596713, 1636420596978, 265, 1, 264, 0, 0, 0
1010, 1, 1636420596814, 1636420597086, 272, 0, 272, 0, 0, 0
1011, 1, 1636420597122, 1636420597389, 267, 0, 267, 0, 0, 0
1012, 1, 1636420597306, 1636420597570, 264, 0, 264, 0, 0, 0
1013, 1, 1636420597557, 1636420597826, 269, 1, 268, 1, 0, 1
1015, 1, 1636420597638, 1636420597902, 264, 0, 264, 0, 0, 0
1014, 1, 1636420597658, 1636420597922, 264, 0, 264, 0, 0, 0
1016, 1, 1636420597693, 1636420597962, 269, 1, 268, 0, 1, 1
1017, 1, 1636420597826, 1636420598090, 264, 0, 264, 0, 0, 0
1018, 1, 1636420598126, 1636420598390, 264, 0, 264, 0, 0, 0
1019, 1, 1636420598306, 1636420598574, 268, 0, 268, 0, 0, 0
1020, 1, 1636420598577, 1636420598841, 264, 1, 263, 0, 0, 0
1021, 1, 1636420598581, 1636420598850, 269, 0, 269, 0, 0, 0
1022, 1, 1636420598669, 1636420598937, 268, 1, 267, 1, 0, 1
1023, 1, 1636420598702, 1636420598965, 263, 0, 263, 0, 0, 0
1006, 1, 1636420598709, 1636420598977, 268, 0, 268, 0, 0, 0
1024, 1, 1636420598841, 1636420599106, 265, 1, 264, 0, 1, 1
1025, 1, 1636420599105, 1636420599369, 264, 2, 262, 0, 0, 0
1026, 1, 1636420599109, 1636420599377, 268, 0, 268, 0, 0, 0
1027, 1, 1636420599309, 1636420599573, 264, 1, 263, 0, 0, 0
1028, 1, 1636420599393, 1636420599661, 268, 1, 267, 0, 1, 1
1029, 1, 1636420599537, 1636420599802, 265, 1, 264, 0, 0, 0
1030, 1, 1636420599601, 1636420599865, 264, 1, 263, 0, 0, 0
1031, 1, 1636420599642, 1636420599906, 264, 0, 264, 0, 0, 0
1032, 1, 1636420599705, 1636420599970, 265, 1, 264, 1, 0, 1
1033, 1, 1636420599842, 1636420600105, 263, 0, 263, 0, 0, 0
1034, 1, 1636420600113, 1636420600378, 265, 1, 264, 0, 0, 0
1035, 1, 1636420600129, 1636420600397, 268, 1, 267, 0, 0, 0
1036, 1, 1636420600314, 1636420600578, 264, 0, 264, 0, 0, 0
1037, 1, 1636420600334, 1636420600597, 263, 0, 263, 0, 0, 0
1038, 1, 1636420600514, 1636420600781, 267, 0, 267, 0, 0, 0
1039, 1, 1636420600593, 1636420600861, 268, 1, 267, 0, 0, 0
1040, 1, 1636420600673, 1636420600945, 272, 1, 271, 0, 0, 0
1041, 1, 1636420600717, 1636420600982, 265, 0, 265, 0, 0, 0
1042, 1, 1636420600857, 1636420601122, 265, 0, 265, 0, 0, 0
1043, 1, 1636420601125, 1636420601389, 264, 1, 263, 0, 1, 1
1044, 1, 1636420601153, 1636420601418, 265, 0, 265, 0, 0, 0
1045, 1, 1636420601297, 1636420601562, 265, 0, 265, 0, 0, 0
1046, 1, 1636420601333, 1636420601602, 269, 0, 269, 0, 0, 0
1047, 1, 1636420601522, 1636420601786, 264, 0, 264, 0, 0, 0
1048, 1, 1636420601597, 1636420601861, 264, 1, 263, 1, 0, 1
1050, 1, 1636420601722, 1636420601986, 264, 0, 264, 0, 0, 0
1051, 1, 1636420601853, 1636420602118, 265, 1, 264, 0, 0, 0
1052, 1, 1636420602126, 1636420602390, 264, 0, 264, 0, 0, 0
1053, 1, 1636420602133, 1636420602402, 269, 0, 269, 0, 0, 0
1054, 1, 1636420602301, 1636420602565, 264, 1, 263, 0, 0, 0
1055, 1, 1636420602325, 1636420602594, 269, 1, 268, 0, 0, 0
1056, 1, 1636420602558, 1636420602825, 267, 0, 267, 0, 0, 0
1057, 1, 1636420602577, 1636420602841, 264, 1, 263, 1, 0, 1
1058, 1, 1636420602722, 1636420602986, 264, 0, 264, 0, 0, 0
1059, 1, 1636420602861, 1636420603126, 265, 0, 265, 0, 0, 0
1060, 1, 1636420603133, 1636420603402, 269, 1, 268, 1, 0, 1
1061, 1, 1636420603141, 1636420603405, 264, 1, 263, 1, 0, 1
1062, 1, 1636420603313, 1636420603578, 265, 1, 264, 0, 0, 0
1063, 1, 1636420603330, 1636420603597, 267, 0, 267, 0, 0, 0
1064, 1, 1636420603549, 1636420603814, 265, 1, 264, 0, 0, 0
1065, 1, 1636420603569, 1636420603837, 268, 1, 267, 0, 0, 0
1066, 1, 1636420603701, 1636420603966, 265, 1, 264, 1, 0, 1
1067, 1, 1636420603837, 1636420604102, 265, 1, 264, 0, 0, 0
1068, 1, 1636420604106, 1636420604373, 267, 0, 267, 0, 0, 0
1069, 1, 1636420604178, 1636420604442, 264, 0, 264, 0, 0, 0
1070, 1, 1636420604337, 1636420604602, 265, 1, 264, 0, 1, 1
1071, 1, 1636420604366, 1636420604630, 264, 0, 264, 0, 0, 0
1072, 1, 1636420604561, 1636420605186, 625, 1, 624, 0, 0, 0
1074, 1, 1636420605097, 1636420605366, 269, 1, 268, 1, 0, 1
1075, 1, 1636420605189, 1636420605466, 277, 1, 276, 1, 0, 1
1073, 1, 1636420605189, 1636420605469, 280, 1, 279, 0, 1, 1
1077, 1, 1636420605293, 1636420605562, 269, 1, 268, 0, 0, 0
1078, 1, 1636420605389, 1636420605653, 264, 1, 263, 1, 0, 1
1079, 1, 1636420605389, 1636420605654, 265, 1, 264, 0, 0, 0
1076, 1, 1636420605465, 1636420605729, 264, 1, 263, 0, 0, 0
1089, 1, 1636420605657, 1636420605926, 269, 0, 269, 0, 0, 0
1091, 1, 1636420605773, 1636420606042, 269, 1, 268, 0, 0, 0
1049, 1, 1636420605789, 1636420606062, 273, 1, 272, 0, 0, 0
1092, 1, 1636420605882, 1636420606149, 267, 0, 267, 0, 0, 0
1093, 1, 1636420605889, 1636420606157, 268, 1, 267, 0, 0, 0
1096, 1, 1636420606133, 1636420606397, 264, 1, 263, 0, 0, 0
1095, 1, 1636420606153, 1636420606418, 265, 1, 264, 1, 0, 1
1097, 1, 1636420606329, 1636420606593, 264, 0, 264, 0, 0, 0
1098, 1, 1636420606333, 1636420606597, 264, 1, 263, 0, 1, 1
1099, 1, 1636420606465, 1636420606733, 268, 1, 267, 1, 0, 1
1100, 1, 1636420606541, 1636420606806, 265, 1, 264, 0, 1, 1
1101, 1, 1636420606722, 1636420606986, 264, 0, 264, 0, 0, 0
1102, 1, 1636420606814, 1636420607077, 263, 0, 263, 0, 0, 0
1103, 1, 1636420606826, 1636420607090, 264, 0, 264, 0, 0, 0
1104, 1, 1636420607090, 1636420607353, 263, 1, 262, 0, 0, 0
1105, 1, 1636420607153, 1636420607418, 265, 1, 264, 0, 1, 1
1106, 1, 1636420607333, 1636420607598, 265, 1, 264, 0, 1, 1
1107, 1, 1636420607342, 1636420607606, 264, 0, 264, 0, 0, 0
1108, 1, 1636420607398, 1636420607666, 268, 0, 268, 0, 0, 0
1109, 1, 1636420607538, 1636420607801, 263, 0, 263, 0, 0, 0
1110, 1, 1636420607753, 1636420608017, 264, 1, 263, 0, 1, 1
1111, 1, 1636420607785, 1636420608050, 265, 1, 264, 0, 1, 1
1112, 1, 1636420607817, 1636420608081, 264, 1, 263, 0, 0, 0
1113, 1, 1636420608053, 1636420608317, 264, 1, 263, 0, 0, 0
1114, 1, 1636420608177, 1636420608441, 264, 1, 263, 0, 1, 1
1116, 1, 1636420608354, 1636420608617, 263, 0, 263, 0, 0, 0
1117, 1, 1636420608421, 1636420608686, 265, 1, 264, 1, 0, 1
1115, 1, 1636420608441, 1636420608706, 265, 1, 264, 1, 0, 1
1118, 1, 1636420608509, 1636420608777, 268, 0, 268, 0, 0, 0
1119, 1, 1636420608789, 1636420609053, 264, 1, 263, 0, 1, 1
1120, 1, 1636420608801, 1636420609070, 269, 0, 269, 0, 0, 0
1121, 1, 1636420608825, 1636420609098, 273, 0, 273, 0, 0, 0
1122, 1, 1636420609070, 1636420609333, 263, 0, 263, 0, 0, 0
1123, 1, 1636420609157, 1636420609425, 268, 1, 267, 0, 0, 0
1124, 1, 1636420609345, 1636420609609, 264, 1, 263, 1, 0, 1
1125, 1, 1636420609362, 1636420609630, 268, 0, 268, 0, 0, 0
1126, 1, 1636420609433, 1636420609697, 264, 1, 263, 1, 0, 1
1128, 1, 1636420609781, 1636420610046, 265, 1, 264, 0, 0, 0
1129, 1, 1636420609781, 1636420610046, 265, 1, 264, 1, 0, 1
1130, 1, 1636420609817, 1636420610081, 264, 0, 264, 0, 0, 0
1131, 1, 1636420610053, 1636420610321, 268, 1, 267, 0, 0, 0
1132, 1, 1636420610142, 1636420610406, 264, 0, 264, 0, 0, 0
1133, 1, 1636420610337, 1636420610601, 264, 1, 263, 0, 0, 0
1134, 1, 1636420610377, 1636420610641, 264, 1, 263, 0, 0, 0
1135, 1, 1636420610446, 1636420610710, 264, 0, 264, 0, 0, 0
1136, 1, 1636420610750, 1636420611014, 264, 0, 264, 0, 0, 0
1138, 1, 1636420610842, 1636420611109, 267, 0, 267, 0, 0, 0
1140, 1, 1636420611141, 1636420611405, 264, 1, 263, 1, 0, 1
1141, 1, 1636420611354, 1636420611618, 264, 0, 264, 0, 0, 0
1142, 1, 1636420611414, 1636420611678, 264, 0, 264, 0, 0, 0
1143, 1, 1636420611438, 1636420611702, 264, 0, 264, 0, 0, 0
1144, 1, 1636420611710, 1636420611974, 264, 0, 264, 0, 0, 0
1145, 1, 1636420611858, 1636420612122, 264, 0, 264, 0, 0, 0
1146, 1, 1636420612137, 1636420612401, 264, 1, 263, 0, 0, 0
1147, 1, 1636420612357, 1636420612622, 265, 1, 264, 1, 0, 1
1148, 1, 1636420612385, 1636420612649, 264, 0, 264, 0, 0, 0
1149, 1, 1636420612457, 1636420612722, 265, 1, 264, 0, 0, 0
1150, 1, 1636420612678, 1636420612942, 264, 0, 264, 0, 0, 0
1151, 1, 1636420612846, 1636420613110, 264, 0, 264, 0, 0, 0
1152, 1, 1636420613137, 1636420613401, 264, 1, 263, 0, 0, 0
1154, 1, 1636420613357, 1636420613622, 265, 0, 265, 0, 0, 0
1153, 1, 1636420613357, 1636420613622, 265, 1, 264, 0, 0, 0
1155, 1, 1636420613465, 1636420613730, 265, 0, 265, 0, 0, 0
1156, 1, 1636420613697, 1636420613965, 268, 1, 267, 1, 0, 1
1157, 1, 1636420613850, 1636420614114, 264, 0, 264, 0, 0, 0
1158, 1, 1636420614126, 1636420614390, 264, 0, 264, 0, 0, 0
1159, 1, 1636420614325, 1636420614589, 264, 1, 263, 0, 1, 1
1160, 1, 1636420614389, 1636420614654, 265, 1, 264, 0, 0, 0
1161, 1, 1636420614458, 1636420614722, 264, 0, 264, 0, 0, 0
1162, 1, 1636420614725, 1636420614990, 265, 1, 264, 0, 0, 0
1163, 1, 1636420614817, 1636420615081, 264, 1, 263, 0, 0, 0
1164, 1, 1636420615134, 1636420615397, 263, 0, 263, 0, 0, 0
1165, 1, 1636420615349, 1636420616017, 668, 1, 667, 0, 0, 0
1166, 1, 1636420615829, 1636420616097, 268, 0, 268, 0, 0, 0
1167, 1, 1636420615873, 1636420616138, 265, 0, 265, 0, 0, 0
1094, 1, 1636420615961, 1636420616225, 264, 1, 263, 1, 0, 1
1168, 1, 1636420616013, 1636420616290, 277, 0, 277, 0, 0, 0
1169, 1, 1636420616049, 1636420616313, 264, 0, 264, 0, 0, 0
1170, 1, 1636420616173, 1636420616442, 269, 1, 268, 0, 0, 0
1181, 1, 1636420616425, 1636420616690, 265, 1, 264, 0, 0, 0
1182, 1, 1636420616521, 1636420616786, 265, 1, 264, 1, 0, 1
1183, 1, 1636420616542, 1636420616806, 264, 0, 264, 0, 0, 0
1185, 1, 1636420616793, 1636420617058, 265, 1, 264, 0, 0, 0
1186, 1, 1636420617061, 1636420617330, 269, 0, 269, 0, 0, 0
1187, 1, 1636420617117, 1636420617385, 268, 1, 267, 0, 0, 0
1188, 1, 1636420617366, 1636420617634, 268, 0, 268, 0, 0, 0
1189, 1, 1636420617502, 1636420617766, 264, 0, 264, 0, 0, 0
1190, 1, 1636420617525, 1636420617790, 265, 1, 264, 0, 1, 1
1191, 1, 1636420617774, 1636420618038, 264, 0, 264, 0, 0, 0
1192, 1, 1636420617801, 1636420618065, 264, 1, 263, 0, 0, 0
1193, 1, 1636420618097, 1636420618361, 264, 1, 263, 0, 0, 0
1194, 1, 1636420618361, 1636420618625, 264, 0, 264, 0, 0, 0
1195, 1, 1636420618538, 1636420618801, 263, 0, 263, 0, 0, 0
1196, 1, 1636420618562, 1636420618829, 267, 0, 267, 0, 0, 0
1198, 1, 1636420618781, 1636420619046, 265, 1, 264, 1, 0, 1
1197, 1, 1636420618805, 1636420619069, 264, 0, 264, 0, 0, 0
1199, 1, 1636420619114, 1636420619381, 267, 0, 267, 0, 0, 0
1200, 1, 1636420619369, 1636420619634, 265, 1, 264, 0, 0, 0
1201, 1, 1636420619541, 1636420619805, 264, 1, 263, 1, 0, 1
1202, 1, 1636420619581, 1636420619846, 265, 1, 264, 0, 0, 0
1205, 1, 1636420619766, 1636420620033, 267, 0, 267, 0, 0, 0
1203, 1, 1636420619805, 1636420620070, 265, 1, 264, 1, 0, 1
1204, 1, 1636420619801, 1636420620070, 269, 1, 268, 0, 0, 0
1206, 1, 1636420620142, 1636420620405, 263, 0, 263, 0, 0, 0
1207, 1, 1636420620357, 1636420620621, 264, 0, 264, 0, 0, 0
1208, 1, 1636420620498, 1636420620813, 315, 0, 315, 0, 0, 0
1209, 1, 1636420620569, 1636420620837, 268, 0, 268, 0, 0, 0
1210, 1, 1636420620729, 1636420620994, 265, 1, 264, 1, 0, 1
1212, 1, 1636420620733, 1636420621002, 269, 1, 268, 0, 1, 1
1211, 1, 1636420620813, 1636420621093, 280, 1, 279, 1, 0, 1
1213, 1, 1636420621118, 1636420621382, 264, 0, 264, 0, 0, 0
1214, 1, 1636420621162, 1636420621425, 263, 0, 263, 0, 0, 0
1216, 1, 1636420621345, 1636420621609, 264, 1, 263, 0, 0, 0
1217, 1, 1636420621457, 1636420621726, 269, 1, 268, 1, 0, 1
1218, 1, 1636420621605, 1636420621870, 265, 1, 264, 1, 0, 1
1219, 1, 1636420621697, 1636420621962, 265, 1, 264, 0, 1, 1
1220, 1, 1636420621733, 1636420621997, 264, 1, 263, 0, 0, 0
1221, 1, 1636420621741, 1636420622010, 269, 1, 268, 0, 0, 0
1222, 1, 1636420622010, 1636420622274, 264, 0, 264, 0, 0, 0
1223, 1, 1636420622133, 1636420622397, 264, 1, 263, 1, 0, 1
1224, 1, 1636420622365, 1636420622634, 269, 0, 269, 0, 0, 0
1225, 1, 1636420622466, 1636420622730, 264, 0, 264, 0, 0, 0
1226, 1, 1636420622617, 1636420622882, 265, 1, 264, 1, 0, 1
1227, 1, 1636420622661, 1636420622926, 265, 1, 264, 1, 0, 1
1228, 1, 1636420622745, 1636420623010, 265, 1, 264, 1, 0, 1
1229, 1, 1636420622786, 1636420623050, 264, 0, 264, 0, 0, 0
1230, 1, 1636420623030, 1636420623298, 268, 0, 268, 0, 0, 0
1231, 1, 1636420623158, 1636420623421, 263, 1, 262, 0, 0, 0
1232, 1, 1636420623373, 1636420623638, 265, 1, 264, 0, 0, 0
1233, 1, 1636420623429, 1636420623698, 269, 1, 268, 1, 0, 1
1234, 1, 1636420623645, 1636420623909, 264, 1, 263, 0, 0, 0
1235, 1, 1636420623690, 1636420623961, 271, 0, 271, 0, 0, 0
1236, 1, 1636420623701, 1636420623970, 269, 0, 269, 0, 0, 0
1237, 1, 1636420623778, 1636420624046, 268, 0, 268, 0, 0, 0
1238, 1, 1636420624037, 1636420624301, 264, 1, 263, 1, 0, 1
1239, 1, 1636420624174, 1636420624437, 263, 0, 263, 0, 0, 0
1240, 1, 1636420624349, 1636420624614, 265, 0, 265, 0, 0, 0
1241, 1, 1636420624441, 1636420624705, 264, 1, 263, 0, 1, 1
1242, 1, 1636420624665, 1636420624929, 264, 1, 263, 0, 1, 1
1243, 1, 1636420624682, 1636420624949, 267, 0, 267, 0, 0, 0
1244, 1, 1636420624721, 1636420624989, 268, 1, 267, 1, 0, 1
1245, 1, 1636420624741, 1636420625005, 264, 1, 263, 0, 1, 1
1246, 1, 1636420625033, 1636420625298, 265, 1, 264, 0, 0, 0
1247, 1, 1636420625177, 1636420625441, 264, 0, 264, 0, 0, 0
1248, 1, 1636420625341, 1636420625610, 269, 1, 268, 0, 0, 0
1249, 1, 1636420625421, 1636420625686, 265, 1, 264, 0, 0, 0
1250, 1, 1636420625661, 1636420625930, 269, 1, 268, 0, 0, 0
1252, 1, 1636420625706, 1636420625970, 264, 0, 264, 0, 0, 0
1253, 1, 1636420625741, 1636420626005, 264, 1, 263, 0, 0, 0
1254, 1, 1636420625998, 1636420626741, 743, 0, 743, 0, 0, 0
1255, 1, 1636420626665, 1636420626929, 264, 1, 263, 0, 0, 0
1256, 1, 1636420626753, 1636420627018, 265, 0, 265, 0, 0, 0
1258, 1, 1636420626793, 1636420627058, 265, 1, 264, 1, 0, 1
1259, 1, 1636420626793, 1636420627058, 265, 1, 264, 1, 0, 1
1257, 1, 1636420626826, 1636420627090, 264, 0, 264, 0, 0, 0
1272, 1, 1636420627142, 1636420627406, 264, 0, 264, 0, 0, 0
1273, 1, 1636420627321, 1636420627585, 264, 1, 263, 1, 0, 1
1274, 1, 1636420627417, 1636420627682, 265, 1, 264, 1, 0, 1
1275, 1, 1636420627453, 1636420627721, 268, 1, 267, 0, 0, 0
1277, 1, 1636420627766, 1636420628030, 264, 0, 264, 0, 0, 0
1279, 1, 1636420628286, 1636420628549, 263, 0, 263, 0, 0, 0
1280, 1, 1636420628370, 1636420628634, 264, 0, 264, 0, 0, 0
1281, 1, 1636420628425, 1636420628690, 265, 1, 264, 0, 0, 0
1282, 1, 1636420628794, 1636420629058, 264, 0, 264, 0, 0, 0
1283, 1, 1636420629310, 1636420629573, 263, 0, 263, 0, 0, 0
1284, 1, 1636420629350, 1636420629613, 263, 0, 263, 0, 0, 0
1285, 1, 1636420629430, 1636420629694, 264, 0, 264, 0, 0, 0
1286, 1, 1636420629794, 1636420630058, 264, 0, 264, 0, 0, 0
1287, 1, 1636420630334, 1636420630598, 264, 0, 264, 0, 0, 0
1288, 1, 1636420630341, 1636420630606, 265, 1, 264, 0, 1, 1
1289, 1, 1636420630453, 1636420630718, 265, 0, 265, 0, 0, 0
1290, 1, 1636420630818, 1636420631085, 267, 0, 267, 0, 0, 0
1291, 1, 1636420631386, 1636420631649, 263, 0, 263, 0, 0, 0
1292, 1, 1636420631386, 1636420631650, 264, 0, 264, 0, 0, 0
1278, 1, 1636420631474, 1636420631737, 263, 0, 263, 0, 0, 0
1293, 1, 1636420631558, 1636420631822, 264, 0, 264, 0, 0, 0
1294, 1, 1636420631778, 1636420632042, 264, 0, 264, 0, 0, 0
1295, 1, 1636420631837, 1636420632101, 264, 1, 263, 0, 0, 0
1296, 1, 1636420632137, 1636420632401, 264, 1, 263, 1, 0, 1
1298, 1, 1636420632389, 1636420632658, 269, 0, 269, 0, 0, 0
1297, 1, 1636420632401, 1636420632665, 264, 1, 263, 1, 0, 1
1299, 1, 1636420632482, 1636420632746, 264, 0, 264, 0, 0, 0
1300, 1, 1636420632669, 1636420632933, 264, 0, 264, 0, 0, 0
1301, 1, 1636420632874, 1636420633142, 268, 0, 268, 0, 0, 0
1302, 1, 1636420633065, 1636420633330, 265, 1, 264, 1, 0, 1
1303, 1, 1636420633349, 1636420633614, 265, 1, 264, 0, 0, 0
1304, 1, 1636420633409, 1636420633674, 265, 1, 264, 0, 0, 0
1305, 1, 1636420633473, 1636420633738, 265, 1, 264, 0, 0, 0
1306, 1, 1636420633705, 1636420633974, 269, 1, 268, 0, 0, 0
1307, 1, 1636420633854, 1636420634117, 263, 0, 263, 0, 0, 0
1308, 1, 1636420634069, 1636420634333, 264, 1, 263, 0, 0, 0
1310, 1, 1636420634374, 1636420634638, 264, 0, 264, 0, 0, 0
1309, 1, 1636420634377, 1636420634645, 268, 0, 268, 0, 0, 0
1311, 1, 1636420634454, 1636420634717, 263, 0, 263, 0, 0, 0
1312, 1, 1636420634705, 1636420634969, 264, 1, 263, 1, 0, 1
1313, 1, 1636420634837, 1636420635101, 264, 1, 263, 0, 0, 0
1314, 1, 1636420635049, 1636420635313, 264, 1, 263, 0, 0, 0
1315, 1, 1636420635337, 1636420635602, 265, 1, 264, 0, 0, 0
1316, 1, 1636420635357, 1636420635626, 269, 1, 268, 0, 0, 0
1317, 1, 1636420635429, 1636420635726, 297, 1, 296, 1, 0, 1
1318, 1, 1636420635721, 1636420635990, 269, 1, 268, 0, 1, 1
1319, 1, 1636420635809, 1636420636074, 265, 0, 265, 0, 0, 0
1320, 1, 1636420636065, 1636420636330, 265, 1, 264, 0, 1, 1
1321, 1, 1636420636361, 1636420636626, 265, 0, 265, 0, 0, 0
1322, 1, 1636420636373, 1636420636642, 269, 1, 268, 0, 1, 1
1323, 1, 1636420636449, 1636420636714, 265, 0, 265, 0, 0, 0
1324, 1, 1636420636689, 1636420636954, 265, 1, 264, 1, 0, 1
1325, 1, 1636420637298, 1636420637565, 267, 0, 267, 0, 0, 0
1276, 1, 1636420637389, 1636420637658, 269, 1, 268, 0, 1, 1
1326, 1, 1636420637481, 1636420637745, 264, 0, 264, 0, 0, 0
1327, 1, 1636420637517, 1636420637782, 265, 1, 264, 1, 0, 1
1328, 1, 1636420637517, 1636420637782, 265, 1, 264, 0, 1, 1
1329, 1, 1636420637517, 1636420637782, 265, 0, 265, 0, 0, 0
1342, 1, 1636420637969, 1636420638234, 265, 1, 264, 0, 0, 0
1343, 1, 1636420637977, 1636420638241, 264, 1, 263, 0, 1, 1
1345, 1, 1636420638141, 1636420638405, 264, 1, 263, 0, 0, 0
1344, 1, 1636420638241, 1636420638506, 265, 1, 264, 1, 0, 1
1346, 1, 1636420638361, 1636420638633, 272, 1, 271, 1, 0, 1
1347, 1, 1636420638381, 1636420638649, 268, 0, 268, 0, 0, 0
1348, 1, 1636420638441, 1636420638706, 265, 1, 264, 0, 0, 0
1349, 1, 1636420638877, 1636420639141, 264, 1, 263, 0, 0, 0
1350, 1, 1636420638937, 1636420639209, 272, 1, 271, 0, 0, 0
1352, 1, 1636420639101, 1636420639366, 265, 0, 265, 0, 0, 0
1351, 1, 1636420639146, 1636420639409, 263, 0, 263, 0, 0, 0
1353, 1, 1636420639381, 1636420639645, 264, 1, 263, 1, 0, 1
1354, 1, 1636420639417, 1636420639681, 264, 1, 263, 0, 1, 1
1355, 1, 1636420639453, 1636420639718, 265, 1, 264, 0, 0, 0
1356, 1, 1636420639894, 1636420640158, 264, 0, 264, 0, 0, 0
1357, 1, 1636420639930, 1636420640193, 263, 0, 263, 0, 0, 0
1359, 1, 1636420640074, 1636420640338, 264, 0, 264, 0, 0, 0
1358, 1, 1636420640158, 1636420640421, 263, 1, 262, 0, 1, 1
1360, 1, 1636420640405, 1636420640669, 264, 0, 264, 0, 0, 0
1362, 1, 1636420640453, 1636420640717, 264, 1, 263, 1, 0, 1
1363, 1, 1636420640873, 1636420641138, 265, 1, 264, 1, 0, 1
1364, 1, 1636420640961, 1636420641225, 264, 1, 263, 0, 1, 1
1366, 1, 1636420641077, 1636420641342, 265, 1, 264, 0, 0, 0
1365, 1, 1636420641138, 1636420641401, 263, 1, 262, 0, 0, 0
1367, 1, 1636420641394, 1636420641662, 268, 0, 268, 0, 0, 0
1368, 1, 1636420641445, 1636420641709, 264, 1, 263, 0, 0, 0
1369, 1, 1636420641870, 1636420642137, 267, 0, 267, 0, 0, 0
1370, 1, 1636420641957, 1636420642221, 264, 1, 263, 0, 0, 0
1371, 1, 1636420642049, 1636420642313, 264, 1, 263, 1, 0, 1
1373, 1, 1636420642086, 1636420642350, 264, 0, 264, 0, 0, 0
1374, 1, 1636420642377, 1636420642641, 264, 1, 263, 1, 0, 1
1375, 1, 1636420642461, 1636420642730, 269, 0, 269, 0, 0, 0
1376, 1, 1636420642870, 1636420643133, 263, 0, 263, 0, 0, 0
1377, 1, 1636420642945, 1636420643210, 265, 1, 264, 0, 0, 0
1378, 1, 1636420642953, 1636420643217, 264, 1, 263, 0, 0, 0
1379, 1, 1636420643086, 1636420643349, 263, 0, 263, 0, 0, 0
1381, 1, 1636420643462, 1636420643726, 264, 0, 264, 0, 0, 0
1383, 1, 1636420643957, 1636420644230, 273, 1, 272, 0, 0, 0
1384, 1, 1636420643977, 1636420644250, 273, 1, 272, 0, 1, 1
1385, 1, 1636420644053, 1636420644318, 265, 1, 264, 0, 0, 0
1386, 1, 1636420644469, 1636420644734, 265, 0, 265, 0, 0, 0
1387, 1, 1636420644946, 1636420645217, 271, 0, 271, 0, 0, 0
1388, 1, 1636420644986, 1636420645249, 263, 0, 263, 0, 0, 0
1389, 1, 1636420645074, 1636420645338, 264, 0, 264, 0, 0, 0
1390, 1, 1636420645438, 1636420645709, 271, 0, 271, 0, 0, 0
1391, 1, 1636420645918, 1636420646186, 268, 0, 268, 0, 0, 0
1392, 1, 1636420645977, 1636420646242, 265, 1, 264, 1, 0, 1
1393, 1, 1636420646054, 1636420646317, 263, 0, 263, 0, 0, 0
1394, 1, 1636420646438, 1636420646702, 264, 0, 264, 0, 0, 0
1395, 1, 1636420646886, 1636420647150, 264, 0, 264, 0, 0, 0
1396, 1, 1636420646993, 1636420647258, 265, 1, 264, 0, 0, 0
1397, 1, 1636420647085, 1636420647350, 265, 1, 264, 1, 0, 1
1398, 1, 1636420647426, 1636420648245, 819, 0, 819, 0, 0, 0
1380, 1, 1636420648198, 1636420648462, 264, 0, 264, 0, 0, 0
1400, 1, 1636420648293, 1636420648558, 265, 1, 264, 1, 0, 1
1399, 1, 1636420648293, 1636420648558, 265, 1, 264, 0, 1, 1
1405, 1, 1636420648482, 1636420648750, 268, 0, 268, 0, 0, 0
1414, 1, 1636420648645, 1636420648909, 264, 1, 263, 1, 0, 1
1415, 1, 1636420648865, 1636420649129, 264, 1, 263, 0, 0, 0
1416, 1, 1636420648982, 1636420649249, 267, 0, 267, 0, 0, 0
1417, 1, 1636420649069, 1636420649334, 265, 1, 264, 1, 0, 1
1418, 1, 1636420649369, 1636420649633, 264, 1, 263, 0, 0, 0
1419, 1, 1636420649586, 1636420649850, 264, 0, 264, 0, 0, 0
1420, 1, 1636420649830, 1636420650094, 264, 0, 264, 0, 0, 0
1421, 1, 1636420649946, 1636420650210, 264, 0, 264, 0, 0, 0
1422, 1, 1636420650097, 1636420650362, 265, 1, 264, 0, 1, 1
1423, 1, 1636420650374, 1636420650638, 264, 0, 264, 0, 0, 0
1424, 1, 1636420650589, 1636420650857, 268, 1, 267, 1, 0, 1
1425, 1, 1636420650714, 1636420650977, 263, 0, 263, 0, 0, 0
1426, 1, 1636420650845, 1636420651113, 268, 1, 267, 1, 0, 1
1427, 1, 1636420650973, 1636420651237, 264, 1, 263, 1, 0, 1
1428, 1, 1636420651077, 1636420651342, 265, 0, 265, 0, 0, 0
1429, 1, 1636420651357, 1636420651621, 264, 1, 263, 1, 0, 1
1430, 1, 1636420651582, 1636420651846, 264, 0, 264, 0, 0, 0
1431, 1, 1636420651629, 1636420651897, 268, 1, 267, 0, 1, 1
1432, 1, 1636420651845, 1636420652109, 264, 1, 263, 0, 0, 0
1433, 1, 1636420651954, 1636420652217, 263, 0, 263, 0, 0, 0
1434, 1, 1636420652145, 1636420652413, 268, 1, 267, 1, 0, 1
1382, 1, 1636420652234, 1636420652497, 263, 0, 263, 0, 0, 0
1435, 1, 1636420652501, 1636420652769, 268, 0, 268, 0, 0, 0
1436, 1, 1636420652537, 1636420652802, 265, 1, 264, 0, 1, 1
1438, 1, 1636420652665, 1636420652934, 269, 1, 268, 0, 1, 1
1439, 1, 1636420652849, 1636420653113, 264, 1, 263, 0, 1, 1
1440, 1, 1636420652897, 1636420653161, 264, 1, 263, 0, 1, 1
1442, 1, 1636420653053, 1636420653317, 264, 1, 263, 1, 0, 1
1443, 1, 1636420653393, 1636420653658, 265, 1, 264, 1, 0, 1
1444, 1, 1636420653450, 1636420653714, 264, 0, 264, 0, 0, 0
1445, 1, 1636420653641, 1636420653910, 269, 1, 268, 0, 1, 1
1446, 1, 1636420653814, 1636420654078, 264, 0, 264, 0, 0, 0
1447, 1, 1636420653825, 1636420654089, 264, 0, 264, 0, 0, 0
1448, 1, 1636420654049, 1636420654313, 264, 1, 263, 0, 0, 0
1449, 1, 1636420654365, 1636420654630, 265, 1, 264, 1, 0, 1
1450, 1, 1636420654446, 1636420654709, 263, 0, 263, 0, 0, 0
1451, 1, 1636420654613, 1636420654877, 264, 1, 263, 0, 0, 0
1452, 1, 1636420654805, 1636420655070, 265, 0, 265, 0, 0, 0
1453, 1, 1636420654837, 1636420655105, 268, 0, 268, 0, 0, 0
1454, 1, 1636420655025, 1636420655290, 265, 1, 264, 1, 0, 1
1455, 1, 1636420655370, 1636420655637, 267, 0, 267, 0, 0, 0
1456, 1, 1636420655414, 1636420655677, 263, 0, 263, 0, 0, 0
1457, 1, 1636420655573, 1636420655838, 265, 1, 264, 0, 0, 0
1458, 1, 1636420655782, 1636420656046, 264, 0, 264, 0, 0, 0
1459, 1, 1636420655850, 1636420656113, 263, 0, 263, 0, 0, 0
1460, 1, 1636420656049, 1636420656318, 269, 1, 268, 0, 1, 1
1461, 1, 1636420656406, 1636420656670, 264, 0, 264, 0, 0, 0
1462, 1, 1636420656438, 1636420656702, 264, 0, 264, 0, 0, 0
1464, 1, 1636420656785, 1636420657054, 269, 1, 268, 0, 0, 0
1465, 1, 1636420656845, 1636420657110, 265, 1, 264, 1, 0, 1
1466, 1, 1636420657026, 1636420657294, 268, 0, 268, 0, 0, 0
1467, 1, 1636420657377, 1636420657642, 265, 1, 264, 0, 0, 0
1468, 1, 1636420657454, 1636420657718, 264, 0, 264, 0, 0, 0
1469, 1, 1636420657765, 1636420658030, 265, 1, 264, 1, 0, 1
1470, 1, 1636420657825, 1636420658090, 265, 1, 264, 0, 0, 0
1471, 1, 1636420658894, 1636420659158, 264, 0, 264, 0, 0, 0
1472, 1, 1636420658894, 1636420659158, 264, 0, 264, 0, 0, 0
1473, 1, 1636420658981, 1636420659254, 273, 1, 272, 0, 0, 0
1475, 1, 1636420659018, 1636420659281, 263, 0, 263, 0, 0, 0
1477, 1, 1636420659197, 1636420659466, 269, 0, 269, 0, 0, 0
1474, 1, 1636420659254, 1636420659521, 267, 0, 267, 0, 0, 0
1487, 1, 1636420659557, 1636420659822, 265, 1, 264, 0, 0, 0
1488, 1, 1636420659557, 1636420659822, 265, 1, 264, 1, 0, 1
1490, 1, 1636420659741, 1636420660010, 269, 0, 269, 0, 0, 0
1489, 1, 1636420659825, 1636420660089, 264, 1, 263, 0, 0, 0
1491, 1, 1636420659925, 1636420660189, 264, 1, 263, 0, 0, 0
1492, 1, 1636420660101, 1636420660366, 265, 1, 264, 0, 1, 1
1494, 1, 1636420660497, 1636420660762, 265, 1, 264, 0, 1, 1
1495, 1, 1636420660625, 1636420660890, 265, 1, 264, 0, 0, 0
1496, 1, 1636420660706, 1636420660970, 264, 0, 264, 0, 0, 0
1497, 1, 1636420660881, 1636420661146, 265, 1, 264, 0, 1, 1
1498, 1, 1636420661114, 1636420661378, 264, 0, 264, 0, 0, 0
1499, 1, 1636420661514, 1636420661778, 264, 0, 264, 0, 0, 0
1500, 1, 1636420661590, 1636420661853, 263, 0, 263, 0, 0, 0
1501, 1, 1636420661670, 1636420661934, 264, 0, 264, 0, 0, 0
1502, 1, 1636420661858, 1636420662121, 263, 0, 263, 0, 0, 0
1503, 1, 1636420662113, 1636420662378, 265, 1, 264, 0, 0, 0
1504, 1, 1636420662525, 1636420662790, 265, 0, 265, 0, 0, 0
1505, 1, 1636420662557, 1636420662826, 269, 0, 269, 0, 0, 0
1506, 1, 1636420662698, 1636420662990, 292, 0, 292, 0, 0, 0
1508, 1, 1636420662850, 1636420663113, 263, 0, 263, 0, 0, 0
1509, 1, 1636420663125, 1636420663390, 265, 1, 264, 0, 0, 0
1511, 1, 1636420663502, 1636420663770, 268, 0, 268, 0, 0, 0
1512, 1, 1636420663561, 1636420663825, 264, 1, 263, 0, 1, 1
1513, 1, 1636420663686, 1636420663950, 264, 0, 264, 0, 0, 0
1514, 1, 1636420663841, 1636420664106, 265, 1, 264, 0, 0, 0
1515, 1, 1636420664130, 1636420664394, 264, 0, 264, 0, 0, 0
1516, 1, 1636420664485, 1636420664753, 268, 1, 267, 0, 0, 0
1517, 1, 1636420664561, 1636420664830, 269, 1, 268, 0, 0, 0
1518, 1, 1636420664654, 1636420664918, 264, 0, 264, 0, 0, 0
1519, 1, 1636420664858, 1636420665122, 264, 0, 264, 0, 0, 0
1520, 1, 1636420665122, 1636420665386, 264, 0, 264, 0, 0, 0
1521, 1, 1636420665517, 1636420665782, 265, 1, 264, 1, 0, 1
1522, 1, 1636420665537, 1636420665802, 265, 1, 264, 0, 0, 0
1523, 1, 1636420665633, 1636420665897, 264, 0, 264, 0, 0, 0
1524, 1, 1636420665886, 1636420666150, 264, 0, 264, 0, 0, 0
1525, 1, 1636420666102, 1636420666366, 264, 0, 264, 0, 0, 0
1526, 1, 1636420666529, 1636420666793, 264, 1, 263, 0, 0, 0
1527, 1, 1636420666550, 1636420666813, 263, 0, 263, 0, 0, 0
1530, 1, 1636420666853, 1636420667118, 265, 1, 264, 0, 1, 1
1529, 1, 1636420666877, 1636420667146, 269, 1, 268, 0, 0, 0
1531, 1, 1636420667138, 1636420667401, 263, 0, 263, 0, 0, 0
1532, 1, 1636420667534, 1636420667797, 263, 0, 263, 0, 0, 0
1533, 1, 1636420667534, 1636420667801, 267, 0, 267, 0, 0, 0
1534, 1, 1636420667790, 1636420668054, 264, 0, 264, 0, 0, 0
1535, 1, 1636420667837, 1636420668102, 265, 1, 264, 1, 0, 1
1536, 1, 1636420668101, 1636420668369, 268, 1, 267, 0, 0, 0
1537, 1, 1636420668521, 1636420668785, 264, 1, 263, 0, 0, 0
1538, 1, 1636420668549, 1636420668814, 265, 1, 264, 0, 0, 0
1539, 1, 1636420668802, 1636420669065, 263, 0, 263, 0, 0, 0
1540, 1, 1636420668825, 1636420669097, 272, 1, 271, 0, 0, 0
1541, 1, 1636420669481, 1636420669753, 272, 1, 271, 1, 0, 1
1493, 1, 1636420669605, 1636420669870, 265, 1, 264, 0, 0, 0
1542, 1, 1636420669701, 1636420669965, 264, 1, 263, 0, 0, 0
1543, 1, 1636420669705, 1636420669969, 264, 1, 263, 0, 0, 0
1544, 1, 1636420669801, 1636420670066, 265, 1, 264, 1, 0, 1
1545, 1, 1636420669834, 1636420670098, 264, 0, 264, 0, 0, 0
1547, 1, 1636420669869, 1636420670133, 264, 1, 263, 0, 0, 0
1556, 1, 1636420670166, 1636420670434, 268, 0, 268, 0, 0, 0
1557, 1, 1636420670266, 1636420670530, 264, 0, 264, 0, 0, 0
1558, 1, 1636420670474, 1636420670741, 267, 0, 267, 0, 0, 0
1559, 1, 1636420670530, 1636420670797, 267, 0, 267, 0, 0, 0
1560, 1, 1636420670785, 1636420671049, 264, 0, 264, 0, 0, 0
1562, 1, 1636420670817, 1636420671082, 265, 1, 264, 0, 1, 1
1561, 1, 1636420670817, 1636420671082, 265, 0, 265, 0, 0, 0
1563, 1, 1636420671125, 1636420671390, 265, 1, 264, 1, 0, 1
1564, 1, 1636420671226, 1636420671494, 268, 0, 268, 0, 0, 0
1565, 1, 1636420671457, 1636420671722, 265, 1, 264, 1, 0, 1
1566, 1, 1636420671550, 1636420671813, 263, 0, 263, 0, 0, 0
1567, 1, 1636420671758, 1636420672022, 264, 0, 264, 0, 0, 0
1568, 1, 1636420671809, 1636420672073, 264, 1, 263, 1, 0, 1
1569, 1, 1636420672114, 1636420672378, 264, 0, 264, 0, 0, 0
1570, 1, 1636420672209, 1636420672481, 272, 1, 271, 1, 0, 1
1571, 1, 1636420672489, 1636420672758, 269, 1, 268, 0, 1, 1
1572, 1, 1636420672529, 1636420672801, 272, 0, 272, 0, 0, 0
1573, 1, 1636420672758, 1636420673021, 263, 0, 263, 0, 0, 0
1574, 1, 1636420672833, 1636420673097, 264, 1, 263, 0, 1, 1
1575, 1, 1636420673122, 1636420673386, 264, 0, 264, 0, 0, 0
1576, 1, 1636420673214, 1636420673478, 264, 0, 264, 0, 0, 0
1577, 1, 1636420673225, 1636420673494, 269, 1, 268, 1, 0, 1
1578, 1, 1636420673465, 1636420673730, 265, 1, 264, 1, 0, 1
1580, 1, 1636420673529, 1636420673793, 264, 1, 263, 0, 0, 0
1579, 1, 1636420673558, 1636420673822, 264, 0, 264, 0, 0, 0
1581, 1, 1636420673730, 1636420673994, 264, 0, 264, 0, 0, 0
1582, 1, 1636420673825, 1636420674089, 264, 0, 264, 0, 0, 0
1584, 1, 1636420674089, 1636420674354, 265, 1, 264, 0, 0, 0
1583, 1, 1636420674089, 1636420674354, 265, 1, 264, 0, 0, 0
1585, 1, 1636420674257, 1636420674521, 264, 0, 264, 0, 0, 0
1586, 1, 1636420674453, 1636420674718, 265, 0, 265, 0, 0, 0
1587, 1, 1636420674498, 1636420674766, 268, 0, 268, 0, 0, 0
1588, 1, 1636420674766, 1636420675030, 264, 0, 264, 0, 0, 0
1589, 1, 1636420674841, 1636420675110, 269, 1, 268, 1, 0, 1
1590, 1, 1636420675065, 1636420675329, 264, 1, 263, 0, 0, 0
1591, 1, 1636420675133, 1636420675397, 264, 1, 263, 0, 1, 1
1592, 1, 1636420675229, 1636420675493, 264, 1, 263, 1, 0, 1
1593, 1, 1636420675490, 1636420675754, 264, 0, 264, 0, 0, 0
1594, 1, 1636420675533, 1636420675798, 265, 0, 265, 0, 0, 0
1595, 1, 1636420675730, 1636420675993, 263, 0, 263, 0, 0, 0
1596, 1, 1636420675842, 1636420676105, 263, 0, 263, 0, 0, 0
1598, 1, 1636420676097, 1636420676362, 265, 0, 265, 0, 0, 0
1599, 1, 1636420676205, 1636420676470, 265, 0, 265, 0, 0, 0
1600, 1, 1636420676462, 1636420676726, 264, 0, 264, 0, 0, 0
1601, 1, 1636420676553, 1636420676817, 264, 1, 263, 0, 1, 1
1602, 1, 1636420676754, 1636420677017, 263, 0, 263, 0, 0, 0
1603, 1, 1636420676821, 1636420677085, 264, 0, 264, 0, 0, 0
1604, 1, 1636420676966, 1636420677234, 268, 0, 268, 0, 0, 0
1605, 1, 1636420677097, 1636420677362, 265, 1, 264, 0, 0, 0
1606, 1, 1636420677234, 1636420677498, 264, 0, 264, 0, 0, 0
1607, 1, 1636420677441, 1636420677706, 265, 1, 264, 0, 1, 1
1608, 1, 1636420677526, 1636420677789, 263, 0, 263, 0, 0, 0
1609, 1, 1636420677741, 1636420678006, 265, 1, 264, 0, 1, 1
1610, 1, 1636420677826, 1636420678090, 264, 0, 264, 0, 0, 0
1611, 1, 1636420677882, 1636420678146, 264, 0, 264, 0, 0, 0
1612, 1, 1636420678057, 1636420678325, 268, 1, 267, 1, 0, 1
1613, 1, 1636420678213, 1636420678478, 265, 1, 264, 0, 0, 0
1614, 1, 1636420678433, 1636420678697, 264, 1, 263, 0, 0, 0
1615, 1, 1636420678697, 1636420678962, 265, 1, 264, 1, 0, 1
1616, 1, 1636420678738, 1636420679002, 264, 0, 264, 0, 0, 0
1617, 1, 1636420678822, 1636420679085, 263, 0, 263, 0, 0, 0
1618, 1, 1636420678902, 1636420679166, 264, 0, 264, 0, 0, 0
1620, 1, 1636420679213, 1636420679478, 265, 1, 264, 1, 0, 1
1622, 1, 1636420679498, 1636420679762, 264, 0, 264, 0, 0, 0
1623, 1, 1636420680117, 1636420680386, 269, 1, 268, 1, 0, 1
1624, 1, 1636420680209, 1636420680473, 264, 1, 263, 0, 0, 0
1625, 1, 1636420680209, 1636420680477, 268, 1, 267, 0, 0, 0
1626, 1, 1636420680341, 1636420680605, 264, 1, 263, 0, 0, 0
1636, 1, 1636420680497, 1636420680761, 264, 1, 263, 1, 0, 1
1637, 1, 1636420680806, 1636420681069, 263, 0, 263, 0, 0, 0
1638, 1, 1636420680878, 1636420681141, 263, 0, 263, 0, 0, 0
1639, 1, 1636420680917, 1636420681182, 265, 1, 264, 0, 0, 0
1640, 1, 1636420681230, 1636420681494, 264, 0, 264, 0, 0, 0
1641, 1, 1636420681473, 1636420681738, 265, 1, 264, 1, 0, 1
1642, 1, 1636420681738, 1636420682002, 264, 0, 264, 0, 0, 0
1644, 1, 1636420681898, 1636420682162, 264, 0, 264, 0, 0, 0
1643, 1, 1636420682009, 1636420682286, 277, 1, 276, 0, 1, 1
1645, 1, 1636420682253, 1636420682518, 265, 1, 264, 0, 1, 1
1646, 1, 1636420682505, 1636420682774, 269, 1, 268, 0, 0, 0
1647, 1, 1636420682710, 1636420682974, 264, 0, 264, 0, 0, 0
1649, 1, 1636420682866, 1636420683130, 264, 0, 264, 0, 0, 0
1648, 1, 1636420682866, 1636420683130, 264, 0, 264, 0, 0, 0
1650, 1, 1636420683222, 1636420683486, 264, 0, 264, 0, 0, 0
1651, 1, 1636420683486, 1636420683753, 267, 0, 267, 0, 0, 0
1652, 1, 1636420683698, 1636420683961, 263, 0, 263, 0, 0, 0
1653, 1, 1636420683874, 1636420684138, 264, 0, 264, 0, 0, 0
1654, 1, 1636420683902, 1636420684166, 264, 0, 264, 0, 0, 0
1655, 1, 1636420684694, 1636420684957, 263, 0, 263, 0, 0, 0
1656, 1, 1636420684902, 1636420685166, 264, 0, 264, 0, 0, 0
1657, 1, 1636420684922, 1636420685186, 264, 0, 264, 0, 0, 0
1659, 1, 1636420685890, 1636420686158, 268, 0, 268, 0, 0, 0
1660, 1, 1636420685941, 1636420686205, 264, 0, 264, 0, 0, 0
1661, 1, 1636420686386, 1636420686649, 263, 0, 263, 0, 0, 0
1662, 1, 1636420686877, 1636420687142, 265, 1, 264, 0, 0, 0
1663, 1, 1636420686898, 1636420687166, 268, 0, 268, 0, 0, 0
1664, 1, 1636420687290, 1636420687553, 263, 0, 263, 0, 0, 0
1665, 1, 1636420687838, 1636420688102, 264, 0, 264, 0, 0, 0
1666, 1, 1636420687909, 1636420688177, 268, 1, 267, 0, 0, 0
1667, 1, 1636420688266, 1636420688530, 264, 0, 264, 0, 0, 0
1668, 1, 1636420688838, 1636420689102, 264, 0, 264, 0, 0, 0
1669, 1, 1636420688922, 1636420689185, 263, 0, 263, 0, 0, 0
1670, 1, 1636420689237, 1636420689501, 264, 1, 263, 1, 0, 1
1671, 1, 1636420689386, 1636420689650, 264, 0, 264, 0, 0, 0
1672, 1, 1636420689730, 1636420689994, 264, 0, 264, 0, 0, 0
1673, 1, 1636420689809, 1636420690074, 265, 0, 265, 0, 0, 0
1674, 1, 1636420689902, 1636420690166, 264, 0, 264, 0, 0, 0
1675, 1, 1636420690262, 1636420690925, 663, 0, 663, 0, 0, 0
1676, 1, 1636420690286, 1636420690925, 639, 0, 639, 0, 0, 0
1677, 1, 1636420690929, 1636420691193, 264, 0, 264, 0, 0, 0
1678, 1, 1636420690973, 1636420691237, 264, 1, 263, 0, 1, 1
1679, 1, 1636420690973, 1636420691241, 268, 1, 267, 0, 1, 1
1683, 1, 1636420691142, 1636420691405, 263, 0, 263, 0, 0, 0
1689, 1, 1636420691326, 1636420691590, 264, 0, 264, 0, 0, 0
1690, 1, 1636420691326, 1636420691590, 264, 0, 264, 0, 0, 0
1691, 1, 1636420691645, 1636420691918, 273, 1, 272, 0, 0, 0
1692, 1, 1636420691834, 1636420692102, 268, 0, 268, 0, 0, 0
1693, 1, 1636420691898, 1636420692162, 264, 0, 264, 0, 0, 0
1694, 1, 1636420692078, 1636420692342, 264, 0, 264, 0, 0, 0
1695, 1, 1636420692282, 1636420692546, 264, 0, 264, 0, 0, 0
1696, 1, 1636420692306, 1636420692570, 264, 0, 264, 0, 0, 0
1697, 1, 1636420692621, 1636420692890, 269, 1, 268, 0, 0, 0
1698, 1, 1636420692921, 1636420693186, 265, 1, 264, 1, 0, 1
1699, 1, 1636420693081, 1636420693345, 264, 1, 263, 1, 0, 1
1700, 1, 1636420693241, 1636420693506, 265, 1, 264, 1, 0, 1
1701, 1, 1636420693345, 1636420693614, 269, 1, 268, 1, 0, 1
1702, 1, 1636420693637, 1636420693902, 265, 1, 264, 1, 0, 1
1703, 1, 1636420693902, 1636420694170, 268, 0, 268, 0, 0, 0
1704, 1, 1636420694093, 1636420694362, 269, 0, 269, 0, 0, 0
1705, 1, 1636420694257, 1636420694522, 265, 0, 265, 0, 0, 0
1706, 1, 1636420694302, 1636420694566, 264, 0, 264, 0, 0, 0
1707, 1, 1636420694678, 1636420694946, 268, 0, 268, 0, 0, 0
1708, 1, 1636420694886, 1636420695153, 267, 0, 267, 0, 0, 0
1709, 1, 1636420695102, 1636420695366, 264, 0, 264, 0, 0, 0
1710, 1, 1636420695253, 1636420695518, 265, 1, 264, 0, 0, 0
1711, 1, 1636420695269, 1636420695533, 264, 1, 263, 0, 0, 0
1712, 1, 1636420695669, 1636420695933, 264, 1, 263, 1, 0, 1
1713, 1, 1636420695893, 1636420696157, 264, 1, 263, 0, 0, 0
1714, 1, 1636420696017, 1636420696281, 264, 1, 263, 0, 0, 0
1715, 1, 1636420696093, 1636420696358, 265, 1, 264, 1, 0, 1
1716, 1, 1636420696241, 1636420696506, 265, 1, 264, 0, 0, 0
1717, 1, 1636420696273, 1636420696537, 264, 1, 263, 0, 1, 1
1718, 1, 1636420696670, 1636420696933, 263, 0, 263, 0, 0, 0
1719, 1, 1636420696886, 1636420697154, 268, 0, 268, 0, 0, 0
1720, 1, 1636420696925, 1636420697189, 264, 1, 263, 0, 0, 0
1721, 1, 1636420697082, 1636420697345, 263, 0, 263, 0, 0, 0
1722, 1, 1636420697213, 1636420697477, 264, 1, 263, 1, 0, 1
1723, 1, 1636420697237, 1636420697502, 265, 1, 264, 0, 0, 0
1724, 1, 1636420697706, 1636420697969, 263, 0, 263, 0, 0, 0
1725, 1, 1636420697889, 1636420698154, 265, 1, 264, 0, 0, 0
1726, 1, 1636420697901, 1636420698169, 268, 1, 267, 0, 0, 0
1727, 1, 1636420698121, 1636420698386, 265, 1, 264, 0, 0, 0
1728, 1, 1636420698213, 1636420698478, 265, 1, 264, 0, 0, 0
1729, 1, 1636420698241, 1636420698509, 268, 1, 267, 0, 0, 0
1730, 1, 1636420698698, 1636420698961, 263, 0, 263, 0, 0, 0
1731, 1, 1636420698882, 1636420699149, 267, 0, 267, 0, 0, 0
1732, 1, 1636420698889, 1636420699154, 265, 1, 264, 0, 1, 1
1733, 1, 1636420699153, 1636420699418, 265, 1, 264, 1, 0, 1
1734, 1, 1636420699205, 1636420699470, 265, 0, 265, 0, 0, 0
1735, 1, 1636420699217, 1636420699482, 265, 0, 265, 0, 0, 0
1736, 1, 1636420699682, 1636420699945, 263, 0, 263, 0, 0, 0
1737, 1, 1636420699893, 1636420700161, 268, 1, 267, 0, 0, 0
1738, 1, 1636420699898, 1636420700173, 275, 0, 275, 0, 0, 0
1739, 1, 1636420700066, 1636420700329, 263, 0, 263, 0, 0, 0
1740, 1, 1636420700209, 1636420700473, 264, 0, 264, 0, 0, 0
1741, 1, 1636420700241, 1636420700513, 272, 0, 272, 0, 0, 0
1742, 1, 1636420700686, 1636420700949, 263, 0, 263, 0, 0, 0
1743, 1, 1636420700882, 1636420701525, 643, 0, 643, 0, 0, 0
1744, 1, 1636420701441, 1636420701705, 264, 1, 263, 0, 1, 1
1746, 1, 1636420701533, 1636420701798, 265, 1, 264, 0, 0, 0
1745, 1, 1636420701533, 1636420701798, 265, 1, 264, 1, 0, 1
1747, 1, 1636420701681, 1636420701945, 264, 1, 263, 1, 0, 1
1756, 1, 1636420701950, 1636420702214, 264, 0, 264, 0, 0, 0
1757, 1, 1636420702121, 1636420702390, 269, 1, 268, 1, 0, 1
1759, 1, 1636420702217, 1636420702486, 269, 1, 268, 0, 0, 0
1758, 1, 1636420702226, 1636420702493, 267, 0, 267, 0, 0, 0
1760, 1, 1636420702718, 1636420702981, 263, 0, 263, 0, 0, 0
1761, 1, 1636420702926, 1636420703194, 268, 0, 268, 0, 0, 0
1762, 1, 1636420703065, 1636420703329, 264, 1, 263, 0, 1, 1
1763, 1, 1636420703182, 1636420703450, 268, 0, 268, 0, 0, 0
1764, 1, 1636420703457, 1636420703722, 265, 1, 264, 1, 0, 1
1765, 1, 1636420703701, 1636420703965, 264, 1, 263, 0, 1, 1
1766, 1, 1636420703910, 1636420704178, 268, 0, 268, 0, 0, 0
1767, 1, 1636420704038, 1636420704306, 268, 0, 268, 0, 0, 0
1768, 1, 1636420704198, 1636420704461, 263, 0, 263, 0, 0, 0
1769, 1, 1636420704205, 1636420704469, 264, 1, 263, 0, 0, 0
1770, 1, 1636420704718, 1636420704981, 263, 0, 263, 0, 0, 0
1772, 1, 1636420705018, 1636420705285, 267, 0, 267, 0, 0, 0
1773, 1, 1636420705178, 1636420705446, 268, 0, 268, 0, 0, 0
1774, 1, 1636420705237, 1636420705502, 265, 1, 264, 1, 0, 1
1775, 1, 1636420705742, 1636420706010, 268, 0, 268, 0, 0, 0
1776, 1, 1636420706017, 1636420706281, 264, 1, 263, 0, 1, 1
1777, 1, 1636420706206, 1636420706478, 272, 0, 272, 0, 0, 0
1779, 1, 1636420706717, 1636420706982, 265, 1, 264, 1, 0, 1
1781, 1, 1636420707234, 1636420707502, 268, 0, 268, 0, 0, 0
1782, 1, 1636420707706, 1636420707970, 264, 0, 264, 0, 0, 0
1783, 1, 1636420708225, 1636420708490, 265, 1, 264, 0, 0, 0
1784, 1, 1636420708706, 1636420708970, 264, 0, 264, 0, 0, 0
1785, 1, 1636420709214, 1636420709478, 264, 0, 264, 0, 0, 0
1786, 1, 1636420709678, 1636420709942, 264, 0, 264, 0, 0, 0
1787, 1, 1636420710177, 1636420710442, 265, 1, 264, 0, 0, 0
1788, 1, 1636420710682, 1636420710946, 264, 0, 264, 0, 0, 0
1789, 1, 1636420711173, 1636420711441, 268, 1, 267, 0, 0, 0
1790, 1, 1636420712033, 1636420712302, 269, 1, 268, 0, 0, 0
1791, 1, 1636420712166, 1636420712430, 264, 0, 264, 0, 0, 0
1800, 1, 1636420712721, 1636420712990, 269, 1, 268, 0, 0, 0
1778, 1, 1636420714898, 1636420715161, 263, 0, 263, 0, 0, 0
1801, 1, 1636420715205, 1636420715470, 265, 1, 264, 0, 0, 0
1802, 1, 1636420715558, 1636420715826, 268, 0, 268, 0, 0, 0
1803, 1, 1636420716105, 1636420716369, 264, 1, 263, 1, 0, 1
1804, 1, 1636420716501, 1636420716766, 265, 1, 264, 1, 0, 1
1805, 1, 1636420717162, 1636420717426, 264, 0, 264, 0, 0, 0
1806, 1, 1636420717338, 1636420717602, 264, 0, 264, 0, 0, 0
1807, 1, 1636420717514, 1636420717778, 264, 0, 264, 0, 0, 0
1808, 1, 1636420718125, 1636420718390, 265, 1, 264, 0, 0, 0
1809, 1, 1636420718245, 1636420718513, 268, 1, 267, 1, 0, 1
1810, 1, 1636420718533, 1636420718797, 264, 1, 263, 1, 0, 1
1811, 1, 1636420719113, 1636420719378, 265, 1, 264, 0, 0, 0
1812, 1, 1636420719226, 1636420719494, 268, 0, 268, 0, 0, 0
1813, 1, 1636420719533, 1636420719798, 265, 1, 264, 0, 0, 0
1814, 1, 1636420720146, 1636420720410, 264, 0, 264, 0, 0, 0
1815, 1, 1636420720214, 1636420720482, 268, 0, 268, 0, 0, 0
1816, 1, 1636420720505, 1636420720770, 265, 1, 264, 0, 0, 0
1817, 1, 1636420721161, 1636420721426, 265, 1, 264, 1, 0, 1
1818, 1, 1636420721230, 1636420721494, 264, 0, 264, 0, 0, 0
1820, 1, 1636420722529, 1636420722797, 268, 1, 267, 0, 0, 0
1821, 1, 1636420722529, 1636420722798, 269, 1, 268, 0, 0, 0
1819, 1, 1636420722661, 1636420722930, 269, 1, 268, 0, 0, 0
1824, 1, 1636420722929, 1636420723197, 268, 1, 267, 0, 0, 0
1830, 1, 1636420723213, 1636420723477, 264, 0, 264, 0, 0, 0
1831, 1, 1636420723241, 1636420723514, 273, 1, 272, 0, 0, 0
1832, 1, 1636420723330, 1636420723594, 264, 0, 264, 0, 0, 0
1833, 1, 1636420723850, 1636420724113, 263, 0, 263, 0, 0, 0
1834, 1, 1636420724157, 1636420724422, 265, 1, 264, 0, 0, 0
1835, 1, 1636420724217, 1636420724481, 264, 1, 263, 0, 0, 0
1836, 1, 1636420724302, 1636420724566, 264, 0, 264, 0, 0, 0
1837, 1, 1636420724865, 1636420725129, 264, 0, 264, 0, 0, 0
1838, 1, 1636420725170, 1636420725434, 264, 0, 264, 0, 0, 0
1839, 1, 1636420725217, 1636420725481, 264, 1, 263, 1, 0, 1
1840, 1, 1636420725310, 1636420725574, 264, 0, 264, 0, 0, 0
1841, 1, 1636420725866, 1636420726130, 264, 0, 264, 0, 0, 0
1843, 1, 1636420726198, 1636420726461, 263, 0, 263, 0, 0, 0
1842, 1, 1636420726198, 1636420726461, 263, 0, 263, 0, 0, 0
1844, 1, 1636420726301, 1636420726566, 265, 1, 264, 1, 0, 1
1845, 1, 1636420726862, 1636420727125, 263, 0, 263, 0, 0, 0
1846, 1, 1636420727189, 1636420727457, 268, 0, 268, 0, 0, 0
1847, 1, 1636420727205, 1636420727470, 265, 0, 265, 0, 0, 0
1848, 1, 1636420727337, 1636420727602, 265, 1, 264, 1, 0, 1
1849, 1, 1636420727854, 1636420728118, 264, 0, 264, 0, 0, 0
1851, 1, 1636420728229, 1636420728493, 264, 1, 263, 0, 0, 0
1850, 1, 1636420728229, 1636420728493, 264, 1, 263, 0, 0, 0
1852, 1, 1636420728306, 1636420728569, 263, 0, 263, 0, 0, 0
1855, 1, 1636420729234, 1636420729501, 267, 1, 266, 0, 1, 1
1854, 1, 1636420729234, 1636420729501, 267, 0, 267, 0, 0, 0
1856, 1, 1636420729297, 1636420729561, 264, 0, 264, 0, 0, 0
1857, 1, 1636420730237, 1636420730502, 265, 1, 264, 0, 1, 1
1858, 1, 1636420730245, 1636420730509, 264, 1, 263, 0, 1, 1
1859, 1, 1636420730273, 1636420730538, 265, 1, 264, 0, 1, 1
1860, 1, 1636420731213, 1636420731481, 268, 1, 267, 1, 0, 1
1861, 1, 1636420731242, 1636420731506, 264, 0, 264, 0, 0, 0
1862, 1, 1636420731269, 1636420731533, 264, 1, 263, 0, 0, 0
1863, 1, 1636420732209, 1636420732473, 264, 1, 263, 0, 0, 0
1864, 1, 1636420732218, 1636420732482, 264, 0, 264, 0, 0, 0
1865, 1, 1636420732277, 1636420732541, 264, 1, 263, 0, 0, 0
1853, 1, 1636420733218, 1636420733481, 263, 0, 263, 0, 0, 0
1866, 1, 1636420733301, 1636420733566, 265, 1, 264, 0, 0, 0
1868, 1, 1636420733305, 1636420733574, 269, 1, 268, 1, 0, 1
1867, 1, 1636420733574, 1636420733838, 264, 0, 264, 0, 0, 0
1876, 1, 1636420733901, 1636420734166, 265, 1, 264, 0, 1, 1
1877, 1, 1636420734181, 1636420734445, 264, 1, 263, 1, 0, 1
1878, 1, 1636420734273, 1636420734537, 264, 1, 263, 0, 0, 0
1879, 1, 1636420734314, 1636420734578, 264, 0, 264, 0, 0, 0
1880, 1, 1636420734830, 1636420735093, 263, 0, 263, 0, 0, 0
1881, 1, 1636420735137, 1636420735401, 264, 1, 263, 0, 1, 1
1882, 1, 1636420735214, 1636420735478, 264, 0, 264, 0, 0, 0
1883, 1, 1636420735337, 1636420735602, 265, 1, 264, 0, 0, 0
1884, 1, 1636420735866, 1636420736130, 264, 0, 264, 0, 0, 0
1885, 1, 1636420736142, 1636420736406, 264, 0, 264, 0, 0, 0
1886, 1, 1636420736233, 1636420736498, 265, 1, 264, 0, 0, 0
1887, 1, 1636420736317, 1636420736582, 265, 1, 264, 0, 0, 0
1888, 1, 1636420736902, 1636420737169, 267, 0, 267, 0, 0, 0
1889, 1, 1636420737173, 1636420737438, 265, 1, 264, 0, 0, 0
1890, 1, 1636420737246, 1636420737513, 267, 0, 267, 0, 0, 0
1891, 1, 1636420737297, 1636420737562, 265, 1, 264, 1, 0, 1
1892, 1, 1636420737866, 1636420738129, 263, 0, 263, 0, 0, 0
1893, 1, 1636420738145, 1636420738413, 268, 0, 268, 0, 0, 0
1894, 1, 1636420738261, 1636420738525, 264, 1, 263, 1, 0, 1
1895, 1, 1636420738277, 1636420738550, 273, 1, 272, 0, 1, 1
1896, 1, 1636420738838, 1636420739102, 264, 0, 264, 0, 0, 0
1897, 1, 1636420739121, 1636420739385, 264, 1, 263, 0, 1, 1
1898, 1, 1636420739253, 1636420739521, 268, 1, 267, 1, 0, 1
1899, 1, 1636420739289, 1636420739553, 264, 1, 263, 0, 0, 0
1900, 1, 1636420739802, 1636420740070, 268, 0, 268, 0, 0, 0
1901, 1, 1636420740089, 1636420740354, 265, 1, 264, 0, 0, 0
1902, 1, 1636420740257, 1636420740522, 265, 1, 264, 0, 0, 0
1903, 1, 1636420740286, 1636420740550, 264, 0, 264, 0, 0, 0
1904, 1, 1636420740802, 1636420741070, 268, 0, 268, 0, 0, 0
1906, 1, 1636420741281, 1636420741549, 268, 1, 267, 0, 0, 0
1907, 1, 1636420741297, 1636420741562, 265, 1, 264, 0, 0, 0
1910, 1, 1636420742298, 1636420742562, 264, 1, 263, 0, 0, 0
1909, 1, 1636420742298, 1636420742562, 264, 1, 263, 0, 0, 0
1911, 1, 1636420743289, 1636420743825, 536, 1, 535, 0, 0, 0
1912, 1, 1636420743310, 1636420743825, 515, 0, 515, 0, 0, 0
1913, 1, 1636420744050, 1636420744314, 264, 0, 264, 0, 0, 0
1920, 1, 1636420744294, 1636420744558, 264, 0, 264, 0, 0, 0
1922, 1, 1636420744993, 1636420745258, 265, 0, 265, 0, 0, 0
1923, 1, 1636420745313, 1636420745578, 265, 0, 265, 0, 0, 0
1924, 1, 1636420746022, 1636420746285, 263, 0, 263, 0, 0, 0
1925, 1, 1636420746310, 1636420746574, 264, 0, 264, 0, 0, 0
1926, 1, 1636420747045, 1636420747310, 265, 1, 264, 1, 0, 1
1927, 1, 1636420747313, 1636420747582, 269, 1, 268, 0, 0, 0
1928, 1, 1636420748033, 1636420748298, 265, 1, 264, 1, 0, 1
1929, 1, 1636420748286, 1636420748554, 268, 0, 268, 0, 0, 0
1930, 1, 1636420749029, 1636420749293, 264, 0, 264, 0, 0, 0
1931, 1, 1636420749281, 1636420749550, 269, 1, 268, 1, 0, 1
1932, 1, 1636420750054, 1636420750317, 263, 0, 263, 0, 0, 0
1934, 1, 1636420751058, 1636420751322, 264, 0, 264, 0, 0, 0
1935, 1, 1636420751377, 1636420751645, 268, 1, 267, 1, 0, 1
1936, 1, 1636420752062, 1636420752326, 264, 0, 264, 0, 0, 0
1937, 1, 1636420752121, 1636420752386, 265, 1, 264, 1, 0, 1
1938, 1, 1636420752297, 1636420752562, 265, 1, 264, 0, 0, 0
1939, 1, 1636420753037, 1636420753302, 265, 0, 265, 0, 0, 0
1940, 1, 1636420753049, 1636420753318, 269, 1, 268, 1, 0, 1
1941, 1, 1636420753301, 1636420753566, 265, 1, 264, 0, 0, 0
1943, 1, 1636420754281, 1636420754545, 264, 1, 263, 1, 0, 1
1933, 1, 1636420754281, 1636420754545, 264, 1, 263, 0, 1, 1
1942, 1, 1636420754281, 1636420754557, 276, 1, 275, 0, 1, 1
1944, 1, 1636420754409, 1636420754677, 268, 0, 268, 0, 0, 0
1945, 1, 1636420754609, 1636420754874, 265, 1, 264, 0, 1, 1
1952, 1, 1636420754962, 1636420755234, 272, 0, 272, 0, 0, 0
1953, 1, 1636420755017, 1636420755281, 264, 0, 264, 0, 0, 0
1954, 1, 1636420755021, 1636420755285, 264, 0, 264, 0, 0, 0
1955, 1, 1636420755293, 1636420755557, 264, 1, 263, 0, 0, 0
1956, 1, 1636420755506, 1636420755773, 267, 0, 267, 0, 0, 0
1957, 1, 1636420755909, 1636420756177, 268, 1, 267, 0, 1, 1
1958, 1, 1636420755989, 1636420756253, 264, 1, 263, 0, 1, 1
1959, 1, 1636420756018, 1636420756289, 271, 0, 271, 0, 0, 0
1960, 1, 1636420756326, 1636420756590, 264, 0, 264, 0, 0, 0
1961, 1, 1636420756549, 1636420756814, 265, 1, 264, 0, 0, 0
1962, 1, 1636420756918, 1636420757186, 268, 0, 268, 0, 0, 0
1963, 1, 1636420757001, 1636420757266, 265, 1, 264, 1, 0, 1
1964, 1, 1636420757005, 1636420757274, 269, 1, 268, 0, 0, 0
1965, 1, 1636420757321, 1636420757585, 264, 1, 263, 1, 0, 1
1966, 1, 1636420757518, 1636420757782, 264, 0, 264, 0, 0, 0
1967, 1, 1636420757913, 1636420758181, 268, 1, 267, 1, 0, 1
1968, 1, 1636420757985, 1636420758249, 264, 1, 263, 0, 0, 0
1969, 1, 1636420758010, 1636420758274, 264, 0, 264, 0, 0, 0
1970, 1, 1636420758329, 1636420758594, 265, 1, 264, 0, 1, 1
1971, 1, 1636420758594, 1636420758858, 264, 1, 263, 0, 1, 1
1974, 1, 1636420758994, 1636420759258, 264, 0, 264, 0, 0, 0
1973, 1, 1636420758994, 1636420759265, 271, 0, 271, 0, 0, 0
1975, 1, 1636420759366, 1636420759634, 268, 0, 268, 0, 0, 0
1976, 1, 1636420759478, 1636420759742, 264, 0, 264, 0, 0, 0
1978, 1, 1636420759974, 1636420760237, 263, 0, 263, 0, 0, 0
1977, 1, 1636420759974, 1636420760237, 263, 0, 263, 0, 0, 0
1979, 1, 1636420760361, 1636420760626, 265, 1, 264, 1, 0, 1
1981, 1, 1636420760953, 1636420761217, 264, 1, 263, 1, 0, 1
1982, 1, 1636420760965, 1636420761230, 265, 0, 265, 0, 0, 0
1983, 1, 1636420761353, 1636420761618, 265, 1, 264, 1, 0, 1
1984, 1, 1636420761957, 1636420762222, 265, 1, 264, 1, 0, 1
1985, 1, 1636420761973, 1636420762242, 269, 1, 268, 0, 0, 0
1986, 1, 1636420762374, 1636420762638, 264, 0, 264, 0, 0, 0
1987, 1, 1636420762941, 1636420763205, 264, 1, 263, 1, 0, 1
1988, 1, 1636420762978, 1636420763241, 263, 0, 263, 0, 0, 0
1989, 1, 1636420763370, 1636420763638, 268, 0, 268, 0, 0, 0
1990, 1, 1636420763930, 1636420764197, 267, 0, 267, 0, 0, 0
1991, 1, 1636420763989, 1636420764253, 264, 1, 263, 1, 0, 1
1992, 1, 1636420764394, 1636420764902, 508, 0, 508, 0, 0, 0
1993, 1, 1636420764953, 1636420765218, 265, 1, 264, 1, 0, 1
1994, 1, 1636420765006, 1636420765269, 263, 0, 263, 0, 0, 0
2001, 1, 1636420765390, 1636420765657, 267, 0, 267, 0, 0, 0
2002, 1, 1636420765925, 1636420766190, 265, 1, 264, 1, 0, 1
2003, 1, 1636420766037, 1636420766302, 265, 1, 264, 0, 1, 1
2004, 1, 1636420766398, 1636420766666, 268, 0, 268, 0, 0, 0
2005, 1, 1636420766906, 1636420767174, 268, 0, 268, 0, 0, 0
2006, 1, 1636420767042, 1636420767306, 264, 0, 264, 0, 0, 0
2007, 1, 1636420767425, 1636420767694, 269, 1, 268, 0, 1, 1
2008, 1, 1636420767902, 1636420768170, 268, 0, 268, 0, 0, 0
2009, 1, 1636420768050, 1636420768314, 264, 0, 264, 0, 0, 0
2010, 1, 1636420768402, 1636420768665, 263, 0, 263, 0, 0, 0
2011, 1, 1636420768922, 1636420769186, 264, 0, 264, 0, 0, 0
2012, 1, 1636420769070, 1636420769334, 264, 0, 264, 0, 0, 0
2014, 1, 1636420769381, 1636420769646, 265, 1, 264, 1, 0, 1
2015, 1, 1636420769942, 1636420770210, 268, 0, 268, 0, 0, 0
2016, 1, 1636420770101, 1636420770370, 269, 1, 268, 1, 0, 1
2017, 1, 1636420770425, 1636420770690, 265, 1, 264, 1, 0, 1
2018, 1, 1636420770770, 1636420771034, 264, 0, 264, 0, 0, 0
2020, 1, 1636420771081, 1636420771346, 265, 1, 264, 1, 0, 1
2021, 1, 1636420771686, 1636420771950, 264, 0, 264, 0, 0, 0
2022, 1, 1636420772065, 1636420772330, 265, 1, 264, 1, 0, 1
2023, 1, 1636420772698, 1636420772965, 267, 0, 267, 0, 0, 0
2024, 1, 1636420773037, 1636420773302, 265, 1, 264, 0, 1, 1
2025, 1, 1636420773670, 1636420773938, 268, 0, 268, 0, 0, 0
2026, 1, 1636420774073, 1636420774338, 265, 1, 264, 0, 0, 0
2027, 1, 1636420774690, 1636420774953, 263, 0, 263, 0, 0, 0
2028, 1, 1636420775313, 1636420775581, 268, 1, 267, 1, 0, 1
2019, 1, 1636420775361, 1636420775626, 265, 1, 264, 1, 0, 1
2033, 1, 1636420775626, 1636420775890, 264, 0, 264, 0, 0, 0
2035, 1, 1636420775701, 1636420775965, 264, 1, 263, 0, 0, 0
2036, 1, 1636420776021, 1636420776286, 265, 1, 264, 0, 1, 1
2037, 1, 1636420776054, 1636420776318, 264, 0, 264, 0, 0, 0
2038, 1, 1636420776558, 1636420776822, 264, 0, 264, 0, 0, 0
2039, 1, 1636420776674, 1636420776937, 263, 0, 263, 0, 0, 0
2040, 1, 1636420776957, 1636420777222, 265, 1, 264, 0, 0, 0
2041, 1, 1636420777070, 1636420777338, 268, 0, 268, 0, 0, 0
2042, 1, 1636420777581, 1636420777846, 265, 1, 264, 0, 0, 0
2043, 1, 1636420777710, 1636420777974, 264, 0, 264, 0, 0, 0
2044, 1, 1636420777925, 1636420778194, 269, 1, 268, 0, 0, 0
2045, 1, 1636420778041, 1636420778306, 265, 1, 264, 0, 1, 1
2046, 1, 1636420778554, 1636420778817, 263, 0, 263, 0, 0, 0
2047, 1, 1636420778741, 1636420779006, 265, 1, 264, 0, 0, 0
2048, 1, 1636420778905, 1636420779170, 265, 1, 264, 1, 0, 1
2049, 1, 1636420779065, 1636420779330, 265, 1, 264, 1, 0, 1
2050, 1, 1636420779497, 1636420779762, 265, 1, 264, 0, 0, 0
2051, 1, 1636420779549, 1636420779813, 264, 1, 263, 1, 0, 1
2052, 1, 1636420779718, 1636420779985, 267, 0, 267, 0, 0, 0
2053, 1, 1636420779917, 1636420780186, 269, 1, 268, 1, 0, 1
2054, 1, 1636420780074, 1636420780337, 263, 0, 263, 0, 0, 0
2055, 1, 1636420780402, 1636420780666, 264, 0, 264, 0, 0, 0
2056, 1, 1636420780577, 1636420780841, 264, 1, 263, 1, 0, 1
2057, 1, 1636420780697, 1636420780961, 264, 1, 263, 0, 0, 0
2058, 1, 1636420780925, 1636420781189, 264, 1, 263, 1, 0, 1
2059, 1, 1636420781057, 1636420781325, 268, 1, 267, 1, 0, 1
2060, 1, 1636420781441, 1636420781706, 265, 1, 264, 0, 0, 0
2061, 1, 1636420781578, 1636420781841, 263, 0, 263, 0, 0, 0
2062, 1, 1636420781693, 1636420781957, 264, 1, 263, 1, 0, 1
2063, 1, 1636420781934, 1636420782198, 264, 0, 264, 0, 0, 0
2064, 1, 1636420782078, 1636420782342, 264, 0, 264, 0, 0, 0
2065, 1, 1636420782417, 1636420782685, 268, 1, 267, 1, 0, 1
2066, 1, 1636420782590, 1636420782853, 263, 0, 263, 0, 0, 0
2067, 1, 1636420782677, 1636420782941, 264, 1, 263, 1, 0, 1
2068, 1, 1636420782933, 1636420783197, 264, 0, 264, 0, 0, 0
2069, 1, 1636420783069, 1636420783334, 265, 1, 264, 0, 0, 0
2070, 1, 1636420783377, 1636420783642, 265, 1, 264, 0, 1, 1
2071, 1, 1636420783574, 1636420783837, 263, 0, 263, 0, 0, 0
2072, 1, 1636420783702, 1636420783966, 264, 0, 264, 0, 0, 0
2073, 1, 1636420783957, 1636420784222, 265, 1, 264, 0, 0, 0
2074, 1, 1636420784054, 1636420784317, 263, 0, 263, 0, 0, 0
2075, 1, 1636420784366, 1636420784629, 263, 0, 263, 0, 0, 0
2076, 1, 1636420784546, 1636420784810, 264, 0, 264, 0, 0, 0
2077, 1, 1636420784685, 1636420784949, 264, 1, 263, 0, 0, 0
2078, 1, 1636420784977, 1636420785241, 264, 1, 263, 0, 0, 0
2079, 1, 1636420785050, 1636420785313, 263, 0, 263, 0, 0, 0
2081, 1, 1636420785689, 1636420785958, 269, 1, 268, 0, 0, 0
2082, 1, 1636420785866, 1636420786129, 263, 0, 263, 0, 0, 0
2083, 1, 1636420785993, 1636420786258, 265, 1, 264, 1, 0, 1
2085, 1, 1636420786045, 1636420786310, 265, 1, 264, 0, 1, 1
2084, 1, 1636420786093, 1636420786357, 264, 0, 264, 0, 0, 0
2090, 1, 1636420786526, 1636420786789, 263, 0, 263, 0, 0, 0
2091, 1, 1636420786710, 1636420786973, 263, 0, 263, 0, 0, 0
2092, 1, 1636420786993, 1636420787261, 268, 1, 267, 0, 0, 0
2093, 1, 1636420787017, 1636420787285, 268, 1, 267, 0, 1, 1
2094, 1, 1636420787021, 1636420787289, 268, 0, 268, 0, 0, 0
2095, 1, 1636420787541, 1636420787810, 269, 0, 269, 0, 0, 0
2096, 1, 1636420787693, 1636420787958, 265, 1, 264, 0, 1, 1
2097, 1, 1636420788005, 1636420788269, 264, 1, 263, 0, 0, 0
2098, 1, 1636420788021, 1636420788294, 273, 1, 272, 0, 1, 1
2099, 1, 1636420788021, 1636420788294, 273, 1, 272, 0, 1, 1
2100, 1, 1636420788538, 1636420788809, 271, 0, 271, 0, 0, 0
2101, 1, 1636420788682, 1636420788950, 268, 0, 268, 0, 0, 0
2102, 1, 1636420788977, 1636420789245, 268, 1, 267, 0, 1, 1
2103, 1, 1636420789010, 1636420789274, 264, 0, 264, 0, 0, 0
2104, 1, 1636420789021, 1636420789286, 265, 0, 265, 0, 0, 0
2105, 1, 1636420789530, 1636420789794, 264, 0, 264, 0, 0, 0
2106, 1, 1636420789681, 1636420789946, 265, 1, 264, 0, 0, 0
2107, 1, 1636420789945, 1636420790213, 268, 1, 267, 0, 0, 0
2108, 1, 1636420790021, 1636420790286, 265, 1, 264, 0, 0, 0
2109, 1, 1636420790046, 1636420790314, 268, 0, 268, 0, 0, 0
2110, 1, 1636420790506, 1636420790770, 264, 0, 264, 0, 0, 0
2111, 1, 1636420790914, 1636420791181, 267, 0, 267, 0, 0, 0
2112, 1, 1636420791009, 1636420791274, 265, 1, 264, 0, 0, 0
2113, 1, 1636420791026, 1636420791290, 264, 0, 264, 0, 0, 0
2114, 1, 1636420791494, 1636420791761, 267, 0, 267, 0, 0, 0
2115, 1, 1636420791910, 1636420792178, 268, 0, 268, 0, 0, 0
2116, 1, 1636420792002, 1636420792265, 263, 0, 263, 0, 0, 0
2117, 1, 1636420792057, 1636420792326, 269, 1, 268, 1, 0, 1
2118, 1, 1636420792502, 1636420792770, 268, 0, 268, 0, 0, 0
2119, 1, 1636420792886, 1636420793150, 264, 0, 264, 0, 0, 0
2120, 1, 1636420793017, 1636420793282, 265, 1, 264, 0, 1, 1
2121, 1, 1636420793054, 1636420793318, 264, 0, 264, 0, 0, 0
2122, 1, 1636420793486, 1636420793750, 264, 0, 264, 0, 0, 0
2123, 1, 1636420793862, 1636420794125, 263, 0, 263, 0, 0, 0
2124, 1, 1636420794046, 1636420794309, 263, 0, 263, 0, 0, 0
2125, 1, 1636420794062, 1636420794325, 263, 0, 263, 0, 0, 0
2126, 1, 1636420794466, 1636420794730, 264, 0, 264, 0, 0, 0
2127, 1, 1636420794822, 1636420795085, 263, 0, 263, 0, 0, 0
2129, 1, 1636420795045, 1636420795310, 265, 1, 264, 0, 0, 0
2128, 1, 1636420795045, 1636420795310, 265, 1, 264, 1, 0, 1
2130, 1, 1636420795490, 1636420795754, 264, 0, 264, 0, 0, 0
2131, 1, 1636420795661, 1636420795926, 265, 0, 265, 0, 0, 0
2134, 1, 1636420796158, 1636420796422, 264, 0, 264, 0, 0, 0
2133, 1, 1636420796158, 1636420796425, 267, 0, 267, 0, 0, 0
2135, 1, 1636420796457, 1636420796722, 265, 0, 265, 0, 0, 0
2137, 1, 1636420796577, 1636420796841, 264, 1, 263, 0, 1, 1
2136, 1, 1636420796601, 1636420796866, 265, 1, 264, 1, 0, 1
2140, 1, 1636420796866, 1636420797130, 264, 1, 263, 0, 1, 1
2141, 1, 1636420797033, 1636420797297, 264, 1, 263, 0, 0, 0
2142, 1, 1636420797045, 1636420797309, 264, 1, 263, 0, 0, 0
2139, 1, 1636420797129, 1636420797394, 265, 1, 264, 0, 0, 0
2138, 1, 1636420797393, 1636420797658, 265, 1, 264, 0, 0, 0
2143, 1, 1636420797437, 1636420797701, 264, 1, 263, 0, 1, 1
2144, 1, 1636420797514, 1636420797778, 264, 0, 264, 0, 0, 0
2145, 1, 1636420797582, 1636420797845, 263, 0, 263, 0, 0, 0
2146, 1, 1636420797777, 1636420798041, 264, 1, 263, 0, 0, 0
2147, 1, 1636420797813, 1636420798078, 265, 0, 265, 0, 0, 0
2149, 1, 1636420798057, 1636420798322, 265, 1, 264, 1, 0, 1
2150, 1, 1636420798081, 1636420798345, 264, 0, 264, 0, 0, 0
2148, 1, 1636420798077, 1636420798345, 268, 1, 267, 0, 0, 0
2151, 1, 1636420798445, 1636420798713, 268, 1, 267, 0, 0, 0
2152, 1, 1636420798474, 1636420798738, 264, 0, 264, 0, 0, 0
2153, 1, 1636420798561, 1636420798826, 265, 1, 264, 0, 0, 0
2154, 1, 1636420798737, 1636420799001, 264, 1, 263, 0, 0, 0
2155, 1, 1636420798789, 1636420799053, 264, 1, 263, 0, 1, 1
2157, 1, 1636420799045, 1636420799309, 264, 1, 263, 1, 0, 1
2156, 1, 1636420799053, 1636420799317, 264, 1, 263, 0, 0, 0
2158, 1, 1636420799061, 1636420799325, 264, 1, 263, 0, 1, 1
2159, 1, 1636420799470, 1636420799733, 263, 0, 263, 0, 0, 0
2160, 1, 1636420799494, 1636420799757, 263, 0, 263, 0, 0, 0
2161, 1, 1636420799573, 1636420799837, 264, 0, 264, 0, 0, 0
2162, 1, 1636420799757, 1636420800021, 264, 1, 263, 1, 0, 1
2163, 1, 1636420799777, 1636420800041, 264, 1, 263, 0, 1, 1
2164, 1, 1636420800049, 1636420800314, 265, 1, 264, 1, 0, 1
2166, 1, 1636420800061, 1636420800325, 264, 1, 263, 0, 1, 1
2167, 1, 1636420800482, 1636420800745, 263, 0, 263, 0, 0, 0
2168, 1, 1636420800482, 1636420800746, 264, 0, 264, 0, 0, 0
2170, 1, 1636420800613, 1636420800877, 264, 1, 263, 0, 0, 0
2169, 1, 1636420800745, 1636420801014, 269, 1, 268, 0, 0, 0
2171, 1, 1636420800773, 1636420801042, 269, 1, 268, 0, 0, 0
2172, 1, 1636420801045, 1636420801310, 265, 1, 264, 0, 0, 0
2174, 1, 1636420801469, 1636420801733, 264, 1, 263, 1, 0, 1
2175, 1, 1636420801498, 1636420801761, 263, 0, 263, 0, 0, 0
2177, 1, 1636420801590, 1636420801853, 263, 0, 263, 0, 0, 0
2176, 1, 1636420801733, 1636420802005, 272, 1, 271, 1, 0, 1
2178, 1, 1636420801797, 1636420802061, 264, 1, 263, 0, 0, 0
2179, 1, 1636420802069, 1636420802334, 265, 1, 264, 0, 1, 1
2180, 1, 1636420802501, 1636420802766, 265, 1, 264, 0, 0, 0
2181, 1, 1636420802533, 1636420802797, 264, 0, 264, 0, 0, 0
2183, 1, 1636420802598, 1636420802865, 267, 0, 267, 0, 0, 0
2182, 1, 1636420802765, 1636420803029, 264, 1, 263, 0, 0, 0
2184, 1, 1636420802801, 1636420803069, 268, 0, 268, 0, 0, 0
2185, 1, 1636420803069, 1636420803338, 269, 1, 268, 1, 0, 1
2187, 1, 1636420803530, 1636420803794, 264, 0, 264, 0, 0, 0
2186, 1, 1636420803530, 1636420803797, 267, 0, 267, 0, 0, 0
2189, 1, 1636420803613, 1636420803877, 264, 0, 264, 0, 0, 0
2188, 1, 1636420803797, 1636420804065, 268, 1, 267, 1, 0, 1
2190, 1, 1636420803809, 1636420804074, 265, 0, 265, 0, 0, 0
2191, 1, 1636420804073, 1636420804338, 265, 1, 264, 0, 0, 0
2192, 1, 1636420804521, 1636420804789, 268, 1, 267, 0, 0, 0
2193, 1, 1636420804554, 1636420804817, 263, 0, 263, 0, 0, 0
2195, 1, 1636420804613, 1636420804877, 264, 1, 263, 0, 1, 1
2194, 1, 1636420804793, 1636420805058, 265, 1, 264, 0, 0, 0
2198, 1, 1636420805490, 1636420805754, 264, 0, 264, 0, 0, 0
2200, 1, 1636420805578, 1636420805850, 272, 0, 272, 0, 0, 0
2201, 1, 1636420805589, 1636420805858, 269, 0, 269, 0, 0, 0
2199, 1, 1636420805765, 1636420806029, 264, 1, 263, 1, 0, 1
2202, 1, 1636420806122, 1636420806390, 268, 0, 268, 0, 0, 0
2203, 1, 1636420806449, 1636420806714, 265, 1, 264, 1, 0, 1
2205, 1, 1636420806613, 1636420806877, 264, 1, 263, 0, 0, 0
2206, 1, 1636420806622, 1636420806893, 271, 0, 271, 0, 0, 0
2204, 1, 1636420806717, 1636420806986, 269, 1, 268, 0, 0, 0
2207, 1, 1636420807033, 1636420807301, 268, 1, 267, 1, 0, 1
2208, 1, 1636420807421, 1636420807686, 265, 1, 264, 0, 0, 0
2210, 1, 1636420807589, 1636420807854, 265, 1, 264, 0, 0, 0
2211, 1, 1636420807589, 1636420807854, 265, 1, 264, 0, 0, 0
2209, 1, 1636420807685, 1636420807950, 265, 1, 264, 0, 0, 0
2212, 1, 1636420808042, 1636420808310, 268, 0, 268, 0, 0, 0
2214, 1, 1636420808570, 1636420808834, 264, 0, 264, 0, 0, 0
2216, 1, 1636420808606, 1636420808870, 264, 0, 264, 0, 0, 0
2217, 1, 1636420809022, 1636420809285, 263, 0, 263, 0, 0, 0
2218, 1, 1636420809545, 1636420809809, 264, 0, 264, 0, 0, 0
2219, 1, 1636420809589, 1636420809853, 264, 1, 263, 0, 0, 0
2220, 1, 1636420810081, 1636420810346, 265, 1, 264, 1, 0, 1
2222, 1, 1636420810557, 1636420810821, 264, 1, 263, 0, 1, 1
2223, 1, 1636420810625, 1636420810890, 265, 1, 264, 1, 0, 1
2224, 1, 1636420811062, 1636420811325, 263, 0, 263, 0, 0, 0
2225, 1, 1636420811409, 1636420811674, 265, 0, 265, 0, 0, 0
2226, 1, 1636420811538, 1636420811801, 263, 0, 263, 0, 0, 0
2227, 1, 1636420811657, 1636420811926, 269, 1, 268, 1, 0, 1
2228, 1, 1636420812034, 1636420812301, 267, 0, 267, 0, 0, 0
2229, 1, 1636420812333, 1636420812597, 264, 1, 263, 1, 0, 1
2230, 1, 1636420812537, 1636420812802, 265, 1, 264, 1, 0, 1
2231, 1, 1636420812629, 1636420812894, 265, 1, 264, 1, 0, 1
2232, 1, 1636420813042, 1636420813305, 263, 0, 263, 0, 0, 0
2233, 1, 1636420813373, 1636420813637, 264, 1, 263, 1, 0, 1
2234, 1, 1636420813558, 1636420813822, 264, 0, 264, 0, 0, 0
2235, 1, 1636420814077, 1636420814345, 268, 1, 267, 0, 0, 0
2236, 1, 1636420814349, 1636420814613, 264, 1, 263, 0, 0, 0
2237, 1, 1636420814538, 1636420814846, 308, 0, 308, 0, 0, 0
2238, 1, 1636420815074, 1636420815337, 263, 0, 263, 0, 0, 0
2239, 1, 1636420815337, 1636420815602, 265, 0, 265, 0, 0, 0
2241, 1, 1636420815349, 1636420815613, 264, 1, 263, 0, 0, 0
2242, 1, 1636420815561, 1636420815826, 265, 1, 264, 0, 0, 0
2240, 1, 1636420815605, 1636420815873, 268, 1, 267, 1, 0, 1
2243, 1, 1636420816061, 1636420816326, 265, 1, 264, 1, 0, 1
2244, 1, 1636420816254, 1636420816521, 267, 0, 267, 0, 0, 0
2246, 1, 1636420816317, 1636420816581, 264, 1, 263, 0, 0, 0
2245, 1, 1636420816521, 1636420816785, 264, 1, 263, 0, 0, 0
2247, 1, 1636420816573, 1636420816838, 265, 1, 264, 1, 0, 1
2248, 1, 1636420817082, 1636420817345, 263, 0, 263, 0, 0, 0
2249, 1, 1636420817233, 1636420817498, 265, 1, 264, 0, 0, 0
2251, 1, 1636420817321, 1636420817586, 265, 0, 265, 0, 0, 0
2250, 1, 1636420817501, 1636420817766, 265, 0, 265, 0, 0, 0
2252, 1, 1636420817553, 1636420817818, 265, 0, 265, 0, 0, 0
2253, 1, 1636420818078, 1636420818342, 264, 0, 264, 0, 0, 0
2254, 1, 1636420818262, 1636420818526, 264, 0, 264, 0, 0, 0
2256, 1, 1636420818313, 1636420818621, 308, 1, 307, 0, 0, 0
2255, 1, 1636420818537, 1636420818801, 264, 1, 263, 0, 1, 1
2257, 1, 1636420818621, 1636420818889, 268, 1, 267, 0, 0, 0
2258, 1, 1636420818770, 1636420819034, 264, 0, 264, 0, 0, 0
2259, 1, 1636420819041, 1636420819305, 264, 0, 264, 0, 0, 0
2260, 1, 1636420819093, 1636420819357, 264, 1, 263, 1, 0, 1
2261, 1, 1636420819281, 1636420819545, 264, 1, 263, 0, 0, 0
2263, 1, 1636420819329, 1636420819593, 264, 0, 264, 0, 0, 0
2262, 1, 1636420819554, 1636420819821, 267, 0, 267, 0, 0, 0
2264, 1, 1636420819573, 1636420819837, 264, 1, 263, 0, 0, 0
2265, 1, 1636420819657, 1636420819922, 265, 1, 264, 1, 0, 1
2266, 1, 1636420819922, 1636420820186, 264, 0, 264, 0, 0, 0
2267, 1, 1636420820086, 1636420820389, 303, 0, 303, 0, 0, 0
2268, 1, 1636420820301, 1636420820574, 273, 1, 272, 0, 0, 0
2270, 1, 1636420820317, 1636420820581, 264, 1, 263, 0, 0, 0
2271, 1, 1636420820574, 1636420820838, 264, 0, 264, 0, 0, 0
2273, 1, 1636420820641, 1636420820905, 264, 1, 263, 0, 1, 1
2272, 1, 1636420820649, 1636420820917, 268, 1, 267, 1, 0, 1
2274, 1, 1636420820905, 1636420821169, 264, 1, 263, 1, 0, 1
2275, 1, 1636420821089, 1636420821353, 264, 1, 263, 1, 0, 1
2276, 1, 1636420821286, 1636420821553, 267, 0, 267, 0, 0, 0
2277, 1, 1636420821313, 1636420821578, 265, 1, 264, 0, 0, 0
2278, 1, 1636420821557, 1636420821822, 265, 1, 264, 0, 0, 0
2279, 1, 1636420821565, 1636420821830, 265, 1, 264, 0, 0, 0
2280, 1, 1636420821625, 1636420821890, 265, 1, 264, 0, 1, 1
2281, 1, 1636420821889, 1636420822154, 265, 1, 264, 0, 0, 0
2282, 1, 1636420822125, 1636420822390, 265, 1, 264, 1, 0, 1
2283, 1, 1636420822309, 1636420822573, 264, 1, 263, 0, 0, 0
2285, 1, 1636420822569, 1636420822834, 265, 1, 264, 0, 0, 0
2286, 1, 1636420822601, 1636420822865, 264, 1, 263, 1, 0, 1
2287, 1, 1636420822637, 1636420822902, 265, 1, 264, 0, 0, 0
2288, 1, 1636420822902, 1636420823166, 264, 1, 263, 0, 0, 0
2289, 1, 1636420823098, 1636420823361, 263, 0, 263, 0, 0, 0
2290, 1, 1636420823365, 1636420823633, 268, 0, 268, 0, 0, 0
2291, 1, 1636420823542, 1636420823806, 264, 0, 264, 0, 0, 0
2292, 1, 1636420823573, 1636420823838, 265, 0, 265, 0, 0, 0
2293, 1, 1636420823613, 1636420823878, 265, 1, 264, 0, 0, 0
2294, 1, 1636420823881, 1636420824145, 264, 1, 263, 0, 0, 0
2295, 1, 1636420824329, 1636420824597, 268, 1, 267, 0, 0, 0
2297, 1, 1636420824541, 1636420824809, 268, 1, 267, 0, 1, 1
2296, 1, 1636420824541, 1636420824809, 268, 1, 267, 0, 1, 1
2298, 1, 1636420824589, 1636420824854, 265, 1, 264, 0, 0, 0
2299, 1, 1636420824857, 1636420825126, 269, 0, 269, 0, 0, 0
2301, 1, 1636420825505, 1636420825770, 265, 1, 264, 0, 0, 0
2302, 1, 1636420825513, 1636420825778, 265, 1, 264, 0, 0, 0
2303, 1, 1636420825597, 1636420825862, 265, 1, 264, 0, 1, 1
2305, 1, 1636420826486, 1636420826762, 276, 0, 276, 0, 0, 0
2307, 1, 1636420826602, 1636420826866, 264, 0, 264, 0, 0, 0
2308, 1, 1636420827473, 1636420827738, 265, 1, 264, 1, 0, 1
2310, 1, 1636420828514, 1636420828778, 264, 0, 264, 0, 0, 0
2311, 1, 1636420829482, 1636420829750, 268, 0, 268, 0, 0, 0
2312, 1, 1636420830457, 1636420830758, 301, 1, 300, 0, 1, 1
2300, 1, 1636420830673, 1636420830937, 264, 1, 263, 0, 0, 0
2313, 1, 1636420830981, 1636420831249, 268, 1, 267, 0, 1, 1
2314, 1, 1636420831338, 1636420831601, 263, 0, 263, 0, 0, 0
2315, 1, 1636420831425, 1636420831690, 265, 0, 265, 0, 0, 0
2316, 1, 1636420831870, 1636420832138, 268, 0, 268, 0, 0, 0
2317, 1, 1636420832302, 1636420832570, 268, 0, 268, 0, 0, 0
2319, 1, 1636420832621, 1636420832886, 265, 1, 264, 1, 0, 1
2321, 1, 1636420833282, 1636420833550, 268, 0, 268, 0, 0, 0
2322, 1, 1636420833554, 1636420833818, 264, 0, 264, 0, 0, 0
2323, 1, 1636420834281, 1636420834549, 268, 1, 267, 0, 0, 0
2324, 1, 1636420834570, 1636420834838, 268, 0, 268, 0, 0, 0
2325, 1, 1636420835265, 1636420835530, 265, 1, 264, 0, 0, 0
2326, 1, 1636420835558, 1636420835830, 272, 0, 272, 0, 0, 0
2304, 2, 1636420825862, 1636420835958, 10096, 0, 10096, 0, 0, 0
2327, 1, 1636420836273, 1636420836541, 268, 1, 267, 0, 0, 0
2329, 1, 1636420836545, 1636420836810, 265, 1, 264, 0, 0, 0
2330, 1, 1636420836810, 1636420837074, 264, 0, 264, 0, 0, 0
2331, 1, 1636420837246, 1636420837510, 264, 0, 264, 0, 0, 0
2332, 1, 1636420837541, 1636420837809, 268, 1, 267, 0, 0, 0
2333, 1, 1636420837718, 1636420837982, 264, 0, 264, 0, 0, 0
2335, 1, 1636420838254, 1636420838517, 263, 0, 263, 0, 0, 0
2336, 1, 1636420838549, 1636420838817, 268, 0, 268, 0, 0, 0
2337, 1, 1636420838729, 1636420838994, 265, 0, 265, 0, 0, 0
2338, 1, 1636420839261, 1636420839530, 269, 1, 268, 1, 0, 1
2339, 1, 1636420839517, 1636420839782, 265, 1, 264, 0, 0, 0
2340, 1, 1636420839701, 1636420839970, 269, 1, 268, 0, 0, 0
2341, 1, 1636420840254, 1636420840522, 268, 0, 268, 0, 0, 0
2342, 1, 1636420840550, 1636420840814, 264, 0, 264, 0, 0, 0
2343, 1, 1636420840714, 1636420840978, 264, 0, 264, 0, 0, 0
2344, 1, 1636420841257, 1636420841521, 264, 1, 263, 0, 0, 0
2345, 1, 1636420841541, 1636420841806, 265, 0, 265, 0, 0, 0
2346, 1, 1636420841746, 1636420842013, 267, 0, 267, 0, 0, 0
2347, 1, 1636420842317, 1636420842581, 264, 1, 263, 0, 1, 1
2348, 1, 1636420842550, 1636420842813, 263, 0, 263, 0, 0, 0
2350, 1, 1636420842745, 1636420843065, 320, 1, 319, 0, 0, 0
2349, 1, 1636420842757, 1636420843069, 312, 1, 311, 0, 0, 0
2328, 1, 1636420842981, 1636420843245, 264, 1, 263, 1, 0, 1
2352, 1, 1636420843261, 1636420843525, 264, 1, 263, 1, 0, 1
2351, 1, 1636420843289, 1636420843558, 269, 1, 268, 0, 1, 1
2353, 1, 1636420843569, 1636420843834, 265, 1, 264, 0, 0, 0
2355, 1, 1636420843657, 1636420843921, 264, 1, 263, 1, 0, 1
2354, 1, 1636420843681, 1636420843945, 264, 1, 263, 1, 0, 1
2356, 1, 1636420843761, 1636420844029, 268, 1, 267, 1, 0, 1
2357, 1, 1636420844193, 1636420844461, 268, 0, 268, 0, 0, 0
2358, 1, 1636420844273, 1636420844537, 264, 1, 263, 0, 0, 0
2359, 1, 1636420844577, 1636420844850, 273, 1, 272, 0, 1, 1
2360, 1, 1636420844649, 1636420844914, 265, 1, 264, 0, 0, 0
2361, 1, 1636420844693, 1636420844957, 264, 1, 263, 0, 0, 0
2362, 1, 1636420844781, 1636420845046, 265, 1, 264, 1, 0, 1
2363, 1, 1636420845170, 1636420845434, 264, 0, 264, 0, 0, 0
2364, 1, 1636420845250, 1636420845517, 267, 0, 267, 0, 0, 0
2365, 1, 1636420845597, 1636420845862, 265, 0, 265, 0, 0, 0
2366, 1, 1636420845641, 1636420845906, 265, 1, 264, 0, 0, 0
2367, 1, 1636420845665, 1636420845938, 273, 1, 272, 0, 0, 0
2368, 1, 1636420845782, 1636420846049, 267, 0, 267, 0, 0, 0
2369, 1, 1636420846158, 1636420846425, 267, 0, 267, 0, 0, 0
2370, 1, 1636420846209, 1636420846477, 268, 1, 267, 1, 0, 1
2371, 1, 1636420846565, 1636420846830, 265, 1, 264, 0, 0, 0
2372, 1, 1636420846670, 1636420846934, 264, 0, 264, 0, 0, 0
2373, 1, 1636420846670, 1636420846934, 264, 0, 264, 0, 0, 0
2374, 1, 1636420846761, 1636420847026, 265, 0, 265, 0, 0, 0
2375, 1, 1636420847173, 1636420847437, 264, 1, 263, 0, 0, 0
2376, 1, 1636420847202, 1636420847465, 263, 0, 263, 0, 0, 0
2378, 1, 1636420847661, 1636420847933, 272, 1, 271, 1, 0, 1
2379, 1, 1636420847665, 1636420847934, 269, 1, 268, 0, 0, 0
2380, 1, 1636420847758, 1636420848022, 264, 0, 264, 0, 0, 0
2382, 1, 1636420848157, 1636420848422, 265, 1, 264, 1, 0, 1
2381, 1, 1636420848198, 1636420848461, 263, 0, 263, 0, 0, 0
2383, 1, 1636420848201, 1636420848465, 264, 1, 263, 1, 0, 1
2385, 1, 1636420848661, 1636420848925, 264, 1, 263, 0, 0, 0
2384, 1, 1636420848661, 1636420848925, 264, 1, 263, 1, 0, 1
2386, 1, 1636420848741, 1636420849005, 264, 0, 264, 0, 0, 0
2387, 1, 1636420849117, 1636420849386, 269, 1, 268, 0, 0, 0
2389, 1, 1636420849181, 1636420849445, 264, 1, 263, 0, 0, 0
2390, 1, 1636420849657, 1636420849921, 264, 0, 264, 0, 0, 0
2391, 1, 1636420849673, 1636420849938, 265, 0, 265, 0, 0, 0
2392, 1, 1636420849766, 1636420850030, 264, 0, 264, 0, 0, 0
2393, 1, 1636420850110, 1636420850374, 264, 0, 264, 0, 0, 0
2394, 1, 1636420850161, 1636420850425, 264, 1, 263, 0, 0, 0
2395, 1, 1636420850673, 1636420850938, 265, 1, 264, 0, 0, 0
2396, 1, 1636420850702, 1636420850965, 263, 0, 263, 0, 0, 0
2397, 1, 1636420850746, 1636420851009, 263, 0, 263, 0, 0, 0
2398, 1, 1636420851102, 1636420851366, 264, 0, 264, 0, 0, 0
2399, 1, 1636420851134, 1636420851398, 264, 0, 264, 0, 0, 0
2400, 1, 1636420851673, 1636420851937, 264, 1, 263, 0, 0, 0
2401, 1, 1636420851697, 1636420851961, 264, 1, 263, 0, 0, 0
2402, 1, 1636420851781, 1636420852046, 265, 1, 264, 1, 0, 1
2403, 1, 1636420852094, 1636420852358, 264, 0, 264, 0, 0, 0
2404, 1, 1636420852141, 1636420852405, 264, 1, 263, 0, 1, 1
2405, 1, 1636420852657, 1636420852921, 264, 1, 263, 1, 0, 1
2406, 1, 1636420852674, 1636420852945, 271, 0, 271, 0, 0, 0
2407, 1, 1636420853098, 1636420853366, 268, 0, 268, 0, 0, 0
2408, 1, 1636420853154, 1636420853417, 263, 0, 263, 0, 0, 0
2410, 1, 1636420853686, 1636420853950, 264, 0, 264, 0, 0, 0
2411, 1, 1636420854102, 1636420854370, 268, 0, 268, 0, 0, 0
2412, 1, 1636420854170, 1636420854441, 271, 0, 271, 0, 0, 0
2413, 1, 1636420854677, 1636420854941, 264, 1, 263, 0, 0, 0
2414, 1, 1636420855066, 1636420855334, 268, 0, 268, 0, 0, 0
2415, 1, 1636420855150, 1636420855413, 263, 0, 263, 0, 0, 0
2416, 1, 1636420855698, 1636420855961, 263, 0, 263, 0, 0, 0
2417, 1, 1636420856034, 1636420856298, 264, 0, 264, 0, 0, 0
2419, 1, 1636420856685, 1636420856950, 265, 1, 264, 1, 0, 1
2420, 1, 1636420856997, 1636420857266, 269, 1, 268, 0, 1, 1
2421, 1, 1636420857698, 1636420857962, 264, 0, 264, 0, 0, 0
2422, 1, 1636420857853, 1636420858118, 265, 1, 264, 0, 1, 1
2424, 1, 1636420858766, 1636420859034, 268, 0, 268, 0, 0, 0
2426, 1, 1636420859762, 1636420860029, 267, 0, 267, 0, 0, 0
2427, 1, 1636420860742, 1636420861010, 268, 0, 268, 0, 0, 0
2428, 1, 1636420861750, 1636420862014, 264, 0, 264, 0, 0, 0
2429, 1, 1636420862734, 1636420863001, 267, 0, 267, 0, 0, 0
2430, 1, 1636420863745, 1636420864013, 268, 1, 267, 1, 0, 1
2431, 1, 1636420863970, 1636420864233, 263, 0, 263, 0, 0, 0
2432, 1, 1636420864750, 1636420865013, 263, 0, 263, 0, 0, 0
2433, 1, 1636420864878, 1636420865142, 264, 0, 264, 0, 0, 0
2434, 1, 1636420865742, 1636420866009, 267, 0, 267, 0, 0, 0
2435, 1, 1636420865858, 1636420866170, 312, 0, 312, 0, 0, 0
2436, 1, 1636420866437, 1636420866706, 269, 1, 268, 0, 1, 1
2437, 1, 1636420866757, 1636420867021, 264, 1, 263, 0, 0, 0
2438, 1, 1636420866849, 1636420867113, 264, 1, 263, 1, 0, 1
2439, 1, 1636420867338, 1636420867605, 267, 0, 267, 0, 0, 0
2440, 1, 1636420867766, 1636420868030, 264, 0, 264, 0, 0, 0
2441, 1, 1636420867858, 1636420868122, 264, 0, 264, 0, 0, 0
2442, 1, 1636420868297, 1636420868561, 264, 1, 263, 1, 0, 1
2443, 1, 1636420868314, 1636420868577, 263, 0, 263, 0, 0, 0
2444, 1, 1636420868770, 1636420869034, 264, 0, 264, 0, 0, 0
2445, 1, 1636420868837, 1636420869105, 268, 1, 267, 1, 0, 1
2446, 1, 1636420869205, 1636420869501, 296, 1, 295, 1, 0, 1
2447, 1, 1636420869325, 1636420869589, 264, 1, 263, 1, 0, 1
2448, 1, 1636420869770, 1636420870037, 267, 0, 267, 0, 0, 0
2449, 1, 1636420869777, 1636420870041, 264, 1, 263, 0, 0, 0
2450, 1, 1636420869845, 1636420870113, 268, 0, 268, 0, 0, 0
2451, 1, 1636420870205, 1636420870473, 268, 1, 267, 0, 1, 1
2452, 1, 1636420870293, 1636420870558, 265, 1, 264, 0, 0, 0
2453, 1, 1636420870705, 1636420870970, 265, 1, 264, 0, 1, 1
2454, 1, 1636420870749, 1636420871013, 264, 1, 263, 0, 0, 0
2455, 1, 1636420870853, 1636420871122, 269, 1, 268, 1, 0, 1
2456, 1, 1636420871177, 1636420871442, 265, 1, 264, 0, 0, 0
2457, 1, 1636420871266, 1636420871533, 267, 0, 267, 0, 0, 0
2458, 1, 1636420871690, 1636420871953, 263, 0, 263, 0, 0, 0
2459, 1, 1636420871741, 1636420872006, 265, 1, 264, 0, 1, 1
2460, 1, 1636420871833, 1636420872097, 264, 1, 263, 0, 0, 0
2461, 1, 1636420872210, 1636420872473, 263, 0, 263, 0, 0, 0
2462, 1, 1636420872269, 1636420872534, 265, 1, 264, 0, 0, 0
2463, 1, 1636420872686, 1636420872950, 264, 0, 264, 0, 0, 0
2464, 1, 1636420872733, 1636420872997, 264, 1, 263, 1, 0, 1
2465, 1, 1636420872853, 1636420873117, 264, 1, 263, 1, 0, 1
2466, 1, 1636420873217, 1636420873482, 265, 1, 264, 0, 1, 1
2467, 1, 1636420873289, 1636420873553, 264, 1, 263, 0, 0, 0
2468, 1, 1636420873689, 1636420873954, 265, 0, 265, 0, 0, 0
2469, 1, 1636420873733, 1636420873997, 264, 0, 264, 0, 0, 0
2470, 1, 1636420873869, 1636420874134, 265, 1, 264, 1, 0, 1
2471, 1, 1636420874181, 1636420874450, 269, 1, 268, 0, 0, 0
2472, 1, 1636420874278, 1636420874546, 268, 0, 268, 0, 0, 0
2473, 1, 1636420874697, 1636420874961, 264, 1, 263, 1, 0, 1
2474, 1, 1636420874710, 1636420874978, 268, 0, 268, 0, 0, 0
2475, 1, 1636420874870, 1636420875134, 264, 0, 264, 0, 0, 0
2476, 1, 1636420875185, 1636420875458, 273, 1, 272, 1, 0, 1
2477, 1, 1636420875286, 1636420875554, 268, 0, 268, 0, 0, 0
2478, 1, 1636420875690, 1636420875954, 264, 0, 264, 0, 0, 0
2479, 1, 1636420875717, 1636420875982, 265, 1, 264, 1, 0, 1
2480, 1, 1636420875870, 1636420876134, 264, 0, 264, 0, 0, 0
2481, 1, 1636420876222, 1636420876489, 267, 0, 267, 0, 0, 0
2482, 1, 1636420876298, 1636420876566, 268, 0, 268, 0, 0, 0
2483, 1, 1636420876658, 1636420876921, 263, 0, 263, 0, 0, 0
2484, 1, 1636420876681, 1636420876946, 265, 1, 264, 0, 0, 0
2485, 1, 1636420876846, 1636420877114, 268, 0, 268, 0, 0, 0
2486, 1, 1636420877221, 1636420877486, 265, 1, 264, 0, 1, 1
2487, 1, 1636420877294, 1636420877558, 264, 0, 264, 0, 0, 0
2488, 1, 1636420877641, 1636420877906, 265, 0, 265, 0, 0, 0
2490, 1, 1636420877837, 1636420878105, 268, 1, 267, 0, 0, 0
2491, 1, 1636420878205, 1636420878473, 268, 1, 267, 0, 0, 0
2492, 1, 1636420878325, 1636420878593, 268, 0, 268, 0, 0, 0
2493, 1, 1636420878609, 1636420878873, 264, 1, 263, 0, 0, 0
2494, 1, 1636420878829, 1636420879102, 273, 1, 272, 0, 0, 0
2495, 1, 1636420879234, 1636420879502, 268, 0, 268, 0, 0, 0
2496, 1, 1636420879301, 1636420879570, 269, 1, 268, 0, 0, 0
2497, 1, 1636420879605, 1636420879869, 264, 1, 263, 0, 0, 0
2498, 1, 1636420879806, 1636420880070, 264, 0, 264, 0, 0, 0
2499, 1, 1636420880226, 1636420880490, 264, 0, 264, 0, 0, 0
2500, 1, 1636420880289, 1636420880554, 265, 1, 264, 0, 1, 1
2501, 1, 1636420880577, 1636420880841, 264, 1, 263, 0, 0, 0
2502, 1, 1636420880773, 1636420881038, 265, 0, 265, 0, 0, 0
2503, 1, 1636420881246, 1636420881513, 267, 0, 267, 0, 0, 0
2504, 1, 1636420881282, 1636420881550, 268, 0, 268, 0, 0, 0
2505, 1, 1636420881550, 1636420881814, 264, 0, 264, 0, 0, 0
2506, 1, 1636420881778, 1636420882042, 264, 0, 264, 0, 0, 0
2507, 1, 1636420882253, 1636420882518, 265, 1, 264, 0, 0, 0
2508, 1, 1636420882518, 1636420882782, 264, 0, 264, 0, 0, 0
2509, 1, 1636420882745, 1636420883010, 265, 1, 264, 0, 0, 0
2510, 1, 1636420883237, 1636420883502, 265, 0, 265, 0, 0, 0
2512, 1, 1636420883721, 1636420883989, 268, 1, 267, 1, 0, 1
2513, 1, 1636420884218, 1636420884486, 268, 0, 268, 0, 0, 0
2514, 1, 1636420884693, 1636420884958, 265, 1, 264, 1, 0, 1
2515, 1, 1636420885190, 1636420885454, 264, 0, 264, 0, 0, 0
2516, 1, 1636420885721, 1636420885990, 269, 1, 268, 0, 0, 0
2517, 1, 1636420886154, 1636420886418, 264, 0, 264, 0, 0, 0
2518, 1, 1636420886693, 1636420886962, 269, 1, 268, 1, 0, 1
2519, 1, 1636420887113, 1636420887378, 265, 1, 264, 0, 0, 0
2520, 1, 1636420887701, 1636420887966, 265, 0, 265, 0, 0, 0
2521, 1, 1636420887966, 1636420888229, 263, 0, 263, 0, 0, 0
2522, 1, 1636420888145, 1636420888410, 265, 1, 264, 1, 0, 1
2523, 1, 1636420888637, 1636420888901, 264, 0, 264, 0, 0, 0
2524, 1, 1636420888873, 1636420889138, 265, 1, 264, 0, 1, 1
2525, 1, 1636420889145, 1636420889410, 265, 1, 264, 0, 0, 0
2527, 1, 1636420889845, 1636420890109, 264, 1, 263, 0, 0, 0
2528, 1, 1636420890137, 1636420890401, 264, 1, 263, 0, 1, 1
2529, 1, 1636420890809, 1636420891074, 265, 1, 264, 0, 0, 0
2530, 1, 1636420891121, 1636420891386, 265, 1, 264, 0, 0, 0
2531, 1, 1636420891842, 1636420892106, 264, 0, 264, 0, 0, 0
2533, 1, 1636420892838, 1636420893101, 263, 0, 263, 0, 0, 0
2534, 1, 1636420893809, 1636420894073, 264, 1, 263, 0, 1, 1
2535, 1, 1636420893837, 1636420894101, 264, 1, 263, 1, 0, 1
2536, 1, 1636420894721, 1636420894985, 264, 1, 263, 1, 0, 1
2537, 1, 1636420894849, 1636420895114, 265, 1, 264, 0, 0, 0
2538, 1, 1636420895753, 1636420896022, 269, 1, 268, 1, 0, 1
2539, 1, 1636420895846, 1636420896110, 264, 0, 264, 0, 0, 0
2540, 1, 1636420896726, 1636420896997, 271, 0, 271, 0, 0, 0
2541, 1, 1636420896850, 1636420897114, 264, 0, 264, 0, 0, 0
2542, 1, 1636420897725, 1636420897993, 268, 0, 268, 0, 0, 0
2543, 1, 1636420897861, 1636420898130, 269, 1, 268, 0, 1, 1
2544, 1, 1636420898730, 1636420898997, 267, 0, 267, 0, 0, 0
2545, 1, 1636420899001, 1636420899266, 265, 0, 265, 0, 0, 0
2546, 1, 1636420899729, 1636420899997, 268, 0, 268, 0, 0, 0
2547, 1, 1636420899882, 1636420900146, 264, 0, 264, 0, 0, 0
2548, 1, 1636420899938, 1636420900202, 264, 0, 264, 0, 0, 0
2549, 1, 1636420900721, 1636420900986, 265, 1, 264, 0, 1, 1
2550, 1, 1636420900838, 1636420901106, 268, 0, 268, 0, 0, 0
2551, 1, 1636420900845, 1636420901113, 268, 1, 267, 0, 0, 0
2552, 1, 1636420901761, 1636420902030, 269, 0, 269, 0, 0, 0
2553, 1, 1636420901842, 1636420902154, 312, 0, 312, 0, 0, 0
2554, 1, 1636420901865, 1636420902154, 289, 1, 288, 1, 0, 1
2555, 1, 1636420902417, 1636420902682, 265, 1, 264, 0, 0, 0
2556, 1, 1636420902733, 1636420903001, 268, 1, 267, 0, 1, 1
2557, 1, 1636420902813, 1636420903077, 264, 1, 263, 0, 0, 0
2558, 1, 1636420902865, 1636420903130, 265, 1, 264, 0, 0, 0
2559, 1, 1636420903329, 1636420903598, 269, 1, 268, 0, 0, 0
2560, 1, 1636420903713, 1636420903977, 264, 1, 263, 0, 0, 0
2561, 1, 1636420903777, 1636420904042, 265, 0, 265, 0, 0, 0
2562, 1, 1636420903882, 1636420904146, 264, 0, 264, 0, 0, 0
2563, 1, 1636420904346, 1636420904614, 268, 0, 268, 0, 0, 0
2564, 1, 1636420904726, 1636420904989, 263, 0, 263, 0, 0, 0
2565, 1, 1636420904758, 1636420905026, 268, 0, 268, 0, 0, 0
2566, 1, 1636420904886, 1636420905149, 263, 0, 263, 0, 0, 0
2567, 1, 1636420905326, 1636420905593, 267, 0, 267, 0, 0, 0
2568, 1, 1636420905753, 1636420906018, 265, 1, 264, 1, 0, 1
2569, 1, 1636420905858, 1636420906121, 263, 0, 263, 0, 0, 0
2570, 1, 1636420906321, 1636420906590, 269, 1, 268, 0, 1, 1
2571, 1, 1636420906725, 1636420906997, 272, 1, 271, 0, 1, 1
2572, 1, 1636420906865, 1636420907129, 264, 1, 263, 1, 0, 1
2573, 1, 1636420907329, 1636420907598, 269, 1, 268, 0, 0, 0
2574, 1, 1636420907714, 1636420907978, 264, 0, 264, 0, 0, 0
2575, 1, 1636420907898, 1636420908166, 268, 0, 268, 0, 0, 0
2576, 1, 1636420908297, 1636420908561, 264, 1, 263, 1, 0, 1
2577, 1, 1636420908678, 1636420908942, 264, 0, 264, 0, 0, 0
2578, 1, 1636420908898, 1636420909165, 267, 0, 267, 0, 0, 0
2579, 1, 1636420909306, 1636420909570, 264, 0, 264, 0, 0, 0
2580, 1, 1636420909710, 1636420909974, 264, 0, 264, 0, 0, 0
2581, 1, 1636420909885, 1636420910149, 264, 1, 263, 1, 0, 1
2582, 1, 1636420910342, 1636420910606, 264, 0, 264, 0, 0, 0
2583, 1, 1636420910686, 1636420910950, 264, 0, 264, 0, 0, 0
2584, 1, 1636420910909, 1636420911174, 265, 1, 264, 0, 0, 0
2585, 1, 1636420911337, 1636420911606, 269, 1, 268, 0, 0, 0
2586, 1, 1636420911654, 1636420911918, 264, 0, 264, 0, 0, 0
2587, 1, 1636420912321, 1636420912585, 264, 1, 263, 1, 0, 1
2588, 1, 1636420912622, 1636420912890, 268, 0, 268, 0, 0, 0
2589, 1, 1636420913350, 1636420913614, 264, 0, 264, 0, 0, 0
2591, 1, 1636420923922, 1636420924190, 268, 0, 268, 0, 0, 0
2592, 1, 1636420924834, 1636420925098, 264, 0, 264, 0, 0, 0
2593, 1, 1636420925842, 1636420926106, 264, 0, 264, 0, 0, 0
2594, 1, 1636420926818, 1636420927082, 264, 0, 264, 0, 0, 0
2595, 1, 1636420927834, 1636420928102, 268, 0, 268, 0, 0, 0
2596, 1, 1636420928837, 1636420929102, 265, 1, 264, 0, 0, 0
2597, 1, 1636420929809, 1636420930078, 269, 0, 269, 0, 0, 0
2598, 1, 1636420930818, 1636420931082, 264, 0, 264, 0, 0, 0
2599, 1, 1636420931853, 1636420932122, 269, 1, 268, 0, 1, 1
2600, 1, 1636420932853, 1636420933118, 265, 1, 264, 0, 1, 1
2601, 1, 1636421195630, 1636421195893, 263, 0, 263, 0, 0, 0
2602, 1, 1636421196294, 1636421196558, 264, 0, 264, 0, 0, 0
2603, 1, 1636421196474, 1636421196738, 264, 0, 264, 0, 0, 0
2604, 1, 1636421196962, 1636421197226, 264, 0, 264, 0, 0, 0
2605, 1, 1636421197142, 1636421197406, 264, 0, 264, 0, 0, 0
2606, 1, 1636421197189, 1636421197453, 264, 0, 264, 0, 0, 0
2607, 1, 1636421197629, 1636421197894, 265, 1, 264, 0, 0, 0
2609, 1, 1636421197809, 1636421198073, 264, 1, 263, 0, 0, 0
2608, 1, 1636421197809, 1636421198077, 268, 1, 267, 0, 0, 0
2610, 1, 1636421197850, 1636421198114, 264, 0, 264, 0, 0, 0
2611, 1, 1636421198298, 1636421198565, 267, 0, 267, 0, 0, 0
2613, 1, 1636421198437, 1636421198702, 265, 0, 265, 0, 0, 0
2612, 1, 1636421198477, 1636421198741, 264, 0, 264, 0, 0, 0
2614, 1, 1636421198485, 1636421198749, 264, 1, 263, 0, 0, 0
2615, 1, 1636421198510, 1636421198778, 268, 0, 268, 0, 0, 0
2616, 1, 1636421198970, 1636421199234, 264, 0, 264, 0, 0, 0
2617, 1, 1636421198990, 1636421199257, 267, 0, 267, 0, 0, 0
2618, 1, 1636421199106, 1636421199370, 264, 0, 264, 0, 0, 0
2619, 1, 1636421199146, 1636421199409, 263, 0, 263, 0, 0, 0
2620, 1, 1636421199149, 1636421199413, 264, 1, 263, 0, 1, 1
2621, 1, 1636421199182, 1636421199449, 267, 0, 267, 0, 0, 0
2623, 1, 1636421199633, 1636421199898, 265, 0, 265, 0, 0, 0
2622, 1, 1636421199641, 1636421199905, 264, 1, 263, 1, 0, 1
2624, 1, 1636421199677, 1636421199942, 265, 1, 264, 0, 0, 0
2625, 1, 1636421199769, 1636421200037, 268, 0, 268, 0, 0, 0
2627, 1, 1636421199813, 1636421200077, 264, 1, 263, 0, 0, 0
2626, 1, 1636421199813, 1636421200077, 264, 1, 263, 1, 0, 1
2628, 1, 1636421199853, 1636421200118, 265, 1, 264, 1, 0, 1
2631, 1, 1636421200289, 1636421200557, 268, 1, 267, 0, 0, 0
2629, 1, 1636421200301, 1636421200565, 264, 0, 264, 0, 0, 0
2630, 1, 1636421200313, 1636421200581, 268, 0, 268, 0, 0, 0
2632, 1, 1636421200345, 1636421200609, 264, 0, 264, 0, 0, 0
2633, 1, 1636421200433, 1636421200702, 269, 0, 269, 0, 0, 0
2634, 1, 1636421200477, 1636421200742, 265, 1, 264, 0, 1, 1
2635, 1, 1636421200477, 1636421200742, 265, 1, 264, 0, 0, 0
2636, 1, 1636421200513, 1636421200781, 268, 0, 268, 0, 0, 0
2637, 1, 1636421200861, 1636421201125, 264, 1, 263, 0, 0, 0
2639, 1, 1636421200969, 1636421201233, 264, 0, 264, 0, 0, 0
2638, 1, 1636421200969, 1636421201241, 272, 0, 272, 0, 0, 0
2641, 1, 1636421201009, 1636421201274, 265, 1, 264, 0, 1, 1
2642, 1, 1636421201101, 1636421201365, 264, 1, 263, 1, 0, 1
2640, 1, 1636421201129, 1636421201397, 268, 1, 267, 1, 0, 1
2644, 1, 1636421201153, 1636421201417, 264, 1, 263, 1, 0, 1
2643, 1, 1636421201153, 1636421201417, 264, 1, 263, 1, 0, 1
2645, 1, 1636421201181, 1636421201457, 276, 0, 276, 0, 0, 0
2646, 1, 1636421201405, 1636421201669, 264, 1, 263, 1, 0, 1
2647, 1, 1636421201529, 1636421201794, 265, 1, 264, 0, 0, 0
2648, 1, 1636421201637, 1636421201902, 265, 1, 264, 0, 0, 0
2649, 1, 1636421201637, 1636421201905, 268, 1, 267, 0, 1, 1
2650, 1, 1636421201681, 1636421201945, 264, 1, 263, 0, 0, 0
2651, 1, 1636421201770, 1636421202034, 264, 0, 264, 0, 0, 0
2652, 1, 1636421201793, 1636421202058, 265, 1, 264, 0, 0, 0
2653, 1, 1636421201821, 1636421202085, 264, 1, 263, 1, 0, 1
2654, 1, 1636421201821, 1636421202085, 264, 1, 263, 0, 0, 0
2655, 1, 1636421201861, 1636421202125, 264, 1, 263, 0, 0, 0
2656, 1, 1636421202069, 1636421202333, 264, 1, 263, 0, 0, 0
2657, 1, 1636421202205, 1636421202469, 264, 1, 263, 0, 1, 1
2658, 1, 1636421202305, 1636421202570, 265, 1, 264, 1, 0, 1
2659, 1, 1636421202305, 1636421202570, 265, 1, 264, 1, 0, 1
2660, 1, 1636421202349, 1636421202614, 265, 0, 265, 0, 0, 0
2661, 1, 1636421202429, 1636421202698, 269, 1, 268, 0, 0, 0
2662, 1, 1636421202457, 1636421202725, 268, 0, 268, 0, 0, 0
2663, 1, 1636421202485, 1636421202749, 264, 1, 263, 1, 0, 1
2664, 1, 1636421202485, 1636421202749, 264, 1, 263, 1, 0, 1
2665, 1, 1636421202525, 1636421202789, 264, 0, 264, 0, 0, 0
2666, 1, 1636421202737, 1636421203001, 264, 1, 263, 1, 0, 1
2667, 1, 1636421202873, 1636421203138, 265, 0, 265, 0, 0, 0
2669, 1, 1636421202965, 1636421203230, 265, 0, 265, 0, 0, 0
2668, 1, 1636421202965, 1636421203230, 265, 0, 265, 0, 0, 0
2670, 1, 1636421203013, 1636421203277, 264, 0, 264, 0, 0, 0
2671, 1, 1636421203097, 1636421203365, 268, 0, 268, 0, 0, 0
2672, 1, 1636421203129, 1636421203394, 265, 1, 264, 0, 0, 0
2674, 1, 1636421203145, 1636421203413, 268, 0, 268, 0, 0, 0
2673, 1, 1636421203157, 1636421203421, 264, 1, 263, 0, 0, 0
2675, 1, 1636421203193, 1636421203458, 265, 0, 265, 0, 0, 0
2677, 1, 1636421203409, 1636421203673, 264, 1, 263, 1, 0, 1
2676, 1, 1636421203413, 1636421203677, 264, 1, 263, 1, 0, 1
2678, 1, 1636421203541, 1636421203809, 268, 1, 267, 1, 0, 1
2680, 1, 1636421203633, 1636421203897, 264, 1, 263, 0, 0, 0
2679, 1, 1636421203633, 1636421203897, 264, 1, 263, 0, 0, 0
2681, 1, 1636421203685, 1636421203949, 264, 0, 264, 0, 0, 0
2682, 1, 1636421203761, 1636421204025, 264, 1, 263, 1, 0, 1
2683, 1, 1636421203802, 1636421204065, 263, 0, 263, 0, 0, 0
2684, 1, 1636421203813, 1636421204081, 268, 0, 268, 0, 0, 0
2685, 1, 1636421203833, 1636421204105, 272, 1, 271, 1, 0, 1
2686, 1, 1636421203857, 1636421204125, 268, 0, 268, 0, 0, 0
2687, 1, 1636421204073, 1636421204338, 265, 1, 264, 0, 0, 0
2688, 1, 1636421204081, 1636421204346, 265, 1, 264, 1, 0, 1
2689, 1, 1636421204205, 1636421204470, 265, 1, 264, 0, 0, 0
2692, 1, 1636421204273, 1636421204545, 272, 1, 271, 0, 0, 0
2690, 1, 1636421204297, 1636421204565, 268, 1, 267, 0, 1, 1
2691, 1, 1636421204297, 1636421204566, 269, 1, 268, 1, 0, 1
2694, 1, 1636421204425, 1636421204689, 264, 1, 263, 1, 0, 1
2696, 1, 1636421204489, 1636421204761, 272, 1, 271, 1, 0, 1
2697, 1, 1636421204505, 1636421204769, 264, 0, 264, 0, 0, 0
2698, 1, 1636421204525, 1636421204794, 269, 0, 269, 0, 0, 0
2693, 1, 1636421204545, 1636421204813, 268, 1, 267, 1, 0, 1
2700, 1, 1636421204741, 1636421205005, 264, 1, 263, 0, 0, 0
2701, 1, 1636421204749, 1636421205013, 264, 1, 263, 0, 0, 0
2702, 1, 1636421204877, 1636421205145, 268, 1, 267, 0, 1, 1
2703, 1, 1636421204957, 1636421205221, 264, 0, 264, 0, 0, 0
2705, 1, 1636421204965, 1636421205237, 272, 1, 271, 0, 0, 0
2706, 1, 1636421205089, 1636421205354, 265, 1, 264, 1, 0, 1
2708, 1, 1636421205173, 1636421205442, 269, 1, 268, 0, 0, 0
2711, 1, 1636421205225, 1636421205489, 264, 1, 263, 0, 0, 0
2710, 1, 1636421205229, 1636421205497, 268, 1, 267, 0, 0, 0
2712, 1, 1636421205409, 1636421205677, 268, 1, 267, 1, 0, 1
2713, 1, 1636421205417, 1636421205685, 268, 1, 267, 0, 0, 0
2714, 1, 1636421205553, 1636421205818, 265, 1, 264, 0, 1, 1
2715, 1, 1636421205634, 1636421205897, 263, 0, 263, 0, 0, 0
2718, 1, 1636421205757, 1636421206026, 269, 0, 269, 0, 0, 0
2719, 1, 1636421205841, 1636421206105, 264, 1, 263, 1, 0, 1
2720, 1, 1636421205894, 1636421206157, 263, 0, 263, 0, 0, 0
2722, 1, 1636421206073, 1636421206345, 272, 1, 271, 0, 0, 0
2723, 1, 1636421206089, 1636421206353, 264, 1, 263, 1, 0, 1
2725, 1, 1636421206305, 1636421206569, 264, 0, 264, 0, 0, 0
2727, 1, 1636421206425, 1636421206690, 265, 1, 264, 0, 0, 0
2729, 1, 1636421206557, 1636421206822, 265, 1, 264, 0, 0, 0
2731, 1, 1636421206762, 1636421207029, 267, 0, 267, 0, 0, 0
2733, 1, 1636421206974, 1636421207238, 264, 0, 264, 0, 0, 0
2735, 1, 1636421207238, 1636421207502, 264, 0, 264, 0, 0, 0
2736, 1, 1636421207438, 1636421207706, 268, 0, 268, 0, 0, 0
2738, 1, 1636421207642, 1636421207906, 264, 0, 264, 0, 0, 0
2741, 1, 1636421208109, 1636421208374, 265, 1, 264, 0, 1, 1
2742, 1, 1636421208310, 1636421208574, 264, 0, 264, 0, 0, 0
2745, 1, 1636421208978, 1636421209246, 268, 0, 268, 0, 0, 0
2699, 2, 1636421204813, 1636421214926, 10113, 0, 10113, 0, 0, 0
2749, 1, 1636421215417, 1636421215729, 312, 1, 311, 1, 0, 1
2748, 1, 1636421215417, 1636421215729, 312, 1, 311, 1, 0, 1
2751, 1, 1636421216133, 1636421216397, 264, 1, 263, 0, 1, 1
2752, 1, 1636421216133, 1636421216397, 264, 1, 263, 0, 1, 1
2754, 1, 1636421216838, 1636421217133, 295, 0, 295, 0, 0, 0
2755, 1, 1636421216838, 1636421217133, 295, 0, 295, 0, 0, 0
2759, 1, 1636421217570, 1636421217841, 271, 0, 271, 0, 0, 0
2758, 1, 1636421217570, 1636421217841, 271, 0, 271, 0, 0, 0
2762, 1, 1636421218250, 1636421218514, 264, 0, 264, 0, 0, 0
2763, 1, 1636421218942, 1636421219210, 268, 0, 268, 0, 0, 0
2764, 1, 1636421219614, 1636421219878, 264, 0, 264, 0, 0, 0
2765, 1, 1636421228218, 1636421228486, 268, 0, 268, 0, 0, 0
2784, 1, 1636421228557, 1636421228821, 264, 1, 263, 0, 1, 1
2785, 1, 1636421235869, 1636421236137, 268, 1, 267, 0, 0, 0
2787, 1, 1636421236173, 1636421236438, 265, 1, 264, 0, 0, 0
2788, 1, 1636421236173, 1636421236438, 265, 1, 264, 1, 0, 1
2793, 1, 1636421236173, 1636421236438, 265, 1, 264, 0, 0, 0
2791, 1, 1636421236474, 1636421236742, 268, 0, 268, 0, 0, 0
2802, 1, 1636421236826, 1636421237090, 264, 0, 264, 0, 0, 0
2804, 1, 1636421236841, 1636421237106, 265, 1, 264, 0, 0, 0
2805, 1, 1636421236841, 1636421237106, 265, 1, 264, 0, 0, 0
2803, 1, 1636421236841, 1636421237113, 272, 2, 270, 0, 0, 0
2806, 1, 1636421237186, 1636421237449, 263, 0, 263, 0, 0, 0
2807, 1, 1636421237453, 1636421237721, 268, 0, 268, 0, 0, 0
2811, 1, 1636421237513, 1636421237790, 277, 0, 277, 0, 0, 0
2809, 1, 1636421237505, 1636421237790, 285, 1, 284, 0, 0, 0
2808, 1, 1636421237497, 1636421237790, 293, 1, 292, 1, 0, 1
2812, 1, 1636421237858, 1636421238122, 264, 0, 264, 0, 0, 0
2813, 1, 1636421238061, 1636421238326, 265, 1, 264, 0, 1, 1
2814, 1, 1636421238122, 1636421238386, 264, 0, 264, 0, 0, 0
2817, 1, 1636421238194, 1636421238458, 264, 1, 263, 0, 1, 1
2816, 1, 1636421238194, 1636421238458, 264, 0, 264, 0, 0, 0
2815, 1, 1636421238194, 1636421238461, 267, 1, 266, 0, 0, 0
2818, 1, 1636421238565, 1636421238833, 268, 1, 267, 0, 1, 1
2819, 1, 1636421238729, 1636421238993, 264, 1, 263, 1, 0, 1
2820, 1, 1636421238801, 1636421239070, 269, 1, 268, 0, 0, 0
2821, 1, 1636421238825, 1636421239094, 269, 0, 269, 0, 0, 0
2822, 1, 1636421238861, 1636421239126, 265, 1, 264, 0, 0, 0
2824, 1, 1636421238861, 1636421239126, 265, 2, 263, 0, 0, 0
2823, 1, 1636421238862, 1636421239126, 264, 0, 264, 0, 0, 0
2810, 1, 1636421239222, 1636421239485, 263, 0, 263, 0, 0, 0
2825, 1, 1636421239269, 1636421239537, 268, 1, 267, 0, 0, 0
2826, 1, 1636421239405, 1636421239673, 268, 1, 267, 0, 0, 0
2827, 1, 1636421239473, 1636421239741, 268, 1, 267, 1, 0, 1
2828, 1, 1636421239501, 1636421239765, 264, 1, 263, 0, 0, 0
2831, 1, 1636421239530, 1636421239793, 263, 0, 263, 0, 0, 0
2830, 1, 1636421239537, 1636421239801, 264, 1, 263, 0, 0, 0
2829, 1, 1636421239530, 1636421239801, 271, 0, 271, 0, 0, 0
2832, 1, 1636421239797, 1636421240061, 264, 1, 263, 0, 0, 0
2834, 1, 1636421240070, 1636421240333, 263, 0, 263, 0, 0, 0
2835, 1, 1636421240077, 1636421240342, 265, 1, 264, 1, 0, 1
2836, 1, 1636421240145, 1636421240409, 264, 1, 263, 1, 0, 1
2837, 1, 1636421240166, 1636421240434, 268, 0, 268, 0, 0, 0
2838, 1, 1636421240197, 1636421240461, 264, 1, 263, 0, 1, 1
2839, 1, 1636421240341, 1636421240610, 269, 1, 268, 0, 0, 0
2840, 1, 1636421240433, 1636421240705, 272, 1, 271, 0, 0, 0
2841, 1, 1636421240461, 1636421240725, 264, 1, 263, 0, 0, 0
2843, 1, 1636421240742, 1636421241010, 268, 0, 268, 0, 0, 0
2842, 1, 1636421240742, 1636421241010, 268, 0, 268, 0, 0, 0
2844, 1, 1636421240813, 1636421241077, 264, 1, 263, 0, 0, 0
2845, 1, 1636421240841, 1636421241106, 265, 1, 264, 0, 0, 0
2847, 1, 1636421241013, 1636421241277, 264, 0, 264, 0, 0, 0
2848, 1, 1636421241105, 1636421241373, 268, 1, 267, 0, 0, 0
2849, 1, 1636421241133, 1636421241397, 264, 0, 264, 0, 0, 0
2850, 1, 1636421241413, 1636421241677, 264, 1, 263, 0, 0, 0
2852, 1, 1636421241485, 1636421241749, 264, 1, 263, 0, 0, 0
2853, 1, 1636421241506, 1636421241773, 267, 0, 267, 0, 0, 0
2856, 1, 1636421241801, 1636421242065, 264, 1, 263, 1, 0, 1
2857, 1, 1636421242081, 1636421242346, 265, 1, 264, 0, 0, 0
2859, 1, 1636421242178, 1636421242442, 264, 0, 264, 0, 0, 0
2860, 1, 1636421242470, 1636421242734, 264, 0, 264, 0, 0, 0
2862, 1, 1636421242846, 1636421243110, 264, 0, 264, 0, 0, 0
2863, 1, 1636421243134, 1636421243397, 263, 0, 263, 0, 0, 0
2865, 1, 1636421243801, 1636421244066, 265, 1, 264, 1, 0, 1
2855, 1, 1636421246621, 1636421246889, 268, 1, 267, 0, 0, 0
2868, 1, 1636421246885, 1636421247150, 265, 1, 264, 1, 0, 1
2867, 1, 1636421246885, 1636421247150, 265, 1, 264, 0, 0, 0
2873, 1, 1636421247157, 1636421247421, 264, 0, 264, 0, 0, 0
2875, 1, 1636421247157, 1636421247421, 264, 0, 264, 0, 0, 0
2880, 1, 1636421247557, 1636421247821, 264, 1, 263, 1, 0, 1
2879, 1, 1636421247557, 1636421247821, 264, 1, 263, 0, 0, 0
2882, 1, 1636421247829, 1636421248093, 264, 1, 263, 0, 0, 0
2881, 1, 1636421247829, 1636421248093, 264, 1, 263, 0, 1, 1
2884, 1, 1636421248221, 1636421248486, 265, 1, 264, 0, 1, 1
2885, 1, 1636421248502, 1636421248770, 268, 0, 268, 0, 0, 0
2887, 1, 1636421248890, 1636421249154, 264, 0, 264, 0, 0, 0
2888, 1, 1636421249174, 1636421249445, 271, 0, 271, 0, 0, 0
2889, 1, 1636421249557, 1636421249826, 269, 1, 268, 1, 0, 1
2890, 1, 1636421249850, 1636421250114, 264, 0, 264, 0, 0, 0
2891, 1, 1636421250194, 1636421250458, 264, 0, 264, 0, 0, 0
2892, 1, 1636421250458, 1636421250726, 268, 0, 268, 0, 0, 0
2893, 1, 1636421250733, 1636421250998, 265, 1, 264, 0, 1, 1
2894, 1, 1636421250862, 1636421251130, 268, 0, 268, 0, 0, 0
2895, 1, 1636421251130, 1636421251397, 267, 0, 267, 0, 0, 0
2896, 1, 1636421251177, 1636421251453, 276, 0, 276, 0, 0, 0
2897, 1, 1636421251397, 1636421251662, 265, 1, 264, 1, 0, 1
2898, 1, 1636421251545, 1636421251814, 269, 0, 269, 0, 0, 0
2899, 1, 1636421251726, 1636421251990, 264, 0, 264, 0, 0, 0
2900, 1, 1636421251797, 1636421252065, 268, 1, 267, 1, 0, 1
2902, 1, 1636421252017, 1636421252281, 264, 1, 263, 1, 0, 1
2903, 1, 1636421252109, 1636421252381, 272, 0, 272, 0, 0, 0
2904, 1, 1636421252241, 1636421252506, 265, 1, 264, 0, 1, 1
2906, 1, 1636421252462, 1636421252726, 264, 0, 264, 0, 0, 0
2910, 1, 1636421252926, 1636421253190, 264, 0, 264, 0, 0, 0
2911, 1, 1636421253053, 1636421253318, 265, 1, 264, 0, 0, 0
2913, 1, 1636421253602, 1636421253866, 264, 0, 264, 0, 0, 0
2915, 1, 1636421253822, 1636421254090, 268, 0, 268, 0, 0, 0
2916, 1, 1636421254270, 1636421254534, 264, 0, 264, 0, 0, 0
2918, 1, 1636421254782, 1636421255046, 264, 0, 264, 0, 0, 0
2919, 1, 1636421254938, 1636421255202, 264, 0, 264, 0, 0, 0
2921, 1, 1636421255605, 1636421255874, 269, 1, 268, 1, 0, 1
2923, 1, 1636421257429, 1636421257693, 264, 0, 264, 0, 0, 0
2909, 1, 1636421257521, 1636421257785, 264, 1, 263, 0, 0, 0
2926, 1, 1636421257517, 1636421257793, 276, 1, 275, 0, 1, 1
2907, 1, 1636421257797, 1636421258065, 268, 1, 267, 0, 0, 0
2929, 1, 1636421257797, 1636421258073, 276, 1, 275, 0, 0, 0
2928, 1, 1636421258089, 1636421258362, 273, 1, 272, 0, 0, 0
2933, 1, 1636421258194, 1636421258461, 267, 0, 267, 0, 0, 0
2927, 1, 1636421258365, 1636421258630, 265, 0, 265, 0, 0, 0
2935, 1, 1636421258469, 1636421258734, 265, 0, 265, 0, 0, 0
2936, 1, 1636421258542, 1636421258805, 263, 0, 263, 0, 0, 0
2937, 1, 1636421258769, 1636421259033, 264, 1, 263, 0, 0, 0
2938, 1, 1636421258809, 1636421259077, 268, 1, 267, 0, 0, 0
2939, 1, 1636421258853, 1636421259118, 265, 1, 264, 1, 0, 1
2940, 1, 1636421259033, 1636421259298, 265, 1, 264, 1, 0, 1
2941, 1, 1636421259129, 1636421259394, 265, 1, 264, 0, 1, 1
2943, 1, 1636421259433, 1636421259697, 264, 1, 263, 0, 0, 0
2945, 1, 1636421259513, 1636421259778, 265, 1, 264, 1, 0, 1
2946, 1, 1636421259697, 1636421259962, 265, 1, 264, 1, 0, 1
2947, 1, 1636421259794, 1636421260061, 267, 0, 267, 0, 0, 0
2948, 1, 1636421260106, 1636421260370, 264, 0, 264, 0, 0, 0
2949, 1, 1636421260178, 1636421260442, 264, 0, 264, 0, 0, 0
2950, 1, 1636421260373, 1636421260642, 269, 1, 268, 0, 0, 0
2951, 1, 1636421260465, 1636421260729, 264, 1, 263, 0, 0, 0
2952, 1, 1636421260774, 1636421261037, 263, 0, 263, 0, 0, 0
2953, 1, 1636421260841, 1636421261110, 269, 1, 268, 0, 1, 1
2954, 1, 1636421261041, 1636421261305, 264, 1, 263, 0, 0, 0
2955, 1, 1636421261133, 1636421261397, 264, 1, 263, 0, 0, 0
2956, 1, 1636421261442, 1636421261706, 264, 0, 264, 0, 0, 0
2957, 1, 1636421261513, 1636421261778, 265, 1, 264, 0, 0, 0
2958, 1, 1636421261725, 1636421261989, 264, 1, 263, 1, 0, 1
2959, 1, 1636421261818, 1636421262081, 263, 0, 263, 0, 0, 0
2960, 1, 1636421262114, 1636421262378, 264, 0, 264, 0, 0, 0
2961, 1, 1636421262169, 1636421262433, 264, 1, 263, 1, 0, 1
2962, 1, 1636421262169, 1636421262433, 264, 1, 263, 1, 0, 1
2963, 1, 1636421262393, 1636421262662, 269, 0, 269, 0, 0, 0
2964, 1, 1636421262481, 1636421262746, 265, 0, 265, 0, 0, 0
2965, 1, 1636421262730, 1636421262993, 263, 0, 263, 0, 0, 0
2966, 1, 1636421262786, 1636421263050, 264, 0, 264, 0, 0, 0
2968, 1, 1636421262865, 1636421263169, 304, 1, 303, 0, 1, 1
2969, 1, 1636421262993, 1636421263258, 265, 1, 264, 1, 0, 1
2970, 1, 1636421263085, 1636421263350, 265, 1, 264, 0, 0, 0
2972, 1, 1636421263394, 1636421263658, 264, 0, 264, 0, 0, 0
2973, 1, 1636421263437, 1636421263702, 265, 1, 264, 1, 0, 1
2975, 1, 1636421263585, 1636421263854, 269, 1, 268, 0, 0, 0
2976, 1, 1636421263673, 1636421263938, 265, 0, 265, 0, 0, 0
2978, 1, 1636421264026, 1636421264294, 268, 0, 268, 0, 0, 0
2979, 1, 1636421264057, 1636421264321, 264, 0, 264, 0, 0, 0
2980, 1, 1636421264101, 1636421264366, 265, 1, 264, 1, 0, 1
2981, 1, 1636421264249, 1636421264557, 308, 1, 307, 0, 0, 0
2982, 1, 1636421264381, 1636421264646, 265, 1, 264, 1, 0, 1
2983, 1, 1636421264693, 1636421264958, 265, 1, 264, 1, 0, 1
2984, 1, 1636421264725, 1636421264990, 265, 0, 265, 0, 0, 0
2985, 1, 1636421264770, 1636421265037, 267, 0, 267, 0, 0, 0
2986, 1, 1636421264825, 1636421265089, 264, 1, 263, 1, 0, 1
2987, 1, 1636421264969, 1636421265233, 264, 1, 263, 0, 0, 0
2988, 1, 1636421265061, 1636421265326, 265, 1, 264, 1, 0, 1
2989, 1, 1636421265362, 1636421265629, 267, 0, 267, 0, 0, 0
2990, 1, 1636421265405, 1636421265670, 265, 1, 264, 1, 0, 1
2991, 1, 1636421265441, 1636421265706, 265, 1, 264, 0, 0, 0
2922, 1, 1636421265453, 1636421265717, 264, 0, 264, 0, 0, 0
2992, 1, 1636421265497, 1636421265765, 268, 0, 268, 0, 0, 0
2993, 1, 1636421265633, 1636421265897, 264, 0, 264, 0, 0, 0
2994, 1, 1636421265729, 1636421266001, 272, 1, 271, 0, 0, 0
2995, 1, 1636421265758, 1636421266021, 263, 0, 263, 0, 0, 0
2996, 1, 1636421266033, 1636421266297, 264, 1, 263, 0, 1, 1
2997, 1, 1636421266074, 1636421266338, 264, 0, 264, 0, 0, 0
2998, 1, 1636421266109, 1636421266373, 264, 1, 263, 0, 0, 0
2999, 1, 1636421266125, 1636421266398, 273, 1, 272, 1, 0, 1
3000, 1, 1636421266165, 1636421266429, 264, 0, 264, 0, 0, 0
3001, 1, 1636421266297, 1636421266561, 264, 0, 264, 0, 0, 0
3002, 1, 1636421266405, 1636421266678, 273, 1, 272, 0, 0, 0
3003, 1, 1636421266421, 1636421266690, 269, 1, 268, 0, 0, 0
3004, 1, 1636421266701, 1636421266965, 264, 1, 263, 0, 0, 0
3005, 1, 1636421266737, 1636421267005, 268, 1, 267, 0, 0, 0
3006, 1, 1636421266774, 1636421267037, 263, 0, 263, 0, 0, 0
3007, 1, 1636421266801, 1636421267065, 264, 1, 263, 0, 0, 0
3008, 1, 1636421266833, 1636421267097, 264, 1, 263, 1, 0, 1
3009, 1, 1636421266961, 1636421267225, 264, 1, 263, 0, 1, 1
3010, 1, 1636421267082, 1636421267345, 263, 0, 263, 0, 0, 0
3011, 1, 1636421267089, 1636421267362, 273, 0, 273, 0, 0, 0
3013, 1, 1636421267413, 1636421267681, 268, 0, 268, 0, 0, 0
3012, 1, 1636421267413, 1636421267681, 268, 0, 268, 0, 0, 0
3014, 1, 1636421267506, 1636421267770, 264, 1, 263, 0, 1, 1
3015, 1, 1636421267506, 1636421267770, 264, 1, 263, 0, 1, 1
3016, 1, 1636421267506, 1636421267770, 264, 0, 264, 0, 0, 0
3018, 1, 1636421267773, 1636421268038, 265, 0, 265, 0, 0, 0
3019, 1, 1636421267773, 1636421268042, 269, 0, 269, 0, 0, 0
3023, 1, 1636421268085, 1636421268350, 265, 1, 264, 0, 1, 1
3026, 1, 1636421268238, 1636421268510, 272, 1, 271, 1, 0, 1
3025, 1, 1636421268238, 1636421268510, 272, 1, 271, 1, 0, 1
3027, 1, 1636421268238, 1636421268510, 272, 1, 271, 0, 0, 0
3028, 1, 1636421268425, 1636421268697, 272, 1, 271, 0, 0, 0
3030, 1, 1636421268445, 1636421268709, 264, 0, 264, 0, 0, 0
3032, 1, 1636421268749, 1636421269014, 265, 1, 264, 1, 0, 1
3036, 1, 1636421268918, 1636421269181, 263, 0, 263, 0, 0, 0
3034, 1, 1636421268925, 1636421269193, 268, 1, 267, 0, 0, 0
3038, 1, 1636421269113, 1636421269378, 265, 1, 264, 0, 0, 0
3040, 1, 1636421269526, 1636421269793, 267, 0, 267, 0, 0, 0
3041, 1, 1636421269585, 1636421269849, 264, 1, 263, 1, 0, 1
3042, 1, 1636421269597, 1636421269862, 265, 1, 264, 0, 0, 0
3043, 1, 1636421269785, 1636421270049, 264, 1, 263, 0, 0, 0
3044, 1, 1636421269797, 1636421270061, 264, 0, 264, 0, 0, 0
3045, 1, 1636421270197, 1636421270462, 265, 1, 264, 0, 0, 0
3047, 1, 1636421270274, 1636421270538, 264, 0, 264, 0, 0, 0
3048, 1, 1636421270457, 1636421270722, 265, 1, 264, 1, 0, 1
3049, 1, 1636421270462, 1636421270729, 267, 1, 266, 1, 0, 1
3050, 1, 1636421270862, 1636421271126, 264, 0, 264, 0, 0, 0
3051, 1, 1636421270950, 1636421271213, 263, 0, 263, 0, 0, 0
3053, 1, 1636421271129, 1636421271398, 269, 1, 268, 0, 0, 0
3054, 1, 1636421271538, 1636421271806, 268, 0, 268, 0, 0, 0
3055, 1, 1636421271617, 1636421271882, 265, 1, 264, 0, 0, 0
3056, 1, 1636421271809, 1636421272074, 265, 1, 264, 1, 0, 1
3057, 1, 1636421272214, 1636421272477, 263, 0, 263, 0, 0, 0
3058, 1, 1636421272286, 1636421272550, 264, 0, 264, 0, 0, 0
3059, 1, 1636421272481, 1636421272750, 269, 1, 268, 1, 0, 1
3060, 1, 1636421272906, 1636421273213, 307, 0, 307, 0, 0, 0
3062, 1, 1636421273221, 1636421273498, 277, 1, 276, 1, 0, 1
3065, 1, 1636421273633, 1636421273898, 265, 1, 264, 0, 1, 1
3037, 1, 1636421273770, 1636421274034, 264, 0, 264, 0, 0, 0
3067, 1, 1636421273945, 1636421274214, 269, 1, 268, 1, 0, 1
3069, 1, 1636421274301, 1636421274566, 265, 1, 264, 0, 0, 0
3070, 1, 1636421274438, 1636421274702, 264, 0, 264, 0, 0, 0
3071, 1, 1636421274617, 1636421274890, 273, 1, 272, 0, 1, 1
3072, 1, 1636421274970, 1636421275234, 264, 0, 264, 0, 0, 0
3073, 1, 1636421275102, 1636421275365, 263, 0, 263, 0, 0, 0
3074, 1, 1636421275294, 1636421275557, 263, 0, 263, 0, 0, 0
3075, 1, 1636421275637, 1636421275906, 269, 1, 268, 1, 0, 1
3076, 1, 1636421275770, 1636421276034, 264, 0, 264, 0, 0, 0
3077, 1, 1636421275966, 1636421276234, 268, 0, 268, 0, 0, 0
3078, 1, 1636421276314, 1636421276578, 264, 0, 264, 0, 0, 0
3079, 1, 1636421276437, 1636421276701, 264, 0, 264, 0, 0, 0
3080, 1, 1636421276638, 1636421276910, 272, 0, 272, 0, 0, 0
3081, 1, 1636421276977, 1636421277242, 265, 1, 264, 0, 0, 0
3082, 1, 1636421277102, 1636421277369, 267, 0, 267, 0, 0, 0
3083, 1, 1636421277310, 1636421277574, 264, 0, 264, 0, 0, 0
3084, 1, 1636421277685, 1636421277950, 265, 1, 264, 0, 0, 0
3085, 1, 1636421278106, 1636421278373, 267, 0, 267, 0, 0, 0
3089, 1, 1636421278397, 1636421278666, 269, 2, 267, 0, 0, 0
3087, 1, 1636421278397, 1636421278666, 269, 1, 268, 0, 0, 0
3088, 1, 1636421278397, 1636421278666, 269, 1, 268, 0, 0, 0
3093, 1, 1636421278785, 1636421279050, 265, 1, 264, 1, 0, 1
3099, 1, 1636421279097, 1636421279370, 273, 1, 272, 0, 0, 0
3098, 1, 1636421279097, 1636421279370, 273, 1, 272, 0, 0, 0
3097, 1, 1636421279097, 1636421279370, 273, 2, 271, 1, 0, 1
3101, 1, 1636421279461, 1636421279725, 264, 0, 264, 0, 0, 0
3105, 1, 1636421279770, 1636421280037, 267, 1, 266, 0, 0, 0
3104, 1, 1636421279770, 1636421280037, 267, 0, 267, 0, 0, 0
3103, 1, 1636421279770, 1636421280037, 267, 1, 266, 0, 1, 1
3106, 1, 1636421280125, 1636421280390, 265, 1, 264, 1, 0, 1
3108, 1, 1636421280437, 1636421280701, 264, 1, 263, 0, 0, 0
3107, 1, 1636421280441, 1636421280706, 265, 1, 264, 1, 0, 1
3109, 1, 1636421280441, 1636421280706, 265, 1, 264, 0, 0, 0
3111, 1, 1636421280790, 1636421281062, 272, 0, 272, 0, 0, 0
3113, 1, 1636421281109, 1636421281373, 264, 1, 263, 1, 0, 1
3114, 1, 1636421281109, 1636421281373, 264, 1, 263, 1, 0, 1
3116, 1, 1636421281461, 1636421281730, 269, 0, 269, 0, 0, 0
3118, 1, 1636421281777, 1636421282041, 264, 1, 263, 1, 0, 1
3119, 1, 1636421282134, 1636421282398, 264, 0, 264, 0, 0, 0
3121, 1, 1636421282817, 1636421283082, 265, 1, 264, 0, 0, 0
3124, 1, 1636421283486, 1636421283750, 264, 0, 264, 0, 0, 0
3127, 1, 1636421284170, 1636421284434, 264, 0, 264, 0, 0, 0
3129, 1, 1636421284838, 1636421285102, 264, 0, 264, 0, 0, 0
3130, 1, 1636421285501, 1636421285770, 269, 1, 268, 0, 0, 0
3131, 1, 1636421286174, 1636421286438, 264, 0, 264, 0, 0, 0
3133, 1, 1636421288282, 1636421288554, 272, 0, 272, 0, 0, 0
3134, 1, 1636421288830, 1636421289138, 308, 0, 308, 0, 0, 0
3135, 1, 1636421288965, 1636421289269, 304, 1, 303, 0, 1, 1
3136, 1, 1636421288998, 1636421289270, 272, 0, 272, 0, 0, 0
3139, 1, 1636421289182, 1636421289445, 263, 0, 263, 0, 0, 0
3141, 1, 1636421289537, 1636421289801, 264, 1, 263, 1, 0, 1
3142, 1, 1636421289537, 1636421289805, 268, 1, 267, 1, 0, 1
3144, 1, 1636421289677, 1636421289941, 264, 1, 263, 0, 0, 0
3143, 1, 1636421289677, 1636421289945, 268, 1, 267, 0, 0, 0
3145, 1, 1636421289849, 1636421290114, 265, 0, 265, 0, 0, 0
3146, 1, 1636421290033, 1636421290298, 265, 1, 264, 1, 0, 1
3148, 1, 1636421290209, 1636421290477, 268, 1, 267, 1, 0, 1
3147, 1, 1636421290209, 1636421290478, 269, 1, 268, 1, 0, 1
3150, 1, 1636421290345, 1636421290610, 265, 1, 264, 0, 0, 0
3149, 1, 1636421290345, 1636421290610, 265, 0, 265, 0, 0, 0
3151, 1, 1636421290518, 1636421290781, 263, 0, 263, 0, 0, 0
3152, 1, 1636421290733, 1636421291006, 273, 0, 273, 0, 0, 0
3153, 1, 1636421290865, 1636421291146, 281, 1, 280, 1, 0, 1
3155, 1, 1636421290885, 1636421291149, 264, 1, 263, 0, 1, 1
3154, 1, 1636421290885, 1636421291149, 264, 1, 263, 0, 1, 1
3157, 1, 1636421291017, 1636421291281, 264, 1, 263, 0, 0, 0
3158, 1, 1636421291197, 1636421291477, 280, 0, 280, 0, 0, 0
3159, 1, 1636421291414, 1636421291678, 264, 0, 264, 0, 0, 0
3160, 1, 1636421291414, 1636421291681, 267, 0, 267, 0, 0, 0
3161, 1, 1636421291553, 1636421291817, 264, 0, 264, 0, 0, 0
3163, 1, 1636421291557, 1636421291821, 264, 1, 263, 0, 0, 0
3162, 1, 1636421291557, 1636421291825, 268, 1, 267, 1, 0, 1
3164, 1, 1636421291685, 1636421291957, 272, 0, 272, 0, 0, 0
3165, 1, 1636421291741, 1636421292009, 268, 1, 267, 1, 0, 1
3166, 1, 1636421291881, 1636421292149, 268, 1, 267, 1, 0, 1
3167, 1, 1636421292082, 1636421292346, 264, 0, 264, 0, 0, 0
3169, 1, 1636421292085, 1636421292349, 264, 1, 263, 1, 0, 1
3171, 1, 1636421292221, 1636421292485, 264, 0, 264, 0, 0, 0
3170, 1, 1636421292221, 1636421292486, 265, 0, 265, 0, 0, 0
3172, 1, 1636421292225, 1636421292493, 268, 0, 268, 0, 0, 0
3173, 1, 1636421292397, 1636421292662, 265, 1, 264, 0, 1, 1
3174, 1, 1636421292409, 1636421292678, 269, 1, 268, 0, 0, 0
3175, 1, 1636421292549, 1636421292813, 264, 0, 264, 0, 0, 0
3178, 1, 1636421292758, 1636421293021, 263, 0, 263, 0, 0, 0
3177, 1, 1636421292750, 1636421293021, 271, 0, 271, 0, 0, 0
3180, 1, 1636421292889, 1636421293154, 265, 1, 264, 0, 0, 0
3179, 1, 1636421292889, 1636421293154, 265, 1, 264, 0, 0, 0
3181, 1, 1636421292893, 1636421293157, 264, 0, 264, 0, 0, 0
3182, 1, 1636421293061, 1636421293326, 265, 1, 264, 0, 0, 0
3183, 1, 1636421293121, 1636421293389, 268, 0, 268, 0, 0, 0
3184, 1, 1636421293213, 1636421293513, 300, 1, 299, 1, 0, 1
3185, 1, 1636421293429, 1636421293697, 268, 1, 267, 1, 0, 1
3186, 1, 1636421293429, 1636421293701, 272, 1, 271, 1, 0, 1
3189, 1, 1636421293565, 1636421293849, 284, 1, 283, 0, 0, 0
3190, 1, 1636421293565, 1636421293849, 284, 2, 282, 0, 1, 1
3187, 1, 1636421293565, 1636421293849, 284, 2, 282, 1, 0, 1
3188, 1, 1636421293565, 1636421293853, 288, 2, 286, 0, 0, 0
3191, 1, 1636421293765, 1636421294034, 269, 1, 268, 0, 0, 0
3193, 1, 1636421293793, 1636421294109, 316, 1, 315, 0, 0, 0
3194, 1, 1636421293933, 1636421294197, 264, 1, 263, 1, 0, 1
3195, 1, 1636421294121, 1636421294425, 304, 1, 303, 1, 0, 1
3196, 1, 1636421294121, 1636421294425, 304, 1, 303, 1, 0, 1
3198, 1, 1636421294262, 1636421294525, 263, 1, 262, 0, 0, 0
3201, 1, 1636421294262, 1636421294529, 267, 1, 266, 1, 0, 1
3200, 1, 1636421294262, 1636421294530, 268, 1, 267, 1, 0, 1
3199, 1, 1636421294262, 1636421294529, 267, 1, 266, 1, 0, 1
3156, 1, 1636421294381, 1636421294649, 268, 0, 268, 0, 0, 0
3203, 1, 1636421294473, 1636421294742, 269, 0, 269, 0, 0, 0
3204, 1, 1636421294513, 1636421294785, 272, 1, 271, 0, 1, 1
3205, 1, 1636421294597, 1636421294862, 265, 0, 265, 0, 0, 0
3207, 1, 1636421294825, 1636421295090, 265, 1, 264, 1, 0, 1
3208, 1, 1636421294829, 1636421295093, 264, 1, 263, 0, 0, 0
3209, 1, 1636421294921, 1636421295185, 264, 0, 264, 0, 0, 0
3212, 1, 1636421294933, 1636421295197, 264, 1, 263, 0, 1, 1
3210, 1, 1636421294933, 1636421295206, 273, 1, 272, 0, 1, 1
3211, 1, 1636421294933, 1636421295206, 273, 1, 272, 1, 0, 1
3213, 1, 1636421295061, 1636421295325, 264, 1, 263, 0, 1, 1
3214, 1, 1636421295145, 1636421295410, 265, 0, 265, 0, 0, 0
3215, 1, 1636421295181, 1636421295445, 264, 1, 263, 1, 0, 1
3216, 1, 1636421295261, 1636421295525, 264, 1, 263, 0, 0, 0
3217, 1, 1636421295485, 1636421295749, 264, 0, 264, 0, 0, 0
3218, 1, 1636421295489, 1636421295753, 264, 1, 263, 1, 0, 1
3219, 1, 1636421295585, 1636421295849, 264, 1, 263, 1, 0, 1
3220, 1, 1636421295606, 1636421295869, 263, 0, 263, 0, 0, 0
3222, 1, 1636421295617, 1636421295881, 264, 0, 264, 0, 0, 0
3221, 1, 1636421295617, 1636421295881, 264, 0, 264, 0, 0, 0
3223, 1, 1636421295721, 1636421295985, 264, 1, 263, 0, 0, 0
3224, 1, 1636421295813, 1636421296078, 265, 0, 265, 0, 0, 0
3225, 1, 1636421295845, 1636421296109, 264, 0, 264, 0, 0, 0
3226, 1, 1636421295926, 1636421296190, 264, 0, 264, 0, 0, 0
3228, 1, 1636421296153, 1636421296417, 264, 1, 263, 0, 0, 0
3227, 1, 1636421296153, 1636421296421, 268, 1, 267, 1, 0, 1
3229, 1, 1636421296245, 1636421296513, 268, 0, 268, 0, 0, 0
3230, 1, 1636421296273, 1636421296537, 264, 1, 263, 1, 0, 1
3232, 1, 1636421296285, 1636421296553, 268, 0, 268, 0, 0, 0
3231, 1, 1636421296285, 1636421296553, 268, 1, 267, 0, 1, 1
3233, 1, 1636421296389, 1636421296653, 264, 0, 264, 0, 0, 0
3234, 1, 1636421296481, 1636421296746, 265, 1, 264, 0, 1, 1
3235, 1, 1636421296513, 1636421296781, 268, 1, 267, 0, 0, 0
3236, 1, 1636421296593, 1636421296881, 288, 1, 287, 0, 1, 1
3237, 1, 1636421296813, 1636421297082, 269, 1, 268, 0, 1, 1
3238, 1, 1636421296825, 1636421297094, 269, 0, 269, 0, 0, 0
3239, 1, 1636421296925, 1636421297193, 268, 0, 268, 0, 0, 0
3240, 1, 1636421296941, 1636421297206, 265, 0, 265, 0, 0, 0
3242, 1, 1636421296961, 1636421297226, 265, 1, 264, 1, 0, 1
3241, 1, 1636421296961, 1636421297226, 265, 1, 264, 0, 1, 1
3243, 1, 1636421297049, 1636421297313, 264, 1, 263, 0, 0, 0
3245, 1, 1636421297141, 1636421297406, 265, 1, 264, 0, 1, 1
3246, 1, 1636421297189, 1636421297465, 276, 0, 276, 0, 0, 0
3247, 1, 1636421297285, 1636421297549, 264, 1, 263, 1, 0, 1
3248, 1, 1636421297481, 1636421297745, 264, 1, 263, 1, 0, 1
3249, 1, 1636421297497, 1636421297769, 272, 1, 271, 0, 0, 0
3250, 1, 1636421297593, 1636421297857, 264, 1, 263, 0, 0, 0
3251, 1, 1636421297613, 1636421297877, 264, 1, 263, 1, 0, 1
3253, 1, 1636421297629, 1636421297898, 269, 0, 269, 0, 0, 0
3252, 1, 1636421297629, 1636421297898, 269, 0, 269, 0, 0, 0
3254, 1, 1636421297709, 1636421297969, 260, 0, 260, 0, 0, 0
3255, 1, 1636421297801, 1636421298073, 272, 1, 271, 1, 0, 1
3256, 1, 1636421297877, 1636421298145, 268, 1, 267, 0, 0, 0
3257, 1, 1636421297949, 1636421298217, 268, 1, 267, 1, 0, 1
3258, 1, 1636421298149, 1636421298417, 268, 1, 267, 0, 0, 0
3259, 1, 1636421298169, 1636421298433, 264, 1, 263, 0, 1, 1
3260, 1, 1636421298253, 1636421298521, 268, 1, 267, 0, 0, 0
3261, 1, 1636421298277, 1636421298545, 268, 1, 267, 0, 1, 1
3262, 1, 1636421298297, 1636421298574, 277, 0, 277, 0, 0, 0
3264, 1, 1636421298369, 1636421298637, 268, 1, 267, 0, 0, 0
3263, 1, 1636421298437, 1636421298701, 264, 0, 264, 0, 0, 0
3265, 1, 1636421298473, 1636421298737, 264, 1, 263, 0, 0, 0
3266, 1, 1636421298549, 1636421298813, 264, 1, 263, 0, 1, 1
3267, 1, 1636421298625, 1636421298894, 269, 1, 268, 0, 1, 1
3269, 1, 1636421298865, 1636421299133, 268, 1, 267, 0, 0, 0
3268, 1, 1636421298865, 1636421299133, 268, 1, 267, 0, 0, 0
3271, 1, 1636421298957, 1636421299221, 264, 1, 263, 1, 0, 1
3270, 1, 1636421298957, 1636421299222, 265, 1, 264, 0, 0, 0
3272, 1, 1636421299009, 1636421299277, 268, 0, 268, 0, 0, 0
3273, 1, 1636421299049, 1636421299314, 265, 0, 265, 0, 0, 0
3274, 1, 1636421299105, 1636421299373, 268, 0, 268, 0, 0, 0
3275, 1, 1636421299181, 1636421299445, 264, 0, 264, 0, 0, 0
3276, 1, 1636421299269, 1636421299533, 264, 1, 263, 0, 0, 0
3277, 1, 1636421299361, 1636421299625, 264, 1, 263, 0, 0, 0
3278, 1, 1636421299541, 1636421299805, 264, 1, 263, 1, 0, 1
3279, 1, 1636421299541, 1636421299805, 264, 1, 263, 0, 0, 0
3282, 1, 1636421299625, 1636421299889, 264, 1, 263, 1, 0, 1
3283, 1, 1636421299633, 1636421299901, 268, 0, 268, 0, 0, 0
3284, 1, 1636421299681, 1636421299953, 272, 1, 271, 0, 0, 0
3286, 1, 1636421299717, 1636421299981, 264, 1, 263, 0, 0, 0
3287, 1, 1636421299773, 1636421300041, 268, 0, 268, 0, 0, 0
3288, 1, 1636421299849, 1636421300113, 264, 1, 263, 0, 0, 0
3289, 1, 1636421299937, 1636421300206, 269, 1, 268, 0, 0, 0
3290, 1, 1636421300029, 1636421300294, 265, 1, 264, 0, 0, 0
3291, 1, 1636421300209, 1636421300473, 264, 1, 263, 1, 0, 1
3292, 1, 1636421300209, 1636421300473, 264, 1, 263, 0, 0, 0
3293, 1, 1636421300293, 1636421300561, 268, 1, 267, 0, 0, 0
3294, 1, 1636421300305, 1636421300569, 264, 1, 263, 0, 0, 0
3295, 1, 1636421300357, 1636421300621, 264, 1, 263, 1, 0, 1
3296, 1, 1636421300385, 1636421300649, 264, 1, 263, 0, 0, 0
3297, 1, 1636421300449, 1636421300713, 264, 1, 263, 0, 1, 1
3298, 1, 1636421300517, 1636421300781, 264, 1, 263, 0, 1, 1
3299, 1, 1636421300605, 1636421300874, 269, 1, 268, 1, 0, 1
3300, 1, 1636421300693, 1636421300961, 268, 1, 267, 1, 0, 1
3302, 1, 1636421300869, 1636421301133, 264, 1, 263, 0, 0, 0
3301, 1, 1636421300874, 1636421301137, 263, 0, 263, 0, 0, 0
3303, 1, 1636421300965, 1636421301233, 268, 0, 268, 0, 0, 0
3304, 1, 1636421300974, 1636421301245, 271, 0, 271, 0, 0, 0
3305, 1, 1636421301033, 1636421301298, 265, 1, 264, 1, 0, 1
3307, 1, 1636421301125, 1636421301390, 265, 1, 264, 0, 1, 1
3308, 1, 1636421301185, 1636421301449, 264, 0, 264, 0, 0, 0
3309, 1, 1636421301273, 1636421301537, 264, 1, 263, 1, 0, 1
3310, 1, 1636421301361, 1636421301634, 273, 1, 272, 1, 0, 1
3311, 1, 1636421301537, 1636421301805, 268, 1, 267, 1, 0, 1
3313, 1, 1636421301637, 1636421301901, 264, 0, 264, 0, 0, 0
3314, 1, 1636421301649, 1636421301918, 269, 0, 269, 0, 0, 0
3315, 1, 1636421301701, 1636421301965, 264, 0, 264, 0, 0, 0
3316, 1, 1636421301793, 1636421302058, 265, 1, 264, 0, 0, 0
3318, 1, 1636421301949, 1636421302213, 264, 0, 264, 0, 0, 0
3319, 1, 1636421302041, 1636421302310, 269, 1, 268, 1, 0, 1
3320, 1, 1636421302209, 1636421302477, 268, 1, 267, 0, 0, 0
3322, 1, 1636421302318, 1636421302586, 268, 0, 268, 0, 0, 0
3323, 1, 1636421302369, 1636421302637, 268, 1, 267, 0, 0, 0
3325, 1, 1636421302466, 1636421302729, 263, 0, 263, 0, 0, 0
3324, 1, 1636421302609, 1636421302878, 269, 0, 269, 0, 0, 0
3326, 1, 1636421302621, 1636421302885, 264, 0, 264, 0, 0, 0
3328, 1, 1636421302929, 1636421303193, 264, 0, 264, 0, 0, 0
3330, 1, 1636421303041, 1636421303301, 260, 0, 260, 0, 0, 0
3332, 1, 1636421303129, 1636421303394, 265, 0, 265, 0, 0, 0
3331, 1, 1636421303193, 1636421303462, 269, 1, 268, 1, 0, 1
3333, 1, 1636421303285, 1636421303550, 265, 1, 264, 0, 1, 1
3334, 1, 1636421303285, 1636421303550, 265, 1, 264, 1, 0, 1
3336, 1, 1636421303737, 1636421304005, 268, 1, 267, 0, 0, 0
3337, 1, 1636421303829, 1636421304097, 268, 1, 267, 1, 0, 1
3338, 1, 1636421303869, 1636421304153, 284, 0, 284, 0, 0, 0
3339, 1, 1636421303981, 1636421304246, 265, 1, 264, 0, 1, 1
3340, 1, 1636421303981, 1636421304246, 265, 1, 264, 0, 1, 1
3206, 1, 1636421304370, 1636421304634, 264, 0, 264, 0, 0, 0
3342, 1, 1636421304414, 1636421304677, 263, 0, 263, 0, 0, 0
3345, 1, 1636421304549, 1636421304814, 265, 0, 265, 0, 0, 0
3347, 1, 1636421304646, 1636421304913, 267, 0, 267, 0, 0, 0
3346, 1, 1636421304646, 1636421304914, 268, 0, 268, 0, 0, 0
3350, 1, 1636421305082, 1636421305346, 264, 0, 264, 0, 0, 0
3351, 1, 1636421305218, 1636421305482, 264, 0, 264, 0, 0, 0
3352, 1, 1636421305314, 1636421305578, 264, 0, 264, 0, 0, 0
3354, 1, 1636421305749, 1636421306014, 265, 1, 264, 0, 0, 0
3355, 1, 1636421305886, 1636421306153, 267, 0, 267, 0, 0, 0
3356, 1, 1636421305978, 1636421306246, 268, 0, 268, 0, 0, 0
3357, 1, 1636421306418, 1636421306682, 264, 0, 264, 0, 0, 0
3358, 1, 1636421306558, 1636421306822, 264, 0, 264, 0, 0, 0
3359, 1, 1636421306646, 1636421306910, 264, 0, 264, 0, 0, 0
3361, 1, 1636421307233, 1636421307498, 265, 1, 264, 0, 1, 1
3362, 1, 1636421307317, 1636421307582, 265, 1, 264, 0, 0, 0
3363, 1, 1636421307453, 1636421307718, 265, 1, 264, 0, 0, 0
3364, 1, 1636421307902, 1636421308166, 264, 0, 264, 0, 0, 0
3365, 1, 1636421307986, 1636421308250, 264, 0, 264, 0, 0, 0
3366, 1, 1636421308121, 1636421308386, 265, 1, 264, 0, 0, 0
3367, 1, 1636421308570, 1636421308834, 264, 0, 264, 0, 0, 0
3368, 1, 1636421308654, 1636421308918, 264, 0, 264, 0, 0, 0
3369, 1, 1636421308790, 1636421309054, 264, 0, 264, 0, 0, 0
3370, 1, 1636421309238, 1636421309506, 268, 0, 268, 0, 0, 0
3371, 1, 1636421309321, 1636421309665, 344, 1, 343, 0, 0, 0
3372, 1, 1636421309493, 1636421309762, 269, 0, 269, 0, 0, 0
3374, 1, 1636421309894, 1636421310158, 264, 0, 264, 0, 0, 0
3375, 1, 1636421309913, 1636421310177, 264, 1, 263, 0, 0, 0
3377, 1, 1636421310066, 1636421310329, 263, 0, 263, 0, 0, 0
3378, 1, 1636421310157, 1636421310422, 265, 1, 264, 0, 0, 0
3379, 1, 1636421310561, 1636421310829, 268, 0, 268, 0, 0, 0
3380, 1, 1636421310581, 1636421310846, 265, 0, 265, 0, 0, 0
3381, 1, 1636421310733, 1636421311002, 269, 1, 268, 0, 0, 0
3382, 1, 1636421310825, 1636421311090, 265, 1, 264, 1, 0, 1
3383, 1, 1636421311237, 1636421311501, 264, 1, 263, 1, 0, 1
3384, 1, 1636421311257, 1636421311521, 264, 1, 263, 0, 0, 0
3385, 1, 1636421311345, 1636421311610, 265, 0, 265, 0, 0, 0
3387, 1, 1636421311493, 1636421311758, 265, 1, 264, 0, 0, 0
3389, 1, 1636421311905, 1636421312169, 264, 1, 263, 0, 0, 0
3391, 1, 1636421312033, 1636421312342, 309, 1, 308, 0, 0, 0
3392, 1, 1636421312169, 1636421312433, 264, 1, 263, 0, 1, 1
3393, 1, 1636421312169, 1636421312433, 264, 1, 263, 0, 0, 0
3395, 1, 1636421312613, 1636421312877, 264, 1, 263, 0, 0, 0
3396, 1, 1636421312762, 1636421313029, 267, 0, 267, 0, 0, 0
3397, 1, 1636421312853, 1636421313117, 264, 1, 263, 0, 0, 0
3399, 1, 1636421313029, 1636421313294, 265, 1, 264, 0, 0, 0
3401, 1, 1636421313301, 1636421313566, 265, 0, 265, 0, 0, 0
3402, 1, 1636421313462, 1636421313726, 264, 0, 264, 0, 0, 0
3403, 1, 1636421313553, 1636421313817, 264, 1, 263, 0, 0, 0
3405, 1, 1636421313901, 1636421314166, 265, 0, 265, 0, 0, 0
3407, 1, 1636421314133, 1636421314398, 265, 1, 264, 0, 1, 1
3408, 1, 1636421314289, 1636421314553, 264, 0, 264, 0, 0, 0
3413, 1, 1636421314817, 1636421315082, 265, 1, 264, 0, 1, 1
3414, 1, 1636421314993, 1636421315258, 265, 0, 265, 0, 0, 0
3394, 1, 1636421315037, 1636421315302, 265, 1, 264, 0, 0, 0
3418, 1, 1636421315625, 1636421315897, 272, 1, 271, 0, 0, 0
3419, 1, 1636421315661, 1636421315934, 273, 0, 273, 0, 0, 0
3420, 1, 1636421315705, 1636421315978, 273, 0, 273, 0, 0, 0
3423, 1, 1636421316386, 1636421316654, 268, 0, 268, 0, 0, 0
3424, 1, 1636421317058, 1636421317322, 264, 0, 264, 0, 0, 0
3425, 1, 1636421317389, 1636421317654, 265, 1, 264, 0, 0, 0
3426, 1, 1636421317721, 1636421317990, 269, 0, 269, 0, 0, 0
3428, 1, 1636421318394, 1636421318670, 276, 0, 276, 0, 0, 0
3429, 1, 1636421319074, 1636421319338, 264, 0, 264, 0, 0, 0
3430, 1, 1636421319758, 1636421320061, 303, 0, 303, 0, 0, 0
3431, 1, 1636421320466, 1636421320730, 264, 0, 264, 0, 0, 0
3432, 1, 1636421320469, 1636421320738, 269, 1, 268, 0, 0, 0
3433, 1, 1636421320745, 1636421321014, 269, 1, 268, 0, 0, 0
3434, 1, 1636421321133, 1636421321402, 269, 0, 269, 0, 0, 0
3437, 1, 1636421321817, 1636421322082, 265, 1, 264, 0, 0, 0
3438, 1, 1636421321938, 1636421322201, 263, 0, 263, 0, 0, 0
3439, 1, 1636421322153, 1636421322418, 265, 0, 265, 0, 0, 0
3440, 1, 1636421322485, 1636421322754, 269, 0, 269, 0, 0, 0
3441, 1, 1636421322602, 1636421322881, 279, 0, 279, 0, 0, 0
3442, 1, 1636421322822, 1636421323090, 268, 0, 268, 0, 0, 0
3443, 1, 1636421323154, 1636421323418, 264, 0, 264, 0, 0, 0
3444, 1, 1636421323154, 1636421323418, 264, 0, 264, 0, 0, 0
3445, 1, 1636421323325, 1636421323594, 269, 0, 269, 0, 0, 0
3446, 1, 1636421323494, 1636421323757, 263, 0, 263, 0, 0, 0
3447, 1, 1636421323585, 1636421323849, 264, 1, 263, 0, 0, 0
3450, 1, 1636421324022, 1636421324286, 264, 0, 264, 0, 0, 0
3451, 1, 1636421324022, 1636421324286, 264, 0, 264, 0, 0, 0
3452, 1, 1636421324161, 1636421324433, 272, 0, 272, 0, 0, 0
3455, 1, 1636421324773, 1636421325038, 265, 1, 264, 1, 0, 1
3457, 1, 1636421324773, 1636421325038, 265, 1, 264, 1, 0, 1
3458, 1, 1636421324865, 1636421325129, 264, 1, 263, 0, 1, 1
3416, 1, 1636421324997, 1636421325262, 265, 0, 265, 0, 0, 0
3460, 1, 1636421325085, 1636421325354, 269, 0, 269, 0, 0, 0
3462, 1, 1636421325361, 1636421325630, 269, 1, 268, 0, 0, 0
3463, 1, 1636421325457, 1636421325722, 265, 1, 264, 0, 1, 1
3465, 1, 1636421325537, 1636421325801, 264, 1, 263, 0, 1, 1
3466, 1, 1636421325677, 1636421325942, 265, 1, 264, 0, 1, 1
3471, 1, 1636421326209, 1636421326478, 269, 1, 268, 0, 0, 0
3474, 1, 1636421326881, 1636421327145, 264, 1, 263, 0, 0, 0
3475, 1, 1636421327549, 1636421327814, 265, 1, 264, 1, 0, 1
3476, 1, 1636421328233, 1636421328501, 268, 1, 267, 0, 0, 0
3478, 1, 1636421328910, 1636421329178, 268, 0, 268, 0, 0, 0
3479, 1, 1636421329582, 1636421329850, 268, 0, 268, 0, 0, 0
3480, 1, 1636421330254, 1636421330518, 264, 0, 264, 0, 0, 0
3483, 1, 1636421331902, 1636421332166, 264, 0, 264, 0, 0, 0
3482, 1, 1636421331902, 1636421332169, 267, 0, 267, 0, 0, 0
3485, 1, 1636421332169, 1636421332433, 264, 1, 263, 1, 0, 1
3486, 1, 1636421332570, 1636421332834, 264, 0, 264, 0, 0, 0
3487, 1, 1636421332570, 1636421332837, 267, 0, 267, 0, 0, 0
3488, 1, 1636421332845, 1636421333109, 264, 1, 263, 0, 0, 0
3490, 1, 1636421333234, 1636421333498, 264, 0, 264, 0, 0, 0
3489, 1, 1636421333234, 1636421333501, 267, 0, 267, 0, 0, 0
3491, 1, 1636421333513, 1636421333777, 264, 1, 263, 0, 0, 0
3492, 1, 1636421333917, 1636421334181, 264, 1, 263, 0, 1, 1
3493, 1, 1636421333917, 1636421334181, 264, 1, 263, 0, 1, 1
3495, 1, 1636421334137, 1636421334465, 328, 1, 327, 0, 0, 0
3496, 1, 1636421334289, 1636421334553, 264, 1, 263, 0, 0, 0
3477, 1, 1636421334382, 1636421334649, 267, 0, 267, 0, 0, 0
3497, 1, 1636421334557, 1636421334829, 272, 0, 272, 0, 0, 0
3498, 1, 1636421334594, 1636421334857, 263, 0, 263, 0, 0, 0
3499, 1, 1636421334597, 1636421334861, 264, 1, 263, 0, 1, 1
3468, 1, 1636421334649, 1636421334918, 269, 1, 268, 1, 0, 1
3501, 1, 1636421334909, 1636421335174, 265, 1, 264, 0, 0, 0
3473, 1, 1636421334969, 1636421335237, 268, 1, 267, 0, 0, 0
3502, 1, 1636421335001, 1636421335265, 264, 1, 263, 0, 0, 0
3503, 1, 1636421335001, 1636421335265, 264, 1, 263, 1, 0, 1
3505, 1, 1636421335229, 1636421335494, 265, 1, 264, 0, 0, 0
3507, 1, 1636421335305, 1636421335570, 265, 1, 264, 0, 1, 1
3506, 1, 1636421335309, 1636421335573, 264, 1, 263, 0, 0, 0
3509, 1, 1636421335570, 1636421335833, 263, 0, 263, 0, 0, 0
3511, 1, 1636421335625, 1636421335894, 269, 1, 268, 0, 0, 0
3513, 1, 1636421335713, 1636421335981, 268, 0, 268, 0, 0, 0
3514, 1, 1636421335833, 1636421336101, 268, 1, 267, 1, 0, 1
3516, 1, 1636421335926, 1636421336190, 264, 0, 264, 0, 0, 0
3518, 1, 1636421335989, 1636421336253, 264, 1, 263, 0, 1, 1
3520, 1, 1636421336257, 1636421336521, 264, 0, 264, 0, 0, 0
3521, 1, 1636421336350, 1636421336617, 267, 0, 267, 0, 0, 0
3523, 1, 1636421336385, 1636421336650, 265, 1, 264, 0, 1, 1
3481, 1, 1636421336398, 1636421336669, 271, 0, 271, 0, 0, 0
3527, 1, 1636421336662, 1636421336930, 268, 0, 268, 0, 0, 0
3529, 1, 1636421336918, 1636421337182, 264, 0, 264, 0, 0, 0
3530, 1, 1636421337018, 1636421337286, 268, 0, 268, 0, 0, 0
3532, 1, 1636421337069, 1636421337342, 273, 0, 273, 0, 0, 0
3533, 1, 1636421337333, 1636421337598, 265, 0, 265, 0, 0, 0
3534, 1, 1636421337581, 1636421337846, 265, 1, 264, 0, 0, 0
3535, 1, 1636421337690, 1636421337954, 264, 0, 264, 0, 0, 0
3536, 1, 1636421337745, 1636421338010, 265, 1, 264, 1, 0, 1
3537, 1, 1636421338001, 1636421338265, 264, 1, 263, 0, 1, 1
3538, 1, 1636421338249, 1636421338518, 269, 1, 268, 0, 0, 0
3539, 1, 1636421338358, 1636421338622, 264, 0, 264, 0, 0, 0
3540, 1, 1636421338413, 1636421338678, 265, 1, 264, 0, 0, 0
3541, 1, 1636421338666, 1636421338930, 264, 0, 264, 0, 0, 0
3542, 1, 1636421338921, 1636421339185, 264, 1, 263, 0, 0, 0
3543, 1, 1636421339021, 1636421339285, 264, 1, 263, 0, 0, 0
3544, 1, 1636421339077, 1636421339346, 269, 1, 268, 1, 0, 1
3545, 1, 1636421339329, 1636421339593, 264, 1, 263, 0, 0, 0
3546, 1, 1636421339581, 1636421339849, 268, 0, 268, 0, 0, 0
3548, 1, 1636421339750, 1636421340017, 267, 0, 267, 0, 0, 0
3550, 1, 1636421340250, 1636421340514, 264, 0, 264, 0, 0, 0
3551, 1, 1636421340421, 1636421340690, 269, 1, 268, 0, 0, 0
3552, 1, 1636421340914, 1636421341178, 264, 0, 264, 0, 0, 0
3554, 1, 1636421341582, 1636421341850, 268, 0, 268, 0, 0, 0
3555, 1, 1636421342269, 1636421342534, 265, 1, 264, 0, 0, 0
3556, 1, 1636421342581, 1636421342850, 269, 1, 268, 0, 1, 1
3557, 1, 1636421342934, 1636421343202, 268, 0, 268, 0, 0, 0
3558, 1, 1636421343254, 1636421343517, 263, 0, 263, 0, 0, 0
3559, 1, 1636421343601, 1636421343866, 265, 1, 264, 0, 0, 0
3560, 1, 1636421343918, 1636421344182, 264, 0, 264, 0, 0, 0
3561, 1, 1636421344313, 1636421344578, 265, 1, 264, 0, 0, 0
3562, 1, 1636421344446, 1636421344734, 288, 0, 288, 0, 0, 0
3563, 1, 1636421344586, 1636421344850, 264, 0, 264, 0, 0, 0
3564, 1, 1636421345009, 1636421345278, 269, 1, 268, 0, 0, 0
3565, 1, 1636421345009, 1636421345282, 273, 0, 273, 0, 0, 0
3566, 1, 1636421345186, 1636421345453, 267, 0, 267, 0, 0, 0
3567, 1, 1636421345281, 1636421345589, 308, 1, 307, 0, 0, 0
3568, 1, 1636421345413, 1636421345686, 273, 0, 273, 0, 0, 0
3570, 1, 1636421345701, 1636421346013, 312, 1, 311, 0, 0, 0
3569, 1, 1636421345701, 1636421346014, 313, 1, 312, 0, 0, 0
3571, 1, 1636421345733, 1636421346014, 281, 0, 281, 0, 0, 0
3573, 1, 1636421345861, 1636421346133, 272, 0, 272, 0, 0, 0
3574, 1, 1636421346033, 1636421346301, 268, 1, 267, 0, 1, 1
3575, 1, 1636421346033, 1636421346302, 269, 1, 268, 0, 1, 1
3576, 1, 1636421346125, 1636421346389, 264, 1, 263, 0, 0, 0
3572, 1, 1636421346305, 1636421346569, 264, 0, 264, 0, 0, 0
3580, 1, 1636421346461, 1636421346741, 280, 1, 279, 0, 0, 0
3578, 1, 1636421346461, 1636421346742, 281, 1, 280, 1, 0, 1
3579, 1, 1636421346461, 1636421346745, 284, 1, 283, 1, 0, 1
3581, 1, 1636421346565, 1636421346829, 264, 1, 263, 0, 0, 0
3583, 1, 1636421346741, 1636421347005, 264, 1, 263, 0, 1, 1
3584, 1, 1636421346789, 1636421347093, 304, 0, 304, 0, 0, 0
3589, 1, 1636421347009, 1636421347273, 264, 1, 263, 1, 0, 1
3587, 1, 1636421347009, 1636421347273, 264, 1, 263, 1, 0, 1
3591, 1, 1636421347149, 1636421347413, 264, 1, 263, 1, 0, 1
3590, 1, 1636421347149, 1636421347422, 273, 1, 272, 0, 0, 0
3593, 1, 1636421347230, 1636421347497, 267, 0, 267, 0, 0, 0
3594, 1, 1636421347362, 1636421347633, 271, 0, 271, 0, 0, 0
3595, 1, 1636421347413, 1636421347677, 264, 1, 263, 1, 0, 1
3597, 1, 1636421347677, 1636421347942, 265, 1, 264, 0, 1, 1
3598, 1, 1636421347674, 1636421347942, 268, 0, 268, 0, 0, 0
3600, 1, 1636421347813, 1636421348081, 268, 1, 267, 0, 0, 0
3601, 1, 1636421347905, 1636421348169, 264, 0, 264, 0, 0, 0
3602, 1, 1636421348033, 1636421348298, 265, 1, 264, 0, 1, 1
3603, 1, 1636421348085, 1636421348345, 260, 0, 260, 0, 0, 0
3605, 1, 1636421348345, 1636421348614, 269, 1, 268, 0, 1, 1
3604, 1, 1636421348345, 1636421348614, 269, 1, 268, 0, 1, 1
3606, 1, 1636421348481, 1636421348746, 265, 1, 264, 0, 0, 0
3607, 1, 1636421348573, 1636421348838, 265, 0, 265, 0, 0, 0
3608, 1, 1636421348702, 1636421348970, 268, 0, 268, 0, 0, 0
3609, 1, 1636421348746, 1636421349009, 263, 1, 262, 0, 0, 0
3610, 1, 1636421349017, 1636421349281, 264, 1, 263, 1, 0, 1
3611, 1, 1636421349017, 1636421349285, 268, 1, 267, 0, 0, 0
3613, 1, 1636421349237, 1636421349502, 265, 0, 265, 0, 0, 0
3614, 1, 1636421349373, 1636421349638, 265, 0, 265, 0, 0, 0
3615, 1, 1636421349414, 1636421349677, 263, 0, 263, 0, 0, 0
3616, 1, 1636421349685, 1636421349953, 268, 1, 267, 0, 0, 0
3618, 1, 1636421349905, 1636421350178, 273, 0, 273, 0, 0, 0
3619, 1, 1636421350037, 1636421350302, 265, 1, 264, 0, 1, 1
3622, 1, 1636421350302, 1636421350565, 263, 0, 263, 0, 0, 0
3623, 1, 1636421350357, 1636421350621, 264, 1, 263, 0, 0, 0
3624, 1, 1636421350581, 1636421350850, 269, 0, 269, 0, 0, 0
3625, 1, 1636421350710, 1636421350974, 264, 0, 264, 0, 0, 0
3627, 1, 1636421351049, 1636421351313, 264, 1, 263, 0, 0, 0
3628, 1, 1636421351270, 1636421351534, 264, 0, 264, 0, 0, 0
3631, 1, 1636421351718, 1636421351982, 264, 0, 264, 0, 0, 0
3632, 1, 1636421351937, 1636421352202, 265, 1, 264, 0, 0, 0
3633, 1, 1636421352386, 1636421352650, 264, 0, 264, 0, 0, 0
3634, 1, 1636421352570, 1636421352833, 263, 0, 263, 0, 0, 0
3637, 1, 1636421352605, 1636421352874, 269, 1, 268, 0, 0, 0
3638, 1, 1636421353053, 1636421353317, 264, 1, 263, 0, 0, 0
3639, 1, 1636421353238, 1636421353501, 263, 0, 263, 0, 0, 0
3640, 1, 1636421353277, 1636421353542, 265, 1, 264, 0, 1, 1
3641, 1, 1636421353718, 1636421353982, 264, 0, 264, 0, 0, 0
3642, 1, 1636421353906, 1636421354174, 268, 0, 268, 0, 0, 0
3643, 1, 1636421353946, 1636421354210, 264, 0, 264, 0, 0, 0
3645, 1, 1636421354573, 1636421354837, 264, 1, 263, 0, 0, 0
3646, 1, 1636421354614, 1636421354878, 264, 0, 264, 0, 0, 0
3647, 1, 1636421355242, 1636421355506, 264, 0, 264, 0, 0, 0
3648, 1, 1636421355282, 1636421355550, 268, 0, 268, 0, 0, 0
3649, 1, 1636421355913, 1636421356182, 269, 0, 269, 0, 0, 0
3650, 1, 1636421355953, 1636421356222, 269, 0, 269, 0, 0, 0
3653, 1, 1636421356626, 1636421357053, 427, 0, 427, 0, 0, 0
3652, 1, 1636421356586, 1636421357053, 467, 0, 467, 0, 0, 0
3659, 1, 1636421357458, 1636421357722, 264, 0, 264, 0, 0, 0
3660, 1, 1636421357466, 1636421357734, 268, 0, 268, 0, 0, 0
3661, 1, 1636421357810, 1636421358077, 267, 0, 267, 0, 0, 0
3662, 1, 1636421358125, 1636421358389, 264, 1, 263, 0, 0, 0
3664, 1, 1636421358137, 1636421358401, 264, 0, 264, 0, 0, 0
3665, 1, 1636421358481, 1636421358746, 265, 1, 264, 0, 0, 0
3666, 1, 1636421358793, 1636421359062, 269, 1, 268, 0, 1, 1
3667, 1, 1636421358805, 1636421359078, 273, 1, 272, 0, 0, 0
3668, 1, 1636421359189, 1636421359454, 265, 1, 264, 0, 0, 0
3670, 1, 1636421359469, 1636421359782, 313, 1, 312, 0, 1, 1
3671, 1, 1636421359481, 1636421359782, 301, 1, 300, 0, 0, 0
3672, 1, 1636421359854, 1636421360126, 272, 0, 272, 0, 0, 0
3673, 1, 1636421360041, 1636421360305, 264, 0, 264, 0, 0, 0
3674, 1, 1636421360265, 1636421360530, 265, 1, 264, 0, 0, 0
3676, 1, 1636421360353, 1636421360618, 265, 0, 265, 0, 0, 0
3677, 1, 1636421360394, 1636421360658, 264, 0, 264, 0, 0, 0
3679, 1, 1636421360709, 1636421361014, 305, 1, 304, 0, 0, 0
3681, 1, 1636421361014, 1636421361282, 268, 0, 268, 0, 0, 0
3658, 1, 1636421362617, 1636421362882, 265, 1, 264, 1, 0, 1
3688, 1, 1636421363146, 1636421363413, 267, 0, 267, 0, 0, 0
3690, 1, 1636421363285, 1636421363550, 265, 1, 264, 0, 0, 0
3689, 1, 1636421363413, 1636421363678, 265, 1, 264, 1, 0, 1
3691, 1, 1636421363817, 1636421364081, 264, 1, 263, 0, 0, 0
3692, 1, 1636421363950, 1636421364214, 264, 0, 264, 0, 0, 0
3693, 1, 1636421364090, 1636421364354, 264, 0, 264, 0, 0, 0
3694, 1, 1636421364485, 1636421364750, 265, 1, 264, 0, 1, 1
3695, 1, 1636421364621, 1636421364886, 265, 1, 264, 0, 1, 1
3696, 1, 1636421364685, 1636421364949, 264, 0, 264, 0, 0, 0
3697, 1, 1636421364754, 1636421365018, 264, 0, 264, 0, 0, 0
3698, 1, 1636421365150, 1636421365414, 264, 0, 264, 0, 0, 0
3701, 1, 1636421365414, 1636421365678, 264, 1, 263, 0, 0, 0
3702, 1, 1636421365814, 1636421366077, 263, 0, 263, 0, 0, 0
3703, 1, 1636421366086, 1636421366350, 264, 0, 264, 0, 0, 0
3704, 1, 1636421366482, 1636421366750, 268, 0, 268, 0, 0, 0
3705, 1, 1636421366750, 1636421367014, 264, 0, 264, 0, 0, 0
3707, 1, 1636421367330, 1636421367594, 264, 0, 264, 0, 0, 0
3708, 1, 1636421367597, 1636421367862, 265, 1, 264, 0, 0, 0
3713, 1, 1636421367997, 1636421368265, 268, 0, 268, 0, 0, 0
3714, 1, 1636421368306, 1636421368570, 264, 0, 264, 0, 0, 0
3716, 1, 1636421368670, 1636421368938, 268, 0, 268, 0, 0, 0
3717, 1, 1636421368974, 1636421369238, 264, 0, 264, 0, 0, 0
3718, 1, 1636421369342, 1636421369610, 268, 0, 268, 0, 0, 0
3719, 1, 1636421369638, 1636421369902, 264, 0, 264, 0, 0, 0
3723, 1, 1636421370578, 1636421370845, 267, 0, 267, 0, 0, 0
3724, 1, 1636421370930, 1636421371197, 267, 0, 267, 0, 0, 0
3725, 1, 1636421371241, 1636421371505, 264, 0, 264, 0, 0, 0
3726, 1, 1636421371286, 1636421371550, 264, 0, 264, 0, 0, 0
3729, 1, 1636421371733, 1636421371998, 265, 0, 265, 0, 0, 0
3728, 1, 1636421371733, 1636421371998, 265, 0, 265, 0, 0, 0
3732, 1, 1636421372006, 1636421372269, 263, 0, 263, 0, 0, 0
3733, 1, 1636421372045, 1636421372310, 265, 0, 265, 0, 0, 0
3736, 1, 1636421372405, 1636421372674, 269, 1, 268, 0, 0, 0
3739, 1, 1636421372714, 1636421372982, 268, 0, 268, 0, 0, 0
3740, 1, 1636421373069, 1636421373337, 268, 1, 267, 0, 0, 0
3742, 1, 1636421373738, 1636421374006, 268, 0, 268, 0, 0, 0
3743, 1, 1636421374410, 1636421374678, 268, 0, 268, 0, 0, 0
3744, 1, 1636421375081, 1636421375345, 264, 0, 264, 0, 0, 0
3745, 1, 1636421375618, 1636421375882, 264, 0, 264, 0, 0, 0
3747, 1, 1636421375750, 1636421376017, 267, 0, 267, 0, 0, 0
3749, 1, 1636421376418, 1636421376686, 268, 0, 268, 0, 0, 0
3750, 1, 1636421377090, 1636421377354, 264, 0, 264, 0, 0, 0
3715, 1, 1636421377766, 1636421378033, 267, 0, 267, 0, 0, 0
3752, 1, 1636421377813, 1636421378081, 268, 0, 268, 0, 0, 0
3753, 1, 1636421378030, 1636421378294, 264, 0, 264, 0, 0, 0
3756, 1, 1636421378030, 1636421378302, 272, 0, 272, 0, 0, 0
3755, 1, 1636421378301, 1636421378565, 264, 1, 263, 0, 0, 0
3758, 1, 1636421378485, 1636421378749, 264, 0, 264, 0, 0, 0
3759, 1, 1636421378697, 1636421378962, 265, 1, 264, 0, 0, 0
3760, 1, 1636421378706, 1636421378978, 272, 0, 272, 0, 0, 0
3761, 1, 1636421378981, 1636421379245, 264, 1, 263, 0, 0, 0
3762, 1, 1636421379162, 1636421379425, 263, 0, 263, 0, 0, 0
3763, 1, 1636421379366, 1636421379629, 263, 0, 263, 0, 0, 0
3764, 1, 1636421379382, 1636421379650, 268, 0, 268, 0, 0, 0
3765, 1, 1636421379657, 1636421379921, 264, 1, 263, 0, 0, 0
3766, 1, 1636421379878, 1636421380141, 263, 0, 263, 0, 0, 0
3768, 1, 1636421380057, 1636421380354, 297, 1, 296, 0, 0, 0
3767, 1, 1636421380057, 1636421380354, 297, 1, 296, 0, 1, 1
3770, 1, 1636421380361, 1636421380630, 269, 1, 268, 0, 0, 0
3771, 1, 1636421380361, 1636421380630, 269, 1, 268, 0, 0, 0
3772, 1, 1636421380546, 1636421380809, 263, 0, 263, 0, 0, 0
3773, 1, 1636421380637, 1636421380901, 264, 0, 264, 0, 0, 0
3774, 1, 1636421380753, 1636421381018, 265, 1, 264, 0, 0, 0
3775, 1, 1636421380762, 1636421381026, 264, 0, 264, 0, 0, 0
3776, 1, 1636421381030, 1636421381293, 263, 0, 263, 0, 0, 0
3778, 1, 1636421381238, 1636421381506, 268, 0, 268, 0, 0, 0
3780, 1, 1636421381425, 1636421381689, 264, 0, 264, 0, 0, 0
3781, 1, 1636421381462, 1636421381726, 264, 0, 264, 0, 0, 0
3782, 1, 1636421381689, 1636421381997, 308, 1, 307, 1, 0, 1
3783, 1, 1636421381693, 1636421381997, 304, 0, 304, 0, 0, 0
3784, 1, 1636421381954, 1636421382217, 263, 0, 263, 0, 0, 0
3787, 1, 1636421382134, 1636421382441, 307, 0, 307, 0, 0, 0
3786, 1, 1636421382129, 1636421382441, 312, 1, 311, 0, 1, 1
3785, 1, 1636421382134, 1636421382441, 307, 0, 307, 0, 0, 0
3791, 1, 1636421382449, 1636421382713, 264, 1, 263, 1, 0, 1
3790, 1, 1636421382449, 1636421382721, 272, 1, 271, 1, 0, 1
3792, 1, 1636421382449, 1636421382721, 272, 1, 271, 0, 1, 1
3793, 1, 1636421382629, 1636421382893, 264, 1, 263, 0, 0, 0
3795, 1, 1636421382858, 1636421383122, 264, 0, 264, 0, 0, 0
3796, 1, 1636421382858, 1636421383133, 275, 0, 275, 0, 0, 0
3800, 1, 1636421383122, 1636421383425, 303, 1, 302, 0, 0, 0
3801, 1, 1636421383125, 1636421383426, 301, 0, 301, 0, 0, 0
3802, 1, 1636421383337, 1636421383605, 268, 1, 267, 0, 0, 0
3803, 1, 1636421383562, 1636421383825, 263, 0, 263, 0, 0, 0
3805, 1, 1636421383694, 1636421383974, 280, 0, 280, 0, 0, 0
3807, 1, 1636421383833, 1636421384097, 264, 0, 264, 0, 0, 0
3808, 1, 1636421384009, 1636421384278, 269, 1, 268, 0, 1, 1
3809, 1, 1636421384237, 1636421384502, 265, 0, 265, 0, 0, 0
3810, 1, 1636421384386, 1636421384654, 268, 0, 268, 0, 0, 0
3811, 1, 1636421384509, 1636421384774, 265, 1, 264, 0, 0, 0
3812, 1, 1636421384681, 1636421384946, 265, 1, 264, 1, 0, 1
3813, 1, 1636421384905, 1636421385170, 265, 1, 264, 0, 0, 0
3814, 1, 1636421385058, 1636421385325, 267, 0, 267, 0, 0, 0
3815, 1, 1636421385177, 1636421385446, 269, 1, 268, 0, 0, 0
3819, 1, 1636421385850, 1636421386118, 268, 0, 268, 0, 0, 0
3820, 1, 1636421385973, 1636421386242, 269, 0, 269, 0, 0, 0
3821, 1, 1636421386522, 1636421386789, 267, 0, 267, 0, 0, 0
3823, 1, 1636421386645, 1636421386910, 265, 0, 265, 0, 0, 0
3824, 1, 1636421387254, 1636421387518, 264, 0, 264, 0, 0, 0
3825, 1, 1636421387313, 1636421387578, 265, 1, 264, 0, 0, 0
3826, 1, 1636421387494, 1636421387762, 268, 0, 268, 0, 0, 0
3827, 1, 1636421387921, 1636421388185, 264, 0, 264, 0, 0, 0
3828, 1, 1636421387981, 1636421388246, 265, 1, 264, 1, 0, 1
3829, 1, 1636421388202, 1636421388477, 275, 0, 275, 0, 0, 0
3830, 1, 1636421388325, 1636421388590, 265, 1, 264, 1, 0, 1
3831, 1, 1636421388618, 1636421388886, 268, 0, 268, 0, 0, 0
3832, 1, 1636421388649, 1636421388914, 265, 1, 264, 0, 1, 1
3834, 1, 1636421388882, 1636421389145, 263, 0, 263, 0, 0, 0
3835, 1, 1636421388994, 1636421389262, 268, 0, 268, 0, 0, 0
3836, 1, 1636421389289, 1636421389558, 269, 1, 268, 0, 0, 0
3837, 1, 1636421389313, 1636421389578, 265, 0, 265, 0, 0, 0
3838, 1, 1636421389553, 1636421389817, 264, 1, 263, 1, 0, 1
3839, 1, 1636421389666, 1636421389930, 264, 0, 264, 0, 0, 0
3840, 1, 1636421389962, 1636421390226, 264, 0, 264, 0, 0, 0
3841, 1, 1636421390013, 1636421390277, 264, 1, 263, 0, 0, 0
3842, 1, 1636421390245, 1636421390514, 269, 1, 268, 1, 0, 1
3843, 1, 1636421390337, 1636421390602, 265, 1, 264, 0, 1, 1
3845, 1, 1636421390633, 1636421390898, 265, 1, 264, 1, 0, 1
3846, 1, 1636421390681, 1636421390946, 265, 1, 264, 0, 1, 1
3847, 1, 1636421390917, 1636421391186, 269, 0, 269, 0, 0, 0
3848, 1, 1636421391010, 1636421391274, 264, 0, 264, 0, 0, 0
3849, 1, 1636421391345, 1636421391613, 268, 1, 267, 0, 0, 0
3851, 1, 1636421391358, 1636421391622, 264, 0, 264, 0, 0, 0
3852, 1, 1636421391593, 1636421391858, 265, 1, 264, 0, 0, 0
3854, 1, 1636421391677, 1636421391946, 269, 1, 268, 0, 0, 0
3855, 1, 1636421392018, 1636421392281, 263, 0, 263, 0, 0, 0
3856, 1, 1636421392021, 1636421392285, 264, 1, 263, 0, 1, 1
3857, 1, 1636421392313, 1636421392581, 268, 1, 267, 0, 0, 0
3858, 1, 1636421392401, 1636421392669, 268, 1, 267, 0, 0, 0
3859, 1, 1636421392622, 1636421392890, 268, 0, 268, 0, 0, 0
3862, 1, 1636421392714, 1636421393022, 308, 0, 308, 0, 0, 0
3860, 1, 1636421392714, 1636421393022, 308, 1, 307, 0, 0, 0
3861, 1, 1636421392714, 1636421393025, 311, 0, 311, 0, 0, 0
3863, 1, 1636421393069, 1636421393333, 264, 1, 263, 1, 0, 1
3864, 1, 1636421393069, 1636421393333, 264, 1, 263, 0, 0, 0
3865, 1, 1636421393069, 1636421393333, 264, 1, 263, 1, 0, 1
3868, 1, 1636421393289, 1636421393557, 268, 0, 268, 0, 0, 0
3867, 1, 1636421393333, 1636421393609, 276, 1, 275, 1, 0, 1
3871, 1, 1636421393429, 1636421393693, 264, 1, 263, 0, 0, 0
3872, 1, 1636421393429, 1636421393694, 265, 1, 264, 0, 1, 1
3870, 1, 1636421393433, 1636421393697, 264, 0, 264, 0, 0, 0
3874, 1, 1636421393785, 1636421394050, 265, 1, 264, 0, 0, 0
3873, 1, 1636421393785, 1636421394050, 265, 1, 264, 0, 0, 0
3875, 1, 1636421393785, 1636421394053, 268, 1, 267, 1, 0, 1
3876, 1, 1636421393877, 1636421394141, 264, 0, 264, 0, 0, 0
3878, 1, 1636421394061, 1636421394325, 264, 0, 264, 0, 0, 0
3881, 1, 1636421394101, 1636421394365, 264, 0, 264, 0, 0, 0
3880, 1, 1636421394101, 1636421394373, 272, 0, 272, 0, 0, 0
3882, 1, 1636421394145, 1636421394409, 264, 1, 263, 0, 0, 0
3879, 1, 1636421394325, 1636421394593, 268, 1, 267, 1, 0, 1
3883, 1, 1636421394454, 1636421394717, 263, 0, 263, 0, 0, 0
3884, 1, 1636421394454, 1636421394717, 263, 0, 263, 0, 0, 0
3886, 1, 1636421394545, 1636421394809, 264, 0, 264, 0, 0, 0
3888, 1, 1636421394761, 1636421395026, 265, 1, 264, 0, 0, 0
3889, 1, 1636421394777, 1636421395045, 268, 1, 267, 0, 1, 1
3890, 1, 1636421394813, 1636421395077, 264, 0, 264, 0, 0, 0
3891, 1, 1636421394989, 1636421395254, 265, 0, 265, 0, 0, 0
3892, 1, 1636421395114, 1636421395390, 276, 0, 276, 0, 0, 0
3894, 1, 1636421395213, 1636421395477, 264, 1, 263, 0, 0, 0
3895, 1, 1636421395441, 1636421395705, 264, 0, 264, 0, 0, 0
3897, 1, 1636421395533, 1636421395802, 269, 1, 268, 0, 1, 1
3899, 1, 1636421395709, 1636421395973, 264, 1, 263, 0, 1, 1
3898, 1, 1636421395709, 1636421395977, 268, 1, 267, 1, 0, 1
3903, 1, 1636421396061, 1636421396326, 265, 1, 264, 0, 1, 1
3904, 1, 1636421396113, 1636421396377, 264, 0, 264, 0, 0, 0
3906, 1, 1636421396373, 1636421396637, 264, 0, 264, 0, 0, 0
3908, 1, 1636421396773, 1636421397037, 264, 1, 263, 0, 1, 1
3909, 1, 1636421396782, 1636421397045, 263, 0, 263, 0, 0, 0
3910, 1, 1636421396893, 1636421397158, 265, 0, 265, 0, 0, 0
3911, 1, 1636421397041, 1636421397306, 265, 0, 265, 0, 0, 0
3913, 1, 1636421397442, 1636421397705, 263, 0, 263, 0, 0, 0
3912, 1, 1636421397442, 1636421397705, 263, 0, 263, 0, 0, 0
3914, 1, 1636421397566, 1636421397830, 264, 0, 264, 0, 0, 0
3915, 1, 1636421397705, 1636421397970, 265, 1, 264, 0, 1, 1
3917, 1, 1636421398118, 1636421398390, 272, 0, 272, 0, 0, 0
3916, 1, 1636421398118, 1636421398390, 272, 0, 272, 0, 0, 0
3918, 1, 1636421398233, 1636421398502, 269, 1, 268, 0, 0, 0
3919, 1, 1636421398369, 1636421398634, 265, 0, 265, 0, 0, 0
3921, 1, 1636421398790, 1636421399053, 263, 0, 263, 0, 0, 0
3920, 1, 1636421398790, 1636421399054, 264, 0, 264, 0, 0, 0
3922, 1, 1636421398917, 1636421399182, 265, 0, 265, 0, 0, 0
3923, 1, 1636421399037, 1636421399302, 265, 0, 265, 0, 0, 0
3925, 1, 1636421399458, 1636421399721, 263, 0, 263, 0, 0, 0
3927, 1, 1636421399590, 1636421399853, 263, 0, 263, 0, 0, 0
3928, 1, 1636421399705, 1636421399973, 268, 1, 267, 0, 0, 0
3929, 1, 1636421400126, 1636421400398, 272, 0, 272, 0, 0, 0
3930, 1, 1636421400254, 1636421400518, 264, 0, 264, 0, 0, 0
3932, 1, 1636421400669, 1636421400933, 264, 1, 263, 0, 0, 0
3933, 1, 1636421400802, 1636421401066, 264, 0, 264, 0, 0, 0
3934, 1, 1636421400921, 1636421401185, 264, 1, 263, 0, 0, 0
3935, 1, 1636421401337, 1636421401602, 265, 1, 264, 0, 0, 0
3936, 1, 1636421401477, 1636421401742, 265, 1, 264, 0, 1, 1
3937, 1, 1636421401593, 1636421401861, 268, 1, 267, 0, 0, 0
3938, 1, 1636421401653, 1636421401918, 265, 1, 264, 0, 0, 0
3939, 1, 1636421401921, 1636421402185, 264, 0, 264, 0, 0, 0
3940, 1, 1636421402002, 1636421402270, 268, 0, 268, 0, 0, 0
3941, 1, 1636421402149, 1636421402414, 265, 0, 265, 0, 0, 0
3942, 1, 1636421402262, 1636421402530, 268, 0, 268, 0, 0, 0
3943, 1, 1636421402317, 1636421402585, 268, 1, 267, 0, 0, 0
3944, 1, 1636421402585, 1636421402849, 264, 1, 263, 1, 0, 1
3945, 1, 1636421402662, 1636421402926, 264, 0, 264, 0, 0, 0
3946, 1, 1636421402822, 1636421403086, 264, 0, 264, 0, 0, 0
3947, 1, 1636421402942, 1636421403209, 267, 0, 267, 0, 0, 0
3948, 1, 1636421403029, 1636421403297, 268, 0, 268, 0, 0, 0
3949, 1, 1636421403301, 1636421403566, 265, 1, 264, 0, 1, 1
3950, 1, 1636421403382, 1636421403646, 264, 0, 264, 0, 0, 0
3951, 1, 1636421403474, 1636421403738, 264, 0, 264, 0, 0, 0
3953, 1, 1636421403610, 1636421403874, 264, 0, 264, 0, 0, 0
3954, 1, 1636421403697, 1636421403962, 265, 0, 265, 0, 0, 0
3955, 1, 1636421403738, 1636421404049, 311, 0, 311, 0, 0, 0
3956, 1, 1636421403966, 1636421404229, 263, 0, 263, 0, 0, 0
3957, 1, 1636421404053, 1636421404317, 264, 1, 263, 0, 0, 0
3958, 1, 1636421404145, 1636421404409, 264, 0, 264, 0, 0, 0
3959, 1, 1636421404321, 1636421404585, 264, 1, 263, 1, 0, 1
3960, 1, 1636421404321, 1636421404585, 264, 1, 263, 0, 1, 1
3961, 1, 1636421404361, 1636421404626, 265, 0, 265, 0, 0, 0
3962, 1, 1636421404454, 1636421404717, 263, 0, 263, 0, 0, 0
3963, 1, 1636421404626, 1636421404889, 263, 0, 263, 0, 0, 0
3964, 1, 1636421404709, 1636421404974, 265, 1, 264, 0, 0, 0
3965, 1, 1636421404769, 1636421405033, 264, 1, 263, 1, 0, 1
3968, 1, 1636421404985, 1636421405253, 268, 1, 267, 1, 0, 1
3967, 1, 1636421404985, 1636421405257, 272, 1, 271, 0, 0, 0
3969, 1, 1636421405026, 1636421405293, 267, 0, 267, 0, 0, 0
3970, 1, 1636421405077, 1636421405345, 268, 0, 268, 0, 0, 0
3972, 1, 1636421405313, 1636421405582, 269, 1, 268, 0, 0, 0
3973, 1, 1636421405405, 1636421405673, 268, 1, 267, 0, 1, 1
3975, 1, 1636421405438, 1636421405701, 263, 0, 263, 0, 0, 0
3976, 1, 1636421405665, 1636421405965, 300, 1, 299, 0, 0, 0
3977, 1, 1636421405665, 1636421405966, 301, 1, 300, 0, 0, 0
3978, 1, 1636421405697, 1636421405966, 269, 1, 268, 0, 0, 0
3979, 1, 1636421405789, 1636421406053, 264, 1, 263, 1, 0, 1
3980, 1, 1636421405789, 1636421406057, 268, 1, 267, 0, 1, 1
3981, 1, 1636421406010, 1636421406273, 263, 0, 263, 0, 0, 0
3982, 1, 1636421406101, 1636421406366, 265, 1, 264, 0, 0, 0
3983, 1, 1636421406101, 1636421406369, 268, 1, 267, 1, 0, 1
3986, 1, 1636421406189, 1636421406454, 265, 0, 265, 0, 0, 0
3985, 1, 1636421406189, 1636421406457, 268, 1, 267, 0, 0, 0
3987, 1, 1636421406386, 1636421406653, 267, 0, 267, 0, 0, 0
3988, 1, 1636421406430, 1636421406693, 263, 0, 263, 0, 0, 0
3990, 1, 1636421406473, 1636421406737, 264, 1, 263, 1, 0, 1
3992, 1, 1636421406513, 1636421406778, 265, 1, 264, 0, 0, 0
3993, 1, 1636421406697, 1636421406965, 268, 1, 267, 0, 0, 0
3995, 1, 1636421406766, 1636421407029, 263, 0, 263, 0, 0, 0
3997, 1, 1636421406862, 1636421407126, 264, 0, 264, 0, 0, 0
3998, 1, 1636421406965, 1636421407233, 268, 1, 267, 1, 0, 1
3999, 1, 1636421407053, 1636421407321, 268, 1, 267, 0, 1, 1
4000, 1, 1636421407093, 1636421407357, 264, 1, 263, 0, 0, 0
4002, 1, 1636421407181, 1636421407446, 265, 1, 264, 0, 0, 0
4003, 1, 1636421407365, 1636421407634, 269, 1, 268, 0, 0, 0
4004, 1, 1636421407430, 1636421407693, 263, 0, 263, 0, 0, 0
4005, 1, 1636421407529, 1636421407798, 269, 1, 268, 0, 0, 0
4007, 1, 1636421407726, 1636421407993, 267, 0, 267, 0, 0, 0
4008, 1, 1636421407761, 1636421408026, 265, 1, 264, 0, 0, 0
4009, 1, 1636421407850, 1636421408118, 268, 0, 268, 0, 0, 0
4010, 1, 1636421408030, 1636421408297, 267, 0, 267, 0, 0, 0
4012, 1, 1636421408201, 1636421408466, 265, 0, 265, 0, 0, 0
4013, 1, 1636421408397, 1636421408665, 268, 1, 267, 0, 0, 0
4014, 1, 1636421408433, 1636421408698, 265, 1, 264, 0, 0, 0
4015, 1, 1636421408534, 1636421408802, 268, 0, 268, 0, 0, 0
4016, 1, 1636421408706, 1636421408970, 264, 0, 264, 0, 0, 0
4017, 1, 1636421408869, 1636421409133, 264, 1, 263, 0, 1, 1
4019, 1, 1636421409101, 1636421409365, 264, 1, 263, 0, 0, 0
4018, 1, 1636421409101, 1636421409369, 268, 1, 267, 1, 0, 1
4020, 1, 1636421409241, 1636421409505, 264, 1, 263, 1, 0, 1
4021, 1, 1636421409413, 1636421409677, 264, 1, 263, 1, 0, 1
4022, 1, 1636421409413, 1636421409677, 264, 1, 263, 0, 1, 1
4023, 1, 1636421409549, 1636421409817, 268, 0, 268, 0, 0, 0
4024, 1, 1636421409765, 1636421410030, 265, 0, 265, 0, 0, 0
4025, 1, 1636421409769, 1636421410033, 264, 1, 263, 0, 0, 0
4026, 1, 1636421409769, 1636421410033, 264, 1, 263, 1, 0, 1
4027, 1, 1636421409914, 1636421410177, 263, 0, 263, 0, 0, 0
4029, 1, 1636421410077, 1636421410341, 264, 1, 263, 0, 0, 0
4028, 1, 1636421410077, 1636421410341, 264, 1, 263, 1, 0, 1
4030, 1, 1636421410218, 1636421410486, 268, 0, 268, 0, 0, 0
4033, 1, 1636421410453, 1636421410717, 264, 0, 264, 0, 0, 0
4034, 1, 1636421410590, 1636421410857, 267, 0, 267, 0, 0, 0
4037, 1, 1636421410745, 1636421411010, 265, 1, 264, 0, 0, 0
4036, 1, 1636421410745, 1636421411010, 265, 1, 264, 0, 1, 1
4038, 1, 1636421410886, 1636421411149, 263, 0, 263, 0, 0, 0
4039, 1, 1636421411122, 1636421411393, 271, 0, 271, 0, 0, 0
4040, 1, 1636421411261, 1636421411525, 264, 1, 263, 1, 0, 1
4041, 1, 1636421411417, 1636421411685, 268, 1, 267, 0, 1, 1
4042, 1, 1636421411417, 1636421411686, 269, 1, 268, 0, 1, 1
4043, 1, 1636421411553, 1636421411821, 268, 1, 267, 0, 0, 0
4044, 1, 1636421411797, 1636421412061, 264, 1, 263, 0, 0, 0
4045, 1, 1636421411926, 1636421412189, 263, 0, 263, 0, 0, 0
4047, 1, 1636421412085, 1636421412353, 268, 1, 267, 0, 0, 0
4046, 1, 1636421412085, 1636421412353, 268, 1, 267, 1, 0, 1
4048, 1, 1636421412229, 1636421412494, 265, 1, 264, 0, 0, 0
4049, 1, 1636421412465, 1636421412729, 264, 1, 263, 0, 0, 0
4050, 1, 1636421412593, 1636421412857, 264, 1, 263, 1, 0, 1
4052, 1, 1636421412757, 1636421413021, 264, 0, 264, 0, 0, 0
4051, 1, 1636421412757, 1636421413021, 264, 0, 264, 0, 0, 0
4053, 1, 1636421412893, 1636421413166, 273, 1, 272, 0, 0, 0
4054, 1, 1636421413133, 1636421413397, 264, 1, 263, 0, 0, 0
4055, 1, 1636421413257, 1636421413554, 297, 0, 297, 0, 0, 0
4056, 1, 1636421413422, 1636421413686, 264, 0, 264, 0, 0, 0
4057, 1, 1636421413469, 1636421413733, 264, 0, 264, 0, 0, 0
4059, 1, 1636421413806, 1636421414070, 264, 0, 264, 0, 0, 0
4060, 1, 1636421413821, 1636421414097, 276, 1, 275, 0, 0, 0
4062, 1, 1636421414085, 1636421414354, 269, 1, 268, 0, 0, 0
4063, 1, 1636421414142, 1636421414406, 264, 0, 264, 0, 0, 0
4064, 1, 1636421414473, 1636421414741, 268, 1, 267, 1, 0, 1
4065, 1, 1636421414502, 1636421414774, 272, 0, 272, 0, 0, 0
4066, 1, 1636421414773, 1636421415046, 273, 1, 272, 0, 0, 0
4067, 1, 1636421414810, 1636421415073, 263, 0, 263, 0, 0, 0
4068, 1, 1636421415125, 1636421415390, 265, 1, 264, 0, 0, 0
4070, 1, 1636421415213, 1636421415482, 269, 1, 268, 1, 0, 1
4073, 1, 1636421415477, 1636421415742, 265, 1, 264, 0, 0, 0
4072, 1, 1636421415477, 1636421415742, 265, 1, 264, 1, 0, 1
4074, 1, 1636421415733, 1636421416001, 268, 0, 268, 0, 0, 0
4075, 1, 1636421415789, 1636421416053, 264, 0, 264, 0, 0, 0
4076, 1, 1636421415882, 1636421416189, 307, 0, 307, 0, 0, 0
4077, 1, 1636421416137, 1636421416425, 288, 0, 288, 0, 0, 0
4078, 1, 1636421416141, 1636421416429, 288, 1, 287, 0, 1, 1
4079, 1, 1636421416433, 1636421416737, 304, 0, 304, 0, 0, 0
4080, 1, 1636421416561, 1636421416826, 265, 1, 264, 0, 0, 0
4081, 1, 1636421416561, 1636421416826, 265, 1, 264, 0, 0, 0
4082, 1, 1636421416637, 1636421416901, 264, 0, 264, 0, 0, 0
4083, 1, 1636421416745, 1636421417010, 265, 1, 264, 0, 0, 0
4086, 1, 1636421416877, 1636421417182, 305, 0, 305, 0, 0, 0
4088, 1, 1636421417101, 1636421417369, 268, 1, 267, 0, 1, 1
4091, 1, 1636421417237, 1636421417501, 264, 1, 263, 0, 0, 0
4092, 1, 1636421417318, 1636421417582, 264, 0, 264, 0, 0, 0
4093, 1, 1636421417409, 1636421417678, 269, 0, 269, 0, 0, 0
4094, 1, 1636421417449, 1636421417714, 265, 1, 264, 0, 0, 0
4096, 1, 1636421417813, 1636421418077, 264, 1, 263, 0, 0, 0
4098, 1, 1636421417958, 1636421418221, 263, 0, 263, 0, 0, 0
4099, 1, 1636421417986, 1636421418250, 264, 0, 264, 0, 0, 0
4100, 1, 1636421418078, 1636421418341, 263, 0, 263, 0, 0, 0
4101, 1, 1636421418137, 1636421418401, 264, 1, 263, 0, 0, 0
4103, 1, 1636421418478, 1636421418742, 264, 0, 264, 0, 0, 0
4104, 1, 1636421418626, 1636421418889, 263, 0, 263, 0, 0, 0
4105, 1, 1636421418749, 1636421419018, 269, 0, 269, 0, 0, 0
4106, 1, 1636421418809, 1636421419074, 265, 1, 264, 0, 1, 1
4107, 1, 1636421419145, 1636421419414, 269, 1, 268, 0, 0, 0
4108, 1, 1636421419294, 1636421419557, 263, 0, 263, 0, 0, 0
4109, 1, 1636421419421, 1636421419686, 265, 1, 264, 0, 0, 0
4110, 1, 1636421419473, 1636421419737, 264, 1, 263, 0, 1, 1
4111, 1, 1636421419818, 1636421420081, 263, 0, 263, 0, 0, 0
4113, 1, 1636421420089, 1636421420354, 265, 0, 265, 0, 0, 0
4114, 1, 1636421420141, 1636421420406, 265, 0, 265, 0, 0, 0
4115, 1, 1636421420570, 1636421420838, 268, 0, 268, 0, 0, 0
4116, 1, 1636421420753, 1636421421025, 272, 0, 272, 0, 0, 0
4117, 1, 1636421420797, 1636421421061, 264, 0, 264, 0, 0, 0
4119, 1, 1636421420838, 1636421421101, 263, 0, 263, 0, 0, 0
4120, 1, 1636421421009, 1636421421274, 265, 1, 264, 0, 1, 1
4121, 1, 1636421421242, 1636421421505, 263, 0, 263, 0, 0, 0
4122, 1, 1636421421425, 1636421421694, 269, 1, 268, 0, 0, 0
4124, 1, 1636421421518, 1636421421786, 268, 0, 268, 0, 0, 0
4125, 1, 1636421421677, 1636421421942, 265, 1, 264, 0, 0, 0
4126, 1, 1636421421910, 1636421422174, 264, 0, 264, 0, 0, 0
4127, 1, 1636421422098, 1636421422362, 264, 0, 264, 0, 0, 0
4128, 1, 1636421422189, 1636421422454, 265, 0, 265, 0, 0, 0
4130, 1, 1636421422582, 1636421422845, 263, 0, 263, 0, 0, 0
4131, 1, 1636421422766, 1636421423034, 268, 0, 268, 0, 0, 0
4132, 1, 1636421422857, 1636421423121, 264, 1, 263, 1, 0, 1
4133, 1, 1636421423250, 1636421423514, 264, 0, 264, 0, 0, 0
4134, 1, 1636421423469, 1636421423734, 265, 1, 264, 0, 0, 0
4135, 1, 1636421423561, 1636421423826, 265, 0, 265, 0, 0, 0
4136, 1, 1636421423913, 1636421424178, 265, 1, 264, 0, 0, 0
4137, 1, 1636421423917, 1636421424182, 265, 1, 264, 0, 0, 0
4139, 1, 1636421424229, 1636421424494, 265, 0, 265, 0, 0, 0
4140, 1, 1636421424265, 1636421424534, 269, 0, 269, 0, 0, 0
4141, 1, 1636421424581, 1636421424850, 269, 1, 268, 0, 1, 1
4144, 1, 1636421424937, 1636421425202, 265, 1, 264, 0, 0, 0
4145, 1, 1636421425253, 1636421425522, 269, 0, 269, 0, 0, 0
4146, 1, 1636421425454, 1636421425722, 268, 0, 268, 0, 0, 0
4147, 1, 1636421425610, 1636421425874, 264, 0, 264, 0, 0, 0
4148, 1, 1636421425782, 1636421426050, 268, 0, 268, 0, 0, 0
4149, 1, 1636421425929, 1636421426194, 265, 1, 264, 0, 0, 0
4151, 1, 1636421426273, 1636421426538, 265, 1, 264, 0, 0, 0
4153, 1, 1636421426593, 1636421426862, 269, 1, 268, 0, 0, 0
4154, 1, 1636421427006, 1636421427274, 268, 0, 268, 0, 0, 0
4157, 1, 1636421427281, 1636421427545, 264, 1, 263, 0, 0, 0
4158, 1, 1636421427345, 1636421427629, 284, 1, 283, 0, 0, 0
4159, 1, 1636421427454, 1636421427725, 271, 0, 271, 0, 0, 0
4160, 1, 1636421427545, 1636421427813, 268, 1, 267, 0, 0, 0
4161, 1, 1636421427669, 1636421427945, 276, 0, 276, 0, 0, 0
4162, 1, 1636421427898, 1636421428161, 263, 0, 263, 0, 0, 0
4163, 1, 1636421427945, 1636421428209, 264, 0, 264, 0, 0, 0
4164, 1, 1636421428029, 1636421428293, 264, 1, 263, 0, 0, 0
4165, 1, 1636421428133, 1636421428433, 300, 1, 299, 0, 0, 0
4167, 1, 1636421428205, 1636421428469, 264, 1, 263, 0, 0, 0
4166, 1, 1636421428205, 1636421428473, 268, 1, 267, 1, 0, 1
4168, 1, 1636421428349, 1636421428613, 264, 1, 263, 0, 1, 1
4169, 1, 1636421428561, 1636421428825, 264, 1, 263, 1, 0, 1
4171, 1, 1636421428697, 1636421428966, 269, 1, 268, 0, 1, 1
4170, 1, 1636421428697, 1636421428966, 269, 1, 268, 0, 0, 0
4172, 1, 1636421428845, 1636421429109, 264, 1, 263, 0, 0, 0
4173, 1, 1636421428869, 1636421429134, 265, 1, 264, 0, 0, 0
4174, 1, 1636421428877, 1636421429141, 264, 0, 264, 0, 0, 0
4175, 1, 1636421429229, 1636421429493, 264, 1, 263, 0, 0, 0
4176, 1, 1636421429365, 1636421429629, 264, 0, 264, 0, 0, 0
4177, 1, 1636421429365, 1636421429629, 264, 1, 263, 0, 0, 0
4180, 1, 1636421429541, 1636421429805, 264, 1, 263, 0, 0, 0
4179, 1, 1636421429541, 1636421429805, 264, 1, 263, 1, 0, 1
4181, 1, 1636421429917, 1636421430182, 265, 1, 264, 0, 0, 0
4182, 1, 1636421430053, 1636421430321, 268, 1, 267, 0, 1, 1
4184, 1, 1636421430209, 1636421430482, 273, 1, 272, 0, 1, 1
4186, 1, 1636421430265, 1636421430529, 264, 0, 264, 0, 0, 0
4187, 1, 1636421430589, 1636421430854, 265, 1, 264, 0, 0, 0
4188, 1, 1636421430750, 1636421431013, 263, 0, 263, 0, 0, 0
4189, 1, 1636421430882, 1636421431146, 264, 0, 264, 0, 0, 0
4190, 1, 1636421430969, 1636421431233, 264, 1, 263, 0, 0, 0
4192, 1, 1636421431261, 1636421431525, 264, 1, 263, 1, 0, 1
4193, 1, 1636421431425, 1636421431690, 265, 1, 264, 0, 0, 0
4194, 1, 1636421431558, 1636421431822, 264, 0, 264, 0, 0, 0
4195, 1, 1636421431645, 1636421431909, 264, 0, 264, 0, 0, 0
4197, 1, 1636421431930, 1636421432194, 264, 0, 264, 0, 0, 0
4198, 1, 1636421432093, 1636421432381, 288, 1, 287, 1, 0, 1
4199, 1, 1636421432217, 1636421432482, 265, 1, 264, 0, 0, 0
4200, 1, 1636421432305, 1636421432569, 264, 0, 264, 0, 0, 0
4201, 1, 1636421432594, 1636421432857, 263, 0, 263, 0, 0, 0
4202, 1, 1636421432645, 1636421432910, 265, 1, 264, 0, 0, 0
4203, 1, 1636421432790, 1636421433058, 268, 0, 268, 0, 0, 0
4204, 1, 1636421432881, 1636421433146, 265, 1, 264, 1, 0, 1
4205, 1, 1636421432973, 1636421433238, 265, 1, 264, 0, 0, 0
4206, 1, 1636421433262, 1636421433529, 267, 0, 267, 0, 0, 0
4207, 1, 1636421433309, 1636421433577, 268, 1, 267, 0, 0, 0
4208, 1, 1636421433458, 1636421433721, 263, 0, 263, 0, 0, 0
4209, 1, 1636421433541, 1636421433805, 264, 1, 263, 0, 0, 0
4210, 1, 1636421433646, 1636421433909, 263, 0, 263, 0, 0, 0
4211, 1, 1636421433934, 1636421434197, 263, 0, 263, 0, 0, 0
4212, 1, 1636421434001, 1636421434265, 264, 1, 263, 0, 0, 0
4213, 1, 1636421434125, 1636421434390, 265, 1, 264, 1, 0, 1
4214, 1, 1636421434221, 1636421434490, 269, 0, 269, 0, 0, 0
4215, 1, 1636421434313, 1636421434626, 313, 0, 313, 0, 0, 0
4216, 1, 1636421434449, 1636421434722, 273, 0, 273, 0, 0, 0
4217, 1, 1636421434633, 1636421434937, 304, 1, 303, 0, 0, 0
4220, 1, 1636421434890, 1636421435157, 267, 0, 267, 0, 0, 0
4222, 1, 1636421435029, 1636421435294, 265, 1, 264, 0, 0, 0
4223, 1, 1636421435122, 1636421435386, 264, 0, 264, 0, 0, 0
4224, 1, 1636421435205, 1636421435470, 265, 1, 264, 0, 1, 1
4226, 1, 1636421435558, 1636421435825, 267, 0, 267, 0, 0, 0
4227, 1, 1636421435693, 1636421435958, 265, 1, 264, 0, 0, 0
4228, 1, 1636421435782, 1636421436046, 264, 0, 264, 0, 0, 0
4229, 1, 1636421435870, 1636421436165, 295, 0, 295, 0, 0, 0
4230, 1, 1636421436225, 1636421436493, 268, 1, 267, 1, 0, 1
4231, 1, 1636421436357, 1636421436621, 264, 1, 263, 0, 0, 0
4233, 1, 1636421436449, 1636421436714, 265, 1, 264, 0, 0, 0
4234, 1, 1636421436566, 1636421436830, 264, 0, 264, 0, 0, 0
4236, 1, 1636421436901, 1636421437170, 269, 1, 268, 0, 0, 0
4237, 1, 1636421437054, 1636421437321, 267, 0, 267, 0, 0, 0
4238, 1, 1636421437145, 1636421437410, 265, 1, 264, 0, 0, 0
4239, 1, 1636421437237, 1636421437505, 268, 1, 267, 0, 0, 0
4240, 1, 1636421437498, 1636421437769, 271, 0, 271, 0, 0, 0
4241, 1, 1636421437569, 1636421437834, 265, 1, 264, 0, 0, 0
4242, 1, 1636421437589, 1636421437857, 268, 1, 267, 0, 1, 1
4244, 1, 1636421437810, 1636421438073, 263, 0, 263, 0, 0, 0
4245, 1, 1636421437905, 1636421438169, 264, 0, 264, 0, 0, 0
4246, 1, 1636421438169, 1636421438434, 265, 1, 264, 0, 0, 0
4247, 1, 1636421438237, 1636421438501, 264, 0, 264, 0, 0, 0
4248, 1, 1636421438261, 1636421438529, 268, 0, 268, 0, 0, 0
4249, 1, 1636421438474, 1636421438738, 264, 0, 264, 0, 0, 0
4250, 1, 1636421438565, 1636421438830, 265, 0, 265, 0, 0, 0
4251, 1, 1636421438833, 1636421439097, 264, 0, 264, 0, 0, 0
4252, 1, 1636421438910, 1636421439174, 264, 0, 264, 0, 0, 0
4254, 1, 1636421439230, 1636421439493, 263, 0, 263, 0, 0, 0
4255, 1, 1636421439497, 1636421439766, 269, 1, 268, 0, 1, 1
4256, 1, 1636421439821, 1636421440094, 273, 1, 272, 0, 1, 1
4257, 1, 1636421440166, 1636421440429, 263, 0, 263, 0, 0, 0
4258, 1, 1636421440381, 1636421440646, 265, 1, 264, 1, 0, 1
4259, 1, 1636421440498, 1636421440766, 268, 0, 268, 0, 0, 0
4260, 1, 1636421440522, 1636421440789, 267, 0, 267, 0, 0, 0
4261, 1, 1636421440834, 1636421441142, 308, 0, 308, 0, 0, 0
4262, 1, 1636421441062, 1636421441326, 264, 0, 264, 0, 0, 0
4264, 1, 1636421441202, 1636421441465, 263, 0, 263, 0, 0, 0
4263, 1, 1636421441202, 1636421441465, 263, 0, 263, 0, 0, 0
4265, 1, 1636421441417, 1636421441682, 265, 0, 265, 0, 0, 0
4266, 1, 1636421441550, 1636421441817, 267, 0, 267, 0, 0, 0
4267, 1, 1636421441737, 1636421442002, 265, 0, 265, 0, 0, 0
4268, 1, 1636421441870, 1636421442133, 263, 0, 263, 0, 0, 0
4269, 1, 1636421441869, 1636421442133, 264, 0, 264, 0, 0, 0
4271, 1, 1636421442089, 1636421442353, 264, 0, 264, 0, 0, 0
4272, 1, 1636421442221, 1636421442490, 269, 1, 268, 0, 1, 1
4275, 1, 1636421442537, 1636421442801, 264, 1, 263, 1, 0, 1
4274, 1, 1636421442537, 1636421442805, 268, 1, 267, 0, 0, 0
4276, 1, 1636421442757, 1636421443022, 265, 1, 264, 0, 0, 0
4277, 1, 1636421442893, 1636421443158, 265, 1, 264, 0, 1, 1
4279, 1, 1636421443201, 1636421443466, 265, 1, 264, 1, 0, 1
4278, 1, 1636421443205, 1636421443469, 264, 1, 263, 0, 1, 1
4280, 1, 1636421443421, 1636421443686, 265, 1, 264, 0, 1, 1
4281, 1, 1636421443558, 1636421443822, 264, 0, 264, 0, 0, 0
4282, 1, 1636421443869, 1636421444134, 265, 1, 264, 1, 0, 1
4283, 1, 1636421443869, 1636421444137, 268, 1, 267, 1, 0, 1
4284, 1, 1636421444089, 1636421444354, 265, 1, 264, 0, 0, 0
4285, 1, 1636421444222, 1636421444485, 263, 0, 263, 0, 0, 0
4287, 1, 1636421444541, 1636421444838, 297, 1, 296, 0, 0, 0
4286, 1, 1636421444541, 1636421444838, 297, 1, 296, 0, 0, 0
4288, 1, 1636421444770, 1636421445033, 263, 0, 263, 0, 0, 0
4290, 1, 1636421444985, 1636421445249, 264, 1, 263, 0, 0, 0
4292, 1, 1636421445206, 1636421445470, 264, 0, 264, 0, 0, 0
4293, 1, 1636421445237, 1636421445502, 265, 1, 264, 0, 0, 0
4294, 1, 1636421445245, 1636421445517, 272, 1, 271, 1, 0, 1
4295, 1, 1636421445429, 1636421445693, 264, 0, 264, 0, 0, 0
4296, 1, 1636421445653, 1636421445917, 264, 1, 263, 1, 0, 1
4297, 1, 1636421445653, 1636421445917, 264, 1, 263, 0, 1, 1
4298, 1, 1636421445870, 1636421446133, 263, 0, 263, 0, 0, 0
4299, 1, 1636421445905, 1636421446169, 264, 1, 263, 0, 0, 0
4300, 1, 1636421445917, 1636421446181, 264, 1, 263, 0, 1, 1
4301, 1, 1636421446097, 1636421446361, 264, 1, 263, 1, 0, 1
4302, 1, 1636421446317, 1636421446581, 264, 1, 263, 0, 0, 0
4303, 1, 1636421446317, 1636421446589, 272, 1, 271, 1, 0, 1
4304, 1, 1636421446534, 1636421446801, 267, 0, 267, 0, 0, 0
4306, 1, 1636421446625, 1636421446890, 265, 1, 264, 0, 0, 0
4305, 1, 1636421446625, 1636421446890, 265, 1, 264, 0, 0, 0
4308, 1, 1636421446805, 1636421447069, 264, 0, 264, 0, 0, 0
4309, 1, 1636421446981, 1636421447246, 265, 1, 264, 1, 0, 1
4310, 1, 1636421446985, 1636421447249, 264, 0, 264, 0, 0, 0
4312, 1, 1636421447202, 1636421447469, 267, 0, 267, 0, 0, 0
4313, 1, 1636421447293, 1636421447561, 268, 1, 267, 0, 1, 1
4315, 1, 1636421447482, 1636421447769, 287, 0, 287, 0, 0, 0
4316, 1, 1636421447682, 1636421447946, 264, 0, 264, 0, 0, 0
4317, 1, 1636421447682, 1636421447946, 264, 0, 264, 0, 0, 0
4318, 1, 1636421447901, 1636421448165, 264, 1, 263, 0, 0, 0
4320, 1, 1636421448034, 1636421448302, 268, 0, 268, 0, 0, 0
4321, 1, 1636421448169, 1636421448434, 265, 0, 265, 0, 0, 0
4323, 1, 1636421448345, 1636421448610, 265, 0, 265, 0, 0, 0
4322, 1, 1636421448345, 1636421448618, 273, 0, 273, 0, 0, 0
4324, 1, 1636421448566, 1636421448829, 263, 0, 263, 0, 0, 0
4325, 1, 1636421448701, 1636421448974, 273, 1, 272, 0, 0, 0
4328, 1, 1636421449025, 1636421449294, 269, 1, 268, 1, 0, 1
4327, 1, 1636421449025, 1636421449294, 269, 1, 268, 0, 0, 0
4329, 1, 1636421449234, 1636421449498, 264, 0, 264, 0, 0, 0
4330, 1, 1636421449241, 1636421449506, 265, 1, 264, 1, 0, 1
4331, 1, 1636421449374, 1636421449638, 264, 0, 264, 0, 0, 0
4334, 1, 1636421449917, 1636421450186, 269, 1, 268, 0, 0, 0
4335, 1, 1636421450042, 1636421450306, 264, 0, 264, 0, 0, 0
4336, 1, 1636421450590, 1636421450854, 264, 0, 264, 0, 0, 0
4337, 1, 1636421450706, 1636421450970, 264, 0, 264, 0, 0, 0
4339, 1, 1636421451374, 1636421451641, 267, 0, 267, 0, 0, 0
4341, 1, 1636421452394, 1636421452657, 263, 0, 263, 0, 0, 0
4342, 1, 1636421452702, 1636421452970, 268, 0, 268, 0, 0, 0
4343, 1, 1636421453062, 1636421453329, 267, 0, 267, 0, 0, 0
4344, 1, 1636421453369, 1636421453638, 269, 1, 268, 0, 1, 1
4345, 1, 1636421453729, 1636421453993, 264, 1, 263, 1, 0, 1
4346, 1, 1636421454037, 1636421454310, 273, 1, 272, 0, 0, 0
4347, 1, 1636421454397, 1636421454662, 265, 0, 265, 0, 0, 0
4348, 1, 1636421454754, 1636421455022, 268, 0, 268, 0, 0, 0
4349, 1, 1636421455062, 1636421455330, 268, 0, 268, 0, 0, 0
4351, 1, 1636421455414, 1636421455677, 263, 0, 263, 0, 0, 0
4352, 1, 1636421455422, 1636421455689, 267, 0, 267, 0, 0, 0
4353, 1, 1636421455734, 1636421455997, 263, 0, 263, 0, 0, 0
4354, 1, 1636421456078, 1636421456342, 264, 0, 264, 0, 0, 0
4355, 1, 1636421456089, 1636421456357, 268, 1, 267, 0, 1, 1
4356, 1, 1636421456397, 1636421456666, 269, 0, 269, 0, 0, 0
4358, 1, 1636421456790, 1636421457053, 263, 0, 263, 0, 0, 0
4359, 1, 1636421457049, 1636421457333, 284, 1, 283, 0, 0, 0
4360, 1, 1636421457113, 1636421457378, 265, 1, 264, 0, 1, 1
4361, 1, 1636421457378, 1636421457642, 264, 0, 264, 0, 0, 0
4363, 1, 1636421457597, 1636421457861, 264, 1, 263, 0, 0, 0
4364, 1, 1636421457741, 1636421458005, 264, 1, 263, 0, 0, 0
4365, 1, 1636421457782, 1636421458046, 264, 0, 264, 0, 0, 0
4366, 1, 1636421458045, 1636421458313, 268, 1, 267, 0, 0, 0
4368, 1, 1636421458266, 1636421458529, 263, 0, 263, 0, 0, 0
4367, 1, 1636421458266, 1636421458529, 263, 0, 263, 0, 0, 0
4369, 1, 1636421458417, 1636421458681, 264, 0, 264, 0, 0, 0
4370, 1, 1636421458445, 1636421458709, 264, 0, 264, 0, 0, 0
4371, 1, 1636421458709, 1636421458973, 264, 1, 263, 0, 0, 0
4373, 1, 1636421458933, 1636421459198, 265, 1, 264, 0, 0, 0
4372, 1, 1636421458933, 1636421459198, 265, 1, 264, 0, 0, 0
4374, 1, 1636421459094, 1636421459358, 264, 0, 264, 0, 0, 0
4375, 1, 1636421459113, 1636421459377, 264, 0, 264, 0, 0, 0
4377, 1, 1636421459373, 1636421459637, 264, 1, 263, 0, 0, 0
4379, 1, 1636421459606, 1636421459869, 263, 0, 263, 0, 0, 0
4378, 1, 1636421459606, 1636421459870, 264, 0, 264, 0, 0, 0
4380, 1, 1636421459786, 1636421460049, 263, 0, 263, 0, 0, 0
4382, 1, 1636421460001, 1636421460265, 264, 0, 264, 0, 0, 0
4383, 1, 1636421460049, 1636421460313, 264, 1, 263, 1, 0, 1
4384, 1, 1636421460269, 1636421460534, 265, 1, 264, 0, 1, 1
4385, 1, 1636421460273, 1636421460537, 264, 0, 264, 0, 0, 0
4386, 1, 1636421460449, 1636421460718, 269, 0, 269, 0, 0, 0
4387, 1, 1636421460669, 1636421460942, 273, 1, 272, 0, 0, 0
4388, 1, 1636421460729, 1636421460997, 268, 1, 267, 0, 1, 1
4389, 1, 1636421460937, 1636421461202, 265, 1, 264, 0, 1, 1
4390, 1, 1636421460950, 1636421461218, 268, 0, 268, 0, 0, 0
4391, 1, 1636421461121, 1636421461390, 269, 1, 268, 0, 0, 0
4392, 1, 1636421461346, 1636421461609, 263, 0, 263, 0, 0, 0
4393, 1, 1636421461429, 1636421461694, 265, 1, 264, 1, 0, 1
4394, 1, 1636421461566, 1636421461830, 264, 0, 264, 0, 0, 0
4395, 1, 1636421461606, 1636421461869, 263, 0, 263, 0, 0, 0
4397, 1, 1636421461794, 1636421462082, 288, 0, 288, 0, 0, 0
4399, 1, 1636421462097, 1636421462362, 265, 0, 265, 0, 0, 0
4400, 1, 1636421462233, 1636421462506, 273, 1, 272, 0, 1, 1
4402, 1, 1636421462486, 1636421462750, 264, 0, 264, 0, 0, 0
4403, 1, 1636421462762, 1636421463026, 264, 0, 264, 0, 0, 0
4404, 1, 1636421462906, 1636421463169, 263, 0, 263, 0, 0, 0
4405, 1, 1636421463154, 1636421463418, 264, 0, 264, 0, 0, 0
4406, 1, 1636421463426, 1636421463689, 263, 0, 263, 0, 0, 0
4407, 1, 1636421463569, 1636421463838, 269, 1, 268, 0, 0, 0
4408, 1, 1636421463822, 1636421464085, 263, 0, 263, 0, 0, 0
4409, 1, 1636421464094, 1636421464358, 264, 0, 264, 0, 0, 0
4410, 1, 1636421464242, 1636421464509, 267, 0, 267, 0, 0, 0
4413, 1, 1636421464914, 1636421465182, 268, 0, 268, 0, 0, 0
4414, 1, 1636421465506, 1636421465769, 263, 0, 263, 0, 0, 0
4415, 1, 1636421465585, 1636421465854, 269, 1, 268, 0, 0, 0
4416, 1, 1636421466174, 1636421466442, 268, 0, 268, 0, 0, 0
4419, 1, 1636421467098, 1636421467366, 268, 0, 268, 0, 0, 0
4421, 1, 1636421467769, 1636421468037, 268, 1, 267, 0, 1, 1
4420, 1, 1636421467769, 1636421468038, 269, 1, 268, 0, 1, 1
4423, 1, 1636421468437, 1636421468702, 265, 1, 264, 0, 1, 1
4422, 1, 1636421468437, 1636421468702, 265, 1, 264, 0, 0, 0
4424, 1, 1636421469105, 1636421469370, 265, 0, 265, 0, 0, 0
4426, 1, 1636421469454, 1636421469718, 264, 0, 264, 0, 0, 0
4429, 1, 1636421470121, 1636421470386, 265, 1, 264, 0, 0, 0
4417, 1, 1636421472266, 1636421472533, 267, 0, 267, 0, 0, 0
4431, 1, 1636421472317, 1636421472581, 264, 1, 263, 1, 0, 1
4432, 1, 1636421472937, 1636421473205, 268, 1, 267, 0, 0, 0
4433, 1, 1636421472985, 1636421473254, 269, 0, 269, 0, 0, 0
4434, 1, 1636421473609, 1636421473874, 265, 1, 264, 0, 1, 1
4435, 1, 1636421473657, 1636421473925, 268, 1, 267, 0, 0, 0
4436, 1, 1636421474277, 1636421474541, 264, 0, 264, 0, 0, 0
4437, 1, 1636421474353, 1636421474617, 264, 0, 264, 0, 0, 0
4440, 1, 1636421475022, 1636421475290, 268, 0, 268, 0, 0, 0
4442, 1, 1636421475694, 1636421475962, 268, 0, 268, 0, 0, 0
4443, 1, 1636421476366, 1636421476630, 264, 0, 264, 0, 0, 0
4444, 1, 1636421477189, 1636421477458, 269, 1, 268, 0, 0, 0
4445, 1, 1636421477866, 1636421478134, 268, 0, 268, 0, 0, 0
4446, 1, 1636421478537, 1636421478806, 269, 1, 268, 0, 0, 0
4448, 1, 1636421479414, 1636421479682, 268, 0, 268, 0, 0, 0
4449, 1, 1636421480070, 1636421480334, 264, 0, 264, 0, 0, 0
4450, 1, 1636421480089, 1636421480362, 273, 1, 272, 0, 0, 0
4451, 1, 1636421480402, 1636421480670, 268, 0, 268, 0, 0, 0
4452, 1, 1636421480745, 1636421481009, 264, 1, 263, 0, 0, 0
4453, 1, 1636421480758, 1636421481022, 264, 0, 264, 0, 0, 0
4454, 1, 1636421481077, 1636421481342, 265, 1, 264, 0, 0, 0
4455, 1, 1636421481097, 1636421481365, 268, 1, 267, 0, 1, 1
4456, 1, 1636421481410, 1636421481682, 272, 0, 272, 0, 0, 0
4457, 1, 1636421481422, 1636421481689, 267, 0, 267, 0, 0, 0
4459, 1, 1636421481765, 1636421482030, 265, 1, 264, 1, 0, 1
4460, 1, 1636421482082, 1636421482350, 268, 0, 268, 0, 0, 0
4461, 1, 1636421482094, 1636421482362, 268, 0, 268, 0, 0, 0
4462, 1, 1636421482433, 1636421482698, 265, 0, 265, 0, 0, 0
4463, 1, 1636421482754, 1636421483018, 264, 0, 264, 0, 0, 0
4464, 1, 1636421482765, 1636421483029, 264, 1, 263, 1, 0, 1
4466, 1, 1636421483418, 1636421483682, 264, 0, 264, 0, 0, 0
4467, 1, 1636421483434, 1636421483697, 263, 0, 263, 0, 0, 0
4468, 1, 1636421484082, 1636421484350, 268, 0, 268, 0, 0, 0
4469, 1, 1636421484353, 1636421484618, 265, 1, 264, 1, 0, 1
4470, 1, 1636421485033, 1636421485298, 265, 1, 264, 0, 1, 1
4471, 1, 1636421485154, 1636421485418, 264, 0, 264, 0, 0, 0
4472, 1, 1636421485257, 1636421485526, 269, 1, 268, 0, 0, 0
4473, 1, 1636421485426, 1636421485689, 263, 0, 263, 0, 0, 0
4474, 1, 1636421485701, 1636421485970, 269, 1, 268, 0, 0, 0
4475, 1, 1636421485822, 1636421486086, 264, 0, 264, 0, 0, 0
4476, 1, 1636421485929, 1636421486202, 273, 0, 273, 0, 0, 0
4477, 1, 1636421486093, 1636421486366, 273, 1, 272, 1, 0, 1
4478, 1, 1636421486377, 1636421486642, 265, 0, 265, 0, 0, 0
4480, 1, 1636421486606, 1636421486870, 264, 0, 264, 0, 0, 0
4483, 1, 1636421487278, 1636421487546, 268, 0, 268, 0, 0, 0
4484, 1, 1636421487950, 1636421488218, 268, 0, 268, 0, 0, 0
4485, 1, 1636421488622, 1636421488894, 272, 0, 272, 0, 0, 0
4486, 1, 1636421489302, 1636421489569, 267, 0, 267, 0, 0, 0
4487, 1, 1636421489518, 1636421489786, 268, 0, 268, 0, 0, 0
4488, 1, 1636421490190, 1636421490458, 268, 0, 268, 0, 0, 0
4489, 1, 1636421490862, 1636421491130, 268, 0, 268, 0, 0, 0
4490, 1, 1636421491533, 1636421491797, 264, 1, 263, 1, 0, 1
4491, 1, 1636421492050, 1636421492322, 272, 0, 272, 0, 0, 0
4492, 1, 1636421492202, 1636421492465, 263, 0, 263, 0, 0, 0
4493, 1, 1636421492726, 1636421492994, 268, 0, 268, 0, 0, 0
4494, 1, 1636421493002, 1636421493265, 263, 0, 263, 0, 0, 0
4495, 1, 1636421493394, 1636421493661, 267, 0, 267, 0, 0, 0
4496, 1, 1636421493417, 1636421493686, 269, 1, 268, 0, 1, 1
4497, 1, 1636421493669, 1636421493942, 273, 0, 273, 0, 0, 0
4499, 1, 1636421494090, 1636421494357, 267, 0, 267, 0, 0, 0
4500, 1, 1636421494345, 1636421494613, 268, 1, 267, 0, 0, 0
4501, 1, 1636421494766, 1636421495030, 264, 0, 264, 0, 0, 0
4502, 1, 1636421495018, 1636421495286, 268, 0, 268, 0, 0, 0
4503, 1, 1636421495433, 1636421495697, 264, 1, 263, 0, 0, 0
4504, 1, 1636421495690, 1636421495954, 264, 0, 264, 0, 0, 0
4505, 1, 1636421496101, 1636421496366, 265, 1, 264, 0, 1, 1
4506, 1, 1636421496357, 1636421496626, 269, 0, 269, 0, 0, 0
4507, 1, 1636421496813, 1636421497085, 272, 1, 271, 0, 0, 0
4508, 1, 1636421496813, 1636421497085, 272, 1, 271, 0, 0, 0
4510, 1, 1636421497093, 1636421497357, 264, 0, 264, 0, 0, 0
4511, 1, 1636421497353, 1636421497617, 264, 1, 263, 0, 0, 0
4512, 1, 1636421497493, 1636421497757, 264, 1, 263, 0, 1, 1
4513, 1, 1636421497493, 1636421497761, 268, 1, 267, 0, 0, 0
4514, 1, 1636421497761, 1636421498025, 264, 1, 263, 1, 0, 1
4515, 1, 1636421498017, 1636421498286, 269, 1, 268, 0, 0, 0
4516, 1, 1636421498162, 1636421498425, 263, 0, 263, 0, 0, 0
4517, 1, 1636421498165, 1636421498434, 269, 0, 269, 0, 0, 0
4518, 1, 1636421498438, 1636421498706, 268, 0, 268, 0, 0, 0
4519, 1, 1636421498689, 1636421498958, 269, 1, 268, 1, 0, 1
4520, 1, 1636421498829, 1636421499098, 269, 0, 269, 0, 0, 0
4523, 1, 1636421499362, 1636421499626, 264, 0, 264, 0, 0, 0
4524, 1, 1636421499498, 1636421499766, 268, 0, 268, 0, 0, 0
4525, 1, 1636421500029, 1636421500298, 269, 0, 269, 0, 0, 0
4526, 1, 1636421500169, 1636421500434, 265, 1, 264, 0, 1, 1
4527, 1, 1636421500701, 1636421500974, 273, 1, 272, 0, 0, 0
4529, 1, 1636421501378, 1636421501646, 268, 0, 268, 0, 0, 0
4530, 1, 1636421504374, 1636421504642, 268, 0, 268, 0, 0, 0
4531, 1, 1636421505046, 1636421505314, 268, 0, 268, 0, 0, 0
4532, 1, 1636421505718, 1636421505982, 264, 0, 264, 0, 0, 0
4533, 1, 1636421506386, 1636421506654, 268, 0, 268, 0, 0, 0
4534, 1, 1636421507074, 1636421507338, 264, 0, 264, 0, 0, 0
4535, 1, 1636421507338, 1636421507606, 268, 0, 268, 0, 0, 0
4536, 1, 1636421507742, 1636421508010, 268, 0, 268, 0, 0, 0
4537, 1, 1636421508013, 1636421508281, 268, 0, 268, 0, 0, 0
4538, 1, 1636421508414, 1636421508682, 268, 0, 268, 0, 0, 0
4539, 1, 1636421508705, 1636421508970, 265, 1, 264, 1, 0, 1
4540, 1, 1636421509086, 1636421509354, 268, 0, 268, 0, 0, 0
4541, 1, 1636421509145, 1636421509410, 265, 1, 264, 0, 1, 1
4542, 1, 1636421509382, 1636421509650, 268, 0, 268, 0, 0, 0
4543, 1, 1636421509413, 1636421509677, 264, 1, 263, 0, 0, 0
4544, 1, 1636421509758, 1636421510022, 264, 0, 264, 0, 0, 0
4545, 1, 1636421509813, 1636421510078, 265, 1, 264, 0, 0, 0
4546, 1, 1636421510053, 1636421510318, 265, 1, 264, 0, 0, 0
4547, 1, 1636421510077, 1636421510345, 268, 1, 267, 0, 0, 0
4548, 1, 1636421510426, 1636421510689, 263, 0, 263, 0, 0, 0
4549, 1, 1636421510481, 1636421510745, 264, 1, 263, 0, 1, 1
4550, 1, 1636421510722, 1636421510990, 268, 0, 268, 0, 0, 0
4551, 1, 1636421510798, 1636421511066, 268, 0, 268, 0, 0, 0
4552, 1, 1636421511093, 1636421511358, 265, 1, 264, 0, 0, 0
4553, 1, 1636421511145, 1636421511410, 265, 1, 264, 1, 0, 1
4554, 1, 1636421511149, 1636421511414, 265, 0, 265, 0, 0, 0
4555, 1, 1636421511394, 1636421511661, 267, 0, 267, 0, 0, 0
4556, 1, 1636421511465, 1636421511729, 264, 1, 263, 0, 0, 0
4558, 1, 1636421511809, 1636421512078, 269, 0, 269, 0, 0, 0
4559, 1, 1636421511817, 1636421512081, 264, 1, 263, 0, 0, 0
4560, 1, 1636421512133, 1636421512402, 269, 1, 268, 0, 1, 1
4561, 1, 1636421512485, 1636421512749, 264, 1, 263, 0, 0, 0
4562, 1, 1636421512485, 1636421512750, 265, 1, 264, 0, 0, 0
4563, 1, 1636421512801, 1636421513069, 268, 0, 268, 0, 0, 0
4565, 1, 1636421513154, 1636421513421, 267, 0, 267, 0, 0, 0
4564, 1, 1636421513154, 1636421513421, 267, 0, 267, 0, 0, 0
4566, 1, 1636421513469, 1636421513734, 265, 1, 264, 0, 0, 0
4567, 1, 1636421513825, 1636421514090, 265, 1, 264, 0, 0, 0
4568, 1, 1636421513825, 1636421514090, 265, 1, 264, 0, 1, 1
4569, 1, 1636421514134, 1636421514398, 264, 0, 264, 0, 0, 0
4571, 1, 1636421514494, 1636421514757, 263, 0, 263, 0, 0, 0
4570, 1, 1636421514494, 1636421514757, 263, 0, 263, 0, 0, 0
4572, 1, 1636421514802, 1636421515070, 268, 0, 268, 0, 0, 0
4573, 1, 1636421515162, 1636421515426, 264, 0, 264, 0, 0, 0
4574, 1, 1636421515162, 1636421515426, 264, 0, 264, 0, 0, 0
4575, 1, 1636421515470, 1636421515734, 264, 0, 264, 0, 0, 0
4576, 1, 1636421515825, 1636421516093, 268, 1, 267, 0, 1, 1
4577, 1, 1636421516138, 1636421516402, 264, 0, 264, 0, 0, 0
4580, 1, 1636421522070, 1636421522334, 264, 0, 264, 0, 0, 0
4581, 1, 1636421522737, 1636421523006, 269, 1, 268, 0, 0, 0
4582, 1, 1636421523410, 1636421523678, 268, 0, 268, 0, 0, 0
4583, 1, 1636421524082, 1636421524346, 264, 0, 264, 0, 0, 0
4584, 1, 1636421524750, 1636421525014, 264, 0, 264, 0, 0, 0
4585, 1, 1636421525418, 1636421525682, 264, 0, 264, 0, 0, 0
4586, 1, 1636421526086, 1636421526354, 268, 0, 268, 0, 0, 0
4587, 1, 1636421526850, 1636421527114, 264, 0, 264, 0, 0, 0
4588, 1, 1636421527122, 1636421527386, 264, 0, 264, 0, 0, 0
4589, 1, 1636421527518, 1636421527790, 272, 0, 272, 0, 0, 0
4590, 1, 1636421527793, 1636421528057, 264, 1, 263, 0, 0, 0
4591, 1, 1636421528193, 1636421528458, 265, 1, 264, 1, 0, 1
4592, 1, 1636421528466, 1636421528729, 263, 0, 263, 0, 0, 0
4593, 1, 1636421528862, 1636421529126, 264, 0, 264, 0, 0, 0
4594, 1, 1636421529134, 1636421529414, 280, 0, 280, 0, 0, 0
4595, 1, 1636421529530, 1636421529794, 264, 0, 264, 0, 0, 0
4596, 1, 1636421529813, 1636421530078, 265, 0, 265, 0, 0, 0
4597, 1, 1636421530197, 1636421530461, 264, 0, 264, 0, 0, 0
4598, 1, 1636421530482, 1636421530745, 263, 0, 263, 0, 0, 0
4599, 1, 1636421530866, 1636421531130, 264, 0, 264, 0, 0, 0
4600, 1, 1636421531142, 1636421531410, 268, 0, 268, 0, 0, 0
4601, 1, 1636421836074, 1636421836342, 268, 0, 268, 0, 0, 0
4603, 1, 1636421836842, 1636421837106, 264, 0, 264, 0, 0, 0
4604, 1, 1636421837486, 1636421837754, 268, 0, 268, 0, 0, 0
4606, 1, 1636421838102, 1636421838370, 268, 0, 268, 0, 0, 0
4608, 1, 1636421838722, 1636421838986, 264, 0, 264, 0, 0, 0
4611, 1, 1636421839418, 1636421839682, 264, 0, 264, 0, 0, 0
4613, 1, 1636421840138, 1636421840402, 264, 0, 264, 0, 0, 0
4615, 1, 1636421840770, 1636421841038, 268, 0, 268, 0, 0, 0
4614, 1, 1636421840806, 1636421841070, 264, 0, 264, 0, 0, 0
4616, 1, 1636421841401, 1636421841665, 264, 0, 264, 0, 0, 0
4617, 1, 1636421841474, 1636421841741, 267, 0, 267, 0, 0, 0
4620, 1, 1636421842081, 1636421842349, 268, 1, 267, 0, 0, 0
4622, 1, 1636421842754, 1636421843026, 272, 0, 272, 0, 0, 0
4623, 1, 1636421843430, 1636421843694, 264, 0, 264, 0, 0, 0
4624, 1, 1636421843786, 1636421844054, 268, 0, 268, 0, 0, 0
4627, 1, 1636421844482, 1636421844750, 268, 0, 268, 0, 0, 0
4628, 1, 1636421845153, 1636421845425, 272, 1, 271, 0, 0, 0
4629, 1, 1636421845690, 1636421845954, 264, 0, 264, 0, 0, 0
4630, 1, 1636421845830, 1636421846098, 268, 0, 268, 0, 0, 0
4632, 1, 1636421846317, 1636421846581, 264, 1, 263, 0, 1, 1
4631, 1, 1636421846357, 1636421846622, 265, 1, 264, 0, 0, 0
4635, 1, 1636421847022, 1636421847285, 263, 0, 263, 0, 0, 0
4636, 1, 1636421847085, 1636421847350, 265, 1, 264, 0, 1, 1
4637, 1, 1636421847221, 1636421847486, 265, 1, 264, 1, 0, 1
4639, 1, 1636421847754, 1636421848017, 263, 0, 263, 0, 0, 0
4640, 1, 1636421847854, 1636421848121, 267, 0, 267, 0, 0, 0
4642, 1, 1636421848062, 1636421848325, 263, 0, 263, 0, 0, 0
4643, 1, 1636421848422, 1636421848690, 268, 0, 268, 0, 0, 0
4644, 1, 1636421848502, 1636421848769, 267, 0, 267, 0, 0, 0
4645, 1, 1636421848529, 1636421848793, 264, 1, 263, 0, 0, 0
4647, 1, 1636421848693, 1636421848962, 269, 0, 269, 0, 0, 0
4646, 1, 1636421848766, 1636421849030, 264, 0, 264, 0, 0, 0
4648, 1, 1636421849093, 1636421849358, 265, 0, 265, 0, 0, 0
4649, 1, 1636421849117, 1636421849382, 265, 1, 264, 0, 0, 0
4651, 1, 1636421849197, 1636421849465, 268, 1, 267, 1, 0, 1
4650, 1, 1636421849173, 1636421849473, 300, 1, 299, 0, 0, 0
4652, 1, 1636421849209, 1636421849481, 272, 0, 272, 0, 0, 0
4654, 1, 1636421849469, 1636421849737, 268, 1, 267, 0, 0, 0
4655, 1, 1636421849729, 1636421849993, 264, 1, 263, 1, 0, 1
4656, 1, 1636421849761, 1636421850029, 268, 1, 267, 0, 0, 0
4657, 1, 1636421849789, 1636421850053, 264, 1, 263, 0, 1, 1
4658, 1, 1636421849873, 1636421850161, 288, 1, 287, 0, 1, 1
4659, 1, 1636421849890, 1636421850162, 272, 0, 272, 0, 0, 0
4660, 1, 1636421850077, 1636421850341, 264, 0, 264, 0, 0, 0
4663, 1, 1636421850393, 1636421850657, 264, 1, 263, 0, 0, 0
4665, 1, 1636421850425, 1636421850689, 264, 1, 263, 0, 1, 1
4664, 1, 1636421850425, 1636421850689, 264, 1, 263, 1, 0, 1
4666, 1, 1636421850453, 1636421850718, 265, 0, 265, 0, 0, 0
4668, 1, 1636421850561, 1636421850825, 264, 1, 263, 0, 0, 0
4667, 1, 1636421850569, 1636421850833, 264, 1, 263, 0, 0, 0
4669, 1, 1636421850745, 1636421851010, 265, 1, 264, 0, 1, 1
4670, 1, 1636421851061, 1636421851325, 264, 1, 263, 0, 0, 0
4671, 1, 1636421851093, 1636421851357, 264, 1, 263, 0, 0, 0
4672, 1, 1636421851097, 1636421851361, 264, 0, 264, 0, 0, 0
4673, 1, 1636421851130, 1636421851394, 264, 0, 264, 0, 0, 0
4674, 1, 1636421851233, 1636421851521, 288, 1, 287, 0, 1, 1
4675, 1, 1636421851241, 1636421851525, 284, 1, 283, 0, 1, 1
4676, 1, 1636421851430, 1636421851693, 263, 0, 263, 0, 0, 0
4677, 1, 1636421851733, 1636421851998, 265, 0, 265, 0, 0, 0
4678, 1, 1636421851761, 1636421852025, 264, 0, 264, 0, 0, 0
4679, 1, 1636421851773, 1636421852042, 269, 1, 268, 1, 0, 1
4680, 1, 1636421851777, 1636421852050, 273, 1, 272, 0, 0, 0
4682, 1, 1636421851797, 1636421852065, 268, 1, 267, 1, 0, 1
4683, 1, 1636421852013, 1636421852277, 264, 1, 263, 1, 0, 1
4684, 1, 1636421852013, 1636421852278, 265, 1, 264, 0, 0, 0
4681, 1, 1636421852105, 1636421852365, 260, 0, 260, 0, 0, 0
4686, 1, 1636421852397, 1636421852662, 265, 1, 264, 1, 0, 1
4687, 1, 1636421852409, 1636421852673, 264, 1, 263, 0, 0, 0
4688, 1, 1636421852429, 1636421852693, 264, 1, 263, 1, 0, 1
4689, 1, 1636421852449, 1636421852714, 265, 1, 264, 0, 0, 0
4691, 1, 1636421852457, 1636421852730, 273, 0, 273, 0, 0, 0
4690, 1, 1636421852681, 1636421852953, 272, 1, 271, 0, 0, 0
4694, 1, 1636421852686, 1636421852957, 271, 0, 271, 0, 0, 0
4693, 1, 1636421852686, 1636421852957, 271, 0, 271, 0, 0, 0
4695, 1, 1636421852769, 1636421853033, 264, 1, 263, 0, 0, 0
4696, 1, 1636421853065, 1636421853333, 268, 1, 267, 0, 0, 0
4697, 1, 1636421853085, 1636421853349, 264, 1, 263, 1, 0, 1
4698, 1, 1636421853093, 1636421853369, 276, 0, 276, 0, 0, 0
4700, 1, 1636421853137, 1636421853405, 268, 1, 267, 0, 0, 0
4701, 1, 1636421853349, 1636421853613, 264, 1, 263, 1, 0, 1
4703, 1, 1636421853357, 1636421853621, 264, 0, 264, 0, 0, 0
4702, 1, 1636421853361, 1636421853625, 264, 0, 264, 0, 0, 0
4704, 1, 1636421853433, 1636421853698, 265, 1, 264, 0, 0, 0
4705, 1, 1636421853733, 1636421853997, 264, 1, 263, 0, 0, 0
4706, 1, 1636421853749, 1636421854017, 268, 0, 268, 0, 0, 0
4707, 1, 1636421853773, 1636421854038, 265, 1, 264, 0, 0, 0
4708, 1, 1636421853801, 1636421854069, 268, 0, 268, 0, 0, 0
4709, 1, 1636421854053, 1636421854317, 264, 1, 263, 1, 0, 1
4711, 1, 1636421854053, 1636421854321, 268, 1, 267, 0, 0, 0
4712, 1, 1636421854145, 1636421854409, 264, 0, 264, 0, 0, 0
4714, 1, 1636421854401, 1636421854666, 265, 1, 264, 0, 0, 0
4713, 1, 1636421854453, 1636421854717, 264, 1, 263, 1, 0, 1
4716, 1, 1636421854453, 1636421854717, 264, 1, 263, 1, 0, 1
4715, 1, 1636421854453, 1636421854717, 264, 1, 263, 1, 0, 1
4717, 1, 1636421854473, 1636421854737, 264, 0, 264, 0, 0, 0
4718, 1, 1636421854725, 1636421854994, 269, 0, 269, 0, 0, 0
4721, 1, 1636421854805, 1636421855073, 268, 1, 267, 1, 0, 1
4720, 1, 1636421854805, 1636421855073, 268, 1, 267, 0, 0, 0
4722, 1, 1636421855069, 1636421855334, 265, 0, 265, 0, 0, 0
4723, 1, 1636421855113, 1636421855377, 264, 1, 263, 0, 0, 0
4725, 1, 1636421855121, 1636421855389, 268, 0, 268, 0, 0, 0
4724, 1, 1636421855129, 1636421855397, 268, 1, 267, 0, 0, 0
4726, 1, 1636421855141, 1636421855405, 264, 0, 264, 0, 0, 0
4727, 1, 1636421855401, 1636421855665, 264, 0, 264, 0, 0, 0
4728, 1, 1636421855481, 1636421855749, 268, 1, 267, 1, 0, 1
4730, 1, 1636421855738, 1636421856002, 264, 0, 264, 0, 0, 0
4732, 1, 1636421855793, 1636421856058, 265, 1, 264, 1, 0, 1
4733, 1, 1636421855810, 1636421856074, 264, 0, 264, 0, 0, 0
4734, 1, 1636421855817, 1636421856081, 264, 1, 263, 0, 0, 0
4735, 1, 1636421856073, 1636421856337, 264, 1, 263, 0, 0, 0
4736, 1, 1636421856153, 1636421856418, 265, 1, 264, 0, 1, 1
4737, 1, 1636421856405, 1636421856674, 269, 1, 268, 1, 0, 1
4738, 1, 1636421856465, 1636421856729, 264, 1, 263, 0, 1, 1
4740, 1, 1636421856490, 1636421856754, 264, 0, 264, 0, 0, 0
4741, 1, 1636421856750, 1636421857061, 311, 0, 311, 0, 0, 0
4742, 1, 1636421856821, 1636421857086, 265, 1, 264, 0, 0, 0
4743, 1, 1636421856821, 1636421857086, 265, 1, 264, 0, 0, 0
4744, 1, 1636421857117, 1636421857381, 264, 1, 263, 1, 0, 1
4745, 1, 1636421857129, 1636421857393, 264, 1, 263, 0, 0, 0
4746, 1, 1636421857197, 1636421857465, 268, 1, 267, 0, 0, 0
4747, 1, 1636421857325, 1636421857593, 268, 0, 268, 0, 0, 0
4749, 1, 1636421857494, 1636421857762, 268, 0, 268, 0, 0, 0
4748, 1, 1636421857457, 1636421857762, 305, 0, 305, 0, 0, 0
4750, 1, 1636421857494, 1636421857762, 268, 0, 268, 0, 0, 0
4752, 1, 1636421857805, 1636421858069, 264, 1, 263, 0, 1, 1
4751, 1, 1636421857813, 1636421858077, 264, 1, 263, 0, 1, 1
4754, 1, 1636421858017, 1636421858281, 264, 1, 263, 0, 0, 0
4755, 1, 1636421858025, 1636421858289, 264, 0, 264, 0, 0, 0
4757, 1, 1636421858161, 1636421858425, 264, 0, 264, 0, 0, 0
4756, 1, 1636421858169, 1636421858433, 264, 1, 263, 0, 0, 0
4758, 1, 1636421858169, 1636421858441, 272, 1, 271, 1, 0, 1
4759, 1, 1636421858293, 1636421858561, 268, 1, 267, 0, 0, 0
4761, 1, 1636421858481, 1636421858745, 264, 0, 264, 0, 0, 0
4762, 1, 1636421858677, 1636421858941, 264, 1, 263, 1, 0, 1
4763, 1, 1636421858693, 1636421858957, 264, 1, 263, 0, 0, 0
4764, 1, 1636421858833, 1636421859097, 264, 0, 264, 0, 0, 0
4766, 1, 1636421858849, 1636421859118, 269, 0, 269, 0, 0, 0
4767, 1, 1636421858969, 1636421859238, 269, 1, 268, 0, 1, 1
4768, 1, 1636421859149, 1636421859445, 296, 1, 295, 0, 0, 0
4769, 1, 1636421859361, 1636421859625, 264, 0, 264, 0, 0, 0
4770, 1, 1636421859361, 1636421859625, 264, 1, 263, 0, 0, 0
4771, 1, 1636421859497, 1636421859761, 264, 0, 264, 0, 0, 0
4772, 1, 1636421859513, 1636421859777, 264, 0, 264, 0, 0, 0
4773, 1, 1636421859637, 1636421859905, 268, 0, 268, 0, 0, 0
4774, 1, 1636421859713, 1636421859977, 264, 1, 263, 0, 0, 0
4775, 1, 1636421859881, 1636421860145, 264, 1, 263, 0, 0, 0
4777, 1, 1636421860033, 1636421860297, 264, 0, 264, 0, 0, 0
4776, 1, 1636421860033, 1636421860297, 264, 0, 264, 0, 0, 0
4778, 1, 1636421860210, 1636421860473, 263, 0, 263, 0, 0, 0
4779, 1, 1636421860213, 1636421860481, 268, 0, 268, 0, 0, 0
4780, 1, 1636421860257, 1636421860521, 264, 0, 264, 0, 0, 0
4781, 1, 1636421860353, 1636421860618, 265, 0, 265, 0, 0, 0
4782, 1, 1636421860385, 1636421860649, 264, 0, 264, 0, 0, 0
4783, 1, 1636421860521, 1636421860785, 264, 1, 263, 1, 0, 1
4785, 1, 1636421860693, 1636421860958, 265, 0, 265, 0, 0, 0
4786, 1, 1636421860697, 1636421860961, 264, 0, 264, 0, 0, 0
4787, 1, 1636421860882, 1636421861145, 263, 0, 263, 0, 0, 0
4789, 1, 1636421860929, 1636421861193, 264, 0, 264, 0, 0, 0
4790, 1, 1636421861017, 1636421861286, 269, 0, 269, 0, 0, 0
4791, 1, 1636421861053, 1636421861317, 264, 1, 263, 0, 1, 1
4792, 1, 1636421861201, 1636421861465, 264, 1, 263, 1, 0, 1
4793, 1, 1636421861365, 1636421861630, 265, 1, 264, 0, 1, 1
4794, 1, 1636421861365, 1636421861633, 268, 1, 267, 0, 1, 1
4795, 1, 1636421861550, 1636421861818, 268, 0, 268, 0, 0, 0
4796, 1, 1636421861597, 1636421861862, 265, 0, 265, 0, 0, 0
4797, 1, 1636421861689, 1636421861954, 265, 0, 265, 0, 0, 0
4798, 1, 1636421861717, 1636421861985, 268, 1, 267, 0, 0, 0
4799, 1, 1636421861877, 1636421862145, 268, 1, 267, 0, 0, 0
4800, 1, 1636421862049, 1636421862317, 268, 1, 267, 1, 0, 1
4801, 1, 1636421862049, 1636421862321, 272, 1, 271, 0, 1, 1
4802, 1, 1636421862269, 1636421862545, 276, 0, 276, 0, 0, 0
4803, 1, 1636421862269, 1636421862545, 276, 0, 276, 0, 0, 0
4804, 1, 1636421862369, 1636421862629, 260, 0, 260, 0, 0, 0
4805, 1, 1636421862393, 1636421862657, 264, 0, 264, 0, 0, 0
4806, 1, 1636421862398, 1636421862662, 264, 0, 264, 0, 0, 0
4807, 1, 1636421862549, 1636421862813, 264, 0, 264, 0, 0, 0
4808, 1, 1636421862717, 1636421862982, 265, 1, 264, 1, 0, 1
4809, 1, 1636421862725, 1636421862989, 264, 0, 264, 0, 0, 0
4810, 1, 1636421862817, 1636421863081, 264, 0, 264, 0, 0, 0
4811, 1, 1636421862981, 1636421863253, 272, 1, 271, 0, 0, 0
4814, 1, 1636421863073, 1636421863338, 265, 1, 264, 1, 0, 1
4815, 1, 1636421863073, 1636421863338, 265, 1, 264, 1, 0, 1
4813, 1, 1636421863073, 1636421863338, 265, 1, 264, 0, 0, 0
4816, 1, 1636421863253, 1636421863517, 264, 1, 263, 1, 0, 1
4818, 1, 1636421863397, 1636421863661, 264, 1, 263, 0, 0, 0
4820, 1, 1636421863485, 1636421863749, 264, 1, 263, 0, 1, 1
4819, 1, 1636421863521, 1636421863785, 264, 1, 263, 0, 0, 0
4821, 1, 1636421863657, 1636421863921, 264, 0, 264, 0, 0, 0
4822, 1, 1636421863737, 1636421864001, 264, 1, 263, 0, 0, 0
4824, 1, 1636421863741, 1636421864005, 264, 1, 263, 0, 0, 0
4823, 1, 1636421863741, 1636421864009, 268, 1, 267, 1, 0, 1
4825, 1, 1636421863921, 1636421864189, 268, 1, 267, 1, 0, 1
4827, 1, 1636421864161, 1636421864425, 264, 1, 263, 0, 0, 0
4828, 1, 1636421864213, 1636421864481, 268, 1, 267, 0, 0, 0
4829, 1, 1636421864321, 1636421864585, 264, 1, 263, 1, 0, 1
4830, 1, 1636421864341, 1636421864605, 264, 0, 264, 0, 0, 0
4831, 1, 1636421864401, 1636421864665, 264, 1, 263, 0, 0, 0
4833, 1, 1636421864413, 1636421864678, 265, 1, 264, 0, 0, 0
4834, 1, 1636421864589, 1636421864857, 268, 0, 268, 0, 0, 0
4835, 1, 1636421864829, 1636421865097, 268, 1, 267, 0, 0, 0
4836, 1, 1636421864905, 1636421865169, 264, 1, 263, 0, 1, 1
4837, 1, 1636421864998, 1636421865261, 263, 0, 263, 0, 0, 0
4838, 1, 1636421865005, 1636421865273, 268, 1, 267, 0, 0, 0
4839, 1, 1636421865037, 1636421865301, 264, 0, 264, 0, 0, 0
4842, 1, 1636421865261, 1636421865529, 268, 1, 267, 1, 0, 1
4841, 1, 1636421865277, 1636421865541, 264, 0, 264, 0, 0, 0
4840, 1, 1636421865345, 1636421865609, 264, 1, 263, 0, 1, 1
4844, 1, 1636421865577, 1636421865842, 265, 0, 265, 0, 0, 0
4843, 1, 1636421865649, 1636421865917, 268, 0, 268, 0, 0, 0
4845, 1, 1636421865669, 1636421865938, 269, 0, 269, 0, 0, 0
4846, 1, 1636421865677, 1636421865942, 265, 1, 264, 1, 0, 1
4848, 1, 1636421865926, 1636421866189, 263, 0, 263, 0, 0, 0
4847, 1, 1636421865941, 1636421866209, 268, 1, 267, 0, 0, 0
4851, 1, 1636421866009, 1636421866281, 272, 0, 272, 0, 0, 0
4852, 1, 1636421866193, 1636421866457, 264, 0, 264, 0, 0, 0
4850, 1, 1636421866213, 1636421866521, 308, 0, 308, 0, 0, 0
4856, 1, 1636421866341, 1636421866605, 264, 0, 264, 0, 0, 0
4854, 1, 1636421866341, 1636421866609, 268, 0, 268, 0, 0, 0
4853, 1, 1636421866465, 1636421866729, 264, 1, 263, 0, 0, 0
4857, 1, 1636421866597, 1636421866865, 268, 1, 267, 1, 0, 1
4858, 1, 1636421866653, 1636421866917, 264, 0, 264, 0, 0, 0
4859, 1, 1636421866678, 1636421866941, 263, 0, 263, 0, 0, 0
4860, 1, 1636421866781, 1636421867046, 265, 1, 264, 0, 0, 0
4861, 1, 1636421866869, 1636421867133, 264, 1, 263, 0, 0, 0
4864, 1, 1636421867021, 1636421867286, 265, 1, 264, 0, 0, 0
4863, 1, 1636421867057, 1636421867330, 273, 1, 272, 1, 0, 1
4865, 1, 1636421867137, 1636421867401, 264, 0, 264, 0, 0, 0
4866, 1, 1636421867269, 1636421867537, 268, 0, 268, 0, 0, 0
4867, 1, 1636421867325, 1636421867601, 276, 1, 275, 0, 1, 1
4868, 1, 1636421867350, 1636421867617, 267, 0, 267, 0, 0, 0
4869, 1, 1636421867449, 1636421867718, 269, 0, 269, 0, 0, 0
4870, 1, 1636421867541, 1636421867809, 268, 0, 268, 0, 0, 0
4871, 1, 1636421867689, 1636421867953, 264, 1, 263, 0, 0, 0
4872, 1, 1636421867761, 1636421868030, 269, 1, 268, 1, 0, 1
4874, 1, 1636421867986, 1636421868249, 263, 0, 263, 0, 0, 0
4875, 1, 1636421868001, 1636421868266, 265, 1, 264, 0, 0, 0
4876, 1, 1636421868017, 1636421868281, 264, 1, 263, 0, 0, 0
4877, 1, 1636421868125, 1636421868393, 268, 0, 268, 0, 0, 0
4879, 1, 1636421868258, 1636421868521, 263, 0, 263, 0, 0, 0
4878, 1, 1636421868281, 1636421868545, 264, 1, 263, 1, 0, 1
4880, 1, 1636421868357, 1636421868626, 269, 0, 269, 0, 0, 0
4882, 1, 1636421868649, 1636421868913, 264, 0, 264, 0, 0, 0
4883, 1, 1636421868705, 1636421868969, 264, 1, 263, 0, 0, 0
4886, 1, 1636421868797, 1636421869062, 265, 1, 264, 0, 0, 0
4885, 1, 1636421868922, 1636421869193, 271, 0, 271, 0, 0, 0
4888, 1, 1636421868950, 1636421869221, 271, 0, 271, 0, 0, 0
4891, 1, 1636421869322, 1636421869589, 267, 0, 267, 0, 0, 0
4894, 1, 1636421869594, 1636421869858, 264, 0, 264, 0, 0, 0
4895, 1, 1636421869617, 1636421869882, 265, 1, 264, 1, 0, 1
4897, 1, 1636421870265, 1636421870530, 265, 1, 264, 0, 0, 0
4898, 1, 1636421870290, 1636421870589, 299, 0, 299, 0, 0, 0
4900, 1, 1636421870934, 1636421871206, 272, 0, 272, 0, 0, 0
4911, 1, 1636421878114, 1636421878382, 268, 0, 268, 0, 0, 0
4913, 1, 1636421878793, 1636421879065, 272, 0, 272, 0, 0, 0
4912, 1, 1636421878793, 1636421879066, 273, 1, 272, 0, 1, 1
4916, 1, 1636421879514, 1636421879778, 264, 0, 264, 0, 0, 0
4919, 1, 1636421879514, 1636421879778, 264, 1, 263, 0, 1, 1
4918, 1, 1636421879514, 1636421879778, 264, 0, 264, 0, 0, 0
4917, 1, 1636421879514, 1636421879778, 264, 1, 263, 1, 0, 1
4920, 1, 1636421879682, 1636421879946, 264, 0, 264, 0, 0, 0
4921, 1, 1636421879778, 1636421880050, 272, 1, 271, 0, 1, 1
4922, 1, 1636421880178, 1636421880442, 264, 0, 264, 0, 0, 0
4925, 1, 1636421880178, 1636421880445, 267, 0, 267, 0, 0, 0
4924, 1, 1636421880185, 1636421880445, 260, 0, 260, 0, 0, 0
4927, 1, 1636421880349, 1636421880618, 269, 0, 269, 0, 0, 0
4926, 1, 1636421880454, 1636421880718, 264, 0, 264, 0, 0, 0
4931, 1, 1636421880861, 1636421881125, 264, 1, 263, 0, 0, 0
4930, 1, 1636421880861, 1636421881125, 264, 1, 263, 1, 0, 1
4929, 1, 1636421880857, 1636421881125, 268, 1, 267, 0, 1, 1
4933, 1, 1636421881149, 1636421881413, 264, 1, 263, 0, 1, 1
4932, 1, 1636421881149, 1636421881413, 264, 1, 263, 0, 0, 0
4934, 1, 1636421881169, 1636421881433, 264, 0, 264, 0, 0, 0
4935, 1, 1636421881297, 1636421881561, 264, 1, 263, 0, 1, 1
4936, 1, 1636421881502, 1636421881766, 264, 0, 264, 0, 0, 0
4938, 1, 1636421881565, 1636421881830, 265, 1, 264, 0, 1, 1
4937, 1, 1636421881565, 1636421881830, 265, 0, 265, 0, 0, 0
4941, 1, 1636421881822, 1636421882086, 264, 0, 264, 0, 0, 0
4942, 1, 1636421881837, 1636421882101, 264, 0, 264, 0, 0, 0
4940, 1, 1636421881841, 1636421882109, 268, 1, 267, 0, 0, 0
4943, 1, 1636421881914, 1636421882177, 263, 0, 263, 0, 0, 0
4945, 1, 1636421882169, 1636421882438, 269, 1, 268, 0, 0, 0
4946, 1, 1636421882233, 1636421882498, 265, 1, 264, 0, 0, 0
4947, 1, 1636421882233, 1636421882505, 272, 1, 271, 0, 0, 0
4948, 1, 1636421882485, 1636421882753, 268, 0, 268, 0, 0, 0
4949, 1, 1636421882502, 1636421882765, 263, 0, 263, 0, 0, 0
4950, 1, 1636421882509, 1636421882777, 268, 0, 268, 0, 0, 0
4952, 1, 1636421882838, 1636421883105, 267, 0, 267, 0, 0, 0
4953, 1, 1636421882902, 1636421883165, 263, 0, 263, 0, 0, 0
4954, 1, 1636421882910, 1636421883173, 263, 0, 263, 0, 0, 0
4955, 1, 1636421883157, 1636421883426, 269, 1, 268, 0, 0, 0
4957, 1, 1636421883217, 1636421883482, 265, 1, 264, 0, 0, 0
4960, 1, 1636421883570, 1636421883833, 263, 1, 262, 0, 0, 0
4959, 1, 1636421883570, 1636421883838, 268, 0, 268, 0, 0, 0
4961, 1, 1636421883570, 1636421883841, 271, 1, 270, 0, 0, 0
4962, 1, 1636421883869, 1636421884134, 265, 1, 264, 1, 0, 1
4963, 1, 1636421883885, 1636421884150, 265, 1, 264, 0, 0, 0
4964, 1, 1636421883993, 1636421884265, 272, 0, 272, 0, 0, 0
4966, 1, 1636421884249, 1636421884513, 264, 1, 263, 0, 0, 0
4967, 1, 1636421884249, 1636421884513, 264, 1, 263, 0, 0, 0
4965, 1, 1636421884249, 1636421884513, 264, 1, 263, 0, 0, 0
4969, 1, 1636421884581, 1636421884845, 264, 1, 263, 0, 0, 0
4968, 1, 1636421884585, 1636421884849, 264, 1, 263, 0, 0, 0
4971, 1, 1636421884685, 1636421884957, 272, 1, 271, 0, 1, 1
4970, 1, 1636421884845, 1636421885110, 265, 1, 264, 1, 0, 1
4974, 1, 1636421884917, 1636421885182, 265, 1, 264, 0, 1, 1
4973, 1, 1636421884917, 1636421885182, 265, 1, 264, 1, 0, 1
4972, 1, 1636421884917, 1636421885182, 265, 1, 264, 0, 1, 1
4975, 1, 1636421885017, 1636421885281, 264, 0, 264, 0, 0, 0
4977, 1, 1636421885253, 1636421885518, 265, 1, 264, 1, 0, 1
4976, 1, 1636421885253, 1636421885518, 265, 1, 264, 0, 0, 0
4979, 1, 1636421885513, 1636421885782, 269, 1, 268, 0, 0, 0
4978, 1, 1636421885518, 1636421885782, 264, 0, 264, 0, 0, 0
4982, 1, 1636421885589, 1636421885853, 264, 0, 264, 0, 0, 0
4983, 1, 1636421885789, 1636421886053, 264, 0, 264, 0, 0, 0
4985, 1, 1636421885917, 1636421886181, 264, 1, 263, 1, 0, 1
4984, 1, 1636421885917, 1636421886181, 264, 1, 263, 1, 0, 1
4986, 1, 1636421886226, 1636421886493, 267, 0, 267, 0, 0, 0
4989, 1, 1636421886514, 1636421886778, 264, 0, 264, 0, 0, 0
4992, 1, 1636421886605, 1636421886869, 264, 1, 263, 1, 0, 1
4991, 1, 1636421886605, 1636421886870, 265, 1, 264, 0, 0, 0
4990, 1, 1636421886605, 1636421886877, 272, 1, 271, 0, 0, 0
4994, 1, 1636421886958, 1636421887226, 268, 0, 268, 0, 0, 0
4998, 1, 1636421887282, 1636421887546, 264, 0, 264, 0, 0, 0
4997, 1, 1636421887282, 1636421887546, 264, 0, 264, 0, 0, 0
4999, 1, 1636421887537, 1636421887802, 265, 0, 265, 0, 0, 0
5000, 1, 1636421887625, 1636421887890, 265, 1, 264, 0, 0, 0
5001, 1, 1636421887953, 1636421888222, 269, 0, 269, 0, 0, 0
5003, 1, 1636421888206, 1636421888470, 264, 0, 264, 0, 0, 0
5004, 1, 1636421888294, 1636421888558, 264, 0, 264, 0, 0, 0
5006, 1, 1636421888882, 1636421889154, 272, 0, 272, 0, 0, 0
5008, 1, 1636421889322, 1636421889586, 264, 0, 264, 0, 0, 0
5010, 1, 1636421889645, 1636421889910, 265, 1, 264, 0, 0, 0
5011, 1, 1636421889985, 1636421890250, 265, 1, 264, 0, 1, 1
5012, 1, 1636421890317, 1636421890586, 269, 1, 268, 0, 1, 1
5013, 1, 1636421890594, 1636421890858, 264, 0, 264, 0, 0, 0
5014, 1, 1636421890654, 1636421890917, 263, 0, 263, 0, 0, 0
5015, 1, 1636421890866, 1636421891134, 268, 0, 268, 0, 0, 0
5016, 1, 1636421890989, 1636421891258, 269, 1, 268, 0, 0, 0
5017, 1, 1636421891261, 1636421891573, 312, 1, 311, 0, 0, 0
5019, 1, 1636421891578, 1636421891842, 264, 0, 264, 0, 0, 0
5021, 1, 1636421891841, 1636421892106, 265, 1, 264, 1, 0, 1
5022, 1, 1636421892014, 1636421892282, 268, 0, 268, 0, 0, 0
5024, 1, 1636421892273, 1636421892537, 264, 0, 264, 0, 0, 0
5023, 1, 1636421892285, 1636421892549, 264, 1, 263, 0, 1, 1
5026, 1, 1636421892681, 1636421892945, 264, 0, 264, 0, 0, 0
5027, 1, 1636421892890, 1636421893154, 264, 0, 264, 0, 0, 0
5028, 1, 1636421892941, 1636421893209, 268, 1, 267, 0, 0, 0
5029, 1, 1636421892953, 1636421893217, 264, 0, 264, 0, 0, 0
5030, 1, 1636421893373, 1636421893642, 269, 0, 269, 0, 0, 0
5031, 1, 1636421893478, 1636421893742, 264, 0, 264, 0, 0, 0
5032, 1, 1636421893557, 1636421893826, 269, 1, 268, 1, 0, 1
5034, 1, 1636421893654, 1636421893922, 268, 0, 268, 0, 0, 0
5035, 1, 1636421893818, 1636421894082, 264, 0, 264, 0, 0, 0
5033, 1, 1636421893925, 1636421894194, 269, 0, 269, 0, 0, 0
5036, 1, 1636421894046, 1636421894314, 268, 0, 268, 0, 0, 0
5038, 1, 1636421894230, 1636421894494, 264, 0, 264, 0, 0, 0
5039, 1, 1636421894322, 1636421894585, 263, 0, 263, 0, 0, 0
5041, 1, 1636421894597, 1636421894866, 269, 1, 268, 0, 1, 1
5042, 1, 1636421894717, 1636421894982, 265, 1, 264, 0, 0, 0
5043, 1, 1636421894894, 1636421895162, 268, 0, 268, 0, 0, 0
5044, 1, 1636421894994, 1636421895258, 264, 0, 264, 0, 0, 0
5045, 1, 1636421895274, 1636421895542, 268, 0, 268, 0, 0, 0
5046, 1, 1636421895382, 1636421895677, 295, 0, 295, 0, 0, 0
5047, 1, 1636421895593, 1636421895861, 268, 0, 268, 0, 0, 0
5048, 1, 1636421895681, 1636421895949, 268, 1, 267, 0, 0, 0
5049, 1, 1636421895901, 1636421896165, 264, 1, 263, 0, 0, 0
5050, 1, 1636421895901, 1636421896169, 268, 1, 267, 0, 0, 0
5051, 1, 1636421895949, 1636421896226, 277, 1, 276, 0, 1, 1
5052, 1, 1636421896122, 1636421896385, 263, 0, 263, 0, 0, 0
5053, 1, 1636421896301, 1636421896565, 264, 1, 263, 0, 0, 0
5054, 1, 1636421896393, 1636421896657, 264, 1, 263, 0, 1, 1
5055, 1, 1636421896517, 1636421896782, 265, 0, 265, 0, 0, 0
5056, 1, 1636421896565, 1636421896829, 264, 0, 264, 0, 0, 0
5059, 1, 1636421896629, 1636421896937, 308, 1, 307, 0, 0, 0
5060, 1, 1636421896789, 1636421897057, 268, 1, 267, 0, 0, 0
5061, 1, 1636421896989, 1636421897253, 264, 1, 263, 0, 0, 0
5062, 1, 1636421897077, 1636421897346, 269, 1, 268, 0, 1, 1
5064, 1, 1636421897233, 1636421897497, 264, 1, 263, 0, 0, 0
5066, 1, 1636421897365, 1636421897633, 268, 1, 267, 0, 1, 1
5067, 1, 1636421897465, 1636421897733, 268, 1, 267, 0, 1, 1
5068, 1, 1636421897501, 1636421897766, 265, 0, 265, 0, 0, 0
5069, 1, 1636421897597, 1636421897861, 264, 1, 263, 0, 1, 1
5070, 1, 1636421897657, 1636421897922, 265, 0, 265, 0, 0, 0
5071, 1, 1636421897749, 1636421898017, 268, 1, 267, 0, 0, 0
5073, 1, 1636421898038, 1636421898302, 264, 0, 264, 0, 0, 0
5076, 1, 1636421898258, 1636421898521, 263, 0, 263, 0, 0, 0
5078, 1, 1636421898330, 1636421898598, 268, 0, 268, 0, 0, 0
5080, 1, 1636421898713, 1636421899001, 288, 1, 287, 0, 0, 0
5082, 1, 1636421898934, 1636421899202, 268, 0, 268, 0, 0, 0
5083, 1, 1636421899010, 1636421899273, 263, 0, 263, 0, 0, 0
5084, 1, 1636421899269, 1636421899538, 269, 0, 269, 0, 0, 0
5085, 1, 1636421899421, 1636421899689, 268, 1, 267, 0, 0, 0
5087, 1, 1636421899693, 1636421899962, 269, 0, 269, 0, 0, 0
5088, 1, 1636421899865, 1636421900130, 265, 1, 264, 0, 0, 0
5020, 1, 1636421901318, 1636421901586, 268, 0, 268, 0, 0, 0
5093, 1, 1636421901622, 1636421901886, 264, 0, 264, 0, 0, 0
5094, 1, 1636421901990, 1636421902258, 268, 0, 268, 0, 0, 0
5097, 1, 1636421902818, 1636421903090, 272, 0, 272, 0, 0, 0
5098, 1, 1636421903494, 1636421903758, 264, 0, 264, 0, 0, 0
5099, 1, 1636421904194, 1636421904458, 264, 0, 264, 0, 0, 0
5100, 1, 1636421904453, 1636421904725, 272, 1, 271, 1, 0, 1
5101, 1, 1636421904797, 1636421905062, 265, 1, 264, 0, 1, 1
5102, 1, 1636421904862, 1636421905126, 264, 0, 264, 0, 0, 0
5103, 1, 1636421905129, 1636421905398, 269, 1, 268, 0, 0, 0
5104, 1, 1636421905466, 1636421905730, 264, 0, 264, 0, 0, 0
5105, 1, 1636421905530, 1636421905797, 267, 0, 267, 0, 0, 0
5106, 1, 1636421905801, 1636421906066, 265, 0, 265, 0, 0, 0
5107, 1, 1636421906133, 1636421906402, 269, 1, 268, 0, 0, 0
5108, 1, 1636421906201, 1636421906465, 264, 1, 263, 0, 0, 0
5109, 1, 1636421906477, 1636421906742, 265, 1, 264, 0, 0, 0
5110, 1, 1636421906805, 1636421907073, 268, 1, 267, 1, 0, 1
5111, 1, 1636421906870, 1636421907133, 263, 0, 263, 0, 0, 0
5112, 1, 1636421906877, 1636421907146, 269, 1, 268, 0, 1, 1
5114, 1, 1636421907150, 1636421907418, 268, 0, 268, 0, 0, 0
5115, 1, 1636421907485, 1636421907749, 264, 1, 263, 0, 0, 0
5116, 1, 1636421907525, 1636421907794, 269, 1, 268, 0, 0, 0
5118, 1, 1636421907550, 1636421907817, 267, 0, 267, 0, 0, 0
5117, 1, 1636421907794, 1636421908058, 264, 0, 264, 0, 0, 0
5120, 1, 1636421907858, 1636421908122, 264, 0, 264, 0, 0, 0
5122, 1, 1636421908225, 1636421908489, 264, 1, 263, 0, 1, 1
5123, 1, 1636421908225, 1636421908489, 264, 1, 263, 0, 1, 1
5121, 1, 1636421908225, 1636421908489, 264, 1, 263, 0, 0, 0
5124, 1, 1636421908225, 1636421908497, 272, 1, 271, 0, 0, 0
5126, 1, 1636421908466, 1636421908729, 263, 0, 263, 0, 0, 0
5125, 1, 1636421908466, 1636421908729, 263, 0, 263, 0, 0, 0
5127, 1, 1636421908517, 1636421908781, 264, 1, 263, 1, 0, 1
5128, 1, 1636421908517, 1636421908785, 268, 1, 267, 1, 0, 1
5132, 1, 1636421908885, 1636421909153, 268, 1, 267, 0, 1, 1
5133, 1, 1636421908898, 1636421909165, 267, 0, 267, 0, 0, 0
5131, 1, 1636421908898, 1636421909165, 267, 0, 267, 0, 0, 0
5134, 1, 1636421908898, 1636421909165, 267, 1, 266, 0, 0, 0
5135, 1, 1636421909133, 1636421909393, 260, 0, 260, 0, 0, 0
5137, 1, 1636421909185, 1636421909449, 264, 1, 263, 0, 0, 0
5138, 1, 1636421909201, 1636421909478, 277, 1, 276, 0, 0, 0
5140, 1, 1636421909561, 1636421909825, 264, 1, 263, 0, 0, 0
5143, 1, 1636421909570, 1636421909833, 263, 0, 263, 0, 0, 0
5141, 1, 1636421909570, 1636421909833, 263, 0, 263, 0, 0, 0
5144, 1, 1636421909805, 1636421910070, 265, 0, 265, 0, 0, 0
5142, 1, 1636421909833, 1636421910126, 293, 1, 292, 1, 0, 1
5146, 1, 1636421909893, 1636421910157, 264, 0, 264, 0, 0, 0
5147, 1, 1636421909953, 1636421910217, 264, 0, 264, 0, 0, 0
5145, 1, 1636421910133, 1636421910405, 272, 0, 272, 0, 0, 0
5149, 1, 1636421910270, 1636421910574, 304, 0, 304, 0, 0, 0
5148, 1, 1636421910261, 1636421910574, 313, 1, 312, 0, 0, 0
5151, 1, 1636421910270, 1636421910574, 304, 0, 304, 0, 0, 0
5150, 1, 1636421910405, 1636421910670, 265, 1, 264, 1, 0, 1
5154, 1, 1636421910581, 1636421910845, 264, 0, 264, 0, 0, 0
5155, 1, 1636421910581, 1636421910846, 265, 0, 265, 0, 0, 0
5156, 1, 1636421910625, 1636421910889, 264, 0, 264, 0, 0, 0
5158, 1, 1636421910813, 1636421911077, 264, 0, 264, 0, 0, 0
5159, 1, 1636421910833, 1636421911098, 265, 1, 264, 0, 1, 1
5162, 1, 1636421910969, 1636421911233, 264, 1, 263, 0, 1, 1
5160, 1, 1636421910973, 1636421911234, 261, 0, 261, 0, 0, 0
5161, 1, 1636421910969, 1636421911237, 268, 1, 267, 1, 0, 1
5163, 1, 1636421911069, 1636421911334, 265, 1, 264, 0, 0, 0
5164, 1, 1636421911245, 1636421911509, 264, 1, 263, 0, 0, 0
5165, 1, 1636421911245, 1636421911509, 264, 1, 263, 0, 0, 0
5166, 1, 1636421911301, 1636421911565, 264, 1, 263, 0, 1, 1
5168, 1, 1636421911502, 1636421911765, 263, 0, 263, 0, 0, 0
5167, 1, 1636421911565, 1636421911833, 268, 1, 267, 0, 0, 0
5169, 1, 1636421911641, 1636421911905, 264, 1, 263, 0, 1, 1
5170, 1, 1636421911649, 1636421911917, 268, 0, 268, 0, 0, 0
5172, 1, 1636421911737, 1636421912001, 264, 0, 264, 0, 0, 0
5171, 1, 1636421911833, 1636421912097, 264, 1, 263, 0, 0, 0
5173, 1, 1636421911925, 1636421912194, 269, 0, 269, 0, 0, 0
5175, 1, 1636421911978, 1636421912241, 263, 0, 263, 0, 0, 0
5176, 1, 1636421912165, 1636421912429, 264, 1, 263, 0, 0, 0
5177, 1, 1636421912241, 1636421912505, 264, 1, 263, 0, 0, 0
5178, 1, 1636421912333, 1636421912597, 264, 0, 264, 0, 0, 0
5180, 1, 1636421912405, 1636421912669, 264, 1, 263, 0, 0, 0
5181, 1, 1636421912501, 1636421912770, 269, 1, 268, 0, 0, 0
5183, 1, 1636421912593, 1636421912857, 264, 0, 264, 0, 0, 0
5184, 1, 1636421912641, 1636421912909, 268, 0, 268, 0, 0, 0
5182, 1, 1636421912669, 1636421912934, 265, 1, 264, 1, 0, 1
5185, 1, 1636421912873, 1636421913137, 264, 0, 264, 0, 0, 0
5186, 1, 1636421912909, 1636421913173, 264, 0, 264, 0, 0, 0
5187, 1, 1636421912997, 1636421913265, 268, 1, 267, 1, 0, 1
5189, 1, 1636421913073, 1636421913342, 269, 0, 269, 0, 0, 0
5190, 1, 1636421913173, 1636421913442, 269, 0, 269, 0, 0, 0
5191, 1, 1636421913269, 1636421913533, 264, 1, 263, 0, 0, 0
5188, 1, 1636421913269, 1636421913537, 268, 0, 268, 0, 0, 0
5192, 1, 1636421913309, 1636421913581, 272, 1, 271, 0, 0, 0
5193, 1, 1636421913333, 1636421913597, 264, 1, 263, 0, 1, 1
5194, 1, 1636421913537, 1636421913797, 260, 0, 260, 0, 0, 0
5195, 1, 1636421913577, 1636421913841, 264, 0, 264, 0, 0, 0
5196, 1, 1636421913673, 1636421913937, 264, 0, 264, 0, 0, 0
5197, 1, 1636421913742, 1636421914005, 263, 0, 263, 0, 0, 0
5198, 1, 1636421913845, 1636421914110, 265, 0, 265, 0, 0, 0
5199, 1, 1636421913933, 1636421914205, 272, 1, 271, 0, 0, 0
5200, 1, 1636421913937, 1636421914205, 268, 1, 267, 0, 0, 0
5201, 1, 1636421913981, 1636421914245, 264, 0, 264, 0, 0, 0
5202, 1, 1636421914001, 1636421914270, 269, 1, 268, 1, 0, 1
5203, 1, 1636421914205, 1636421914469, 264, 1, 263, 0, 1, 1
5204, 1, 1636421914245, 1636421914510, 265, 1, 264, 0, 0, 0
5205, 1, 1636421914341, 1636421914609, 268, 1, 267, 0, 1, 1
5206, 1, 1636421914409, 1636421914673, 264, 1, 263, 0, 1, 1
5207, 1, 1636421914510, 1636421914773, 263, 0, 263, 0, 0, 0
5209, 1, 1636421914601, 1636421914866, 265, 0, 265, 0, 0, 0
5210, 1, 1636421914649, 1636421914913, 264, 0, 264, 0, 0, 0
5211, 1, 1636421914661, 1636421914925, 264, 0, 264, 0, 0, 0
5212, 1, 1636421914866, 1636421915129, 263, 0, 263, 0, 0, 0
5213, 1, 1636421914913, 1636421915181, 268, 1, 267, 0, 1, 1
5214, 1, 1636421915018, 1636421915281, 263, 0, 263, 0, 0, 0
5216, 1, 1636421915173, 1636421915441, 268, 1, 267, 0, 1, 1
5217, 1, 1636421915273, 1636421915537, 264, 0, 264, 0, 0, 0
5218, 1, 1636421915317, 1636421915581, 264, 1, 263, 0, 1, 1
5219, 1, 1636421915337, 1636421915605, 268, 1, 267, 0, 0, 0
5220, 1, 1636421915537, 1636421915806, 269, 1, 268, 0, 0, 0
5221, 1, 1636421915581, 1636421915850, 269, 1, 268, 0, 0, 0
5222, 1, 1636421915689, 1636421915954, 265, 0, 265, 0, 0, 0
5223, 1, 1636421915842, 1636421916105, 263, 0, 263, 0, 0, 0
5225, 1, 1636421915989, 1636421916254, 265, 1, 264, 0, 1, 1
5226, 1, 1636421916001, 1636421916266, 265, 0, 265, 0, 0, 0
5227, 1, 1636421916210, 1636421916478, 268, 0, 268, 0, 0, 0
5229, 1, 1636421916358, 1636421916621, 263, 0, 263, 0, 0, 0
5230, 1, 1636421916510, 1636421916778, 268, 0, 268, 0, 0, 0
5231, 1, 1636421916657, 1636421916925, 268, 0, 268, 0, 0, 0
5232, 1, 1636421916669, 1636421916933, 264, 0, 264, 0, 0, 0
5233, 1, 1636421916874, 1636421917137, 263, 0, 263, 0, 0, 0
5234, 1, 1636421917066, 1636421917330, 264, 0, 264, 0, 0, 0
5235, 1, 1636421917181, 1636421917445, 264, 1, 263, 1, 0, 1
5236, 1, 1636421917193, 1636421917458, 265, 0, 265, 0, 0, 0
5238, 1, 1636421917469, 1636421917737, 268, 1, 267, 0, 0, 0
5239, 1, 1636421917541, 1636421917813, 272, 1, 271, 0, 1, 1
5240, 1, 1636421917762, 1636421918026, 264, 0, 264, 0, 0, 0
5242, 1, 1636421917857, 1636421918122, 265, 0, 265, 0, 0, 0
5243, 1, 1636421917889, 1636421918153, 264, 1, 263, 0, 1, 1
5244, 1, 1636421918133, 1636421918398, 265, 1, 264, 0, 0, 0
5246, 1, 1636421918461, 1636421918725, 264, 1, 263, 0, 1, 1
5248, 1, 1636421918554, 1636421918909, 355, 0, 355, 0, 0, 0
5247, 1, 1636421918554, 1636421918909, 355, 0, 355, 0, 0, 0
5157, 1, 1636421918833, 1636421919097, 264, 1, 263, 0, 0, 0
5250, 1, 1636421918929, 1636421919194, 265, 1, 264, 0, 0, 0
5152, 1, 1636421919101, 1636421919366, 265, 1, 264, 1, 0, 1
5251, 1, 1636421919194, 1636421919462, 268, 0, 268, 0, 0, 0
5254, 1, 1636421919321, 1636421919585, 264, 0, 264, 0, 0, 0
5253, 1, 1636421919321, 1636421919585, 264, 1, 263, 0, 0, 0
5257, 1, 1636421919541, 1636421919805, 264, 1, 263, 0, 0, 0
5258, 1, 1636421919601, 1636421919866, 265, 0, 265, 0, 0, 0
5260, 1, 1636421919869, 1636421920133, 264, 0, 264, 0, 0, 0
5261, 1, 1636421919993, 1636421920257, 264, 0, 264, 0, 0, 0
5262, 1, 1636421919993, 1636421920257, 264, 1, 263, 0, 1, 1
5263, 1, 1636421920210, 1636421920517, 307, 0, 307, 0, 0, 0
5264, 1, 1636421920269, 1636421920534, 265, 0, 265, 0, 0, 0
5266, 1, 1636421920662, 1636421920926, 264, 0, 264, 0, 0, 0
5267, 1, 1636421920662, 1636421920926, 264, 0, 264, 0, 0, 0
5268, 1, 1636421920786, 1636421921050, 264, 0, 264, 0, 0, 0
5269, 1, 1636421920918, 1636421921182, 264, 0, 264, 0, 0, 0
5270, 1, 1636421920929, 1636421921197, 268, 1, 267, 0, 0, 0
5272, 1, 1636421921329, 1636421921593, 264, 1, 263, 0, 1, 1
5271, 1, 1636421921329, 1636421921593, 264, 1, 263, 0, 1, 1
5274, 1, 1636421921585, 1636421921849, 264, 0, 264, 0, 0, 0
5275, 1, 1636421921605, 1636421921870, 265, 0, 265, 0, 0, 0
5276, 1, 1636421922009, 1636421922273, 264, 1, 263, 0, 1, 1
5277, 1, 1636421922009, 1636421922277, 268, 1, 267, 0, 1, 1
5278, 1, 1636421922226, 1636421922490, 264, 0, 264, 0, 0, 0
5279, 1, 1636421922285, 1636421922549, 264, 1, 263, 0, 1, 1
5280, 1, 1636421922285, 1636421922550, 265, 1, 264, 1, 0, 1
5281, 1, 1636421922641, 1636421922906, 265, 0, 265, 0, 0, 0
5282, 1, 1636421922677, 1636421922941, 264, 0, 264, 0, 0, 0
5283, 1, 1636421922682, 1636421922946, 264, 0, 264, 0, 0, 0
5285, 1, 1636421922961, 1636421923229, 268, 1, 267, 0, 0, 0
5286, 1, 1636421922961, 1636421923229, 268, 1, 267, 0, 0, 0
5288, 1, 1636421923346, 1636421923609, 263, 0, 263, 0, 0, 0
5289, 1, 1636421923346, 1636421923609, 263, 0, 263, 0, 0, 0
5290, 1, 1636421923633, 1636421923898, 265, 0, 265, 0, 0, 0
5291, 1, 1636421923638, 1636421923906, 268, 0, 268, 0, 0, 0
5293, 1, 1636421924013, 1636421924278, 265, 1, 264, 0, 0, 0
5292, 1, 1636421924013, 1636421924281, 268, 1, 267, 0, 1, 1
5294, 1, 1636421924305, 1636421924569, 264, 1, 263, 0, 0, 0
5295, 1, 1636421924313, 1636421924581, 268, 1, 267, 0, 1, 1
5296, 1, 1636421924697, 1636421924962, 265, 1, 264, 1, 0, 1
5297, 1, 1636421924697, 1636421924965, 268, 1, 267, 1, 0, 1
5298, 1, 1636421924937, 1636421925201, 264, 1, 263, 0, 0, 0
5299, 1, 1636421924977, 1636421925242, 265, 1, 264, 1, 0, 1
5300, 1, 1636421925029, 1636421925293, 264, 1, 263, 0, 1, 1
5302, 1, 1636421925362, 1636421925626, 264, 0, 264, 0, 0, 0
5301, 1, 1636421925362, 1636421925626, 264, 0, 264, 0, 0, 0
5303, 1, 1636421925369, 1636421925637, 268, 0, 268, 0, 0, 0
5305, 1, 1636421925645, 1636421925909, 264, 1, 263, 0, 0, 0
5306, 1, 1636421925697, 1636421925981, 284, 1, 283, 1, 0, 1
5308, 1, 1636421926037, 1636421926301, 264, 1, 263, 0, 0, 0
5307, 1, 1636421926037, 1636421926302, 265, 1, 264, 0, 0, 0
5310, 1, 1636421926249, 1636421926517, 268, 1, 267, 0, 1, 1
5311, 1, 1636421926341, 1636421926605, 264, 0, 264, 0, 0, 0
5312, 1, 1636421926385, 1636421926653, 268, 1, 267, 0, 0, 0
5313, 1, 1636421926561, 1636421926826, 265, 1, 264, 0, 0, 0
5314, 1, 1636421926701, 1636421926965, 264, 1, 263, 0, 1, 1
5315, 1, 1636421926697, 1636421926965, 268, 1, 267, 0, 1, 1
5317, 1, 1636421927009, 1636421927270, 261, 0, 261, 0, 0, 0
5318, 1, 1636421927053, 1636421927321, 268, 0, 268, 0, 0, 0
5320, 1, 1636421927373, 1636421927637, 264, 1, 263, 0, 0, 0
5321, 1, 1636421927373, 1636421927638, 265, 1, 264, 0, 0, 0
5322, 1, 1636421927637, 1636421927901, 264, 1, 263, 1, 0, 1
5323, 1, 1636421927713, 1636421927978, 265, 0, 265, 0, 0, 0
5324, 1, 1636421927725, 1636421927985, 260, 0, 260, 0, 0, 0
5326, 1, 1636421928081, 1636421928345, 264, 1, 263, 0, 0, 0
5325, 1, 1636421928081, 1636421928349, 268, 1, 267, 0, 0, 0
5327, 1, 1636421928173, 1636421928437, 264, 0, 264, 0, 0, 0
5330, 1, 1636421928390, 1636421928654, 264, 0, 264, 0, 0, 0
5329, 1, 1636421928390, 1636421928654, 264, 0, 264, 0, 0, 0
5331, 1, 1636421928529, 1636421928793, 264, 1, 263, 0, 0, 0
5333, 1, 1636421928762, 1636421929025, 263, 0, 263, 0, 0, 0
5332, 1, 1636421928762, 1636421929025, 263, 0, 263, 0, 0, 0
5335, 1, 1636421929061, 1636421929325, 264, 1, 263, 1, 0, 1
5336, 1, 1636421929061, 1636421929325, 264, 1, 263, 0, 0, 0
5337, 1, 1636421929138, 1636421929402, 264, 0, 264, 0, 0, 0
5339, 1, 1636421929458, 1636421929725, 267, 0, 267, 0, 0, 0
5340, 1, 1636421929458, 1636421929725, 267, 0, 267, 0, 0, 0
5342, 1, 1636421929725, 1636421929993, 268, 1, 267, 1, 0, 1
5343, 1, 1636421929725, 1636421929993, 268, 1, 267, 1, 0, 1
5344, 1, 1636421929762, 1636421930033, 271, 0, 271, 0, 0, 0
5348, 1, 1636421930130, 1636421930393, 263, 0, 263, 0, 0, 0
5349, 1, 1636421930130, 1636421930393, 263, 0, 263, 0, 0, 0
5351, 1, 1636421930429, 1636421930693, 264, 0, 264, 0, 0, 0
5350, 1, 1636421930429, 1636421930697, 268, 0, 268, 0, 0, 0
5352, 1, 1636421930437, 1636421930705, 268, 0, 268, 0, 0, 0
5353, 1, 1636421930797, 1636421931061, 264, 1, 263, 0, 0, 0
5355, 1, 1636421930873, 1636421931138, 265, 0, 265, 0, 0, 0
5356, 1, 1636421931097, 1636421931362, 265, 0, 265, 0, 0, 0
5357, 1, 1636421931101, 1636421931365, 264, 1, 263, 0, 0, 0
5358, 1, 1636421931105, 1636421931369, 264, 0, 264, 0, 0, 0
5362, 1, 1636421931766, 1636421932030, 264, 0, 264, 0, 0, 0
5363, 1, 1636421931770, 1636421932038, 268, 0, 268, 0, 0, 0
5364, 1, 1636421931770, 1636421932046, 276, 0, 276, 0, 0, 0
5365, 1, 1636421932433, 1636421932702, 269, 1, 268, 0, 0, 0
5367, 1, 1636421932450, 1636421932713, 263, 0, 263, 0, 0, 0
5369, 1, 1636421933114, 1636421933378, 264, 0, 264, 0, 0, 0
5372, 1, 1636421933782, 1636421934054, 272, 0, 272, 0, 0, 0
5373, 1, 1636421934458, 1636421934722, 264, 0, 264, 0, 0, 0
5374, 1, 1636421935125, 1636421935398, 273, 1, 272, 0, 0, 0
5375, 1, 1636421935793, 1636421936078, 285, 1, 284, 0, 0, 0
5378, 1, 1636421936482, 1636421936749, 267, 0, 267, 0, 0, 0
5379, 1, 1636421937189, 1636421937454, 265, 1, 264, 0, 1, 1
5382, 1, 1636421937862, 1636421938126, 264, 0, 264, 0, 0, 0
5383, 1, 1636421938526, 1636421938794, 268, 0, 268, 0, 0, 0
5386, 1, 1636421939198, 1636421939470, 272, 0, 272, 0, 0, 0
5388, 1, 1636421939818, 1636421940118, 300, 0, 300, 0, 0, 0
5389, 1, 1636421939941, 1636421940206, 265, 0, 265, 0, 0, 0
5392, 1, 1636421940382, 1636421940650, 268, 0, 268, 0, 0, 0
5393, 1, 1636421940525, 1636421940837, 312, 1, 311, 0, 0, 0
5394, 1, 1636421940614, 1636421940878, 264, 0, 264, 0, 0, 0
5391, 1, 1636421940661, 1636421940925, 264, 0, 264, 0, 0, 0
5395, 1, 1636421941053, 1636421941317, 264, 1, 263, 0, 1, 1
5396, 1, 1636421941105, 1636421941377, 272, 1, 271, 0, 1, 1
5398, 1, 1636421941277, 1636421941581, 304, 1, 303, 0, 0, 0
5397, 1, 1636421941238, 1636421941581, 343, 0, 343, 0, 0, 0
5399, 1, 1636421941406, 1636421941670, 264, 0, 264, 0, 0, 0
5400, 1, 1636421941717, 1636421941981, 264, 1, 263, 0, 1, 1
5402, 1, 1636421941846, 1636421942113, 267, 0, 267, 0, 0, 0
5405, 1, 1636421941977, 1636421942249, 272, 1, 271, 0, 0, 0
5404, 1, 1636421941977, 1636421942250, 273, 1, 272, 0, 1, 1
5407, 1, 1636421942066, 1636421942330, 264, 0, 264, 0, 0, 0
5406, 1, 1636421942066, 1636421942330, 264, 0, 264, 0, 0, 0
5408, 1, 1636421942397, 1636421942665, 268, 1, 267, 0, 1, 1
5410, 1, 1636421942657, 1636421942922, 265, 1, 264, 0, 1, 1
5411, 1, 1636421942657, 1636421942922, 265, 1, 264, 1, 0, 1
5413, 1, 1636421942734, 1636421942998, 264, 0, 264, 0, 0, 0
5412, 1, 1636421942734, 1636421942998, 264, 0, 264, 0, 0, 0
5414, 1, 1636421942749, 1636421943013, 264, 0, 264, 0, 0, 0
5415, 1, 1636421943069, 1636421943337, 268, 1, 267, 0, 0, 0
5417, 1, 1636421943325, 1636421943594, 269, 1, 268, 0, 0, 0
5418, 1, 1636421943401, 1636421943666, 265, 1, 264, 0, 0, 0
5419, 1, 1636421943401, 1636421943666, 265, 1, 264, 0, 0, 0
5420, 1, 1636421943421, 1636421943686, 265, 0, 265, 0, 0, 0
5422, 1, 1636421943502, 1636421943766, 264, 0, 264, 0, 0, 0
5423, 1, 1636421943737, 1636421944002, 265, 1, 264, 0, 1, 1
5424, 1, 1636421943930, 1636421944193, 263, 0, 263, 0, 0, 0
5425, 1, 1636421944001, 1636421944266, 265, 1, 264, 0, 0, 0
5426, 1, 1636421944074, 1636421944338, 264, 0, 264, 0, 0, 0
5427, 1, 1636421944074, 1636421944338, 264, 0, 264, 0, 0, 0
5429, 1, 1636421944173, 1636421944441, 268, 1, 267, 0, 0, 0
5430, 1, 1636421944401, 1636421944665, 264, 0, 264, 0, 0, 0
5431, 1, 1636421944605, 1636421944873, 268, 1, 267, 0, 1, 1
5432, 1, 1636421944665, 1636421944930, 265, 1, 264, 0, 0, 0
5433, 1, 1636421944741, 1636421945010, 269, 0, 269, 0, 0, 0
5434, 1, 1636421944741, 1636421945010, 269, 0, 269, 0, 0, 0
5435, 1, 1636421944845, 1636421945114, 269, 1, 268, 0, 1, 1
5436, 1, 1636421945069, 1636421945334, 265, 1, 264, 1, 0, 1
5437, 1, 1636421945281, 1636421945545, 264, 1, 263, 1, 0, 1
5438, 1, 1636421945342, 1636421945605, 263, 0, 263, 0, 0, 0
5439, 1, 1636421945413, 1636421945678, 265, 1, 264, 0, 0, 0
5440, 1, 1636421945413, 1636421945678, 265, 1, 264, 0, 0, 0
5441, 1, 1636421945518, 1636421945781, 263, 0, 263, 0, 0, 0
5442, 1, 1636421945781, 1636421946053, 272, 0, 272, 0, 0, 0
5443, 1, 1636421945965, 1636421946234, 269, 0, 269, 0, 0, 0
5444, 1, 1636421946013, 1636421946277, 264, 0, 264, 0, 0, 0
5446, 1, 1636421946093, 1636421946381, 288, 1, 287, 0, 0, 0
5445, 1, 1636421946093, 1636421946381, 288, 1, 287, 1, 0, 1
5447, 1, 1636421946205, 1636421946474, 269, 1, 268, 0, 0, 0
5448, 1, 1636421946229, 1636421946493, 264, 1, 263, 0, 1, 1
5449, 1, 1636421946454, 1636421946721, 267, 0, 267, 0, 0, 0
5451, 1, 1636421946641, 1636421946909, 268, 1, 267, 1, 0, 1
5450, 1, 1636421946641, 1636421946909, 268, 1, 267, 0, 0, 0
5452, 1, 1636421946677, 1636421946941, 264, 1, 263, 0, 0, 0
5454, 1, 1636421946785, 1636421947050, 265, 1, 264, 1, 0, 1
5453, 1, 1636421946785, 1636421947053, 268, 1, 267, 0, 0, 0
5455, 1, 1636421946877, 1636421947137, 260, 0, 260, 0, 0, 0
5456, 1, 1636421946901, 1636421947165, 264, 1, 263, 0, 0, 0
5457, 1, 1636421947125, 1636421947390, 265, 0, 265, 0, 0, 0
5459, 1, 1636421947318, 1636421947585, 267, 0, 267, 0, 0, 0
5458, 1, 1636421947318, 1636421947589, 271, 0, 271, 0, 0, 0
5460, 1, 1636421947345, 1636421947609, 264, 0, 264, 0, 0, 0
5461, 1, 1636421947493, 1636421947765, 272, 1, 271, 0, 1, 1
5462, 1, 1636421947493, 1636421947766, 273, 1, 272, 0, 0, 0
5463, 1, 1636421947529, 1636421947801, 272, 0, 272, 0, 0, 0
5465, 1, 1636421947581, 1636421947853, 272, 1, 271, 1, 0, 1
5464, 1, 1636421947581, 1636421947854, 273, 1, 272, 1, 0, 1
5466, 1, 1636421947793, 1636421948057, 264, 0, 264, 0, 0, 0
5467, 1, 1636421947853, 1636421948126, 273, 1, 272, 0, 1, 1
5468, 1, 1636421947993, 1636421948257, 264, 1, 263, 0, 1, 1
5469, 1, 1636421947993, 1636421948261, 268, 1, 267, 0, 0, 0
5470, 1, 1636421948017, 1636421948282, 265, 0, 265, 0, 0, 0
5471, 1, 1636421948165, 1636421948433, 268, 1, 267, 0, 1, 1
5472, 1, 1636421948177, 1636421948441, 264, 0, 264, 0, 0, 0
5473, 1, 1636421948206, 1636421948469, 263, 0, 263, 0, 0, 0
5475, 1, 1636421948257, 1636421948521, 264, 0, 264, 0, 0, 0
5474, 1, 1636421948261, 1636421948529, 268, 0, 268, 0, 0, 0
5476, 1, 1636421948485, 1636421948749, 264, 0, 264, 0, 0, 0
5477, 1, 1636421948521, 1636421948785, 264, 1, 263, 0, 0, 0
5479, 1, 1636421948669, 1636421948933, 264, 1, 263, 0, 0, 0
5478, 1, 1636421948669, 1636421948933, 264, 1, 263, 1, 0, 1
5480, 1, 1636421948717, 1636421948985, 268, 0, 268, 0, 0, 0
5481, 1, 1636421948837, 1636421949102, 265, 0, 265, 0, 0, 0
5482, 1, 1636421948849, 1636421949121, 272, 1, 271, 1, 0, 1
5483, 1, 1636421948874, 1636421949137, 263, 0, 263, 0, 0, 0
5486, 1, 1636421948933, 1636421949201, 268, 1, 267, 0, 0, 0
5485, 1, 1636421948929, 1636421949202, 273, 0, 273, 0, 0, 0
5484, 1, 1636421948925, 1636421949201, 276, 1, 275, 0, 0, 0
5487, 1, 1636421949149, 1636421949421, 272, 1, 271, 0, 0, 0
5488, 1, 1636421949209, 1636421949473, 264, 0, 264, 0, 0, 0
5489, 1, 1636421949345, 1636421949613, 268, 1, 267, 0, 0, 0
5490, 1, 1636421949345, 1636421949614, 269, 1, 268, 0, 1, 1
5491, 1, 1636421949401, 1636421949669, 268, 1, 267, 0, 0, 0
5492, 1, 1636421949493, 1636421949757, 264, 0, 264, 0, 0, 0
5493, 1, 1636421949505, 1636421949766, 261, 0, 261, 0, 0, 0
5494, 1, 1636421949529, 1636421949793, 264, 1, 263, 0, 0, 0
5495, 1, 1636421949581, 1636421949845, 264, 1, 263, 0, 0, 0
5498, 1, 1636421949629, 1636421949889, 260, 0, 260, 0, 0, 0
5496, 1, 1636421949633, 1636421949897, 264, 1, 263, 0, 0, 0
5497, 1, 1636421949633, 1636421949901, 268, 0, 268, 0, 0, 0
5499, 1, 1636421949826, 1636421950093, 267, 0, 267, 0, 0, 0
5500, 1, 1636421949837, 1636421950101, 264, 0, 264, 0, 0, 0
5501, 1, 1636421949877, 1636421950165, 288, 1, 287, 0, 0, 0
5503, 1, 1636421950010, 1636421950277, 267, 0, 267, 0, 0, 0
5502, 1, 1636421950017, 1636421950285, 268, 1, 267, 0, 0, 0
5504, 1, 1636421950081, 1636421950349, 268, 0, 268, 0, 0, 0
5505, 1, 1636421950173, 1636421950437, 264, 1, 263, 0, 0, 0
5506, 1, 1636421950173, 1636421950437, 264, 1, 263, 1, 0, 1
5507, 1, 1636421950217, 1636421950485, 268, 1, 267, 0, 1, 1
5508, 1, 1636421950249, 1636421950517, 268, 1, 267, 0, 1, 1
5509, 1, 1636421950297, 1636421950561, 264, 0, 264, 0, 0, 0
5510, 1, 1636421950305, 1636421950569, 264, 1, 263, 1, 0, 1
5511, 1, 1636421950305, 1636421950573, 268, 1, 267, 1, 0, 1
5512, 1, 1636421950417, 1636421950681, 264, 0, 264, 0, 0, 0
5513, 1, 1636421950489, 1636421950753, 264, 0, 264, 0, 0, 0
5514, 1, 1636421950506, 1636421950769, 263, 0, 263, 0, 0, 0
5515, 1, 1636421950565, 1636421950829, 264, 1, 263, 1, 0, 1
5516, 1, 1636421950673, 1636421950941, 268, 0, 268, 0, 0, 0
5517, 1, 1636421950685, 1636421950949, 264, 0, 264, 0, 0, 0
5518, 1, 1636421950749, 1636421951017, 268, 0, 268, 0, 0, 0
5520, 1, 1636421950841, 1636421951106, 265, 0, 265, 0, 0, 0
5519, 1, 1636421950841, 1636421951106, 265, 0, 265, 0, 0, 0
5521, 1, 1636421950885, 1636421951149, 264, 1, 263, 0, 1, 1
5522, 1, 1636421950921, 1636421951185, 264, 0, 264, 0, 0, 0
5523, 1, 1636421950965, 1636421951229, 264, 1, 263, 0, 0, 0
5524, 1, 1636421950981, 1636421951245, 264, 1, 263, 1, 0, 1
5525, 1, 1636421950981, 1636421951253, 272, 1, 271, 1, 0, 1
5526, 1, 1636421951077, 1636421951341, 264, 0, 264, 0, 0, 0
5527, 1, 1636421951165, 1636421951433, 268, 1, 267, 1, 0, 1
5528, 1, 1636421951173, 1636421951441, 268, 1, 267, 0, 0, 0
5529, 1, 1636421951229, 1636421951493, 264, 1, 263, 0, 0, 0
5531, 1, 1636421951353, 1636421951617, 264, 0, 264, 0, 0, 0
5530, 1, 1636421951349, 1636421951617, 268, 0, 268, 0, 0, 0
5532, 1, 1636421951425, 1636421951698, 273, 0, 273, 0, 0, 0
5533, 1, 1636421951509, 1636421951773, 264, 1, 263, 0, 0, 0
5534, 1, 1636421951513, 1636421951777, 264, 0, 264, 0, 0, 0
5536, 1, 1636421951585, 1636421951898, 313, 1, 312, 1, 0, 1
5535, 1, 1636421951557, 1636421951898, 341, 0, 341, 0, 0, 0
5538, 1, 1636421951721, 1636421951985, 264, 1, 263, 1, 0, 1
5539, 1, 1636421951721, 1636421951989, 268, 1, 267, 1, 0, 1
5537, 1, 1636421951721, 1636421951989, 268, 1, 267, 0, 0, 0
5540, 1, 1636421951813, 1636421952077, 264, 0, 264, 0, 0, 0
5542, 1, 1636421951901, 1636421952165, 264, 1, 263, 1, 0, 1
5543, 1, 1636421951905, 1636421952169, 264, 0, 264, 0, 0, 0
5541, 1, 1636421951901, 1636421952169, 268, 1, 267, 0, 0, 0
5544, 1, 1636421952033, 1636421952297, 264, 1, 263, 0, 1, 1
5545, 1, 1636421952033, 1636421952301, 268, 1, 267, 0, 0, 0
5546, 1, 1636421952093, 1636421952361, 268, 1, 267, 0, 0, 0
5548, 1, 1636421952158, 1636421952421, 263, 0, 263, 0, 0, 0
5549, 1, 1636421952173, 1636421952441, 268, 0, 268, 0, 0, 0
5550, 1, 1636421952181, 1636421952453, 272, 0, 272, 0, 0, 0
5551, 1, 1636421952305, 1636421952586, 281, 1, 280, 1, 0, 1
5552, 1, 1636421952305, 1636421952586, 281, 1, 280, 0, 1, 1
5554, 1, 1636421952401, 1636421952674, 273, 0, 273, 0, 0, 0
5555, 1, 1636421952401, 1636421952674, 273, 1, 272, 0, 0, 0
5553, 1, 1636421952393, 1636421952674, 281, 1, 280, 0, 1, 1
5556, 1, 1636421952485, 1636421952761, 276, 1, 275, 0, 0, 0
5558, 1, 1636421952586, 1636421952849, 263, 1, 262, 1, 0, 1
5559, 1, 1636421952569, 1636421952850, 281, 1, 280, 0, 0, 0
5557, 1, 1636421952569, 1636421952849, 280, 1, 279, 0, 0, 0
5560, 1, 1636421952717, 1636421952982, 265, 1, 264, 0, 1, 1
5561, 1, 1636421952717, 1636421952982, 265, 1, 264, 0, 1, 1
5562, 1, 1636421952761, 1636421953025, 264, 0, 264, 0, 0, 0
5563, 1, 1636421952817, 1636421953089, 272, 0, 272, 0, 0, 0
5566, 1, 1636421952857, 1636421953121, 264, 1, 263, 0, 0, 0
5565, 1, 1636421952857, 1636421953129, 272, 0, 272, 0, 0, 0
5567, 1, 1636421952981, 1636421953250, 269, 1, 268, 0, 0, 0
5568, 1, 1636421952989, 1636421953250, 261, 0, 261, 0, 0, 0
5571, 1, 1636421953073, 1636421953361, 288, 1, 287, 1, 0, 1
5569, 1, 1636421953073, 1636421953366, 293, 1, 292, 0, 0, 0
5570, 1, 1636421953073, 1636421953366, 293, 1, 292, 1, 0, 1
5572, 1, 1636421953189, 1636421953461, 272, 1, 271, 0, 0, 0
5573, 1, 1636421953281, 1636421953549, 268, 1, 267, 0, 0, 0
5574, 1, 1636421953281, 1636421953549, 268, 1, 267, 0, 0, 0
5575, 1, 1636421953281, 1636421953558, 277, 1, 276, 1, 0, 1
5576, 1, 1636421953409, 1636421953673, 264, 1, 263, 0, 1, 1
5577, 1, 1636421953417, 1636421953685, 268, 1, 267, 1, 0, 1
5579, 1, 1636421953505, 1636421953769, 264, 0, 264, 0, 0, 0
5581, 1, 1636421953534, 1636421953797, 263, 0, 263, 0, 0, 0
5580, 1, 1636421953557, 1636421953821, 264, 1, 263, 0, 0, 0
5582, 1, 1636421953629, 1636421953893, 264, 1, 263, 0, 0, 0
5584, 1, 1636421953653, 1636421953921, 268, 1, 267, 0, 0, 0
5583, 1, 1636421953653, 1636421953921, 268, 1, 267, 1, 0, 1
5586, 1, 1636421953773, 1636421954037, 264, 0, 264, 0, 0, 0
5587, 1, 1636421953777, 1636421954045, 268, 0, 268, 0, 0, 0
5588, 1, 1636421953777, 1636421954045, 268, 0, 268, 0, 0, 0
5589, 1, 1636421953853, 1636421954133, 280, 0, 280, 0, 0, 0
5591, 1, 1636421953957, 1636421954217, 260, 0, 260, 0, 0, 0
5590, 1, 1636421953957, 1636421954217, 260, 0, 260, 0, 0, 0
5593, 1, 1636421954078, 1636421954341, 263, 0, 263, 0, 0, 0
5594, 1, 1636421954089, 1636421954353, 264, 1, 263, 1, 0, 1
5595, 1, 1636421954189, 1636421954453, 264, 0, 264, 0, 0, 0
5596, 1, 1636421954201, 1636421954465, 264, 1, 263, 0, 0, 0
5599, 1, 1636421954325, 1636421954593, 268, 1, 267, 0, 0, 0
5600, 1, 1636421954325, 1636421954594, 269, 1, 268, 1, 0, 1
5604, 1, 1636421954445, 1636421954709, 264, 1, 263, 1, 0, 1
5603, 1, 1636421954445, 1636421954713, 268, 1, 267, 1, 0, 1
5602, 1, 1636421954441, 1636421954717, 276, 0, 276, 0, 0, 0
5605, 1, 1636421954533, 1636421954797, 264, 0, 264, 0, 0, 0
5607, 1, 1636421954621, 1636421954886, 265, 1, 264, 1, 0, 1
5606, 1, 1636421954621, 1636421954886, 265, 1, 264, 0, 0, 0
5608, 1, 1636421954737, 1636421955001, 264, 1, 263, 0, 0, 0
5609, 1, 1636421954773, 1636421955037, 264, 0, 264, 0, 0, 0
5610, 1, 1636421954861, 1636421955125, 264, 1, 263, 0, 0, 0
5611, 1, 1636421954865, 1636421955137, 272, 0, 272, 0, 0, 0
5612, 1, 1636421954997, 1636421955261, 264, 0, 264, 0, 0, 0
5613, 1, 1636421954997, 1636421955261, 264, 0, 264, 0, 0, 0
5615, 1, 1636421955125, 1636421955393, 268, 1, 267, 1, 0, 1
5614, 1, 1636421955125, 1636421955394, 269, 1, 268, 0, 0, 0
5616, 1, 1636421955125, 1636421955394, 269, 1, 268, 0, 0, 0
5617, 1, 1636421955197, 1636421955461, 264, 0, 264, 0, 0, 0
5618, 1, 1636421955289, 1636421955557, 268, 1, 267, 1, 0, 1
5619, 1, 1636421955289, 1636421955561, 272, 1, 271, 0, 0, 0
5620, 1, 1636421955409, 1636421955673, 264, 1, 263, 1, 0, 1
5621, 1, 1636421955437, 1636421955702, 265, 1, 264, 0, 0, 0
5622, 1, 1636421955529, 1636421955798, 269, 0, 269, 0, 0, 0
5623, 1, 1636421955533, 1636421955801, 268, 0, 268, 0, 0, 0
5625, 1, 1636421955665, 1636421955933, 268, 1, 267, 0, 1, 1
5627, 1, 1636421955798, 1636421956065, 267, 0, 267, 0, 0, 0
5628, 1, 1636421955798, 1636421956065, 267, 1, 266, 0, 1, 1
5626, 1, 1636421955798, 1636421956069, 271, 1, 270, 0, 0, 0
5629, 1, 1636421955870, 1636421956133, 263, 0, 263, 0, 0, 0
5630, 1, 1636421955965, 1636421956229, 264, 1, 263, 0, 0, 0
5631, 1, 1636421955965, 1636421956233, 268, 1, 267, 0, 0, 0
5632, 1, 1636421956073, 1636421956338, 265, 0, 265, 0, 0, 0
5633, 1, 1636421956109, 1636421956373, 264, 1, 263, 0, 0, 0
5635, 1, 1636421956209, 1636421956477, 268, 1, 267, 0, 1, 1
5634, 1, 1636421956209, 1636421956477, 268, 1, 267, 1, 0, 1
5636, 1, 1636421956337, 1636421956601, 264, 1, 263, 0, 0, 0
5638, 1, 1636421956469, 1636421956734, 265, 1, 264, 0, 0, 0
5637, 1, 1636421956469, 1636421956734, 265, 1, 264, 1, 0, 1
5639, 1, 1636421956469, 1636421956734, 265, 1, 264, 1, 0, 1
5640, 1, 1636421956541, 1636421956809, 268, 1, 267, 0, 1, 1
5641, 1, 1636421956633, 1636421956901, 268, 1, 267, 1, 0, 1
5642, 1, 1636421956633, 1636421956905, 272, 1, 271, 1, 0, 1
5643, 1, 1636421956734, 1636421956997, 263, 1, 262, 0, 1, 1
5644, 1, 1636421956773, 1636421957037, 264, 0, 264, 0, 0, 0
5645, 1, 1636421956881, 1636421957145, 264, 1, 263, 0, 0, 0
5646, 1, 1636421956881, 1636421957145, 264, 1, 263, 0, 0, 0
5647, 1, 1636421957009, 1636421957273, 264, 1, 263, 0, 1, 1
5650, 1, 1636421957137, 1636421957402, 265, 1, 264, 0, 1, 1
5648, 1, 1636421957137, 1636421957402, 265, 1, 264, 1, 0, 1
5651, 1, 1636421957210, 1636421957474, 264, 0, 264, 0, 0, 0
5652, 1, 1636421957301, 1636421957565, 264, 1, 263, 0, 1, 1
5653, 1, 1636421957314, 1636421957577, 263, 0, 263, 0, 0, 0
5654, 1, 1636421957405, 1636421957669, 264, 0, 264, 0, 0, 0
5657, 1, 1636421957557, 1636421957821, 264, 1, 263, 0, 0, 0
5656, 1, 1636421957557, 1636421957822, 265, 1, 264, 0, 0, 0
5658, 1, 1636421957669, 1636421957933, 264, 0, 264, 0, 0, 0
5659, 1, 1636421957806, 1636421958069, 263, 0, 263, 0, 0, 0
5660, 1, 1636421957806, 1636421958073, 267, 0, 267, 0, 0, 0
5661, 1, 1636421957882, 1636421958145, 263, 0, 263, 0, 0, 0
5662, 1, 1636421957973, 1636421958237, 264, 1, 263, 0, 1, 1
5663, 1, 1636421957977, 1636421958241, 264, 0, 264, 0, 0, 0
5664, 1, 1636421958073, 1636421958341, 268, 1, 267, 0, 1, 1
5666, 1, 1636421958221, 1636421958485, 264, 1, 263, 1, 0, 1
5665, 1, 1636421958225, 1636421958489, 264, 0, 264, 0, 0, 0
5667, 1, 1636421958349, 1636421958613, 264, 1, 263, 0, 0, 0
5669, 1, 1636421958477, 1636421958742, 265, 1, 264, 0, 0, 0
5668, 1, 1636421958477, 1636421958742, 265, 1, 264, 1, 0, 1
5670, 1, 1636421958545, 1636421958810, 265, 1, 264, 0, 0, 0
5671, 1, 1636421958637, 1636421958909, 272, 1, 271, 0, 1, 1
5672, 1, 1636421958650, 1636421958913, 263, 0, 263, 0, 0, 0
5673, 1, 1636421958745, 1636421959009, 264, 0, 264, 0, 0, 0
5675, 1, 1636421958893, 1636421959157, 264, 0, 264, 0, 0, 0
5674, 1, 1636421958889, 1636421959157, 268, 1, 267, 0, 1, 1
5676, 1, 1636421959009, 1636421959273, 264, 1, 263, 0, 0, 0
5677, 1, 1636421959145, 1636421959410, 265, 1, 264, 0, 0, 0
5678, 1, 1636421959145, 1636421959410, 265, 1, 264, 1, 0, 1
5679, 1, 1636421959213, 1636421959477, 264, 0, 264, 0, 0, 0
5680, 1, 1636421959309, 1636421959581, 272, 1, 271, 0, 1, 1
5681, 1, 1636421959317, 1636421959585, 268, 1, 267, 0, 0, 0
5682, 1, 1636421959413, 1636421959681, 268, 0, 268, 0, 0, 0
5683, 1, 1636421959561, 1636421959830, 269, 1, 268, 0, 1, 1
5684, 1, 1636421959569, 1636421959834, 265, 1, 264, 0, 0, 0
5685, 1, 1636421959677, 1636421959941, 264, 1, 263, 0, 1, 1
5686, 1, 1636421959817, 1636421960086, 269, 1, 268, 0, 0, 0
5688, 1, 1636421959881, 1636421960145, 264, 1, 263, 0, 0, 0
5690, 1, 1636421959989, 1636421960257, 268, 1, 267, 0, 1, 1
5689, 1, 1636421959989, 1636421960257, 268, 1, 267, 0, 1, 1
5692, 1, 1636421960234, 1636421960497, 263, 0, 263, 0, 0, 0
5693, 1, 1636421960237, 1636421960505, 268, 0, 268, 0, 0, 0
5694, 1, 1636421960349, 1636421960617, 268, 1, 267, 1, 0, 1
5695, 1, 1636421960494, 1636421960757, 263, 0, 263, 0, 0, 0
5696, 1, 1636421960553, 1636421960821, 268, 0, 268, 0, 0, 0
5697, 1, 1636421960661, 1636421960926, 265, 1, 264, 1, 0, 1
5698, 1, 1636421960661, 1636421960926, 265, 1, 264, 0, 1, 1
5699, 1, 1636421960901, 1636421961166, 265, 1, 264, 0, 0, 0
5700, 1, 1636421960909, 1636421961181, 272, 1, 271, 0, 0, 0
5702, 1, 1636421961162, 1636421961425, 263, 0, 263, 0, 0, 0
5703, 1, 1636421961217, 1636421961481, 264, 1, 263, 0, 0, 0
5704, 1, 1636421961330, 1636421961594, 264, 0, 264, 0, 0, 0
5706, 1, 1636421961570, 1636421961838, 268, 0, 268, 0, 0, 0
5707, 1, 1636421961585, 1636421961854, 269, 1, 268, 0, 0, 0
5708, 1, 1636421961829, 1636421962098, 269, 1, 268, 0, 1, 1
5709, 1, 1636421961889, 1636421962166, 277, 1, 276, 0, 0, 0
5710, 1, 1636421962002, 1636421962265, 263, 0, 263, 0, 0, 0
5711, 1, 1636421962241, 1636421962506, 265, 1, 264, 1, 0, 1
5712, 1, 1636421962309, 1636421962581, 272, 1, 271, 0, 0, 0
5715, 1, 1636421962570, 1636421962838, 268, 0, 268, 0, 0, 0
5716, 1, 1636421962666, 1636421962929, 263, 0, 263, 0, 0, 0
5718, 1, 1636421962986, 1636421963249, 263, 0, 263, 0, 0, 0
5720, 1, 1636421963237, 1636421963510, 273, 1, 272, 1, 0, 1
5722, 1, 1636421963678, 1636421963946, 268, 0, 268, 0, 0, 0
5723, 1, 1636421963769, 1636421964030, 261, 0, 261, 0, 0, 0
5726, 1, 1636421964274, 1636421964541, 267, 0, 267, 0, 0, 0
5727, 1, 1636421964382, 1636421964646, 264, 0, 264, 0, 0, 0
5729, 1, 1636421964577, 1636421964845, 268, 1, 267, 0, 1, 1
5733, 1, 1636421965050, 1636421965317, 267, 0, 267, 0, 0, 0
5736, 1, 1636421965978, 1636421966241, 263, 0, 263, 0, 0, 0
5738, 1, 1636421967442, 1636421967709, 267, 0, 267, 0, 0, 0
5739, 1, 1636421967754, 1636421968022, 268, 0, 268, 0, 0, 0
5742, 1, 1636421970130, 1636421970398, 268, 0, 268, 0, 0, 0
5743, 1, 1636421970402, 1636421970670, 268, 0, 268, 0, 0, 0
5746, 1, 1636421971325, 1636421971590, 265, 1, 264, 0, 0, 0
5747, 1, 1636421971641, 1636421971910, 269, 1, 268, 1, 0, 1
5750, 1, 1636421972766, 1636421973029, 263, 0, 263, 0, 0, 0
5751, 1, 1636421972813, 1636421973082, 269, 0, 269, 0, 0, 0
5752, 1, 1636421973285, 1636421973550, 265, 1, 264, 1, 0, 1
5753, 1, 1636421973437, 1636421973702, 265, 1, 264, 1, 0, 1
5754, 1, 1636421973509, 1636421973774, 265, 0, 265, 0, 0, 0
5756, 1, 1636421973638, 1636421973946, 308, 0, 308, 0, 0, 0
5758, 1, 1636421974137, 1636421974401, 264, 1, 263, 0, 1, 1
5759, 1, 1636421974177, 1636421974441, 264, 1, 263, 0, 0, 0
5760, 1, 1636421974218, 1636421974525, 307, 0, 307, 0, 0, 0
5762, 1, 1636421974358, 1636421974642, 284, 0, 284, 0, 0, 0
5764, 1, 1636421974809, 1636421975073, 264, 1, 263, 1, 0, 1
5765, 1, 1636421974897, 1636421975162, 265, 1, 264, 0, 0, 0
5768, 1, 1636421975033, 1636421975298, 265, 1, 264, 0, 1, 1
5769, 1, 1636421975045, 1636421975309, 264, 1, 263, 1, 0, 1
5771, 1, 1636421975481, 1636421975745, 264, 0, 264, 0, 0, 0
5773, 1, 1636421975566, 1636421975834, 268, 0, 268, 0, 0, 0
5774, 1, 1636421975714, 1636421975982, 268, 0, 268, 0, 0, 0
5775, 1, 1636421975714, 1636421975982, 268, 0, 268, 0, 0, 0
5776, 1, 1636421976061, 1636421976326, 265, 1, 264, 1, 0, 1
5777, 1, 1636421976150, 1636421976414, 264, 0, 264, 0, 0, 0
5778, 1, 1636421976242, 1636421976505, 263, 0, 263, 0, 0, 0
5779, 1, 1636421976393, 1636421976685, 292, 1, 291, 0, 0, 0
5780, 1, 1636421976386, 1636421976685, 299, 0, 299, 0, 0, 0
5782, 1, 1636421976821, 1636421977090, 269, 0, 269, 0, 0, 0
5783, 1, 1636421976909, 1636421977173, 264, 1, 263, 0, 0, 0
5785, 1, 1636421977090, 1636421977358, 268, 0, 268, 0, 0, 0
5786, 1, 1636421977090, 1636421977358, 268, 0, 268, 0, 0, 0
5787, 1, 1636421977498, 1636421977762, 264, 0, 264, 0, 0, 0
5788, 1, 1636421977581, 1636421977846, 265, 1, 264, 0, 1, 1
5789, 1, 1636421977762, 1636421978029, 267, 0, 267, 0, 0, 0
5790, 1, 1636421977762, 1636421978029, 267, 0, 267, 0, 0, 0
5791, 1, 1636421978201, 1636421978465, 264, 0, 264, 0, 0, 0
5792, 1, 1636421978289, 1636421978553, 264, 1, 263, 1, 0, 1
5795, 1, 1636421978473, 1636421978737, 264, 1, 263, 1, 0, 1
5794, 1, 1636421978473, 1636421978741, 268, 1, 267, 1, 0, 1
5797, 1, 1636421978869, 1636421979134, 265, 0, 265, 0, 0, 0
5798, 1, 1636421978961, 1636421979226, 265, 1, 264, 0, 1, 1
5799, 1, 1636421979138, 1636421979405, 267, 0, 267, 0, 0, 0
5800, 1, 1636421979149, 1636421979418, 269, 0, 269, 0, 0, 0
5801, 1, 1636421979537, 1636421979805, 268, 1, 267, 1, 0, 1
5802, 1, 1636421979629, 1636421979894, 265, 1, 264, 0, 0, 0
5803, 1, 1636421979809, 1636421980074, 265, 0, 265, 0, 0, 0
5804, 1, 1636421979825, 1636421980094, 269, 1, 268, 0, 0, 0
5806, 1, 1636421980297, 1636421980561, 264, 1, 263, 0, 0, 0
5807, 1, 1636421980477, 1636421980741, 264, 0, 264, 0, 0, 0
5808, 1, 1636421980498, 1636421980765, 267, 0, 267, 0, 0, 0
5811, 1, 1636421981154, 1636421981418, 264, 0, 264, 0, 0, 0
5812, 1, 1636421981201, 1636421981465, 264, 1, 263, 0, 1, 1
5815, 1, 1636421981870, 1636421982138, 268, 0, 268, 0, 0, 0
5823, 1, 1636421985218, 1636421985486, 268, 0, 268, 0, 0, 0
5827, 1, 1636421985886, 1636421986154, 268, 0, 268, 0, 0, 0
5828, 1, 1636421986602, 1636421986866, 264, 0, 264, 0, 0, 0
5831, 1, 1636421987266, 1636421987534, 268, 0, 268, 0, 0, 0
5832, 1, 1636421987938, 1636421988205, 267, 0, 267, 0, 0, 0
5833, 1, 1636421988610, 1636421988878, 268, 0, 268, 0, 0, 0
5836, 1, 1636421989282, 1636421989554, 272, 0, 272, 0, 0, 0
5837, 1, 1636421989958, 1636421990250, 292, 0, 292, 0, 0, 0
5839, 1, 1636421990654, 1636421990922, 268, 0, 268, 0, 0, 0
5841, 1, 1636421991322, 1636421991594, 272, 0, 272, 0, 0, 0
5844, 1, 1636421991998, 1636421992262, 264, 0, 264, 0, 0, 0
5853, 1, 1636421995466, 1636421995733, 267, 0, 267, 0, 0, 0
5855, 1, 1636421995906, 1636421996174, 268, 0, 268, 0, 0, 0
5856, 1, 1636421996137, 1636421996406, 269, 0, 269, 0, 0, 0
5857, 1, 1636421996181, 1636421996450, 269, 1, 268, 0, 0, 0
5858, 1, 1636421996573, 1636421996838, 265, 0, 265, 0, 0, 0
5859, 1, 1636421996809, 1636421997086, 277, 0, 277, 0, 0, 0
5860, 1, 1636421996853, 1636421997122, 269, 1, 268, 0, 1, 1
5861, 1, 1636421997242, 1636421997510, 268, 0, 268, 0, 0, 0
5863, 1, 1636421997489, 1636421997753, 264, 1, 263, 0, 0, 0
5864, 1, 1636421997525, 1636421997793, 268, 0, 268, 0, 0, 0
5865, 1, 1636421997570, 1636421997834, 264, 0, 264, 0, 0, 0
5866, 1, 1636421997913, 1636421998178, 265, 1, 264, 0, 0, 0
5867, 1, 1636421998157, 1636421998425, 268, 0, 268, 0, 0, 0
5868, 1, 1636421998197, 1636421998466, 269, 1, 268, 0, 1, 1
5869, 1, 1636421998238, 1636421998501, 263, 0, 263, 0, 0, 0
5870, 1, 1636421998586, 1636421998854, 268, 0, 268, 0, 0, 0
5871, 1, 1636421998838, 1636421999105, 267, 0, 267, 0, 0, 0
5872, 1, 1636421998905, 1636421999169, 264, 1, 263, 0, 0, 0
5873, 1, 1636421998905, 1636421999169, 264, 1, 263, 1, 0, 1
5874, 1, 1636421999021, 1636421999286, 265, 1, 264, 0, 1, 1
5875, 1, 1636421999253, 1636421999525, 272, 1, 271, 0, 0, 0
5876, 1, 1636421999345, 1636421999609, 264, 1, 263, 0, 0, 0
5877, 1, 1636421999513, 1636421999777, 264, 1, 263, 0, 0, 0
5879, 1, 1636421999569, 1636421999837, 268, 1, 267, 1, 0, 1
5878, 1, 1636421999569, 1636421999838, 269, 1, 268, 1, 0, 1
5880, 1, 1636421999693, 1636421999957, 264, 1, 263, 0, 0, 0
5881, 1, 1636421999925, 1636422000194, 269, 0, 269, 0, 0, 0
5882, 1, 1636422000013, 1636422000273, 260, 0, 260, 0, 0, 0
5883, 1, 1636422000182, 1636422000445, 263, 0, 263, 0, 0, 0
5884, 1, 1636422000246, 1636422000557, 311, 0, 311, 0, 0, 0
5885, 1, 1636422000246, 1636422000557, 311, 0, 311, 0, 0, 0
5886, 1, 1636422000382, 1636422000653, 271, 0, 271, 0, 0, 0
5887, 1, 1636422000605, 1636422000869, 264, 0, 264, 0, 0, 0
5888, 1, 1636422000697, 1636422000969, 272, 0, 272, 0, 0, 0
5889, 1, 1636422000825, 1636422001090, 265, 1, 264, 0, 1, 1
5890, 1, 1636422000849, 1636422001113, 264, 0, 264, 0, 0, 0
5891, 1, 1636422000961, 1636422001225, 264, 1, 263, 1, 0, 1
5892, 1, 1636422000961, 1636422001225, 264, 1, 263, 0, 1, 1
5893, 1, 1636422001157, 1636422001421, 264, 1, 263, 1, 0, 1
5895, 1, 1636422001433, 1636422001698, 265, 1, 264, 0, 1, 1
5896, 1, 1636422001513, 1636422001778, 265, 1, 264, 0, 0, 0
5897, 1, 1636422001577, 1636422001841, 264, 0, 264, 0, 0, 0
5899, 1, 1636422001669, 1636422001937, 268, 1, 267, 1, 0, 1
5898, 1, 1636422001669, 1636422001937, 268, 1, 267, 1, 0, 1
5900, 1, 1636422001701, 1636422001969, 268, 0, 268, 0, 0, 0
5901, 1, 1636422001793, 1636422002057, 264, 0, 264, 0, 0, 0
5902, 1, 1636422001825, 1636422002089, 264, 1, 263, 0, 1, 1
5894, 1, 1636422001993, 1636422002257, 264, 1, 263, 0, 0, 0
5903, 1, 1636422002085, 1636422002353, 268, 1, 267, 0, 0, 0
5904, 1, 1636422002105, 1636422002378, 273, 0, 273, 0, 0, 0
5906, 1, 1636422002245, 1636422002509, 264, 0, 264, 0, 0, 0
5908, 1, 1636422002345, 1636422002610, 265, 1, 264, 1, 0, 1
5907, 1, 1636422002345, 1636422002610, 265, 1, 264, 0, 1, 1
5909, 1, 1636422002377, 1636422002642, 265, 1, 264, 0, 1, 1
5910, 1, 1636422002437, 1636422002753, 316, 1, 315, 0, 1, 1
5911, 1, 1636422002457, 1636422002753, 296, 1, 295, 1, 0, 1
5912, 1, 1636422002577, 1636422002837, 260, 0, 260, 0, 0, 0
5913, 1, 1636422002669, 1636422002973, 304, 1, 303, 1, 0, 1
5914, 1, 1636422002797, 1636422003062, 265, 1, 264, 0, 0, 0
5915, 1, 1636422002889, 1636422003153, 264, 0, 264, 0, 0, 0
5917, 1, 1636422002977, 1636422003241, 264, 0, 264, 0, 0, 0
5920, 1, 1636422003021, 1636422003281, 260, 0, 260, 0, 0, 0
5921, 1, 1636422003109, 1636422003381, 272, 0, 272, 0, 0, 0
5922, 1, 1636422003153, 1636422003421, 268, 1, 267, 0, 0, 0
5924, 1, 1636422003209, 1636422003477, 268, 1, 267, 0, 1, 1
5926, 1, 1636422003241, 1636422003509, 268, 1, 267, 0, 1, 1
5925, 1, 1636422003249, 1636422003517, 268, 0, 268, 0, 0, 0
5927, 1, 1636422003381, 1636422003649, 268, 1, 267, 1, 0, 1
5923, 1, 1636422003421, 1636422003686, 265, 1, 264, 1, 0, 1
5929, 1, 1636422003557, 1636422003821, 264, 0, 264, 0, 0, 0
5930, 1, 1636422003645, 1636422003909, 264, 0, 264, 0, 0, 0
5931, 1, 1636422003686, 1636422003949, 263, 0, 263, 0, 0, 0
5928, 1, 1636422003689, 1636422003953, 264, 0, 264, 0, 0, 0
5935, 1, 1636422003909, 1636422004173, 264, 1, 263, 0, 0, 0
5936, 1, 1636422003913, 1636422004181, 268, 0, 268, 0, 0, 0
5934, 1, 1636422003993, 1636422004258, 265, 1, 264, 0, 0, 0
5938, 1, 1636422004089, 1636422004357, 268, 0, 268, 0, 0, 0
5939, 1, 1636422004225, 1636422004497, 272, 0, 272, 0, 0, 0
5940, 1, 1636422004313, 1636422004614, 301, 1, 300, 0, 1, 1
5941, 1, 1636422004353, 1636422004621, 268, 1, 267, 0, 0, 0
5942, 1, 1636422004357, 1636422004629, 272, 1, 271, 1, 0, 1
5943, 1, 1636422004437, 1636422004705, 268, 1, 267, 0, 1, 1
5945, 1, 1636422004621, 1636422004885, 264, 1, 263, 0, 0, 0
5944, 1, 1636422004629, 1636422004893, 264, 1, 263, 1, 0, 1
5947, 1, 1636422004761, 1636422005033, 272, 1, 271, 0, 1, 1
5948, 1, 1636422004881, 1636422005145, 264, 0, 264, 0, 0, 0
5949, 1, 1636422004929, 1636422005193, 264, 0, 264, 0, 0, 0
5952, 1, 1636422005065, 1636422005329, 264, 1, 263, 0, 0, 0
5953, 1, 1636422005149, 1636422005413, 264, 1, 263, 0, 1, 1
5950, 1, 1636422005201, 1636422005465, 264, 0, 264, 0, 0, 0
5954, 1, 1636422005278, 1636422005573, 295, 0, 295, 0, 0, 0
5956, 1, 1636422005301, 1636422005577, 276, 0, 276, 0, 0, 0
5957, 1, 1636422005489, 1636422005753, 264, 1, 263, 0, 0, 0
5955, 1, 1636422005489, 1636422005754, 265, 1, 264, 0, 1, 1
5958, 1, 1636422005581, 1636422005845, 264, 0, 264, 0, 0, 0
5959, 1, 1636422005621, 1636422005889, 268, 1, 267, 1, 0, 1
5960, 1, 1636422005757, 1636422006025, 268, 0, 268, 0, 0, 0
5961, 1, 1636422005822, 1636422006085, 263, 0, 263, 0, 0, 0
5962, 1, 1636422005841, 1636422006109, 268, 1, 267, 0, 0, 0
5963, 1, 1636422005869, 1636422006133, 264, 0, 264, 0, 0, 0
5965, 1, 1636422005981, 1636422006249, 268, 1, 267, 0, 1, 1
5964, 1, 1636422005977, 1636422006249, 272, 1, 271, 1, 0, 1
5966, 1, 1636422006161, 1636422006426, 265, 1, 264, 0, 0, 0
5967, 1, 1636422006161, 1636422006429, 268, 1, 267, 1, 0, 1
5968, 1, 1636422006253, 1636422006517, 264, 0, 264, 0, 0, 0
5969, 1, 1636422006293, 1636422006558, 265, 1, 264, 0, 0, 0
5970, 1, 1636422006433, 1636422006697, 264, 1, 263, 0, 0, 0
5971, 1, 1636422006481, 1636422006754, 273, 1, 272, 0, 0, 0
5972, 1, 1636422006513, 1636422006781, 268, 1, 267, 0, 1, 1
5973, 1, 1636422006537, 1636422006805, 268, 1, 267, 1, 0, 1
5974, 1, 1636422006649, 1636422006913, 264, 1, 263, 0, 0, 0
5976, 1, 1636422006829, 1636422007094, 265, 1, 264, 1, 0, 1
5977, 1, 1636422006829, 1636422007097, 268, 1, 267, 1, 0, 1
5978, 1, 1636422006921, 1636422007193, 272, 0, 272, 0, 0, 0
5980, 1, 1636422007097, 1636422007393, 296, 1, 295, 1, 0, 1
5981, 1, 1636422007153, 1636422007425, 272, 0, 272, 0, 0, 0
5982, 1, 1636422007217, 1636422007482, 265, 0, 265, 0, 0, 0
5983, 1, 1636422007217, 1636422007485, 268, 1, 267, 0, 0, 0
5984, 1, 1636422007313, 1636422007581, 268, 0, 268, 0, 0, 0
5986, 1, 1636422007529, 1636422007797, 268, 0, 268, 0, 0, 0
5985, 1, 1636422007593, 1636422007857, 264, 1, 263, 0, 1, 1
5987, 1, 1636422007602, 1636422007865, 263, 0, 263, 0, 0, 0
5988, 1, 1636422007661, 1636422007925, 264, 1, 263, 0, 1, 1
5990, 1, 1636422007829, 1636422008101, 272, 0, 272, 0, 0, 0
5989, 1, 1636422007865, 1636422008129, 264, 1, 263, 1, 0, 1
5992, 1, 1636422007893, 1636422008157, 264, 0, 264, 0, 0, 0
5993, 1, 1636422007985, 1636422008253, 268, 1, 267, 0, 1, 1
5991, 1, 1636422008137, 1636422008401, 264, 1, 263, 0, 1, 1
5994, 1, 1636422008201, 1636422008465, 264, 1, 263, 0, 0, 0
5995, 1, 1636422008253, 1636422008517, 264, 1, 263, 0, 0, 0
5996, 1, 1636422008265, 1636422008533, 268, 0, 268, 0, 0, 0
5997, 1, 1636422008329, 1636422008593, 264, 1, 263, 0, 1, 1
5998, 1, 1636422008505, 1636422008769, 264, 1, 263, 0, 0, 0
5999, 1, 1636422008533, 1636422008798, 265, 1, 264, 0, 1, 1
6000, 1, 1636422008561, 1636422008825, 264, 1, 263, 1, 0, 1
6001, 1, 1636422008653, 1636422008921, 268, 1, 267, 0, 1, 1
6002, 1, 1636422008801, 1636422009069, 268, 0, 268, 0, 0, 0
6003, 1, 1636422008873, 1636422009137, 264, 1, 263, 0, 1, 1
6004, 1, 1636422008917, 1636422009181, 264, 1, 263, 0, 1, 1
6005, 1, 1636422008933, 1636422009201, 268, 1, 267, 1, 0, 1
6006, 1, 1636422009001, 1636422009265, 264, 1, 263, 0, 1, 1
6007, 1, 1636422009174, 1636422009441, 267, 0, 267, 0, 0, 0
6008, 1, 1636422009193, 1636422009457, 264, 1, 263, 0, 0, 0
6009, 1, 1636422009229, 1636422009493, 264, 0, 264, 0, 0, 0
6010, 1, 1636422009329, 1636422009593, 264, 1, 263, 0, 0, 0
6011, 1, 1636422009473, 1636422009737, 264, 1, 263, 0, 1, 1
6012, 1, 1636422009537, 1636422009809, 272, 1, 271, 0, 1, 1
6014, 1, 1636422009609, 1636422009878, 269, 1, 268, 0, 0, 0
6015, 1, 1636422009673, 1636422009937, 264, 1, 263, 0, 0, 0
6018, 1, 1636422009893, 1636422010165, 272, 1, 271, 0, 0, 0
6016, 1, 1636422009945, 1636422010213, 268, 0, 268, 0, 0, 0
6019, 1, 1636422009989, 1636422010253, 264, 1, 263, 1, 0, 1
6020, 1, 1636422010134, 1636422010398, 264, 0, 264, 0, 0, 0
6021, 1, 1636422010209, 1636422010473, 264, 1, 263, 0, 0, 0
6022, 1, 1636422010281, 1636422010546, 265, 1, 264, 0, 0, 0
6023, 1, 1636422010341, 1636422010606, 265, 1, 264, 0, 0, 0
6025, 1, 1636422010613, 1636422010878, 265, 1, 264, 0, 1, 1
6026, 1, 1636422010657, 1636422010930, 273, 1, 272, 0, 1, 1
6027, 1, 1636422010805, 1636422011069, 264, 1, 263, 0, 0, 0
6029, 1, 1636422010950, 1636422011214, 264, 0, 264, 0, 0, 0
6030, 1, 1636422011005, 1636422011274, 269, 1, 268, 0, 0, 0
6031, 1, 1636422011285, 1636422011549, 264, 0, 264, 0, 0, 0
6032, 1, 1636422011329, 1636422011594, 265, 1, 264, 0, 0, 0
6033, 1, 1636422011469, 1636422011733, 264, 1, 263, 0, 1, 1
6034, 1, 1636422011621, 1636422011886, 265, 1, 264, 0, 0, 0
6035, 1, 1636422011682, 1636422011946, 264, 0, 264, 0, 0, 0
6037, 1, 1636422011997, 1636422012261, 264, 0, 264, 0, 0, 0
6038, 1, 1636422012178, 1636422012450, 272, 0, 272, 0, 0, 0
6040, 1, 1636422012350, 1636422012614, 264, 0, 264, 0, 0, 0
6041, 1, 1636422012530, 1636422012794, 264, 0, 264, 0, 0, 0
6043, 1, 1636422012933, 1636422013198, 265, 1, 264, 0, 0, 0
6044, 1, 1636422013113, 1636422013378, 265, 1, 264, 0, 0, 0
6045, 1, 1636422013249, 1636422013513, 264, 1, 263, 0, 0, 0
6048, 1, 1636422013334, 1636422013601, 267, 0, 267, 0, 0, 0
6046, 1, 1636422013341, 1636422013605, 264, 1, 263, 0, 1, 1
6050, 1, 1636422013790, 1636422014089, 299, 0, 299, 0, 0, 0
6051, 1, 1636422013917, 1636422014185, 268, 0, 268, 0, 0, 0
6053, 1, 1636422014014, 1636422014278, 264, 0, 264, 0, 0, 0
6052, 1, 1636422014014, 1636422014278, 264, 0, 264, 0, 0, 0
6055, 1, 1636422014137, 1636422014406, 269, 0, 269, 0, 0, 0
6057, 1, 1636422014526, 1636422014789, 263, 0, 263, 0, 0, 0
6059, 1, 1636422014709, 1636422014973, 264, 1, 263, 1, 0, 1
6061, 1, 1636422014841, 1636422015105, 264, 1, 263, 0, 0, 0
6062, 1, 1636422014969, 1636422015234, 265, 1, 264, 0, 0, 0
6066, 1, 1636422015510, 1636422015778, 268, 0, 268, 0, 0, 0
6067, 1, 1636422015638, 1636422015906, 268, 0, 268, 0, 0, 0
6069, 1, 1636422016310, 1636422016578, 268, 0, 268, 0, 0, 0
6080, 1, 1636422023686, 1636422023954, 268, 0, 268, 0, 0, 0
6082, 1, 1636422024402, 1636422024666, 264, 0, 264, 0, 0, 0
6083, 1, 1636422024402, 1636422024666, 264, 0, 264, 0, 0, 0
6084, 1, 1636422024677, 1636422024942, 265, 0, 265, 0, 0, 0
6085, 1, 1636422024905, 1636422025174, 269, 1, 268, 0, 0, 0
6086, 1, 1636422025057, 1636422025321, 264, 1, 263, 1, 0, 1
6088, 1, 1636422025069, 1636422025333, 264, 0, 264, 0, 0, 0
6089, 1, 1636422025373, 1636422025642, 269, 1, 268, 0, 0, 0
6091, 1, 1636422025601, 1636422025866, 265, 1, 264, 0, 0, 0
6092, 1, 1636422025681, 1636422025946, 265, 0, 265, 0, 0, 0
6093, 1, 1636422025689, 1636422025953, 264, 0, 264, 0, 0, 0
6094, 1, 1636422025725, 1636422025990, 265, 0, 265, 0, 0, 0
6097, 1, 1636422026273, 1636422026537, 264, 1, 263, 0, 1, 1
6099, 1, 1636422026361, 1636422026625, 264, 1, 263, 0, 1, 1
6098, 1, 1636422026365, 1636422026629, 264, 1, 263, 0, 1, 1
6100, 1, 1636422026390, 1636422026653, 263, 0, 263, 0, 0, 0
6101, 1, 1636422026490, 1636422026754, 264, 0, 264, 0, 0, 0
6102, 1, 1636422026961, 1636422027233, 272, 1, 271, 0, 0, 0
6104, 1, 1636422027050, 1636422027313, 263, 0, 263, 0, 0, 0
6106, 1, 1636422027225, 1636422027494, 269, 1, 268, 0, 1, 1
6107, 1, 1636422027265, 1636422027529, 264, 1, 263, 0, 1, 1
6108, 1, 1636422027317, 1636422027585, 268, 0, 268, 0, 0, 0
6109, 1, 1636422027577, 1636422027850, 273, 1, 272, 0, 1, 1
6110, 1, 1636422027637, 1636422027902, 265, 1, 264, 0, 0, 0
6111, 1, 1636422027717, 1636422027981, 264, 1, 263, 0, 0, 0
6112, 1, 1636422027901, 1636422028169, 268, 1, 267, 0, 0, 0
6113, 1, 1636422027933, 1636422028202, 269, 0, 269, 0, 0, 0
6114, 1, 1636422027985, 1636422028253, 268, 0, 268, 0, 0, 0
6115, 1, 1636422028253, 1636422028521, 268, 1, 267, 0, 0, 0
6116, 1, 1636422028305, 1636422028569, 264, 1, 263, 0, 0, 0
6117, 1, 1636422028386, 1636422028650, 264, 0, 264, 0, 0, 0
6118, 1, 1636422028573, 1636422028841, 268, 1, 267, 0, 0, 0
6120, 1, 1636422028657, 1636422028930, 273, 1, 272, 1, 0, 1
6122, 1, 1636422028974, 1636422029237, 263, 0, 263, 0, 0, 0
6123, 1, 1636422029054, 1636422029317, 263, 0, 263, 0, 0, 0
6124, 1, 1636422029245, 1636422029510, 265, 0, 265, 0, 0, 0
6125, 1, 1636422029333, 1636422029597, 264, 1, 263, 0, 0, 0
6126, 1, 1636422029641, 1636422029901, 260, 0, 260, 0, 0, 0
6127, 1, 1636422029721, 1636422029986, 265, 1, 264, 0, 0, 0
6128, 1, 1636422029961, 1636422030226, 265, 1, 264, 0, 1, 1
6129, 1, 1636422030033, 1636422030297, 264, 1, 263, 0, 0, 0
6130, 1, 1636422030257, 1636422030522, 265, 1, 264, 0, 0, 0
6131, 1, 1636422030345, 1636422030609, 264, 0, 264, 0, 0, 0
6132, 1, 1636422030385, 1636422030649, 264, 1, 263, 1, 0, 1
6133, 1, 1636422030521, 1636422030785, 264, 1, 263, 0, 0, 0
6134, 1, 1636422030629, 1636422030910, 281, 1, 280, 0, 0, 0
6135, 1, 1636422030733, 1636422030998, 265, 0, 265, 0, 0, 0
6136, 1, 1636422030957, 1636422031229, 272, 0, 272, 0, 0, 0
6138, 1, 1636422031053, 1636422031322, 269, 1, 268, 1, 0, 1
6137, 1, 1636422031053, 1636422031325, 272, 1, 271, 0, 0, 0
6139, 1, 1636422031173, 1636422031437, 264, 0, 264, 0, 0, 0
6140, 1, 1636422031233, 1636422031502, 269, 0, 269, 0, 0, 0
6141, 1, 1636422031309, 1636422031574, 265, 1, 264, 0, 0, 0
6142, 1, 1636422031401, 1636422031666, 265, 1, 264, 0, 1, 1
6143, 1, 1636422031493, 1636422031757, 264, 1, 263, 1, 0, 1
6146, 1, 1636422031730, 1636422031998, 268, 0, 268, 0, 0, 0
6145, 1, 1636422031730, 1636422031998, 268, 0, 268, 0, 0, 0
6147, 1, 1636422031842, 1636422032105, 263, 0, 263, 0, 0, 0
6149, 1, 1636422031977, 1636422032242, 265, 0, 265, 0, 0, 0
6150, 1, 1636422032065, 1636422032330, 265, 1, 264, 0, 1, 1
6151, 1, 1636422032161, 1636422032425, 264, 1, 263, 0, 0, 0
6152, 1, 1636422032481, 1636422032745, 264, 1, 263, 0, 0, 0
6155, 1, 1636422032574, 1636422032845, 271, 0, 271, 0, 0, 0
6156, 1, 1636422032661, 1636422032933, 272, 1, 271, 0, 0, 0
6157, 1, 1636422032737, 1636422033014, 277, 1, 276, 0, 1, 1
6159, 1, 1636422032929, 1636422033193, 264, 0, 264, 0, 0, 0
6161, 1, 1636422033250, 1636422033514, 264, 0, 264, 0, 0, 0
6162, 1, 1636422033278, 1636422033549, 271, 0, 271, 0, 0, 0
6163, 1, 1636422033341, 1636422033606, 265, 1, 264, 0, 1, 1
6164, 1, 1636422033413, 1636422033677, 264, 1, 263, 0, 1, 1
6165, 1, 1636422033593, 1636422033857, 264, 1, 263, 0, 1, 1
6167, 1, 1636422033993, 1636422034257, 264, 1, 263, 0, 0, 0
6169, 1, 1636422034085, 1636422034350, 265, 1, 264, 0, 1, 1
6170, 1, 1636422034209, 1636422034478, 269, 1, 268, 0, 1, 1
6174, 1, 1636422034878, 1636422035141, 263, 0, 263, 0, 0, 0
6175, 1, 1636422035373, 1636422035638, 265, 1, 264, 0, 1, 1
6177, 1, 1636422035829, 1636422036093, 264, 0, 264, 0, 0, 0
6178, 1, 1636422036089, 1636422036353, 264, 1, 263, 0, 0, 0
6179, 1, 1636422036089, 1636422036353, 264, 1, 263, 0, 0, 0
6180, 1, 1636422036357, 1636422036622, 265, 0, 265, 0, 0, 0
6181, 1, 1636422036497, 1636422036766, 269, 1, 268, 1, 0, 1
6183, 1, 1636422036758, 1636422037022, 264, 0, 264, 0, 0, 0
6182, 1, 1636422036758, 1636422037026, 268, 0, 268, 0, 0, 0
6184, 1, 1636422037053, 1636422037317, 264, 0, 264, 0, 0, 0
6186, 1, 1636422037361, 1636422037625, 264, 1, 263, 0, 0, 0
6187, 1, 1636422037393, 1636422037657, 264, 1, 263, 0, 0, 0
6189, 1, 1636422037430, 1636422037697, 267, 0, 267, 0, 0, 0
6190, 1, 1636422037717, 1636422037981, 264, 1, 263, 0, 0, 0
6191, 1, 1636422038025, 1636422038294, 269, 1, 268, 0, 0, 0
6192, 1, 1636422038066, 1636422038330, 264, 0, 264, 0, 0, 0
6195, 1, 1636422038698, 1636422038961, 263, 0, 263, 0, 0, 0
6196, 1, 1636422038733, 1636422038998, 265, 1, 264, 0, 0, 0
6197, 1, 1636422038914, 1636422039177, 263, 0, 263, 0, 0, 0
6198, 1, 1636422039234, 1636422039498, 264, 0, 264, 0, 0, 0
6200, 1, 1636422039398, 1636422039666, 268, 0, 268, 0, 0, 0
6201, 1, 1636422039582, 1636422039845, 263, 0, 263, 0, 0, 0
6202, 1, 1636422039902, 1636422040169, 267, 0, 267, 0, 0, 0
6203, 1, 1636422040065, 1636422040334, 269, 1, 268, 0, 1, 1
6204, 1, 1636422040254, 1636422040521, 267, 0, 267, 0, 0, 0
6205, 1, 1636422040574, 1636422040842, 268, 0, 268, 0, 0, 0
6206, 1, 1636422040738, 1636422041006, 268, 0, 268, 0, 0, 0
6209, 1, 1636422041405, 1636422041677, 272, 0, 272, 0, 0, 0
6210, 1, 1636422041949, 1636422042213, 264, 0, 264, 0, 0, 0
6211, 1, 1636422042078, 1636422042342, 264, 0, 264, 0, 0, 0
6212, 1, 1636422042217, 1636422042481, 264, 1, 263, 0, 1, 1
6213, 1, 1636422042621, 1636422042890, 269, 1, 268, 0, 0, 0
6214, 1, 1636422042781, 1636422043045, 264, 1, 263, 0, 0, 0
6215, 1, 1636422042781, 1636422043046, 265, 1, 264, 0, 1, 1
6216, 1, 1636422042817, 1636422043081, 264, 0, 264, 0, 0, 0
6217, 1, 1636422042913, 1636422043197, 284, 1, 283, 0, 1, 1
6218, 1, 1636422043137, 1636422043401, 264, 1, 263, 0, 0, 0
6219, 1, 1636422043329, 1636422043598, 269, 1, 268, 0, 0, 0
6221, 1, 1636422043445, 1636422043714, 269, 1, 268, 0, 0, 0
6220, 1, 1636422043445, 1636422043714, 269, 1, 268, 0, 0, 0
6222, 1, 1636422043461, 1636422043725, 264, 0, 264, 0, 0, 0
6223, 1, 1636422043485, 1636422043749, 264, 0, 264, 0, 0, 0
6224, 1, 1636422043598, 1636422043861, 263, 1, 262, 0, 0, 0
6225, 1, 1636422043814, 1636422044085, 271, 0, 271, 0, 0, 0
6227, 1, 1636422044125, 1636422044390, 265, 1, 264, 0, 0, 0
6229, 1, 1636422044133, 1636422044397, 264, 1, 263, 0, 1, 1
6228, 1, 1636422044133, 1636422044397, 264, 1, 263, 0, 1, 1
6230, 1, 1636422044217, 1636422044481, 264, 0, 264, 0, 0, 0
6232, 1, 1636422044309, 1636422044570, 261, 0, 261, 0, 0, 0
6233, 1, 1636422044353, 1636422044617, 264, 1, 263, 0, 0, 0
6234, 1, 1636422044525, 1636422044793, 268, 1, 267, 0, 0, 0
6235, 1, 1636422044617, 1636422044885, 268, 0, 268, 0, 0, 0
6236, 1, 1636422044841, 1636422045101, 260, 0, 260, 0, 0, 0
6238, 1, 1636422044845, 1636422045109, 264, 0, 264, 0, 0, 0
6240, 1, 1636422044966, 1636422045229, 263, 0, 263, 0, 0, 0
6241, 1, 1636422044969, 1636422045233, 264, 1, 263, 0, 1, 1
6242, 1, 1636422045021, 1636422045289, 268, 0, 268, 0, 0, 0
6243, 1, 1636422045061, 1636422045326, 265, 0, 265, 0, 0, 0
6245, 1, 1636422045289, 1636422045593, 304, 0, 304, 0, 0, 0
6246, 1, 1636422045513, 1636422045777, 264, 1, 263, 0, 1, 1
6247, 1, 1636422045513, 1636422045781, 268, 1, 267, 0, 0, 0
6249, 1, 1636422045645, 1636422045913, 268, 0, 268, 0, 0, 0
6248, 1, 1636422045645, 1636422045914, 269, 0, 269, 0, 0, 0
6250, 1, 1636422045729, 1636422045994, 265, 1, 264, 0, 0, 0
6251, 1, 1636422045729, 1636422045997, 268, 0, 268, 0, 0, 0
6252, 1, 1636422045861, 1636422046126, 265, 1, 264, 0, 0, 0
6253, 1, 1636422045997, 1636422046262, 265, 1, 264, 0, 1, 1
6255, 1, 1636422046177, 1636422046449, 272, 0, 272, 0, 0, 0
6254, 1, 1636422046269, 1636422046537, 268, 1, 267, 0, 0, 0
6258, 1, 1636422046401, 1636422046665, 264, 1, 263, 0, 1, 1
6259, 1, 1636422046401, 1636422046670, 269, 1, 268, 0, 1, 1
6260, 1, 1636422046525, 1636422046789, 264, 1, 263, 0, 0, 0
6257, 1, 1636422046541, 1636422046805, 264, 0, 264, 0, 0, 0
6262, 1, 1636422046857, 1636422047121, 264, 1, 263, 1, 0, 1
6263, 1, 1636422046942, 1636422047226, 284, 0, 284, 0, 0, 0
6264, 1, 1636422047070, 1636422047333, 263, 0, 263, 0, 0, 0
6265, 1, 1636422047077, 1636422047341, 264, 1, 263, 0, 1, 1
6266, 1, 1636422047233, 1636422047497, 264, 0, 264, 0, 0, 0
6268, 1, 1636422047513, 1636422047778, 265, 1, 264, 0, 1, 1
6269, 1, 1636422047525, 1636422047794, 269, 1, 268, 0, 1, 1
6271, 1, 1636422047734, 1636422048001, 267, 0, 267, 0, 0, 0
6272, 1, 1636422047734, 1636422048005, 271, 0, 271, 0, 0, 0
6273, 1, 1636422047750, 1636422048017, 267, 0, 267, 0, 0, 0
6275, 1, 1636422048190, 1636422048453, 263, 0, 263, 0, 0, 0
6278, 1, 1636422048434, 1636422048701, 267, 0, 267, 0, 0, 0
6279, 1, 1636422048434, 1636422048702, 268, 1, 267, 0, 0, 0
6280, 1, 1636422048434, 1636422048702, 268, 1, 267, 0, 1, 1
6277, 1, 1636422048434, 1636422048705, 271, 0, 271, 0, 0, 0
6281, 1, 1636422048705, 1636422048973, 268, 0, 268, 0, 0, 0
6282, 1, 1636422048866, 1636422049129, 263, 0, 263, 0, 0, 0
6286, 1, 1636422049109, 1636422049413, 304, 1, 303, 0, 1, 1
6285, 1, 1636422049109, 1636422049414, 305, 1, 304, 0, 0, 0
6284, 1, 1636422049106, 1636422049414, 308, 0, 308, 0, 0, 0
6287, 1, 1636422049417, 1636422049681, 264, 0, 264, 0, 0, 0
6289, 1, 1636422049681, 1636422049946, 265, 0, 265, 0, 0, 0
6292, 1, 1636422049817, 1636422050082, 265, 1, 264, 0, 0, 0
6290, 1, 1636422049817, 1636422050082, 265, 1, 264, 0, 1, 1
6293, 1, 1636422050085, 1636422050349, 264, 0, 264, 0, 0, 0
6294, 1, 1636422050349, 1636422050617, 268, 1, 267, 0, 1, 1
6295, 1, 1636422050485, 1636422050749, 264, 1, 263, 0, 1, 1
6296, 1, 1636422050485, 1636422050749, 264, 1, 263, 0, 0, 0
6297, 1, 1636422050789, 1636422051050, 261, 0, 261, 0, 0, 0
6298, 1, 1636422051026, 1636422051289, 263, 0, 263, 0, 0, 0
6300, 1, 1636422051153, 1636422051417, 264, 1, 263, 0, 1, 1
6299, 1, 1636422051153, 1636422051425, 272, 0, 272, 0, 0, 0
6301, 1, 1636422051230, 1636422051493, 263, 0, 263, 0, 0, 0
6302, 1, 1636422051458, 1636422051721, 263, 0, 263, 0, 0, 0
6303, 1, 1636422051553, 1636422051821, 268, 1, 267, 0, 1, 1
6304, 1, 1636422051697, 1636422051961, 264, 0, 264, 0, 0, 0
6305, 1, 1636422051825, 1636422052094, 269, 1, 268, 0, 0, 0
6306, 1, 1636422051833, 1636422052101, 268, 1, 267, 0, 0, 0
6307, 1, 1636422051901, 1636422052170, 269, 1, 268, 0, 1, 1
6308, 1, 1636422052125, 1636422052394, 269, 0, 269, 0, 0, 0
6309, 1, 1636422052229, 1636422052502, 273, 1, 272, 0, 0, 0
6310, 1, 1636422052373, 1636422052638, 265, 1, 264, 0, 1, 1
6311, 1, 1636422052493, 1636422052762, 269, 1, 268, 0, 1, 1
6312, 1, 1636422052501, 1636422052769, 268, 1, 267, 0, 0, 0
6313, 1, 1636422052577, 1636422052842, 265, 1, 264, 1, 0, 1
6314, 1, 1636422052798, 1636422053061, 263, 0, 263, 0, 0, 0
6315, 1, 1636422052909, 1636422053173, 264, 1, 263, 0, 0, 0
6316, 1, 1636422053045, 1636422053309, 264, 0, 264, 0, 0, 0
6317, 1, 1636422053170, 1636422053438, 268, 0, 268, 0, 0, 0
6318, 1, 1636422053173, 1636422053441, 268, 1, 267, 0, 0, 0
6319, 1, 1636422053249, 1636422053510, 261, 0, 261, 0, 0, 0
6320, 1, 1636422053465, 1636422053729, 264, 1, 263, 0, 0, 0
6321, 1, 1636422053577, 1636422053846, 269, 1, 268, 0, 1, 1
6322, 1, 1636422053713, 1636422053977, 264, 0, 264, 0, 0, 0
6323, 1, 1636422053841, 1636422054106, 265, 1, 264, 0, 0, 0
6324, 1, 1636422053846, 1636422054109, 263, 0, 263, 0, 0, 0
6325, 1, 1636422053917, 1636422054182, 265, 0, 265, 0, 0, 0
6326, 1, 1636422054173, 1636422054437, 264, 1, 263, 0, 0, 0
6327, 1, 1636422054265, 1636422054537, 272, 1, 271, 0, 0, 0
6328, 1, 1636422054394, 1636422054657, 263, 0, 263, 0, 0, 0
6329, 1, 1636422054402, 1636422054665, 263, 0, 263, 0, 0, 0
6330, 1, 1636422054510, 1636422054774, 264, 0, 264, 0, 0, 0
6331, 1, 1636422054510, 1636422054774, 264, 0, 264, 0, 0, 0
6332, 1, 1636422054597, 1636422054929, 332, 1, 331, 0, 0, 0
6333, 1, 1636422054753, 1636422055017, 264, 0, 264, 0, 0, 0
6334, 1, 1636422054846, 1636422055110, 264, 0, 264, 0, 0, 0
6335, 1, 1636422054981, 1636422055245, 264, 1, 263, 0, 0, 0
6336, 1, 1636422055065, 1636422055329, 264, 0, 264, 0, 0, 0
6337, 1, 1636422055073, 1636422055337, 264, 0, 264, 0, 0, 0
6338, 1, 1636422055154, 1636422055417, 263, 0, 263, 0, 0, 0
6339, 1, 1636422055181, 1636422055445, 264, 0, 264, 0, 0, 0
6341, 1, 1636422055189, 1636422055457, 268, 1, 267, 0, 0, 0
6342, 1, 1636422055329, 1636422055597, 268, 0, 268, 0, 0, 0
6343, 1, 1636422055421, 1636422055685, 264, 0, 264, 0, 0, 0
6344, 1, 1636422055509, 1636422055773, 264, 0, 264, 0, 0, 0
6345, 1, 1636422055513, 1636422055777, 264, 0, 264, 0, 0, 0
6346, 1, 1636422055645, 1636422055909, 264, 0, 264, 0, 0, 0
6347, 1, 1636422055737, 1636422056002, 265, 0, 265, 0, 0, 0
6348, 1, 1636422055741, 1636422056005, 264, 0, 264, 0, 0, 0
6349, 1, 1636422055821, 1636422056086, 265, 0, 265, 0, 0, 0
6351, 1, 1636422055862, 1636422056130, 268, 0, 268, 0, 0, 0
6352, 1, 1636422055997, 1636422056266, 269, 0, 269, 0, 0, 0
6353, 1, 1636422056089, 1636422056358, 269, 0, 269, 0, 0, 0
6354, 1, 1636422056181, 1636422056445, 264, 0, 264, 0, 0, 0
6356, 1, 1636422056313, 1636422056581, 268, 1, 267, 0, 1, 1
6358, 1, 1636422056405, 1636422056709, 304, 1, 303, 0, 0, 0
6357, 1, 1636422056405, 1636422056709, 304, 0, 304, 0, 0, 0
6359, 1, 1636422056534, 1636422056797, 263, 0, 263, 0, 0, 0
6360, 1, 1636422056534, 1636422056798, 264, 0, 264, 0, 0, 0
6362, 1, 1636422056665, 1636422056930, 265, 0, 265, 0, 0, 0
6363, 1, 1636422056761, 1636422057021, 260, 0, 260, 0, 0, 0
6361, 1, 1636422056801, 1636422057065, 264, 0, 264, 0, 0, 0
6364, 1, 1636422056845, 1636422057113, 268, 1, 267, 0, 0, 0
6366, 1, 1636422056985, 1636422057274, 289, 1, 288, 0, 0, 0
6365, 1, 1636422057097, 1636422057366, 269, 1, 268, 0, 0, 0
6368, 1, 1636422057109, 1636422057374, 265, 0, 265, 0, 0, 0
6369, 1, 1636422057201, 1636422057469, 268, 1, 267, 0, 0, 0
6370, 1, 1636422057201, 1636422057469, 268, 1, 267, 0, 0, 0
6371, 1, 1636422057333, 1636422057597, 264, 0, 264, 0, 0, 0
6372, 1, 1636422057422, 1636422057689, 267, 0, 267, 0, 0, 0
6373, 1, 1636422057493, 1636422057757, 264, 1, 263, 1, 0, 1
6374, 1, 1636422057514, 1636422057781, 267, 0, 267, 0, 0, 0
6375, 1, 1636422057586, 1636422057853, 267, 0, 267, 0, 0, 0
6376, 1, 1636422057681, 1636422057945, 264, 0, 264, 0, 0, 0
6378, 1, 1636422057801, 1636422058066, 265, 1, 264, 0, 0, 0
6377, 1, 1636422057801, 1636422058066, 265, 1, 264, 1, 0, 1
6379, 1, 1636422057869, 1636422058133, 264, 1, 263, 0, 0, 0
6380, 1, 1636422057877, 1636422058145, 268, 1, 267, 1, 0, 1
6382, 1, 1636422058002, 1636422058265, 263, 0, 263, 0, 0, 0
6383, 1, 1636422058093, 1636422058357, 264, 1, 263, 0, 0, 0
6384, 1, 1636422058157, 1636422058421, 264, 1, 263, 0, 0, 0
6385, 1, 1636422058185, 1636422058449, 264, 1, 263, 0, 0, 0
6386, 1, 1636422058249, 1636422058517, 268, 0, 268, 0, 0, 0
6387, 1, 1636422058286, 1636422058549, 263, 0, 263, 0, 0, 0
6388, 1, 1636422058377, 1636422058641, 264, 0, 264, 0, 0, 0
6390, 1, 1636422058469, 1636422058737, 268, 1, 267, 1, 0, 1
6389, 1, 1636422058469, 1636422058737, 268, 1, 267, 1, 0, 1
6392, 1, 1636422058533, 1636422058801, 268, 0, 268, 0, 0, 0
6393, 1, 1636422058537, 1636422058802, 265, 0, 265, 0, 0, 0
6395, 1, 1636422058757, 1636422059017, 260, 0, 260, 0, 0, 0
6396, 1, 1636422058833, 1636422059098, 265, 0, 265, 0, 0, 0
6397, 1, 1636422058853, 1636422059149, 296, 1, 295, 0, 0, 0
6398, 1, 1636422058918, 1636422059181, 263, 0, 263, 0, 0, 0
6399, 1, 1636422058969, 1636422059234, 265, 0, 265, 0, 0, 0
6401, 1, 1636422059153, 1636422059417, 264, 1, 263, 1, 0, 1
6402, 1, 1636422059153, 1636422059421, 268, 1, 267, 1, 0, 1
6403, 1, 1636422059205, 1636422059473, 268, 0, 268, 0, 0, 0
6406, 1, 1636422059421, 1636422059685, 264, 1, 263, 1, 0, 1
6407, 1, 1636422059505, 1636422059770, 265, 0, 265, 0, 0, 0
6408, 1, 1636422059549, 1636422059857, 308, 1, 307, 1, 0, 1
6409, 1, 1636422059597, 1636422059861, 264, 0, 264, 0, 0, 0
6410, 1, 1636422059685, 1636422059949, 264, 1, 263, 0, 1, 1
6412, 1, 1636422059865, 1636422060129, 264, 1, 263, 0, 0, 0
6411, 1, 1636422059865, 1636422060129, 264, 1, 263, 0, 1, 1
6413, 1, 1636422059865, 1636422060133, 268, 1, 267, 1, 0, 1
6414, 1, 1636422059905, 1636422060173, 268, 1, 267, 0, 0, 0
6415, 1, 1636422060129, 1636422060393, 264, 1, 263, 1, 0, 1
6417, 1, 1636422060173, 1636422060437, 264, 0, 264, 0, 0, 0
6419, 1, 1636422060265, 1636422060530, 265, 1, 264, 0, 0, 0
6418, 1, 1636422060265, 1636422060530, 265, 0, 265, 0, 0, 0
6420, 1, 1636422060353, 1636422060621, 268, 0, 268, 0, 0, 0
6423, 1, 1636422060533, 1636422060793, 260, 0, 260, 0, 0, 0
6422, 1, 1636422060529, 1636422060797, 268, 1, 267, 0, 1, 1
6421, 1, 1636422060529, 1636422060797, 268, 1, 267, 0, 1, 1
6424, 1, 1636422060574, 1636422060837, 263, 0, 263, 0, 0, 0
6426, 1, 1636422060837, 1636422061101, 264, 0, 264, 0, 0, 0
6427, 1, 1636422060925, 1636422061189, 264, 1, 263, 0, 1, 1
6428, 1, 1636422060933, 1636422061197, 264, 1, 263, 0, 1, 1
6429, 1, 1636422061025, 1636422061293, 268, 1, 267, 0, 1, 1
6432, 1, 1636422061201, 1636422061469, 268, 1, 267, 0, 0, 0
6431, 1, 1636422061205, 1636422061473, 268, 1, 267, 0, 1, 1
6430, 1, 1636422061205, 1636422061473, 268, 1, 267, 0, 0, 0
6434, 1, 1636422061506, 1636422061770, 264, 0, 264, 0, 0, 0
6435, 1, 1636422061598, 1636422061866, 268, 0, 268, 0, 0, 0
6437, 1, 1636422061694, 1636422061957, 263, 0, 263, 0, 0, 0
6438, 1, 1636422061877, 1636422062142, 265, 1, 264, 0, 0, 0
6439, 1, 1636422061877, 1636422062145, 268, 1, 267, 0, 0, 0
6441, 1, 1636422062170, 1636422062434, 264, 0, 264, 0, 0, 0
6442, 1, 1636422062265, 1636422062530, 265, 1, 264, 0, 1, 1
6443, 1, 1636422062361, 1636422062626, 265, 1, 264, 0, 0, 0
6444, 1, 1636422062545, 1636422062813, 268, 1, 267, 0, 0, 0
6445, 1, 1636422062545, 1636422062813, 268, 1, 267, 1, 0, 1
6447, 1, 1636422062937, 1636422063201, 264, 1, 263, 0, 0, 0
6448, 1, 1636422063030, 1636422063293, 263, 0, 263, 0, 0, 0
6450, 1, 1636422063218, 1636422063486, 268, 0, 268, 0, 0, 0
6451, 1, 1636422063605, 1636422063869, 264, 1, 263, 0, 0, 0
6453, 1, 1636422063890, 1636422064154, 264, 0, 264, 0, 0, 0
6455, 1, 1636422064558, 1636422064826, 268, 0, 268, 0, 0, 0
6456, 1, 1636422065234, 1636422065497, 263, 0, 263, 0, 0, 0
6457, 1, 1636422065494, 1636422065762, 268, 0, 268, 0, 0, 0
6459, 1, 1636422066157, 1636422066421, 264, 1, 263, 0, 0, 0
6460, 1, 1636422066166, 1636422066430, 264, 0, 264, 0, 0, 0
6461, 1, 1636422066485, 1636422066750, 265, 1, 264, 0, 1, 1
6462, 1, 1636422066826, 1636422067090, 264, 0, 264, 0, 0, 0
6463, 1, 1636422066837, 1636422067102, 265, 1, 264, 0, 0, 0
6464, 1, 1636422067157, 1636422067430, 273, 1, 272, 0, 1, 1
6465, 1, 1636422067422, 1636422067685, 263, 0, 263, 0, 0, 0
6466, 1, 1636422067493, 1636422067758, 265, 1, 264, 1, 0, 1
6467, 1, 1636422067505, 1636422067769, 264, 1, 263, 0, 0, 0
6468, 1, 1636422067833, 1636422068098, 265, 1, 264, 0, 0, 0
6469, 1, 1636422068121, 1636422068386, 265, 1, 264, 0, 1, 1
6470, 1, 1636422068161, 1636422068426, 265, 1, 264, 1, 0, 1
6471, 1, 1636422068173, 1636422068438, 265, 0, 265, 0, 0, 0
6472, 1, 1636422068533, 1636422068805, 272, 1, 271, 0, 0, 0
6473, 1, 1636422068790, 1636422069085, 295, 0, 295, 0, 0, 0
6474, 1, 1636422068845, 1636422069110, 265, 1, 264, 0, 0, 0
6475, 1, 1636422068845, 1636422069110, 265, 1, 264, 0, 1, 1
6476, 1, 1636422069001, 1636422069266, 265, 1, 264, 0, 0, 0
6477, 1, 1636422069277, 1636422069541, 264, 1, 263, 0, 1, 1
6478, 1, 1636422069390, 1636422069653, 263, 0, 263, 0, 0, 0
6479, 1, 1636422069497, 1636422069761, 264, 1, 263, 1, 0, 1
6481, 1, 1636422069513, 1636422069778, 265, 1, 264, 0, 0, 0
6482, 1, 1636422069513, 1636422069778, 265, 1, 264, 1, 0, 1
6480, 1, 1636422069513, 1636422069778, 265, 1, 264, 0, 0, 0
6483, 1, 1636422069665, 1636422069934, 269, 0, 269, 0, 0, 0
6484, 1, 1636422069989, 1636422070253, 264, 1, 263, 0, 1, 1
6485, 1, 1636422070081, 1636422070345, 264, 0, 264, 0, 0, 0
6486, 1, 1636422070173, 1636422070437, 264, 0, 264, 0, 0, 0
6489, 1, 1636422070217, 1636422070485, 268, 1, 267, 1, 0, 1
6487, 1, 1636422070217, 1636422070485, 268, 1, 267, 1, 0, 1
6490, 1, 1636422070337, 1636422070606, 269, 1, 268, 0, 1, 1
6491, 1, 1636422070658, 1636422070974, 316, 0, 316, 0, 0, 0
6492, 1, 1636422070801, 1636422071070, 269, 1, 268, 0, 0, 0
6493, 1, 1636422070889, 1636422071158, 269, 1, 268, 0, 1, 1
6495, 1, 1636422071025, 1636422071294, 269, 1, 268, 0, 1, 1
6496, 1, 1636422071197, 1636422071462, 265, 1, 264, 1, 0, 1
6498, 1, 1636422071473, 1636422071738, 265, 1, 264, 0, 1, 1
6499, 1, 1636422071558, 1636422071825, 267, 0, 267, 0, 0, 0
6500, 1, 1636422071697, 1636422071962, 265, 1, 264, 0, 0, 0
6502, 1, 1636422072141, 1636422072406, 265, 1, 264, 0, 1, 1
6503, 1, 1636422072185, 1636422072449, 264, 1, 263, 0, 0, 0
6504, 1, 1636422072365, 1636422072630, 265, 0, 265, 0, 0, 0
6505, 1, 1636422072809, 1636422073074, 265, 1, 264, 0, 0, 0
6506, 1, 1636422072889, 1636422073153, 264, 0, 264, 0, 0, 0
6507, 1, 1636422073029, 1636422073294, 265, 1, 264, 0, 1, 1
6508, 1, 1636422073486, 1636422073750, 264, 0, 264, 0, 0, 0
6509, 1, 1636422073562, 1636422073826, 264, 0, 264, 0, 0, 0
6511, 1, 1636422074229, 1636422074498, 269, 1, 268, 1, 0, 1
6512, 1, 1636422074902, 1636422075178, 276, 0, 276, 0, 0, 0
6513, 1, 1636422075582, 1636422075845, 263, 0, 263, 0, 0, 0
6514, 1, 1636422076210, 1636422076474, 264, 0, 264, 0, 0, 0
6515, 1, 1636422076246, 1636422076514, 268, 0, 268, 0, 0, 0
6518, 1, 1636422081194, 1636422081458, 264, 0, 264, 0, 0, 0
6522, 1, 1636422081466, 1636422081730, 264, 0, 264, 0, 0, 0
6528, 1, 1636422082169, 1636422082438, 269, 1, 268, 0, 1, 1
6529, 1, 1636422082838, 1636422083110, 272, 0, 272, 0, 0, 0
6530, 1, 1636422083510, 1636422083782, 272, 0, 272, 0, 0, 0
6531, 1, 1636422084202, 1636422084470, 268, 0, 268, 0, 0, 0
6533, 1, 1636422084870, 1636422085146, 276, 0, 276, 0, 0, 0
6534, 1, 1636422085550, 1636422085822, 272, 0, 272, 0, 0, 0
6535, 1, 1636422086218, 1636422086486, 268, 0, 268, 0, 0, 0
6537, 1, 1636422087186, 1636422087450, 264, 0, 264, 0, 0, 0
6538, 1, 1636422087854, 1636422088122, 268, 0, 268, 0, 0, 0
6539, 1, 1636422088526, 1636422088790, 264, 0, 264, 0, 0, 0
6540, 1, 1636422089193, 1636422089458, 265, 1, 264, 1, 0, 1
6541, 1, 1636422089862, 1636422090130, 268, 0, 268, 0, 0, 0
6542, 1, 1636422090570, 1636422090834, 264, 0, 264, 0, 0, 0
6543, 1, 1636422091425, 1636422091689, 264, 0, 264, 0, 0, 0
6549, 1, 1636422092181, 1636422092450, 269, 1, 268, 1, 0, 1
6550, 1, 1636422092454, 1636422092717, 263, 0, 263, 0, 0, 0
6551, 1, 1636422092854, 1636422093118, 264, 0, 264, 0, 0, 0
6552, 1, 1636422093125, 1636422093398, 273, 1, 272, 0, 0, 0
6553, 1, 1636422093522, 1636422093790, 268, 0, 268, 0, 0, 0
6554, 1, 1636422093802, 1636422094066, 264, 0, 264, 0, 0, 0
6555, 1, 1636422094194, 1636422094506, 312, 0, 312, 0, 0, 0
6556, 1, 1636422094509, 1636422094778, 269, 1, 268, 1, 0, 1
6557, 1, 1636422094910, 1636422095174, 264, 0, 264, 0, 0, 0
6558, 1, 1636422095182, 1636422095445, 263, 0, 263, 0, 0, 0
6559, 1, 1636422095578, 1636422095842, 264, 0, 264, 0, 0, 0
6560, 1, 1636422095849, 1636422096113, 264, 1, 263, 0, 1, 1
6561, 1, 1636422096246, 1636422096514, 268, 0, 268, 0, 0, 0
6562, 1, 1636422096518, 1636422096782, 264, 0, 264, 0, 0, 0
6564, 1, 1636422102046, 1636422102310, 264, 0, 264, 0, 0, 0
6565, 1, 1636422102394, 1636422102658, 264, 0, 264, 0, 0, 0
6569, 1, 1636422102709, 1636422102974, 265, 1, 264, 0, 0, 0
6570, 1, 1636422103062, 1636422103326, 264, 0, 264, 0, 0, 0
6571, 1, 1636422103373, 1636422103638, 265, 0, 265, 0, 0, 0
6572, 1, 1636422103730, 1636422103998, 268, 0, 268, 0, 0, 0
6573, 1, 1636422104045, 1636422104306, 261, 0, 261, 0, 0, 0
6574, 1, 1636422104397, 1636422104662, 265, 1, 264, 0, 0, 0
6575, 1, 1636422104710, 1636422104974, 264, 0, 264, 0, 0, 0
6576, 1, 1636422105065, 1636422105330, 265, 1, 264, 0, 0, 0
6577, 1, 1636422105377, 1636422105645, 268, 1, 267, 0, 1, 1
6578, 1, 1636422105730, 1636422105998, 268, 0, 268, 0, 0, 0
6579, 1, 1636422106045, 1636422106314, 269, 0, 269, 0, 0, 0
6580, 1, 1636422106397, 1636422106662, 265, 1, 264, 0, 0, 0
6583, 1, 1636422112762, 1636422113030, 268, 0, 268, 0, 0, 0
6584, 1, 1636422113038, 1636422113302, 264, 0, 264, 0, 0, 0
6585, 1, 1636422113434, 1636422113698, 264, 0, 264, 0, 0, 0
6586, 1, 1636422113702, 1636422113974, 272, 0, 272, 0, 0, 0
6587, 1, 1636422114102, 1636422114370, 268, 0, 268, 0, 0, 0
6588, 1, 1636422114373, 1636422114637, 264, 1, 263, 0, 0, 0
6589, 1, 1636422114773, 1636422115042, 269, 1, 268, 0, 0, 0
6590, 1, 1636422115042, 1636422115309, 267, 0, 267, 0, 0, 0
6591, 1, 1636422115446, 1636422115714, 268, 0, 268, 0, 0, 0
6592, 1, 1636422115721, 1636422115986, 265, 1, 264, 0, 1, 1
6593, 1, 1636422116117, 1636422116382, 265, 0, 265, 0, 0, 0
6594, 1, 1636422116385, 1636422116649, 264, 1, 263, 0, 0, 0
6601, 1, 1636422474858, 1636422475126, 268, 0, 268, 0, 0, 0
6602, 1, 1636422475329, 1636422475597, 268, 1, 267, 0, 0, 0
6604, 1, 1636422475886, 1636422476158, 272, 0, 272, 0, 0, 0
6606, 1, 1636422476414, 1636422476678, 264, 0, 264, 0, 0, 0
6608, 1, 1636422476982, 1636422477250, 268, 0, 268, 0, 0, 0
6610, 1, 1636422477582, 1636422477854, 272, 0, 272, 0, 0, 0
6612, 1, 1636422478102, 1636422478366, 264, 0, 264, 0, 0, 0
6614, 1, 1636422478714, 1636422478982, 268, 0, 268, 0, 0, 0
6616, 1, 1636422479250, 1636422479521, 271, 0, 271, 0, 0, 0
6618, 1, 1636422479717, 1636422479990, 273, 0, 273, 0, 0, 0
6621, 1, 1636422481362, 1636422481629, 267, 0, 267, 0, 0, 0
6622, 1, 1636422481878, 1636422482141, 263, 0, 263, 0, 0, 0
6624, 1, 1636422482437, 1636422482701, 264, 0, 264, 0, 0, 0
6626, 1, 1636422483034, 1636422483297, 263, 0, 263, 0, 0, 0
6628, 1, 1636422483578, 1636422483842, 264, 0, 264, 0, 0, 0
6630, 1, 1636422484086, 1636422484354, 268, 0, 268, 0, 0, 0
6632, 1, 1636422484697, 1636422484966, 269, 1, 268, 0, 0, 0
6634, 1, 1636422485281, 1636422485550, 269, 1, 268, 0, 0, 0
6637, 1, 1636422485882, 1636422486146, 264, 0, 264, 0, 0, 0
6636, 1, 1636422485945, 1636422486209, 264, 1, 263, 0, 1, 1
6639, 1, 1636422486390, 1636422486685, 295, 0, 295, 0, 0, 0
6640, 1, 1636422486630, 1636422486898, 268, 0, 268, 0, 0, 0
6641, 1, 1636422486634, 1636422486898, 264, 0, 264, 0, 0, 0
6643, 1, 1636422486945, 1636422487213, 268, 0, 268, 0, 0, 0
6644, 1, 1636422487129, 1636422487397, 268, 1, 267, 0, 1, 1
6647, 1, 1636422487445, 1636422487709, 264, 0, 264, 0, 0, 0
6646, 1, 1636422487481, 1636422487746, 265, 1, 264, 0, 1, 1
6648, 1, 1636422487666, 1636422487929, 263, 0, 263, 0, 0, 0
6649, 1, 1636422487910, 1636422488177, 267, 0, 267, 0, 0, 0
6650, 1, 1636422488074, 1636422488378, 304, 0, 304, 0, 0, 0
6651, 1, 1636422488202, 1636422488466, 264, 0, 264, 0, 0, 0
6653, 1, 1636422488481, 1636422488742, 261, 0, 261, 0, 0, 0
6654, 1, 1636422488646, 1636422488925, 279, 0, 279, 0, 0, 0
6656, 1, 1636422488789, 1636422489053, 264, 0, 264, 0, 0, 0
6657, 1, 1636422489022, 1636422489289, 267, 0, 267, 0, 0, 0
6658, 1, 1636422489193, 1636422489506, 313, 1, 312, 1, 0, 1
6660, 1, 1636422489361, 1636422489626, 265, 1, 264, 1, 0, 1
6661, 1, 1636422489606, 1636422489870, 264, 0, 264, 0, 0, 0
6662, 1, 1636422489773, 1636422490042, 269, 1, 268, 0, 0, 0
6664, 1, 1636422489958, 1636422490222, 264, 0, 264, 0, 0, 0
6665, 1, 1636422490177, 1636422490441, 264, 1, 263, 0, 0, 0
6666, 1, 1636422490305, 1636422490570, 265, 1, 264, 0, 1, 1
6668, 1, 1636422490485, 1636422490745, 260, 0, 260, 0, 0, 0
6669, 1, 1636422490713, 1636422490978, 265, 1, 264, 1, 0, 1
6670, 1, 1636422490809, 1636422491073, 264, 0, 264, 0, 0, 0
6672, 1, 1636422491029, 1636422491293, 264, 1, 263, 0, 1, 1
6673, 1, 1636422491301, 1636422491566, 265, 1, 264, 0, 1, 1
6675, 1, 1636422491538, 1636422491802, 264, 0, 264, 0, 0, 0
6676, 1, 1636422491849, 1636422492162, 313, 0, 313, 0, 0, 0
6678, 1, 1636422492345, 1636422492610, 265, 1, 264, 1, 0, 1
6679, 1, 1636422492425, 1636422492702, 277, 1, 276, 0, 0, 0
6681, 1, 1636422492970, 1636422493274, 304, 0, 304, 0, 0, 0
6682, 1, 1636422493141, 1636422493409, 268, 1, 267, 0, 1, 1
6684, 1, 1636422493541, 1636422493833, 292, 1, 291, 0, 0, 0
6685, 1, 1636422493686, 1636422493949, 263, 0, 263, 0, 0, 0
6686, 1, 1636422493957, 1636422494222, 265, 1, 264, 0, 1, 1
6687, 1, 1636422494101, 1636422494382, 281, 1, 280, 0, 1, 1
6688, 1, 1636422494293, 1636422494557, 264, 1, 263, 0, 0, 0
6689, 1, 1636422494497, 1636422494766, 269, 1, 268, 0, 0, 0
6690, 1, 1636422494650, 1636422494914, 264, 0, 264, 0, 0, 0
6692, 1, 1636422494826, 1636422495089, 263, 0, 263, 0, 0, 0
6693, 1, 1636422495062, 1636422495325, 263, 0, 263, 0, 0, 0
6694, 1, 1636422495177, 1636422495486, 309, 1, 308, 0, 1, 1
6696, 1, 1636422495405, 1636422495670, 265, 0, 265, 0, 0, 0
6697, 1, 1636422495626, 1636422495890, 264, 0, 264, 0, 0, 0
6698, 1, 1636422495762, 1636422496078, 316, 0, 316, 0, 0, 0
6700, 1, 1636422495901, 1636422496170, 269, 1, 268, 0, 0, 0
6701, 1, 1636422496165, 1636422496433, 268, 1, 267, 1, 0, 1
6702, 1, 1636422496342, 1636422496605, 263, 0, 263, 0, 0, 0
6704, 1, 1636422496517, 1636422496781, 264, 1, 263, 0, 1, 1
6705, 1, 1636422496722, 1636422496985, 263, 0, 263, 0, 0, 0
6706, 1, 1636422496938, 1636422497206, 268, 0, 268, 0, 0, 0
6708, 1, 1636422497058, 1636422497322, 264, 0, 264, 0, 0, 0
6709, 1, 1636422497277, 1636422497541, 264, 0, 264, 0, 0, 0
6712, 1, 1636422497649, 1636422497917, 268, 1, 267, 0, 0, 0
6711, 1, 1636422497689, 1636422497958, 269, 0, 269, 0, 0, 0
6713, 1, 1636422497874, 1636422498138, 264, 0, 264, 0, 0, 0
6715, 1, 1636422498405, 1636422498669, 264, 0, 264, 0, 0, 0
6716, 1, 1636422498469, 1636422498737, 268, 1, 267, 0, 0, 0
6717, 1, 1636422498562, 1636422498825, 263, 0, 263, 0, 0, 0
6719, 1, 1636422499006, 1636422499310, 304, 0, 304, 0, 0, 0
6720, 1, 1636422499225, 1636422499494, 269, 1, 268, 0, 1, 1
6721, 1, 1636422499254, 1636422499522, 268, 0, 268, 0, 0, 0
6723, 1, 1636422499581, 1636422499845, 264, 1, 263, 1, 0, 1
6724, 1, 1636422499761, 1636422500025, 264, 1, 263, 0, 1, 1
6727, 1, 1636422500113, 1636422500378, 265, 1, 264, 1, 0, 1
6728, 1, 1636422500294, 1636422500558, 264, 0, 264, 0, 0, 0
6730, 1, 1636422500702, 1636422501006, 304, 0, 304, 0, 0, 0
6731, 1, 1636422500829, 1636422501094, 265, 1, 264, 0, 0, 0
6733, 1, 1636422501274, 1636422501541, 267, 0, 267, 0, 0, 0
6734, 1, 1636422501458, 1636422501726, 268, 0, 268, 0, 0, 0
6736, 1, 1636422501806, 1636422502069, 263, 0, 263, 0, 0, 0
6737, 1, 1636422501986, 1636422502253, 267, 0, 267, 0, 0, 0
6739, 1, 1636422502410, 1636422502678, 268, 0, 268, 0, 0, 0
6740, 1, 1636422502526, 1636422502794, 268, 0, 268, 0, 0, 0
6742, 1, 1636422502942, 1636422503206, 264, 0, 264, 0, 0, 0
6743, 1, 1636422503134, 1636422503397, 263, 0, 263, 0, 0, 0
6745, 1, 1636422503454, 1636422503721, 267, 0, 267, 0, 0, 0
6746, 1, 1636422503666, 1636422503930, 264, 0, 264, 0, 0, 0
6748, 1, 1636422504174, 1636422504442, 268, 0, 268, 0, 0, 0
6751, 1, 1636422505054, 1636422505330, 276, 0, 276, 0, 0, 0
6752, 1, 1636422505594, 1636422505889, 295, 0, 295, 0, 0, 0
6753, 1, 1636422505806, 1636422506074, 268, 0, 268, 0, 0, 0
6754, 1, 1636422506153, 1636422506458, 305, 1, 304, 0, 0, 0
6755, 1, 1636422506310, 1636422506577, 267, 0, 267, 0, 0, 0
6757, 1, 1636422506721, 1636422506994, 273, 1, 272, 0, 1, 1
6758, 1, 1636422506905, 1636422507169, 264, 0, 264, 0, 0, 0
6760, 1, 1636422507262, 1636422507554, 292, 0, 292, 0, 0, 0
6761, 1, 1636422507470, 1636422507734, 264, 0, 264, 0, 0, 0
6763, 1, 1636422507818, 1636422508102, 284, 0, 284, 0, 0, 0
6764, 1, 1636422508018, 1636422508286, 268, 0, 268, 0, 0, 0
6766, 1, 1636422508369, 1636422508634, 265, 0, 265, 0, 0, 0
6767, 1, 1636422508538, 1636422508802, 264, 0, 264, 0, 0, 0
6769, 1, 1636422508969, 1636422509238, 269, 1, 268, 0, 0, 0
6770, 1, 1636422509125, 1636422509390, 265, 1, 264, 0, 1, 1
6772, 1, 1636422509574, 1636422509838, 264, 0, 264, 0, 0, 0
6773, 1, 1636422509681, 1636422509946, 265, 1, 264, 0, 1, 1
6776, 1, 1636422510281, 1636422510565, 284, 0, 284, 0, 0, 0
6775, 1, 1636422510325, 1636422510589, 264, 1, 263, 0, 0, 0
6777, 1, 1636422510390, 1636422510657, 267, 0, 267, 0, 0, 0
6779, 1, 1636422510834, 1636422511137, 303, 0, 303, 0, 0, 0
6780, 1, 1636422511054, 1636422511317, 263, 0, 263, 0, 0, 0
6781, 1, 1636422511070, 1636422511334, 264, 0, 264, 0, 0, 0
6783, 1, 1636422511406, 1636422511674, 268, 0, 268, 0, 0, 0
6784, 1, 1636422511589, 1636422511854, 265, 1, 264, 0, 1, 1
6786, 1, 1636422511873, 1636422512138, 265, 0, 265, 0, 0, 0
6787, 1, 1636422511942, 1636422512205, 263, 0, 263, 0, 0, 0
6788, 1, 1636422512117, 1636422512381, 264, 1, 263, 0, 1, 1
6789, 1, 1636422512369, 1636422512633, 264, 1, 263, 1, 0, 1
6790, 1, 1636422512538, 1636422512817, 279, 0, 279, 0, 0, 0
6791, 1, 1636422512657, 1636422512922, 265, 1, 264, 1, 0, 1
6792, 1, 1636422512678, 1636422512941, 263, 0, 263, 0, 0, 0
6793, 1, 1636422512937, 1636422513202, 265, 1, 264, 0, 0, 0
6794, 1, 1636422513082, 1636422513362, 280, 0, 280, 0, 0, 0
6795, 1, 1636422513185, 1636422513449, 264, 1, 263, 0, 0, 0
6796, 1, 1636422513277, 1636422513541, 264, 1, 263, 0, 0, 0
6797, 1, 1636422513466, 1636422513729, 263, 0, 263, 0, 0, 0
6798, 1, 1636422513466, 1636422513741, 275, 0, 275, 0, 0, 0
6799, 1, 1636422513633, 1636422513898, 265, 0, 265, 0, 0, 0
6800, 1, 1636422513733, 1636422514002, 269, 1, 268, 0, 1, 1
6801, 1, 1636422513802, 1636422514066, 264, 0, 264, 0, 0, 0
6802, 1, 1636422513970, 1636422514233, 263, 0, 263, 0, 0, 0
6803, 1, 1636422514066, 1636422514329, 263, 0, 263, 0, 0, 0
6804, 1, 1636422514226, 1636422514498, 272, 0, 272, 0, 0, 0
6805, 1, 1636422514258, 1636422514525, 267, 0, 267, 0, 0, 0
6807, 1, 1636422514346, 1636422514613, 267, 0, 267, 0, 0, 0
6806, 1, 1636422514529, 1636422514798, 269, 0, 269, 0, 0, 0
6808, 1, 1636422514550, 1636422514813, 263, 0, 263, 0, 0, 0
6809, 1, 1636422514602, 1636422514865, 263, 0, 263, 0, 0, 0
6810, 1, 1636422514762, 1636422515030, 268, 0, 268, 0, 0, 0
6811, 1, 1636422514829, 1636422515093, 264, 1, 263, 0, 1, 1
6813, 1, 1636422514953, 1636422515221, 268, 1, 267, 1, 0, 1
6814, 1, 1636422515097, 1636422515366, 269, 1, 268, 0, 1, 1
6812, 1, 1636422515105, 1636422515369, 264, 1, 263, 0, 1, 1
6815, 1, 1636422515153, 1636422515418, 265, 1, 264, 0, 1, 1
6816, 1, 1636422515209, 1636422515473, 264, 1, 263, 0, 1, 1
6817, 1, 1636422515277, 1636422515541, 264, 1, 263, 0, 0, 0
6818, 1, 1636422515373, 1636422515637, 264, 0, 264, 0, 0, 0
6820, 1, 1636422515485, 1636422515749, 264, 1, 263, 1, 0, 1
6821, 1, 1636422515541, 1636422515805, 264, 1, 263, 0, 1, 1
6819, 1, 1636422515637, 1636422515905, 268, 1, 267, 1, 0, 1
6823, 1, 1636422515762, 1636422516029, 267, 0, 267, 0, 0, 0
6822, 1, 1636422515773, 1636422516041, 268, 1, 267, 0, 0, 0
6824, 1, 1636422515869, 1636422516133, 264, 1, 263, 0, 1, 1
6825, 1, 1636422515945, 1636422516209, 264, 1, 263, 0, 1, 1
6827, 1, 1636422516001, 1636422516265, 264, 0, 264, 0, 0, 0
6828, 1, 1636422516117, 1636422516381, 264, 1, 263, 0, 1, 1
6829, 1, 1636422516313, 1636422516597, 284, 0, 284, 0, 0, 0
6830, 1, 1636422516293, 1636422516601, 308, 0, 308, 0, 0, 0
6831, 1, 1636422516337, 1636422516605, 268, 1, 267, 1, 0, 1
6833, 1, 1636422516553, 1636422516817, 264, 1, 263, 1, 0, 1
6834, 1, 1636422516690, 1636422516953, 263, 0, 263, 0, 0, 0
6835, 1, 1636422516730, 1636422516993, 263, 0, 263, 0, 0, 0
6836, 1, 1636422516813, 1636422517077, 264, 0, 264, 0, 0, 0
6837, 1, 1636422516869, 1636422517141, 272, 0, 272, 0, 0, 0
6838, 1, 1636422516909, 1636422517173, 264, 1, 263, 0, 1, 1
6840, 1, 1636422517081, 1636422517349, 268, 1, 267, 0, 0, 0
6841, 1, 1636422517189, 1636422517453, 264, 1, 263, 0, 0, 0
6842, 1, 1636422517337, 1636422517601, 264, 0, 264, 0, 0, 0
6843, 1, 1636422517405, 1636422517714, 309, 1, 308, 0, 1, 1
6844, 1, 1636422517489, 1636422517753, 264, 0, 264, 0, 0, 0
6845, 1, 1636422517537, 1636422517801, 264, 1, 263, 0, 0, 0
6846, 1, 1636422517582, 1636422517849, 267, 0, 267, 0, 0, 0
6848, 1, 1636422517761, 1636422518021, 260, 0, 260, 0, 0, 0
6847, 1, 1636422517805, 1636422518069, 264, 0, 264, 0, 0, 0
6849, 1, 1636422517873, 1636422518145, 272, 1, 271, 0, 1, 1
6851, 1, 1636422517953, 1636422518222, 269, 1, 268, 0, 1, 1
6850, 1, 1636422517969, 1636422518278, 309, 1, 308, 0, 1, 1
6852, 1, 1636422518121, 1636422518389, 268, 1, 267, 0, 0, 0
6853, 1, 1636422518133, 1636422518401, 268, 1, 267, 0, 0, 0
6854, 1, 1636422518277, 1636422518542, 265, 1, 264, 0, 0, 0
6855, 1, 1636422518333, 1636422518602, 269, 1, 268, 0, 0, 0
6856, 1, 1636422518397, 1636422518669, 272, 0, 272, 0, 0, 0
6857, 1, 1636422518477, 1636422518741, 264, 1, 263, 0, 1, 1
6859, 1, 1636422518517, 1636422518786, 269, 1, 268, 0, 1, 1
6858, 1, 1636422518541, 1636422518845, 304, 1, 303, 0, 0, 0
6860, 1, 1636422518665, 1636422518929, 264, 1, 263, 0, 0, 0
6861, 1, 1636422518697, 1636422518961, 264, 1, 263, 0, 0, 0
6862, 1, 1636422518757, 1636422519017, 260, 0, 260, 0, 0, 0
6863, 1, 1636422518929, 1636422519193, 264, 1, 263, 0, 1, 1
6864, 1, 1636422518937, 1636422519205, 268, 0, 268, 0, 0, 0
6866, 1, 1636422519081, 1636422519389, 308, 0, 308, 0, 0, 0
6867, 1, 1636422519121, 1636422519390, 269, 1, 268, 0, 1, 1
6865, 1, 1636422519106, 1636422519390, 284, 0, 284, 0, 0, 0
6868, 1, 1636422519213, 1636422519477, 264, 0, 264, 0, 0, 0
6870, 1, 1636422519305, 1636422519570, 265, 0, 265, 0, 0, 0
6871, 1, 1636422519317, 1636422519586, 269, 0, 269, 0, 0, 0
6872, 1, 1636422519485, 1636422519749, 264, 0, 264, 0, 0, 0
6873, 1, 1636422519513, 1636422519781, 268, 0, 268, 0, 0, 0
6874, 1, 1636422519550, 1636422519813, 263, 0, 263, 0, 0, 0
6875, 1, 1636422519645, 1636422519910, 265, 1, 264, 0, 1, 1
6876, 1, 1636422519734, 1636422520005, 271, 0, 271, 0, 0, 0
6877, 1, 1636422519734, 1636422520005, 271, 0, 271, 0, 0, 0
6878, 1, 1636422519825, 1636422520097, 272, 0, 272, 0, 0, 0
6879, 1, 1636422519913, 1636422520177, 264, 0, 264, 0, 0, 0
6880, 1, 1636422519957, 1636422520225, 268, 1, 267, 0, 0, 0
6881, 1, 1636422520005, 1636422520265, 260, 0, 260, 0, 0, 0
6882, 1, 1636422520070, 1636422520334, 264, 0, 264, 0, 0, 0
6883, 1, 1636422520129, 1636422520393, 264, 1, 263, 0, 1, 1
6884, 1, 1636422520185, 1636422520445, 260, 0, 260, 0, 0, 0
6885, 1, 1636422520257, 1636422520521, 264, 0, 264, 0, 0, 0
6886, 1, 1636422520341, 1636422520605, 264, 0, 264, 0, 0, 0
6887, 1, 1636422520357, 1636422520621, 264, 1, 263, 0, 1, 1
6888, 1, 1636422520365, 1636422520629, 264, 1, 263, 0, 0, 0
6889, 1, 1636422520514, 1636422520777, 263, 0, 263, 0, 0, 0
6890, 1, 1636422520565, 1636422520829, 264, 0, 264, 0, 0, 0
6891, 1, 1636422520629, 1636422520893, 264, 1, 263, 0, 0, 0
6893, 1, 1636422520717, 1636422520981, 264, 1, 263, 0, 1, 1
6894, 1, 1636422520785, 1636422521053, 268, 1, 267, 1, 0, 1
6895, 1, 1636422520785, 1636422521054, 269, 1, 268, 1, 0, 1
6897, 1, 1636422520893, 1636422521157, 264, 0, 264, 0, 0, 0
6898, 1, 1636422520945, 1636422521209, 264, 0, 264, 0, 0, 0
6896, 1, 1636422521053, 1636422521317, 264, 1, 263, 0, 0, 0
6899, 1, 1636422521081, 1636422521341, 260, 0, 260, 0, 0, 0
6900, 1, 1636422521125, 1636422521389, 264, 0, 264, 0, 0, 0
6902, 1, 1636422521213, 1636422521473, 260, 0, 260, 0, 0, 0
6903, 1, 1636422521317, 1636422521577, 260, 1, 259, 1, 0, 1
6904, 1, 1636422521341, 1636422521610, 269, 0, 269, 0, 0, 0
6905, 1, 1636422521381, 1636422521641, 260, 0, 260, 0, 0, 0
6907, 1, 1636422521493, 1636422521757, 264, 0, 264, 0, 0, 0
6908, 1, 1636422521505, 1636422521770, 265, 0, 265, 0, 0, 0
6906, 1, 1636422521581, 1636422521874, 293, 0, 293, 0, 0, 0
6909, 1, 1636422521577, 1636422521877, 300, 0, 300, 0, 0, 0
6911, 1, 1636422521705, 1636422521969, 264, 1, 263, 0, 1, 1
6910, 1, 1636422521709, 1636422521973, 264, 1, 263, 0, 1, 1
6913, 1, 1636422521873, 1636422522141, 268, 1, 267, 0, 0, 0
6914, 1, 1636422521917, 1636422522178, 261, 0, 261, 0, 0, 0
6917, 1, 1636422522113, 1636422522377, 264, 1, 263, 0, 0, 0
6918, 1, 1636422522113, 1636422522378, 265, 1, 264, 0, 0, 0
6916, 1, 1636422522141, 1636422522401, 260, 0, 260, 0, 0, 0
6919, 1, 1636422522145, 1636422522409, 264, 0, 264, 0, 0, 0
6915, 1, 1636422522189, 1636422522454, 265, 0, 265, 0, 0, 0
6920, 1, 1636422522281, 1636422522542, 261, 0, 261, 0, 0, 0
6921, 1, 1636422522313, 1636422522578, 265, 1, 264, 0, 1, 1
6922, 1, 1636422522321, 1636422522597, 276, 1, 275, 0, 0, 0
6923, 1, 1636422522393, 1636422522657, 264, 1, 263, 1, 0, 1
6925, 1, 1636422522505, 1636422522777, 272, 1, 271, 1, 0, 1
6926, 1, 1636422522670, 1636422522933, 263, 0, 263, 0, 0, 0
6927, 1, 1636422522701, 1636422522965, 264, 0, 264, 0, 0, 0
6929, 1, 1636422522853, 1636422523117, 264, 1, 263, 0, 0, 0
6928, 1, 1636422522857, 1636422523121, 264, 1, 263, 0, 0, 0
6930, 1, 1636422522913, 1636422523177, 264, 1, 263, 0, 0, 0
6931, 1, 1636422522913, 1636422523178, 265, 1, 264, 1, 0, 1
6932, 1, 1636422522949, 1636422523209, 260, 0, 260, 0, 0, 0
6934, 1, 1636422523105, 1636422523369, 264, 0, 264, 0, 0, 0
6935, 1, 1636422523133, 1636422523397, 264, 0, 264, 0, 0, 0
6936, 1, 1636422523201, 1636422523466, 265, 1, 264, 0, 1, 1
6937, 1, 1636422523301, 1636422523562, 261, 0, 261, 0, 0, 0
6938, 1, 1636422523481, 1636422523745, 264, 0, 264, 0, 0, 0
6939, 1, 1636422523493, 1636422523765, 272, 0, 272, 0, 0, 0
6941, 1, 1636422523662, 1636422523925, 263, 0, 263, 0, 0, 0
6942, 1, 1636422523713, 1636422523977, 264, 1, 263, 0, 0, 0
6943, 1, 1636422523729, 1636422523993, 264, 1, 263, 0, 1, 1
6944, 1, 1636422523757, 1636422524025, 268, 0, 268, 0, 0, 0
6945, 1, 1636422523897, 1636422524165, 268, 1, 267, 0, 0, 0
6947, 1, 1636422524002, 1636422524265, 263, 0, 263, 0, 0, 0
6948, 1, 1636422524106, 1636422524370, 264, 0, 264, 0, 0, 0
6949, 1, 1636422524289, 1636422524553, 264, 1, 263, 0, 1, 1
6950, 1, 1636422524301, 1636422524570, 269, 0, 269, 0, 0, 0
6951, 1, 1636422524458, 1636422524722, 264, 0, 264, 0, 0, 0
6952, 1, 1636422524489, 1636422524754, 265, 0, 265, 0, 0, 0
6953, 1, 1636422524521, 1636422524786, 265, 1, 264, 0, 1, 1
6955, 1, 1636422524722, 1636422524986, 264, 0, 264, 0, 0, 0
6956, 1, 1636422524789, 1636422525054, 265, 0, 265, 0, 0, 0
6957, 1, 1636422524897, 1636422525158, 261, 0, 261, 0, 0, 0
6959, 1, 1636422525094, 1636422525357, 263, 0, 263, 0, 0, 0
6960, 1, 1636422525241, 1636422525509, 268, 0, 268, 0, 0, 0
6961, 1, 1636422525286, 1636422525553, 267, 0, 267, 0, 0, 0
6962, 1, 1636422525325, 1636422525585, 260, 0, 260, 0, 0, 0
6963, 1, 1636422525489, 1636422525753, 264, 0, 264, 0, 0, 0
6964, 1, 1636422525593, 1636422525861, 268, 1, 267, 0, 0, 0
6965, 1, 1636422525693, 1636422525962, 269, 1, 268, 0, 0, 0
6966, 1, 1636422525929, 1636422526194, 265, 1, 264, 0, 1, 1
6967, 1, 1636422526057, 1636422526317, 260, 0, 260, 0, 0, 0
6968, 1, 1636422526101, 1636422526370, 269, 0, 269, 0, 0, 0
6969, 1, 1636422526129, 1636422526393, 264, 1, 263, 1, 0, 1
6971, 1, 1636422526285, 1636422526577, 292, 0, 292, 0, 0, 0
6972, 1, 1636422526401, 1636422526666, 265, 0, 265, 0, 0, 0
6973, 1, 1636422526509, 1636422526774, 265, 0, 265, 0, 0, 0
6974, 1, 1636422526694, 1636422526961, 267, 0, 267, 0, 0, 0
6976, 1, 1636422526845, 1636422527113, 268, 1, 267, 1, 0, 1
6977, 1, 1636422526882, 1636422527145, 263, 0, 263, 0, 0, 0
6978, 1, 1636422526941, 1636422527210, 269, 1, 268, 0, 0, 0
6979, 1, 1636422527105, 1636422527369, 264, 0, 264, 0, 0, 0
6981, 1, 1636422527305, 1636422527565, 260, 0, 260, 0, 0, 0
6983, 1, 1636422527505, 1636422527770, 265, 0, 265, 0, 0, 0
6984, 1, 1636422527645, 1636422527910, 265, 1, 264, 0, 0, 0
6985, 1, 1636422527702, 1636422527966, 264, 0, 264, 0, 0, 0
6987, 1, 1636422527886, 1636422528150, 264, 0, 264, 0, 0, 0
6988, 1, 1636422528106, 1636422528377, 271, 0, 271, 0, 0, 0
6990, 1, 1636422528461, 1636422528726, 265, 1, 264, 0, 1, 1
6991, 1, 1636422528497, 1636422528761, 264, 1, 263, 0, 0, 0
6992, 1, 1636422528693, 1636422528957, 264, 1, 263, 1, 0, 1
6993, 1, 1636422528909, 1636422529174, 265, 1, 264, 0, 0, 0
6994, 1, 1636422529281, 1636422529545, 264, 0, 264, 0, 0, 0
6995, 1, 1636422529325, 1636422529585, 260, 0, 260, 0, 0, 0
6996, 1, 1636422529501, 1636422529765, 264, 1, 263, 0, 0, 0
6998, 1, 1636422529718, 1636422529986, 268, 0, 268, 0, 0, 0
6999, 1, 1636422530045, 1636422530310, 265, 1, 264, 1, 0, 1
7000, 1, 1636422530097, 1636422530361, 264, 1, 263, 0, 0, 0
7001, 1, 1636422530309, 1636422530574, 265, 1, 264, 0, 0, 0
7003, 1, 1636422530853, 1636422531114, 261, 0, 261, 0, 0, 0
7004, 1, 1636422530897, 1636422531161, 264, 0, 264, 0, 0, 0
7005, 1, 1636422531038, 1636422531302, 264, 0, 264, 0, 0, 0
7007, 1, 1636422531481, 1636422531766, 285, 1, 284, 0, 0, 0
7008, 1, 1636422531681, 1636422531950, 269, 1, 268, 0, 0, 0
7010, 1, 1636422531958, 1636422532221, 263, 0, 263, 0, 0, 0
7011, 1, 1636422532034, 1636422532298, 264, 0, 264, 0, 0, 0
7012, 1, 1636422532226, 1636422532534, 308, 0, 308, 0, 0, 0
7014, 1, 1636422532670, 1636422532934, 264, 0, 264, 0, 0, 0
7015, 1, 1636422532742, 1636422533006, 264, 0, 264, 0, 0, 0
7017, 1, 1636422532998, 1636422533266, 268, 0, 268, 0, 0, 0
7019, 1, 1636422533426, 1636422533690, 264, 0, 264, 0, 0, 0
7020, 1, 1636422533569, 1636422533834, 265, 0, 265, 0, 0, 0
7021, 1, 1636422533793, 1636422534057, 264, 0, 264, 0, 0, 0
7024, 1, 1636422534230, 1636422534493, 263, 0, 263, 0, 0, 0
7023, 1, 1636422534238, 1636422534501, 263, 0, 263, 0, 0, 0
7025, 1, 1636422534345, 1636422534610, 265, 1, 264, 0, 0, 0
7027, 1, 1636422534866, 1636422535134, 268, 0, 268, 0, 0, 0
7028, 1, 1636422534953, 1636422535222, 269, 1, 268, 0, 1, 1
7029, 1, 1636422535045, 1636422535309, 264, 1, 263, 0, 1, 1
7031, 1, 1636422535394, 1636422535661, 267, 0, 267, 0, 0, 0
7032, 1, 1636422535578, 1636422535841, 263, 0, 263, 0, 0, 0
7033, 1, 1636422535742, 1636422536006, 264, 0, 264, 0, 0, 0
7034, 1, 1636422535818, 1636422536082, 264, 0, 264, 0, 0, 0
7035, 1, 1636422536145, 1636422536410, 265, 1, 264, 0, 0, 0
7036, 1, 1636422536413, 1636422536681, 268, 1, 267, 1, 0, 1
7038, 1, 1636422536554, 1636422536818, 264, 0, 264, 0, 0, 0
7037, 1, 1636422536589, 1636422536885, 296, 0, 296, 0, 0, 0
7040, 1, 1636422536889, 1636422537154, 265, 0, 265, 0, 0, 0
7041, 1, 1636422537153, 1636422537421, 268, 1, 267, 0, 0, 0
7042, 1, 1636422537186, 1636422537450, 264, 0, 264, 0, 0, 0
7043, 1, 1636422537329, 1636422537593, 264, 1, 263, 0, 0, 0
7045, 1, 1636422537505, 1636422537769, 264, 0, 264, 0, 0, 0
7046, 1, 1636422537681, 1636422537950, 269, 1, 268, 0, 1, 1
7047, 1, 1636422537701, 1636422537969, 268, 1, 267, 1, 0, 1
7048, 1, 1636422537865, 1636422538129, 264, 1, 263, 0, 1, 1
7050, 1, 1636422538041, 1636422538342, 301, 1, 300, 0, 0, 0
7051, 1, 1636422538105, 1636422538370, 265, 1, 264, 1, 0, 1
7052, 1, 1636422538210, 1636422538473, 263, 0, 263, 0, 0, 0
7053, 1, 1636422538393, 1636422538657, 264, 0, 264, 0, 0, 0
7055, 1, 1636422538606, 1636422538870, 264, 0, 264, 0, 0, 0
7056, 1, 1636422538665, 1636422538930, 265, 0, 265, 0, 0, 0
7057, 1, 1636422538749, 1636422539018, 269, 1, 268, 0, 0, 0
7058, 1, 1636422538922, 1636422539186, 264, 0, 264, 0, 0, 0
7059, 1, 1636422539010, 1636422539273, 263, 0, 263, 0, 0, 0
7060, 1, 1636422539189, 1636422539453, 264, 1, 263, 0, 0, 0
7061, 1, 1636422539313, 1636422539578, 265, 0, 265, 0, 0, 0
7062, 1, 1636422539493, 1636422539758, 265, 1, 264, 0, 1, 1
7063, 1, 1636422539589, 1636422539853, 264, 0, 264, 0, 0, 0
7064, 1, 1636422539717, 1636422539982, 265, 0, 265, 0, 0, 0
7066, 1, 1636422539809, 1636422540077, 268, 0, 268, 0, 0, 0
7065, 1, 1636422539841, 1636422540106, 265, 1, 264, 0, 0, 0
7067, 1, 1636422540013, 1636422540274, 261, 0, 261, 0, 0, 0
7068, 1, 1636422540105, 1636422540370, 265, 1, 264, 0, 0, 0
7069, 1, 1636422540278, 1636422540545, 267, 0, 267, 0, 0, 0
7070, 1, 1636422540370, 1636422540634, 264, 0, 264, 0, 0, 0
7071, 1, 1636422540554, 1636422540817, 263, 0, 263, 0, 0, 0
7072, 1, 1636422540601, 1636422540861, 260, 0, 260, 0, 0, 0
7075, 1, 1636422540809, 1636422541074, 265, 1, 264, 0, 1, 1
7074, 1, 1636422540814, 1636422541081, 267, 0, 267, 0, 0, 0
7076, 1, 1636422540917, 1636422541182, 265, 1, 264, 0, 1, 1
7077, 1, 1636422541074, 1636422541337, 263, 0, 263, 0, 0, 0
7079, 1, 1636422541329, 1636422541593, 264, 1, 263, 0, 1, 1
7080, 1, 1636422541358, 1636422541622, 264, 0, 264, 0, 0, 0
7081, 1, 1636422541413, 1636422541677, 264, 1, 263, 0, 1, 1
7082, 1, 1636422541553, 1636422541818, 265, 0, 265, 0, 0, 0
7083, 1, 1636422541645, 1636422541910, 265, 1, 264, 0, 1, 1
7085, 1, 1636422541881, 1636422542150, 269, 1, 268, 1, 0, 1
7086, 1, 1636422541997, 1636422542261, 264, 1, 263, 1, 0, 1
7087, 1, 1636422542118, 1636422542381, 263, 0, 263, 0, 0, 0
7089, 1, 1636422542169, 1636422542433, 264, 1, 263, 1, 0, 1
7090, 1, 1636422542317, 1636422542586, 269, 1, 268, 0, 0, 0
7091, 1, 1636422542410, 1636422542677, 267, 0, 267, 0, 0, 0
7088, 1, 1636422542410, 1636422542678, 268, 0, 268, 0, 0, 0
7092, 1, 1636422542694, 1636422542957, 263, 0, 263, 0, 0, 0
7094, 1, 1636422542766, 1636422543033, 267, 0, 267, 0, 0, 0
7095, 1, 1636422542933, 1636422543197, 264, 0, 264, 0, 0, 0
7093, 1, 1636422542965, 1636422543225, 260, 0, 260, 0, 0, 0
7096, 1, 1636422542965, 1636422543233, 268, 0, 268, 0, 0, 0
7099, 1, 1636422543110, 1636422543389, 279, 0, 279, 0, 0, 0
7098, 1, 1636422543093, 1636422543389, 296, 1, 295, 0, 1, 1
7100, 1, 1636422543233, 1636422543497, 264, 1, 263, 0, 0, 0
7101, 1, 1636422543509, 1636422543777, 268, 1, 267, 0, 0, 0
7103, 1, 1636422543629, 1636422543893, 264, 0, 264, 0, 0, 0
7104, 1, 1636422543657, 1636422543957, 300, 1, 299, 0, 0, 0
7105, 1, 1636422543734, 1636422544001, 267, 0, 267, 0, 0, 0
7106, 1, 1636422543781, 1636422544041, 260, 0, 260, 0, 0, 0
7107, 1, 1636422543813, 1636422544077, 264, 0, 264, 0, 0, 0
7110, 1, 1636422544222, 1636422544486, 264, 0, 264, 0, 0, 0
7111, 1, 1636422544257, 1636422544521, 264, 1, 263, 0, 1, 1
7112, 1, 1636422544365, 1636422544649, 284, 1, 283, 0, 0, 0
7113, 1, 1636422544385, 1636422544650, 265, 0, 265, 0, 0, 0
7115, 1, 1636422544566, 1636422544830, 264, 0, 264, 0, 0, 0
7116, 1, 1636422544657, 1636422544921, 264, 0, 264, 0, 0, 0
7117, 1, 1636422544917, 1636422545181, 264, 1, 263, 0, 1, 1
7118, 1, 1636422544941, 1636422545202, 261, 1, 260, 0, 0, 0
7119, 1, 1636422545093, 1636422545357, 264, 1, 263, 0, 1, 1
7120, 1, 1636422545178, 1636422545441, 263, 0, 263, 0, 0, 0
7121, 1, 1636422545225, 1636422545489, 264, 0, 264, 0, 0, 0
7122, 1, 1636422545373, 1636422545637, 264, 0, 264, 0, 0, 0
7124, 1, 1636422545409, 1636422545673, 264, 0, 264, 0, 0, 0
7123, 1, 1636422545437, 1636422545701, 264, 1, 263, 0, 0, 0
7125, 1, 1636422545621, 1636422545886, 265, 0, 265, 0, 0, 0
7126, 1, 1636422545738, 1636422546001, 263, 0, 263, 0, 0, 0
7128, 1, 1636422545965, 1636422546229, 264, 1, 263, 0, 1, 1
7129, 1, 1636422545990, 1636422546253, 263, 0, 263, 0, 0, 0
7130, 1, 1636422546162, 1636422546425, 263, 0, 263, 0, 0, 0
7132, 1, 1636422546209, 1636422546474, 265, 0, 265, 0, 0, 0
7134, 1, 1636422546585, 1636422546849, 264, 1, 263, 0, 0, 0
7135, 1, 1636422546761, 1636422547025, 264, 1, 263, 0, 0, 0
7136, 1, 1636422546797, 1636422547057, 260, 0, 260, 0, 0, 0
7137, 1, 1636422546934, 1636422547198, 264, 0, 264, 0, 0, 0
7139, 1, 1636422547014, 1636422547278, 264, 0, 264, 0, 0, 0
7140, 1, 1636422547382, 1636422547646, 264, 0, 264, 0, 0, 0
7141, 1, 1636422547562, 1636422547829, 267, 0, 267, 0, 0, 0
7142, 1, 1636422547641, 1636422547906, 265, 1, 264, 0, 1, 1
7144, 1, 1636422547658, 1636422547921, 263, 0, 263, 0, 0, 0
7145, 1, 1636422547833, 1636422548098, 265, 1, 264, 0, 0, 0
7146, 1, 1636422548142, 1636422548405, 263, 0, 263, 0, 0, 0
7147, 1, 1636422548270, 1636422548538, 268, 0, 268, 0, 0, 0
7148, 1, 1636422548361, 1636422548625, 264, 0, 264, 0, 0, 0
7149, 1, 1636422548369, 1636422548633, 264, 1, 263, 0, 0, 0
7150, 1, 1636422548469, 1636422548734, 265, 1, 264, 0, 1, 1
7151, 1, 1636422548629, 1636422548894, 265, 0, 265, 0, 0, 0
7152, 1, 1636422548794, 1636422549058, 264, 0, 264, 0, 0, 0
7153, 1, 1636422548957, 1636422549221, 264, 0, 264, 0, 0, 0
7154, 1, 1636422548994, 1636422549265, 271, 0, 271, 0, 0, 0
7156, 1, 1636422549173, 1636422549441, 268, 1, 267, 0, 1, 1
7157, 1, 1636422549257, 1636422549521, 264, 1, 263, 0, 1, 1
7159, 1, 1636422549517, 1636422549782, 265, 1, 264, 0, 1, 1
7160, 1, 1636422549765, 1636422550030, 265, 1, 264, 0, 0, 0
7163, 1, 1636422550050, 1636422550325, 275, 0, 275, 0, 0, 0
7166, 1, 1636422550854, 1636422551122, 268, 0, 268, 0, 0, 0
7167, 1, 1636422550905, 1636422551194, 289, 1, 288, 0, 0, 0
7168, 1, 1636422551454, 1636422551722, 268, 0, 268, 0, 0, 0
7169, 1, 1636422551617, 1636422551886, 269, 0, 269, 0, 0, 0
7170, 1, 1636422551693, 1636422551966, 273, 1, 272, 0, 0, 0
7171, 1, 1636422552038, 1636422552301, 263, 0, 263, 0, 0, 0
7172, 1, 1636422552177, 1636422552445, 268, 0, 268, 0, 0, 0
7174, 1, 1636422552461, 1636422552729, 268, 1, 267, 0, 1, 1
7175, 1, 1636422552762, 1636422553030, 268, 0, 268, 0, 0, 0
7177, 1, 1636422553278, 1636422553546, 268, 0, 268, 0, 0, 0
7180, 1, 1636422553793, 1636422554057, 264, 1, 263, 0, 1, 1
7181, 1, 1636422554098, 1636422554362, 264, 0, 264, 0, 0, 0
7182, 1, 1636422554206, 1636422554469, 263, 0, 263, 0, 0, 0
7183, 1, 1636422554318, 1636422554586, 268, 0, 268, 0, 0, 0
7184, 1, 1636422554509, 1636422554774, 265, 0, 265, 0, 0, 0
7185, 1, 1636422554829, 1636422555090, 261, 0, 261, 0, 0, 0
7186, 1, 1636422554873, 1636422555137, 264, 0, 264, 0, 0, 0
7187, 1, 1636422554917, 1636422555185, 268, 1, 267, 0, 0, 0
7188, 1, 1636422555026, 1636422555289, 263, 0, 263, 0, 0, 0
7189, 1, 1636422555305, 1636422555570, 265, 1, 264, 1, 0, 1
7190, 1, 1636422555546, 1636422555809, 263, 0, 263, 0, 0, 0
7191, 1, 1636422555673, 1636422555937, 264, 0, 264, 0, 0, 0
7193, 1, 1636422555817, 1636422556081, 264, 0, 264, 0, 0, 0
7194, 1, 1636422556126, 1636422556397, 271, 0, 271, 0, 0, 0
7195, 1, 1636422556166, 1636422556474, 308, 0, 308, 0, 0, 0
7198, 1, 1636422556482, 1636422556746, 264, 0, 264, 0, 0, 0
7197, 1, 1636422556482, 1636422556746, 264, 0, 264, 0, 0, 0
7199, 1, 1636422556633, 1636422556898, 265, 1, 264, 0, 1, 1
7200, 1, 1636422556741, 1636422557018, 277, 0, 277, 0, 0, 0
7201, 1, 1636422556885, 1636422557150, 265, 1, 264, 0, 1, 1
7203, 1, 1636422557186, 1636422557450, 264, 0, 264, 0, 0, 0
7204, 1, 1636422557289, 1636422557558, 269, 1, 268, 0, 1, 1
7205, 1, 1636422557293, 1636422557558, 265, 0, 265, 0, 0, 0
7207, 1, 1636422557470, 1636422557733, 263, 0, 263, 0, 0, 0
7209, 1, 1636422557906, 1636422558174, 268, 0, 268, 0, 0, 0
7210, 1, 1636422557981, 1636422558245, 264, 0, 264, 0, 0, 0
7211, 1, 1636422558010, 1636422558273, 263, 0, 263, 0, 0, 0
7212, 1, 1636422558089, 1636422558354, 265, 0, 265, 0, 0, 0
7213, 1, 1636422558277, 1636422558550, 273, 0, 273, 0, 0, 0
7214, 1, 1636422558633, 1636422558897, 264, 1, 263, 1, 0, 1
7215, 1, 1636422558801, 1636422559066, 265, 0, 265, 0, 0, 0
7216, 1, 1636422558817, 1636422559081, 264, 1, 263, 1, 0, 1
7218, 1, 1636422559061, 1636422559326, 265, 0, 265, 0, 0, 0
7219, 1, 1636422559481, 1636422559745, 264, 1, 263, 0, 0, 0
7220, 1, 1636422559486, 1636422559750, 264, 0, 264, 0, 0, 0
7222, 1, 1636422559606, 1636422559869, 263, 0, 263, 0, 0, 0
7223, 1, 1636422559761, 1636422560029, 268, 0, 268, 0, 0, 0
7224, 1, 1636422559857, 1636422560122, 265, 0, 265, 0, 0, 0
7225, 1, 1636422560146, 1636422560413, 267, 0, 267, 0, 0, 0
7226, 1, 1636422560205, 1636422560469, 264, 0, 264, 0, 0, 0
7228, 1, 1636422560237, 1636422560506, 269, 1, 268, 0, 1, 1
7227, 1, 1636422560293, 1636422560598, 305, 1, 304, 0, 0, 0
7229, 1, 1636422560425, 1636422560685, 260, 0, 260, 0, 0, 0
7230, 1, 1636422560469, 1636422560733, 264, 1, 263, 0, 0, 0
7231, 1, 1636422560649, 1636422560913, 264, 1, 263, 1, 0, 1
7232, 1, 1636422560649, 1636422560913, 264, 1, 263, 0, 0, 0
7234, 1, 1636422560829, 1636422561093, 264, 1, 263, 0, 0, 0
7233, 1, 1636422560866, 1636422561130, 264, 0, 264, 0, 0, 0
7236, 1, 1636422561001, 1636422561265, 264, 0, 264, 0, 0, 0
7237, 1, 1636422561030, 1636422561297, 267, 0, 267, 0, 0, 0
7235, 1, 1636422561030, 1636422561298, 268, 0, 268, 0, 0, 0
7238, 1, 1636422561190, 1636422561453, 263, 0, 263, 0, 0, 0
7239, 1, 1636422561253, 1636422561517, 264, 1, 263, 0, 0, 0
7240, 1, 1636422561361, 1636422561626, 265, 1, 264, 0, 1, 1
7241, 1, 1636422561453, 1636422561721, 268, 1, 267, 1, 0, 1
7242, 1, 1636422561582, 1636422561845, 263, 0, 263, 0, 0, 0
7243, 1, 1636422561646, 1636422561909, 263, 0, 263, 0, 0, 0
7244, 1, 1636422561777, 1636422562045, 268, 1, 267, 0, 0, 0
7246, 1, 1636422561817, 1636422562081, 264, 1, 263, 0, 0, 0
7247, 1, 1636422561998, 1636422562261, 263, 0, 263, 0, 0, 0
7245, 1, 1636422562053, 1636422562321, 268, 0, 268, 0, 0, 0
7248, 1, 1636422562070, 1636422562334, 264, 0, 264, 0, 0, 0
7249, 1, 1636422562178, 1636422562478, 300, 0, 300, 0, 0, 0
7250, 1, 1636422562249, 1636422562513, 264, 1, 263, 0, 0, 0
7251, 1, 1636422562393, 1636422562657, 264, 0, 264, 0, 0, 0
7253, 1, 1636422562589, 1636422562858, 269, 1, 268, 0, 1, 1
7254, 1, 1636422562637, 1636422562901, 264, 0, 264, 0, 0, 0
7252, 1, 1636422562661, 1636422562929, 268, 0, 268, 0, 0, 0
7256, 1, 1636422562753, 1636422563029, 276, 0, 276, 0, 0, 0
7257, 1, 1636422562789, 1636422563057, 268, 1, 267, 0, 0, 0
7259, 1, 1636422562973, 1636422563234, 261, 0, 261, 0, 0, 0
7260, 1, 1636422563069, 1636422563337, 268, 0, 268, 0, 0, 0
7261, 1, 1636422563190, 1636422563457, 267, 0, 267, 0, 0, 0
7262, 1, 1636422563289, 1636422563558, 269, 1, 268, 0, 0, 0
7265, 1, 1636422563441, 1636422563705, 264, 0, 264, 0, 0, 0
7266, 1, 1636422563477, 1636422563741, 264, 0, 264, 0, 0, 0
7267, 1, 1636422563621, 1636422563885, 264, 0, 264, 0, 0, 0
7269, 1, 1636422563761, 1636422564026, 265, 0, 265, 0, 0, 0
7271, 1, 1636422563849, 1636422564114, 265, 0, 265, 0, 0, 0
7270, 1, 1636422563873, 1636422564142, 269, 0, 269, 0, 0, 0
7273, 1, 1636422564009, 1636422564278, 269, 1, 268, 0, 0, 0
7274, 1, 1636422564241, 1636422564509, 268, 1, 267, 0, 0, 0
7275, 1, 1636422564273, 1636422564537, 264, 1, 263, 0, 1, 1
7276, 1, 1636422564402, 1636422564666, 264, 0, 264, 0, 0, 0
7277, 1, 1636422564553, 1636422564817, 264, 0, 264, 0, 0, 0
7278, 1, 1636422564605, 1636422564869, 264, 0, 264, 0, 0, 0
7279, 1, 1636422564641, 1636422564905, 264, 1, 263, 0, 1, 1
7280, 1, 1636422564822, 1636422565085, 263, 0, 263, 0, 0, 0
7281, 1, 1636422565037, 1636422565301, 264, 0, 264, 0, 0, 0
7282, 1, 1636422565053, 1636422565322, 269, 0, 269, 0, 0, 0
7283, 1, 1636422565178, 1636422565445, 267, 0, 267, 0, 0, 0
7284, 1, 1636422565362, 1636422565626, 264, 0, 264, 0, 0, 0
7285, 1, 1636422565425, 1636422565689, 264, 1, 263, 0, 0, 0
7286, 1, 1636422565453, 1636422565718, 265, 1, 264, 0, 0, 0
7287, 1, 1636422565605, 1636422565873, 268, 0, 268, 0, 0, 0
7288, 1, 1636422565825, 1636422566089, 264, 0, 264, 0, 0, 0
7289, 1, 1636422565869, 1636422566142, 273, 1, 272, 0, 0, 0
7290, 1, 1636422565981, 1636422566245, 264, 1, 263, 0, 1, 1
7291, 1, 1636422566053, 1636422566318, 265, 1, 264, 0, 1, 1
7292, 1, 1636422566153, 1636422566418, 265, 0, 265, 0, 0, 0
7293, 1, 1636422566217, 1636422566481, 264, 1, 263, 0, 0, 0
7294, 1, 1636422566245, 1636422566510, 265, 1, 264, 0, 0, 0
7295, 1, 1636422566397, 1636422566662, 265, 1, 264, 0, 0, 0
7297, 1, 1636422566629, 1636422566898, 269, 1, 268, 0, 0, 0
7296, 1, 1636422566662, 1636422566945, 283, 0, 283, 0, 0, 0
7298, 1, 1636422566638, 1636422566945, 307, 0, 307, 0, 0, 0
7299, 1, 1636422566769, 1636422567030, 261, 0, 261, 0, 0, 0
7300, 1, 1636422566793, 1636422567061, 268, 1, 267, 0, 1, 1
7301, 1, 1636422566989, 1636422567249, 260, 0, 260, 0, 0, 0
7302, 1, 1636422566997, 1636422567261, 264, 0, 264, 0, 0, 0
7303, 1, 1636422567054, 1636422567318, 264, 0, 264, 0, 0, 0
7305, 1, 1636422567197, 1636422567466, 269, 1, 268, 0, 0, 0
7304, 1, 1636422567209, 1636422567473, 264, 0, 264, 0, 0, 0
7306, 1, 1636422567374, 1636422567637, 263, 0, 263, 0, 0, 0
7308, 1, 1636422567465, 1636422567737, 272, 1, 271, 0, 0, 0
7307, 1, 1636422567465, 1636422567741, 276, 1, 275, 0, 0, 0
7309, 1, 1636422567577, 1636422567837, 260, 0, 260, 0, 0, 0
7310, 1, 1636422567653, 1636422567918, 265, 0, 265, 0, 0, 0
7311, 1, 1636422567737, 1636422568005, 268, 1, 267, 0, 1, 1
7312, 1, 1636422567789, 1636422568049, 260, 0, 260, 0, 0, 0
7313, 1, 1636422567785, 1636422568053, 268, 0, 268, 0, 0, 0
7315, 1, 1636422567941, 1636422568205, 264, 0, 264, 0, 0, 0
7317, 1, 1636422567997, 1636422568261, 264, 0, 264, 0, 0, 0
7316, 1, 1636422568009, 1636422568281, 272, 1, 271, 0, 0, 0
7314, 1, 1636422568009, 1636422568282, 273, 0, 273, 0, 0, 0
7318, 1, 1636422568189, 1636422568453, 264, 1, 263, 0, 0, 0
7319, 1, 1636422568241, 1636422568505, 264, 0, 264, 0, 0, 0
7320, 1, 1636422568245, 1636422568505, 260, 0, 260, 0, 0, 0
7321, 1, 1636422568357, 1636422568621, 264, 0, 264, 0, 0, 0
7322, 1, 1636422568397, 1636422568661, 264, 1, 263, 0, 1, 1
7323, 1, 1636422568437, 1636422568705, 268, 1, 267, 1, 0, 1
7324, 1, 1636422568550, 1636422568813, 263, 0, 263, 0, 0, 0
7325, 1, 1636422568597, 1636422568861, 264, 1, 263, 0, 0, 0
7327, 1, 1636422568749, 1636422569013, 264, 0, 264, 0, 0, 0
7329, 1, 1636422568785, 1636422569049, 264, 1, 263, 0, 0, 0
7330, 1, 1636422568977, 1636422569245, 268, 1, 267, 0, 1, 1
7331, 1, 1636422569041, 1636422569309, 268, 0, 268, 0, 0, 0
7332, 1, 1636422569053, 1636422569326, 273, 0, 273, 0, 0, 0
7334, 1, 1636422569158, 1636422569422, 264, 0, 264, 0, 0, 0
7333, 1, 1636422569198, 1636422569465, 267, 0, 267, 0, 0, 0
7337, 1, 1636422569381, 1636422569646, 265, 0, 265, 0, 0, 0
7338, 1, 1636422569390, 1636422569654, 264, 0, 264, 0, 0, 0
7339, 1, 1636422569537, 1636422569801, 264, 0, 264, 0, 0, 0
7340, 1, 1636422569629, 1636422569898, 269, 0, 269, 0, 0, 0
7341, 1, 1636422569765, 1636422570034, 269, 0, 269, 0, 0, 0
7343, 1, 1636422569841, 1636422570102, 261, 0, 261, 0, 0, 0
7344, 1, 1636422569885, 1636422570149, 264, 0, 264, 0, 0, 0
7345, 1, 1636422569901, 1636422570169, 268, 0, 268, 0, 0, 0
7346, 1, 1636422569933, 1636422570210, 277, 0, 277, 0, 0, 0
7347, 1, 1636422570185, 1636422570453, 268, 0, 268, 0, 0, 0
7348, 1, 1636422570194, 1636422570457, 263, 0, 263, 0, 0, 0
7349, 1, 1636422570321, 1636422570589, 268, 0, 268, 0, 0, 0
7350, 1, 1636422570389, 1636422570653, 264, 0, 264, 0, 0, 0
7351, 1, 1636422570557, 1636422570822, 265, 1, 264, 1, 0, 1
7352, 1, 1636422570609, 1636422570874, 265, 0, 265, 0, 0, 0
7353, 1, 1636422570629, 1636422570893, 264, 1, 263, 0, 0, 0
7354, 1, 1636422570690, 1636422570953, 263, 0, 263, 0, 0, 0
7355, 1, 1636422570745, 1636422571014, 269, 1, 268, 0, 0, 0
7356, 1, 1636422570981, 1636422571245, 264, 0, 264, 0, 0, 0
7357, 1, 1636422570989, 1636422571253, 264, 0, 264, 0, 0, 0
7358, 1, 1636422571113, 1636422571378, 265, 0, 265, 0, 0, 0
7359, 1, 1636422571169, 1636422571438, 269, 1, 268, 1, 0, 1
7360, 1, 1636422571374, 1636422571637, 263, 0, 263, 0, 0, 0
7362, 1, 1636422571429, 1636422571697, 268, 0, 268, 0, 0, 0
7363, 1, 1636422571490, 1636422571753, 263, 0, 263, 0, 0, 0
7364, 1, 1636422571545, 1636422571809, 264, 1, 263, 0, 0, 0
7365, 1, 1636422571781, 1636422572045, 264, 1, 263, 0, 0, 0
7366, 1, 1636422571793, 1636422572065, 272, 0, 272, 0, 0, 0
7367, 1, 1636422571897, 1636422572162, 265, 1, 264, 0, 0, 0
7368, 1, 1636422571973, 1636422572237, 264, 0, 264, 0, 0, 0
7369, 1, 1636422572157, 1636422572421, 264, 1, 263, 0, 0, 0
7370, 1, 1636422572230, 1636422572493, 263, 0, 263, 0, 0, 0
7371, 1, 1636422572285, 1636422572549, 264, 1, 263, 0, 0, 0
7372, 1, 1636422572358, 1636422572625, 267, 0, 267, 0, 0, 0
7374, 1, 1636422572593, 1636422572889, 296, 0, 296, 0, 0, 0
7375, 1, 1636422572717, 1636422572985, 268, 0, 268, 0, 0, 0
7376, 1, 1636422572805, 1636422573074, 269, 0, 269, 0, 0, 0
7377, 1, 1636422572978, 1636422573241, 263, 0, 263, 0, 0, 0
7379, 1, 1636422573029, 1636422573301, 272, 0, 272, 0, 0, 0
7380, 1, 1636422573069, 1636422573369, 300, 1, 299, 0, 0, 0
7382, 1, 1636422573137, 1636422573417, 280, 1, 279, 0, 1, 1
7381, 1, 1636422573193, 1636422573457, 264, 0, 264, 0, 0, 0
7383, 1, 1636422573417, 1636422573678, 261, 0, 261, 0, 0, 0
7384, 1, 1636422573509, 1636422573773, 264, 0, 264, 0, 0, 0
7385, 1, 1636422573581, 1636422573853, 272, 0, 272, 0, 0, 0
7387, 1, 1636422573678, 1636422573941, 263, 0, 263, 0, 0, 0
7388, 1, 1636422573789, 1636422574057, 268, 1, 267, 0, 0, 0
7391, 1, 1636422573881, 1636422574150, 269, 0, 269, 0, 0, 0
7392, 1, 1636422573933, 1636422574201, 268, 1, 267, 0, 0, 0
7390, 1, 1636422573933, 1636422574201, 268, 1, 267, 1, 0, 1
7389, 1, 1636422573949, 1636422574213, 264, 1, 263, 0, 0, 0
7393, 1, 1636422574013, 1636422574285, 272, 1, 271, 0, 0, 0
7394, 1, 1636422574221, 1636422574490, 269, 0, 269, 0, 0, 0
7395, 1, 1636422574285, 1636422574553, 268, 1, 267, 1, 0, 1
7396, 1, 1636422574321, 1636422574585, 264, 0, 264, 0, 0, 0
7398, 1, 1636422574405, 1636422574669, 264, 0, 264, 0, 0, 0
7399, 1, 1636422574557, 1636422574825, 268, 0, 268, 0, 0, 0
7397, 1, 1636422574553, 1636422574825, 272, 1, 271, 0, 0, 0
7402, 1, 1636422574685, 1636422574953, 268, 1, 267, 0, 0, 0
7403, 1, 1636422574717, 1636422574981, 264, 1, 263, 0, 0, 0
7404, 1, 1636422574741, 1636422575009, 268, 1, 267, 0, 0, 0
7405, 1, 1636422575001, 1636422575266, 265, 0, 265, 0, 0, 0
7406, 1, 1636422575021, 1636422575285, 264, 1, 263, 1, 0, 1
7407, 1, 1636422575113, 1636422575382, 269, 1, 268, 0, 0, 0
7408, 1, 1636422575229, 1636422575493, 264, 1, 263, 0, 0, 0
7410, 1, 1636422575362, 1636422575625, 263, 0, 263, 0, 0, 0
7411, 1, 1636422575485, 1636422575749, 264, 1, 263, 0, 0, 0
7412, 1, 1636422575517, 1636422575781, 264, 1, 263, 0, 1, 1
7413, 1, 1636422575549, 1636422575813, 264, 1, 263, 0, 1, 1
7416, 1, 1636422575906, 1636422576178, 272, 0, 272, 0, 0, 0
7417, 1, 1636422575997, 1636422576262, 265, 1, 264, 0, 0, 0
7418, 1, 1636422576166, 1636422576430, 264, 0, 264, 0, 0, 0
7419, 1, 1636422576289, 1636422576554, 265, 1, 264, 1, 0, 1
7420, 1, 1636422576326, 1636422576589, 263, 0, 263, 0, 0, 0
7421, 1, 1636422576357, 1636422576621, 264, 1, 263, 1, 0, 1
7422, 1, 1636422576709, 1636422576973, 264, 0, 264, 0, 0, 0
7423, 1, 1636422576793, 1636422577058, 265, 0, 265, 0, 0, 0
7424, 1, 1636422576973, 1636422577238, 265, 1, 264, 0, 0, 0
7425, 1, 1636422577105, 1636422577366, 261, 0, 261, 0, 0, 0
7427, 1, 1636422577149, 1636422577413, 264, 0, 264, 0, 0, 0
7428, 1, 1636422577510, 1636422577773, 263, 0, 263, 0, 0, 0
7429, 1, 1636422577578, 1636422577846, 268, 0, 268, 0, 0, 0
7430, 1, 1636422577773, 1636422578037, 264, 0, 264, 0, 0, 0
7431, 1, 1636422577901, 1636422578166, 265, 1, 264, 0, 0, 0
7433, 1, 1636422578322, 1636422578586, 264, 0, 264, 0, 0, 0
7434, 1, 1636422578373, 1636422578638, 265, 1, 264, 0, 1, 1
7436, 1, 1636422578742, 1636422579005, 263, 0, 263, 0, 0, 0
7438, 1, 1636422579057, 1636422579321, 264, 1, 263, 1, 0, 1
7437, 1, 1636422579057, 1636422579325, 268, 1, 267, 0, 0, 0
7439, 1, 1636422579150, 1636422579414, 264, 0, 264, 0, 0, 0
7440, 1, 1636422579214, 1636422579477, 263, 0, 263, 0, 0, 0
7442, 1, 1636422579517, 1636422579781, 264, 1, 263, 0, 0, 0
7441, 1, 1636422579517, 1636422579781, 264, 0, 264, 0, 0, 0
7443, 1, 1636422579557, 1636422579825, 268, 1, 267, 0, 0, 0
7444, 1, 1636422579729, 1636422579997, 268, 0, 268, 0, 0, 0
7447, 1, 1636422579981, 1636422580249, 268, 1, 267, 0, 1, 1
7445, 1, 1636422580005, 1636422580265, 260, 0, 260, 0, 0, 0
7448, 1, 1636422580150, 1636422580413, 263, 0, 263, 0, 0, 0
7449, 1, 1636422580274, 1636422580538, 264, 0, 264, 0, 0, 0
7451, 1, 1636422580294, 1636422580558, 264, 0, 264, 0, 0, 0
7452, 1, 1636422580513, 1636422580777, 264, 1, 263, 0, 0, 0
7450, 1, 1636422580541, 1636422580805, 264, 0, 264, 0, 0, 0
7453, 1, 1636422580665, 1636422580930, 265, 0, 265, 0, 0, 0
7454, 1, 1636422580789, 1636422581057, 268, 0, 268, 0, 0, 0
7455, 1, 1636422580853, 1636422581117, 264, 1, 263, 0, 0, 0
7456, 1, 1636422581025, 1636422581289, 264, 1, 263, 0, 0, 0
7457, 1, 1636422581098, 1636422581365, 267, 0, 267, 0, 0, 0
7458, 1, 1636422581214, 1636422581481, 267, 0, 267, 0, 0, 0
7459, 1, 1636422581310, 1636422581578, 268, 0, 268, 0, 0, 0
7460, 1, 1636422581413, 1636422581685, 272, 0, 272, 0, 0, 0
7461, 1, 1636422581590, 1636422581854, 264, 0, 264, 0, 0, 0
7462, 1, 1636422581637, 1636422581901, 264, 0, 264, 0, 0, 0
7463, 1, 1636422581730, 1636422581993, 263, 0, 263, 0, 0, 0
7464, 1, 1636422581822, 1636422582085, 263, 0, 263, 0, 0, 0
7465, 1, 1636422581886, 1636422582149, 263, 0, 263, 0, 0, 0
7466, 1, 1636422581969, 1636422582233, 264, 1, 263, 0, 0, 0
7467, 1, 1636422582122, 1636422582385, 263, 0, 263, 0, 0, 0
7469, 1, 1636422582385, 1636422582650, 265, 0, 265, 0, 0, 0
7470, 1, 1636422582441, 1636422582701, 260, 0, 260, 0, 0, 0
7471, 1, 1636422582461, 1636422582725, 264, 1, 263, 0, 0, 0
7472, 1, 1636422582673, 1636422582941, 268, 0, 268, 0, 0, 0
7473, 1, 1636422582714, 1636422582978, 264, 0, 264, 0, 0, 0
7475, 1, 1636422582913, 1636422583178, 265, 1, 264, 1, 0, 1
7476, 1, 1636422582913, 1636422583178, 265, 1, 264, 0, 1, 1
7477, 1, 1636422583189, 1636422583453, 264, 0, 264, 0, 0, 0
7478, 1, 1636422583233, 1636422583501, 268, 0, 268, 0, 0, 0
7479, 1, 1636422583277, 1636422583542, 265, 0, 265, 0, 0, 0
7480, 1, 1636422583354, 1636422583621, 267, 0, 267, 0, 0, 0
7481, 1, 1636422583429, 1636422583698, 269, 0, 269, 0, 0, 0
7482, 1, 1636422583505, 1636422583765, 260, 0, 260, 0, 0, 0
7483, 1, 1636422583602, 1636422583870, 268, 0, 268, 0, 0, 0
7484, 1, 1636422583729, 1636422583993, 264, 1, 263, 0, 0, 0
7485, 1, 1636422583945, 1636422584213, 268, 0, 268, 0, 0, 0
7486, 1, 1636422584009, 1636422584278, 269, 0, 269, 0, 0, 0
7487, 1, 1636422584021, 1636422584289, 268, 1, 267, 0, 1, 1
7488, 1, 1636422584057, 1636422584322, 265, 0, 265, 0, 0, 0
7489, 1, 1636422584061, 1636422584325, 264, 0, 264, 0, 0, 0
7490, 1, 1636422584241, 1636422584505, 264, 1, 263, 0, 0, 0
7491, 1, 1636422584258, 1636422584521, 263, 0, 263, 0, 0, 0
7492, 1, 1636422584381, 1636422584669, 288, 1, 287, 0, 0, 0
7493, 1, 1636422584541, 1636422584805, 264, 0, 264, 0, 0, 0
7494, 1, 1636422584673, 1636422584941, 268, 0, 268, 0, 0, 0
7495, 1, 1636422584809, 1636422585080, 271, 0, 271, 0, 0, 0
7496, 1, 1636422584841, 1636422585101, 260, 0, 260, 0, 0, 0
7497, 1, 1636422584849, 1636422585121, 272, 1, 271, 0, 1, 1
7498, 1, 1636422584873, 1636422585137, 264, 1, 263, 0, 0, 0
7499, 1, 1636422584945, 1636422585210, 265, 0, 265, 0, 0, 0
7500, 1, 1636422584977, 1636422585261, 284, 0, 284, 0, 0, 0
7502, 1, 1636422585085, 1636422585350, 265, 0, 265, 0, 0, 0
7501, 1, 1636422585085, 1636422585357, 272, 0, 272, 0, 0, 0
7503, 1, 1636422585181, 1636422585445, 264, 1, 263, 0, 0, 0
7504, 1, 1636422585309, 1636422585573, 264, 0, 264, 0, 0, 0
7505, 1, 1636422585481, 1636422585749, 268, 1, 267, 0, 1, 1
7506, 1, 1636422585533, 1636422585801, 268, 0, 268, 0, 0, 0
7507, 1, 1636422585617, 1636422585905, 288, 1, 287, 0, 0, 0
7510, 1, 1636422585729, 1636422585993, 264, 1, 263, 0, 0, 0
7511, 1, 1636422585729, 1636422585993, 264, 1, 263, 1, 0, 1
7508, 1, 1636422585729, 1636422585997, 268, 1, 267, 0, 0, 0
7509, 1, 1636422585729, 1636422585997, 268, 1, 267, 1, 0, 1
7513, 1, 1636422585909, 1636422586177, 268, 1, 267, 0, 0, 0
7514, 1, 1636422585917, 1636422586185, 268, 0, 268, 0, 0, 0
7515, 1, 1636422586001, 1636422586261, 260, 0, 260, 0, 0, 0
7512, 1, 1636422586001, 1636422586265, 264, 0, 264, 0, 0, 0
7516, 1, 1636422586129, 1636422586393, 264, 1, 263, 0, 1, 1
7518, 1, 1636422586133, 1636422586397, 264, 1, 263, 1, 0, 1
7517, 1, 1636422586133, 1636422586397, 264, 1, 263, 0, 1, 1
7519, 1, 1636422586273, 1636422586537, 264, 0, 264, 0, 0, 0
7520, 1, 1636422586273, 1636422586537, 264, 0, 264, 0, 0, 0
7521, 1, 1636422586397, 1636422586661, 264, 0, 264, 0, 0, 0
7523, 1, 1636422586441, 1636422586709, 268, 1, 267, 0, 1, 1
7522, 1, 1636422586441, 1636422586709, 268, 1, 267, 1, 0, 1
7524, 1, 1636422586449, 1636422586713, 264, 0, 264, 0, 0, 0
7527, 1, 1636422586641, 1636422586905, 264, 0, 264, 0, 0, 0
7526, 1, 1636422586673, 1636422586937, 264, 0, 264, 0, 0, 0
7525, 1, 1636422586717, 1636422586977, 260, 0, 260, 0, 0, 0
7529, 1, 1636422586785, 1636422587049, 264, 1, 263, 0, 1, 1
7530, 1, 1636422586846, 1636422587149, 303, 0, 303, 0, 0, 0
7532, 1, 1636422586977, 1636422587245, 268, 1, 267, 0, 0, 0
7533, 1, 1636422587065, 1636422587333, 268, 0, 268, 0, 0, 0
7534, 1, 1636422587081, 1636422587345, 264, 0, 264, 0, 0, 0
7531, 1, 1636422587157, 1636422587421, 264, 0, 264, 0, 0, 0
7535, 1, 1636422587197, 1636422587461, 264, 0, 264, 0, 0, 0
7537, 1, 1636422587249, 1636422587509, 260, 0, 260, 0, 0, 0
7536, 1, 1636422587245, 1636422587509, 264, 0, 264, 0, 0, 0
7538, 1, 1636422587257, 1636422587517, 260, 0, 260, 0, 0, 0
7539, 1, 1636422587381, 1636422587641, 260, 0, 260, 0, 0, 0
7541, 1, 1636422587421, 1636422587689, 268, 1, 267, 0, 0, 0
7540, 1, 1636422587421, 1636422587689, 268, 1, 267, 0, 0, 0
7542, 1, 1636422587461, 1636422587721, 260, 0, 260, 0, 0, 0
7543, 1, 1636422587598, 1636422587865, 267, 0, 267, 0, 0, 0
7544, 1, 1636422587637, 1636422587901, 264, 1, 263, 0, 0, 0
7545, 1, 1636422587741, 1636422588009, 268, 0, 268, 0, 0, 0
7546, 1, 1636422587825, 1636422588085, 260, 0, 260, 0, 0, 0
7547, 1, 1636422587837, 1636422588105, 268, 0, 268, 0, 0, 0
7548, 1, 1636422587901, 1636422588165, 264, 1, 263, 0, 1, 1
7549, 1, 1636422587993, 1636422588261, 268, 1, 267, 0, 0, 0
7552, 1, 1636422588041, 1636422588309, 268, 0, 268, 0, 0, 0
7550, 1, 1636422588077, 1636422588345, 268, 1, 267, 0, 0, 0
7551, 1, 1636422588081, 1636422588353, 272, 0, 272, 0, 0, 0
7553, 1, 1636422588129, 1636422588393, 264, 0, 264, 0, 0, 0
7554, 1, 1636422588149, 1636422588414, 265, 1, 264, 0, 1, 1
7557, 1, 1636422588253, 1636422588521, 268, 1, 267, 0, 0, 0
7555, 1, 1636422588253, 1636422588521, 268, 1, 267, 0, 0, 0
7559, 1, 1636422588433, 1636422588697, 264, 1, 263, 0, 0, 0
7558, 1, 1636422588433, 1636422588697, 264, 0, 264, 0, 0, 0
7560, 1, 1636422588557, 1636422588825, 268, 1, 267, 0, 0, 0
7561, 1, 1636422588617, 1636422588881, 264, 0, 264, 0, 0, 0
7562, 1, 1636422588661, 1636422588921, 260, 0, 260, 0, 0, 0
7563, 1, 1636422588701, 1636422588965, 264, 0, 264, 0, 0, 0
7564, 1, 1636422588769, 1636422589038, 269, 1, 268, 0, 0, 0
7566, 1, 1636422588833, 1636422589097, 264, 0, 264, 0, 0, 0
7567, 1, 1636422588841, 1636422589109, 268, 0, 268, 0, 0, 0
7568, 1, 1636422588865, 1636422589129, 264, 1, 263, 0, 0, 0
7565, 1, 1636422588881, 1636422589141, 260, 0, 260, 0, 0, 0
7570, 1, 1636422588949, 1636422589213, 264, 1, 263, 0, 0, 0
7571, 1, 1636422588957, 1636422589225, 268, 1, 267, 0, 0, 0
7572, 1, 1636422589069, 1636422589341, 272, 0, 272, 0, 0, 0
7573, 1, 1636422589189, 1636422589453, 264, 0, 264, 0, 0, 0
7574, 1, 1636422589245, 1636422589510, 265, 1, 264, 0, 0, 0
7575, 1, 1636422589353, 1636422589625, 272, 1, 271, 1, 0, 1
7577, 1, 1636422589441, 1636422589701, 260, 0, 260, 0, 0, 0
7578, 1, 1636422589485, 1636422589753, 268, 0, 268, 0, 0, 0
7579, 1, 1636422589561, 1636422589829, 268, 0, 268, 0, 0, 0
7580, 1, 1636422589585, 1636422589845, 260, 0, 260, 0, 0, 0
7581, 1, 1636422589621, 1636422589893, 272, 1, 271, 0, 0, 0
7582, 1, 1636422589653, 1636422589917, 264, 1, 263, 0, 1, 1
7583, 1, 1636422589677, 1636422589973, 296, 1, 295, 0, 0, 0
7584, 1, 1636422589793, 1636422590057, 264, 1, 263, 1, 0, 1
7585, 1, 1636422589793, 1636422590057, 264, 1, 263, 0, 1, 1
7586, 1, 1636422589885, 1636422590153, 268, 0, 268, 0, 0, 0
7587, 1, 1636422590017, 1636422590278, 261, 0, 261, 0, 0, 0
7588, 1, 1636422590061, 1636422590325, 264, 0, 264, 0, 0, 0
7589, 1, 1636422590145, 1636422590409, 264, 1, 263, 0, 1, 1
7590, 1, 1636422590237, 1636422590501, 264, 0, 264, 0, 0, 0
7591, 1, 1636422590245, 1636422590513, 268, 1, 267, 0, 0, 0
7592, 1, 1636422590289, 1636422590553, 264, 1, 263, 0, 0, 0
7593, 1, 1636422590349, 1636422590613, 264, 1, 263, 0, 0, 0
7594, 1, 1636422590369, 1636422590633, 264, 0, 264, 0, 0, 0
7595, 1, 1636422590425, 1636422590685, 260, 0, 260, 0, 0, 0
7596, 1, 1636422590453, 1636422590721, 268, 1, 267, 0, 1, 1
7597, 1, 1636422590469, 1636422590733, 264, 0, 264, 0, 0, 0
7598, 1, 1636422590545, 1636422590809, 264, 0, 264, 0, 0, 0
7599, 1, 1636422590569, 1636422590841, 272, 1, 271, 0, 1, 1
7600, 1, 1636422590657, 1636422590929, 272, 1, 271, 0, 0, 0
7601, 1, 1636422590805, 1636422591069, 264, 1, 263, 0, 0, 0
7602, 1, 1636422590837, 1636422591102, 265, 0, 265, 0, 0, 0
7603, 1, 1636422590941, 1636422591205, 264, 1, 263, 0, 0, 0
7604, 1, 1636422590945, 1636422591209, 264, 1, 263, 0, 1, 1
7605, 1, 1636422591029, 1636422591289, 260, 0, 260, 0, 0, 0
7606, 1, 1636422591081, 1636422591341, 260, 0, 260, 0, 0, 0
7607, 1, 1636422591141, 1636422591405, 264, 1, 263, 0, 1, 1
7608, 1, 1636422591165, 1636422591429, 264, 0, 264, 0, 0, 0
7609, 1, 1636422591229, 1636422591497, 268, 0, 268, 0, 0, 0
7611, 1, 1636422591249, 1636422591521, 272, 0, 272, 0, 0, 0
7610, 1, 1636422591249, 1636422591521, 272, 1, 271, 0, 0, 0
7612, 1, 1636422591357, 1636422591625, 268, 1, 267, 0, 0, 0
7613, 1, 1636422591381, 1636422591649, 268, 0, 268, 0, 0, 0
7614, 1, 1636422591441, 1636422591713, 272, 0, 272, 0, 0, 0
7615, 1, 1636422591601, 1636422591861, 260, 0, 260, 0, 0, 0
7616, 1, 1636422591641, 1636422591909, 268, 1, 267, 0, 1, 1
7617, 1, 1636422591717, 1636422591985, 268, 1, 267, 0, 1, 1
7618, 1, 1636422591729, 1636422591997, 268, 1, 267, 0, 0, 0
7619, 1, 1636422591845, 1636422592105, 260, 0, 260, 0, 0, 0
7620, 1, 1636422591885, 1636422592150, 265, 0, 265, 0, 0, 0
7621, 1, 1636422591933, 1636422592245, 312, 0, 312, 0, 0, 0
7622, 1, 1636422591993, 1636422592257, 264, 1, 263, 0, 0, 0
7624, 1, 1636422592069, 1636422592333, 264, 1, 263, 1, 0, 1
7625, 1, 1636422592073, 1636422592334, 261, 0, 261, 0, 0, 0
7623, 1, 1636422592069, 1636422592333, 264, 1, 263, 0, 1, 1
7626, 1, 1636422592157, 1636422592425, 268, 1, 267, 0, 1, 1
7627, 1, 1636422592193, 1636422592457, 264, 1, 263, 0, 1, 1
7628, 1, 1636422592249, 1636422592513, 264, 0, 264, 0, 0, 0
7629, 1, 1636422592410, 1636422592673, 263, 0, 263, 0, 0, 0
7630, 1, 1636422592433, 1636422592701, 268, 0, 268, 0, 0, 0
7634, 1, 1636422592629, 1636422592893, 264, 0, 264, 0, 0, 0
7636, 1, 1636422592729, 1636422592997, 268, 0, 268, 0, 0, 0
7637, 1, 1636422592798, 1636422593065, 267, 0, 267, 0, 0, 0
7638, 1, 1636422592845, 1636422593113, 268, 0, 268, 0, 0, 0
7640, 1, 1636422592885, 1636422593149, 264, 1, 263, 0, 0, 0
7639, 1, 1636422592885, 1636422593158, 273, 1, 272, 0, 0, 0
7641, 1, 1636422592961, 1636422593229, 268, 0, 268, 0, 0, 0
7642, 1, 1636422593001, 1636422593265, 264, 1, 263, 0, 0, 0
7645, 1, 1636422593205, 1636422593469, 264, 0, 264, 0, 0, 0
7646, 1, 1636422593237, 1636422593501, 264, 1, 263, 0, 0, 0
7647, 1, 1636422593417, 1636422593686, 269, 1, 268, 0, 1, 1
7649, 1, 1636422593585, 1636422593850, 265, 1, 264, 0, 1, 1
7652, 1, 1636422593661, 1636422593925, 264, 1, 263, 0, 1, 1
7653, 1, 1636422593762, 1636422594025, 263, 0, 263, 0, 0, 0
7654, 1, 1636422593789, 1636422594053, 264, 1, 263, 0, 0, 0
7655, 1, 1636422593989, 1636422594253, 264, 1, 263, 0, 0, 0
7656, 1, 1636422594057, 1636422594321, 264, 1, 263, 0, 0, 0
7657, 1, 1636422594221, 1636422594486, 265, 1, 264, 1, 0, 1
7658, 1, 1636422594381, 1636422594646, 265, 1, 264, 0, 1, 1
7659, 1, 1636422594477, 1636422594746, 269, 1, 268, 0, 0, 0
7660, 1, 1636422594561, 1636422594825, 264, 1, 263, 0, 0, 0
7661, 1, 1636422594578, 1636422594846, 268, 0, 268, 0, 0, 0
7662, 1, 1636422594774, 1636422595045, 271, 0, 271, 0, 0, 0
7663, 1, 1636422594853, 1636422595118, 265, 1, 264, 0, 0, 0
7664, 1, 1636422595018, 1636422595285, 267, 0, 267, 0, 0, 0
7665, 1, 1636422595170, 1636422595434, 264, 0, 264, 0, 0, 0
7666, 1, 1636422595270, 1636422595533, 263, 0, 263, 0, 0, 0
7667, 1, 1636422595361, 1636422595630, 269, 1, 268, 0, 1, 1
7669, 1, 1636422595557, 1636422595825, 268, 1, 267, 0, 0, 0
7670, 1, 1636422595670, 1636422595933, 263, 0, 263, 0, 0, 0
7671, 1, 1636422595829, 1636422596089, 260, 0, 260, 0, 0, 0
7672, 1, 1636422595974, 1636422596237, 263, 0, 263, 0, 0, 0
7673, 1, 1636422596053, 1636422596318, 265, 0, 265, 0, 0, 0
7674, 1, 1636422596178, 1636422596441, 263, 0, 263, 0, 0, 0
7676, 1, 1636422596457, 1636422596722, 265, 1, 264, 0, 1, 1
7677, 1, 1636422596629, 1636422596894, 265, 1, 264, 0, 0, 0
7678, 1, 1636422596793, 1636422597062, 269, 1, 268, 0, 0, 0
7679, 1, 1636422596849, 1636422597113, 264, 1, 263, 0, 0, 0
7680, 1, 1636422596954, 1636422597217, 263, 0, 263, 0, 0, 0
7681, 1, 1636422596978, 1636422597241, 263, 0, 263, 0, 0, 0
7682, 1, 1636422597237, 1636422597501, 264, 1, 263, 1, 0, 1
7684, 1, 1636422597585, 1636422597849, 264, 0, 264, 0, 0, 0
7685, 1, 1636422597629, 1636422597897, 268, 0, 268, 0, 0, 0
7686, 1, 1636422597673, 1636422597938, 265, 1, 264, 0, 0, 0
7687, 1, 1636422597794, 1636422598058, 264, 0, 264, 0, 0, 0
7688, 1, 1636422598034, 1636422598302, 268, 0, 268, 0, 0, 0
7689, 1, 1636422598402, 1636422598666, 264, 0, 264, 0, 0, 0
7691, 1, 1636422598465, 1636422598730, 265, 1, 264, 0, 0, 0
7693, 1, 1636422598581, 1636422598845, 264, 1, 263, 0, 0, 0
7694, 1, 1636422598825, 1636422599093, 268, 0, 268, 0, 0, 0
7695, 1, 1636422599233, 1636422599505, 272, 0, 272, 0, 0, 0
7696, 1, 1636422599242, 1636422599509, 267, 0, 267, 0, 0, 0
7697, 1, 1636422599265, 1636422599530, 265, 1, 264, 0, 1, 1
7698, 1, 1636422599366, 1636422599630, 264, 0, 264, 0, 0, 0
7701, 1, 1636422599966, 1636422600233, 267, 0, 267, 0, 0, 0
7702, 1, 1636422599993, 1636422600258, 265, 1, 264, 0, 1, 1
7703, 1, 1636422600077, 1636422600346, 269, 1, 268, 0, 1, 1
7704, 1, 1636422600158, 1636422600422, 264, 0, 264, 0, 0, 0
7705, 1, 1636422600770, 1636422601034, 264, 0, 264, 0, 0, 0
7706, 1, 1636422600789, 1636422601053, 264, 1, 263, 1, 0, 1
7707, 1, 1636422600874, 1636422601137, 263, 0, 263, 0, 0, 0
7708, 1, 1636422600950, 1636422601214, 264, 0, 264, 0, 0, 0
7709, 1, 1636422601557, 1636422601822, 265, 1, 264, 0, 0, 0
7710, 1, 1636422601578, 1636422601842, 264, 0, 264, 0, 0, 0
7711, 1, 1636422601670, 1636422601934, 264, 0, 264, 0, 0, 0
7713, 1, 1636422602465, 1636422602729, 264, 0, 264, 0, 0, 0
7715, 1, 1636422602553, 1636422602814, 261, 0, 261, 0, 0, 0
7716, 1, 1636422602937, 1636422603201, 264, 1, 263, 1, 0, 1
7717, 1, 1636422602937, 1636422603201, 264, 1, 263, 0, 0, 0
7718, 1, 1636422602937, 1636422603217, 280, 1, 279, 0, 0, 0
7719, 1, 1636422603029, 1636422603289, 260, 0, 260, 0, 0, 0
7720, 1, 1636422603169, 1636422603429, 260, 0, 260, 0, 0, 0
7721, 1, 1636422603269, 1636422603570, 301, 1, 300, 0, 1, 1
7722, 1, 1636422603338, 1636422603693, 355, 0, 355, 0, 0, 0
7723, 1, 1636422603393, 1636422603693, 300, 1, 299, 0, 0, 0
7725, 1, 1636422603697, 1636422603957, 260, 0, 260, 0, 0, 0
7724, 1, 1636422603701, 1636422603965, 264, 0, 264, 0, 0, 0
7726, 1, 1636422603701, 1636422603969, 268, 1, 267, 0, 0, 0
7727, 1, 1636422603793, 1636422604057, 264, 1, 263, 0, 0, 0
7729, 1, 1636422603913, 1636422604173, 260, 0, 260, 0, 0, 0
7728, 1, 1636422603909, 1636422604177, 268, 1, 267, 0, 0, 0
7730, 1, 1636422603941, 1636422604205, 264, 0, 264, 0, 0, 0
7731, 1, 1636422603957, 1636422604221, 264, 1, 263, 0, 0, 0
7733, 1, 1636422604073, 1636422604337, 264, 1, 263, 0, 0, 0
7732, 1, 1636422604098, 1636422604361, 263, 0, 263, 0, 0, 0
7734, 1, 1636422604125, 1636422604393, 268, 0, 268, 0, 0, 0
7736, 1, 1636422604373, 1636422604641, 268, 0, 268, 0, 0, 0
7735, 1, 1636422604382, 1636422604645, 263, 0, 263, 0, 0, 0
7737, 1, 1636422604389, 1636422604654, 265, 0, 265, 0, 0, 0
7738, 1, 1636422604497, 1636422604762, 265, 1, 264, 0, 0, 0
7739, 1, 1636422604633, 1636422604897, 264, 0, 264, 0, 0, 0
7740, 1, 1636422604637, 1636422604901, 264, 0, 264, 0, 0, 0
7741, 1, 1636422604653, 1636422604918, 265, 1, 264, 0, 0, 0
7742, 1, 1636422604753, 1636422605021, 268, 1, 267, 1, 0, 1
7743, 1, 1636422604849, 1636422605113, 264, 0, 264, 0, 0, 0
7744, 1, 1636422604853, 1636422605121, 268, 1, 267, 0, 0, 0
7745, 1, 1636422604889, 1636422605153, 264, 0, 264, 0, 0, 0
7748, 1, 1636422605174, 1636422605437, 263, 0, 263, 0, 0, 0
7747, 1, 1636422605174, 1636422605437, 263, 0, 263, 0, 0, 0
7751, 1, 1636422605421, 1636422605685, 264, 1, 263, 0, 0, 0
7750, 1, 1636422605421, 1636422605685, 264, 1, 263, 0, 0, 0
7753, 1, 1636422605566, 1636422605830, 264, 0, 264, 0, 0, 0
7756, 1, 1636422605677, 1636422605941, 264, 0, 264, 0, 0, 0
7757, 1, 1636422605677, 1636422605941, 264, 0, 264, 0, 0, 0
7754, 1, 1636422605681, 1636422605945, 264, 0, 264, 0, 0, 0
7758, 1, 1636422605982, 1636422606245, 263, 0, 263, 0, 0, 0
7759, 1, 1636422605993, 1636422606258, 265, 1, 264, 0, 1, 1
7761, 1, 1636422606225, 1636422606489, 264, 1, 263, 0, 0, 0
7762, 1, 1636422606353, 1636422606618, 265, 1, 264, 1, 0, 1
7763, 1, 1636422606405, 1636422606673, 268, 1, 267, 0, 0, 0
7764, 1, 1636422606493, 1636422606757, 264, 1, 263, 0, 0, 0
7765, 1, 1636422606493, 1636422606758, 265, 1, 264, 0, 1, 1
7766, 1, 1636422606669, 1636422606934, 265, 0, 265, 0, 0, 0
7767, 1, 1636422606769, 1636422607042, 273, 0, 273, 0, 0, 0
7768, 1, 1636422606786, 1636422607049, 263, 0, 263, 0, 0, 0
7769, 1, 1636422607037, 1636422607301, 264, 1, 263, 1, 0, 1
7770, 1, 1636422607137, 1636422607405, 268, 1, 267, 1, 0, 1
7771, 1, 1636422607213, 1636422607478, 265, 1, 264, 1, 0, 1
7772, 1, 1636422607285, 1636422607549, 264, 1, 263, 1, 0, 1
7773, 1, 1636422607285, 1636422607549, 264, 1, 263, 0, 0, 0
7774, 1, 1636422607377, 1636422607642, 265, 1, 264, 0, 1, 1
7775, 1, 1636422607557, 1636422607821, 264, 1, 263, 0, 1, 1
7776, 1, 1636422607569, 1636422607837, 268, 1, 267, 0, 0, 0
7777, 1, 1636422607729, 1636422607993, 264, 1, 263, 0, 1, 1
7778, 1, 1636422607833, 1636422608097, 264, 0, 264, 0, 0, 0
7779, 1, 1636422607946, 1636422608209, 263, 0, 263, 0, 0, 0
7780, 1, 1636422607997, 1636422608261, 264, 0, 264, 0, 0, 0
7782, 1, 1636422608066, 1636422608329, 263, 0, 263, 0, 0, 0
7781, 1, 1636422608066, 1636422608329, 263, 0, 263, 0, 0, 0
7785, 1, 1636422608389, 1636422608650, 261, 0, 261, 0, 0, 0
7784, 1, 1636422608393, 1636422608657, 264, 0, 264, 0, 0, 0
7786, 1, 1636422608477, 1636422608745, 268, 0, 268, 0, 0, 0
7787, 1, 1636422608653, 1636422608925, 272, 0, 272, 0, 0, 0
7789, 1, 1636422608749, 1636422609009, 260, 0, 260, 0, 0, 0
7788, 1, 1636422608789, 1636422609053, 264, 0, 264, 0, 0, 0
7791, 1, 1636422608805, 1636422609069, 264, 1, 263, 0, 0, 0
7790, 1, 1636422608821, 1636422609085, 264, 1, 263, 0, 1, 1
7792, 1, 1636422608881, 1636422609145, 264, 0, 264, 0, 0, 0
7793, 1, 1636422608893, 1636422609158, 265, 1, 264, 0, 0, 0
7795, 1, 1636422609173, 1636422609437, 264, 1, 263, 0, 0, 0
7794, 1, 1636422609177, 1636422609441, 264, 1, 263, 1, 0, 1
7796, 1, 1636422609233, 1636422609506, 273, 1, 272, 0, 1, 1
7797, 1, 1636422609429, 1636422609713, 284, 0, 284, 0, 0, 0
7798, 1, 1636422609537, 1636422609801, 264, 0, 264, 0, 0, 0
7799, 1, 1636422609582, 1636422609845, 263, 0, 263, 0, 0, 0
7800, 1, 1636422609582, 1636422609845, 263, 0, 263, 0, 0, 0
7802, 1, 1636422609717, 1636422609981, 264, 1, 263, 0, 0, 0
7803, 1, 1636422609725, 1636422609993, 268, 1, 267, 0, 0, 0
7801, 1, 1636422609809, 1636422610074, 265, 0, 265, 0, 0, 0
7804, 1, 1636422609929, 1636422610190, 261, 0, 261, 0, 0, 0
7806, 1, 1636422609973, 1636422610246, 273, 1, 272, 0, 0, 0
7805, 1, 1636422609973, 1636422610246, 273, 1, 272, 1, 0, 1
7807, 1, 1636422609973, 1636422610246, 273, 1, 272, 1, 0, 1
7809, 1, 1636422610229, 1636422610493, 264, 1, 263, 1, 0, 1
7812, 1, 1636422610341, 1636422610602, 261, 0, 261, 0, 0, 0
7811, 1, 1636422610337, 1636422610602, 265, 0, 265, 0, 0, 0
7814, 1, 1636422610485, 1636422610750, 265, 1, 264, 0, 0, 0
7813, 1, 1636422610485, 1636422610750, 265, 1, 264, 0, 0, 0
7815, 1, 1636422610489, 1636422610753, 264, 0, 264, 0, 0, 0
7816, 1, 1636422610638, 1636422610902, 264, 0, 264, 0, 0, 0
7817, 1, 1636422610685, 1636422610949, 264, 1, 263, 0, 0, 0
7819, 1, 1636422610777, 1636422611045, 268, 1, 267, 0, 1, 1
7818, 1, 1636422610777, 1636422611045, 268, 1, 267, 1, 0, 1
7820, 1, 1636422611037, 1636422611310, 273, 0, 273, 0, 0, 0
7821, 1, 1636422611133, 1636422611398, 265, 1, 264, 0, 0, 0
7823, 1, 1636422611242, 1636422611505, 263, 0, 263, 0, 0, 0
7824, 1, 1636422611273, 1636422611542, 269, 0, 269, 0, 0, 0
7825, 1, 1636422611293, 1636422611562, 269, 0, 269, 0, 0, 0
7827, 1, 1636422611497, 1636422611789, 292, 1, 291, 1, 0, 1
7828, 1, 1636422611562, 1636422611825, 263, 0, 263, 0, 0, 0
7830, 1, 1636422611841, 1636422612105, 264, 0, 264, 0, 0, 0
7831, 1, 1636422611945, 1636422612210, 265, 0, 265, 0, 0, 0
7833, 1, 1636422612037, 1636422612301, 264, 1, 263, 0, 0, 0
7832, 1, 1636422612057, 1636422612321, 264, 1, 263, 0, 0, 0
7834, 1, 1636422612237, 1636422612505, 268, 1, 267, 0, 0, 0
7836, 1, 1636422612333, 1636422612605, 272, 0, 272, 0, 0, 0
7837, 1, 1636422612362, 1636422612626, 264, 0, 264, 0, 0, 0
7838, 1, 1636422612625, 1636422612889, 264, 1, 263, 0, 0, 0
7839, 1, 1636422612677, 1636422612941, 264, 1, 263, 1, 0, 1
7840, 1, 1636422612733, 1636422612997, 264, 1, 263, 0, 0, 0
7841, 1, 1636422612769, 1636422613033, 264, 1, 263, 0, 1, 1
7842, 1, 1636422612849, 1636422613117, 268, 0, 268, 0, 0, 0
7843, 1, 1636422612929, 1636422613194, 265, 1, 264, 0, 0, 0
7844, 1, 1636422613105, 1636422613369, 264, 1, 263, 0, 1, 1
7845, 1, 1636422613149, 1636422613413, 264, 0, 264, 0, 0, 0
7846, 1, 1636422613393, 1636422613657, 264, 0, 264, 0, 0, 0
7847, 1, 1636422613433, 1636422613702, 269, 1, 268, 0, 0, 0
7848, 1, 1636422613518, 1636422613781, 263, 0, 263, 0, 0, 0
7850, 1, 1636422613661, 1636422613925, 264, 0, 264, 0, 0, 0
7851, 1, 1636422613685, 1636422613949, 264, 1, 263, 0, 1, 1
7852, 1, 1636422613898, 1636422614166, 268, 0, 268, 0, 0, 0
7853, 1, 1636422613953, 1636422614218, 265, 1, 264, 0, 0, 0
7855, 1, 1636422614234, 1636422614497, 263, 0, 263, 0, 0, 0
7856, 1, 1636422614322, 1636422614586, 264, 0, 264, 0, 0, 0
7858, 1, 1636422614469, 1636422614733, 264, 0, 264, 0, 0, 0
7857, 1, 1636422614466, 1636422614734, 268, 0, 268, 0, 0, 0
7859, 1, 1636422614685, 1636422614953, 268, 1, 267, 0, 0, 0
7860, 1, 1636422614745, 1636422615010, 265, 1, 264, 0, 0, 0
7861, 1, 1636422615038, 1636422615334, 296, 0, 296, 0, 0, 0
7862, 1, 1636422615161, 1636422615429, 268, 0, 268, 0, 0, 0
7864, 1, 1636422615266, 1636422615533, 267, 0, 267, 0, 0, 0
7863, 1, 1636422615341, 1636422615609, 268, 0, 268, 0, 0, 0
7866, 1, 1636422615517, 1636422615781, 264, 1, 263, 0, 0, 0
7865, 1, 1636422615517, 1636422615781, 264, 1, 263, 1, 0, 1
7868, 1, 1636422615646, 1636422615910, 264, 0, 264, 0, 0, 0
7870, 1, 1636422615825, 1636422616089, 264, 1, 263, 0, 0, 0
7872, 1, 1636422615937, 1636422616201, 264, 0, 264, 0, 0, 0
7871, 1, 1636422615961, 1636422616253, 292, 0, 292, 0, 0, 0
7874, 1, 1636422616077, 1636422616342, 265, 1, 264, 0, 1, 1
7873, 1, 1636422616077, 1636422616342, 265, 0, 265, 0, 0, 0
7875, 1, 1636422616193, 1636422616453, 260, 0, 260, 0, 0, 0
7808, 1, 1636422616213, 1636422616477, 264, 0, 264, 0, 0, 0
7877, 1, 1636422616297, 1636422616561, 264, 0, 264, 0, 0, 0
7876, 1, 1636422616341, 1636422616605, 264, 1, 263, 0, 0, 0
7878, 1, 1636422616517, 1636422616777, 260, 0, 260, 0, 0, 0
7879, 1, 1636422616613, 1636422616881, 268, 0, 268, 0, 0, 0
7880, 1, 1636422616674, 1636422616941, 267, 0, 267, 0, 0, 0
7881, 1, 1636422616733, 1636422616997, 264, 1, 263, 0, 1, 1
7883, 1, 1636422616877, 1636422617141, 264, 1, 263, 1, 0, 1
7884, 1, 1636422616885, 1636422617145, 260, 0, 260, 0, 0, 0
7882, 1, 1636422616877, 1636422617145, 268, 1, 267, 1, 0, 1
7886, 1, 1636422617109, 1636422617370, 261, 0, 261, 0, 0, 0
7887, 1, 1636422617133, 1636422617397, 264, 0, 264, 0, 0, 0
7888, 1, 1636422617246, 1636422617517, 271, 0, 271, 0, 0, 0
7889, 1, 1636422617425, 1636422617693, 268, 0, 268, 0, 0, 0
7892, 1, 1636422617649, 1636422617909, 260, 0, 260, 0, 0, 0
7894, 1, 1636422617685, 1636422617949, 264, 1, 263, 0, 0, 0
7893, 1, 1636422617685, 1636422617949, 264, 1, 263, 1, 0, 1
7896, 1, 1636422617917, 1636422618205, 288, 0, 288, 0, 0, 0
7895, 1, 1636422617902, 1636422618205, 303, 0, 303, 0, 0, 0
7897, 1, 1636422618049, 1636422618313, 264, 1, 263, 0, 0, 0
7898, 1, 1636422618258, 1636422618521, 263, 0, 263, 0, 0, 0
7900, 1, 1636422618457, 1636422618725, 268, 0, 268, 0, 0, 0
7901, 1, 1636422618489, 1636422618754, 265, 0, 265, 0, 0, 0
7902, 1, 1636422618493, 1636422618757, 264, 1, 263, 0, 0, 0
7904, 1, 1636422618729, 1636422618997, 268, 1, 267, 0, 0, 0
7905, 1, 1636422618838, 1636422619101, 263, 0, 263, 0, 0, 0
7906, 1, 1636422619033, 1636422619297, 264, 0, 264, 0, 0, 0
7907, 1, 1636422619242, 1636422619506, 264, 0, 264, 0, 0, 0
7910, 1, 1636422619525, 1636422619789, 264, 0, 264, 0, 0, 0
7911, 1, 1636422619646, 1636422619918, 272, 0, 272, 0, 0, 0
7912, 1, 1636422619837, 1636422620106, 269, 1, 268, 0, 0, 0
7913, 1, 1636422620046, 1636422620329, 283, 0, 283, 0, 0, 0
7914, 1, 1636422620334, 1636422620602, 268, 0, 268, 0, 0, 0
7915, 1, 1636422620450, 1636422620717, 267, 0, 267, 0, 0, 0
7917, 1, 1636422620629, 1636422620893, 264, 0, 264, 0, 0, 0
7918, 1, 1636422620853, 1636422621117, 264, 0, 264, 0, 0, 0
7919, 1, 1636422621117, 1636422621377, 260, 0, 260, 0, 0, 0
7920, 1, 1636422621305, 1636422621613, 308, 1, 307, 0, 0, 0
7922, 1, 1636422621437, 1636422621697, 260, 0, 260, 0, 0, 0
7921, 1, 1636422621481, 1636422621742, 261, 0, 261, 0, 0, 0
7923, 1, 1636422621661, 1636422621925, 264, 0, 264, 0, 0, 0
7925, 1, 1636422621877, 1636422622141, 264, 0, 264, 0, 0, 0
7926, 1, 1636422621953, 1636422622213, 260, 0, 260, 0, 0, 0
7927, 1, 1636422622045, 1636422622310, 265, 0, 265, 0, 0, 0
7928, 1, 1636422622177, 1636422622441, 264, 1, 263, 0, 0, 0
7929, 1, 1636422622233, 1636422622501, 268, 1, 267, 0, 1, 1
7930, 1, 1636422622398, 1636422622661, 263, 0, 263, 0, 0, 0
7931, 1, 1636422622457, 1636422622725, 268, 1, 267, 0, 0, 0
7932, 1, 1636422622586, 1636422622849, 263, 0, 263, 0, 0, 0
7933, 1, 1636422622718, 1636422622981, 263, 0, 263, 0, 0, 0
7935, 1, 1636422622954, 1636422623217, 263, 0, 263, 0, 0, 0
7934, 1, 1636422622989, 1636422623253, 264, 1, 263, 1, 0, 1
7936, 1, 1636422623022, 1636422623290, 268, 0, 268, 0, 0, 0
7937, 1, 1636422623109, 1636422623378, 269, 1, 268, 0, 0, 0
7938, 1, 1636422623269, 1636422623534, 265, 0, 265, 0, 0, 0
7939, 1, 1636422623373, 1636422623637, 264, 1, 263, 0, 0, 0
7940, 1, 1636422623521, 1636422623790, 269, 0, 269, 0, 0, 0
7941, 1, 1636422623653, 1636422623918, 265, 1, 264, 1, 0, 1
7942, 1, 1636422623746, 1636422624009, 263, 0, 263, 0, 0, 0
7944, 1, 1636422623830, 1636422624093, 263, 0, 263, 0, 0, 0
7945, 1, 1636422623898, 1636422624161, 263, 0, 263, 0, 0, 0
7946, 1, 1636422624065, 1636422624325, 260, 0, 260, 0, 0, 0
7947, 1, 1636422624169, 1636422624438, 269, 0, 269, 0, 0, 0
7948, 1, 1636422624321, 1636422624589, 268, 1, 267, 0, 0, 0
7950, 1, 1636422624466, 1636422624729, 263, 0, 263, 0, 0, 0
7951, 1, 1636422624557, 1636422624826, 269, 0, 269, 0, 0, 0
7952, 1, 1636422624633, 1636422624898, 265, 1, 264, 0, 0, 0
7953, 1, 1636422624702, 1636422624965, 263, 0, 263, 0, 0, 0
7954, 1, 1636422624866, 1636422625130, 264, 0, 264, 0, 0, 0
7955, 1, 1636422624985, 1636422625250, 265, 0, 265, 0, 0, 0
7956, 1, 1636422625098, 1636422625366, 268, 0, 268, 0, 0, 0
7957, 1, 1636422625253, 1636422625517, 264, 0, 264, 0, 0, 0
7958, 1, 1636422625349, 1636422625617, 268, 1, 267, 0, 0, 0
7959, 1, 1636422625429, 1636422625693, 264, 1, 263, 0, 0, 0
7960, 1, 1636422625513, 1636422625813, 300, 0, 300, 0, 0, 0
7961, 1, 1636422625726, 1636422625993, 267, 0, 267, 0, 0, 0
7962, 1, 1636422625817, 1636422626085, 268, 0, 268, 0, 0, 0
7964, 1, 1636422625901, 1636422626165, 264, 1, 263, 0, 0, 0
7966, 1, 1636422626045, 1636422626309, 264, 0, 264, 0, 0, 0
7965, 1, 1636422626077, 1636422626350, 273, 1, 272, 0, 0, 0
7967, 1, 1636422626161, 1636422626425, 264, 1, 263, 0, 0, 0
7969, 1, 1636422626289, 1636422626561, 272, 1, 271, 0, 0, 0
7970, 1, 1636422626462, 1636422626726, 264, 0, 264, 0, 0, 0
7971, 1, 1636422626582, 1636422626846, 264, 0, 264, 0, 0, 0
7972, 1, 1636422626693, 1636422626958, 265, 1, 264, 0, 0, 0
7973, 1, 1636422626790, 1636422627053, 263, 0, 263, 0, 0, 0
7974, 1, 1636422626861, 1636422627125, 264, 0, 264, 0, 0, 0
7975, 1, 1636422626958, 1636422627221, 263, 0, 263, 0, 0, 0
7976, 1, 1636422627125, 1636422627389, 264, 0, 264, 0, 0, 0
7977, 1, 1636422627249, 1636422627517, 268, 1, 267, 0, 0, 0
7978, 1, 1636422627341, 1636422627606, 265, 1, 264, 0, 1, 1
7979, 1, 1636422627393, 1636422627657, 264, 0, 264, 0, 0, 0
7980, 1, 1636422627521, 1636422627785, 264, 0, 264, 0, 0, 0
7982, 1, 1636422627665, 1636422627930, 265, 1, 264, 0, 0, 0
7984, 1, 1636422627753, 1636422628017, 264, 1, 263, 0, 0, 0
7983, 1, 1636422627801, 1636422628065, 264, 0, 264, 0, 0, 0
7985, 1, 1636422627829, 1636422628093, 264, 0, 264, 0, 0, 0
7986, 1, 1636422627901, 1636422628166, 265, 0, 265, 0, 0, 0
7988, 1, 1636422628049, 1636422628313, 264, 1, 263, 0, 0, 0
7987, 1, 1636422628093, 1636422628357, 264, 1, 263, 1, 0, 1
7989, 1, 1636422628185, 1636422628445, 260, 0, 260, 0, 0, 0
7991, 1, 1636422628430, 1636422628729, 299, 0, 299, 0, 0, 0
7992, 1, 1636422628553, 1636422628814, 261, 0, 261, 0, 0, 0
7994, 1, 1636422628570, 1636422628838, 268, 0, 268, 0, 0, 0
7993, 1, 1636422628570, 1636422628838, 268, 0, 268, 0, 0, 0
7995, 1, 1636422628733, 1636422629001, 268, 1, 267, 0, 1, 1
7996, 1, 1636422628781, 1636422629045, 264, 0, 264, 0, 0, 0
7997, 1, 1636422628817, 1636422629081, 264, 0, 264, 0, 0, 0
7998, 1, 1636422628850, 1636422629117, 267, 0, 267, 0, 0, 0
8000, 1, 1636422628993, 1636422629257, 264, 1, 263, 0, 0, 0
7999, 1, 1636422628993, 1636422629258, 265, 1, 264, 0, 0, 0
8002, 1, 1636422629377, 1636422629641, 264, 1, 263, 0, 0, 0
8004, 1, 1636422629385, 1636422629650, 265, 1, 264, 1, 0, 1
8003, 1, 1636422629385, 1636422629653, 268, 1, 267, 1, 0, 1
8005, 1, 1636422629494, 1636422629761, 267, 0, 267, 0, 0, 0
8006, 1, 1636422629505, 1636422629773, 268, 1, 267, 0, 0, 0
8007, 1, 1636422629593, 1636422629853, 260, 0, 260, 0, 0, 0
8008, 1, 1636422629609, 1636422629869, 260, 0, 260, 0, 0, 0
8009, 1, 1636422629633, 1636422629897, 264, 0, 264, 0, 0, 0
8011, 1, 1636422629705, 1636422629969, 264, 1, 263, 0, 0, 0
8012, 1, 1636422629806, 1636422630073, 267, 0, 267, 0, 0, 0
8013, 1, 1636422630105, 1636422630365, 260, 0, 260, 0, 0, 0
8014, 1, 1636422630137, 1636422630405, 268, 1, 267, 0, 1, 1
8015, 1, 1636422630149, 1636422630413, 264, 1, 263, 0, 0, 0
8017, 1, 1636422630301, 1636422630569, 268, 1, 267, 0, 0, 0
8018, 1, 1636422630309, 1636422630573, 264, 0, 264, 0, 0, 0
8019, 1, 1636422630461, 1636422630722, 261, 0, 261, 0, 0, 0
8020, 1, 1636422630549, 1636422630813, 264, 1, 263, 0, 0, 0
8021, 1, 1636422630641, 1636422630905, 264, 0, 264, 0, 0, 0
8022, 1, 1636422630901, 1636422631165, 264, 1, 263, 0, 1, 1
8023, 1, 1636422630925, 1636422631189, 264, 1, 263, 1, 0, 1
8024, 1, 1636422630953, 1636422631222, 269, 1, 268, 0, 0, 0
8025, 1, 1636422630961, 1636422631225, 264, 1, 263, 0, 0, 0
8026, 1, 1636422631105, 1636422631369, 264, 1, 263, 0, 1, 1
8028, 1, 1636422631233, 1636422631498, 265, 1, 264, 0, 1, 1
8029, 1, 1636422631294, 1636422631558, 264, 0, 264, 0, 0, 0
8030, 1, 1636422631405, 1636422631673, 268, 1, 267, 0, 0, 0
8031, 1, 1636422631613, 1636422631877, 264, 1, 263, 0, 0, 0
8032, 1, 1636422631701, 1636422631961, 260, 0, 260, 0, 0, 0
8033, 1, 1636422631745, 1636422632009, 264, 0, 264, 0, 0, 0
8034, 1, 1636422631789, 1636422632053, 264, 0, 264, 0, 0, 0
8035, 1, 1636422631913, 1636422632181, 268, 1, 267, 0, 0, 0
8037, 1, 1636422632033, 1636422632293, 260, 0, 260, 0, 0, 0
8036, 1, 1636422632061, 1636422632330, 269, 0, 269, 0, 0, 0
8038, 1, 1636422632109, 1636422632374, 265, 0, 265, 0, 0, 0
8039, 1, 1636422632197, 1636422632461, 264, 0, 264, 0, 0, 0
8041, 1, 1636422632522, 1636422632785, 263, 0, 263, 0, 0, 0
8043, 1, 1636422632553, 1636422632818, 265, 1, 264, 0, 0, 0
8042, 1, 1636422632553, 1636422632826, 273, 1, 272, 0, 1, 1
8044, 1, 1636422632706, 1636422632969, 263, 0, 263, 0, 0, 0
8045, 1, 1636422632793, 1636422633057, 264, 1, 263, 0, 1, 1
8046, 1, 1636422632825, 1636422633097, 272, 1, 271, 0, 0, 0
8047, 1, 1636422632893, 1636422633162, 269, 1, 268, 1, 0, 1
8048, 1, 1636422632989, 1636422633258, 269, 0, 269, 0, 0, 0
8049, 1, 1636422633313, 1636422633581, 268, 0, 268, 0, 0, 0
8050, 1, 1636422633341, 1636422633613, 272, 1, 271, 0, 0, 0
8051, 1, 1636422633373, 1636422633641, 268, 1, 267, 0, 0, 0
8052, 1, 1636422633498, 1636422633762, 264, 0, 264, 0, 0, 0
8054, 1, 1636422633633, 1636422633914, 281, 1, 280, 0, 1, 1
8055, 1, 1636422633737, 1636422634002, 265, 0, 265, 0, 0, 0
8056, 1, 1636422633770, 1636422634037, 267, 0, 267, 0, 0, 0
8057, 1, 1636422634125, 1636422634389, 264, 1, 263, 0, 0, 0
8058, 1, 1636422634133, 1636422634397, 264, 0, 264, 0, 0, 0
8060, 1, 1636422634181, 1636422634442, 261, 0, 261, 0, 0, 0
8059, 1, 1636422634177, 1636422634442, 265, 0, 265, 0, 0, 0
8061, 1, 1636422634269, 1636422634538, 269, 0, 269, 0, 0, 0
8062, 1, 1636422634453, 1636422634717, 264, 0, 264, 0, 0, 0
8063, 1, 1636422634541, 1636422634806, 265, 0, 265, 0, 0, 0
8064, 1, 1636422634589, 1636422634849, 260, 0, 260, 0, 0, 0
8065, 1, 1636422634806, 1636422635073, 267, 0, 267, 0, 0, 0
8066, 1, 1636422634889, 1636422635153, 264, 0, 264, 0, 0, 0
8068, 1, 1636422634933, 1636422635197, 264, 1, 263, 1, 0, 1
8067, 1, 1636422634933, 1636422635201, 268, 1, 267, 0, 0, 0
8069, 1, 1636422634981, 1636422635254, 273, 0, 273, 0, 0, 0
8070, 1, 1636422635057, 1636422635325, 268, 1, 267, 0, 0, 0
8071, 1, 1636422635234, 1636422635497, 263, 0, 263, 0, 0, 0
8072, 1, 1636422635305, 1636422635570, 265, 1, 264, 0, 1, 1
8073, 1, 1636422635357, 1636422635625, 268, 0, 268, 0, 0, 0
8074, 1, 1636422635513, 1636422635785, 272, 0, 272, 0, 0, 0
8077, 1, 1636422635729, 1636422635997, 268, 1, 267, 0, 0, 0
8076, 1, 1636422635729, 1636422635997, 268, 1, 267, 0, 1, 1
8078, 1, 1636422635825, 1636422636089, 264, 1, 263, 0, 0, 0
8079, 1, 1636422635865, 1636422636129, 264, 0, 264, 0, 0, 0
8080, 1, 1636422636037, 1636422636305, 268, 0, 268, 0, 0, 0
8081, 1, 1636422636113, 1636422636381, 268, 0, 268, 0, 0, 0
8083, 1, 1636422636150, 1636422636413, 263, 0, 263, 0, 0, 0
8082, 1, 1636422636205, 1636422636469, 264, 0, 264, 0, 0, 0
8085, 1, 1636422636521, 1636422636785, 264, 0, 264, 0, 0, 0
8087, 1, 1636422636533, 1636422636793, 260, 0, 260, 0, 0, 0
8086, 1, 1636422636562, 1636422636825, 263, 0, 263, 0, 0, 0
8088, 1, 1636422636577, 1636422636845, 268, 0, 268, 0, 0, 0
8089, 1, 1636422636649, 1636422636913, 264, 1, 263, 0, 0, 0
8090, 1, 1636422636849, 1636422637114, 265, 0, 265, 0, 0, 0
8091, 1, 1636422636881, 1636422637145, 264, 1, 263, 0, 1, 1
8092, 1, 1636422636913, 1636422637177, 264, 1, 263, 0, 0, 0
8093, 1, 1636422636937, 1636422637201, 264, 1, 263, 0, 1, 1
8094, 1, 1636422637318, 1636422637582, 264, 0, 264, 0, 0, 0
8095, 1, 1636422637337, 1636422637605, 268, 1, 267, 1, 0, 1
8096, 1, 1636422637389, 1636422637657, 268, 0, 268, 0, 0, 0
8097, 1, 1636422637482, 1636422637745, 263, 0, 263, 0, 0, 0
8098, 1, 1636422637661, 1636422637926, 265, 0, 265, 0, 0, 0
8101, 1, 1636422637713, 1636422637977, 264, 0, 264, 0, 0, 0
8100, 1, 1636422637749, 1636422638018, 269, 1, 268, 0, 0, 0
8102, 1, 1636422637918, 1636422638181, 263, 0, 263, 0, 0, 0
8104, 1, 1636422638133, 1636422638398, 265, 0, 265, 0, 0, 0
8103, 1, 1636422638133, 1636422638398, 265, 1, 264, 0, 1, 1
8105, 1, 1636422638225, 1636422638489, 264, 1, 263, 0, 1, 1
8106, 1, 1636422638245, 1636422638509, 264, 1, 263, 0, 1, 1
8107, 1, 1636422638425, 1636422638690, 265, 0, 265, 0, 0, 0
8108, 1, 1636422638522, 1636422638786, 264, 0, 264, 0, 0, 0
8109, 1, 1636422638537, 1636422638806, 269, 1, 268, 1, 0, 1
8111, 1, 1636422638645, 1636422638909, 264, 1, 263, 0, 0, 0
8113, 1, 1636422638925, 1636422639198, 273, 1, 272, 0, 0, 0
8114, 1, 1636422638977, 1636422639262, 285, 1, 284, 0, 1, 1
8115, 1, 1636422639030, 1636422639297, 267, 0, 267, 0, 0, 0
8116, 1, 1636422639265, 1636422639529, 264, 0, 264, 0, 0, 0
8118, 1, 1636422639317, 1636422639581, 264, 0, 264, 0, 0, 0
8119, 1, 1636422639429, 1636422639698, 269, 1, 268, 0, 1, 1
8121, 1, 1636422639765, 1636422640025, 260, 0, 260, 0, 0, 0
8122, 1, 1636422639773, 1636422640037, 264, 0, 264, 0, 0, 0
8125, 1, 1636422640021, 1636422640329, 308, 0, 308, 0, 0, 0
8126, 1, 1636422640094, 1636422640357, 263, 0, 263, 0, 0, 0
8127, 1, 1636422640250, 1636422640517, 267, 0, 267, 0, 0, 0
8128, 1, 1636422640529, 1636422640793, 264, 0, 264, 0, 0, 0
8130, 1, 1636422640569, 1636422640834, 265, 0, 265, 0, 0, 0
8129, 1, 1636422640598, 1636422640861, 263, 0, 263, 0, 0, 0
8131, 1, 1636422640834, 1636422641098, 264, 0, 264, 0, 0, 0
8132, 1, 1636422640897, 1636422641166, 269, 1, 268, 1, 0, 1
8133, 1, 1636422641066, 1636422641329, 263, 0, 263, 0, 0, 0
8134, 1, 1636422641317, 1636422641581, 264, 0, 264, 0, 0, 0
8135, 1, 1636422641341, 1636422641605, 264, 1, 263, 0, 0, 0
8136, 1, 1636422641377, 1636422641641, 264, 0, 264, 0, 0, 0
8137, 1, 1636422641413, 1636422641677, 264, 0, 264, 0, 0, 0
8138, 1, 1636422641621, 1636422641885, 264, 1, 263, 0, 1, 1
8139, 1, 1636422641677, 1636422641941, 264, 1, 263, 0, 0, 0
8140, 1, 1636422641829, 1636422642093, 264, 1, 263, 0, 0, 0
8141, 1, 1636422642097, 1636422642358, 261, 0, 261, 0, 0, 0
8143, 1, 1636422642134, 1636422642402, 268, 0, 268, 0, 0, 0
8142, 1, 1636422642134, 1636422642402, 268, 0, 268, 0, 0, 0
8144, 1, 1636422642161, 1636422642461, 300, 1, 299, 1, 0, 1
8145, 1, 1636422642465, 1636422642725, 260, 0, 260, 0, 0, 0
8146, 1, 1636422642509, 1636422642773, 264, 0, 264, 0, 0, 0
8147, 1, 1636422642654, 1636422642917, 263, 0, 263, 0, 0, 0
8148, 1, 1636422642729, 1636422642993, 264, 0, 264, 0, 0, 0
8149, 1, 1636422642913, 1636422643177, 264, 1, 263, 1, 0, 1
8150, 1, 1636422642925, 1636422643190, 265, 1, 264, 1, 0, 1
8151, 1, 1636422642945, 1636422643213, 268, 1, 267, 0, 0, 0
8152, 1, 1636422643197, 1636422643457, 260, 0, 260, 0, 0, 0
8153, 1, 1636422643241, 1636422643505, 264, 0, 264, 0, 0, 0
8154, 1, 1636422643273, 1636422643538, 265, 0, 265, 0, 0, 0
8156, 1, 1636422643450, 1636422643714, 264, 0, 264, 0, 0, 0
8155, 1, 1636422643529, 1636422643794, 265, 1, 264, 0, 0, 0
8157, 1, 1636422643717, 1636422643985, 268, 1, 267, 0, 1, 1
8158, 1, 1636422643725, 1636422643989, 264, 1, 263, 0, 0, 0
8159, 1, 1636422643797, 1636422644065, 268, 1, 267, 0, 0, 0
8161, 1, 1636422643877, 1636422644141, 264, 0, 264, 0, 0, 0
8162, 1, 1636422644033, 1636422644297, 264, 0, 264, 0, 0, 0
8163, 1, 1636422644061, 1636422644321, 260, 0, 260, 0, 0, 0
8164, 1, 1636422644237, 1636422644501, 264, 1, 263, 1, 0, 1
8165, 1, 1636422644325, 1636422644589, 264, 0, 264, 0, 0, 0
8166, 1, 1636422644505, 1636422644774, 269, 0, 269, 0, 0, 0
8167, 1, 1636422644537, 1636422644801, 264, 0, 264, 0, 0, 0
8168, 1, 1636422644545, 1636422644817, 272, 1, 271, 0, 1, 1
8169, 1, 1636422644601, 1636422644873, 272, 0, 272, 0, 0, 0
8170, 1, 1636422644825, 1636422645089, 264, 0, 264, 0, 0, 0
8171, 1, 1636422644853, 1636422645118, 265, 1, 264, 0, 1, 1
8172, 1, 1636422645038, 1636422645301, 263, 0, 263, 0, 0, 0
8173, 1, 1636422645053, 1636422645317, 264, 0, 264, 0, 0, 0
8174, 1, 1636422645325, 1636422645589, 264, 1, 263, 0, 1, 1
8176, 1, 1636422645334, 1636422645601, 267, 0, 267, 0, 0, 0
8175, 1, 1636422645334, 1636422645601, 267, 0, 267, 0, 0, 0
8177, 1, 1636422645393, 1636422645657, 264, 1, 263, 0, 1, 1
8178, 1, 1636422645653, 1636422645917, 264, 1, 263, 0, 0, 0
8179, 1, 1636422645657, 1636422645925, 268, 1, 267, 1, 0, 1
8180, 1, 1636422645825, 1636422646090, 265, 1, 264, 0, 0, 0
8181, 1, 1636422645862, 1636422646125, 263, 0, 263, 0, 0, 0
8182, 1, 1636422646005, 1636422646270, 265, 0, 265, 0, 0, 0
8183, 1, 1636422646105, 1636422646381, 276, 0, 276, 0, 0, 0
8184, 1, 1636422646141, 1636422646409, 268, 1, 267, 0, 1, 1
8185, 1, 1636422646141, 1636422646410, 269, 1, 268, 0, 0, 0
8186, 1, 1636422646205, 1636422646469, 264, 0, 264, 0, 0, 0
8187, 1, 1636422646429, 1636422646693, 264, 0, 264, 0, 0, 0
8190, 1, 1636422646637, 1636422646905, 268, 1, 267, 0, 0, 0
8189, 1, 1636422646657, 1636422646921, 264, 1, 263, 1, 0, 1
8191, 1, 1636422646657, 1636422646921, 264, 1, 263, 0, 1, 1
8192, 1, 1636422646726, 1636422646989, 263, 0, 263, 0, 0, 0
8193, 1, 1636422646917, 1636422647181, 264, 1, 263, 0, 0, 0
8194, 1, 1636422646929, 1636422647193, 264, 1, 263, 0, 0, 0
8195, 1, 1636422646937, 1636422647201, 264, 1, 263, 0, 0, 0
8196, 1, 1636422647014, 1636422647277, 263, 0, 263, 0, 0, 0
8197, 1, 1636422647234, 1636422647502, 268, 0, 268, 0, 0, 0
8198, 1, 1636422647377, 1636422647645, 268, 1, 267, 0, 0, 0
8199, 1, 1636422647441, 1636422647745, 304, 0, 304, 0, 0, 0
8200, 1, 1636422647461, 1636422647746, 285, 0, 285, 0, 0, 0
8201, 1, 1636422647505, 1636422647765, 260, 0, 260, 0, 0, 0
8203, 1, 1636422647749, 1636422648013, 264, 1, 263, 1, 0, 1
8204, 1, 1636422647749, 1636422648013, 264, 1, 263, 1, 0, 1
8202, 1, 1636422647749, 1636422648017, 268, 1, 267, 0, 0, 0
8205, 1, 1636422647833, 1636422648093, 260, 0, 260, 0, 0, 0
8206, 1, 1636422648017, 1636422648277, 260, 0, 260, 0, 0, 0
8207, 1, 1636422648029, 1636422648293, 264, 0, 264, 0, 0, 0
8208, 1, 1636422648165, 1636422648429, 264, 1, 263, 0, 0, 0
8209, 1, 1636422648233, 1636422648498, 265, 1, 264, 0, 0, 0
8210, 1, 1636422648266, 1636422648529, 263, 0, 263, 0, 0, 0
8211, 1, 1636422648317, 1636422648613, 296, 1, 295, 1, 0, 1
8212, 1, 1636422648529, 1636422648798, 269, 1, 268, 0, 0, 0
8213, 1, 1636422648529, 1636422648798, 269, 1, 268, 0, 0, 0
8214, 1, 1636422648557, 1636422648817, 260, 0, 260, 0, 0, 0
8215, 1, 1636422648617, 1636422648885, 268, 1, 267, 0, 0, 0
8216, 1, 1636422648769, 1636422649033, 264, 0, 264, 0, 0, 0
8218, 1, 1636422648861, 1636422649125, 264, 1, 263, 0, 0, 0
8217, 1, 1636422648882, 1636422649145, 263, 0, 263, 0, 0, 0
8219, 1, 1636422648989, 1636422649257, 268, 0, 268, 0, 0, 0
8220, 1, 1636422649037, 1636422649301, 264, 0, 264, 0, 0, 0
8221, 1, 1636422649070, 1636422649337, 267, 0, 267, 0, 0, 0
8222, 1, 1636422649129, 1636422649393, 264, 0, 264, 0, 0, 0
8223, 1, 1636422649217, 1636422649477, 260, 0, 260, 0, 0, 0
8224, 1, 1636422649309, 1636422649573, 264, 1, 263, 1, 0, 1
8225, 1, 1636422649330, 1636422649593, 263, 0, 263, 0, 0, 0
8226, 1, 1636422649389, 1636422649653, 264, 1, 263, 0, 0, 0
8227, 1, 1636422649481, 1636422649749, 268, 1, 267, 0, 1, 1
8228, 1, 1636422649573, 1636422649881, 308, 1, 307, 1, 0, 1
8229, 1, 1636422649626, 1636422649889, 263, 0, 263, 0, 0, 0
8230, 1, 1636422649653, 1636422649921, 268, 1, 267, 0, 0, 0
8231, 1, 1636422649809, 1636422650077, 268, 0, 268, 0, 0, 0
8232, 1, 1636422649833, 1636422650097, 264, 1, 263, 0, 0, 0
8233, 1, 1636422649901, 1636422650165, 264, 1, 263, 0, 0, 0
8234, 1, 1636422649901, 1636422650166, 265, 1, 264, 1, 0, 1
8235, 1, 1636422649925, 1636422650185, 260, 0, 260, 0, 0, 0
8236, 1, 1636422649933, 1636422650197, 264, 1, 263, 0, 1, 1
8238, 1, 1636422650121, 1636422650385, 264, 1, 263, 0, 1, 1
8237, 1, 1636422650141, 1636422650409, 268, 1, 267, 0, 0, 0
8239, 1, 1636422650141, 1636422650409, 268, 0, 268, 0, 0, 0
8241, 1, 1636422650213, 1636422650477, 264, 0, 264, 0, 0, 0
8240, 1, 1636422650253, 1636422650517, 264, 1, 263, 0, 1, 1
8242, 1, 1636422650337, 1636422650597, 260, 0, 260, 0, 0, 0
8243, 1, 1636422650381, 1636422650645, 264, 0, 264, 0, 0, 0
8245, 1, 1636422650545, 1636422650809, 264, 1, 263, 0, 1, 1
8246, 1, 1636422650561, 1636422650825, 264, 0, 264, 0, 0, 0
8247, 1, 1636422650625, 1636422650893, 268, 0, 268, 0, 0, 0
8248, 1, 1636422650662, 1636422650929, 267, 0, 267, 0, 0, 0
8249, 1, 1636422650717, 1636422650981, 264, 0, 264, 0, 0, 0
8250, 1, 1636422650809, 1636422651073, 264, 1, 263, 1, 0, 1
8251, 1, 1636422650865, 1636422651133, 268, 1, 267, 0, 0, 0
8252, 1, 1636422650926, 1636422651189, 263, 0, 263, 0, 0, 0
8253, 1, 1636422650953, 1636422651217, 264, 1, 263, 0, 0, 0
8255, 1, 1636422651021, 1636422651290, 269, 0, 269, 0, 0, 0
8254, 1, 1636422651073, 1636422651341, 268, 1, 267, 1, 0, 1
8256, 1, 1636422651149, 1636422651413, 264, 0, 264, 0, 0, 0
8257, 1, 1636422651161, 1636422651429, 268, 0, 268, 0, 0, 0
8259, 1, 1636422651366, 1636422651629, 263, 0, 263, 0, 0, 0
8260, 1, 1636422651425, 1636422651685, 260, 0, 260, 0, 0, 0
8261, 1, 1636422651469, 1636422651733, 264, 0, 264, 0, 0, 0
8262, 1, 1636422651521, 1636422651785, 264, 1, 263, 0, 1, 1
8263, 1, 1636422651533, 1636422651805, 272, 1, 271, 0, 0, 0
8264, 1, 1636422651650, 1636422651918, 268, 0, 268, 0, 0, 0
8265, 1, 1636422651721, 1636422651989, 268, 0, 268, 0, 0, 0
8266, 1, 1636422651757, 1636422652025, 268, 1, 267, 0, 0, 0
8268, 1, 1636422651813, 1636422652077, 264, 0, 264, 0, 0, 0
8269, 1, 1636422651938, 1636422652201, 263, 0, 263, 0, 0, 0
8270, 1, 1636422651969, 1636422652233, 264, 0, 264, 0, 0, 0
8271, 1, 1636422652153, 1636422652421, 268, 0, 268, 0, 0, 0
8272, 1, 1636422652225, 1636422652482, 257, 0, 257, 0, 0, 0
8273, 1, 1636422652273, 1636422652542, 269, 1, 268, 0, 1, 1
8274, 1, 1636422652325, 1636422652593, 268, 0, 268, 0, 0, 0
8275, 1, 1636422652337, 1636422652601, 264, 0, 264, 0, 0, 0
8276, 1, 1636422652458, 1636422652722, 264, 0, 264, 0, 0, 0
8277, 1, 1636422652533, 1636422652797, 264, 0, 264, 0, 0, 0
8278, 1, 1636422652549, 1636422652813, 264, 0, 264, 0, 0, 0
8279, 1, 1636422652617, 1636422652882, 265, 1, 264, 1, 0, 1
8280, 1, 1636422652737, 1636422653005, 268, 1, 267, 1, 0, 1
8281, 1, 1636422652785, 1636422653049, 264, 0, 264, 0, 0, 0
8282, 1, 1636422652965, 1636422653237, 272, 0, 272, 0, 0, 0
8283, 1, 1636422653033, 1636422653301, 268, 0, 268, 0, 0, 0
8284, 1, 1636422653077, 1636422653338, 261, 0, 261, 0, 0, 0
8285, 1, 1636422653117, 1636422653381, 264, 1, 263, 0, 1, 1
8286, 1, 1636422653129, 1636422653393, 264, 0, 264, 0, 0, 0
8287, 1, 1636422653265, 1636422653530, 265, 1, 264, 0, 0, 0
8288, 1, 1636422653326, 1636422653589, 263, 0, 263, 0, 0, 0
8289, 1, 1636422653357, 1636422653621, 264, 0, 264, 0, 0, 0
8290, 1, 1636422653426, 1636422653690, 264, 0, 264, 0, 0, 0
8291, 1, 1636422653537, 1636422653798, 261, 0, 261, 0, 0, 0
8292, 1, 1636422653581, 1636422653841, 260, 0, 260, 0, 0, 0
8293, 1, 1636422653817, 1636422654081, 264, 1, 263, 0, 0, 0
8294, 1, 1636422653841, 1636422654109, 268, 1, 267, 0, 0, 0
8295, 1, 1636422653905, 1636422654165, 260, 0, 260, 0, 0, 0
8297, 1, 1636422653953, 1636422654217, 264, 1, 263, 0, 1, 1
8296, 1, 1636422653953, 1636422654221, 268, 1, 267, 1, 0, 1
8298, 1, 1636422654058, 1636422654321, 263, 0, 263, 0, 0, 0
8301, 1, 1636422654129, 1636422654390, 261, 0, 261, 0, 0, 0
8300, 1, 1636422654129, 1636422654394, 265, 0, 265, 0, 0, 0
8302, 1, 1636422654217, 1636422654482, 265, 1, 264, 0, 1, 1
8303, 1, 1636422654349, 1636422654613, 264, 0, 264, 0, 0, 0
8304, 1, 1636422654381, 1636422654646, 265, 0, 265, 0, 0, 0
8305, 1, 1636422654617, 1636422654881, 264, 0, 264, 0, 0, 0
8306, 1, 1636422654633, 1636422654906, 273, 0, 273, 0, 0, 0
8307, 1, 1636422654677, 1636422654941, 264, 0, 264, 0, 0, 0
8309, 1, 1636422654742, 1636422655005, 263, 0, 263, 0, 0, 0
8308, 1, 1636422654745, 1636422655009, 264, 0, 264, 0, 0, 0
8310, 1, 1636422654861, 1636422655125, 264, 0, 264, 0, 0, 0
8312, 1, 1636422654941, 1636422655209, 268, 1, 267, 0, 0, 0
8313, 1, 1636422655013, 1636422655277, 264, 0, 264, 0, 0, 0
8311, 1, 1636422655137, 1636422655405, 268, 0, 268, 0, 0, 0
8314, 1, 1636422655161, 1636422655425, 264, 1, 263, 0, 0, 0
8315, 1, 1636422655165, 1636422655433, 268, 0, 268, 0, 0, 0
8316, 1, 1636422655377, 1636422655649, 272, 1, 271, 0, 1, 1
8317, 1, 1636422655425, 1636422655689, 264, 0, 264, 0, 0, 0
8318, 1, 1636422655462, 1636422655725, 263, 0, 263, 0, 0, 0
8319, 1, 1636422655541, 1636422655809, 268, 1, 267, 0, 1, 1
8320, 1, 1636422655545, 1636422655813, 268, 0, 268, 0, 0, 0
8321, 1, 1636422655649, 1636422655918, 269, 0, 269, 0, 0, 0
8322, 1, 1636422655733, 1636422656005, 272, 0, 272, 0, 0, 0
8324, 1, 1636422655809, 1636422656074, 265, 1, 264, 1, 0, 1
8325, 1, 1636422655945, 1636422656213, 268, 1, 267, 0, 0, 0
8327, 1, 1636422656182, 1636422656445, 263, 0, 263, 0, 0, 0
8328, 1, 1636422656241, 1636422656514, 273, 1, 272, 0, 0, 0
8326, 1, 1636422656217, 1636422656514, 297, 0, 297, 0, 0, 0
8330, 1, 1636422656345, 1636422656609, 264, 0, 264, 0, 0, 0
8331, 1, 1636422656349, 1636422656617, 268, 1, 267, 0, 0, 0
8329, 1, 1636422656453, 1636422656718, 265, 0, 265, 0, 0, 0
8332, 1, 1636422656521, 1636422656789, 268, 0, 268, 0, 0, 0
8333, 1, 1636422656557, 1636422656821, 264, 1, 263, 1, 0, 1
8334, 1, 1636422656601, 1636422656866, 265, 1, 264, 1, 0, 1
8336, 1, 1636422656749, 1636422657017, 268, 0, 268, 0, 0, 0
8335, 1, 1636422656769, 1636422657033, 264, 1, 263, 0, 0, 0
8337, 1, 1636422656913, 1636422657177, 264, 1, 263, 0, 0, 0
8338, 1, 1636422656981, 1636422657245, 264, 1, 263, 0, 0, 0
8339, 1, 1636422657029, 1636422657297, 268, 0, 268, 0, 0, 0
8340, 1, 1636422657121, 1636422657386, 265, 1, 264, 0, 0, 0
8342, 1, 1636422657133, 1636422657397, 264, 1, 263, 0, 0, 0
8341, 1, 1636422657133, 1636422657398, 265, 1, 264, 1, 0, 1
8343, 1, 1636422657273, 1636422657537, 264, 1, 263, 0, 0, 0
8344, 1, 1636422657341, 1636422657605, 264, 0, 264, 0, 0, 0
8345, 1, 1636422657401, 1636422657661, 260, 0, 260, 0, 0, 0
8346, 1, 1636422657490, 1636422657753, 263, 0, 263, 0, 0, 0
8348, 1, 1636422657669, 1636422657938, 269, 1, 268, 0, 1, 1
8347, 1, 1636422657669, 1636422657941, 272, 1, 271, 1, 0, 1
8349, 1, 1636422657773, 1636422658037, 264, 1, 263, 0, 1, 1
8350, 1, 1636422657838, 1636422658105, 267, 0, 267, 0, 0, 0
8353, 1, 1636422657937, 1636422658201, 264, 1, 263, 0, 0, 0
8352, 1, 1636422657937, 1636422658205, 268, 1, 267, 0, 0, 0
8354, 1, 1636422658069, 1636422658333, 264, 1, 263, 0, 0, 0
8355, 1, 1636422658141, 1636422658405, 264, 0, 264, 0, 0, 0
8356, 1, 1636422658193, 1636422658457, 264, 0, 264, 0, 0, 0
8357, 1, 1636422658290, 1636422658557, 267, 0, 267, 0, 0, 0
8358, 1, 1636422658353, 1636422658621, 268, 1, 267, 0, 0, 0
8359, 1, 1636422658453, 1636422658717, 264, 0, 264, 0, 0, 0
8360, 1, 1636422658573, 1636422658837, 264, 1, 263, 1, 0, 1
8361, 1, 1636422658637, 1636422658901, 264, 0, 264, 0, 0, 0
8362, 1, 1636422658729, 1636422659001, 272, 1, 271, 0, 0, 0
8363, 1, 1636422658745, 1636422659009, 264, 1, 263, 0, 0, 0
8364, 1, 1636422658869, 1636422659134, 265, 1, 264, 0, 1, 1
8365, 1, 1636422658929, 1636422659198, 269, 1, 268, 0, 0, 0
8366, 1, 1636422659001, 1636422659266, 265, 1, 264, 0, 0, 0
8367, 1, 1636422659097, 1636422659361, 264, 0, 264, 0, 0, 0
8368, 1, 1636422659141, 1636422659402, 261, 0, 261, 0, 0, 0
8369, 1, 1636422659254, 1636422659518, 264, 0, 264, 0, 0, 0
8370, 1, 1636422659369, 1636422659633, 264, 1, 263, 0, 0, 0
8371, 1, 1636422659437, 1636422659701, 264, 1, 263, 0, 0, 0
8372, 1, 1636422659533, 1636422659801, 268, 1, 267, 0, 0, 0
8373, 1, 1636422659545, 1636422659809, 264, 0, 264, 0, 0, 0
8375, 1, 1636422659730, 1636422659997, 267, 0, 267, 0, 0, 0
8376, 1, 1636422659805, 1636422660066, 261, 0, 261, 0, 0, 0
8377, 1, 1636422659906, 1636422660170, 264, 0, 264, 0, 0, 0
8378, 1, 1636422659953, 1636422660218, 265, 0, 265, 0, 0, 0
8379, 1, 1636422660053, 1636422660317, 264, 1, 263, 0, 1, 1
8382, 1, 1636422660358, 1636422660622, 264, 0, 264, 0, 0, 0
8381, 1, 1636422660358, 1636422660629, 271, 0, 271, 0, 0, 0
8383, 1, 1636422660533, 1636422660805, 272, 1, 271, 0, 0, 0
8384, 1, 1636422660593, 1636422660862, 269, 1, 268, 0, 0, 0
8386, 1, 1636422660705, 1636422660970, 265, 1, 264, 1, 0, 1
8385, 1, 1636422660705, 1636422660970, 265, 1, 264, 0, 0, 0
8387, 1, 1636422660745, 1636422661013, 268, 0, 268, 0, 0, 0
8388, 1, 1636422660857, 1636422661125, 268, 1, 267, 0, 0, 0
8390, 1, 1636422661150, 1636422661413, 263, 0, 263, 0, 0, 0
8389, 1, 1636422661145, 1636422661417, 272, 1, 271, 0, 1, 1
8391, 1, 1636422661334, 1636422661598, 264, 0, 264, 0, 0, 0
8392, 1, 1636422661397, 1636422661665, 268, 1, 267, 0, 0, 0
8393, 1, 1636422661437, 1636422661701, 264, 0, 264, 0, 0, 0
8394, 1, 1636422661501, 1636422661805, 304, 1, 303, 0, 0, 0
8396, 1, 1636422661653, 1636422661917, 264, 1, 263, 0, 0, 0
8397, 1, 1636422661661, 1636422661925, 264, 0, 264, 0, 0, 0
8398, 1, 1636422661937, 1636422662205, 268, 0, 268, 0, 0, 0
8399, 1, 1636422661954, 1636422662217, 263, 0, 263, 0, 0, 0
8400, 1, 1636422662081, 1636422662345, 264, 1, 263, 0, 0, 0
8401, 1, 1636422662181, 1636422662450, 269, 1, 268, 0, 0, 0
8402, 1, 1636422662217, 1636422662482, 265, 0, 265, 0, 0, 0
8403, 1, 1636422662297, 1636422662565, 268, 1, 267, 1, 0, 1
8404, 1, 1636422662382, 1636422662645, 263, 0, 263, 0, 0, 0
8405, 1, 1636422662441, 1636422662705, 264, 0, 264, 0, 0, 0
8406, 1, 1636422662742, 1636422663005, 263, 0, 263, 0, 0, 0
8408, 1, 1636422662797, 1636422663065, 268, 0, 268, 0, 0, 0
8409, 1, 1636422662970, 1636422663233, 263, 0, 263, 0, 0, 0
8410, 1, 1636422663033, 1636422663297, 264, 1, 263, 0, 0, 0
8411, 1, 1636422663109, 1636422663378, 269, 0, 269, 0, 0, 0
8412, 1, 1636422663161, 1636422663422, 261, 0, 261, 0, 0, 0
8413, 1, 1636422663249, 1636422663517, 268, 1, 267, 0, 0, 0
8414, 1, 1636422663530, 1636422663797, 267, 0, 267, 0, 0, 0
8415, 1, 1636422663581, 1636422663845, 264, 0, 264, 0, 0, 0
8416, 1, 1636422663782, 1636422664050, 268, 0, 268, 0, 0, 0
8417, 1, 1636422663841, 1636422664106, 265, 1, 264, 0, 0, 0
8418, 1, 1636422663917, 1636422664201, 284, 1, 283, 0, 1, 1
8419, 1, 1636422663974, 1636422664237, 263, 0, 263, 0, 0, 0
8420, 1, 1636422664037, 1636422664306, 269, 1, 268, 0, 1, 1
8421, 1, 1636422664333, 1636422664598, 265, 1, 264, 0, 0, 0
8422, 1, 1636422664390, 1636422664657, 267, 0, 267, 0, 0, 0
8423, 1, 1636422664461, 1636422664729, 268, 0, 268, 0, 0, 0
8424, 1, 1636422664581, 1636422664845, 264, 1, 263, 0, 0, 0
8425, 1, 1636422664637, 1636422664902, 265, 1, 264, 1, 0, 1
8426, 1, 1636422664705, 1636422664970, 265, 1, 264, 0, 0, 0
8427, 1, 1636422664785, 1636422665050, 265, 1, 264, 0, 0, 0
8429, 1, 1636422665121, 1636422665390, 269, 1, 268, 0, 1, 1
8430, 1, 1636422665177, 1636422665441, 264, 1, 263, 0, 0, 0
8431, 1, 1636422665197, 1636422665461, 264, 1, 263, 0, 0, 0
8432, 1, 1636422665377, 1636422665642, 265, 0, 265, 0, 0, 0
8433, 1, 1636422665449, 1636422665713, 264, 1, 263, 0, 1, 1
8434, 1, 1636422665509, 1636422665773, 264, 0, 264, 0, 0, 0
8435, 1, 1636422665574, 1636422665845, 271, 0, 271, 0, 0, 0
8436, 1, 1636422665945, 1636422666205, 260, 0, 260, 0, 0, 0
8438, 1, 1636422665989, 1636422666253, 264, 0, 264, 0, 0, 0
8439, 1, 1636422666118, 1636422666382, 264, 0, 264, 0, 0, 0
8440, 1, 1636422666233, 1636422666502, 269, 1, 268, 1, 0, 1
8442, 1, 1636422666389, 1636422666658, 269, 1, 268, 1, 0, 1
8443, 1, 1636422666717, 1636422666982, 265, 1, 264, 0, 0, 0
8444, 1, 1636422666789, 1636422667057, 268, 0, 268, 0, 0, 0
8445, 1, 1636422666833, 1636422667097, 264, 1, 263, 0, 0, 0
8446, 1, 1636422667050, 1636422667313, 263, 0, 263, 0, 0, 0
8447, 1, 1636422667178, 1636422667445, 267, 0, 267, 0, 0, 0
8448, 1, 1636422667522, 1636422667786, 264, 0, 264, 0, 0, 0
8449, 1, 1636422667581, 1636422667845, 264, 0, 264, 0, 0, 0
8450, 1, 1636422667638, 1636422667926, 288, 0, 288, 0, 0, 0
8451, 1, 1636422667853, 1636422668118, 265, 1, 264, 0, 0, 0
8452, 1, 1636422668018, 1636422668281, 263, 0, 263, 0, 0, 0
8453, 1, 1636422668193, 1636422668462, 269, 0, 269, 0, 0, 0
8454, 1, 1636422668398, 1636422668665, 267, 0, 267, 0, 0, 0
8455, 1, 1636422668445, 1636422668709, 264, 0, 264, 0, 0, 0
8456, 1, 1636422668669, 1636422668930, 261, 0, 261, 0, 0, 0
8457, 1, 1636422668797, 1636422669062, 265, 1, 264, 0, 0, 0
8458, 1, 1636422668914, 1636422669181, 267, 0, 267, 0, 0, 0
8459, 1, 1636422669205, 1636422669465, 260, 0, 260, 0, 0, 0
8460, 1, 1636422669265, 1636422669533, 268, 1, 267, 0, 0, 0
8461, 1, 1636422669449, 1636422669718, 269, 0, 269, 0, 0, 0
8462, 1, 1636422669577, 1636422669842, 265, 0, 265, 0, 0, 0
8463, 1, 1636422669805, 1636422670070, 265, 0, 265, 0, 0, 0
8465, 1, 1636422670037, 1636422670302, 265, 0, 265, 0, 0, 0
8464, 1, 1636422670070, 1636422670334, 264, 0, 264, 0, 0, 0
8466, 1, 1636422670217, 1636422670485, 268, 1, 267, 0, 1, 1
8468, 1, 1636422670389, 1636422670654, 265, 0, 265, 0, 0, 0
8469, 1, 1636422670522, 1636422670789, 267, 0, 267, 0, 0, 0
8470, 1, 1636422670793, 1636422671058, 265, 1, 264, 0, 1, 1
8471, 1, 1636422670845, 1636422671110, 265, 1, 264, 0, 0, 0
8472, 1, 1636422670926, 1636422671189, 263, 0, 263, 0, 0, 0
8474, 1, 1636422671337, 1636422671601, 264, 1, 263, 0, 0, 0
8476, 1, 1636422671629, 1636422671893, 264, 1, 263, 0, 0, 0
8477, 1, 1636422671726, 1636422671990, 264, 0, 264, 0, 0, 0
8478, 1, 1636422672134, 1636422672406, 272, 0, 272, 0, 0, 0
8479, 1, 1636422672517, 1636422672790, 273, 1, 272, 0, 0, 0
8480, 1, 1636422672926, 1636422673202, 276, 0, 276, 0, 0, 0
8481, 1, 1636422673326, 1636422673590, 264, 0, 264, 0, 0, 0
8482, 1, 1636422673722, 1636422673990, 268, 0, 268, 0, 0, 0
8483, 1, 1636422674114, 1636422674378, 264, 0, 264, 0, 0, 0
8485, 1, 1636422675158, 1636422675430, 272, 0, 272, 0, 0, 0
8486, 1, 1636422675874, 1636422676146, 272, 0, 272, 0, 0, 0
8487, 1, 1636422676286, 1636422676549, 263, 0, 263, 0, 0, 0
8488, 1, 1636422676686, 1636422676950, 264, 0, 264, 0, 0, 0
8489, 1, 1636422677014, 1636422677282, 268, 0, 268, 0, 0, 0
8490, 1, 1636422677497, 1636422677762, 265, 1, 264, 0, 0, 0
8491, 1, 1636422677798, 1636422678066, 268, 0, 268, 0, 0, 0
8492, 1, 1636422678313, 1636422678582, 269, 1, 268, 1, 0, 1
8493, 1, 1636422678606, 1636422678874, 268, 0, 268, 0, 0, 0
8494, 1, 1636422679101, 1636422679369, 268, 0, 268, 0, 0, 0
8495, 1, 1636422679413, 1636422679678, 265, 1, 264, 0, 0, 0
8499, 1, 1636422680217, 1636422680482, 265, 1, 264, 0, 0, 0
8500, 1, 1636422680217, 1636422680482, 265, 1, 264, 1, 0, 1
8501, 1, 1636422680566, 1636422680838, 272, 0, 272, 0, 0, 0
8502, 1, 1636422680922, 1636422681190, 268, 0, 268, 0, 0, 0
8503, 1, 1636422681013, 1636422681277, 264, 1, 263, 0, 0, 0
8475, 1, 1636422681197, 1636422681461, 264, 1, 263, 0, 0, 0
8504, 1, 1636422681285, 1636422681549, 264, 0, 264, 0, 0, 0
8505, 1, 1636422681502, 1636422681765, 263, 0, 263, 0, 0, 0
8506, 1, 1636422681718, 1636422681982, 264, 0, 264, 0, 0, 0
8507, 1, 1636422681809, 1636422682074, 265, 1, 264, 1, 0, 1
8508, 1, 1636422681865, 1636422682129, 264, 0, 264, 0, 0, 0
8509, 1, 1636422682089, 1636422682354, 265, 0, 265, 0, 0, 0
8510, 1, 1636422682222, 1636422682485, 263, 0, 263, 0, 0, 0
8511, 1, 1636422682513, 1636422682782, 269, 0, 269, 0, 0, 0
8512, 1, 1636422682621, 1636422682889, 268, 0, 268, 0, 0, 0
8513, 1, 1636422682630, 1636422682897, 267, 0, 267, 0, 0, 0
8514, 1, 1636422682873, 1636422683138, 265, 1, 264, 0, 0, 0
8515, 1, 1636422683022, 1636422683286, 264, 0, 264, 0, 0, 0
8516, 1, 1636422683318, 1636422683582, 264, 0, 264, 0, 0, 0
8517, 1, 1636422683429, 1636422683693, 264, 1, 263, 0, 0, 0
8518, 1, 1636422683429, 1636422683697, 268, 1, 267, 0, 0, 0
8519, 1, 1636422683677, 1636422683946, 269, 0, 269, 0, 0, 0
8520, 1, 1636422683810, 1636422684074, 264, 0, 264, 0, 0, 0
8522, 1, 1636422684214, 1636422684477, 263, 0, 263, 0, 0, 0
8523, 1, 1636422684222, 1636422684485, 263, 0, 263, 0, 0, 0
8525, 1, 1636422684618, 1636422684886, 268, 0, 268, 0, 0, 0
8526, 1, 1636422685025, 1636422685293, 268, 0, 268, 0, 0, 0
8527, 1, 1636422685033, 1636422685297, 264, 1, 263, 0, 0, 0
8528, 1, 1636422685249, 1636422685518, 269, 0, 269, 0, 0, 0
8531, 1, 1636422685825, 1636422686090, 265, 1, 264, 0, 0, 0
8532, 1, 1636422685954, 1636422686221, 267, 0, 267, 0, 0, 0
8533, 1, 1636422686621, 1636422686890, 269, 1, 268, 0, 0, 0
8534, 1, 1636422686758, 1636422687025, 267, 0, 267, 0, 0, 0
8535, 1, 1636422687414, 1636422687677, 263, 0, 263, 0, 0, 0
8536, 1, 1636422687569, 1636422687834, 265, 1, 264, 0, 0, 0
8537, 1, 1636422688214, 1636422688481, 267, 0, 267, 0, 0, 0
8538, 1, 1636422688385, 1636422688658, 273, 1, 272, 1, 0, 1
8539, 1, 1636422689005, 1636422689270, 265, 1, 264, 0, 0, 0
8540, 1, 1636422689174, 1636422689441, 267, 0, 267, 0, 0, 0
8541, 1, 1636422689813, 1636422690078, 265, 1, 264, 0, 1, 1
8542, 1, 1636422690553, 1636422690818, 265, 0, 265, 0, 0, 0
8545, 1, 1636422690605, 1636422690870, 265, 1, 264, 0, 1, 1
8543, 1, 1636422690825, 1636422691094, 269, 1, 268, 0, 0, 0
8544, 1, 1636422691101, 1636422691366, 265, 0, 265, 0, 0, 0
8546, 1, 1636422691262, 1636422691525, 263, 0, 263, 0, 0, 0
8547, 1, 1636422691413, 1636422691682, 269, 1, 268, 0, 1, 1
8548, 1, 1636422691497, 1636422691761, 264, 1, 263, 0, 0, 0
8549, 1, 1636422691769, 1636422692033, 264, 0, 264, 0, 0, 0
8550, 1, 1636422692049, 1636422692317, 268, 1, 267, 1, 0, 1
8551, 1, 1636422692217, 1636422692481, 264, 1, 263, 0, 1, 1
8552, 1, 1636422692262, 1636422692525, 263, 0, 263, 0, 0, 0
8553, 1, 1636422692538, 1636422692806, 268, 0, 268, 0, 0, 0
8554, 1, 1636422692861, 1636422693125, 264, 1, 263, 0, 0, 0
8555, 1, 1636422693009, 1636422693273, 264, 0, 264, 0, 0, 0
8556, 1, 1636422693069, 1636422693333, 264, 1, 263, 0, 0, 0
8557, 1, 1636422693349, 1636422693617, 268, 0, 268, 0, 0, 0
8558, 1, 1636422693662, 1636422693925, 263, 0, 263, 0, 0, 0
8559, 1, 1636422693793, 1636422694057, 264, 1, 263, 0, 0, 0
8560, 1, 1636422693858, 1636422694149, 291, 0, 291, 0, 0, 0
8561, 1, 1636422694158, 1636422694425, 267, 0, 267, 0, 0, 0
8562, 1, 1636422694425, 1636422694686, 261, 0, 261, 0, 0, 0
8563, 1, 1636422694469, 1636422694733, 264, 0, 264, 0, 0, 0
8564, 1, 1636422694606, 1636422694869, 263, 0, 263, 0, 0, 0
8565, 1, 1636422694645, 1636422694905, 260, 0, 260, 0, 0, 0
8566, 1, 1636422694777, 1636422695046, 269, 1, 268, 0, 0, 0
8567, 1, 1636422694941, 1636422695206, 265, 1, 264, 0, 1, 1
8568, 1, 1636422695129, 1636422695397, 268, 1, 267, 0, 0, 0
8569, 1, 1636422695273, 1636422695533, 260, 0, 260, 0, 0, 0
8530, 1, 1636422695409, 1636422695681, 272, 0, 272, 0, 0, 0
8570, 1, 1636422695497, 1636422695761, 264, 0, 264, 0, 0, 0
8571, 1, 1636422695497, 1636422695761, 264, 1, 263, 1, 0, 1
8572, 1, 1636422695713, 1636422695978, 265, 0, 265, 0, 0, 0
8573, 1, 1636422695769, 1636422696030, 261, 0, 261, 0, 0, 0
8574, 1, 1636422695914, 1636422696181, 267, 0, 267, 0, 0, 0
8576, 1, 1636422696057, 1636422696321, 264, 1, 263, 0, 1, 1
8575, 1, 1636422696085, 1636422696349, 264, 1, 263, 1, 0, 1
8577, 1, 1636422696293, 1636422696558, 265, 0, 265, 0, 0, 0
8578, 1, 1636422696433, 1636422696701, 268, 0, 268, 0, 0, 0
8579, 1, 1636422696545, 1636422696809, 264, 1, 263, 0, 0, 0
8580, 1, 1636422696718, 1636422696982, 264, 0, 264, 0, 0, 0
8581, 1, 1636422696830, 1636422697093, 263, 0, 263, 0, 0, 0
8582, 1, 1636422696837, 1636422697102, 265, 0, 265, 0, 0, 0
8583, 1, 1636422697093, 1636422697362, 269, 1, 268, 1, 0, 1
8584, 1, 1636422697230, 1636422697493, 263, 0, 263, 0, 0, 0
8585, 1, 1636422697358, 1636422697621, 263, 0, 263, 0, 0, 0
8586, 1, 1636422697533, 1636422697798, 265, 1, 264, 0, 0, 0
8587, 1, 1636422697613, 1636422697878, 265, 1, 264, 0, 0, 0
8588, 1, 1636422697909, 1636422698173, 264, 0, 264, 0, 0, 0
8589, 1, 1636422698033, 1636422698298, 265, 1, 264, 0, 0, 0
8590, 1, 1636422698349, 1636422698618, 269, 0, 269, 0, 0, 0
8591, 1, 1636422698417, 1636422698681, 264, 0, 264, 0, 0, 0
8592, 1, 1636422698725, 1636422698994, 269, 0, 269, 0, 0, 0
8593, 1, 1636422698849, 1636422699117, 268, 1, 267, 0, 0, 0
8594, 1, 1636422699137, 1636422699402, 265, 1, 264, 0, 1, 1
8595, 1, 1636422699230, 1636422699493, 263, 0, 263, 0, 0, 0
8596, 1, 1636422699518, 1636422699782, 264, 0, 264, 0, 0, 0
8597, 1, 1636422699650, 1636422699921, 271, 0, 271, 0, 0, 0
8598, 1, 1636422700041, 1636422700305, 264, 0, 264, 0, 0, 0
8599, 1, 1636422700438, 1636422700709, 271, 0, 271, 0, 0, 0
8600, 1, 1636422700846, 1636422701114, 268, 0, 268, 0, 0, 0
